date;id;country;newc;newd;totalc;totald
2020-02-24;AF;Afghanistan;1;0;1;0
2020-02-25;AF;Afghanistan;0;0;1;0
2020-02-26;AF;Afghanistan;0;0;1;0
2020-02-27;AF;Afghanistan;0;0;1;0
2020-02-28;AF;Afghanistan;0;0;1;0
2020-02-29;AF;Afghanistan;0;0;1;0
2020-03-01;AF;Afghanistan;0;0;1;0
2020-03-02;AF;Afghanistan;0;0;1;0
2020-03-03;AF;Afghanistan;1;0;2;0
2020-03-04;AF;Afghanistan;2;0;4;0
2020-03-05;AF;Afghanistan;0;0;4;0
2020-03-06;AF;Afghanistan;0;0;4;0
2020-03-07;AF;Afghanistan;0;0;4;0
2020-03-08;AF;Afghanistan;1;0;5;0
2020-03-09;AF;Afghanistan;2;0;7;0
2020-03-10;AF;Afghanistan;1;0;8;0
2020-03-11;AF;Afghanistan;3;0;11;0
2020-03-12;AF;Afghanistan;1;0;12;0
2020-03-13;AF;Afghanistan;1;0;13;0
2020-03-14;AF;Afghanistan;2;0;15;0
2020-03-15;AF;Afghanistan;1;0;16;0
2020-03-16;AF;Afghanistan;2;0;18;0
2020-03-17;AF;Afghanistan;2;0;20;0
2020-03-18;AF;Afghanistan;4;0;24;0
2020-03-19;AF;Afghanistan;1;0;25;0
2020-03-20;AF;Afghanistan;4;0;29;0
2020-03-21;AF;Afghanistan;1;0;30;0
2020-03-22;AF;Afghanistan;4;1;34;1
2020-03-23;AF;Afghanistan;7;0;41;1
2020-03-24;AF;Afghanistan;2;0;43;1
2020-03-25;AF;Afghanistan;33;1;76;2
2020-03-26;AF;Afghanistan;4;1;80;3
2020-03-27;AF;Afghanistan;11;0;91;3
2020-03-28;AF;Afghanistan;16;1;107;4
2020-03-29;AF;Afghanistan;11;0;118;4
2020-03-30;AF;Afghanistan;28;0;146;4
2020-03-31;AF;Afghanistan;29;0;175;4
2020-04-01;AF;Afghanistan;22;0;197;4
2020-04-02;AF;Afghanistan;43;0;240;4
2020-04-03;AF;Afghanistan;35;4;275;8
2020-04-04;AF;Afghanistan;25;2;300;10
2020-04-05;AF;Afghanistan;38;2;338;12
2020-04-06;AF;Afghanistan;30;3;368;15
2020-04-07;AF;Afghanistan;56;1;424;16
2020-04-08;AF;Afghanistan;21;0;445;16
2020-04-09;AF;Afghanistan;40;1;485;17
2020-04-10;AF;Afghanistan;47;1;532;18
2020-04-11;AF;Afghanistan;24;0;556;18
2020-04-12;AF;Afghanistan;52;1;608;19
2020-04-13;AF;Afghanistan;58;3;666;22
2020-04-14;AF;Afghanistan;49;1;715;23
2020-04-15;AF;Afghanistan;70;6;785;29
2020-04-16;AF;Afghanistan;56;1;841;30
2020-04-17;AF;Afghanistan;66;0;907;30
2020-04-18;AF;Afghanistan;27;0;934;30
2020-04-19;AF;Afghanistan;63;3;997;33
2020-04-20;AF;Afghanistan;30;3;1027;36
2020-04-21;AF;Afghanistan;66;0;1093;36
2020-04-22;AF;Afghanistan;84;4;1177;40
2020-04-23;AF;Afghanistan;59;0;1236;40
2020-04-24;AF;Afghanistan;95;3;1331;43
2020-04-25;AF;Afghanistan;133;4;1464;47
2020-04-26;AF;Afghanistan;68;5;1532;52
2020-04-27;AF;Afghanistan;172;6;1704;58
2020-04-28;AF;Afghanistan;126;1;1830;59
2020-04-29;AF;Afghanistan;110;2;1940;61
2020-04-30;AF;Afghanistan;187;3;2127;64
2020-05-01;AF;Afghanistan;164;4;2291;68
2020-05-02;AF;Afghanistan;179;4;2470;72
2020-05-03;AF;Afghanistan;235;13;2705;85
2020-05-04;AF;Afghanistan;190;5;2895;90
2020-05-05;AF;Afghanistan;330;5;3225;95
2020-05-06;AF;Afghanistan;168;9;3393;104
2020-05-07;AF;Afghanistan;171;2;3564;106
2020-05-08;AF;Afghanistan;217;3;3781;109
2020-05-09;AF;Afghanistan;261;6;4042;115
2020-05-10;AF;Afghanistan;361;5;4403;120
2020-05-11;AF;Afghanistan;284;2;4687;122
2020-05-12;AF;Afghanistan;281;5;4968;127
2020-05-13;AF;Afghanistan;259;5;5227;132
2020-05-14;AF;Afghanistan;413;4;5640;136
2020-05-15;AF;Afghanistan;414;17;6054;153
2020-05-16;AF;Afghanistan;349;15;6403;168
2020-05-17;AF;Afghanistan;262;2;6665;170
2020-05-18;AF;Afghanistan;408;3;7073;173
2020-05-19;AF;Afghanistan;581;5;7654;178
2020-05-20;AF;Afghanistan;492;10;8146;188
2020-05-21;AF;Afghanistan;531;6;8677;194
2020-05-22;AF;Afghanistan;542;12;9219;206
2020-05-23;AF;Afghanistan;782;11;10001;217
2020-05-24;AF;Afghanistan;584;2;10585;219
2020-05-25;AF;Afghanistan;591;1;11176;220
2020-05-26;AF;Afghanistan;658;1;11834;221
2020-05-27;AF;Afghanistan;625;7;12459;228
2020-05-28;AF;Afghanistan;580;8;13039;236
2020-05-29;AF;Afghanistan;623;11;13662;247
2020-05-30;AF;Afghanistan;866;3;14528;250
2020-05-31;AF;Afghanistan;680;8;15208;258
2020-06-01;AF;Afghanistan;545;8;15753;266
2020-06-02;AF;Afghanistan;759;8;16512;274
2020-06-03;AF;Afghanistan;758;24;17270;298
2020-06-04;AF;Afghanistan;787;6;18057;304
2020-06-05;AF;Afghanistan;915;9;18972;313
2020-06-06;AF;Afghanistan;582;18;19554;331
2020-06-07;AF;Afghanistan;791;30;20345;361
2020-06-08;AF;Afghanistan;575;12;20920;373
2020-06-09;AF;Afghanistan;542;15;21462;388
2020-06-10;AF;Afghanistan;684;21;22146;409
2020-06-11;AF;Afghanistan;748;21;22894;430
2020-06-12;AF;Afghanistan;656;20;23550;450
2020-06-13;AF;Afghanistan;556;5;24106;455
2020-06-14;AF;Afghanistan;664;20;24770;475
2020-06-15;AF;Afghanistan;761;7;25531;482
2020-06-16;AF;Afghanistan;783;13;26314;495
2020-06-17;AF;Afghanistan;564;13;26878;508
2020-06-18;AF;Afghanistan;658;42;27536;550
2020-06-19;AF;Afghanistan;346;2;27882;552
2020-06-20;AF;Afghanistan;546;21;28428;573
2020-06-21;AF;Afghanistan;409;12;28837;585
2020-06-22;AF;Afghanistan;310;12;29147;597
2020-06-23;AF;Afghanistan;324;20;29471;617
2020-06-24;AF;Afghanistan;234;21;29705;638
2020-06-25;AF;Afghanistan;460;36;30165;674
2020-06-26;AF;Afghanistan;276;8;30441;682
2020-06-27;AF;Afghanistan;165;34;30606;716
2020-06-28;AF;Afghanistan;351;12;30957;728
2020-06-29;AF;Afghanistan;271;12;31228;740
2020-06-30;AF;Afghanistan;279;12;31507;752
2020-07-01;AF;Afghanistan;319;28;31826;780
2020-07-02;AF;Afghanistan;186;29;32012;809
2020-07-03;AF;Afghanistan;302;12;32314;821
2020-07-04;AF;Afghanistan;348;7;32662;828
2020-07-05;AF;Afghanistan;279;38;32941;866
2020-07-06;AF;Afghanistan;239;34;33180;900
2020-07-07;AF;Afghanistan;194;22;33374;922
2020-07-08;AF;Afghanistan;210;17;33584;939
2020-07-09;AF;Afghanistan;314;20;33898;959
2020-07-10;AF;Afghanistan;286;14;34184;973
2020-07-11;AF;Afghanistan;172;23;34356;996
2020-07-12;AF;Afghanistan;85;16;34441;1012
2020-07-13;AF;Afghanistan;154;28;34595;1040
2020-07-14;AF;Afghanistan;135;24;34730;1064
2020-07-15;AF;Afghanistan;254;32;34984;1096
2020-07-16;AF;Afghanistan;76;21;35060;1117
2020-07-17;AF;Afghanistan;159;32;35219;1149
2020-07-18;AF;Afghanistan;60;17;35279;1166
2020-07-19;AF;Afghanistan;174;17;35453;1183
2020-07-20;AF;Afghanistan;40;2;35493;1185
2020-07-21;AF;Afghanistan;112;3;35605;1188
2020-07-22;AF;Afghanistan;112;4;35717;1192
2020-07-23;AF;Afghanistan;201;21;35918;1213
2020-07-24;AF;Afghanistan;60;14;35978;1227
2020-07-25;AF;Afghanistan;48;22;36026;1249
2020-07-26;AF;Afghanistan;121;12;36147;1261
2020-07-27;AF;Afghanistan;106;10;36253;1271
2020-07-28;AF;Afghanistan;105;1;36358;1272
2020-07-29;AF;Afghanistan;105;1;36463;1273
2020-07-30;AF;Afghanistan;69;10;36532;1283
2020-07-31;AF;Afghanistan;133;1;36665;1284
2020-08-01;AF;Afghanistan;35;1;36700;1285
2020-08-02;AF;Afghanistan;1;1;36701;1286
2020-08-03;AF;Afghanistan;36;4;36737;1290
2020-08-04;AF;Afghanistan;36;0;36773;1290
2020-08-05;AF;Afghanistan;47;6;36820;1296
2020-08-06;AF;Afghanistan;108;5;36928;1301
2020-08-07;AF;Afghanistan;78;9;37006;1310
2020-08-08;AF;Afghanistan;40;5;37046;1315
2020-08-09;AF;Afghanistan;37;6;37083;1321
2020-08-10;AF;Afghanistan;70;8;37153;1329
2020-08-11;AF;Afghanistan;107;17;37260;1346
2020-08-12;AF;Afghanistan;76;10;37336;1356
2020-08-13;AF;Afghanistan;86;9;37422;1365
2020-08-14;AF;Afghanistan;75;5;37497;1370
2020-08-15;AF;Afghanistan;45;1;37542;1371
2020-08-16;AF;Afghanistan;48;5;37590;1376
2020-08-17;AF;Afghanistan;77;2;37667;1378
2020-08-18;AF;Afghanistan;43;4;37710;1382
2020-08-19;AF;Afghanistan;40;2;37750;1384
2020-08-20;AF;Afghanistan;102;2;37852;1386
2020-08-21;AF;Afghanistan;33;0;37885;1386
2020-08-22;AF;Afghanistan;59;0;37944;1386
2020-08-23;AF;Afghanistan;46;2;37990;1388
2020-08-24;AF;Afghanistan;55;2;38045;1390
2020-08-25;AF;Afghanistan;16;8;38061;1398
2020-08-26;AF;Afghanistan;42;4;38103;1402
2020-08-27;AF;Afghanistan;16;0;38119;1402
2020-08-28;AF;Afghanistan;11;1;38130;1403
2020-08-29;AF;Afghanistan;3;0;38133;1403
2020-08-30;AF;Afghanistan;22;0;38155;1403
2020-08-31;AF;Afghanistan;4;0;38159;1403
2020-09-01;AF;Afghanistan;34;4;38193;1407
2020-09-02;AF;Afghanistan;50;3;38243;1410
2020-09-03;AF;Afghanistan;45;0;38288;1410
2020-09-04;AF;Afghanistan;16;0;38304;1410
2020-09-05;AF;Afghanistan;20;0;38324;1410
2020-09-06;AF;Afghanistan;74;3;38398;1413
2020-09-07;AF;Afghanistan;96;3;38494;1416
2020-09-08;AF;Afghanistan;26;3;38520;1419
2020-09-09;AF;Afghanistan;24;2;38544;1421
2020-09-10;AF;Afghanistan;28;0;38572;1421
2020-09-11;AF;Afghanistan;34;0;38606;1421
2020-09-12;AF;Afghanistan;35;0;38641;1421
2020-09-13;AF;Afghanistan;75;0;38716;1421
2020-09-14;AF;Afghanistan;56;6;38772;1427
2020-09-15;AF;Afghanistan;43;1;38815;1428
2020-09-16;AF;Afghanistan;40;10;38855;1438
2020-09-17;AF;Afghanistan;17;0;38872;1438
2020-09-18;AF;Afghanistan;25;1;38897;1439
2020-09-19;AF;Afghanistan;22;0;38919;1439
2020-09-20;AF;Afghanistan;125;4;39044;1443
2020-09-21;AF;Afghanistan;30;3;39074;1446
2020-09-22;AF;Afghanistan;22;1;39096;1447
2020-09-23;AF;Afghanistan;49;1;39145;1448
2020-09-24;AF;Afghanistan;25;5;39170;1453
2020-09-25;AF;Afghanistan;16;0;39186;1453
2020-09-26;AF;Afghanistan;6;2;39192;1455
2020-09-27;AF;Afghanistan;35;0;39227;1455
2020-09-28;AF;Afghanistan;12;3;39239;1458
2020-09-29;AF;Afghanistan;15;2;39254;1460
2020-09-30;AF;Afghanistan;14;0;39268;1460
2020-10-01;AF;Afghanistan;17;0;39285;1460
2020-10-02;AF;Afghanistan;5;0;39290;1460
2020-10-03;AF;Afghanistan;7;4;39297;1464
2020-10-04;AF;Afghanistan;44;0;39341;1464
2020-10-05;AF;Afghanistan;81;4;39422;1468
2020-10-06;AF;Afghanistan;64;1;39486;1469
2020-10-07;AF;Afghanistan;62;2;39548;1471
2020-10-08;AF;Afghanistan;68;1;39616;1472
2020-10-09;AF;Afghanistan;77;2;39693;1474
2020-10-10;AF;Afghanistan;10;1;39703;1475
2020-10-11;AF;Afghanistan;96;4;39799;1479
2020-10-12;AF;Afghanistan;71;2;39870;1481
2020-10-13;AF;Afghanistan;58;1;39928;1482
2020-10-14;AF;Afghanistan;66;1;39994;1483
2020-10-15;AF;Afghanistan;32;0;40026;1483
2020-10-16;AF;Afghanistan;62;4;40088;1487
2020-10-17;AF;Afghanistan;53;3;40141;1490
2020-10-18;AF;Afghanistan;59;4;40200;1494
2020-10-19;AF;Afghanistan;87;5;40287;1499
2020-10-20;AF;Afghanistan;82;2;40369;1501
2020-10-21;AF;Afghanistan;141;2;40510;1503
2020-10-22;AF;Afghanistan;116;4;40626;1507
2020-10-23;AF;Afghanistan;61;2;40687;1509
2020-10-24;AF;Afghanistan;81;4;40768;1513
2020-10-25;AF;Afghanistan;65;3;40833;1516
2020-10-26;AF;Afghanistan;104;4;40937;1520
2020-10-27;AF;Afghanistan;95;5;41032;1525
2020-10-28;AF;Afghanistan;113;6;41145;1531
2020-10-29;AF;Afghanistan;123;3;41268;1534
2020-10-30;AF;Afghanistan;66;1;41334;1535
2020-10-31;AF;Afghanistan;91;3;41425;1538
2020-11-01;AF;Afghanistan;76;0;41501;1538
2020-11-02;AF;Afghanistan;132;6;41633;1544
2020-11-03;AF;Afghanistan;95;3;41728;1547
2020-11-04;AF;Afghanistan;86;4;41814;1551
2020-11-05;AF;Afghanistan;121;6;41935;1557
2020-11-06;AF;Afghanistan;40;0;41975;1557
2020-11-07;AF;Afghanistan;58;2;42033;1559
2020-11-08;AF;Afghanistan;126;6;42159;1565
2020-11-09;AF;Afghanistan;138;12;42297;1577
2020-11-10;AF;Afghanistan;166;3;42463;1580
2020-11-11;AF;Afghanistan;146;4;42609;1584
2020-11-12;AF;Afghanistan;186;10;42795;1594
2020-11-13;AF;Afghanistan;174;4;42969;1598
2020-11-14;AF;Afghanistan;66;10;43035;1608
2020-11-15;AF;Afghanistan;205;12;43240;1620
2020-11-16;AF;Afghanistan;228;15;43468;1635
2020-11-17;AF;Afghanistan;213;6;43681;1641
2020-11-18;AF;Afghanistan;243;7;43924;1648
2020-11-19;AF;Afghanistan;253;5;44177;1653
2020-11-20;AF;Afghanistan;186;13;44363;1666
2020-11-21;AF;Afghanistan;140;12;44503;1678
2020-11-22;AF;Afghanistan;203;12;44706;1690
2020-11-23;AF;Afghanistan;282;12;44988;1702
2020-11-24;AF;Afghanistan;186;13;45174;1715
2020-11-25;AF;Afghanistan;210;13;45384;1728
2020-11-26;AF;Afghanistan;216;9;45600;1737
2020-11-27;AF;Afghanistan;123;3;45723;1740
2020-11-28;AF;Afghanistan;121;12;45844;1752
2020-11-29;AF;Afghanistan;272;22;46116;1774
2020-11-30;AF;Afghanistan;158;21;46274;1795
2020-12-01;AF;Afghanistan;242;27;46516;1822
2020-12-02;AF;Afghanistan;202;19;46718;1841
2020-12-03;AF;Afghanistan;119;5;46837;1846
2020-12-04;AF;Afghanistan;0;0;46837;1846
2020-12-05;AF;Afghanistan;235;18;47072;1864
2020-12-06;AF;Afghanistan;234;10;47306;1874
2020-12-07;AF;Afghanistan;210;26;47516;1900
2020-12-08;AF;Afghanistan;200;6;47716;1906
2020-12-09;AF;Afghanistan;135;13;47851;1919
2020-12-10;AF;Afghanistan;202;16;48053;1935
2020-12-11;AF;Afghanistan;63;10;48116;1945
2020-12-12;AF;Afghanistan;113;11;48229;1956
2020-12-13;AF;Afghanistan;298;9;48527;1965
2020-12-14;AF;Afghanistan;191;4;48718;1969
2020-12-15;AF;Afghanistan;234;26;48952;1995
2020-12-16;AF;Afghanistan;209;16;49161;2011
2020-12-17;AF;Afghanistan;217;14;49378;2025
2020-12-18;AF;Afghanistan;243;5;49621;2030
2020-12-19;AF;Afghanistan;60;17;49681;2047
2020-12-20;AF;Afghanistan;136;20;49817;2067
2020-12-21;AF;Afghanistan;196;15;50013;2082
2020-12-22;AF;Afghanistan;177;14;50190;2096
2020-12-23;AF;Afghanistan;243;21;50433;2117
2020-12-24;AF;Afghanistan;222;9;50655;2126
2020-12-25;AF;Afghanistan;155;13;50810;2139
2020-12-26;AF;Afghanistan;76;10;50886;2149
2020-12-27;AF;Afghanistan;153;11;51039;2160
2020-12-28;AF;Afghanistan;241;14;51280;2174
2020-12-29;AF;Afghanistan;70;5;51350;2179
2020-12-30;AF;Afghanistan;55;2;51405;2181
2020-12-31;AF;Afghanistan;121;10;51526;2191
2021-01-01;AF;Afghanistan;0;0;51526;2191
2021-01-02;AF;Afghanistan;0;0;51526;2191
2021-01-03;AF;Afghanistan;0;0;51526;2191
2021-01-04;AF;Afghanistan;1485;46;53011;2237
2021-01-05;AF;Afghanistan;94;7;53105;2244
2021-01-06;AF;Afghanistan;0;0;53105;2244
2021-01-07;AF;Afghanistan;102;9;53207;2253
2021-01-08;AF;Afghanistan;125;4;53332;2257
2021-01-09;AF;Afghanistan;68;7;53400;2264
2021-01-10;AF;Afghanistan;89;13;53489;2277
2021-01-11;AF;Afghanistan;49;11;53538;2288
2021-01-12;AF;Afghanistan;46;13;53584;2301
2021-01-13;AF;Afghanistan;0;0;53584;2301
2021-01-14;AF;Afghanistan;191;13;53775;2314
2021-01-15;AF;Afghanistan;56;10;53831;2324
2021-01-16;AF;Afghanistan;107;12;53938;2336
2021-01-17;AF;Afghanistan;46;3;53984;2339
2021-01-18;AF;Afghanistan;78;4;54062;2343
2021-01-19;AF;Afghanistan;79;3;54141;2346
2021-01-20;AF;Afghanistan;137;8;54278;2354
2021-01-21;AF;Afghanistan;125;9;54403;2363
2021-01-22;AF;Afghanistan;80;7;54483;2370
2021-01-23;AF;Afghanistan;76;3;54559;2373
2021-01-24;AF;Afghanistan;36;5;54595;2378
2021-01-25;AF;Afghanistan;77;7;54672;2385
2021-01-26;AF;Afghanistan;78;4;54750;2389
2021-01-27;AF;Afghanistan;104;0;54854;2389
2021-01-28;AF;Afghanistan;37;8;54891;2397
2021-01-29;AF;Afghanistan;48;2;54939;2399
2021-01-30;AF;Afghanistan;69;1;55008;2400
2021-01-31;AF;Afghanistan;15;0;55023;2400
2021-02-01;AF;Afghanistan;36;4;55059;2404
2021-02-02;AF;Afghanistan;62;1;55121;2405
2021-02-03;AF;Afghanistan;53;1;55174;2406
2021-02-04;AF;Afghanistan;57;1;55231;2407
2021-02-05;AF;Afghanistan;34;0;55265;2407
2021-02-06;AF;Afghanistan;65;1;55330;2408
2021-02-07;AF;Afghanistan;5;2;55335;2410
2021-02-08;AF;Afghanistan;24;3;55359;2413
2021-02-09;AF;Afghanistan;25;1;55384;2414
2021-02-10;AF;Afghanistan;18;4;55402;2418
2021-02-11;AF;Afghanistan;18;1;55420;2419
2021-02-12;AF;Afghanistan;25;5;55445;2424
2021-02-13;AF;Afghanistan;28;3;55473;2427
2021-02-14;AF;Afghanistan;19;0;55492;2427
2021-02-15;AF;Afghanistan;22;0;55514;2427
2021-02-16;AF;Afghanistan;4;1;55518;2428
2021-02-17;AF;Afghanistan;22;0;55540;2428
2021-02-18;AF;Afghanistan;17;2;55557;2430
2021-02-19;AF;Afghanistan;18;0;55575;2430
2021-02-20;AF;Afghanistan;5;0;55580;2430
2021-02-21;AF;Afghanistan;24;2;55604;2432
2021-02-22;AF;Afghanistan;13;1;55617;2433
2021-02-23;AF;Afghanistan;29;2;55646;2435
2021-02-24;AF;Afghanistan;18;1;55664;2436
2021-02-25;AF;Afghanistan;16;2;55680;2438
2021-02-26;AF;Afghanistan;16;4;55696;2442
2021-02-27;AF;Afghanistan;11;1;55707;2443
2021-02-28;AF;Afghanistan;7;0;55714;2443
2021-03-01;AF;Afghanistan;19;1;55733;2444
2021-03-02;AF;Afghanistan;26;2;55759;2446
2021-03-03;AF;Afghanistan;11;0;55770;2446
2021-03-04;AF;Afghanistan;5;0;55775;2446
2021-03-05;AF;Afghanistan;52;3;55827;2449
2021-03-06;AF;Afghanistan;13;0;55840;2449
2021-03-07;AF;Afghanistan;7;0;55847;2449
2021-03-08;AF;Afghanistan;29;2;55876;2451
2021-03-09;AF;Afghanistan;0;0;55876;2451
2021-03-10;AF;Afghanistan;18;0;55894;2451
2021-03-11;AF;Afghanistan;23;0;55917;2451
2021-03-12;AF;Afghanistan;42;3;55959;2454
2021-03-13;AF;Afghanistan;0;0;55959;2454
2021-03-14;AF;Afghanistan;26;3;55985;2457
2021-03-15;AF;Afghanistan;0;2;55985;2459
2021-03-16;AF;Afghanistan;10;1;55995;2460
2021-03-17;AF;Afghanistan;21;0;56016;2460
2021-03-18;AF;Afghanistan;28;2;56044;2462
2021-03-19;AF;Afghanistan;25;0;56069;2462
2021-03-20;AF;Afghanistan;24;0;56093;2462
2021-03-21;AF;Afghanistan;10;1;56103;2463
2021-03-22;AF;Afghanistan;50;1;56153;2464
2021-03-23;AF;Afghanistan;24;2;56177;2466
2021-03-24;AF;Afghanistan;15;0;56192;2466
2021-03-25;AF;Afghanistan;34;1;56226;2467
2021-03-26;AF;Afghanistan;28;0;56254;2467
2021-03-27;AF;Afghanistan;36;2;56290;2469
2021-03-28;AF;Afghanistan;4;1;56294;2470
2021-03-29;AF;Afghanistan;28;2;56322;2472
2021-03-30;AF;Afghanistan;62;4;56384;2476
2021-03-31;AF;Afghanistan;70;8;56454;2484
2021-04-01;AF;Afghanistan;63;5;56517;2489
2021-04-02;AF;Afghanistan;55;6;56572;2495
2021-04-03;AF;Afghanistan;23;1;56595;2496
2021-04-04;AF;Afghanistan;81;1;56676;2497
2021-04-05;AF;Afghanistan;41;11;56717;2508
2021-04-06;AF;Afghanistan;62;4;56779;2512
2021-04-07;AF;Afghanistan;94;0;56873;2512
2021-04-08;AF;Afghanistan;70;4;56943;2516
2021-04-09;AF;Afghanistan;76;5;57019;2521
2021-04-10;AF;Afghanistan;125;0;57144;2521
2021-04-11;AF;Afghanistan;16;0;57160;2521
2021-04-12;AF;Afghanistan;82;8;57242;2529
2021-04-13;AF;Afghanistan;122;0;57364;2529
2021-04-14;AF;Afghanistan;128;3;57492;2532
2021-04-15;AF;Afghanistan;42;1;57534;2533
2021-04-16;AF;Afghanistan;78;2;57612;2535
2021-04-17;AF;Afghanistan;109;4;57721;2539
2021-04-18;AF;Afghanistan;72;0;57793;2539
2021-04-19;AF;Afghanistan;105;7;57898;2546
2021-04-20;AF;Afghanistan;139;3;58037;2549
2021-04-21;AF;Afghanistan;177;8;58214;2557
2021-04-22;AF;Afghanistan;98;4;58312;2561
2021-04-23;AF;Afghanistan;230;4;58542;2565
2021-04-24;AF;Afghanistan;188;7;58730;2572
2021-04-25;AF;Afghanistan;113;10;58843;2582
2021-04-26;AF;Afghanistan;172;10;59015;2592
2021-04-27;AF;Afghanistan;210;6;59225;2598
2021-04-28;AF;Afghanistan;145;13;59370;2611
2021-04-29;AF;Afghanistan;206;7;59576;2618
2021-04-30;AF;Afghanistan;169;7;59745;2625
2021-05-01;AF;Afghanistan;194;6;59939;2631
2021-05-02;AF;Afghanistan;183;6;60122;2637
2021-05-03;AF;Afghanistan;178;5;60300;2642
2021-05-04;AF;Afghanistan;263;6;60563;2648
2021-05-05;AF;Afghanistan;234;6;60797;2654
2021-05-06;AF;Afghanistan;365;10;61162;2664
2021-05-07;AF;Afghanistan;293;9;61455;2673
2021-05-08;AF;Afghanistan;300;10;61755;2683
2021-05-09;AF;Afghanistan;87;3;61842;2686
2021-05-10;AF;Afghanistan;221;12;62063;2698
2021-05-11;AF;Afghanistan;340;12;62403;2710
2021-05-12;AF;Afghanistan;315;3;62718;2713
2021-05-13;AF;Afghanistan;327;8;63045;2721
2021-05-14;AF;Afghanistan;310;9;63355;2730
2021-05-15;AF;Afghanistan;57;3;63412;2733
2021-05-16;AF;Afghanistan;72;9;63484;2742
2021-05-17;AF;Afghanistan;114;3;63598;2745
2021-05-18;AF;Afghanistan;221;6;63819;2751
2021-05-19;AF;Afghanistan;303;11;64122;2762
2021-05-20;AF;Afghanistan;453;10;64575;2772
2021-05-21;AF;Afghanistan;505;10;65080;2782
2021-05-22;AF;Afghanistan;406;10;65486;2792
2021-05-23;AF;Afghanistan;242;10;65728;2802
2021-05-24;AF;Afghanistan;547;10;66275;2812
2021-05-25;AF;Afghanistan;628;24;66903;2836
2021-05-26;AF;Afghanistan;840;19;67743;2855
2021-05-27;AF;Afghanistan;623;14;68366;2869
2021-05-28;AF;Afghanistan;764;12;69130;2881
2021-05-29;AF;Afghanistan;981;18;70111;2899
2021-05-30;AF;Afghanistan;650;20;70761;2919
2021-05-31;AF;Afghanistan;1077;25;71838;2944
2021-06-01;AF;Afghanistan;1139;29;72977;2973
2021-06-02;AF;Afghanistan;1049;34;74026;3007
2021-06-03;AF;Afghanistan;1093;27;75119;3034
2021-06-04;AF;Afghanistan;1509;34;76628;3068
2021-06-05;AF;Afghanistan;1335;36;77963;3104
2021-06-06;AF;Afghanistan;1261;41;79224;3145
2021-06-07;AF;Afghanistan;1617;42;80841;3187
2021-06-08;AF;Afghanistan;1485;64;82326;3251
2021-06-09;AF;Afghanistan;1724;54;84050;3305
2021-06-10;AF;Afghanistan;1842;51;85892;3356
2021-06-11;AF;Afghanistan;1824;56;87716;3412
2021-06-12;AF;Afghanistan;1024;37;88740;3449
2021-06-13;AF;Afghanistan;1121;78;89861;3527
2021-06-14;AF;Afghanistan;1597;85;91458;3612
2021-06-15;AF;Afghanistan;1814;71;93272;3683
2021-06-16;AF;Afghanistan;16;0;93288;3683
2021-06-17;AF;Afghanistan;3243;159;96531;3842
2021-06-18;AF;Afghanistan;2203;92;98734;3934
2021-06-19;AF;Afghanistan;0;0;98734;3934
2021-06-20;AF;Afghanistan;0;0;98734;3934
2021-06-21;AF;Afghanistan;5168;281;103902;4215
2021-06-22;AF;Afghanistan;1847;78;105749;4293
2021-06-23;AF;Afghanistan;2208;73;107957;4366
2021-06-24;AF;Afghanistan;1575;86;109532;4452
2021-06-25;AF;Afghanistan;2060;67;111592;4519
2021-06-26;AF;Afghanistan;0;0;111592;4519
2021-06-27;AF;Afghanistan;0;0;111592;4519
2021-06-28;AF;Afghanistan;4159;211;115751;4730
2021-06-29;AF;Afghanistan;1407;64;117158;4794
2021-06-30;AF;Afghanistan;1501;77;118659;4871
2021-07-01;AF;Afghanistan;1557;91;120216;4962
2020-02-13;;Africa;0;0;0;0
2020-02-14;;Africa;1;0;1;0
2020-02-15;;Africa;0;0;1;0
2020-02-16;;Africa;0;0;1;0
2020-02-17;;Africa;0;0;1;0
2020-02-18;;Africa;0;0;1;0
2020-02-19;;Africa;0;0;1;0
2020-02-20;;Africa;0;0;1;0
2020-02-21;;Africa;0;0;1;0
2020-02-22;;Africa;0;0;1;0
2020-02-23;;Africa;0;0;1;0
2020-02-24;;Africa;0;0;1;0
2020-02-25;;Africa;1;0;2;0
2020-02-26;;Africa;0;0;2;0
2020-02-27;;Africa;0;0;2;0
2020-02-28;;Africa;1;0;3;0
2020-02-29;;Africa;0;0;3;0
2020-03-01;;Africa;1;0;4;0
2020-03-02;;Africa;4;0;8;0
2020-03-03;;Africa;3;0;11;0
2020-03-04;;Africa;10;0;21;0
2020-03-05;;Africa;3;0;24;0
2020-03-06;;Africa;19;0;43;0
2020-03-07;;Africa;0;0;43;0
2020-03-08;;Africa;40;1;83;1
2020-03-09;;Africa;8;0;91;1
2020-03-10;;Africa;13;1;104;2
2020-03-11;;Africa;14;0;118;2
2020-03-12;;Africa;16;1;134;3
2020-03-13;;Africa;42;3;176;6
2020-03-14;;Africa;78;1;254;7
2020-03-15;;Africa;59;1;313;8
2020-03-16;;Africa;87;0;400;8
2020-03-17;;Africa;84;3;484;11
2020-03-18;;Africa;116;6;600;17
2020-03-19;;Africa;180;3;780;20
2020-03-20;;Africa;188;6;968;26
2020-03-21;;Africa;204;10;1172;36
2020-03-22;;Africa;265;12;1437;48
2020-03-23;;Africa;381;9;1818;57
2020-03-24;;Africa;432;7;2250;64
2020-03-25;;Africa;523;9;2773;73
2020-03-26;;Africa;553;18;3326;91
2020-03-27;;Africa;559;24;3885;115
2020-03-28;;Africa;340;19;4225;134
2020-03-29;;Africa;560;18;4785;152
2020-03-30;;Africa;411;21;5196;173
2020-03-31;;Africa;585;27;5781;200
2020-04-01;;Africa;599;34;6380;234
2020-04-02;;Africa;651;53;7031;287
2020-04-03;;Africa;882;44;7913;331
2020-04-04;;Africa;679;52;8592;383
2020-04-05;;Africa;706;61;9298;444
2020-04-06;;Africa;701;43;9999;487
2020-04-07;;Africa;633;46;10632;533
2020-04-08;;Africa;804;41;11436;574
2020-04-09;;Africa;812;53;12248;627
2020-04-10;;Africa;663;66;12911;693
2020-04-11;;Africa;716;49;13627;742
2020-04-12;;Africa;864;46;14491;788
2020-04-13;;Africa;774;46;15265;834
2020-04-14;;Africa;970;39;16235;873
2020-04-15;;Africa;957;37;17192;910
2020-04-16;;Africa;1168;55;18360;965
2020-04-17;;Africa;1406;51;19766;1016
2020-04-18;;Africa;1306;42;21072;1058
2020-04-19;;Africa;1209;63;22281;1121
2020-04-20;;Africa;1158;38;23439;1159
2020-04-21;;Africa;1070;30;24509;1189
2020-04-22;;Africa;1402;51;25911;1240
2020-04-23;;Africa;1438;57;27349;1297
2020-04-24;;Africa;1719;27;29068;1324
2020-04-25;;Africa;1231;51;30299;1375
2020-04-26;;Africa;1534;48;31833;1423
2020-04-27;;Africa;1334;39;33167;1462
2020-04-28;;Africa;1627;61;34794;1523
2020-04-29;;Africa;2013;65;36807;1588
2020-04-30;;Africa;1946;46;38753;1634
2020-05-01;;Africa;1726;58;40479;1692
2020-05-02;;Africa;2228;67;42707;1759
2020-05-03;;Africa;1594;37;44301;1796
2020-05-04;;Africa;2658;46;46959;1842
2020-05-05;;Africa;2038;66;48997;1908
2020-05-06;;Africa;2546;98;51543;2006
2020-05-07;;Africa;2490;67;54033;2073
2020-05-08;;Africa;3624;81;57657;2154
2020-05-09;;Africa;2850;67;60507;2221
2020-05-10;;Africa;2579;69;63086;2290
2020-05-11;;Africa;3066;54;66152;2344
2020-05-12;;Africa;3160;51;69312;2395
2020-05-13;;Africa;2915;98;72227;2493
2020-05-14;;Africa;3119;69;75346;2562
2020-05-15;;Africa;2928;62;78274;2624
2020-05-16;;Africa;3003;84;81277;2708
2020-05-17;;Africa;3313;51;84590;2759
2020-05-18;;Africa;3668;73;88258;2832
2020-05-19;;Africa;3012;75;91270;2907
2020-05-20;;Africa;3792;83;95062;2990
2020-05-21;;Africa;4692;105;99754;3095
2020-05-22;;Africa;3875;89;103629;3184
2020-05-23;;Africa;3862;73;107491;3257
2020-05-24;;Africa;4126;97;111617;3354
2020-05-25;;Africa;4116;125;115733;3479
2020-05-26;;Africa;3712;112;119445;3591
2020-05-27;;Africa;5079;108;124524;3699
2020-05-28;;Africa;4919;92;129443;3791
2020-05-29;;Africa;5748;131;135191;3922
2020-05-30;;Africa;6120;147;141311;4069
2020-05-31;;Africa;5248;153;146559;4222
2020-06-01;;Africa;5785;121;152344;4343
2020-06-02;;Africa;4885;151;157229;4494
2020-06-03;;Africa;5087;107;162316;4601
2020-06-04;;Africa;7106;155;169422;4756
2020-06-05;;Africa;7196;159;176618;4915
2020-06-06;;Africa;6595;140;183213;5055
2020-06-07;;Africa;6337;133;189550;5188
2020-06-08;;Africa;6648;175;196198;5363
2020-06-09;;Africa;6472;175;202670;5538
2020-06-10;;Africa;6546;150;209216;5688
2020-06-11;;Africa;7402;163;216618;5851
2020-06-12;;Africa;8077;199;224695;6050
2020-06-13;;Africa;8101;203;232796;6253
2020-06-14;;Africa;8767;206;241563;6459
2020-06-15;;Africa;9621;303;251184;6762
2020-06-16;;Africa;7613;253;258797;7015
2020-06-17;;Africa;8732;203;267529;7218
2020-06-18;;Africa;8254;201;275783;7419
2020-06-19;;Africa;9826;263;285609;7682
2020-06-20;;Africa;11330;236;296939;7918
2020-06-21;;Africa;9442;197;306381;8115
2020-06-22;;Africa;8989;223;315370;8338
2020-06-23;;Africa;9051;282;324421;8620
2020-06-24;;Africa;11358;235;335779;8855
2020-06-25;;Africa;11950;214;347729;9069
2020-06-26;;Africa;11577;213;359306;9282
2020-06-27;;Africa;12284;202;371590;9484
2020-06-28;;Africa;10647;179;382237;9663
2020-06-29;;Africa;11048;216;393285;9879
2020-06-30;;Africa;11616;267;404901;10146
2020-07-01;;Africa;13227;259;418128;10405
2020-07-02;;Africa;14193;238;432321;10643
2020-07-03;;Africa;15159;239;447480;10882
2020-07-04;;Africa;15507;201;462987;11083
2020-07-05;;Africa;13640;280;476627;11363
2020-07-06;;Africa;13717;249;490344;11612
2020-07-07;;Africa;17474;365;507818;11977
2020-07-08;;Africa;14726;255;522544;12232
2020-07-09;;Africa;19212;226;541756;12458
2020-07-10;;Africa;17680;310;559436;12768
2020-07-11;;Africa;18815;220;578251;12988
2020-07-12;;Africa;16694;257;594945;13245
2020-07-13;;Africa;16071;218;611016;13463
2020-07-14;;Africa;14435;299;625451;13762
2020-07-15;;Africa;18051;226;643502;13988
2020-07-16;;Africa;20441;370;663943;14358
2020-07-17;;Africa;19540;315;683483;14673
2020-07-18;;Africa;19015;282;702498;14955
2020-07-19;;Africa;18554;214;721052;15169
2020-07-20;;Africa;15525;254;736577;15423
2020-07-21;;Africa;13864;314;750441;15737
2020-07-22;;Africa;19614;708;770055;16445
2020-07-23;;Africa;18467;269;788522;16714
2020-07-24;;Africa;22111;390;810633;17104
2020-07-25;;Africa;18151;417;828784;17521
2020-07-26;;Africa;18315;245;847099;17766
2020-07-27;;Africa;13428;409;860527;18175
2020-07-28;;Africa;13499;322;874026;18497
2020-07-29;;Africa;17642;367;891668;18864
2020-07-30;;Africa;17407;454;909075;19318
2020-07-31;;Africa;19005;364;928080;19682
2020-08-01;;Africa;16920;292;945000;19974
2020-08-02;;Africa;12749;332;957749;20306
2020-08-03;;Africa;10853;321;968602;20627
2020-08-04;;Africa;9915;472;978517;21099
2020-08-05;;Africa;15374;539;993891;21638
2020-08-06;;Africa;14328;431;1008219;22069
2020-08-07;;Africa;13492;439;1021711;22508
2020-08-08;;Africa;14208;413;1035919;22921
2020-08-09;;Africa;12356;358;1048275;23279
2020-08-10;;Africa;9132;319;1057407;23598
2020-08-11;;Africa;7883;269;1065290;23867
2020-08-12;;Africa;9258;410;1074548;24277
2020-08-13;;Africa;10393;405;1084941;24682
2020-08-14;;Africa;12545;416;1097486;25098
2020-08-15;;Africa;11815;240;1109301;25338
2020-08-16;;Africa;9953;295;1119254;25633
2020-08-17;;Africa;8872;264;1128126;25897
2020-08-18;;Africa;8637;415;1136763;26312
2020-08-19;;Africa;10895;328;1147658;26640
2020-08-20;;Africa;10609;337;1158267;26977
2020-08-21;;Africa;10272;352;1168539;27329
2020-08-22;;Africa;10433;274;1178972;27603
2020-08-23;;Africa;9053;182;1188025;27785
2020-08-24;;Africa;7516;220;1195541;28005
2020-08-25;;Africa;7543;283;1203084;28288
2020-08-26;;Africa;8855;319;1211939;28607
2020-08-27;;Africa;8555;253;1220494;28860
2020-08-28;;Africa;8109;231;1228603;29091
2020-08-29;;Africa;8370;331;1236973;29422
2020-08-30;;Africa;8457;164;1245430;29586
2020-08-31;;Africa;6805;226;1252235;29812
2020-09-01;;Africa;7157;242;1259392;30054
2020-09-02;;Africa;8714;265;1268106;30319
2020-09-03;;Africa;7747;297;1275853;30616
2020-09-04;;Africa;8578;238;1284431;30854
2020-09-05;;Africa;7392;225;1291823;31079
2020-09-06;;Africa;7823;224;1299646;31303
2020-09-07;;Africa;6876;218;1306522;31521
2020-09-08;;Africa;7679;226;1314201;31747
2020-09-09;;Africa;8295;192;1322496;31939
2020-09-10;;Africa;8050;185;1330546;32124
2020-09-11;;Africa;8692;231;1339238;32355
2020-09-12;;Africa;7410;146;1346648;32501
2020-09-13;;Africa;6748;121;1353396;32622
2020-09-14;;Africa;6483;171;1359879;32793
2020-09-15;;Africa;6566;277;1366445;33070
2020-09-16;;Africa;7310;179;1373755;33249
2020-09-17;;Africa;8605;179;1382360;33428
2020-09-18;;Africa;8161;193;1390521;33621
2020-09-19;;Africa;8727;202;1399248;33823
2020-09-20;;Africa;8419;133;1407667;33956
2020-09-21;;Africa;6148;126;1413815;34082
2020-09-22;;Africa;6839;240;1420654;34322
2020-09-23;;Africa;8727;209;1429381;34531
2020-09-24;;Africa;8186;175;1437567;34706
2020-09-25;;Africa;7977;154;1445544;34860
2020-09-26;;Africa;6410;168;1451954;35028
2020-09-27;;Africa;8369;135;1460323;35163
2020-09-28;;Africa;5669;294;1465992;35457
2020-09-29;;Africa;7509;217;1473501;35674
2020-09-30;;Africa;8434;189;1481935;35863
2020-10-01;;Africa;7260;217;1489195;36080
2020-10-02;;Africa;8857;149;1498052;36229
2020-10-03;;Africa;8830;111;1506882;36340
2020-10-04;;Africa;8086;170;1514968;36510
2020-10-05;;Africa;4714;128;1519682;36638
2020-10-06;;Africa;6597;188;1526279;36826
2020-10-07;;Africa;10543;269;1536822;37095
2020-10-08;;Africa;10908;298;1547730;37393
2020-10-09;;Africa;8557;236;1556287;37629
2020-10-10;;Africa;13534;271;1569821;37900
2020-10-11;;Africa;8975;208;1578796;38108
2020-10-12;;Africa;5887;193;1584683;38301
2020-10-13;;Africa;7834;271;1592517;38572
2020-10-14;;Africa;11508;263;1604025;38835
2020-10-15;;Africa;9116;254;1613141;39089
2020-10-16;;Africa;10686;207;1623827;39296
2020-10-17;;Africa;14262;265;1638089;39561
2020-10-18;;Africa;8193;185;1646282;39746
2020-10-19;;Africa;9688;184;1655970;39930
2020-10-20;;Africa;9776;298;1665746;40228
2020-10-21;;Africa;10478;252;1676224;40480
2020-10-22;;Africa;10970;216;1687194;40696
2020-10-23;;Africa;10435;224;1697629;40920
2020-10-24;;Africa;11739;223;1709368;41143
2020-10-25;;Africa;9094;116;1718462;41259
2020-10-26;;Africa;10718;348;1729180;41607
2020-10-27;;Africa;8650;182;1737830;41789
2020-10-28;;Africa;11900;346;1749730;42135
2020-10-29;;Africa;11071;202;1760801;42337
2020-10-30;;Africa;13599;292;1774400;42629
2020-10-31;;Africa;11074;224;1785474;42853
2020-11-01;;Africa;10296;322;1795770;43175
2020-11-02;;Africa;7586;214;1803356;43389
2020-11-03;;Africa;10874;316;1814230;43705
2020-11-04;;Africa;14002;235;1828232;43940
2020-11-05;;Africa;15393;304;1843625;44244
2020-11-06;;Africa;11720;223;1855345;44467
2020-11-07;;Africa;15017;378;1870362;44845
2020-11-08;;Africa;12498;515;1882860;45360
2020-11-09;;Africa;8889;249;1891749;45609
2020-11-10;;Africa;13173;341;1904922;45950
2020-11-11;;Africa;14000;332;1918922;46282
2020-11-12;;Africa;15781;269;1934703;46551
2020-11-13;;Africa;14678;280;1949381;46831
2020-11-14;;Africa;14071;235;1963452;47066
2020-11-15;;Africa;12570;296;1976022;47362
2020-11-16;;Africa;10304;279;1986326;47641
2020-11-17;;Africa;12868;393;1999194;48034
2020-11-18;;Africa;15301;392;2014495;48426
2020-11-19;;Africa;13934;276;2028429;48702
2020-11-20;;Africa;15733;412;2044162;49114
2020-11-21;;Africa;13356;314;2057518;49428
2020-11-22;;Africa;12779;290;2070297;49718
2020-11-23;;Africa;10077;269;2080374;49987
2020-11-24;;Africa;12503;344;2092877;50331
2020-11-25;;Africa;14667;316;2107544;50647
2020-11-26;;Africa;13923;297;2121467;50944
2020-11-27;;Africa;16039;320;2137506;51264
2020-11-28;;Africa;13396;235;2150902;51499
2020-11-29;;Africa;13071;224;2163973;51723
2020-11-30;;Africa;10350;269;2174323;51992
2020-12-01;;Africa;10838;258;2185161;52250
2020-12-02;;Africa;16413;330;2201574;52580
2020-12-03;;Africa;15701;267;2217275;52847
2020-12-04;;Africa;17982;430;2235257;53277
2020-12-05;;Africa;14702;287;2249959;53564
2020-12-06;;Africa;13463;306;2263422;53870
2020-12-07;;Africa;10628;248;2274050;54118
2020-12-08;;Africa;13258;402;2287308;54520
2020-12-09;;Africa;19396;350;2306704;54870
2020-12-10;;Africa;19134;394;2325838;55264
2020-12-11;;Africa;19081;398;2344919;55662
2020-12-12;;Africa;18133;326;2363052;55988
2020-12-13;;Africa;16222;346;2379274;56334
2020-12-14;;Africa;11318;311;2390592;56645
2020-12-15;;Africa;18002;427;2408594;57072
2020-12-16;;Africa;21225;346;2429819;57418
2020-12-17;;Africa;20508;396;2450327;57814
2020-12-18;;Africa;19320;496;2469647;58310
2020-12-19;;Africa;21260;449;2490907;58759
2020-12-20;;Africa;18426;340;2509333;59099
2020-12-21;;Africa;16781;429;2526114;59528
2020-12-22;;Africa;19986;529;2546100;60057
2020-12-23;;Africa;25729;820;2571829;60877
2020-12-24;;Africa;27044;554;2598873;61431
2020-12-25;;Africa;25785;524;2624658;61955
2020-12-26;;Africa;21381;419;2646039;62374
2020-12-27;;Africa;18675;432;2664714;62806
2020-12-28;;Africa;15211;545;2679925;63351
2020-12-29;;Africa;20128;717;2700053;64068
2020-12-30;;Africa;30617;701;2730670;64769
2020-12-31;;Africa;29789;699;2760459;65468
2021-01-01;;Africa;27708;658;2788167;66126
2021-01-02;;Africa;22919;515;2811086;66641
2021-01-03;;Africa;21990;605;2833076;67246
2021-01-04;;Africa;21792;685;2854868;67931
2021-01-05;;Africa;26847;820;2881715;68751
2021-01-06;;Africa;35792;1110;2917507;69861
2021-01-07;;Africa;35402;689;2952909;70550
2021-01-08;;Africa;36473;910;2989382;71460
2021-01-09;;Africa;35099;657;3024481;72117
2021-01-10;;Africa;31607;594;3056088;72711
2021-01-11;;Africa;28033;681;3084121;73392
2021-01-12;;Africa;26128;1076;3110249;74468
2021-01-13;;Africa;33997;1220;3144246;75688
2021-01-14;;Africa;34228;1053;3178474;76741
2021-01-15;;Africa;31575;905;3210049;77646
2021-01-16;;Africa;27568;663;3237617;78309
2021-01-17;;Africa;26569;598;3264186;78907
2021-01-18;;Africa;22476;725;3286662;79632
2021-01-19;;Africa;23410;1202;3310072;80834
2021-01-20;;Africa;28337;922;3338409;81756
2021-01-21;;Africa;27865;1025;3366274;82781
2021-01-22;;Africa;26179;974;3392453;83755
2021-01-23;;Africa;27308;782;3419761;84537
2021-01-24;;Africa;20120;647;3439881;85184
2021-01-25;;Africa;16695;771;3456576;85955
2021-01-26;;Africa;18598;983;3475174;86938
2021-01-27;;Africa;20827;1051;3496001;87989
2021-01-28;;Africa;20780;996;3516781;88985
2021-01-29;;Africa;19222;846;3536003;89831
2021-01-30;;Africa;17862;615;3553865;90446
2021-01-31;;Africa;15752;525;3569617;90971
2021-02-01;;Africa;12711;509;3582328;91480
2021-02-02;;Africa;14821;884;3597149;92364
2021-02-03;;Africa;15462;709;3612611;93073
2021-02-04;;Africa;16474;567;3629085;93640
2021-02-05;;Africa;15907;547;3644992;94187
2021-02-06;;Africa;13545;548;3658537;94735
2021-02-07;;Africa;11724;357;3670261;95092
2021-02-08;;Africa;11413;443;3681674;95535
2021-02-09;;Africa;11351;699;3693025;96234
2021-02-10;;Africa;13118;536;3706143;96770
2021-02-11;;Africa;11870;495;3718013;97265
2021-02-12;;Africa;13922;565;3731935;97830
2021-02-13;;Africa;10914;352;3742849;98182
2021-02-14;;Africa;10325;293;3753174;98475
2021-02-15;;Africa;9893;471;3763067;98946
2021-02-16;;Africa;10027;466;3773094;99412
2021-02-17;;Africa;12317;402;3785411;99814
2021-02-18;;Africa;13893;511;3799304;100325
2021-02-19;;Africa;11019;384;3810323;100709
2021-02-20;;Africa;9559;290;3819882;100999
2021-02-21;;Africa;9520;337;3829402;101336
2021-02-22;;Africa;9017;336;3838419;101672
2021-02-23;;Africa;7740;470;3846159;102142
2021-02-24;;Africa;10529;326;3856688;102468
2021-02-25;;Africa;12271;357;3868959;102825
2021-02-26;;Africa;11103;317;3880062;103142
2021-02-27;;Africa;7831;339;3887893;103481
2021-02-28;;Africa;9414;225;3897307;103706
2021-03-01;;Africa;8833;315;3906140;104021
2021-03-02;;Africa;7708;363;3913848;104384
2021-03-03;;Africa;10908;278;3924756;104662
2021-03-04;;Africa;12382;331;3937138;104993
2021-03-05;;Africa;8569;227;3945707;105220
2021-03-06;;Africa;9953;263;3955660;105483
2021-03-07;;Africa;8395;230;3964055;105713
2021-03-08;;Africa;9277;379;3973332;106092
2021-03-09;;Africa;7829;289;3981161;106381
2021-03-10;;Africa;10421;301;3991582;106682
2021-03-11;;Africa;15331;324;4006913;107006
2021-03-12;;Africa;9824;227;4016737;107233
2021-03-13;;Africa;10309;294;4027046;107527
2021-03-14;;Africa;8662;251;4035708;107778
2021-03-15;;Africa;8412;309;4044120;108087
2021-03-16;;Africa;8983;307;4053103;108394
2021-03-17;;Africa;11121;277;4064224;108671
2021-03-18;;Africa;11332;261;4075556;108932
2021-03-19;;Africa;12661;545;4088217;109477
2021-03-20;;Africa;9204;197;4097421;109674
2021-03-21;;Africa;9094;229;4106515;109903
2021-03-22;;Africa;9587;260;4116102;110163
2021-03-23;;Africa;8586;322;4124688;110485
2021-03-24;;Africa;10895;322;4135583;110807
2021-03-25;;Africa;12490;386;4148073;111193
2021-03-26;;Africa;18544;344;4166617;111537
2021-03-27;;Africa;9475;193;4176092;111730
2021-03-28;;Africa;9000;183;4185092;111913
2021-03-29;;Africa;9707;312;4194799;112225
2021-03-30;;Africa;9762;277;4204561;112502
2021-03-31;;Africa;12752;257;4217313;112759
2021-04-01;;Africa;22144;407;4239457;113166
2021-04-02;;Africa;13178;247;4252635;113413
2021-04-03;;Africa;8781;168;4261416;113581
2021-04-04;;Africa;9503;272;4270919;113853
2021-04-05;;Africa;9254;230;4280173;114083
2021-04-06;;Africa;9576;236;4289749;114319
2021-04-07;;Africa;11674;267;4301423;114586
2021-04-08;;Africa;16829;351;4318252;114937
2021-04-09;;Africa;12541;262;4330793;115199
2021-04-10;;Africa;9721;223;4340514;115422
2021-04-11;;Africa;9684;288;4350198;115710
2021-04-12;;Africa;10189;264;4360387;115974
2021-04-13;;Africa;9910;404;4370297;116378
2021-04-14;;Africa;13920;368;4384217;116746
2021-04-15;;Africa;12707;313;4396924;117059
2021-04-16;;Africa;12029;307;4408953;117366
2021-04-17;;Africa;13363;280;4422316;117646
2021-04-18;;Africa;9324;252;4431640;117898
2021-04-19;;Africa;8753;299;4440393;118197
2021-04-20;;Africa;10111;411;4450504;118608
2021-04-21;;Africa;11867;311;4462371;118919
2021-04-22;;Africa;12579;308;4474950;119227
2021-04-23;;Africa;12104;377;4487054;119604
2021-04-24;;Africa;10153;237;4497207;119841
2021-04-25;;Africa;9537;291;4506744;120132
2021-04-26;;Africa;6797;295;4513541;120427
2021-04-27;;Africa;9516;366;4523057;120793
2021-04-28;;Africa;9524;340;4532581;121133
2021-04-29;;Africa;15599;396;4548180;121529
2021-04-30;;Africa;9519;255;4557699;121784
2021-05-01;;Africa;7849;284;4565548;122068
2021-05-02;;Africa;6049;229;4571597;122297
2021-05-03;;Africa;7255;257;4578852;122554
2021-05-04;;Africa;7181;335;4586033;122889
2021-05-05;;Africa;9276;344;4595309;123233
2021-05-06;;Africa;12790;383;4608099;123616
2021-05-07;;Africa;8898;289;4616997;123905
2021-05-08;;Africa;6007;232;4623004;124137
2021-05-09;;Africa;9502;257;4632506;124394
2021-05-10;;Africa;8543;351;4641049;124745
2021-05-11;;Africa;7067;314;4648116;125059
2021-05-12;;Africa;8863;304;4656979;125363
2021-05-13;;Africa;9443;234;4666422;125597
2021-05-14;;Africa;8001;251;4674423;125848
2021-05-15;;Africa;6802;240;4681225;126088
2021-05-16;;Africa;6934;223;4688159;126311
2021-05-17;;Africa;7833;261;4695992;126572
2021-05-18;;Africa;10533;317;4706525;126889
2021-05-19;;Africa;9971;355;4716496;127244
2021-05-20;;Africa;11393;370;4727889;127614
2021-05-21;;Africa;10067;369;4737956;127983
2021-05-22;;Africa;9853;209;4747809;128192
2021-05-23;;Africa;8139;201;4755948;128393
2021-05-24;;Africa;9260;284;4765208;128677
2021-05-25;;Africa;5825;279;4771033;128956
2021-05-26;;Africa;14071;303;4785104;129259
2021-05-27;;Africa;11871;292;4796975;129551
2021-05-28;;Africa;12340;300;4809315;129851
2021-05-29;;Africa;11710;253;4821025;130104
2021-05-30;;Africa;5866;200;4826891;130304
2021-05-31;;Africa;13569;332;4840460;130636
2021-06-01;;Africa;10002;320;4850462;130956
2021-06-02;;Africa;13716;311;4864178;131267
2021-06-03;;Africa;14622;249;4878800;131516
2021-06-04;;Africa;15358;278;4894158;131794
2021-06-05;;Africa;12553;258;4906711;132052
2021-06-06;;Africa;12686;248;4919397;132300
2021-06-07;;Africa;11558;284;4930955;132584
2021-06-08;;Africa;12862;412;4943817;132996
2021-06-09;;Africa;18502;364;4962319;133360
2021-06-10;;Africa;21449;318;4983768;133678
2021-06-11;;Africa;20362;385;5004130;134063
2021-06-12;;Africa;20532;328;5024662;134391
2021-06-13;;Africa;16720;271;5041382;134662
2021-06-14;;Africa;16222;341;5057604;135003
2021-06-15;;Africa;19740;475;5077344;135478
2021-06-16;;Africa;26301;415;5103645;135893
2021-06-17;;Africa;27410;381;5131055;136274
2021-06-18;;Africa;23941;391;5154996;136665
2021-06-19;;Africa;23524;416;5178520;137081
2021-06-20;;Africa;23056;380;5201576;137461
2021-06-21;;Africa;23523;493;5225099;137954
2021-06-22;;Africa;23048;635;5248147;138589
2021-06-23;;Africa;32962;516;5281109;139105
2021-06-24;;Africa;33699;534;5314808;139639
2021-06-25;;Africa;35523;534;5350331;140173
2021-06-26;;Africa;34372;490;5384703;140663
2021-06-27;;Africa;27555;455;5412258;141118
2021-06-28;;Africa;25147;531;5437405;141649
2021-06-29;;Africa;28347;522;5465752;142171
2021-06-30;;Africa;38797;777;5504549;142948
2021-07-01;;Africa;42866;792;5547415;143740
2020-02-25;AL;Albania;0;0;0;0
2020-02-26;AL;Albania;0;0;0;0
2020-02-27;AL;Albania;0;0;0;0
2020-02-28;AL;Albania;0;0;0;0
2020-02-29;AL;Albania;0;0;0;0
2020-03-01;AL;Albania;0;0;0;0
2020-03-02;AL;Albania;0;0;0;0
2020-03-03;AL;Albania;0;0;0;0
2020-03-04;AL;Albania;0;0;0;0
2020-03-05;AL;Albania;0;0;0;0
2020-03-06;AL;Albania;0;0;0;0
2020-03-07;AL;Albania;0;0;0;0
2020-03-08;AL;Albania;0;0;0;0
2020-03-09;AL;Albania;2;0;2;0
2020-03-10;AL;Albania;8;0;10;0
2020-03-11;AL;Albania;2;1;12;1
2020-03-12;AL;Albania;11;0;23;1
2020-03-13;AL;Albania;10;0;33;1
2020-03-14;AL;Albania;5;0;38;1
2020-03-15;AL;Albania;4;0;42;1
2020-03-16;AL;Albania;9;0;51;1
2020-03-17;AL;Albania;4;0;55;1
2020-03-18;AL;Albania;4;1;59;2
2020-03-19;AL;Albania;5;0;64;2
2020-03-20;AL;Albania;6;0;70;2
2020-03-21;AL;Albania;6;0;76;2
2020-03-22;AL;Albania;13;0;89;2
2020-03-23;AL;Albania;15;2;104;4
2020-03-24;AL;Albania;19;1;123;5
2020-03-25;AL;Albania;23;0;146;5
2020-03-26;AL;Albania;28;1;174;6
2020-03-27;AL;Albania;12;2;186;8
2020-03-28;AL;Albania;11;2;197;10
2020-03-29;AL;Albania;15;0;212;10
2020-03-30;AL;Albania;11;1;223;11
2020-03-31;AL;Albania;20;4;243;15
2020-04-01;AL;Albania;16;0;259;15
2020-04-02;AL;Albania;18;1;277;16
2020-04-03;AL;Albania;27;1;304;17
2020-04-04;AL;Albania;29;3;333;20
2020-04-05;AL;Albania;28;0;361;20
2020-04-06;AL;Albania;16;1;377;21
2020-04-07;AL;Albania;6;1;383;22
2020-04-08;AL;Albania;17;0;400;22
2020-04-09;AL;Albania;9;1;409;23
2020-04-10;AL;Albania;7;0;416;23
2020-04-11;AL;Albania;17;0;433;23
2020-04-12;AL;Albania;13;0;446;23
2020-04-13;AL;Albania;21;0;467;23
2020-04-14;AL;Albania;8;1;475;24
2020-04-15;AL;Albania;19;1;494;25
2020-04-16;AL;Albania;24;1;518;26
2020-04-17;AL;Albania;21;0;539;26
2020-04-18;AL;Albania;9;0;548;26
2020-04-19;AL;Albania;14;0;562;26
2020-04-20;AL;Albania;22;0;584;26
2020-04-21;AL;Albania;25;0;609;26
2020-04-22;AL;Albania;25;1;634;27
2020-04-23;AL;Albania;29;0;663;27
2020-04-24;AL;Albania;15;0;678;27
2020-04-25;AL;Albania;34;0;712;27
2020-04-26;AL;Albania;14;1;726;28
2020-04-27;AL;Albania;10;0;736;28
2020-04-28;AL;Albania;14;2;750;30
2020-04-29;AL;Albania;16;0;766;30
2020-04-30;AL;Albania;7;1;773;31
2020-05-01;AL;Albania;9;0;782;31
2020-05-02;AL;Albania;7;0;789;31
2020-05-03;AL;Albania;6;0;795;31
2020-05-04;AL;Albania;8;0;803;31
2020-05-05;AL;Albania;17;0;820;31
2020-05-06;AL;Albania;12;0;832;31
2020-05-07;AL;Albania;10;0;842;31
2020-05-08;AL;Albania;8;0;850;31
2020-05-09;AL;Albania;6;0;856;31
2020-05-10;AL;Albania;12;0;868;31
2020-05-11;AL;Albania;4;0;872;31
2020-05-12;AL;Albania;4;0;876;31
2020-05-13;AL;Albania;4;0;880;31
2020-05-14;AL;Albania;18;0;898;31
2020-05-15;AL;Albania;18;0;916;31
2020-05-16;AL;Albania;17;0;933;31
2020-05-17;AL;Albania;13;0;946;31
2020-05-18;AL;Albania;2;0;948;31
2020-05-19;AL;Albania;1;0;949;31
2020-05-20;AL;Albania;15;0;964;31
2020-05-21;AL;Albania;5;0;969;31
2020-05-22;AL;Albania;12;0;981;31
2020-05-23;AL;Albania;8;0;989;31
2020-05-24;AL;Albania;9;1;998;32
2020-05-25;AL;Albania;6;0;1004;32
2020-05-26;AL;Albania;25;1;1029;33
2020-05-27;AL;Albania;21;0;1050;33
2020-05-28;AL;Albania;26;0;1076;33
2020-05-29;AL;Albania;23;0;1099;33
2020-05-30;AL;Albania;23;0;1122;33
2020-05-31;AL;Albania;15;0;1137;33
2020-06-01;AL;Albania;6;0;1143;33
2020-06-02;AL;Albania;21;0;1164;33
2020-06-03;AL;Albania;20;0;1184;33
2020-06-04;AL;Albania;13;0;1197;33
2020-06-05;AL;Albania;15;0;1212;33
2020-06-06;AL;Albania;20;1;1232;34
2020-06-07;AL;Albania;14;0;1246;34
2020-06-08;AL;Albania;17;0;1263;34
2020-06-09;AL;Albania;36;0;1299;34
2020-06-10;AL;Albania;42;0;1341;34
2020-06-11;AL;Albania;44;1;1385;35
2020-06-12;AL;Albania;31;1;1416;36
2020-06-13;AL;Albania;48;0;1464;36
2020-06-14;AL;Albania;57;0;1521;36
2020-06-15;AL;Albania;69;0;1590;36
2020-06-16;AL;Albania;82;1;1672;37
2020-06-17;AL;Albania;50;1;1722;38
2020-06-18;AL;Albania;66;1;1788;39
2020-06-19;AL;Albania;50;3;1838;42
2020-06-20;AL;Albania;53;1;1891;43
2020-06-21;AL;Albania;71;1;1962;44
2020-06-22;AL;Albania;33;0;1995;44
2020-06-23;AL;Albania;52;1;2047;45
2020-06-24;AL;Albania;67;2;2114;47
2020-06-25;AL;Albania;78;2;2192;49
2020-06-26;AL;Albania;77;2;2269;51
2020-06-27;AL;Albania;61;2;2330;53
2020-06-28;AL;Albania;72;2;2402;55
2020-06-29;AL;Albania;64;3;2466;58
2020-06-30;AL;Albania;69;4;2535;62
2020-07-01;AL;Albania;45;3;2580;65
2020-07-02;AL;Albania;82;4;2662;69
2020-07-03;AL;Albania;90;3;2752;72
2020-07-04;AL;Albania;67;2;2819;74
2020-07-05;AL;Albania;74;2;2893;76
2020-07-06;AL;Albania;71;3;2964;79
2020-07-07;AL;Albania;74;2;3038;81
2020-07-08;AL;Albania;68;2;3106;83
2020-07-09;AL;Albania;82;0;3188;83
2020-07-10;AL;Albania;90;2;3278;85
2020-07-11;AL;Albania;93;4;3371;89
2020-07-12;AL;Albania;83;4;3454;93
2020-07-13;AL;Albania;117;2;3571;95
2020-07-14;AL;Albania;96;2;3667;97
2020-07-15;AL;Albania;85;4;3752;101
2020-07-16;AL;Albania;99;3;3851;104
2020-07-17;AL;Albania;55;3;3906;107
2020-07-18;AL;Albania;102;4;4008;111
2020-07-19;AL;Albania;82;1;4090;112
2020-07-20;AL;Albania;81;1;4171;113
2020-07-21;AL;Albania;119;4;4290;117
2020-07-22;AL;Albania;68;3;4358;120
2020-07-23;AL;Albania;108;3;4466;123
2020-07-24;AL;Albania;104;5;4570;128
2020-07-25;AL;Albania;67;6;4637;134
2020-07-26;AL;Albania;126;4;4763;138
2020-07-27;AL;Albania;117;6;4880;144
2020-07-28;AL;Albania;117;4;4997;148
2020-07-29;AL;Albania;108;2;5105;150
2020-07-30;AL;Albania;92;4;5197;154
2020-07-31;AL;Albania;79;3;5276;157
2020-08-01;AL;Albania;120;4;5396;161
2020-08-02;AL;Albania;123;5;5519;166
2020-08-03;AL;Albania;101;6;5620;172
2020-08-04;AL;Albania;130;4;5750;176
2020-08-05;AL;Albania;139;6;5889;182
2020-08-06;AL;Albania;127;6;6016;188
2020-08-07;AL;Albania;135;1;6151;189
2020-08-08;AL;Albania;124;4;6275;193
2020-08-09;AL;Albania;136;6;6411;199
2020-08-10;AL;Albania;125;1;6536;200
2020-08-11;AL;Albania;140;5;6676;205
2020-08-12;AL;Albania;141;3;6817;208
2020-08-13;AL;Albania;154;5;6971;213
2020-08-14;AL;Albania;146;6;7117;219
2020-08-15;AL;Albania;143;6;7260;225
2020-08-16;AL;Albania;120;3;7380;228
2020-08-17;AL;Albania;119;2;7499;230
2020-08-18;AL;Albania;155;2;7654;232
2020-08-19;AL;Albania;158;2;7812;234
2020-08-20;AL;Albania;155;4;7967;238
2020-08-21;AL;Albania;152;2;8119;240
2020-08-22;AL;Albania;156;5;8275;245
2020-08-23;AL;Albania;152;5;8427;250
2020-08-24;AL;Albania;178;4;8605;254
2020-08-25;AL;Albania;154;5;8759;259
2020-08-26;AL;Albania;168;4;8927;263
2020-08-27;AL;Albania;156;3;9083;266
2020-08-28;AL;Albania;112;5;9195;271
2020-08-29;AL;Albania;84;4;9279;275
2020-08-30;AL;Albania;101;5;9380;280
2020-08-31;AL;Albania;133;4;9513;284
2020-09-01;AL;Albania;93;6;9606;290
2020-09-02;AL;Albania;122;6;9728;296
2020-09-03;AL;Albania;116;5;9844;301
2020-09-04;AL;Albania;123;5;9967;306
2020-09-05;AL;Albania;135;6;10102;312
2020-09-06;AL;Albania;153;4;10255;316
2020-09-07;AL;Albania;151;3;10406;319
2020-09-08;AL;Albania;147;2;10553;321
2020-09-09;AL;Albania;151;1;10704;322
2020-09-10;AL;Albania;156;2;10860;324
2020-09-11;AL;Albania;161;3;11021;327
2020-09-12;AL;Albania;164;3;11185;330
2020-09-13;AL;Albania;168;4;11353;334
2020-09-14;AL;Albania;167;4;11520;338
2020-09-15;AL;Albania;152;2;11672;340
2020-09-16;AL;Albania;144;3;11816;343
2020-09-17;AL;Albania;132;4;11948;347
2020-09-18;AL;Albania;125;6;12073;353
2020-09-19;AL;Albania;153;5;12226;358
2020-09-20;AL;Albania;159;4;12385;362
2020-09-21;AL;Albania;150;2;12535;364
2020-09-22;AL;Albania;131;3;12666;367
2020-09-23;AL;Albania;121;3;12787;370
2020-09-24;AL;Albania;134;0;12921;370
2020-09-25;AL;Albania;124;3;13045;373
2020-09-26;AL;Albania;108;2;13153;375
2020-09-27;AL;Albania;106;2;13259;377
2020-09-28;AL;Albania;132;3;13391;380
2020-09-29;AL;Albania;127;4;13518;384
2020-09-30;AL;Albania;131;3;13649;387
2020-10-01;AL;Albania;157;1;13806;388
2020-10-02;AL;Albania;159;1;13965;389
2020-10-03;AL;Albania;152;3;14117;392
2020-10-04;AL;Albania;149;4;14266;396
2020-10-05;AL;Albania;144;4;14410;400
2020-10-06;AL;Albania;158;3;14568;403
2020-10-07;AL;Albania;162;4;14730;407
2020-10-08;AL;Albania;169;4;14899;411
2020-10-09;AL;Albania;167;2;15066;413
2020-10-10;AL;Albania;165;3;15231;416
2020-10-11;AL;Albania;168;4;15399;420
2020-10-12;AL;Albania;171;4;15570;424
2020-10-13;AL;Albania;182;5;15752;429
2020-10-14;AL;Albania;203;5;15955;434
2020-10-15;AL;Albania;257;5;16212;439
2020-10-16;AL;Albania;289;4;16501;443
2020-10-17;AL;Albania;273;5;16774;448
2020-10-18;AL;Albania;281;3;17055;451
2020-10-19;AL;Albania;295;3;17350;454
2020-10-20;AL;Albania;301;4;17651;458
2020-10-21;AL;Albania;297;4;17948;462
2020-10-22;AL;Albania;302;3;18250;465
2020-10-23;AL;Albania;306;4;18556;469
2020-10-24;AL;Albania;302;4;18858;473
2020-10-25;AL;Albania;299;4;19157;477
2020-10-26;AL;Albania;288;3;19445;480
2020-10-27;AL;Albania;284;7;19729;487
2020-10-28;AL;Albania;311;6;20040;493
2020-10-29;AL;Albania;275;6;20315;499
2020-10-30;AL;Albania;319;3;20634;502
2020-10-31;AL;Albania;241;7;20875;509
2020-11-01;AL;Albania;327;9;21202;518
2020-11-02;AL;Albania;321;9;21523;527
2020-11-03;AL;Albania;381;5;21904;532
2020-11-04;AL;Albania;396;4;22300;536
2020-11-05;AL;Albania;421;7;22721;543
2020-11-06;AL;Albania;489;6;23210;549
2020-11-07;AL;Albania;495;8;23705;557
2020-11-08;AL;Albania;501;2;24206;559
2020-11-09;AL;Albania;525;12;24731;571
2020-11-10;AL;Albania;563;8;25294;579
2020-11-11;AL;Albania;507;11;25801;590
2020-11-12;AL;Albania;410;8;26211;598
2020-11-13;AL;Albania;490;7;26701;605
2020-11-14;AL;Albania;532;7;27233;612
2020-11-15;AL;Albania;597;11;27830;623
2020-11-16;AL;Albania;602;8;28432;631
2020-11-17;AL;Albania;694;6;29126;637
2020-11-18;AL;Albania;711;9;29837;646
2020-11-19;AL;Albania;786;11;30623;657
2020-11-20;AL;Albania;836;15;31459;672
2020-11-21;AL;Albania;737;13;32196;685
2020-11-22;AL;Albania;565;14;32761;699
2020-11-23;AL;Albania;795;17;33556;716
2020-11-24;AL;Albania;744;19;34300;735
2020-11-25;AL;Albania;644;8;34944;743
2020-11-26;AL;Albania;656;10;35600;753
2020-11-27;AL;Albania;645;18;36245;771
2020-11-28;AL;Albania;545;16;36790;787
2020-11-29;AL;Albania;835;11;37625;798
2020-11-30;AL;Albania;557;12;38182;810
2020-12-01;AL;Albania;832;12;39014;822
2020-12-02;AL;Albania;705;17;39719;839
2020-12-03;AL;Albania;782;13;40501;852
2020-12-04;AL;Albania;801;18;41302;870
2020-12-05;AL;Albania;846;19;42148;889
2020-12-06;AL;Albania;840;16;42988;905
2020-12-07;AL;Albania;695;17;43683;922
2020-12-08;AL;Albania;753;14;44436;936
2020-12-09;AL;Albania;752;15;45188;951
2020-12-10;AL;Albania;873;14;46061;965
2020-12-11;AL;Albania;802;12;46863;977
2020-12-12;AL;Albania;879;12;47742;989
2020-12-13;AL;Albania;788;14;48530;1003
2020-12-14;AL;Albania;661;13;49191;1016
2020-12-15;AL;Albania;809;12;50000;1028
2020-12-16;AL;Albania;637;12;50637;1040
2020-12-17;AL;Albania;787;15;51424;1055
2020-12-18;AL;Albania;580;11;52004;1066
2020-12-19;AL;Albania;538;8;52542;1074
2020-12-20;AL;Albania;461;14;53003;1088
2020-12-21;AL;Albania;422;10;53425;1098
2020-12-22;AL;Albania;389;13;53814;1111
2020-12-23;AL;Albania;503;6;54317;1117
2020-12-24;AL;Albania;510;8;54827;1125
2020-12-25;AL;Albania;553;9;55380;1134
2020-12-26;AL;Albania;375;9;55755;1143
2020-12-27;AL;Albania;499;10;56254;1153
2020-12-28;AL;Albania;318;11;56572;1164
2020-12-29;AL;Albania;574;6;57146;1170
2020-12-30;AL;Albania;581;4;57727;1174
2020-12-31;AL;Albania;589;7;58316;1181
2021-01-01;AL;Albania;0;0;58316;1181
2021-01-02;AL;Albania;675;9;58991;1190
2021-01-03;AL;Albania;447;3;59438;1193
2021-01-04;AL;Albania;185;6;59623;1199
2021-01-05;AL;Albania;660;11;60283;1210
2021-01-06;AL;Albania;725;7;61008;1217
2021-01-07;AL;Albania;697;6;61705;1223
2021-01-08;AL;Albania;673;7;62378;1230
2021-01-09;AL;Albania;655;3;63033;1233
2021-01-10;AL;Albania;562;8;63595;1241
2021-01-11;AL;Albania;376;6;63971;1247
2021-01-12;AL;Albania;656;5;64627;1252
2021-01-13;AL;Albania;707;4;65334;1256
2021-01-14;AL;Albania;660;5;65994;1261
2021-01-15;AL;Albania;641;4;66635;1265
2021-01-16;AL;Albania;581;5;67216;1270
2021-01-17;AL;Albania;474;7;67690;1277
2021-01-18;AL;Albania;292;4;67982;1281
2021-01-19;AL;Albania;586;6;68568;1287
2021-01-20;AL;Albania;670;4;69238;1291
2021-01-21;AL;Albania;678;5;69916;1296
2021-01-22;AL;Albania;739;7;70655;1303
2021-01-23;AL;Albania;786;7;71441;1310
2021-01-24;AL;Albania;833;5;72274;1315
2021-01-25;AL;Albania;538;9;72812;1324
2021-01-26;AL;Albania;879;8;73691;1332
2021-01-27;AL;Albania;876;7;74567;1339
2021-01-28;AL;Albania;887;11;75454;1350
2021-01-29;AL;Albania;896;8;76350;1358
2021-01-30;AL;Albania;901;11;77251;1369
2021-01-31;AL;Albania;876;11;78127;1380
2021-02-01;AL;Albania;865;13;78992;1393
2021-02-02;AL;Albania;942;5;79934;1398
2021-02-03;AL;Albania;1007;6;80941;1404
2021-02-04;AL;Albania;1052;14;81993;1418
2021-02-05;AL;Albania;1089;15;83082;1433
2021-02-06;AL;Albania;1130;13;84212;1446
2021-02-07;AL;Albania;1124;14;85336;1460
2021-02-08;AL;Albania;953;12;86289;1472
2021-02-09;AL;Albania;1239;16;87528;1488
2021-02-10;AL;Albania;1143;15;88671;1503
2021-02-11;AL;Albania;1105;14;89776;1517
2021-02-12;AL;Albania;1059;14;90835;1531
2021-02-13;AL;Albania;1152;12;91987;1543
2021-02-14;AL;Albania;1088;12;93075;1555
2021-02-15;AL;Albania;775;12;93850;1567
2021-02-16;AL;Albania;801;15;94651;1582
2021-02-17;AL;Albania;1075;18;95726;1600
2021-02-18;AL;Albania;1112;17;96838;1617
2021-02-19;AL;Albania;1071;19;97909;1636
2021-02-20;AL;Albania;1153;17;99062;1653
2021-02-21;AL;Albania;1184;13;100246;1666
2021-02-22;AL;Albania;1039;15;101285;1681
2021-02-23;AL;Albania;1021;15;102306;1696
2021-02-24;AL;Albania;1021;19;103327;1715
2021-02-25;AL;Albania;986;21;104313;1736
2021-02-26;AL;Albania;916;20;105229;1756
2021-02-27;AL;Albania;986;19;106215;1775
2021-02-28;AL;Albania;952;21;107167;1796
2021-03-01;AL;Albania;764;20;107931;1816
2021-03-02;AL;Albania;892;19;108823;1835
2021-03-03;AL;Albania;851;21;109674;1856
2021-03-04;AL;Albania;847;20;110521;1876
2021-03-05;AL;Albania;780;21;111301;1897
2021-03-06;AL;Albania;777;21;112078;1918
2021-03-07;AL;Albania;819;21;112897;1939
2021-03-08;AL;Albania;683;17;113580;1956
2021-03-09;AL;Albania;629;13;114209;1969
2021-03-10;AL;Albania;631;17;114840;1986
2021-03-11;AL;Albania;602;16;115442;2002
2021-03-12;AL;Albania;681;16;116123;2018
2021-03-13;AL;Albania;698;12;116821;2030
2021-03-14;AL;Albania;653;15;117474;2045
2021-03-15;AL;Albania;543;15;118017;2060
2021-03-16;AL;Albania;475;17;118492;2077
2021-03-17;AL;Albania;446;15;118938;2092
2021-03-18;AL;Albania;590;14;119528;2106
2021-03-19;AL;Albania;494;16;120022;2122
2021-03-20;AL;Albania;519;11;120541;2133
2021-03-21;AL;Albania;659;4;121200;2137
2021-03-22;AL;Albania;344;8;121544;2145
2021-03-23;AL;Albania;303;11;121847;2156
2021-03-24;AL;Albania;448;15;122295;2171
2021-03-25;AL;Albania;472;13;122767;2184
2021-03-26;AL;Albania;449;8;123216;2192
2021-03-27;AL;Albania;425;12;123641;2204
2021-03-28;AL;Albania;493;6;124134;2210
2021-03-29;AL;Albania;285;6;124419;2216
2021-03-30;AL;Albania;304;11;124723;2227
2021-03-31;AL;Albania;434;8;125157;2235
2021-04-01;AL;Albania;349;6;125506;2241
2021-04-02;AL;Albania;336;6;125842;2247
2021-04-03;AL;Albania;341;9;126183;2256
2021-04-04;AL;Albania;348;9;126531;2265
2021-04-05;AL;Albania;264;9;126795;2274
2021-04-06;AL;Albania;141;9;126936;2283
2021-04-07;AL;Albania;256;8;127192;2291
2021-04-08;AL;Albania;317;6;127509;2297
2021-04-09;AL;Albania;286;7;127795;2304
2021-04-10;AL;Albania;360;6;128155;2310
2021-04-11;AL;Albania;238;7;128393;2317
2021-04-12;AL;Albania;125;4;128518;2321
2021-04-13;AL;Albania;234;5;128752;2326
2021-04-14;AL;Albania;207;5;128959;2331
2021-04-15;AL;Albania;169;4;129128;2335
2021-04-16;AL;Albania;179;2;129307;2337
2021-04-17;AL;Albania;149;3;129456;2340
2021-04-18;AL;Albania;138;2;129594;2342
2021-04-19;AL;Albania;100;5;129694;2347
2021-04-20;AL;Albania;148;6;129842;2353
2021-04-21;AL;Albania;138;5;129980;2358
2021-04-22;AL;Albania;134;6;130114;2364
2021-04-23;AL;Albania;156;3;130270;2367
2021-04-24;AL;Albania;139;5;130409;2372
2021-04-25;AL;Albania;128;6;130537;2378
2021-04-26;AL;Albania;69;1;130606;2379
2021-04-27;AL;Albania;130;4;130736;2383
2021-04-28;AL;Albania;123;3;130859;2386
2021-04-29;AL;Albania;118;3;130977;2389
2021-04-30;AL;Albania;108;5;131085;2394
2021-05-01;AL;Albania;100;2;131185;2396
2021-05-02;AL;Albania;53;1;131238;2397
2021-05-03;AL;Albania;38;2;131276;2399
2021-05-04;AL;Albania;51;3;131327;2402
2021-05-05;AL;Albania;92;1;131419;2403
2021-05-06;AL;Albania;91;3;131510;2406
2021-05-07;AL;Albania;67;2;131577;2408
2021-05-08;AL;Albania;89;3;131666;2411
2021-05-09;AL;Albania;57;1;131723;2412
2021-05-10;AL;Albania;30;4;131753;2416
2021-05-11;AL;Albania;50;4;131803;2420
2021-05-12;AL;Albania;42;3;131845;2423
2021-05-13;AL;Albania;45;3;131890;2426
2021-05-14;AL;Albania;49;1;131939;2427
2021-05-15;AL;Albania;39;2;131978;2429
2021-05-16;AL;Albania;37;3;132015;2432
2021-05-17;AL;Albania;17;3;132032;2435
2021-05-18;AL;Albania;39;1;132071;2436
2021-05-19;AL;Albania;24;2;132095;2438
2021-05-20;AL;Albania;23;2;132118;2440
2021-05-21;AL;Albania;35;1;132153;2441
2021-05-22;AL;Albania;23;1;132176;2442
2021-05-23;AL;Albania;33;2;132209;2444
2021-05-24;AL;Albania;6;1;132215;2445
2021-05-25;AL;Albania;14;2;132229;2447
2021-05-26;AL;Albania;15;0;132244;2447
2021-05-27;AL;Albania;20;0;132264;2447
2021-05-28;AL;Albania;21;1;132285;2448
2021-05-29;AL;Albania;12;1;132297;2449
2021-05-30;AL;Albania;12;1;132309;2450
2021-05-31;AL;Albania;6;1;132315;2451
2021-06-01;AL;Albania;22;0;132337;2451
2021-06-02;AL;Albania;14;0;132351;2451
2021-06-03;AL;Albania;9;0;132360;2451
2021-06-04;AL;Albania;12;0;132372;2451
2021-06-05;AL;Albania;2;0;132374;2451
2021-06-06;AL;Albania;5;0;132379;2451
2021-06-07;AL;Albania;5;1;132384;2452
2021-06-08;AL;Albania;13;0;132397;2452
2021-06-09;AL;Albania;18;0;132415;2452
2021-06-10;AL;Albania;11;0;132426;2452
2021-06-11;AL;Albania;11;1;132437;2453
2021-06-12;AL;Albania;12;0;132449;2453
2021-06-13;AL;Albania;10;0;132459;2453
2021-06-14;AL;Albania;2;0;132461;2453
2021-06-15;AL;Albania;8;1;132469;2454
2021-06-16;AL;Albania;7;0;132476;2454
2021-06-17;AL;Albania;5;0;132481;2454
2021-06-18;AL;Albania;3;0;132484;2454
2021-06-19;AL;Albania;4;0;132488;2454
2021-06-20;AL;Albania;2;0;132490;2454
2021-06-21;AL;Albania;0;0;132490;2454
2021-06-22;AL;Albania;6;1;132496;2455
2021-06-23;AL;Albania;1;0;132497;2455
2021-06-24;AL;Albania;2;0;132499;2455
2021-06-25;AL;Albania;7;0;132506;2455
2021-06-26;AL;Albania;3;1;132509;2456
2021-06-27;AL;Albania;3;0;132512;2456
2021-06-28;AL;Albania;1;0;132513;2456
2021-06-29;AL;Albania;1;0;132514;2456
2021-06-30;AL;Albania;7;0;132521;2456
2021-07-01;AL;Albania;2;0;132523;2456
2020-02-25;DZ;Algeria;1;0;1;0
2020-02-26;DZ;Algeria;0;0;1;0
2020-02-27;DZ;Algeria;0;0;1;0
2020-02-28;DZ;Algeria;0;0;1;0
2020-02-29;DZ;Algeria;0;0;1;0
2020-03-01;DZ;Algeria;0;0;1;0
2020-03-02;DZ;Algeria;2;0;3;0
2020-03-03;DZ;Algeria;2;0;5;0
2020-03-04;DZ;Algeria;7;0;12;0
2020-03-05;DZ;Algeria;0;0;12;0
2020-03-06;DZ;Algeria;5;0;17;0
2020-03-07;DZ;Algeria;0;0;17;0
2020-03-08;DZ;Algeria;2;0;19;0
2020-03-09;DZ;Algeria;1;0;20;0
2020-03-10;DZ;Algeria;0;0;20;0
2020-03-11;DZ;Algeria;0;0;20;0
2020-03-12;DZ;Algeria;4;1;24;1
2020-03-13;DZ;Algeria;2;1;26;2
2020-03-14;DZ;Algeria;11;1;37;3
2020-03-15;DZ;Algeria;11;1;48;4
2020-03-16;DZ;Algeria;6;0;54;4
2020-03-17;DZ;Algeria;6;0;60;4
2020-03-18;DZ;Algeria;14;3;74;7
2020-03-19;DZ;Algeria;13;2;87;9
2020-03-20;DZ;Algeria;3;2;90;11
2020-03-21;DZ;Algeria;49;4;139;15
2020-03-22;DZ;Algeria;62;2;201;17
2020-03-23;DZ;Algeria;29;0;230;17
2020-03-24;DZ;Algeria;34;2;264;19
2020-03-25;DZ;Algeria;38;2;302;21
2020-03-26;DZ;Algeria;65;4;367;25
2020-03-27;DZ;Algeria;42;1;409;26
2020-03-28;DZ;Algeria;45;3;454;29
2020-03-29;DZ;Algeria;57;2;511;31
2020-03-30;DZ;Algeria;73;4;584;35
2020-03-31;DZ;Algeria;132;9;716;44
2020-04-01;DZ;Algeria;131;14;847;58
2020-04-02;DZ;Algeria;139;28;986;86
2020-04-03;DZ;Algeria;185;19;1171;105
2020-04-04;DZ;Algeria;80;25;1251;130
2020-04-05;DZ;Algeria;69;22;1320;152
2020-04-06;DZ;Algeria;103;21;1423;173
2020-04-07;DZ;Algeria;45;20;1468;193
2020-04-08;DZ;Algeria;104;12;1572;205
2020-04-09;DZ;Algeria;94;30;1666;235
2020-04-10;DZ;Algeria;95;21;1761;256
2020-04-11;DZ;Algeria;64;19;1825;275
2020-04-12;DZ;Algeria;89;18;1914;293
2020-04-13;DZ;Algeria;69;20;1983;313
2020-04-14;DZ;Algeria;87;13;2070;326
2020-04-15;DZ;Algeria;90;10;2160;336
2020-04-16;DZ;Algeria;108;12;2268;348
2020-04-17;DZ;Algeria;150;16;2418;364
2020-04-18;DZ;Algeria;116;3;2534;367
2020-04-19;DZ;Algeria;95;8;2629;375
2020-04-20;DZ;Algeria;89;9;2718;384
2020-04-21;DZ;Algeria;93;8;2811;392
2020-04-22;DZ;Algeria;99;10;2910;402
2020-04-23;DZ;Algeria;97;5;3007;407
2020-04-24;DZ;Algeria;120;8;3127;415
2020-04-25;DZ;Algeria;129;4;3256;419
2020-04-26;DZ;Algeria;126;6;3382;425
2020-04-27;DZ;Algeria;135;7;3517;432
2020-04-28;DZ;Algeria;132;5;3649;437
2020-04-29;DZ;Algeria;199;7;3848;444
2020-04-30;DZ;Algeria;158;6;4006;450
2020-05-01;DZ;Algeria;148;3;4154;453
2020-05-02;DZ;Algeria;141;6;4295;459
2020-05-03;DZ;Algeria;179;4;4474;463
2020-05-04;DZ;Algeria;174;2;4648;465
2020-05-05;DZ;Algeria;190;5;4838;470
2020-05-06;DZ;Algeria;159;6;4997;476
2020-05-07;DZ;Algeria;185;7;5182;483
2020-05-08;DZ;Algeria;187;5;5369;488
2020-05-09;DZ;Algeria;189;6;5558;494
2020-05-10;DZ;Algeria;165;8;5723;502
2020-05-11;DZ;Algeria;168;5;5891;507
2020-05-12;DZ;Algeria;176;8;6067;515
2020-05-13;DZ;Algeria;186;7;6253;522
2020-05-14;DZ;Algeria;189;7;6442;529
2020-05-15;DZ;Algeria;187;7;6629;536
2020-05-16;DZ;Algeria;192;6;6821;542
2020-05-17;DZ;Algeria;198;6;7019;548
2020-05-18;DZ;Algeria;182;7;7201;555
2020-05-19;DZ;Algeria;176;6;7377;561
2020-05-20;DZ;Algeria;165;7;7542;568
2020-05-21;DZ;Algeria;186;7;7728;575
2020-05-22;DZ;Algeria;190;7;7918;582
2020-05-23;DZ;Algeria;195;10;8113;592
2020-05-24;DZ;Algeria;193;8;8306;600
2020-05-25;DZ;Algeria;197;9;8503;609
2020-05-26;DZ;Algeria;194;8;8697;617
2020-05-27;DZ;Algeria;160;6;8857;623
2020-05-28;DZ;Algeria;140;7;8997;630
2020-05-29;DZ;Algeria;137;8;9134;638
2020-05-30;DZ;Algeria;133;8;9267;646
2020-05-31;DZ;Algeria;127;7;9394;653
2020-06-01;DZ;Algeria;119;8;9513;661
2020-06-02;DZ;Algeria;113;6;9626;667
2020-06-03;DZ;Algeria;107;6;9733;673
2020-06-04;DZ;Algeria;98;8;9831;681
2020-06-05;DZ;Algeria;104;9;9935;690
2020-06-06;DZ;Algeria;115;8;10050;698
2020-06-07;DZ;Algeria;104;9;10154;707
2020-06-08;DZ;Algeria;111;8;10265;715
2020-06-09;DZ;Algeria;117;9;10382;724
2020-06-10;DZ;Algeria;102;8;10484;732
2020-06-11;DZ;Algeria;105;9;10589;741
2020-06-12;DZ;Algeria;109;10;10698;751
2020-06-13;DZ;Algeria;112;9;10810;760
2020-06-14;DZ;Algeria;109;7;10919;767
2020-06-15;DZ;Algeria;112;10;11031;777
2020-06-16;DZ;Algeria;116;11;11147;788
2020-06-17;DZ;Algeria;121;11;11268;799
2020-06-18;DZ;Algeria;117;12;11385;811
2020-06-19;DZ;Algeria;119;14;11504;825
2020-06-20;DZ;Algeria;127;12;11631;837
2020-06-21;DZ;Algeria;140;8;11771;845
2020-06-22;DZ;Algeria;149;7;11920;852
2020-06-23;DZ;Algeria;156;9;12076;861
2020-06-24;DZ;Algeria;172;8;12248;869
2020-06-25;DZ;Algeria;197;9;12445;878
2020-06-26;DZ;Algeria;240;7;12685;885
2020-06-27;DZ;Algeria;283;7;12968;892
2020-06-28;DZ;Algeria;305;5;13273;897
2020-06-29;DZ;Algeria;298;8;13571;905
2020-06-30;DZ;Algeria;336;7;13907;912
2020-07-01;DZ;Algeria;365;8;14272;920
2020-07-02;DZ;Algeria;385;8;14657;928
2020-07-03;DZ;Algeria;413;9;15070;937
2020-07-04;DZ;Algeria;430;9;15500;946
2020-07-05;DZ;Algeria;441;6;15941;952
2020-07-06;DZ;Algeria;463;7;16404;959
2020-07-07;DZ;Algeria;475;9;16879;968
2020-07-08;DZ;Algeria;469;10;17348;978
2020-07-09;DZ;Algeria;460;10;17808;988
2020-07-10;DZ;Algeria;434;8;18242;996
2020-07-11;DZ;Algeria;470;8;18712;1004
2020-07-12;DZ;Algeria;483;7;19195;1011
2020-07-13;DZ;Algeria;494;7;19689;1018
2020-07-14;DZ;Algeria;527;10;20216;1028
2020-07-15;DZ;Algeria;554;12;20770;1040
2020-07-16;DZ;Algeria;585;12;21355;1052
2020-07-17;DZ;Algeria;593;5;21948;1057
2020-07-18;DZ;Algeria;601;11;22549;1068
2020-07-19;DZ;Algeria;535;10;23084;1078
2020-07-20;DZ;Algeria;607;9;23691;1087
2020-07-21;DZ;Algeria;587;13;24278;1100
2020-07-22;DZ;Algeria;594;11;24872;1111
2020-07-23;DZ;Algeria;612;13;25484;1124
2020-07-24;DZ;Algeria;675;12;26159;1136
2020-07-25;DZ;Algeria;605;10;26764;1146
2020-07-26;DZ;Algeria;593;9;27357;1155
2020-07-27;DZ;Algeria;616;8;27973;1163
2020-07-28;DZ;Algeria;642;11;28615;1174
2020-07-29;DZ;Algeria;614;12;29229;1186
2020-07-30;DZ;Algeria;602;14;29831;1200
2020-07-31;DZ;Algeria;563;10;30394;1210
2020-08-01;DZ;Algeria;556;13;30950;1223
2020-08-02;DZ;Algeria;515;8;31465;1231
2020-08-03;DZ;Algeria;507;8;31972;1239
2020-08-04;DZ;Algeria;532;9;32504;1248
2020-08-05;DZ;Algeria;551;13;33055;1261
2020-08-06;DZ;Algeria;571;12;33626;1273
2020-08-07;DZ;Algeria;529;9;34155;1282
2020-08-08;DZ;Algeria;538;11;34693;1293
2020-08-09;DZ;Algeria;467;9;35160;1302
2020-08-10;DZ;Algeria;552;10;35712;1312
2020-08-11;DZ;Algeria;492;10;36204;1322
2020-08-12;DZ;Algeria;495;11;36699;1333
2020-08-13;DZ;Algeria;488;8;37187;1341
2020-08-14;DZ;Algeria;477;10;37664;1351
2020-08-15;DZ;Algeria;469;9;38133;1360
2020-08-16;DZ;Algeria;450;10;38583;1370
2020-08-17;DZ;Algeria;442;9;39025;1379
2020-08-18;DZ;Algeria;419;12;39444;1391
2020-08-19;DZ;Algeria;403;11;39847;1402
2020-08-20;DZ;Algeria;411;9;40258;1411
2020-08-21;DZ;Algeria;409;7;40667;1418
2020-08-22;DZ;Algeria;401;6;41068;1424
2020-08-23;DZ;Algeria;392;11;41460;1435
2020-08-24;DZ;Algeria;398;11;41858;1446
2020-08-25;DZ;Algeria;370;10;42228;1456
2020-08-26;DZ;Algeria;391;9;42619;1465
2020-08-27;DZ;Algeria;397;10;43016;1475
2020-08-28;DZ;Algeria;387;8;43403;1483
2020-08-29;DZ;Algeria;378;8;43781;1491
2020-08-30;DZ;Algeria;365;10;44146;1501
2020-08-31;DZ;Algeria;348;9;44494;1510
2020-09-01;DZ;Algeria;339;8;44833;1518
2020-09-02;DZ;Algeria;325;5;45158;1523
2020-09-03;DZ;Algeria;311;6;45469;1529
2020-09-04;DZ;Algeria;304;10;45773;1539
2020-09-05;DZ;Algeria;298;10;46071;1549
2020-09-06;DZ;Algeria;293;7;46364;1556
2020-09-07;DZ;Algeria;289;6;46653;1562
2020-09-08;DZ;Algeria;285;9;46938;1571
2020-09-09;DZ;Algeria;278;10;47216;1581
2020-09-10;DZ;Algeria;272;10;47488;1591
2020-09-11;DZ;Algeria;264;8;47752;1599
2020-09-12;DZ;Algeria;255;6;48007;1605
2020-09-13;DZ;Algeria;247;7;48254;1612
2020-09-14;DZ;Algeria;242;8;48496;1620
2020-09-15;DZ;Algeria;238;12;48734;1632
2020-09-16;DZ;Algeria;232;13;48966;1645
2020-09-17;DZ;Algeria;228;9;49194;1654
2020-09-18;DZ;Algeria;219;5;49413;1659
2020-09-19;DZ;Algeria;210;6;49623;1665
2020-09-20;DZ;Algeria;203;7;49826;1672
2020-09-21;DZ;Algeria;197;7;50023;1679
2020-09-22;DZ;Algeria;191;10;50214;1689
2020-09-23;DZ;Algeria;186;9;50400;1698
2020-09-24;DZ;Algeria;179;5;50579;1703
2020-09-25;DZ;Algeria;175;4;50754;1707
2020-09-26;DZ;Algeria;160;4;50914;1711
2020-09-27;DZ;Algeria;153;3;51067;1714
2020-09-28;DZ;Algeria;146;5;51213;1719
2020-09-29;DZ;Algeria;155;7;51368;1726
2020-09-30;DZ;Algeria;162;10;51530;1736
2020-10-01;DZ;Algeria;160;5;51690;1741
2020-10-02;DZ;Algeria;157;8;51847;1749
2020-10-03;DZ;Algeria;148;7;51995;1756
2020-10-04;DZ;Algeria;141;4;52136;1760
2020-10-05;DZ;Algeria;134;8;52270;1768
2020-10-06;DZ;Algeria;129;0;52399;1768
2020-10-07;DZ;Algeria;121;3;52520;1771
2020-10-08;DZ;Algeria;138;12;52658;1783
2020-10-09;DZ;Algeria;146;6;52804;1789
2020-10-10;DZ;Algeria;136;6;52940;1795
2020-10-11;DZ;Algeria;132;6;53072;1801
2020-10-12;DZ;Algeria;253;8;53325;1809
2020-10-13;DZ;Algeria;74;9;53399;1818
2020-10-14;DZ;Algeria;185;9;53584;1827
2020-10-15;DZ;Algeria;193;0;53777;1827
2020-10-16;DZ;Algeria;221;14;53998;1841
2020-10-17;DZ;Algeria;205;5;54203;1846
2020-10-18;DZ;Algeria;199;10;54402;1856
2020-10-19;DZ;Algeria;214;9;54616;1865
2020-10-20;DZ;Algeria;213;8;54829;1873
2020-10-21;DZ;Algeria;252;7;55081;1880
2020-10-22;DZ;Algeria;276;8;55357;1888
2020-10-23;DZ;Algeria;273;9;55630;1897
2020-10-24;DZ;Algeria;250;10;55880;1907
2020-10-25;DZ;Algeria;263;7;56143;1914
2020-10-26;DZ;Algeria;276;8;56419;1922
2020-10-27;DZ;Algeria;287;9;56706;1931
2020-10-28;DZ;Algeria;320;10;57026;1941
2020-10-29;DZ;Algeria;306;8;57332;1949
2020-10-30;DZ;Algeria;319;7;57651;1956
2020-10-31;DZ;Algeria;291;8;57942;1964
2020-11-01;DZ;Algeria;330;9;58272;1973
2020-11-02;DZ;Algeria;302;7;58574;1980
2020-11-03;DZ;Algeria;405;0;58979;1980
2020-11-04;DZ;Algeria;548;19;59527;1999
2020-11-05;DZ;Algeria;642;12;60169;2011
2020-11-06;DZ;Algeria;631;13;60800;2024
2020-11-07;DZ;Algeria;581;12;61381;2036
2020-11-08;DZ;Algeria;670;12;62051;2048
2020-11-09;DZ;Algeria;642;14;62693;2062
2020-11-10;DZ;Algeria;753;15;63446;2077
2020-11-11;DZ;Algeria;811;16;64257;2093
2020-11-12;DZ;Algeria;851;18;65108;2111
2020-11-13;DZ;Algeria;867;13;65975;2124
2020-11-14;DZ;Algeria;844;15;66819;2139
2020-11-15;DZ;Algeria;860;15;67679;2154
2020-11-16;DZ;Algeria;910;14;68589;2168
2020-11-17;DZ;Algeria;1002;18;69591;2186
2020-11-18;DZ;Algeria;1038;20;70629;2206
2020-11-19;DZ;Algeria;1023;18;71652;2224
2020-11-20;DZ;Algeria;1103;12;72755;2236
2020-11-21;DZ;Algeria;1019;19;73774;2255
2020-11-22;DZ;Algeria;1088;17;74862;2272
2020-11-23;DZ;Algeria;1005;22;75867;2294
2020-11-24;DZ;Algeria;1133;15;77000;2309
2020-11-25;DZ;Algeria;1025;20;78025;2329
2020-11-26;DZ;Algeria;1085;23;79110;2352
2020-11-27;DZ;Algeria;1058;20;80168;2372
2020-11-28;DZ;Algeria;1044;21;81212;2393
2020-11-29;DZ;Algeria;1009;17;82221;2410
2020-11-30;DZ;Algeria;978;21;83199;2431
2020-12-01;DZ;Algeria;953;16;84152;2447
2020-12-02;DZ;Algeria;932;17;85084;2464
2020-12-03;DZ;Algeria;843;16;85927;2480
2020-12-04;DZ;Algeria;803;12;86730;2492
2020-12-05;DZ;Algeria;772;9;87502;2501
2020-12-06;DZ;Algeria;750;15;88252;2516
2020-12-07;DZ;Algeria;573;11;88825;2527
2020-12-08;DZ;Algeria;591;12;89416;2539
2020-12-09;DZ;Algeria;598;15;90014;2554
2020-12-10;DZ;Algeria;565;10;90579;2564
2020-12-11;DZ;Algeria;542;11;91121;2575
2020-12-12;DZ;Algeria;517;9;91638;2584
2020-12-13;DZ;Algeria;464;12;92102;2596
2020-12-14;DZ;Algeria;495;13;92597;2609
2020-12-15;DZ;Algeria;468;14;93065;2623
2020-12-16;DZ;Algeria;442;8;93507;2631
2020-12-17;DZ;Algeria;426;9;93933;2640
2020-12-18;DZ;Algeria;438;7;94371;2647
2020-12-19;DZ;Algeria;410;12;94781;2659
2020-12-20;DZ;Algeria;422;7;95203;2666
2020-12-21;DZ;Algeria;456;9;95659;2675
2020-12-22;DZ;Algeria;410;12;96069;2687
2020-12-23;DZ;Algeria;480;9;96549;2696
2020-12-24;DZ;Algeria;458;9;97007;2705
2020-12-25;DZ;Algeria;434;11;97441;2716
2020-12-26;DZ;Algeria;416;6;97857;2722
2020-12-27;DZ;Algeria;392;6;98249;2728
2020-12-28;DZ;Algeria;382;9;98631;2737
2020-12-29;DZ;Algeria;357;8;98988;2745
2020-12-30;DZ;Algeria;323;6;99311;2751
2020-12-31;DZ;Algeria;299;5;99610;2756
2021-01-01;DZ;Algeria;287;6;99897;2762
2021-01-02;DZ;Algeria;262;7;100159;2769
2021-01-03;DZ;Algeria;249;3;100408;2772
2021-01-04;DZ;Algeria;237;5;100645;2777
2021-01-05;DZ;Algeria;228;5;100873;2782
2021-01-06;DZ;Algeria;247;4;101120;2786
2021-01-07;DZ;Algeria;262;6;101382;2792
2021-01-08;DZ;Algeria;275;6;101657;2798
2021-01-09;DZ;Algeria;256;5;101913;2803
2021-01-10;DZ;Algeria;231;4;102144;2807
2021-01-11;DZ;Algeria;225;5;102369;2812
2021-01-12;DZ;Algeria;272;4;102641;2816
2021-01-13;DZ;Algeria;219;3;102860;2819
2021-01-14;DZ;Algeria;267;3;103127;2822
2021-01-15;DZ;Algeria;254;5;103381;2827
2021-01-16;DZ;Algeria;230;4;103611;2831
2021-01-17;DZ;Algeria;222;5;103833;2836
2021-01-18;DZ;Algeria;259;4;104092;2840
2021-01-19;DZ;Algeria;249;3;104341;2843
2021-01-20;DZ;Algeria;265;6;104606;2849
2021-01-21;DZ;Algeria;246;4;104852;2853
2021-01-22;DZ;Algeria;272;3;105124;2856
2021-01-23;DZ;Algeria;245;5;105369;2861
2021-01-24;DZ;Algeria;227;2;105596;2863
2021-01-25;DZ;Algeria;258;3;105854;2866
2021-01-26;DZ;Algeria;243;5;106097;2871
2021-01-27;DZ;Algeria;262;6;106359;2877
2021-01-28;DZ;Algeria;251;4;106610;2881
2021-01-29;DZ;Algeria;277;3;106887;2884
2021-01-30;DZ;Algeria;235;4;107122;2888
2021-01-31;DZ;Algeria;217;3;107339;2891
2021-02-01;DZ;Algeria;239;3;107578;2894
2021-02-02;DZ;Algeria;263;4;107841;2898
2021-02-03;DZ;Algeria;275;2;108116;2900
2021-02-04;DZ;Algeria;265;4;108381;2904
2021-02-05;DZ;Algeria;248;5;108629;2909
2021-02-06;DZ;Algeria;0;0;108629;2909
2021-02-07;DZ;Algeria;459;5;109088;2914
2021-02-08;DZ;Algeria;225;4;109313;2918
2021-02-09;DZ;Algeria;246;6;109559;2924
2021-02-10;DZ;Algeria;223;2;109782;2926
2021-02-11;DZ;Algeria;267;4;110049;2930
2021-02-12;DZ;Algeria;254;2;110303;2932
2021-02-13;DZ;Algeria;210;3;110513;2935
2021-02-14;DZ;Algeria;198;4;110711;2939
2021-02-15;DZ;Algeria;183;4;110894;2943
2021-02-16;DZ;Algeria;175;2;111069;2945
2021-02-17;DZ;Algeria;178;2;111247;2947
2021-02-18;DZ;Algeria;171;3;111418;2950
2021-02-19;DZ;Algeria;182;4;111600;2954
2021-02-20;DZ;Algeria;164;4;111764;2958
2021-02-21;DZ;Algeria;153;3;111917;2961
2021-02-22;DZ;Algeria;177;3;112094;2964
2021-02-23;DZ;Algeria;185;3;112279;2967
2021-02-24;DZ;Algeria;182;3;112461;2970
2021-02-25;DZ;Algeria;161;3;112622;2973
2021-02-26;DZ;Algeria;183;4;112805;2977
2021-02-27;DZ;Algeria;155;2;112960;2979
2021-02-28;DZ;Algeria;132;4;113092;2983
2021-03-01;DZ;Algeria;163;4;113255;2987
2021-03-02;DZ;Algeria;175;4;113430;2991
2021-03-03;DZ;Algeria;163;5;113593;2996
2021-03-04;DZ;Algeria;168;6;113761;3002
2021-03-05;DZ;Algeria;187;5;113948;3007
2021-03-06;DZ;Algeria;156;3;114104;3010
2021-03-07;DZ;Algeria;130;3;114234;3013
2021-03-08;DZ;Algeria;148;5;114382;3018
2021-03-09;DZ;Algeria;161;4;114543;3022
2021-03-10;DZ;Algeria;138;4;114681;3026
2021-03-11;DZ;Algeria;170;2;114851;3028
2021-03-12;DZ;Algeria;157;3;115008;3031
2021-03-13;DZ;Algeria;135;3;115143;3034
2021-03-14;DZ;Algeria;122;2;115265;3036
2021-03-15;DZ;Algeria;145;4;115410;3040
2021-03-16;DZ;Algeria;130;5;115540;3045
2021-03-17;DZ;Algeria;148;3;115688;3048
2021-03-18;DZ;Algeria;154;3;115842;3051
2021-03-19;DZ;Algeria;128;2;115970;3053
2021-03-20;DZ;Algeria;96;2;116066;3055
2021-03-21;DZ;Algeria;91;2;116157;3057
2021-03-22;DZ;Algeria;98;4;116255;3061
2021-03-23;DZ;Algeria;94;5;116349;3066
2021-03-24;DZ;Algeria;89;3;116438;3069
2021-03-25;DZ;Algeria;105;2;116543;3071
2021-03-26;DZ;Algeria;114;3;116657;3074
2021-03-27;DZ;Algeria;93;3;116750;3077
2021-03-28;DZ;Algeria;86;3;116836;3080
2021-03-29;DZ;Algeria;110;4;116946;3084
2021-03-30;DZ;Algeria;115;5;117061;3089
2021-03-31;DZ;Algeria;131;4;117192;3093
2021-04-01;DZ;Algeria;112;3;117304;3096
2021-04-02;DZ;Algeria;125;3;117429;3099
2021-04-03;DZ;Algeria;95;3;117524;3102
2021-04-04;DZ;Algeria;98;3;117622;3105
2021-04-05;DZ;Algeria;117;3;117739;3108
2021-04-06;DZ;Algeria;140;4;117879;3112
2021-04-07;DZ;Algeria;125;4;118004;3116
2021-04-08;DZ;Algeria;112;3;118116;3119
2021-04-09;DZ;Algeria;135;4;118251;3123
2021-04-10;DZ;Algeria;127;3;118378;3126
2021-04-11;DZ;Algeria;138;4;118516;3130
2021-04-12;DZ;Algeria;129;4;118645;3134
2021-04-13;DZ;Algeria;154;3;118799;3137
2021-04-14;DZ;Algeria;176;4;118975;3141
2021-04-15;DZ;Algeria;167;3;119142;3144
2021-04-16;DZ;Algeria;181;4;119323;3148
2021-04-17;DZ;Algeria;163;4;119486;3152
2021-04-18;DZ;Algeria;156;3;119642;3155
2021-04-19;DZ;Algeria;163;5;119805;3160
2021-04-20;DZ;Algeria;187;5;119992;3165
2021-04-21;DZ;Algeria;182;7;120174;3172
2021-04-22;DZ;Algeria;189;9;120363;3181
2021-04-23;DZ;Algeria;199;9;120562;3190
2021-04-24;DZ;Algeria;174;8;120736;3198
2021-04-25;DZ;Algeria;186;9;120922;3207
2021-04-26;DZ;Algeria;190;10;121112;3217
2021-04-27;DZ;Algeria;232;8;121344;3225
2021-04-28;DZ;Algeria;236;9;121580;3234
2021-04-29;DZ;Algeria;286;10;121866;3244
2021-04-30;DZ;Algeria;242;9;122108;3253
2021-05-01;DZ;Algeria;203;8;122311;3261
2021-05-02;DZ;Algeria;211;9;122522;3270
2021-05-03;DZ;Algeria;195;10;122717;3280
2021-05-04;DZ;Algeria;282;9;122999;3289
2021-05-05;DZ;Algeria;273;10;123272;3299
2021-05-06;DZ;Algeria;201;8;123473;3307
2021-05-07;DZ;Algeria;219;8;123692;3315
2021-05-08;DZ;Algeria;208;6;123900;3321
2021-05-09;DZ;Algeria;204;7;124104;3328
2021-05-10;DZ;Algeria;184;7;124288;3335
2021-05-11;DZ;Algeria;195;8;124483;3343
2021-05-12;DZ;Algeria;199;7;124682;3350
2021-05-13;DZ;Algeria;207;5;124889;3355
2021-05-14;DZ;Algeria;170;5;125059;3360
2021-05-15;DZ;Algeria;135;6;125194;3366
2021-05-16;DZ;Algeria;117;8;125311;3374
2021-05-17;DZ;Algeria;174;7;125485;3381
2021-05-18;DZ;Algeria;208;7;125693;3388
2021-05-19;DZ;Algeria;203;7;125896;3395
2021-05-20;DZ;Algeria;260;6;126156;3401
2021-05-21;DZ;Algeria;278;4;126434;3405
2021-05-22;DZ;Algeria;217;6;126651;3411
2021-05-23;DZ;Algeria;209;7;126860;3418
2021-05-24;DZ;Algeria;247;8;127107;3426
2021-05-25;DZ;Algeria;254;7;127361;3433
2021-05-26;DZ;Algeria;285;7;127646;3440
2021-05-27;DZ;Algeria;280;8;127926;3448
2021-05-28;DZ;Algeria;272;7;128198;3455
2021-05-29;DZ;Algeria;258;5;128456;3460
2021-05-30;DZ;Algeria;269;5;128725;3465
2021-05-31;DZ;Algeria;188;7;128913;3472
2021-06-01;DZ;Algeria;305;8;129218;3480
2021-06-02;DZ;Algeria;422;10;129640;3490
2021-06-03;DZ;Algeria;336;7;129976;3497
2021-06-04;DZ;Algeria;385;7;130361;3504
2021-06-05;DZ;Algeria;320;6;130681;3510
2021-06-06;DZ;Algeria;277;8;130958;3518
2021-06-07;DZ;Algeria;325;9;131283;3527
2021-06-08;DZ;Algeria;364;10;131647;3537
2021-06-09;DZ;Algeria;387;7;132034;3544
2021-06-10;DZ;Algeria;321;8;132355;3552
2021-06-11;DZ;Algeria;372;8;132727;3560
2021-06-12;DZ;Algeria;343;5;133070;3565
2021-06-13;DZ;Algeria;318;6;133388;3571
2021-06-14;DZ;Algeria;354;8;133742;3579
2021-06-15;DZ;Algeria;373;9;134115;3588
2021-06-16;DZ;Algeria;343;10;134458;3598
2021-06-17;DZ;Algeria;382;7;134840;3605
2021-06-18;DZ;Algeria;379;10;135219;3615
2021-06-19;DZ;Algeria;367;9;135586;3624
2021-06-20;DZ;Algeria;235;7;135821;3631
2021-06-21;DZ;Algeria;473;10;136294;3641
2021-06-22;DZ;Algeria;385;9;136679;3650
2021-06-23;DZ;Algeria;370;10;137049;3660
2021-06-24;DZ;Algeria;354;9;137403;3669
2021-06-25;DZ;Algeria;369;9;137772;3678
2021-06-26;DZ;Algeria;341;7;138113;3685
2021-06-27;DZ;Algeria;352;8;138465;3693
2021-06-28;DZ;Algeria;375;6;138840;3699
2021-06-29;DZ;Algeria;389;9;139229;3708
2021-06-30;DZ;Algeria;397;8;139626;3716
2021-07-01;DZ;Algeria;449;10;140075;3726
2020-03-02;AD;Andorra;1;0;1;0
2020-03-03;AD;Andorra;0;0;1;0
2020-03-04;AD;Andorra;0;0;1;0
2020-03-05;AD;Andorra;0;0;1;0
2020-03-06;AD;Andorra;0;0;1;0
2020-03-07;AD;Andorra;0;0;1;0
2020-03-08;AD;Andorra;0;0;1;0
2020-03-09;AD;Andorra;0;0;1;0
2020-03-10;AD;Andorra;0;0;1;0
2020-03-11;AD;Andorra;0;0;1;0
2020-03-12;AD;Andorra;0;0;1;0
2020-03-13;AD;Andorra;0;0;1;0
2020-03-14;AD;Andorra;0;0;1;0
2020-03-15;AD;Andorra;0;0;1;0
2020-03-16;AD;Andorra;1;0;2;0
2020-03-17;AD;Andorra;37;0;39;0
2020-03-18;AD;Andorra;0;0;39;0
2020-03-19;AD;Andorra;14;0;53;0
2020-03-20;AD;Andorra;22;0;75;0
2020-03-21;AD;Andorra;13;0;88;0
2020-03-22;AD;Andorra;25;1;113;1
2020-03-23;AD;Andorra;20;0;133;1
2020-03-24;AD;Andorra;31;0;164;1
2020-03-25;AD;Andorra;24;0;188;1
2020-03-26;AD;Andorra;36;2;224;3
2020-03-27;AD;Andorra;43;0;267;3
2020-03-28;AD;Andorra;41;0;308;3
2020-03-29;AD;Andorra;26;3;334;6
2020-03-30;AD;Andorra;36;2;370;8
2020-03-31;AD;Andorra;6;4;376;12
2020-04-01;AD;Andorra;14;2;390;14
2020-04-02;AD;Andorra;38;1;428;15
2020-04-03;AD;Andorra;11;1;439;16
2020-04-04;AD;Andorra;27;1;466;17
2020-04-05;AD;Andorra;35;1;501;18
2020-04-06;AD;Andorra;24;3;525;21
2020-04-07;AD;Andorra;20;1;545;22
2020-04-08;AD;Andorra;19;1;564;23
2020-04-09;AD;Andorra;19;2;583;25
2020-04-10;AD;Andorra;18;1;601;26
2020-04-11;AD;Andorra;0;0;601;26
2020-04-12;AD;Andorra;37;3;638;29
2020-04-13;AD;Andorra;8;0;646;29
2020-04-14;AD;Andorra;13;2;659;31
2020-04-15;AD;Andorra;14;2;673;33
2020-04-16;AD;Andorra;0;0;673;33
2020-04-17;AD;Andorra;23;2;696;35
2020-04-18;AD;Andorra;8;0;704;35
2020-04-19;AD;Andorra;9;1;713;36
2020-04-20;AD;Andorra;4;1;717;37
2020-04-21;AD;Andorra;0;0;717;37
2020-04-22;AD;Andorra;6;0;723;37
2020-04-23;AD;Andorra;0;0;723;37
2020-04-24;AD;Andorra;8;3;731;40
2020-04-25;AD;Andorra;7;0;738;40
2020-04-26;AD;Andorra;0;0;738;40
2020-04-27;AD;Andorra;5;0;743;40
2020-04-28;AD;Andorra;0;1;743;41
2020-04-29;AD;Andorra;0;1;743;42
2020-04-30;AD;Andorra;2;0;745;42
2020-05-01;AD;Andorra;0;1;745;43
2020-05-02;AD;Andorra;2;1;747;44
2020-05-03;AD;Andorra;1;1;748;45
2020-05-04;AD;Andorra;2;0;750;45
2020-05-05;AD;Andorra;1;1;751;46
2020-05-06;AD;Andorra;0;0;751;46
2020-05-07;AD;Andorra;1;1;752;47
2020-05-08;AD;Andorra;0;0;752;47
2020-05-09;AD;Andorra;2;1;754;48
2020-05-10;AD;Andorra;1;0;755;48
2020-05-11;AD;Andorra;0;0;755;48
2020-05-12;AD;Andorra;3;0;758;48
2020-05-13;AD;Andorra;2;1;760;49
2020-05-14;AD;Andorra;1;0;761;49
2020-05-15;AD;Andorra;0;0;761;49
2020-05-16;AD;Andorra;0;2;761;51
2020-05-17;AD;Andorra;0;0;761;51
2020-05-18;AD;Andorra;0;0;761;51
2020-05-19;AD;Andorra;0;0;761;51
2020-05-20;AD;Andorra;1;0;762;51
2020-05-21;AD;Andorra;0;0;762;51
2020-05-22;AD;Andorra;0;0;762;51
2020-05-23;AD;Andorra;0;0;762;51
2020-05-24;AD;Andorra;0;0;762;51
2020-05-25;AD;Andorra;1;0;763;51
2020-05-26;AD;Andorra;0;0;763;51
2020-05-27;AD;Andorra;0;0;763;51
2020-05-28;AD;Andorra;0;0;763;51
2020-05-29;AD;Andorra;1;0;764;51
2020-05-30;AD;Andorra;0;0;764;51
2020-05-31;AD;Andorra;0;0;764;51
2020-06-01;AD;Andorra;1;0;765;51
2020-06-02;AD;Andorra;79;0;844;51
2020-06-03;AD;Andorra;7;0;851;51
2020-06-04;AD;Andorra;1;0;852;51
2020-06-05;AD;Andorra;0;0;852;51
2020-06-06;AD;Andorra;0;0;852;51
2020-06-07;AD;Andorra;0;0;852;51
2020-06-08;AD;Andorra;0;0;852;51
2020-06-09;AD;Andorra;0;0;852;51
2020-06-10;AD;Andorra;0;0;852;51
2020-06-11;AD;Andorra;0;0;852;51
2020-06-12;AD;Andorra;1;0;853;51
2020-06-13;AD;Andorra;0;0;853;51
2020-06-14;AD;Andorra;0;0;853;51
2020-06-15;AD;Andorra;0;0;853;51
2020-06-16;AD;Andorra;1;1;854;52
2020-06-17;AD;Andorra;0;0;854;52
2020-06-18;AD;Andorra;1;0;855;52
2020-06-19;AD;Andorra;0;0;855;52
2020-06-20;AD;Andorra;0;0;855;52
2020-06-21;AD;Andorra;0;0;855;52
2020-06-22;AD;Andorra;0;0;855;52
2020-06-23;AD;Andorra;0;0;855;52
2020-06-24;AD;Andorra;0;0;855;52
2020-06-25;AD;Andorra;0;0;855;52
2020-06-26;AD;Andorra;0;0;855;52
2020-06-27;AD;Andorra;0;0;855;52
2020-06-28;AD;Andorra;0;0;855;52
2020-06-29;AD;Andorra;0;0;855;52
2020-06-30;AD;Andorra;0;0;855;52
2020-07-01;AD;Andorra;0;0;855;52
2020-07-02;AD;Andorra;0;0;855;52
2020-07-03;AD;Andorra;0;0;855;52
2020-07-04;AD;Andorra;0;0;855;52
2020-07-05;AD;Andorra;0;0;855;52
2020-07-06;AD;Andorra;0;0;855;52
2020-07-07;AD;Andorra;0;0;855;52
2020-07-08;AD;Andorra;0;0;855;52
2020-07-09;AD;Andorra;0;0;855;52
2020-07-10;AD;Andorra;0;0;855;52
2020-07-11;AD;Andorra;0;0;855;52
2020-07-12;AD;Andorra;0;0;855;52
2020-07-13;AD;Andorra;3;0;858;52
2020-07-14;AD;Andorra;3;0;861;52
2020-07-15;AD;Andorra;1;0;862;52
2020-07-16;AD;Andorra;15;0;877;52
2020-07-17;AD;Andorra;3;0;880;52
2020-07-18;AD;Andorra;0;0;880;52
2020-07-19;AD;Andorra;0;0;880;52
2020-07-20;AD;Andorra;4;0;884;52
2020-07-21;AD;Andorra;0;0;884;52
2020-07-22;AD;Andorra;5;0;889;52
2020-07-23;AD;Andorra;0;0;889;52
2020-07-24;AD;Andorra;8;0;897;52
2020-07-25;AD;Andorra;0;0;897;52
2020-07-26;AD;Andorra;0;0;897;52
2020-07-27;AD;Andorra;10;0;907;52
2020-07-28;AD;Andorra;0;0;907;52
2020-07-29;AD;Andorra;11;0;918;52
2020-07-30;AD;Andorra;4;0;922;52
2020-07-31;AD;Andorra;3;0;925;52
2020-08-01;AD;Andorra;0;0;925;52
2020-08-02;AD;Andorra;0;0;925;52
2020-08-03;AD;Andorra;12;0;937;52
2020-08-04;AD;Andorra;2;0;939;52
2020-08-05;AD;Andorra;0;0;939;52
2020-08-06;AD;Andorra;5;0;944;52
2020-08-07;AD;Andorra;11;0;955;52
2020-08-08;AD;Andorra;0;0;955;52
2020-08-09;AD;Andorra;0;0;955;52
2020-08-10;AD;Andorra;8;0;963;52
2020-08-11;AD;Andorra;0;0;963;52
2020-08-12;AD;Andorra;14;1;977;53
2020-08-13;AD;Andorra;4;0;981;53
2020-08-14;AD;Andorra;8;0;989;53
2020-08-15;AD;Andorra;0;0;989;53
2020-08-16;AD;Andorra;0;0;989;53
2020-08-17;AD;Andorra;16;0;1005;53
2020-08-18;AD;Andorra;0;0;1005;53
2020-08-19;AD;Andorra;19;0;1024;53
2020-08-20;AD;Andorra;0;0;1024;53
2020-08-21;AD;Andorra;21;0;1045;53
2020-08-22;AD;Andorra;0;0;1045;53
2020-08-23;AD;Andorra;0;0;1045;53
2020-08-24;AD;Andorra;15;0;1060;53
2020-08-25;AD;Andorra;0;0;1060;53
2020-08-26;AD;Andorra;38;0;1098;53
2020-08-27;AD;Andorra;0;0;1098;53
2020-08-28;AD;Andorra;26;0;1124;53
2020-08-29;AD;Andorra;0;0;1124;53
2020-08-30;AD;Andorra;0;0;1124;53
2020-08-31;AD;Andorra;52;0;1176;53
2020-09-01;AD;Andorra;8;0;1184;53
2020-09-02;AD;Andorra;15;0;1199;53
2020-09-03;AD;Andorra;0;0;1199;53
2020-09-04;AD;Andorra;16;0;1215;53
2020-09-05;AD;Andorra;0;0;1215;53
2020-09-06;AD;Andorra;0;0;1215;53
2020-09-07;AD;Andorra;46;0;1261;53
2020-09-08;AD;Andorra;0;0;1261;53
2020-09-09;AD;Andorra;40;0;1301;53
2020-09-10;AD;Andorra;0;0;1301;53
2020-09-11;AD;Andorra;43;0;1344;53
2020-09-12;AD;Andorra;0;0;1344;53
2020-09-13;AD;Andorra;0;0;1344;53
2020-09-14;AD;Andorra;94;0;1438;53
2020-09-15;AD;Andorra;0;0;1438;53
2020-09-16;AD;Andorra;45;0;1483;53
2020-09-17;AD;Andorra;0;0;1483;53
2020-09-18;AD;Andorra;81;0;1564;53
2020-09-19;AD;Andorra;0;0;1564;53
2020-09-20;AD;Andorra;0;0;1564;53
2020-09-21;AD;Andorra;117;0;1681;53
2020-09-22;AD;Andorra;0;0;1681;53
2020-09-23;AD;Andorra;72;0;1753;53
2020-09-24;AD;Andorra;0;0;1753;53
2020-09-25;AD;Andorra;83;0;1836;53
2020-09-26;AD;Andorra;0;0;1836;53
2020-09-27;AD;Andorra;0;0;1836;53
2020-09-28;AD;Andorra;130;0;1966;53
2020-09-29;AD;Andorra;0;0;1966;53
2020-09-30;AD;Andorra;84;0;2050;53
2020-10-01;AD;Andorra;0;0;2050;53
2020-10-02;AD;Andorra;60;0;2110;53
2020-10-03;AD;Andorra;0;0;2110;53
2020-10-04;AD;Andorra;0;0;2110;53
2020-10-05;AD;Andorra;260;0;2370;53
2020-10-06;AD;Andorra;0;0;2370;53
2020-10-07;AD;Andorra;198;0;2568;53
2020-10-08;AD;Andorra;0;1;2568;54
2020-10-09;AD;Andorra;128;1;2696;55
2020-10-10;AD;Andorra;0;0;2696;55
2020-10-11;AD;Andorra;0;0;2696;55
2020-10-12;AD;Andorra;299;2;2995;57
2020-10-13;AD;Andorra;0;0;2995;57
2020-10-14;AD;Andorra;195;2;3190;59
2020-10-15;AD;Andorra;0;0;3190;59
2020-10-16;AD;Andorra;187;0;3377;59
2020-10-17;AD;Andorra;0;0;3377;59
2020-10-18;AD;Andorra;0;0;3377;59
2020-10-19;AD;Andorra;246;3;3623;62
2020-10-20;AD;Andorra;0;0;3623;62
2020-10-21;AD;Andorra;188;1;3811;63
2020-10-22;AD;Andorra;0;0;3811;63
2020-10-23;AD;Andorra;227;6;4038;69
2020-10-24;AD;Andorra;0;0;4038;69
2020-10-25;AD;Andorra;0;0;4038;69
2020-10-26;AD;Andorra;287;3;4325;72
2020-10-27;AD;Andorra;85;0;4410;72
2020-10-28;AD;Andorra;107;0;4517;72
2020-10-29;AD;Andorra;50;1;4567;73
2020-10-30;AD;Andorra;98;2;4665;75
2020-10-31;AD;Andorra;91;0;4756;75
2020-11-01;AD;Andorra;69;0;4825;75
2020-11-02;AD;Andorra;63;0;4888;75
2020-11-03;AD;Andorra;22;0;4910;75
2020-11-04;AD;Andorra;135;0;5045;75
2020-11-05;AD;Andorra;90;0;5135;75
2020-11-06;AD;Andorra;0;0;5135;75
2020-11-07;AD;Andorra;184;0;5319;75
2020-11-08;AD;Andorra;64;0;5383;75
2020-11-09;AD;Andorra;54;0;5437;75
2020-11-10;AD;Andorra;40;0;5477;75
2020-11-11;AD;Andorra;90;0;5567;75
2020-11-12;AD;Andorra;49;0;5616;75
2020-11-13;AD;Andorra;109;0;5725;75
2020-11-14;AD;Andorra;0;0;5725;75
2020-11-15;AD;Andorra;147;1;5872;76
2020-11-16;AD;Andorra;42;0;5914;76
2020-11-17;AD;Andorra;37;0;5951;76
2020-11-18;AD;Andorra;67;0;6018;76
2020-11-19;AD;Andorra;48;0;6066;76
2020-11-20;AD;Andorra;76;0;6142;76
2020-11-21;AD;Andorra;65;0;6207;76
2020-11-22;AD;Andorra;49;0;6256;76
2020-11-23;AD;Andorra;48;0;6304;76
2020-11-24;AD;Andorra;47;0;6351;76
2020-11-25;AD;Andorra;77;0;6428;76
2020-11-26;AD;Andorra;106;0;6534;76
2020-11-27;AD;Andorra;76;0;6610;76
2020-11-28;AD;Andorra;0;0;6610;76
2020-11-29;AD;Andorra;102;0;6712;76
2020-11-30;AD;Andorra;33;0;6745;76
2020-12-01;AD;Andorra;45;0;6790;76
2020-12-02;AD;Andorra;52;0;6842;76
2020-12-03;AD;Andorra;62;1;6904;77
2020-12-04;AD;Andorra;51;0;6955;77
2020-12-05;AD;Andorra;50;1;7005;78
2020-12-06;AD;Andorra;45;0;7050;78
2020-12-07;AD;Andorra;34;0;7084;78
2020-12-08;AD;Andorra;43;0;7127;78
2020-12-09;AD;Andorra;35;0;7162;78
2020-12-10;AD;Andorra;28;0;7190;78
2020-12-11;AD;Andorra;46;0;7236;78
2020-12-12;AD;Andorra;52;0;7288;78
2020-12-13;AD;Andorra;50;1;7338;79
2020-12-14;AD;Andorra;44;0;7382;79
2020-12-15;AD;Andorra;0;0;7382;79
2020-12-16;AD;Andorra;64;0;7446;79
2020-12-17;AD;Andorra;20;0;7466;79
2020-12-18;AD;Andorra;53;1;7519;80
2020-12-19;AD;Andorra;41;0;7560;80
2020-12-20;AD;Andorra;17;1;7577;81
2020-12-21;AD;Andorra;25;0;7602;81
2020-12-22;AD;Andorra;31;1;7633;82
2020-12-23;AD;Andorra;36;0;7669;82
2020-12-24;AD;Andorra;30;1;7699;83
2020-12-25;AD;Andorra;57;0;7756;83
2020-12-26;AD;Andorra;50;0;7806;83
2020-12-27;AD;Andorra;15;0;7821;83
2020-12-28;AD;Andorra;54;0;7875;83
2020-12-29;AD;Andorra;44;1;7919;84
2020-12-30;AD;Andorra;64;0;7983;84
2020-12-31;AD;Andorra;66;0;8049;84
2021-01-01;AD;Andorra;68;0;8117;84
2021-01-02;AD;Andorra;49;0;8166;84
2021-01-03;AD;Andorra;26;0;8192;84
2021-01-04;AD;Andorra;57;0;8249;84
2021-01-05;AD;Andorra;59;0;8308;84
2021-01-06;AD;Andorra;40;0;8348;84
2021-01-07;AD;Andorra;0;0;8348;84
2021-01-08;AD;Andorra;141;0;8489;84
2021-01-09;AD;Andorra;97;1;8586;85
2021-01-10;AD;Andorra;0;0;8586;85
2021-01-11;AD;Andorra;0;0;8586;85
2021-01-12;AD;Andorra;96;1;8682;86
2021-01-13;AD;Andorra;136;1;8818;87
2021-01-14;AD;Andorra;50;1;8868;88
2021-01-15;AD;Andorra;78;0;8946;88
2021-01-16;AD;Andorra;92;3;9038;91
2021-01-17;AD;Andorra;45;0;9083;91
2021-01-18;AD;Andorra;0;0;9083;91
2021-01-19;AD;Andorra;111;1;9194;92
2021-01-20;AD;Andorra;114;0;9308;92
2021-01-21;AD;Andorra;71;1;9379;93
2021-01-22;AD;Andorra;37;0;9416;93
2021-01-23;AD;Andorra;83;3;9499;96
2021-01-24;AD;Andorra;50;0;9549;96
2021-01-25;AD;Andorra;47;1;9596;97
2021-01-26;AD;Andorra;42;0;9638;97
2021-01-27;AD;Andorra;78;1;9716;98
2021-01-28;AD;Andorra;63;2;9779;100
2021-01-29;AD;Andorra;58;0;9837;100
2021-01-30;AD;Andorra;48;1;9885;101
2021-01-31;AD;Andorra;52;0;9937;101
2021-02-01;AD;Andorra;35;0;9972;101
2021-02-02;AD;Andorra;45;1;10017;102
2021-02-03;AD;Andorra;53;1;10070;103
2021-02-04;AD;Andorra;67;0;10137;103
2021-02-05;AD;Andorra;35;1;10172;104
2021-02-06;AD;Andorra;34;1;10206;105
2021-02-07;AD;Andorra;45;1;10251;106
2021-02-08;AD;Andorra;24;0;10275;106
2021-02-09;AD;Andorra;37;0;10312;106
2021-02-10;AD;Andorra;40;0;10352;106
2021-02-11;AD;Andorra;39;0;10391;106
2021-02-12;AD;Andorra;36;0;10427;106
2021-02-13;AD;Andorra;36;1;10463;107
2021-02-14;AD;Andorra;40;0;10503;107
2021-02-15;AD;Andorra;35;0;10538;107
2021-02-16;AD;Andorra;17;0;10555;107
2021-02-17;AD;Andorra;28;0;10583;107
2021-02-18;AD;Andorra;27;0;10610;107
2021-02-19;AD;Andorra;35;0;10645;107
2021-02-20;AD;Andorra;27;0;10672;107
2021-02-21;AD;Andorra;27;0;10699;107
2021-02-22;AD;Andorra;13;2;10712;109
2021-02-23;AD;Andorra;27;1;10739;110
2021-02-24;AD;Andorra;36;0;10775;110
2021-02-25;AD;Andorra;24;0;10799;110
2021-02-26;AD;Andorra;23;0;10822;110
2021-02-27;AD;Andorra;27;0;10849;110
2021-02-28;AD;Andorra;17;0;10866;110
2021-03-01;AD;Andorra;23;0;10889;110
2021-03-02;AD;Andorra;19;0;10908;110
2021-03-03;AD;Andorra;40;2;10948;112
2021-03-04;AD;Andorra;28;0;10976;112
2021-03-05;AD;Andorra;22;0;10998;112
2021-03-06;AD;Andorra;21;0;11019;112
2021-03-07;AD;Andorra;23;0;11042;112
2021-03-08;AD;Andorra;27;0;11069;112
2021-03-09;AD;Andorra;20;0;11089;112
2021-03-10;AD;Andorra;41;0;11130;112
2021-03-11;AD;Andorra;0;0;11130;112
2021-03-12;AD;Andorra;69;0;11199;112
2021-03-13;AD;Andorra;29;0;11228;112
2021-03-14;AD;Andorra;38;1;11266;113
2021-03-15;AD;Andorra;23;0;11289;113
2021-03-16;AD;Andorra;30;0;11319;113
2021-03-17;AD;Andorra;41;0;11360;113
2021-03-18;AD;Andorra;33;0;11393;113
2021-03-19;AD;Andorra;38;0;11431;113
2021-03-20;AD;Andorra;50;0;11481;113
2021-03-21;AD;Andorra;36;0;11517;113
2021-03-22;AD;Andorra;28;0;11545;113
2021-03-23;AD;Andorra;46;0;11591;113
2021-03-24;AD;Andorra;47;1;11638;114
2021-03-25;AD;Andorra;49;0;11687;114
2021-03-26;AD;Andorra;45;0;11732;114
2021-03-27;AD;Andorra;77;1;11809;115
2021-03-28;AD;Andorra;41;0;11850;115
2021-03-29;AD;Andorra;38;0;11888;115
2021-03-30;AD;Andorra;56;0;11944;115
2021-03-31;AD;Andorra;66;0;12010;115
2021-04-01;AD;Andorra;43;0;12053;115
2021-04-02;AD;Andorra;62;1;12115;116
2021-04-03;AD;Andorra;59;1;12174;117
2021-04-04;AD;Andorra;57;0;12231;117
2021-04-05;AD;Andorra;55;0;12286;117
2021-04-06;AD;Andorra;42;0;12328;117
2021-04-07;AD;Andorra;35;2;12363;119
2021-04-08;AD;Andorra;46;1;12409;120
2021-04-09;AD;Andorra;47;0;12456;120
2021-04-10;AD;Andorra;41;0;12497;120
2021-04-11;AD;Andorra;48;0;12545;120
2021-04-12;AD;Andorra;36;1;12581;121
2021-04-13;AD;Andorra;33;0;12614;121
2021-04-14;AD;Andorra;27;0;12641;121
2021-04-15;AD;Andorra;0;0;12641;121
2021-04-16;AD;Andorra;71;2;12712;123
2021-04-17;AD;Andorra;59;0;12771;123
2021-04-18;AD;Andorra;34;0;12805;123
2021-04-19;AD;Andorra;0;0;12805;123
2021-04-20;AD;Andorra;69;0;12874;123
2021-04-21;AD;Andorra;43;0;12917;123
2021-04-22;AD;Andorra;25;0;12942;123
2021-04-23;AD;Andorra;65;0;13007;123
2021-04-24;AD;Andorra;17;1;13024;124
2021-04-25;AD;Andorra;36;0;13060;124
2021-04-26;AD;Andorra;23;0;13083;124
2021-04-27;AD;Andorra;38;0;13121;124
2021-04-28;AD;Andorra;27;1;13148;125
2021-04-29;AD;Andorra;50;0;13198;125
2021-04-30;AD;Andorra;34;0;13232;125
2021-05-01;AD;Andorra;0;0;13232;125
2021-05-02;AD;Andorra;50;2;13282;127
2021-05-03;AD;Andorra;13;0;13295;127
2021-05-04;AD;Andorra;21;0;13316;127
2021-05-05;AD;Andorra;24;0;13340;127
2021-05-06;AD;Andorra;23;0;13363;127
2021-05-07;AD;Andorra;27;0;13390;127
2021-05-08;AD;Andorra;16;0;13406;127
2021-05-09;AD;Andorra;17;0;13423;127
2021-05-10;AD;Andorra;6;0;13429;127
2021-05-11;AD;Andorra;18;0;13447;127
2021-05-12;AD;Andorra;23;0;13470;127
2021-05-13;AD;Andorra;0;0;13470;127
2021-05-14;AD;Andorra;40;0;13510;127
2021-05-15;AD;Andorra;0;0;13510;127
2021-05-16;AD;Andorra;0;0;13510;127
2021-05-17;AD;Andorra;45;0;13555;127
2021-05-18;AD;Andorra;14;0;13569;127
2021-05-19;AD;Andorra;0;0;13569;127
2021-05-20;AD;Andorra;0;0;13569;127
2021-05-21;AD;Andorra;0;0;13569;127
2021-05-22;AD;Andorra;0;0;13569;127
2021-05-23;AD;Andorra;0;0;13569;127
2021-05-24;AD;Andorra;0;0;13569;127
2021-05-25;AD;Andorra;95;0;13664;127
2021-05-26;AD;Andorra;7;0;13671;127
2021-05-27;AD;Andorra;11;0;13682;127
2021-05-28;AD;Andorra;11;0;13693;127
2021-05-29;AD;Andorra;0;0;13693;127
2021-05-30;AD;Andorra;0;0;13693;127
2021-05-31;AD;Andorra;34;0;13727;127
2021-06-01;AD;Andorra;2;0;13729;127
2021-06-02;AD;Andorra;15;0;13744;127
2021-06-03;AD;Andorra;8;0;13752;127
2021-06-04;AD;Andorra;6;0;13758;127
2021-06-05;AD;Andorra;0;0;13758;127
2021-06-06;AD;Andorra;0;0;13758;127
2021-06-07;AD;Andorra;19;0;13777;127
2021-06-08;AD;Andorra;4;0;13781;127
2021-06-09;AD;Andorra;10;0;13791;127
2021-06-10;AD;Andorra;14;0;13805;127
2021-06-11;AD;Andorra;8;0;13813;127
2021-06-12;AD;Andorra;0;0;13813;127
2021-06-13;AD;Andorra;0;0;13813;127
2021-06-14;AD;Andorra;13;0;13826;127
2021-06-15;AD;Andorra;2;0;13828;127
2021-06-16;AD;Andorra;8;0;13836;127
2021-06-17;AD;Andorra;3;0;13839;127
2021-06-18;AD;Andorra;3;0;13842;127
2021-06-19;AD;Andorra;0;0;13842;127
2021-06-20;AD;Andorra;0;0;13842;127
2021-06-21;AD;Andorra;22;0;13864;127
2021-06-22;AD;Andorra;0;0;13864;127
2021-06-23;AD;Andorra;9;0;13873;127
2021-06-24;AD;Andorra;4;0;13877;127
2021-06-25;AD;Andorra;5;0;13882;127
2021-06-26;AD;Andorra;0;0;13882;127
2021-06-27;AD;Andorra;0;0;13882;127
2021-06-28;AD;Andorra;0;0;13882;127
2021-06-29;AD;Andorra;18;0;13900;127
2021-06-30;AD;Andorra;11;0;13911;127
2021-07-01;AD;Andorra;7;0;13918;127
2020-03-20;AO;Angola;1;0;1;0
2020-03-21;AO;Angola;1;0;2;0
2020-03-22;AO;Angola;0;0;2;0
2020-03-23;AO;Angola;1;0;3;0
2020-03-24;AO;Angola;0;0;3;0
2020-03-25;AO;Angola;0;0;3;0
2020-03-26;AO;Angola;1;0;4;0
2020-03-27;AO;Angola;0;0;4;0
2020-03-28;AO;Angola;1;0;5;0
2020-03-29;AO;Angola;2;2;7;2
2020-03-30;AO;Angola;0;0;7;2
2020-03-31;AO;Angola;0;0;7;2
2020-04-01;AO;Angola;1;0;8;2
2020-04-02;AO;Angola;0;0;8;2
2020-04-03;AO;Angola;0;0;8;2
2020-04-04;AO;Angola;2;0;10;2
2020-04-05;AO;Angola;4;0;14;2
2020-04-06;AO;Angola;2;0;16;2
2020-04-07;AO;Angola;1;0;17;2
2020-04-08;AO;Angola;2;0;19;2
2020-04-09;AO;Angola;0;0;19;2
2020-04-10;AO;Angola;0;0;19;2
2020-04-11;AO;Angola;0;0;19;2
2020-04-12;AO;Angola;0;0;19;2
2020-04-13;AO;Angola;0;0;19;2
2020-04-14;AO;Angola;0;0;19;2
2020-04-15;AO;Angola;0;0;19;2
2020-04-16;AO;Angola;0;0;19;2
2020-04-17;AO;Angola;0;0;19;2
2020-04-18;AO;Angola;5;0;24;2
2020-04-19;AO;Angola;0;0;24;2
2020-04-20;AO;Angola;0;0;24;2
2020-04-21;AO;Angola;0;0;24;2
2020-04-22;AO;Angola;1;0;25;2
2020-04-23;AO;Angola;0;0;25;2
2020-04-24;AO;Angola;0;0;25;2
2020-04-25;AO;Angola;0;0;25;2
2020-04-26;AO;Angola;1;0;26;2
2020-04-27;AO;Angola;1;0;27;2
2020-04-28;AO;Angola;0;0;27;2
2020-04-29;AO;Angola;0;0;27;2
2020-04-30;AO;Angola;0;0;27;2
2020-05-01;AO;Angola;3;0;30;2
2020-05-02;AO;Angola;5;0;35;2
2020-05-03;AO;Angola;0;0;35;2
2020-05-04;AO;Angola;0;0;35;2
2020-05-05;AO;Angola;1;0;36;2
2020-05-06;AO;Angola;0;0;36;2
2020-05-07;AO;Angola;0;0;36;2
2020-05-08;AO;Angola;7;0;43;2
2020-05-09;AO;Angola;0;0;43;2
2020-05-10;AO;Angola;2;0;45;2
2020-05-11;AO;Angola;0;0;45;2
2020-05-12;AO;Angola;0;0;45;2
2020-05-13;AO;Angola;0;0;45;2
2020-05-14;AO;Angola;3;0;48;2
2020-05-15;AO;Angola;0;0;48;2
2020-05-16;AO;Angola;0;0;48;2
2020-05-17;AO;Angola;0;0;48;2
2020-05-18;AO;Angola;2;1;50;3
2020-05-19;AO;Angola;2;0;52;3
2020-05-20;AO;Angola;0;0;52;3
2020-05-21;AO;Angola;6;0;58;3
2020-05-22;AO;Angola;2;0;60;3
2020-05-23;AO;Angola;1;1;61;4
2020-05-24;AO;Angola;8;0;69;4
2020-05-25;AO;Angola;1;0;70;4
2020-05-26;AO;Angola;0;0;70;4
2020-05-27;AO;Angola;1;0;71;4
2020-05-28;AO;Angola;3;0;74;4
2020-05-29;AO;Angola;7;0;81;4
2020-05-30;AO;Angola;3;0;84;4
2020-05-31;AO;Angola;2;0;86;4
2020-06-01;AO;Angola;0;0;86;4
2020-06-02;AO;Angola;0;0;86;4
2020-06-03;AO;Angola;0;0;86;4
2020-06-04;AO;Angola;0;0;86;4
2020-06-05;AO;Angola;0;0;86;4
2020-06-06;AO;Angola;2;0;88;4
2020-06-07;AO;Angola;3;0;91;4
2020-06-08;AO;Angola;1;0;92;4
2020-06-09;AO;Angola;4;0;96;4
2020-06-10;AO;Angola;17;0;113;4
2020-06-11;AO;Angola;5;1;118;5
2020-06-12;AO;Angola;12;0;130;5
2020-06-13;AO;Angola;8;1;138;6
2020-06-14;AO;Angola;2;0;140;6
2020-06-15;AO;Angola;2;0;142;6
2020-06-16;AO;Angola;6;0;148;6
2020-06-17;AO;Angola;7;1;155;7
2020-06-18;AO;Angola;11;1;166;8
2020-06-19;AO;Angola;6;0;172;8
2020-06-20;AO;Angola;4;1;176;9
2020-06-21;AO;Angola;7;0;183;9
2020-06-22;AO;Angola;3;1;186;10
2020-06-23;AO;Angola;3;0;189;10
2020-06-24;AO;Angola;8;0;197;10
2020-06-25;AO;Angola;15;0;212;10
2020-06-26;AO;Angola;0;0;212;10
2020-06-27;AO;Angola;47;0;259;10
2020-06-28;AO;Angola;8;1;267;11
2020-06-29;AO;Angola;9;0;276;11
2020-06-30;AO;Angola;8;2;284;13
2020-07-01;AO;Angola;7;2;291;15
2020-07-02;AO;Angola;24;2;315;17
2020-07-03;AO;Angola;13;1;328;18
2020-07-04;AO;Angola;18;1;346;19
2020-07-05;AO;Angola;0;0;346;19
2020-07-06;AO;Angola;0;0;346;19
2020-07-07;AO;Angola;40;2;386;21
2020-07-08;AO;Angola;0;0;386;21
2020-07-09;AO;Angola;10;1;396;22
2020-07-10;AO;Angola;62;1;458;23
2020-07-11;AO;Angola;4;0;462;23
2020-07-12;AO;Angola;44;3;506;26
2020-07-13;AO;Angola;19;0;525;26
2020-07-14;AO;Angola;16;0;541;26
2020-07-15;AO;Angola;35;1;576;27
2020-07-16;AO;Angola;31;1;607;28
2020-07-17;AO;Angola;31;1;638;29
2020-07-18;AO;Angola;49;0;687;29
2020-07-19;AO;Angola;18;0;705;29
2020-07-20;AO;Angola;44;0;749;29
2020-07-21;AO;Angola;30;1;779;30
2020-07-22;AO;Angola;33;3;812;33
2020-07-23;AO;Angola;39;0;851;33
2020-07-24;AO;Angola;29;2;880;35
2020-07-25;AO;Angola;36;4;916;39
2020-07-26;AO;Angola;16;1;932;40
2020-07-27;AO;Angola;18;1;950;41
2020-07-28;AO;Angola;50;6;1000;47
2020-07-29;AO;Angola;78;1;1078;48
2020-07-30;AO;Angola;31;3;1109;51
2020-07-31;AO;Angola;39;1;1148;52
2020-08-01;AO;Angola;16;2;1164;54
2020-08-02;AO;Angola;35;1;1199;55
2020-08-03;AO;Angola;81;3;1280;58
2020-08-04;AO;Angola;64;1;1344;59
2020-08-05;AO;Angola;51;3;1395;62
2020-08-06;AO;Angola;88;2;1483;64
2020-08-07;AO;Angola;55;3;1538;67
2020-08-08;AO;Angola;34;3;1572;70
2020-08-09;AO;Angola;100;5;1672;75
2020-08-10;AO;Angola;7;3;1679;78
2020-08-11;AO;Angola;56;2;1735;80
2020-08-12;AO;Angola;27;0;1762;80
2020-08-13;AO;Angola;53;0;1815;80
2020-08-14;AO;Angola;37;6;1852;86
2020-08-15;AO;Angola;27;0;1879;86
2020-08-16;AO;Angola;27;2;1906;88
2020-08-17;AO;Angola;29;0;1935;88
2020-08-18;AO;Angola;31;2;1966;90
2020-08-19;AO;Angola;49;2;2015;92
2020-08-20;AO;Angola;29;1;2044;93
2020-08-21;AO;Angola;24;1;2068;94
2020-08-22;AO;Angola;66;0;2134;94
2020-08-23;AO;Angola;37;2;2171;96
2020-08-24;AO;Angola;51;4;2222;100
2020-08-25;AO;Angola;61;2;2283;102
2020-08-26;AO;Angola;49;1;2332;103
2020-08-27;AO;Angola;83;2;2415;105
2020-08-28;AO;Angola;56;1;2471;106
2020-08-29;AO;Angola;80;1;2551;107
2020-08-30;AO;Angola;73;0;2624;107
2020-08-31;AO;Angola;30;1;2654;108
2020-09-01;AO;Angola;75;1;2729;109
2020-09-02;AO;Angola;48;3;2777;112
2020-09-03;AO;Angola;28;1;2805;113
2020-09-04;AO;Angola;71;2;2876;115
2020-09-05;AO;Angola;59;2;2935;117
2020-09-06;AO;Angola;30;0;2965;117
2020-09-07;AO;Angola;16;3;2981;120
2020-09-08;AO;Angola;52;4;3033;124
2020-09-09;AO;Angola;59;2;3092;126
2020-09-10;AO;Angola;125;4;3217;130
2020-09-11;AO;Angola;62;1;3279;131
2020-09-12;AO;Angola;56;1;3335;132
2020-09-13;AO;Angola;53;2;3388;134
2020-09-14;AO;Angola;51;2;3439;136
2020-09-15;AO;Angola;130;3;3569;139
2020-09-16;AO;Angola;106;4;3675;143
2020-09-17;AO;Angola;114;1;3789;144
2020-09-18;AO;Angola;59;3;3848;147
2020-09-19;AO;Angola;53;0;3901;147
2020-09-20;AO;Angola;90;5;3991;152
2020-09-21;AO;Angola;126;2;4117;154
2020-09-22;AO;Angola;119;1;4236;155
2020-09-23;AO;Angola;127;4;4363;159
2020-09-24;AO;Angola;112;3;4475;162
2020-09-25;AO;Angola;115;5;4590;167
2020-09-26;AO;Angola;82;4;4672;171
2020-09-27;AO;Angola;46;3;4718;174
2020-09-28;AO;Angola;79;2;4797;176
2020-09-29;AO;Angola;108;3;4905;179
2020-09-30;AO;Angola;67;4;4972;183
2020-10-01;AO;Angola;142;2;5114;185
2020-10-02;AO;Angola;97;4;5211;189
2020-10-03;AO;Angola;159;4;5370;193
2020-10-04;AO;Angola;32;2;5402;195
2020-10-05;AO;Angola;128;4;5530;199
2020-10-06;AO;Angola;195;12;5725;211
2020-10-07;AO;Angola;0;0;5725;211
2020-10-08;AO;Angola;233;-3;5958;208
2020-10-09;AO;Angola;73;4;6031;212
2020-10-10;AO;Angola;215;6;6246;218
2020-10-11;AO;Angola;120;0;6366;218
2020-10-12;AO;Angola;122;1;6488;219
2020-10-13;AO;Angola;192;3;6680;222
2020-10-14;AO;Angola;166;5;6846;227
2020-10-15;AO;Angola;250;1;7096;228
2020-10-16;AO;Angola;126;6;7222;234
2020-10-17;AO;Angola;240;7;7462;241
2020-10-18;AO;Angola;160;6;7622;247
2020-10-19;AO;Angola;207;1;7829;248
2020-10-20;AO;Angola;220;3;8049;251
2020-10-21;AO;Angola;289;4;8338;255
2020-10-22;AO;Angola;244;5;8582;260
2020-10-23;AO;Angola;247;5;8829;265
2020-10-24;AO;Angola;197;2;9026;267
2020-10-25;AO;Angola;355;1;9381;268
2020-10-26;AO;Angola;263;2;9644;270
2020-10-27;AO;Angola;227;1;9871;271
2020-10-28;AO;Angola;203;4;10074;275
2020-10-29;AO;Angola;195;0;10269;275
2020-10-30;AO;Angola;289;4;10558;279
2020-10-31;AO;Angola;247;5;10805;284
2020-11-01;AO;Angola;230;2;11035;286
2020-11-02;AO;Angola;193;3;11228;289
2020-11-03;AO;Angola;349;2;11577;291
2020-11-04;AO;Angola;236;5;11813;296
2020-11-05;AO;Angola;289;3;12102;299
2020-11-06;AO;Angola;121;1;12223;300
2020-11-07;AO;Angola;112;3;12335;303
2020-11-08;AO;Angola;98;4;12433;307
2020-11-09;AO;Angola;247;1;12680;308
2020-11-10;AO;Angola;136;0;12816;308
2020-11-11;AO;Angola;137;4;12953;312
2020-11-12;AO;Angola;100;3;13053;315
2020-11-13;AO;Angola;175;2;13228;317
2020-11-14;AO;Angola;146;5;13374;322
2020-11-15;AO;Angola;77;0;13451;322
2020-11-16;AO;Angola;164;2;13615;324
2020-11-17;AO;Angola;203;4;13818;328
2020-11-18;AO;Angola;104;4;13922;332
2020-11-19;AO;Angola;212;1;14134;333
2020-11-20;AO;Angola;133;1;14267;334
2020-11-21;AO;Angola;146;2;14413;336
2020-11-22;AO;Angola;80;1;14493;337
2020-11-23;AO;Angola;141;0;14634;337
2020-11-24;AO;Angola;108;1;14742;338
2020-11-25;AO;Angola;79;2;14821;340
2020-11-26;AO;Angola;99;1;14920;341
2020-11-27;AO;Angola;88;1;15008;342
2020-11-28;AO;Angola;79;3;15087;345
2020-11-29;AO;Angola;16;1;15103;346
2020-11-30;AO;Angola;36;2;15139;348
2020-12-01;AO;Angola;112;2;15251;350
2020-12-02;AO;Angola;68;1;15319;351
2020-12-03;AO;Angola;42;1;15361;352
2020-12-04;AO;Angola;132;1;15493;353
2020-12-05;AO;Angola;43;1;15536;354
2020-12-06;AO;Angola;55;0;15591;354
2020-12-07;AO;Angola;57;0;15648;354
2020-12-08;AO;Angola;81;1;15729;355
2020-12-09;AO;Angola;75;3;15804;358
2020-12-10;AO;Angola;121;4;15925;362
2020-12-11;AO;Angola;136;3;16061;365
2020-12-12;AO;Angola;100;1;16161;366
2020-12-13;AO;Angola;27;5;16188;371
2020-12-14;AO;Angola;89;1;16277;372
2020-12-15;AO;Angola;85;0;16362;372
2020-12-16;AO;Angola;45;7;16407;379
2020-12-17;AO;Angola;77;3;16484;382
2020-12-18;AO;Angola;78;2;16562;384
2020-12-19;AO;Angola;64;2;16626;386
2020-12-20;AO;Angola;18;1;16644;387
2020-12-21;AO;Angola;42;3;16686;390
2020-12-22;AO;Angola;116;3;16802;393
2020-12-23;AO;Angola;129;0;16931;393
2020-12-24;AO;Angola;98;0;17029;393
2020-12-25;AO;Angola;70;3;17099;396
2020-12-26;AO;Angola;50;3;17149;399
2020-12-27;AO;Angola;91;0;17240;399
2020-12-28;AO;Angola;56;4;17296;403
2020-12-29;AO;Angola;75;0;17371;403
2020-12-30;AO;Angola;62;2;17433;405
2020-12-31;AO;Angola;120;0;17553;405
2021-01-01;AO;Angola;15;0;17568;405
2021-01-02;AO;Angola;40;2;17608;407
2021-01-03;AO;Angola;34;1;17642;408
2021-01-04;AO;Angola;42;0;17684;408
2021-01-05;AO;Angola;72;2;17756;410
2021-01-06;AO;Angola;108;3;17864;413
2021-01-07;AO;Angola;110;0;17974;413
2021-01-08;AO;Angola;92;2;18066;415
2021-01-09;AO;Angola;90;1;18156;416
2021-01-10;AO;Angola;37;0;18193;416
2021-01-11;AO;Angola;61;4;18254;420
2021-01-12;AO;Angola;89;2;18343;422
2021-01-13;AO;Angola;82;2;18425;424
2021-01-14;AO;Angola;188;1;18613;425
2021-01-15;AO;Angola;66;3;18679;428
2021-01-16;AO;Angola;86;3;18765;431
2021-01-17;AO;Angola;110;5;18875;436
2021-01-18;AO;Angola;51;3;18926;439
2021-01-19;AO;Angola;85;3;19011;442
2021-01-20;AO;Angola;82;2;19093;444
2021-01-21;AO;Angola;84;4;19177;448
2021-01-22;AO;Angola;92;4;19269;452
2021-01-23;AO;Angola;98;5;19367;457
2021-01-24;AO;Angola;32;2;19399;459
2021-01-25;AO;Angola;77;2;19476;461
2021-01-26;AO;Angola;77;1;19553;462
2021-01-27;AO;Angola;27;0;19580;462
2021-01-28;AO;Angola;92;2;19672;464
2021-01-29;AO;Angola;51;0;19723;464
2021-01-30;AO;Angola;59;0;19782;464
2021-01-31;AO;Angola;14;2;19796;466
2021-02-01;AO;Angola;33;0;19829;466
2021-02-02;AO;Angola;71;2;19900;468
2021-02-03;AO;Angola;37;2;19937;470
2021-02-04;AO;Angola;59;3;19996;473
2021-02-05;AO;Angola;34;1;20030;474
2021-02-06;AO;Angola;32;1;20062;475
2021-02-07;AO;Angola;24;0;20086;475
2021-02-08;AO;Angola;26;0;20112;475
2021-02-09;AO;Angola;51;3;20163;478
2021-02-10;AO;Angola;47;9;20210;487
2021-02-11;AO;Angola;51;0;20261;487
2021-02-12;AO;Angola;33;3;20294;490
2021-02-13;AO;Angola;35;1;20329;491
2021-02-14;AO;Angola;37;1;20366;492
2021-02-15;AO;Angola;15;1;20381;493
2021-02-16;AO;Angola;8;1;20389;494
2021-02-17;AO;Angola;11;2;20400;496
2021-02-18;AO;Angola;52;2;20452;498
2021-02-19;AO;Angola;26;0;20478;498
2021-02-20;AO;Angola;21;0;20499;498
2021-02-21;AO;Angola;20;1;20519;499
2021-02-22;AO;Angola;29;0;20548;499
2021-02-23;AO;Angola;36;1;20584;500
2021-02-24;AO;Angola;56;1;20640;501
2021-02-25;AO;Angola;55;1;20695;502
2021-02-26;AO;Angola;64;2;20759;504
2021-02-27;AO;Angola;23;2;20782;506
2021-02-28;AO;Angola;25;2;20807;508
2021-03-01;AO;Angola;47;0;20854;508
2021-03-02;AO;Angola;28;2;20882;510
2021-03-03;AO;Angola;41;0;20923;510
2021-03-04;AO;Angola;58;1;20981;511
2021-03-05;AO;Angola;45;0;21026;511
2021-03-06;AO;Angola;29;1;21055;512
2021-03-07;AO;Angola;31;2;21086;514
2021-03-08;AO;Angola;22;1;21108;515
2021-03-09;AO;Angola;6;1;21114;516
2021-03-10;AO;Angola;47;0;21161;516
2021-03-11;AO;Angola;44;1;21205;517
2021-03-12;AO;Angola;60;2;21265;519
2021-03-13;AO;Angola;58;1;21323;520
2021-03-14;AO;Angola;57;1;21380;521
2021-03-15;AO;Angola;27;0;21407;521
2021-03-16;AO;Angola;39;1;21446;522
2021-03-17;AO;Angola;43;0;21489;522
2021-03-18;AO;Angola;69;0;21558;522
2021-03-19;AO;Angola;84;2;21642;524
2021-03-20;AO;Angola;54;2;21696;526
2021-03-21;AO;Angola;37;1;21733;527
2021-03-22;AO;Angola;24;3;21757;530
2021-03-23;AO;Angola;17;0;21774;530
2021-03-24;AO;Angola;62;2;21836;532
2021-03-25;AO;Angola;78;0;21914;532
2021-03-26;AO;Angola;47;0;21961;532
2021-03-27;AO;Angola;70;1;22031;533
2021-03-28;AO;Angola;32;0;22063;533
2021-03-29;AO;Angola;69;1;22132;534
2021-03-30;AO;Angola;50;2;22182;536
2021-03-31;AO;Angola;129;1;22311;537
2021-04-01;AO;Angola;88;1;22399;538
2021-04-02;AO;Angola;68;0;22467;538
2021-04-03;AO;Angola;112;2;22579;540
2021-04-04;AO;Angola;52;2;22631;542
2021-04-05;AO;Angola;86;1;22717;543
2021-04-06;AO;Angola;168;4;22885;547
2021-04-07;AO;Angola;125;0;23010;547
2021-04-08;AO;Angola;98;2;23108;549
2021-04-09;AO;Angola;134;0;23242;549
2021-04-10;AO;Angola;89;1;23331;550
2021-04-11;AO;Angola;126;3;23457;553
2021-04-12;AO;Angola;92;1;23549;554
2021-04-13;AO;Angola;148;0;23697;554
2021-04-14;AO;Angola;144;3;23841;557
2021-04-15;AO;Angola;110;0;23951;557
2021-04-16;AO;Angola;171;3;24122;560
2021-04-17;AO;Angola;178;1;24300;561
2021-04-18;AO;Angola;89;0;24389;561
2021-04-19;AO;Angola;129;2;24518;563
2021-04-20;AO;Angola;143;2;24661;565
2021-04-21;AO;Angola;222;5;24883;570
2021-04-22;AO;Angola;168;2;25051;572
2021-04-23;AO;Angola;228;2;25279;574
2021-04-24;AO;Angola;213;3;25492;577
2021-04-25;AO;Angola;117;2;25609;579
2021-04-26;AO;Angola;101;4;25710;583
2021-04-27;AO;Angola;232;4;25942;587
2021-04-28;AO;Angola;226;4;26168;591
2021-04-29;AO;Angola;263;3;26431;594
2021-04-30;AO;Angola;221;2;26652;596
2021-05-01;AO;Angola;163;4;26815;600
2021-05-02;AO;Angola;178;2;26993;602
2021-05-03;AO;Angola;140;1;27133;603
2021-05-04;AO;Angola;151;6;27284;609
2021-05-05;AO;Angola;245;9;27529;618
2021-05-06;AO;Angola;392;4;27921;622
2021-05-07;AO;Angola;280;6;28201;628
2021-05-08;AO;Angola;276;2;28477;630
2021-05-09;AO;Angola;263;3;28740;633
2021-05-10;AO;Angola;135;3;28875;636
2021-05-11;AO;Angola;271;3;29146;639
2021-05-12;AO;Angola;259;6;29405;645
2021-05-13;AO;Angola;290;4;29695;649
2021-05-14;AO;Angola;335;2;30030;651
2021-05-15;AO;Angola;324;4;30354;655
2021-05-16;AO;Angola;283;4;30637;659
2021-05-17;AO;Angola;150;18;30787;677
2021-05-18;AO;Angola;258;8;31045;685
2021-05-19;AO;Angola;393;11;31438;696
2021-05-20;AO;Angola;223;8;31661;704
2021-05-21;AO;Angola;248;5;31909;709
2021-05-22;AO;Angola;240;6;32149;715
2021-05-23;AO;Angola;292;10;32441;725
2021-05-24;AO;Angola;182;6;32623;731
2021-05-25;AO;Angola;310;4;32933;735
2021-05-26;AO;Angola;405;7;33338;742
2021-05-27;AO;Angola;269;3;33607;745
2021-05-28;AO;Angola;337;4;33944;749
2021-05-29;AO;Angola;236;8;34180;757
2021-05-30;AO;Angola;186;7;34366;764
2021-05-31;AO;Angola;185;2;34551;766
2021-06-01;AO;Angola;201;6;34752;772
2021-06-02;AO;Angola;208;8;34960;780
2021-06-03;AO;Angola;180;4;35140;784
2021-06-04;AO;Angola;167;4;35307;788
2021-06-05;AO;Angola;287;6;35594;794
2021-06-06;AO;Angola;178;3;35772;797
2021-06-07;AO;Angola;82;3;35854;800
2021-06-08;AO;Angola;150;3;36004;803
2021-06-09;AO;Angola;111;8;36115;811
2021-06-10;AO;Angola;210;4;36325;815
2021-06-11;AO;Angola;130;4;36455;819
2021-06-12;AO;Angola;145;6;36600;825
2021-06-13;AO;Angola;105;6;36705;831
2021-06-14;AO;Angola;85;5;36790;836
2021-06-15;AO;Angola;131;6;36921;842
2021-06-16;AO;Angola;173;5;37094;847
2021-06-17;AO;Angola;195;4;37289;851
2021-06-18;AO;Angola;178;2;37467;853
2021-06-19;AO;Angola;137;3;37604;856
2021-06-20;AO;Angola;74;3;37678;859
2021-06-21;AO;Angola;70;9;37748;868
2021-06-22;AO;Angola;126;7;37874;875
2021-06-23;AO;Angola;128;3;38002;878
2021-06-24;AO;Angola;89;3;38091;881
2021-06-25;AO;Angola;280;2;38371;883
2021-06-26;AO;Angola;157;4;38528;887
2021-06-27;AO;Angola;28;2;38556;889
2021-06-28;AO;Angola;57;2;38613;891
2021-06-29;AO;Angola;69;3;38682;894
2021-06-30;AO;Angola;167;6;38849;900
2021-07-01;AO;Angola;116;3;38965;903
2021-02-04;AI;Anguilla;0;0;0;0
2021-02-05;AI;Anguilla;0;0;0;0
2021-02-06;AI;Anguilla;0;0;0;0
2021-02-07;AI;Anguilla;0;0;0;0
2021-02-08;AI;Anguilla;0;0;0;0
2021-02-09;AI;Anguilla;0;0;0;0
2021-02-10;AI;Anguilla;0;0;0;0
2021-02-11;AI;Anguilla;0;0;0;0
2021-02-12;AI;Anguilla;0;0;0;0
2021-02-13;AI;Anguilla;0;0;0;0
2021-02-14;AI;Anguilla;0;0;0;0
2021-02-15;AI;Anguilla;0;0;0;0
2021-02-16;AI;Anguilla;0;0;0;0
2021-02-17;AI;Anguilla;0;0;0;0
2021-02-18;AI;Anguilla;0;0;0;0
2021-02-19;AI;Anguilla;0;0;0;0
2021-02-20;AI;Anguilla;0;0;0;0
2021-02-21;AI;Anguilla;0;0;0;0
2021-02-22;AI;Anguilla;0;0;0;0
2021-02-23;AI;Anguilla;0;0;0;0
2021-02-24;AI;Anguilla;0;0;0;0
2021-02-25;AI;Anguilla;0;0;0;0
2021-02-26;AI;Anguilla;0;0;0;0
2021-02-27;AI;Anguilla;0;0;0;0
2021-02-28;AI;Anguilla;0;0;0;0
2021-03-01;AI;Anguilla;0;0;0;0
2021-03-02;AI;Anguilla;0;0;0;0
2021-03-03;AI;Anguilla;0;0;0;0
2021-03-04;AI;Anguilla;0;0;0;0
2021-03-05;AI;Anguilla;0;0;0;0
2021-03-06;AI;Anguilla;0;0;0;0
2021-03-07;AI;Anguilla;0;0;0;0
2021-03-08;AI;Anguilla;0;0;0;0
2021-03-09;AI;Anguilla;0;0;0;0
2021-03-10;AI;Anguilla;0;0;0;0
2021-03-11;AI;Anguilla;0;0;0;0
2021-03-12;AI;Anguilla;0;0;0;0
2021-03-13;AI;Anguilla;0;0;0;0
2021-03-14;AI;Anguilla;0;0;0;0
2021-03-15;AI;Anguilla;0;0;0;0
2021-03-16;AI;Anguilla;0;0;0;0
2021-03-17;AI;Anguilla;0;0;0;0
2021-03-18;AI;Anguilla;0;0;0;0
2021-03-19;AI;Anguilla;0;0;0;0
2021-03-20;AI;Anguilla;0;0;0;0
2021-03-21;AI;Anguilla;0;0;0;0
2021-03-22;AI;Anguilla;0;0;0;0
2021-03-23;AI;Anguilla;0;0;0;0
2021-03-24;AI;Anguilla;0;0;0;0
2021-03-25;AI;Anguilla;0;0;0;0
2021-03-26;AI;Anguilla;0;0;0;0
2021-03-27;AI;Anguilla;0;0;0;0
2021-03-28;AI;Anguilla;0;0;0;0
2021-03-29;AI;Anguilla;0;0;0;0
2021-03-30;AI;Anguilla;0;0;0;0
2021-03-31;AI;Anguilla;0;0;0;0
2021-04-01;AI;Anguilla;0;0;0;0
2021-04-02;AI;Anguilla;0;0;0;0
2021-04-03;AI;Anguilla;0;0;0;0
2021-04-04;AI;Anguilla;0;0;0;0
2021-04-05;AI;Anguilla;0;0;0;0
2021-04-06;AI;Anguilla;0;0;0;0
2021-04-07;AI;Anguilla;0;0;0;0
2021-04-08;AI;Anguilla;0;0;0;0
2021-04-09;AI;Anguilla;0;0;0;0
2021-04-10;AI;Anguilla;0;0;0;0
2021-04-11;AI;Anguilla;0;0;0;0
2021-04-12;AI;Anguilla;0;0;0;0
2021-04-13;AI;Anguilla;0;0;0;0
2021-04-14;AI;Anguilla;0;0;0;0
2021-04-15;AI;Anguilla;0;0;0;0
2021-04-16;AI;Anguilla;0;0;0;0
2021-04-17;AI;Anguilla;0;0;0;0
2021-04-18;AI;Anguilla;0;0;0;0
2021-04-19;AI;Anguilla;0;0;0;0
2021-04-20;AI;Anguilla;0;0;0;0
2021-04-21;AI;Anguilla;0;0;0;0
2021-04-22;AI;Anguilla;0;0;0;0
2021-04-23;AI;Anguilla;0;0;0;0
2021-04-24;AI;Anguilla;0;0;0;0
2021-04-25;AI;Anguilla;0;0;0;0
2021-04-26;AI;Anguilla;0;0;0;0
2021-04-27;AI;Anguilla;0;0;0;0
2021-04-28;AI;Anguilla;0;0;0;0
2021-04-29;AI;Anguilla;0;0;0;0
2021-04-30;AI;Anguilla;0;0;0;0
2021-05-01;AI;Anguilla;0;0;0;0
2021-05-02;AI;Anguilla;0;0;0;0
2021-05-03;AI;Anguilla;0;0;0;0
2021-05-04;AI;Anguilla;0;0;0;0
2021-05-05;AI;Anguilla;0;0;0;0
2021-05-06;AI;Anguilla;0;0;0;0
2021-05-07;AI;Anguilla;0;0;0;0
2021-05-08;AI;Anguilla;0;0;0;0
2021-05-09;AI;Anguilla;0;0;0;0
2021-05-10;AI;Anguilla;0;0;0;0
2021-05-11;AI;Anguilla;0;0;0;0
2021-05-12;AI;Anguilla;0;0;0;0
2021-05-13;AI;Anguilla;0;0;0;0
2021-05-14;AI;Anguilla;0;0;0;0
2021-05-15;AI;Anguilla;0;0;0;0
2021-05-16;AI;Anguilla;0;0;0;0
2021-05-17;AI;Anguilla;0;0;0;0
2021-05-18;AI;Anguilla;0;0;0;0
2021-05-19;AI;Anguilla;0;0;0;0
2021-05-20;AI;Anguilla;0;0;0;0
2021-05-21;AI;Anguilla;0;0;0;0
2021-05-22;AI;Anguilla;0;0;0;0
2021-05-23;AI;Anguilla;0;0;0;0
2021-05-24;AI;Anguilla;0;0;0;0
2021-05-25;AI;Anguilla;0;0;0;0
2021-05-26;AI;Anguilla;0;0;0;0
2021-05-27;AI;Anguilla;0;0;0;0
2021-05-28;AI;Anguilla;0;0;0;0
2021-05-29;AI;Anguilla;0;0;0;0
2021-05-30;AI;Anguilla;0;0;0;0
2021-05-31;AI;Anguilla;0;0;0;0
2021-06-01;AI;Anguilla;0;0;0;0
2021-06-02;AI;Anguilla;0;0;0;0
2021-06-03;AI;Anguilla;0;0;0;0
2021-06-04;AI;Anguilla;0;0;0;0
2021-06-05;AI;Anguilla;0;0;0;0
2021-06-06;AI;Anguilla;0;0;0;0
2021-06-07;AI;Anguilla;0;0;0;0
2021-06-08;AI;Anguilla;0;0;0;0
2021-06-09;AI;Anguilla;0;0;0;0
2021-06-10;AI;Anguilla;0;0;0;0
2021-06-11;AI;Anguilla;0;0;0;0
2021-06-12;AI;Anguilla;0;0;0;0
2021-06-13;AI;Anguilla;0;0;0;0
2021-06-14;AI;Anguilla;0;0;0;0
2021-06-15;AI;Anguilla;0;0;0;0
2021-06-16;AI;Anguilla;0;0;0;0
2021-06-17;AI;Anguilla;0;0;0;0
2021-06-18;AI;Anguilla;0;0;0;0
2021-06-19;AI;Anguilla;0;0;0;0
2021-06-20;AI;Anguilla;0;0;0;0
2021-06-21;AI;Anguilla;0;0;0;0
2021-06-22;AI;Anguilla;0;0;0;0
2021-06-23;AI;Anguilla;0;0;0;0
2021-06-24;AI;Anguilla;0;0;0;0
2021-06-25;AI;Anguilla;0;0;0;0
2020-03-13;AG;Antigua and Barbuda;1;0;1;0
2020-03-14;AG;Antigua and Barbuda;0;0;1;0
2020-03-15;AG;Antigua and Barbuda;0;0;1;0
2020-03-16;AG;Antigua and Barbuda;0;0;1;0
2020-03-17;AG;Antigua and Barbuda;0;0;1;0
2020-03-18;AG;Antigua and Barbuda;0;0;1;0
2020-03-19;AG;Antigua and Barbuda;0;0;1;0
2020-03-20;AG;Antigua and Barbuda;0;0;1;0
2020-03-21;AG;Antigua and Barbuda;0;0;1;0
2020-03-22;AG;Antigua and Barbuda;0;0;1;0
2020-03-23;AG;Antigua and Barbuda;2;0;3;0
2020-03-24;AG;Antigua and Barbuda;0;0;3;0
2020-03-25;AG;Antigua and Barbuda;0;0;3;0
2020-03-26;AG;Antigua and Barbuda;4;0;7;0
2020-03-27;AG;Antigua and Barbuda;0;0;7;0
2020-03-28;AG;Antigua and Barbuda;0;0;7;0
2020-03-29;AG;Antigua and Barbuda;0;0;7;0
2020-03-30;AG;Antigua and Barbuda;0;0;7;0
2020-03-31;AG;Antigua and Barbuda;0;0;7;0
2020-04-01;AG;Antigua and Barbuda;0;0;7;0
2020-04-02;AG;Antigua and Barbuda;2;0;9;0
2020-04-03;AG;Antigua and Barbuda;6;0;15;0
2020-04-04;AG;Antigua and Barbuda;0;0;15;0
2020-04-05;AG;Antigua and Barbuda;0;0;15;0
2020-04-06;AG;Antigua and Barbuda;0;0;15;0
2020-04-07;AG;Antigua and Barbuda;4;1;19;1
2020-04-08;AG;Antigua and Barbuda;0;1;19;2
2020-04-09;AG;Antigua and Barbuda;0;0;19;2
2020-04-10;AG;Antigua and Barbuda;0;0;19;2
2020-04-11;AG;Antigua and Barbuda;2;0;21;2
2020-04-12;AG;Antigua and Barbuda;0;0;21;2
2020-04-13;AG;Antigua and Barbuda;2;0;23;2
2020-04-14;AG;Antigua and Barbuda;0;0;23;2
2020-04-15;AG;Antigua and Barbuda;0;0;23;2
2020-04-16;AG;Antigua and Barbuda;0;1;23;3
2020-04-17;AG;Antigua and Barbuda;0;0;23;3
2020-04-18;AG;Antigua and Barbuda;0;0;23;3
2020-04-19;AG;Antigua and Barbuda;0;0;23;3
2020-04-20;AG;Antigua and Barbuda;0;0;23;3
2020-04-21;AG;Antigua and Barbuda;0;0;23;3
2020-04-22;AG;Antigua and Barbuda;1;0;24;3
2020-04-23;AG;Antigua and Barbuda;0;0;24;3
2020-04-24;AG;Antigua and Barbuda;0;0;24;3
2020-04-25;AG;Antigua and Barbuda;0;0;24;3
2020-04-26;AG;Antigua and Barbuda;0;0;24;3
2020-04-27;AG;Antigua and Barbuda;0;0;24;3
2020-04-28;AG;Antigua and Barbuda;0;0;24;3
2020-04-29;AG;Antigua and Barbuda;0;0;24;3
2020-04-30;AG;Antigua and Barbuda;0;0;24;3
2020-05-01;AG;Antigua and Barbuda;1;0;25;3
2020-05-02;AG;Antigua and Barbuda;0;0;25;3
2020-05-03;AG;Antigua and Barbuda;0;0;25;3
2020-05-04;AG;Antigua and Barbuda;0;0;25;3
2020-05-05;AG;Antigua and Barbuda;0;0;25;3
2020-05-06;AG;Antigua and Barbuda;0;0;25;3
2020-05-07;AG;Antigua and Barbuda;0;0;25;3
2020-05-08;AG;Antigua and Barbuda;0;0;25;3
2020-05-09;AG;Antigua and Barbuda;0;0;25;3
2020-05-10;AG;Antigua and Barbuda;0;0;25;3
2020-05-11;AG;Antigua and Barbuda;0;0;25;3
2020-05-12;AG;Antigua and Barbuda;0;0;25;3
2020-05-13;AG;Antigua and Barbuda;0;0;25;3
2020-05-14;AG;Antigua and Barbuda;0;0;25;3
2020-05-15;AG;Antigua and Barbuda;0;0;25;3
2020-05-16;AG;Antigua and Barbuda;0;0;25;3
2020-05-17;AG;Antigua and Barbuda;0;0;25;3
2020-05-18;AG;Antigua and Barbuda;0;0;25;3
2020-05-19;AG;Antigua and Barbuda;0;0;25;3
2020-05-20;AG;Antigua and Barbuda;0;0;25;3
2020-05-21;AG;Antigua and Barbuda;0;0;25;3
2020-05-22;AG;Antigua and Barbuda;0;0;25;3
2020-05-23;AG;Antigua and Barbuda;0;0;25;3
2020-05-24;AG;Antigua and Barbuda;0;0;25;3
2020-05-25;AG;Antigua and Barbuda;0;0;25;3
2020-05-26;AG;Antigua and Barbuda;0;0;25;3
2020-05-27;AG;Antigua and Barbuda;0;0;25;3
2020-05-28;AG;Antigua and Barbuda;0;0;25;3
2020-05-29;AG;Antigua and Barbuda;0;0;25;3
2020-05-30;AG;Antigua and Barbuda;0;0;25;3
2020-05-31;AG;Antigua and Barbuda;1;0;26;3
2020-06-01;AG;Antigua and Barbuda;0;0;26;3
2020-06-02;AG;Antigua and Barbuda;0;0;26;3
2020-06-03;AG;Antigua and Barbuda;0;0;26;3
2020-06-04;AG;Antigua and Barbuda;0;0;26;3
2020-06-05;AG;Antigua and Barbuda;0;0;26;3
2020-06-06;AG;Antigua and Barbuda;0;0;26;3
2020-06-07;AG;Antigua and Barbuda;0;0;26;3
2020-06-08;AG;Antigua and Barbuda;0;0;26;3
2020-06-09;AG;Antigua and Barbuda;0;0;26;3
2020-06-10;AG;Antigua and Barbuda;0;0;26;3
2020-06-11;AG;Antigua and Barbuda;0;0;26;3
2020-06-12;AG;Antigua and Barbuda;0;0;26;3
2020-06-13;AG;Antigua and Barbuda;0;0;26;3
2020-06-14;AG;Antigua and Barbuda;0;0;26;3
2020-06-15;AG;Antigua and Barbuda;0;0;26;3
2020-06-16;AG;Antigua and Barbuda;0;0;26;3
2020-06-17;AG;Antigua and Barbuda;0;0;26;3
2020-06-18;AG;Antigua and Barbuda;0;0;26;3
2020-06-19;AG;Antigua and Barbuda;0;0;26;3
2020-06-20;AG;Antigua and Barbuda;0;0;26;3
2020-06-21;AG;Antigua and Barbuda;0;0;26;3
2020-06-22;AG;Antigua and Barbuda;0;0;26;3
2020-06-23;AG;Antigua and Barbuda;0;0;26;3
2020-06-24;AG;Antigua and Barbuda;0;0;26;3
2020-06-25;AG;Antigua and Barbuda;39;0;65;3
2020-06-26;AG;Antigua and Barbuda;0;0;65;3
2020-06-27;AG;Antigua and Barbuda;0;0;65;3
2020-06-28;AG;Antigua and Barbuda;4;0;69;3
2020-06-29;AG;Antigua and Barbuda;0;0;69;3
2020-06-30;AG;Antigua and Barbuda;0;0;69;3
2020-07-01;AG;Antigua and Barbuda;0;0;69;3
2020-07-02;AG;Antigua and Barbuda;0;0;69;3
2020-07-03;AG;Antigua and Barbuda;-1;0;68;3
2020-07-04;AG;Antigua and Barbuda;0;0;68;3
2020-07-05;AG;Antigua and Barbuda;0;0;68;3
2020-07-06;AG;Antigua and Barbuda;2;0;70;3
2020-07-07;AG;Antigua and Barbuda;0;0;70;3
2020-07-08;AG;Antigua and Barbuda;0;0;70;3
2020-07-09;AG;Antigua and Barbuda;3;0;73;3
2020-07-10;AG;Antigua and Barbuda;1;0;74;3
2020-07-11;AG;Antigua and Barbuda;0;0;74;3
2020-07-12;AG;Antigua and Barbuda;0;0;74;3
2020-07-13;AG;Antigua and Barbuda;0;0;74;3
2020-07-14;AG;Antigua and Barbuda;0;0;74;3
2020-07-15;AG;Antigua and Barbuda;0;0;74;3
2020-07-16;AG;Antigua and Barbuda;0;0;74;3
2020-07-17;AG;Antigua and Barbuda;2;0;76;3
2020-07-18;AG;Antigua and Barbuda;0;0;76;3
2020-07-19;AG;Antigua and Barbuda;0;0;76;3
2020-07-20;AG;Antigua and Barbuda;0;0;76;3
2020-07-21;AG;Antigua and Barbuda;0;0;76;3
2020-07-22;AG;Antigua and Barbuda;0;0;76;3
2020-07-23;AG;Antigua and Barbuda;0;0;76;3
2020-07-24;AG;Antigua and Barbuda;6;0;82;3
2020-07-25;AG;Antigua and Barbuda;0;0;82;3
2020-07-26;AG;Antigua and Barbuda;0;0;82;3
2020-07-27;AG;Antigua and Barbuda;4;0;86;3
2020-07-28;AG;Antigua and Barbuda;0;0;86;3
2020-07-29;AG;Antigua and Barbuda;5;0;91;3
2020-07-30;AG;Antigua and Barbuda;0;0;91;3
2020-07-31;AG;Antigua and Barbuda;0;0;91;3
2020-08-01;AG;Antigua and Barbuda;0;0;91;3
2020-08-02;AG;Antigua and Barbuda;0;0;91;3
2020-08-03;AG;Antigua and Barbuda;1;0;92;3
2020-08-04;AG;Antigua and Barbuda;0;0;92;3
2020-08-05;AG;Antigua and Barbuda;0;0;92;3
2020-08-06;AG;Antigua and Barbuda;0;0;92;3
2020-08-07;AG;Antigua and Barbuda;0;0;92;3
2020-08-08;AG;Antigua and Barbuda;0;0;92;3
2020-08-09;AG;Antigua and Barbuda;0;0;92;3
2020-08-10;AG;Antigua and Barbuda;0;0;92;3
2020-08-11;AG;Antigua and Barbuda;0;0;92;3
2020-08-12;AG;Antigua and Barbuda;0;0;92;3
2020-08-13;AG;Antigua and Barbuda;0;0;92;3
2020-08-14;AG;Antigua and Barbuda;1;0;93;3
2020-08-15;AG;Antigua and Barbuda;0;0;93;3
2020-08-16;AG;Antigua and Barbuda;0;0;93;3
2020-08-17;AG;Antigua and Barbuda;0;0;93;3
2020-08-18;AG;Antigua and Barbuda;0;0;93;3
2020-08-19;AG;Antigua and Barbuda;1;0;94;3
2020-08-20;AG;Antigua and Barbuda;0;0;94;3
2020-08-21;AG;Antigua and Barbuda;0;0;94;3
2020-08-22;AG;Antigua and Barbuda;0;0;94;3
2020-08-23;AG;Antigua and Barbuda;0;0;94;3
2020-08-24;AG;Antigua and Barbuda;0;0;94;3
2020-08-25;AG;Antigua and Barbuda;0;0;94;3
2020-08-26;AG;Antigua and Barbuda;0;0;94;3
2020-08-27;AG;Antigua and Barbuda;0;0;94;3
2020-08-28;AG;Antigua and Barbuda;0;0;94;3
2020-08-29;AG;Antigua and Barbuda;0;0;94;3
2020-08-30;AG;Antigua and Barbuda;0;0;94;3
2020-08-31;AG;Antigua and Barbuda;0;0;94;3
2020-09-01;AG;Antigua and Barbuda;0;0;94;3
2020-09-02;AG;Antigua and Barbuda;0;0;94;3
2020-09-03;AG;Antigua and Barbuda;1;0;95;3
2020-09-04;AG;Antigua and Barbuda;0;0;95;3
2020-09-05;AG;Antigua and Barbuda;0;0;95;3
2020-09-06;AG;Antigua and Barbuda;0;0;95;3
2020-09-07;AG;Antigua and Barbuda;0;0;95;3
2020-09-08;AG;Antigua and Barbuda;0;0;95;3
2020-09-09;AG;Antigua and Barbuda;0;0;95;3
2020-09-10;AG;Antigua and Barbuda;0;0;95;3
2020-09-11;AG;Antigua and Barbuda;0;0;95;3
2020-09-12;AG;Antigua and Barbuda;0;0;95;3
2020-09-13;AG;Antigua and Barbuda;0;0;95;3
2020-09-14;AG;Antigua and Barbuda;0;0;95;3
2020-09-15;AG;Antigua and Barbuda;0;0;95;3
2020-09-16;AG;Antigua and Barbuda;0;0;95;3
2020-09-17;AG;Antigua and Barbuda;0;0;95;3
2020-09-18;AG;Antigua and Barbuda;0;0;95;3
2020-09-19;AG;Antigua and Barbuda;1;0;96;3
2020-09-20;AG;Antigua and Barbuda;0;0;96;3
2020-09-21;AG;Antigua and Barbuda;0;0;96;3
2020-09-22;AG;Antigua and Barbuda;0;0;96;3
2020-09-23;AG;Antigua and Barbuda;1;0;97;3
2020-09-24;AG;Antigua and Barbuda;0;0;97;3
2020-09-25;AG;Antigua and Barbuda;1;0;98;3
2020-09-26;AG;Antigua and Barbuda;0;0;98;3
2020-09-27;AG;Antigua and Barbuda;3;0;101;3
2020-09-28;AG;Antigua and Barbuda;0;0;101;3
2020-09-29;AG;Antigua and Barbuda;0;0;101;3
2020-09-30;AG;Antigua and Barbuda;0;0;101;3
2020-10-01;AG;Antigua and Barbuda;0;0;101;3
2020-10-02;AG;Antigua and Barbuda;5;0;106;3
2020-10-03;AG;Antigua and Barbuda;1;0;107;3
2020-10-04;AG;Antigua and Barbuda;0;0;107;3
2020-10-05;AG;Antigua and Barbuda;0;0;107;3
2020-10-06;AG;Antigua and Barbuda;0;0;107;3
2020-10-07;AG;Antigua and Barbuda;1;0;108;3
2020-10-08;AG;Antigua and Barbuda;3;0;111;3
2020-10-09;AG;Antigua and Barbuda;0;0;111;3
2020-10-10;AG;Antigua and Barbuda;0;0;111;3
2020-10-11;AG;Antigua and Barbuda;0;0;111;3
2020-10-12;AG;Antigua and Barbuda;0;0;111;3
2020-10-13;AG;Antigua and Barbuda;0;0;111;3
2020-10-14;AG;Antigua and Barbuda;1;0;112;3
2020-10-15;AG;Antigua and Barbuda;0;0;112;3
2020-10-16;AG;Antigua and Barbuda;0;0;112;3
2020-10-17;AG;Antigua and Barbuda;7;0;119;3
2020-10-18;AG;Antigua and Barbuda;0;0;119;3
2020-10-19;AG;Antigua and Barbuda;0;0;119;3
2020-10-20;AG;Antigua and Barbuda;0;0;119;3
2020-10-21;AG;Antigua and Barbuda;3;0;122;3
2020-10-22;AG;Antigua and Barbuda;0;0;122;3
2020-10-23;AG;Antigua and Barbuda;0;0;122;3
2020-10-24;AG;Antigua and Barbuda;2;0;124;3
2020-10-25;AG;Antigua and Barbuda;0;0;124;3
2020-10-26;AG;Antigua and Barbuda;0;0;124;3
2020-10-27;AG;Antigua and Barbuda;0;0;124;3
2020-10-28;AG;Antigua and Barbuda;0;0;124;3
2020-10-29;AG;Antigua and Barbuda;0;0;124;3
2020-10-30;AG;Antigua and Barbuda;3;0;127;3
2020-10-31;AG;Antigua and Barbuda;1;0;128;3
2020-11-01;AG;Antigua and Barbuda;0;0;128;3
2020-11-02;AG;Antigua and Barbuda;0;0;128;3
2020-11-03;AG;Antigua and Barbuda;0;0;128;3
2020-11-04;AG;Antigua and Barbuda;2;0;130;3
2020-11-05;AG;Antigua and Barbuda;0;0;130;3
2020-11-06;AG;Antigua and Barbuda;0;0;130;3
2020-11-07;AG;Antigua and Barbuda;1;0;131;3
2020-11-08;AG;Antigua and Barbuda;0;0;131;3
2020-11-09;AG;Antigua and Barbuda;0;0;131;3
2020-11-10;AG;Antigua and Barbuda;0;0;131;3
2020-11-11;AG;Antigua and Barbuda;0;0;131;3
2020-11-12;AG;Antigua and Barbuda;0;0;131;3
2020-11-13;AG;Antigua and Barbuda;2;0;133;3
2020-11-14;AG;Antigua and Barbuda;1;1;134;4
2020-11-15;AG;Antigua and Barbuda;0;0;134;4
2020-11-16;AG;Antigua and Barbuda;0;0;134;4
2020-11-17;AG;Antigua and Barbuda;0;0;134;4
2020-11-18;AG;Antigua and Barbuda;5;0;139;4
2020-11-19;AG;Antigua and Barbuda;0;0;139;4
2020-11-20;AG;Antigua and Barbuda;0;0;139;4
2020-11-21;AG;Antigua and Barbuda;0;0;139;4
2020-11-22;AG;Antigua and Barbuda;0;0;139;4
2020-11-23;AG;Antigua and Barbuda;0;0;139;4
2020-11-24;AG;Antigua and Barbuda;0;0;139;4
2020-11-25;AG;Antigua and Barbuda;1;0;140;4
2020-11-26;AG;Antigua and Barbuda;1;0;141;4
2020-11-27;AG;Antigua and Barbuda;0;0;141;4
2020-11-28;AG;Antigua and Barbuda;0;0;141;4
2020-11-29;AG;Antigua and Barbuda;0;0;141;4
2020-11-30;AG;Antigua and Barbuda;0;0;141;4
2020-12-01;AG;Antigua and Barbuda;1;0;142;4
2020-12-02;AG;Antigua and Barbuda;2;0;144;4
2020-12-03;AG;Antigua and Barbuda;0;0;144;4
2020-12-04;AG;Antigua and Barbuda;0;0;144;4
2020-12-05;AG;Antigua and Barbuda;0;0;144;4
2020-12-06;AG;Antigua and Barbuda;0;0;144;4
2020-12-07;AG;Antigua and Barbuda;2;0;146;4
2020-12-08;AG;Antigua and Barbuda;0;0;146;4
2020-12-09;AG;Antigua and Barbuda;0;0;146;4
2020-12-10;AG;Antigua and Barbuda;0;0;146;4
2020-12-11;AG;Antigua and Barbuda;1;0;147;4
2020-12-12;AG;Antigua and Barbuda;1;0;148;4
2020-12-13;AG;Antigua and Barbuda;0;1;148;5
2020-12-14;AG;Antigua and Barbuda;0;0;148;5
2020-12-15;AG;Antigua and Barbuda;0;0;148;5
2020-12-16;AG;Antigua and Barbuda;3;0;151;5
2020-12-17;AG;Antigua and Barbuda;0;0;151;5
2020-12-18;AG;Antigua and Barbuda;1;0;152;5
2020-12-19;AG;Antigua and Barbuda;0;0;152;5
2020-12-20;AG;Antigua and Barbuda;1;0;153;5
2020-12-21;AG;Antigua and Barbuda;0;0;153;5
2020-12-22;AG;Antigua and Barbuda;0;0;153;5
2020-12-23;AG;Antigua and Barbuda;1;0;154;5
2020-12-24;AG;Antigua and Barbuda;0;0;154;5
2020-12-25;AG;Antigua and Barbuda;1;0;155;5
2020-12-26;AG;Antigua and Barbuda;0;0;155;5
2020-12-27;AG;Antigua and Barbuda;0;0;155;5
2020-12-28;AG;Antigua and Barbuda;3;0;158;5
2020-12-29;AG;Antigua and Barbuda;0;0;158;5
2020-12-30;AG;Antigua and Barbuda;0;0;158;5
2020-12-31;AG;Antigua and Barbuda;1;0;159;5
2021-01-01;AG;Antigua and Barbuda;0;0;159;5
2021-01-02;AG;Antigua and Barbuda;0;0;159;5
2021-01-03;AG;Antigua and Barbuda;1;0;160;5
2021-01-04;AG;Antigua and Barbuda;0;0;160;5
2021-01-05;AG;Antigua and Barbuda;0;0;160;5
2021-01-06;AG;Antigua and Barbuda;3;0;163;5
2021-01-07;AG;Antigua and Barbuda;0;0;163;5
2021-01-08;AG;Antigua and Barbuda;4;0;167;5
2021-01-09;AG;Antigua and Barbuda;2;0;169;5
2021-01-10;AG;Antigua and Barbuda;7;0;176;5
2021-01-11;AG;Antigua and Barbuda;0;0;176;5
2021-01-12;AG;Antigua and Barbuda;0;0;176;5
2021-01-13;AG;Antigua and Barbuda;0;0;176;5
2021-01-14;AG;Antigua and Barbuda;8;1;184;6
2021-01-15;AG;Antigua and Barbuda;0;0;184;6
2021-01-16;AG;Antigua and Barbuda;3;0;187;6
2021-01-17;AG;Antigua and Barbuda;2;0;189;6
2021-01-18;AG;Antigua and Barbuda;0;0;189;6
2021-01-19;AG;Antigua and Barbuda;1;0;190;6
2021-01-20;AG;Antigua and Barbuda;0;0;190;6
2021-01-21;AG;Antigua and Barbuda;2;0;192;6
2021-01-22;AG;Antigua and Barbuda;3;0;195;6
2021-01-23;AG;Antigua and Barbuda;0;0;195;6
2021-01-24;AG;Antigua and Barbuda;3;0;198;6
2021-01-25;AG;Antigua and Barbuda;3;0;201;6
2021-01-26;AG;Antigua and Barbuda;0;0;201;6
2021-01-27;AG;Antigua and Barbuda;14;0;215;6
2021-01-28;AG;Antigua and Barbuda;0;0;215;6
2021-01-29;AG;Antigua and Barbuda;3;0;218;6
2021-01-30;AG;Antigua and Barbuda;0;1;218;7
2021-01-31;AG;Antigua and Barbuda;16;0;234;7
2021-02-01;AG;Antigua and Barbuda;0;0;234;7
2021-02-02;AG;Antigua and Barbuda;15;0;249;7
2021-02-03;AG;Antigua and Barbuda;0;0;249;7
2021-02-04;AG;Antigua and Barbuda;19;0;268;7
2021-02-05;AG;Antigua and Barbuda;9;0;277;7
2021-02-06;AG;Antigua and Barbuda;11;0;288;7
2021-02-07;AG;Antigua and Barbuda;11;0;299;7
2021-02-08;AG;Antigua and Barbuda;17;0;316;7
2021-02-09;AG;Antigua and Barbuda;0;1;316;8
2021-02-10;AG;Antigua and Barbuda;34;1;350;9
2021-02-11;AG;Antigua and Barbuda;31;0;381;9
2021-02-12;AG;Antigua and Barbuda;38;0;419;9
2021-02-13;AG;Antigua and Barbuda;8;0;427;9
2021-02-14;AG;Antigua and Barbuda;0;0;427;9
2021-02-15;AG;Antigua and Barbuda;16;0;443;9
2021-02-16;AG;Antigua and Barbuda;0;0;443;9
2021-02-17;AG;Antigua and Barbuda;82;1;525;10
2021-02-18;AG;Antigua and Barbuda;23;0;548;10
2021-02-19;AG;Antigua and Barbuda;0;0;548;10
2021-02-20;AG;Antigua and Barbuda;50;1;598;11
2021-02-21;AG;Antigua and Barbuda;0;2;598;13
2021-02-22;AG;Antigua and Barbuda;16;1;614;14
2021-02-23;AG;Antigua and Barbuda;22;0;636;14
2021-02-24;AG;Antigua and Barbuda;10;0;646;14
2021-02-25;AG;Antigua and Barbuda;55;0;701;14
2021-02-26;AG;Antigua and Barbuda;0;0;701;14
2021-02-27;AG;Antigua and Barbuda;25;0;726;14
2021-02-28;AG;Antigua and Barbuda;4;0;730;14
2021-03-01;AG;Antigua and Barbuda;39;0;769;14
2021-03-02;AG;Antigua and Barbuda;0;0;769;14
2021-03-03;AG;Antigua and Barbuda;0;5;769;19
2021-03-04;AG;Antigua and Barbuda;44;2;813;21
2021-03-05;AG;Antigua and Barbuda;0;0;813;21
2021-03-06;AG;Antigua and Barbuda;0;0;813;21
2021-03-07;AG;Antigua and Barbuda;35;0;848;21
2021-03-08;AG;Antigua and Barbuda;0;0;848;21
2021-03-09;AG;Antigua and Barbuda;14;1;862;22
2021-03-10;AG;Antigua and Barbuda;20;1;882;23
2021-03-11;AG;Antigua and Barbuda;0;0;882;23
2021-03-12;AG;Antigua and Barbuda;63;2;945;25
2021-03-13;AG;Antigua and Barbuda;17;2;962;27
2021-03-14;AG;Antigua and Barbuda;1;0;963;27
2021-03-15;AG;Antigua and Barbuda;0;0;963;27
2021-03-16;AG;Antigua and Barbuda;29;0;992;27
2021-03-17;AG;Antigua and Barbuda;0;0;992;27
2021-03-18;AG;Antigua and Barbuda;16;0;1008;27
2021-03-19;AG;Antigua and Barbuda;3;0;1011;27
2021-03-20;AG;Antigua and Barbuda;22;1;1033;28
2021-03-21;AG;Antigua and Barbuda;0;0;1033;28
2021-03-22;AG;Antigua and Barbuda;39;0;1072;28
2021-03-23;AG;Antigua and Barbuda;8;0;1080;28
2021-03-24;AG;Antigua and Barbuda;0;0;1080;28
2021-03-25;AG;Antigua and Barbuda;23;0;1103;28
2021-03-26;AG;Antigua and Barbuda;19;0;1122;28
2021-03-27;AG;Antigua and Barbuda;0;0;1122;28
2021-03-28;AG;Antigua and Barbuda;6;0;1128;28
2021-03-29;AG;Antigua and Barbuda;8;0;1136;28
2021-03-30;AG;Antigua and Barbuda;0;0;1136;28
2021-03-31;AG;Antigua and Barbuda;0;0;1136;28
2021-04-01;AG;Antigua and Barbuda;11;0;1147;28
2021-04-02;AG;Antigua and Barbuda;5;0;1152;28
2021-04-03;AG;Antigua and Barbuda;18;0;1170;28
2021-04-04;AG;Antigua and Barbuda;0;0;1170;28
2021-04-05;AG;Antigua and Barbuda;3;1;1173;29
2021-04-06;AG;Antigua and Barbuda;0;0;1173;29
2021-04-07;AG;Antigua and Barbuda;4;0;1177;29
2021-04-08;AG;Antigua and Barbuda;3;0;1180;29
2021-04-09;AG;Antigua and Barbuda;2;1;1182;30
2021-04-10;AG;Antigua and Barbuda;15;0;1197;30
2021-04-11;AG;Antigua and Barbuda;1;0;1198;30
2021-04-12;AG;Antigua and Barbuda;0;0;1198;30
2021-04-13;AG;Antigua and Barbuda;3;1;1201;31
2021-04-14;AG;Antigua and Barbuda;0;0;1201;31
2021-04-15;AG;Antigua and Barbuda;8;0;1209;31
2021-04-16;AG;Antigua and Barbuda;4;0;1213;31
2021-04-17;AG;Antigua and Barbuda;3;0;1216;31
2021-04-18;AG;Antigua and Barbuda;0;0;1216;31
2021-04-19;AG;Antigua and Barbuda;1;0;1217;31
2021-04-20;AG;Antigua and Barbuda;0;0;1217;31
2021-04-21;AG;Antigua and Barbuda;0;0;1217;31
2021-04-22;AG;Antigua and Barbuda;0;0;1217;31
2021-04-23;AG;Antigua and Barbuda;5;0;1222;31
2021-04-24;AG;Antigua and Barbuda;5;0;1227;31
2021-04-25;AG;Antigua and Barbuda;0;0;1227;31
2021-04-26;AG;Antigua and Barbuda;1;1;1228;32
2021-04-27;AG;Antigua and Barbuda;4;0;1232;32
2021-04-28;AG;Antigua and Barbuda;0;0;1232;32
2021-04-29;AG;Antigua and Barbuda;0;0;1232;32
2021-04-30;AG;Antigua and Barbuda;0;0;1232;32
2021-05-01;AG;Antigua and Barbuda;0;0;1232;32
2021-05-02;AG;Antigua and Barbuda;0;0;1232;32
2021-05-03;AG;Antigua and Barbuda;0;0;1232;32
2021-05-04;AG;Antigua and Barbuda;0;0;1232;32
2021-05-05;AG;Antigua and Barbuda;0;0;1232;32
2021-05-06;AG;Antigua and Barbuda;0;0;1232;32
2021-05-07;AG;Antigua and Barbuda;0;0;1232;32
2021-05-08;AG;Antigua and Barbuda;0;0;1232;32
2021-05-09;AG;Antigua and Barbuda;-1;0;1231;32
2021-05-10;AG;Antigua and Barbuda;6;0;1237;32
2021-05-11;AG;Antigua and Barbuda;1;0;1238;32
2021-05-12;AG;Antigua and Barbuda;2;0;1240;32
2021-05-13;AG;Antigua and Barbuda;0;0;1240;32
2021-05-14;AG;Antigua and Barbuda;0;0;1240;32
2021-05-15;AG;Antigua and Barbuda;1;1;1241;33
2021-05-16;AG;Antigua and Barbuda;0;0;1241;33
2021-05-17;AG;Antigua and Barbuda;10;9;1251;42
2021-05-18;AG;Antigua and Barbuda;0;0;1251;42
2021-05-19;AG;Antigua and Barbuda;1;0;1252;42
2021-05-20;AG;Antigua and Barbuda;3;0;1255;42
2021-05-21;AG;Antigua and Barbuda;0;0;1255;42
2021-05-22;AG;Antigua and Barbuda;2;0;1257;42
2021-05-23;AG;Antigua and Barbuda;0;0;1257;42
2021-05-24;AG;Antigua and Barbuda;1;0;1258;42
2021-05-25;AG;Antigua and Barbuda;0;0;1258;42
2021-05-26;AG;Antigua and Barbuda;0;0;1258;42
2021-05-27;AG;Antigua and Barbuda;0;0;1258;42
2021-05-28;AG;Antigua and Barbuda;1;0;1259;42
2021-05-29;AG;Antigua and Barbuda;0;0;1259;42
2021-05-30;AG;Antigua and Barbuda;0;0;1259;42
2021-05-31;AG;Antigua and Barbuda;1;0;1260;42
2021-06-01;AG;Antigua and Barbuda;0;0;1260;42
2021-06-02;AG;Antigua and Barbuda;2;0;1262;42
2021-06-03;AG;Antigua and Barbuda;0;0;1262;42
2021-06-04;AG;Antigua and Barbuda;1;0;1263;42
2021-06-05;AG;Antigua and Barbuda;0;0;1263;42
2021-06-06;AG;Antigua and Barbuda;0;0;1263;42
2021-06-07;AG;Antigua and Barbuda;0;0;1263;42
2021-06-08;AG;Antigua and Barbuda;0;0;1263;42
2021-06-09;AG;Antigua and Barbuda;0;0;1263;42
2021-06-10;AG;Antigua and Barbuda;0;0;1263;42
2021-06-11;AG;Antigua and Barbuda;0;0;1263;42
2021-06-12;AG;Antigua and Barbuda;0;0;1263;42
2021-06-13;AG;Antigua and Barbuda;0;0;1263;42
2021-06-14;AG;Antigua and Barbuda;0;0;1263;42
2021-06-15;AG;Antigua and Barbuda;0;0;1263;42
2021-06-16;AG;Antigua and Barbuda;0;0;1263;42
2021-06-17;AG;Antigua and Barbuda;0;0;1263;42
2021-06-18;AG;Antigua and Barbuda;0;0;1263;42
2021-06-19;AG;Antigua and Barbuda;0;0;1263;42
2021-06-20;AG;Antigua and Barbuda;0;0;1263;42
2021-06-21;AG;Antigua and Barbuda;0;0;1263;42
2021-06-22;AG;Antigua and Barbuda;0;0;1263;42
2021-06-23;AG;Antigua and Barbuda;0;0;1263;42
2021-06-24;AG;Antigua and Barbuda;0;0;1263;42
2021-06-25;AG;Antigua and Barbuda;0;0;1263;42
2021-06-26;AG;Antigua and Barbuda;0;0;1263;42
2021-06-27;AG;Antigua and Barbuda;0;0;1263;42
2021-06-28;AG;Antigua and Barbuda;0;0;1263;42
2021-06-29;AG;Antigua and Barbuda;0;0;1263;42
2021-06-30;AG;Antigua and Barbuda;0;0;1263;42
2021-07-01;AG;Antigua and Barbuda;1;0;1264;42
2020-01-01;AR;Argentina;0;0;0;0
2020-01-02;AR;Argentina;0;0;0;0
2020-01-03;AR;Argentina;0;0;0;0
2020-01-04;AR;Argentina;0;0;0;0
2020-01-05;AR;Argentina;0;0;0;0
2020-01-06;AR;Argentina;0;0;0;0
2020-01-07;AR;Argentina;0;0;0;0
2020-01-08;AR;Argentina;0;0;0;0
2020-01-09;AR;Argentina;0;0;0;0
2020-01-10;AR;Argentina;0;0;0;0
2020-01-11;AR;Argentina;0;0;0;0
2020-01-12;AR;Argentina;0;0;0;0
2020-01-13;AR;Argentina;0;0;0;0
2020-01-14;AR;Argentina;0;0;0;0
2020-01-15;AR;Argentina;0;0;0;0
2020-01-16;AR;Argentina;0;0;0;0
2020-01-17;AR;Argentina;0;0;0;0
2020-01-18;AR;Argentina;0;0;0;0
2020-01-19;AR;Argentina;0;0;0;0
2020-01-20;AR;Argentina;0;0;0;0
2020-01-21;AR;Argentina;0;0;0;0
2020-01-22;AR;Argentina;0;0;0;0
2020-01-23;AR;Argentina;0;0;0;0
2020-01-24;AR;Argentina;0;0;0;0
2020-01-25;AR;Argentina;0;0;0;0
2020-01-26;AR;Argentina;0;0;0;0
2020-01-27;AR;Argentina;0;0;0;0
2020-01-28;AR;Argentina;0;0;0;0
2020-01-29;AR;Argentina;0;0;0;0
2020-01-30;AR;Argentina;0;0;0;0
2020-01-31;AR;Argentina;0;0;0;0
2020-02-01;AR;Argentina;0;0;0;0
2020-02-02;AR;Argentina;0;0;0;0
2020-02-03;AR;Argentina;0;0;0;0
2020-02-04;AR;Argentina;0;0;0;0
2020-02-05;AR;Argentina;0;0;0;0
2020-02-06;AR;Argentina;0;0;0;0
2020-02-07;AR;Argentina;0;0;0;0
2020-02-08;AR;Argentina;0;0;0;0
2020-02-09;AR;Argentina;0;0;0;0
2020-02-10;AR;Argentina;0;0;0;0
2020-02-11;AR;Argentina;0;0;0;0
2020-02-12;AR;Argentina;0;0;0;0
2020-02-13;AR;Argentina;0;0;0;0
2020-02-14;AR;Argentina;0;0;0;0
2020-02-15;AR;Argentina;0;0;0;0
2020-02-16;AR;Argentina;0;0;0;0
2020-02-17;AR;Argentina;0;0;0;0
2020-02-18;AR;Argentina;0;0;0;0
2020-02-19;AR;Argentina;0;0;0;0
2020-02-20;AR;Argentina;0;0;0;0
2020-02-21;AR;Argentina;0;0;0;0
2020-02-22;AR;Argentina;0;0;0;0
2020-02-23;AR;Argentina;0;0;0;0
2020-02-24;AR;Argentina;0;0;0;0
2020-02-25;AR;Argentina;0;0;0;0
2020-02-26;AR;Argentina;0;0;0;0
2020-02-27;AR;Argentina;0;0;0;0
2020-02-28;AR;Argentina;0;0;0;0
2020-02-29;AR;Argentina;0;0;0;0
2020-03-01;AR;Argentina;0;0;0;0
2020-03-02;AR;Argentina;0;0;0;0
2020-03-03;AR;Argentina;1;0;1;0
2020-03-04;AR;Argentina;0;0;1;0
2020-03-05;AR;Argentina;0;0;1;0
2020-03-06;AR;Argentina;1;0;2;0
2020-03-07;AR;Argentina;6;0;8;0
2020-03-08;AR;Argentina;4;1;12;1
2020-03-09;AR;Argentina;0;0;12;1
2020-03-10;AR;Argentina;5;0;17;1
2020-03-11;AR;Argentina;2;0;19;1
2020-03-12;AR;Argentina;0;0;19;1
2020-03-13;AR;Argentina;12;1;31;2
2020-03-14;AR;Argentina;3;0;34;2
2020-03-15;AR;Argentina;11;0;45;2
2020-03-16;AR;Argentina;11;0;56;2
2020-03-17;AR;Argentina;12;0;68;2
2020-03-18;AR;Argentina;11;0;79;2
2020-03-19;AR;Argentina;18;1;97;3
2020-03-20;AR;Argentina;31;0;128;3
2020-03-21;AR;Argentina;30;1;158;4
2020-03-22;AR;Argentina;108;0;266;4
2020-03-23;AR;Argentina;35;0;301;4
2020-03-24;AR;Argentina;86;2;387;6
2020-03-25;AR;Argentina;0;2;387;8
2020-03-26;AR;Argentina;115;1;502;9
2020-03-27;AR;Argentina;87;4;589;13
2020-03-28;AR;Argentina;101;5;690;18
2020-03-29;AR;Argentina;55;1;745;19
2020-03-30;AR;Argentina;75;4;820;23
2020-03-31;AR;Argentina;234;4;1054;27
2020-04-01;AR;Argentina;0;1;1054;28
2020-04-02;AR;Argentina;79;8;1133;36
2020-04-03;AR;Argentina;132;3;1265;39
2020-04-04;AR;Argentina;186;4;1451;43
2020-04-05;AR;Argentina;0;1;1451;44
2020-04-06;AR;Argentina;103;4;1554;48
2020-04-07;AR;Argentina;74;8;1628;56
2020-04-08;AR;Argentina;87;7;1715;63
2020-04-09;AR;Argentina;80;9;1795;72
2020-04-10;AR;Argentina;180;10;1975;82
2020-04-11;AR;Argentina;0;1;1975;83
2020-04-12;AR;Argentina;167;7;2142;90
2020-04-13;AR;Argentina;66;7;2208;97
2020-04-14;AR;Argentina;69;5;2277;102
2020-04-15;AR;Argentina;166;9;2443;111
2020-04-16;AR;Argentina;128;4;2571;115
2020-04-17;AR;Argentina;98;8;2669;123
2020-04-18;AR;Argentina;89;6;2758;129
2020-04-19;AR;Argentina;81;3;2839;132
2020-04-20;AR;Argentina;102;4;2941;136
2020-04-21;AR;Argentina;90;11;3031;147
2020-04-22;AR;Argentina;113;5;3144;152
2020-04-23;AR;Argentina;291;13;3435;165
2020-04-24;AR;Argentina;172;11;3607;176
2020-04-25;AR;Argentina;173;9;3780;185
2020-04-26;AR;Argentina;112;7;3892;192
2020-04-27;AR;Argentina;111;5;4003;197
2020-04-28;AR;Argentina;124;10;4127;207
2020-04-29;AR;Argentina;158;7;4285;214
2020-04-30;AR;Argentina;143;4;4428;218
2020-05-01;AR;Argentina;104;7;4532;225
2020-05-02;AR;Argentina;149;12;4681;237
2020-05-03;AR;Argentina;102;9;4783;246
2020-05-04;AR;Argentina;104;14;4887;260
2020-05-05;AR;Argentina;133;4;5020;264
2020-05-06;AR;Argentina;188;9;5208;273
2020-05-07;AR;Argentina;163;9;5371;282
2020-05-08;AR;Argentina;240;11;5611;293
2020-05-09;AR;Argentina;165;7;5776;300
2020-05-10;AR;Argentina;258;5;6034;305
2020-05-11;AR;Argentina;244;9;6278;314
2020-05-12;AR;Argentina;285;5;6563;319
2020-05-13;AR;Argentina;316;10;6879;329
2020-05-14;AR;Argentina;255;24;7134;353
2020-05-15;AR;Argentina;345;3;7479;356
2020-05-16;AR;Argentina;326;7;7805;363
2020-05-17;AR;Argentina;263;10;8068;373
2020-05-18;AR;Argentina;303;9;8371;382
2020-05-19;AR;Argentina;438;11;8809;393
2020-05-20;AR;Argentina;474;10;9283;403
2020-05-21;AR;Argentina;648;13;9931;416
2020-05-22;AR;Argentina;718;17;10649;433
2020-05-23;AR;Argentina;704;12;11353;445
2020-05-24;AR;Argentina;723;7;12076;452
2020-05-25;AR;Argentina;552;15;12628;467
2020-05-26;AR;Argentina;600;17;13228;484
2020-05-27;AR;Argentina;705;16;13933;500
2020-05-28;AR;Argentina;769;8;14702;508
2020-05-29;AR;Argentina;717;12;15419;520
2020-05-30;AR;Argentina;795;8;16214;528
2020-05-31;AR;Argentina;637;11;16851;539
2020-06-01;AR;Argentina;564;17;17415;556
2020-06-02;AR;Argentina;904;13;18319;569
2020-06-03;AR;Argentina;949;14;19268;583
2020-06-04;AR;Argentina;929;25;20197;608
2020-06-05;AR;Argentina;840;24;21037;632
2020-06-06;AR;Argentina;983;16;22020;648
2020-06-07;AR;Argentina;774;16;22794;664
2020-06-08;AR;Argentina;826;29;23620;693
2020-06-09;AR;Argentina;1141;24;24761;717
2020-06-10;AR;Argentina;1226;18;25987;735
2020-06-11;AR;Argentina;1386;30;27373;765
2020-06-12;AR;Argentina;1391;20;28764;785
2020-06-13;AR;Argentina;1531;30;30295;815
2020-06-14;AR;Argentina;1282;18;31577;833
2020-06-15;AR;Argentina;1208;21;32785;854
2020-06-16;AR;Argentina;1374;24;34159;878
2020-06-17;AR;Argentina;1393;35;35552;913
2020-06-18;AR;Argentina;1958;35;37510;948
2020-06-19;AR;Argentina;2060;31;39570;979
2020-06-20;AR;Argentina;1634;13;41204;992
2020-06-21;AR;Argentina;1581;19;42785;1011
2020-06-22;AR;Argentina;2146;32;44931;1043
2020-06-23;AR;Argentina;2272;35;47203;1078
2020-06-24;AR;Argentina;2648;38;49851;1116
2020-06-25;AR;Argentina;2606;34;52457;1150
2020-06-26;AR;Argentina;2886;34;55343;1184
2020-06-27;AR;Argentina;2401;23;57744;1207
2020-06-28;AR;Argentina;2189;25;59933;1232
2020-06-29;AR;Argentina;2335;48;62268;1280
2020-06-30;AR;Argentina;2262;27;64530;1307
2020-07-01;AR;Argentina;2667;44;67197;1351
2020-07-02;AR;Argentina;2744;34;69941;1385
2020-07-03;AR;Argentina;2845;52;72786;1437
2020-07-04;AR;Argentina;2590;44;75376;1481
2020-07-05;AR;Argentina;2439;26;77815;1507
2020-07-06;AR;Argentina;2632;75;80447;1582
2020-07-07;AR;Argentina;2979;62;83426;1644
2020-07-08;AR;Argentina;3604;50;87030;1694
2020-07-09;AR;Argentina;3663;26;90693;1720
2020-07-10;AR;Argentina;3367;54;94060;1774
2020-07-11;AR;Argentina;3449;36;97509;1810
2020-07-12;AR;Argentina;2657;35;100166;1845
2020-07-13;AR;Argentina;3099;58;103265;1903
2020-07-14;AR;Argentina;3645;65;106910;1968
2020-07-15;AR;Argentina;4236;82;111146;2050
2020-07-16;AR;Argentina;3637;62;114783;2112
2020-07-17;AR;Argentina;4518;66;119301;2178
2020-07-18;AR;Argentina;3223;42;122524;2220
2020-07-19;AR;Argentina;4231;40;126755;2260
2020-07-20;AR;Argentina;4019;113;130774;2373
2020-07-21;AR;Argentina;5344;117;136118;2490
2020-07-22;AR;Argentina;5782;98;141900;2588
2020-07-23;AR;Argentina;6127;114;148027;2702
2020-07-24;AR;Argentina;5493;105;153520;2807
2020-07-25;AR;Argentina;4814;86;158334;2893
2020-07-26;AR;Argentina;4192;46;162526;2939
2020-07-27;AR;Argentina;4890;120;167416;3059
2020-07-28;AR;Argentina;5939;120;173355;3179
2020-07-29;AR;Argentina;5641;109;178996;3288
2020-07-30;AR;Argentina;6377;153;185373;3441
2020-07-31;AR;Argentina;5929;102;191302;3543
2020-08-01;AR;Argentina;5241;53;196543;3596
2020-08-02;AR;Argentina;5376;52;201919;3648
2020-08-03;AR;Argentina;4824;165;206743;3813
2020-08-04;AR;Argentina;6792;166;213535;3979
2020-08-05;AR;Argentina;7147;127;220682;4106
2020-08-06;AR;Argentina;7513;145;228195;4251
2020-08-07;AR;Argentina;7482;160;235677;4411
2020-08-08;AR;Argentina;6134;112;241811;4523
2020-08-09;AR;Argentina;4688;83;246499;4606
2020-08-10;AR;Argentina;7369;158;253868;4764
2020-08-11;AR;Argentina;7043;240;260911;5004
2020-08-12;AR;Argentina;7663;209;268574;5213
2020-08-13;AR;Argentina;7498;149;276072;5362
2020-08-14;AR;Argentina;6365;165;282437;5527
2020-08-15;AR;Argentina;6663;110;289100;5637
2020-08-16;AR;Argentina;5469;66;294569;5703
2020-08-17;AR;Argentina;4557;111;299126;5814
2020-08-18;AR;Argentina;6840;234;305966;6048
2020-08-19;AR;Argentina;6693;282;312659;6330
2020-08-20;AR;Argentina;8225;187;320884;6517
2020-08-21;AR;Argentina;8159;213;329043;6730
2020-08-22;AR;Argentina;7759;118;336802;6848
2020-08-23;AR;Argentina;5352;137;342154;6985
2020-08-24;AR;Argentina;8713;381;350867;7366
2020-08-25;AR;Argentina;8771;197;359638;7563
2020-08-26;AR;Argentina;10550;276;370188;7839
2020-08-27;AR;Argentina;10104;211;380292;8050
2020-08-28;AR;Argentina;11717;221;392009;8271
2020-08-29;AR;Argentina;9230;82;401239;8353
2020-08-30;AR;Argentina;7187;104;408426;8457
2020-08-31;AR;Argentina;9309;203;417735;8660
2020-09-01;AR;Argentina;10504;259;428239;8919
2020-09-02;AR;Argentina;10933;199;439172;9118
2020-09-03;AR;Argentina;12026;243;451198;9361
2020-09-04;AR;Argentina;10684;262;461882;9623
2020-09-05;AR;Argentina;9924;116;471806;9739
2020-09-06;AR;Argentina;6986;120;478792;9859
2020-09-07;AR;Argentina;9215;270;488007;10129
2020-09-08;AR;Argentina;12027;276;500034;10405
2020-09-09;AR;Argentina;12259;253;512293;10658
2020-09-10;AR;Argentina;11905;249;524198;10907
2020-09-11;AR;Argentina;11507;241;535705;11148
2020-09-12;AR;Argentina;10776;115;546481;11263
2020-09-13;AR;Argentina;9056;89;555537;11352
2020-09-14;AR;Argentina;9909;315;565446;11667
2020-09-15;AR;Argentina;11892;185;577338;11852
2020-09-16;AR;Argentina;11674;264;589012;12116
2020-09-17;AR;Argentina;12701;344;601713;12460
2020-09-18;AR;Argentina;11945;196;613658;12656
2020-09-19;AR;Argentina;9276;143;622934;12799
2020-09-20;AR;Argentina;8431;254;631365;13053
2020-09-21;AR;Argentina;8782;429;640147;13482
2020-09-22;AR;Argentina;12027;470;652174;13952
2020-09-23;AR;Argentina;12625;424;664799;14376
2020-09-24;AR;Argentina;13467;390;678266;14766
2020-09-25;AR;Argentina;12969;442;691235;15208
2020-09-26;AR;Argentina;11249;335;702484;15543
2020-09-27;AR;Argentina;8841;206;711325;15749
2020-09-28;AR;Argentina;11807;364;723132;16113
2020-09-29;AR;Argentina;13477;406;736609;16519
2020-09-30;AR;Argentina;14392;418;751001;16937
2020-10-01;AR;Argentina;14001;3351;765002;20288
2020-10-02;AR;Argentina;14687;311;779689;20599
2020-10-03;AR;Argentina;11129;196;790818;20795
2020-10-04;AR;Argentina;7668;223;798486;21018
2020-10-05;AR;Argentina;11242;450;809728;21468
2020-10-06;AR;Argentina;14740;359;824468;21827
2020-10-07;AR;Argentina;16447;399;840915;22226
2020-10-08;AR;Argentina;15454;484;856369;22710
2020-10-09;AR;Argentina;15099;515;871468;23225
2020-10-10;AR;Argentina;12414;356;883882;23581
2020-10-11;AR;Argentina;10324;287;894206;23868
2020-10-12;AR;Argentina;9524;318;903730;24186
2020-10-13;AR;Argentina;13305;386;917035;24572
2020-10-14;AR;Argentina;14932;349;931967;24921
2020-10-15;AR;Argentina;17096;421;949063;25342
2020-10-16;AR;Argentina;16546;381;965609;25723
2020-10-17;AR;Argentina;13510;384;979119;26107
2020-10-18;AR;Argentina;10561;160;989680;26267
2020-10-19;AR;Argentina;12982;449;1002662;26716
2020-10-20;AR;Argentina;16337;384;1018999;27100
2020-10-21;AR;Argentina;18326;419;1037325;27519
2020-10-22;AR;Argentina;16325;438;1053650;27957
2020-10-23;AR;Argentina;15718;381;1069368;28338
2020-10-24;AR;Argentina;11968;275;1081336;28613
2020-10-25;AR;Argentina;9253;283;1090589;28896
2020-10-26;AR;Argentina;11712;405;1102301;29301
2020-10-27;AR;Argentina;14308;429;1116609;29730
2020-10-28;AR;Argentina;13924;341;1130533;30071
2020-10-29;AR;Argentina;13267;371;1143800;30442
2020-10-30;AR;Argentina;13379;350;1157179;30792
2020-10-31;AR;Argentina;9745;210;1166924;31002
2020-11-01;AR;Argentina;6609;138;1173533;31140
2020-11-02;AR;Argentina;9598;483;1183131;31623
2020-11-03;AR;Argentina;12145;429;1195276;32052
2020-11-04;AR;Argentina;10652;468;1205928;32520
2020-11-05;AR;Argentina;11100;246;1217028;32766
2020-11-06;AR;Argentina;11786;370;1228814;33136
2020-11-07;AR;Argentina;8037;212;1236851;33348
2020-11-08;AR;Argentina;5331;212;1242182;33560
2020-11-09;AR;Argentina;8317;347;1250499;33907
2020-11-10;AR;Argentina;11977;276;1262476;34183
2020-11-11;AR;Argentina;10880;348;1273356;34531
2020-11-12;AR;Argentina;11163;251;1284519;34782
2020-11-13;AR;Argentina;11859;263;1296378;35045
2020-11-14;AR;Argentina;8468;262;1304846;35307
2020-11-15;AR;Argentina;5645;129;1310491;35436
2020-11-16;AR;Argentina;7893;291;1318384;35727
2020-11-17;AR;Argentina;10621;379;1329005;36106
2020-11-18;AR;Argentina;10332;241;1339337;36347
2020-11-19;AR;Argentina;10097;185;1349434;36532
2020-11-20;AR;Argentina;9608;258;1359042;36790
2020-11-21;AR;Argentina;7140;112;1366182;36902
2020-11-22;AR;Argentina;4184;100;1370366;37002
2020-11-23;AR;Argentina;4265;120;1374631;37122
2020-11-24;AR;Argentina;7164;310;1381795;37432
2020-11-25;AR;Argentina;8593;282;1390388;37714
2020-11-26;AR;Argentina;9043;227;1399431;37941
2020-11-27;AR;Argentina;7846;275;1407277;38216
2020-11-28;AR;Argentina;6098;106;1413375;38322
2020-11-29;AR;Argentina;5432;151;1418807;38473
2020-11-30;AR;Argentina;5726;257;1424533;38730
2020-12-01;AR;Argentina;8037;198;1432570;38928
2020-12-02;AR;Argentina;7533;228;1440103;39156
2020-12-03;AR;Argentina;7629;149;1447732;39305
2020-12-04;AR;Argentina;6899;207;1454631;39512
2020-12-05;AR;Argentina;5201;120;1459832;39632
2020-12-06;AR;Argentina;3278;138;1463110;39770
2020-12-07;AR;Argentina;3199;118;1466309;39888
2020-12-08;AR;Argentina;3610;121;1469919;40009
2020-12-09;AR;Argentina;5303;213;1475222;40222
2020-12-10;AR;Argentina;6994;209;1482216;40431
2020-12-11;AR;Argentina;7112;175;1489328;40606
2020-12-12;AR;Argentina;5274;62;1494602;40668
2020-12-13;AR;Argentina;3558;98;1498160;40766
2020-12-14;AR;Argentina;5062;275;1503222;41041
2020-12-15;AR;Argentina;6981;163;1510203;41204
2020-12-16;AR;Argentina;6843;161;1517046;41365
2020-12-17;AR;Argentina;7326;169;1524372;41534
2020-12-18;AR;Argentina;7002;138;1531374;41672
2020-12-19;AR;Argentina;5795;91;1537169;41763
2020-12-20;AR;Argentina;4116;50;1541285;41813
2020-12-21;AR;Argentina;5853;184;1547138;41997
2020-12-22;AR;Argentina;8141;257;1555279;42254
2020-12-23;AR;Argentina;8586;60;1563865;42314
2020-12-24;AR;Argentina;0;0;1563865;42314
2020-12-25;AR;Argentina;10689;108;1574554;42422
2020-12-26;AR;Argentina;3713;79;1578267;42501
2020-12-27;AR;Argentina;5030;149;1583297;42650
2020-12-28;AR;Argentina;7216;218;1590513;42868
2020-12-29;AR;Argentina;11650;150;1602163;43018
2020-12-30;AR;Argentina;11765;145;1613928;43163
2020-12-31;AR;Argentina;11586;82;1625514;43245
2021-01-01;AR;Argentina;4080;74;1629594;43319
2021-01-02;AR;Argentina;5240;56;1634834;43375
2021-01-03;AR;Argentina;5884;107;1640718;43482
2021-01-04;AR;Argentina;8222;152;1648940;43634
2021-01-05;AR;Argentina;13790;151;1662730;43785
2021-01-06;AR;Argentina;13441;191;1676171;43976
2021-01-07;AR;Argentina;13835;146;1690006;44122
2021-01-08;AR;Argentina;13346;151;1703352;44273
2021-01-09;AR;Argentina;11057;144;1714409;44417
2021-01-10;AR;Argentina;7808;78;1722217;44495
2021-01-11;AR;Argentina;8704;159;1730921;44654
2021-01-12;AR;Argentina;13783;194;1744704;44848
2021-01-13;AR;Argentina;12725;135;1757429;44983
2021-01-14;AR;Argentina;13286;142;1770715;45125
2021-01-15;AR;Argentina;12332;102;1783047;45227
2021-01-16;AR;Argentina;8932;68;1791979;45295
2021-01-17;AR;Argentina;7264;112;1799243;45407
2021-01-18;AR;Argentina;8185;425;1807428;45832
2021-01-19;AR;Argentina;12141;234;1819569;46066
2021-01-20;AR;Argentina;12112;150;1831681;46216
2021-01-21;AR;Argentina;11396;139;1843077;46355
2021-01-22;AR;Argentina;10753;220;1853830;46575
2021-01-23;AR;Argentina;8362;162;1862192;46737
2021-01-24;AR;Argentina;5031;90;1867223;46827
2021-01-25;AR;Argentina;7578;207;1874801;47034
2021-01-26;AR;Argentina;10409;219;1885210;47253
2021-01-27;AR;Argentina;10843;182;1896053;47435
2021-01-28;AR;Argentina;9471;166;1905524;47601
2021-01-29;AR;Argentina;9838;174;1915362;47775
2021-01-30;AR;Argentina;6902;156;1922264;47931
2021-01-31;AR;Argentina;4975;43;1927239;47974
2021-02-01;AR;Argentina;6614;275;1933853;48249
2021-02-02;AR;Argentina;9695;177;1943548;48426
2021-02-03;AR;Argentina;9196;113;1952744;48539
2021-02-04;AR;Argentina;8891;161;1961635;48700
2021-02-05;AR;Argentina;8374;285;1970009;48985
2021-02-06;AR;Argentina;6680;125;1976689;49110
2021-02-07;AR;Argentina;3658;61;1980347;49171
2021-02-08;AR;Argentina;5154;227;1985501;49398
2021-02-09;AR;Argentina;7794;168;1993295;49566
2021-02-10;AR;Argentina;7739;108;2001034;49674
2021-02-11;AR;Argentina;7311;200;2008345;49874
2021-02-12;AR;Argentina;7151;155;2015496;50029
2021-02-13;AR;Argentina;6057;159;2021553;50188
2021-02-14;AR;Argentina;4245;48;2025798;50236
2021-02-15;AR;Argentina;3259;91;2029057;50327
2021-02-16;AR;Argentina;4003;105;2033060;50432
2021-02-17;AR;Argentina;6064;184;2039124;50616
2021-02-18;AR;Argentina;7671;241;2046795;50857
2021-02-19;AR;Argentina;7886;143;2054681;51000
2021-02-20;AR;Argentina;5944;122;2060625;51122
2021-02-21;AR;Argentina;3709;76;2064334;51198
2021-02-22;AR;Argentina;5417;161;2069751;51359
2021-02-23;AR;Argentina;7477;151;2077228;51510
2021-02-24;AR;Argentina;8183;140;2085411;51650
2021-02-25;AR;Argentina;8234;145;2093645;51795
2021-02-26;AR;Argentina;5083;92;2098728;51887
2021-02-27;AR;Argentina;5469;59;2104197;51946
2021-02-28;AR;Argentina;3168;19;2107365;51965
2021-03-01;AR;Argentina;4658;112;2112023;52077
2021-03-02;AR;Argentina;6653;115;2118676;52192
2021-03-03;AR;Argentina;7855;261;2126531;52453
2021-03-04;AR;Argentina;7432;191;2133963;52644
2021-03-05;AR;Argentina;7891;140;2141854;52784
2021-03-06;AR;Argentina;4860;86;2146714;52870
2021-03-07;AR;Argentina;2922;10;2149636;52880
2021-03-08;AR;Argentina;5058;241;2154694;53121
2021-03-09;AR;Argentina;7307;131;2162001;53252
2021-03-10;AR;Argentina;7693;107;2169694;53359
2021-03-11;AR;Argentina;8204;134;2177898;53493
2021-03-12;AR;Argentina;7849;85;2185747;53578
2021-03-13;AR;Argentina;6278;68;2192025;53646
2021-03-14;AR;Argentina;3697;24;2195722;53670
2021-03-15;AR;Argentina;6164;166;2201886;53836
2021-03-16;AR;Argentina;8235;200;2210121;54036
2021-03-17;AR;Argentina;8304;195;2218425;54231
2021-03-18;AR;Argentina;8328;155;2226753;54386
2021-03-19;AR;Argentina;8160;90;2234913;54476
2021-03-20;AR;Argentina;6826;41;2241739;54517
2021-03-21;AR;Argentina;4032;28;2245771;54545
2021-03-22;AR;Argentina;6401;126;2252172;54671
2021-03-23;AR;Argentina;9405;152;2261577;54823
2021-03-24;AR;Argentina;8300;123;2269877;54946
2021-03-25;AR;Argentina;8238;146;2278115;55092
2021-03-26;AR;Argentina;12936;143;2291051;55235
2021-03-27;AR;Argentina;10338;133;2301389;55368
2021-03-28;AR;Argentina;7208;81;2308597;55449
2021-03-29;AR;Argentina;14014;162;2322611;55611
2021-03-30;AR;Argentina;10154;125;2332765;55736
2021-03-31;AR;Argentina;16056;122;2348821;55858
2021-04-01;AR;Argentina;14430;83;2363251;55941
2021-04-02;AR;Argentina;9902;82;2373153;56023
2021-04-03;AR;Argentina;10384;83;2383537;56106
2021-04-04;AR;Argentina;9955;93;2393492;56199
2021-04-05;AR;Argentina;13667;272;2407159;56471
2021-04-06;AR;Argentina;20870;163;2428029;56634
2021-04-07;AR;Argentina;22039;198;2450068;56832
2021-04-08;AR;Argentina;23683;290;2473751;57122
2021-04-09;AR;Argentina;24130;228;2497881;57350
2021-04-10;AR;Argentina;19419;297;2517300;57647
2021-04-11;AR;Argentina;15262;132;2532562;57779
2021-04-12;AR;Argentina;19437;178;2551999;57957
2021-04-13;AR;Argentina;27001;217;2579000;58174
2021-04-14;AR;Argentina;25157;368;2604157;58542
2021-04-15;AR;Argentina;24999;383;2629156;58925
2021-04-16;AR;Argentina;29472;159;2658628;59084
2021-04-17;AR;Argentina;19119;80;2677747;59164
2021-04-18;AR;Argentina;16267;64;2694014;59228
2021-04-19;AR;Argentina;20461;248;2714475;59476
2021-04-20;AR;Argentina;29145;316;2743620;59792
2021-04-21;AR;Argentina;25932;291;2769552;60083
2021-04-22;AR;Argentina;27216;537;2796768;60620
2021-04-23;AR;Argentina;27884;556;2824652;61176
2021-04-24;AR;Argentina;21220;298;2845872;61474
2021-04-25;AR;Argentina;15012;170;2860884;61644
2021-04-26;AR;Argentina;18793;443;2879677;62087
2021-04-27;AR;Argentina;25495;512;2905172;62599
2021-04-28;AR;Argentina;23718;348;2928890;62947
2021-04-29;AR;Argentina;26053;561;2954943;63508
2021-04-30;AR;Argentina;22420;357;2977363;63865
2021-05-01;AR;Argentina;16502;231;2993865;64096
2021-05-02;AR;Argentina;11394;156;3005259;64252
2021-05-03;AR;Argentina;15920;540;3021179;64792
2021-05-04;AR;Argentina;26238;410;3047417;65202
2021-05-05;AR;Argentina;24079;663;3071496;65865
2021-05-06;AR;Argentina;24086;398;3095582;66263
2021-05-07;AR;Argentina;22552;609;3118134;66872
2021-05-08;AR;Argentina;18024;170;3136158;67042
2021-05-09;AR;Argentina;11582;283;3147740;67325
2021-05-10;AR;Argentina;17381;496;3165121;67821
2021-05-11;AR;Argentina;25976;490;3191097;68311
2021-05-12;AR;Argentina;24475;496;3215572;68807
2021-05-13;AR;Argentina;26531;447;3242103;69254
2021-05-14;AR;Argentina;27363;599;3269466;69853
2021-05-15;AR;Argentina;21469;400;3290935;70253
2021-05-16;AR;Argentina;16350;269;3307285;70522
2021-05-17;AR;Argentina;28680;505;3335965;71027
2021-05-18;AR;Argentina;35543;744;3371508;71771
2021-05-19;AR;Argentina;39652;494;3411160;72265
2021-05-20;AR;Argentina;35884;434;3447044;72699
2021-05-21;AR;Argentina;35468;692;3482512;73391
2021-05-22;AR;Argentina;32171;297;3514683;73688
2021-05-23;AR;Argentina;24801;375;3539484;74063
2021-05-24;AR;Argentina;22651;417;3562135;74480
2021-05-25;AR;Argentina;24601;576;3586736;75056
2021-05-26;AR;Argentina;35399;532;3622135;75588
2021-05-27;AR;Argentina;41080;547;3663215;76135
2021-05-28;AR;Argentina;39207;558;3702422;76693
2021-05-29;AR;Argentina;29841;415;3732263;77108
2021-05-30;AR;Argentina;21346;348;3753609;77456
2021-05-31;AR;Argentina;28175;637;3781784;78093
2021-06-01;AR;Argentina;35355;640;3817139;78733
2021-06-02;AR;Argentina;35017;587;3852156;79320
2021-06-03;AR;Argentina;32291;553;3884447;79873
2021-06-04;AR;Argentina;30950;538;3915397;80411
2021-06-05;AR;Argentina;23627;456;3939024;80867
2021-06-06;AR;Argentina;16415;347;3955439;81214
2021-06-07;AR;Argentina;22195;732;3977634;81946
2021-06-08;AR;Argentina;31137;721;4008771;82667
2021-06-09;AR;Argentina;29757;605;4038528;83272
2021-06-10;AR;Argentina;27628;669;4066156;83941
2021-06-11;AR;Argentina;26934;687;4093090;84628
2021-06-12;AR;Argentina;18057;447;4111147;85075
2021-06-13;AR;Argentina;13043;268;4124190;85343
2021-06-14;AR;Argentina;21292;686;4145482;86029
2021-06-15;AR;Argentina;27260;586;4172742;86615
2021-06-16;AR;Argentina;25878;646;4198620;87261
2021-06-17;AR;Argentina;23780;528;4222400;87789
2021-06-18;AR;Argentina;20363;458;4242763;88247
2021-06-19;AR;Argentina;15631;495;4258394;88742
2021-06-20;AR;Argentina;10395;301;4268789;89043
2021-06-21;AR;Argentina;8606;447;4277395;89490
2021-06-22;AR;Argentina;21387;791;4298782;90281
2021-06-23;AR;Argentina;27319;705;4326101;90986
2021-06-24;AR;Argentina;24463;452;4350564;91438
2021-06-25;AR;Argentina;24023;541;4374587;91979
2021-06-26;AR;Argentina;18555;338;4393142;92317
2021-06-27;AR;Argentina;12105;251;4405247;92568
2021-06-28;AR;Argentina;18389;574;4423636;93142
2021-06-29;AR;Argentina;24065;526;4447701;93668
2021-06-30;AR;Argentina;22673;636;4470374;94304
2021-07-01;AR;Argentina;21177;468;4491551;94772
2020-03-01;AM;Armenia;1;0;1;0
2020-03-02;AM;Armenia;0;0;1;0
2020-03-03;AM;Armenia;0;0;1;0
2020-03-04;AM;Armenia;0;0;1;0
2020-03-05;AM;Armenia;0;0;1;0
2020-03-06;AM;Armenia;0;0;1;0
2020-03-07;AM;Armenia;0;0;1;0
2020-03-08;AM;Armenia;0;0;1;0
2020-03-09;AM;Armenia;0;0;1;0
2020-03-10;AM;Armenia;0;0;1;0
2020-03-11;AM;Armenia;0;0;1;0
2020-03-12;AM;Armenia;3;0;4;0
2020-03-13;AM;Armenia;4;0;8;0
2020-03-14;AM;Armenia;10;0;18;0
2020-03-15;AM;Armenia;8;0;26;0
2020-03-16;AM;Armenia;26;0;52;0
2020-03-17;AM;Armenia;26;0;78;0
2020-03-18;AM;Armenia;6;0;84;0
2020-03-19;AM;Armenia;31;0;115;0
2020-03-20;AM;Armenia;21;0;136;0
2020-03-21;AM;Armenia;24;0;160;0
2020-03-22;AM;Armenia;34;0;194;0
2020-03-23;AM;Armenia;41;0;235;0
2020-03-24;AM;Armenia;14;0;249;0
2020-03-25;AM;Armenia;16;0;265;0
2020-03-26;AM;Armenia;25;1;290;1
2020-03-27;AM;Armenia;39;0;329;1
2020-03-28;AM;Armenia;78;0;407;1
2020-03-29;AM;Armenia;17;2;424;3
2020-03-30;AM;Armenia;58;0;482;3
2020-03-31;AM;Armenia;50;0;532;3
2020-04-01;AM;Armenia;39;1;571;4
2020-04-02;AM;Armenia;92;3;663;7
2020-04-03;AM;Armenia;73;0;736;7
2020-04-04;AM;Armenia;34;0;770;7
2020-04-05;AM;Armenia;52;0;822;7
2020-04-06;AM;Armenia;11;1;833;8
2020-04-07;AM;Armenia;20;0;853;8
2020-04-08;AM;Armenia;28;1;881;9
2020-04-09;AM;Armenia;40;1;921;10
2020-04-10;AM;Armenia;16;2;937;12
2020-04-11;AM;Armenia;30;1;967;13
2020-04-12;AM;Armenia;46;0;1013;13
2020-04-13;AM;Armenia;26;1;1039;14
2020-04-14;AM;Armenia;28;2;1067;16
2020-04-15;AM;Armenia;44;1;1111;17
2020-04-16;AM;Armenia;48;1;1159;18
2020-04-17;AM;Armenia;42;1;1201;19
2020-04-18;AM;Armenia;47;1;1248;20
2020-04-19;AM;Armenia;43;0;1291;20
2020-04-20;AM;Armenia;48;2;1339;22
2020-04-21;AM;Armenia;62;2;1401;24
2020-04-22;AM;Armenia;72;0;1473;24
2020-04-23;AM;Armenia;50;0;1523;24
2020-04-24;AM;Armenia;73;3;1596;27
2020-04-25;AM;Armenia;81;1;1677;28
2020-04-26;AM;Armenia;69;0;1746;28
2020-04-27;AM;Armenia;62;1;1808;29
2020-04-28;AM;Armenia;59;1;1867;30
2020-04-29;AM;Armenia;65;0;1932;30
2020-04-30;AM;Armenia;134;2;2066;32
2020-05-01;AM;Armenia;82;1;2148;33
2020-05-02;AM;Armenia;125;0;2273;33
2020-05-03;AM;Armenia;113;2;2386;35
2020-05-04;AM;Armenia;121;4;2507;39
2020-05-05;AM;Armenia;112;1;2619;40
2020-05-06;AM;Armenia;163;0;2782;40
2020-05-07;AM;Armenia;102;2;2884;42
2020-05-08;AM;Armenia;145;1;3029;43
2020-05-09;AM;Armenia;146;1;3175;44
2020-05-10;AM;Armenia;138;1;3313;45
2020-05-11;AM;Armenia;79;1;3392;46
2020-05-12;AM;Armenia;146;1;3538;47
2020-05-13;AM;Armenia;180;1;3718;48
2020-05-14;AM;Armenia;142;1;3860;49
2020-05-15;AM;Armenia;184;3;4044;52
2020-05-16;AM;Armenia;239;3;4283;55
2020-05-17;AM;Armenia;189;5;4472;60
2020-05-18;AM;Armenia;351;1;4823;61
2020-05-19;AM;Armenia;218;3;5041;64
2020-05-20;AM;Armenia;230;3;5271;67
2020-05-21;AM;Armenia;335;3;5606;70
2020-05-22;AM;Armenia;322;4;5928;74
2020-05-23;AM;Armenia;374;3;6302;77
2020-05-24;AM;Armenia;359;4;6661;81
2020-05-25;AM;Armenia;452;6;7113;87
2020-05-26;AM;Armenia;289;4;7402;91
2020-05-27;AM;Armenia;372;7;7774;98
2020-05-28;AM;Armenia;442;15;8216;113
2020-05-29;AM;Armenia;460;7;8676;120
2020-05-30;AM;Armenia;251;7;8927;127
2020-05-31;AM;Armenia;355;4;9282;131
2020-06-01;AM;Armenia;210;8;9492;139
2020-06-02;AM;Armenia;517;19;10009;158
2020-06-03;AM;Armenia;515;12;10524;170
2020-06-04;AM;Armenia;697;6;11221;176
2020-06-05;AM;Armenia;596;7;11817;183
2020-06-06;AM;Armenia;547;7;12364;190
2020-06-07;AM;Armenia;766;10;13130;200
2020-06-08;AM;Armenia;195;11;13325;211
2020-06-09;AM;Armenia;350;6;13675;217
2020-06-10;AM;Armenia;428;10;14103;227
2020-06-11;AM;Armenia;566;18;14669;245
2020-06-12;AM;Armenia;612;13;15281;258
2020-06-13;AM;Armenia;723;6;16004;264
2020-06-14;AM;Armenia;663;5;16667;269
2020-06-15;AM;Armenia;397;16;17064;285
2020-06-16;AM;Armenia;425;8;17489;293
2020-06-17;AM;Armenia;544;9;18033;302
2020-06-18;AM;Armenia;665;7;18698;309
2020-06-19;AM;Armenia;459;10;19157;319
2020-06-20;AM;Armenia;551;13;19708;332
2020-06-21;AM;Armenia;560;18;20268;350
2020-06-22;AM;Armenia;320;10;20588;360
2020-06-23;AM;Armenia;418;12;21006;372
2020-06-24;AM;Armenia;711;14;21717;386
2020-06-25;AM;Armenia;771;11;22488;397
2020-06-26;AM;Armenia;759;13;23247;410
2020-06-27;AM;Armenia;662;11;23909;421
2020-06-28;AM;Armenia;736;5;24645;426
2020-06-29;AM;Armenia;482;7;25127;433
2020-06-30;AM;Armenia;415;10;25542;443
2020-07-01;AM;Armenia;523;10;26065;453
2020-07-02;AM;Armenia;593;6;26658;459
2020-07-03;AM;Armenia;662;10;27320;469
2020-07-04;AM;Armenia;580;8;27900;477
2020-07-05;AM;Armenia;706;7;28606;484
2020-07-06;AM;Armenia;330;7;28936;491
2020-07-07;AM;Armenia;349;12;29285;503
2020-07-08;AM;Armenia;535;18;29820;521
2020-07-09;AM;Armenia;526;14;30346;535
2020-07-10;AM;Armenia;557;11;30903;546
2020-07-11;AM;Armenia;489;13;31392;559
2020-07-12;AM;Armenia;577;6;31969;565
2020-07-13;AM;Armenia;182;8;32151;573
2020-07-14;AM;Armenia;339;8;32490;581
2020-07-15;AM;Armenia;515;11;33005;592
2020-07-16;AM;Armenia;554;15;33559;607
2020-07-17;AM;Armenia;442;13;34001;620
2020-07-18;AM;Armenia;461;11;34462;631
2020-07-19;AM;Armenia;415;10;34877;641
2020-07-20;AM;Armenia;104;9;34981;650
2020-07-21;AM;Armenia;273;12;35254;662
2020-07-22;AM;Armenia;439;16;35693;678
2020-07-23;AM;Armenia;469;10;36162;688
2020-07-24;AM;Armenia;451;4;36613;692
2020-07-25;AM;Armenia;383;8;36996;700
2020-07-26;AM;Armenia;321;5;37317;705
2020-07-27;AM;Armenia;73;6;37390;711
2020-07-28;AM;Armenia;239;8;37629;719
2020-07-29;AM;Armenia;308;4;37937;723
2020-07-30;AM;Armenia;259;5;38196;728
2020-07-31;AM;Armenia;354;10;38550;738
2020-08-01;AM;Armenia;291;11;38841;749
2020-08-02;AM;Armenia;209;5;39050;754
2020-08-03;AM;Armenia;52;8;39102;762
2020-08-04;AM;Armenia;196;6;39298;768
2020-08-05;AM;Armenia;288;2;39586;770
2020-08-06;AM;Armenia;233;2;39819;772
2020-08-07;AM;Armenia;166;5;39985;777
2020-08-08;AM;Armenia;200;8;40185;785
2020-08-09;AM;Armenia;225;6;40410;791
2020-08-10;AM;Armenia;23;5;40433;796
2020-08-11;AM;Armenia;160;7;40593;803
2020-08-12;AM;Armenia;201;3;40794;806
2020-08-13;AM;Armenia;229;3;41023;809
2020-08-14;AM;Armenia;276;5;41299;814
2020-08-15;AM;Armenia;196;3;41495;817
2020-08-16;AM;Armenia;168;1;41663;818
2020-08-17;AM;Armenia;38;6;41701;824
2020-08-18;AM;Armenia;145;8;41846;832
2020-08-19;AM;Armenia;210;1;42056;833
2020-08-20;AM;Armenia;263;3;42319;836
2020-08-21;AM;Armenia;158;6;42477;842
2020-08-22;AM;Armenia;139;8;42616;850
2020-08-23;AM;Armenia;176;2;42792;852
2020-08-24;AM;Armenia;33;2;42825;854
2020-08-25;AM;Armenia;111;4;42936;858
2020-08-26;AM;Armenia;131;3;43067;861
2020-08-27;AM;Armenia;203;3;43270;864
2020-08-28;AM;Armenia;181;5;43451;869
2020-08-29;AM;Armenia;175;3;43626;872
2020-08-30;AM;Armenia;124;5;43750;877
2020-08-31;AM;Armenia;31;2;43781;879
2020-09-01;AM;Armenia;97;2;43878;881
2020-09-02;AM;Armenia;197;3;44075;884
2020-09-03;AM;Armenia;196;3;44271;887
2020-09-04;AM;Armenia;190;4;44461;891
2020-09-05;AM;Armenia;188;4;44649;895
2020-09-06;AM;Armenia;134;2;44783;897
2020-09-07;AM;Armenia;62;3;44845;900
2020-09-08;AM;Armenia;108;3;44953;903
2020-09-09;AM;Armenia;199;2;45152;905
2020-09-10;AM;Armenia;174;1;45326;906
2020-09-11;AM;Armenia;177;3;45503;909
2020-09-12;AM;Armenia;172;2;45675;911
2020-09-13;AM;Armenia;187;5;45862;916
2020-09-14;AM;Armenia;107;3;45969;919
2020-09-15;AM;Armenia;150;1;46119;920
2020-09-16;AM;Armenia;257;3;46376;923
2020-09-17;AM;Armenia;295;2;46671;925
2020-09-18;AM;Armenia;239;1;46910;926
2020-09-19;AM;Armenia;244;2;47154;928
2020-09-20;AM;Armenia;277;2;47431;930
2020-09-21;AM;Armenia;121;6;47552;936
2020-09-22;AM;Armenia;115;2;47667;938
2020-09-23;AM;Armenia;210;4;47877;942
2020-09-24;AM;Armenia;374;3;48251;945
2020-09-25;AM;Armenia;392;2;48643;947
2020-09-26;AM;Armenia;429;1;49072;948
2020-09-27;AM;Armenia;328;3;49400;951
2020-09-28;AM;Armenia;174;6;49574;957
2020-09-29;AM;Armenia;327;1;49901;958
2020-09-30;AM;Armenia;458;1;50359;959
2020-10-01;AM;Armenia;491;4;50850;963
2020-10-02;AM;Armenia;532;3;51382;966
2020-10-03;AM;Armenia;543;6;51925;972
2020-10-04;AM;Armenia;571;5;52496;977
2020-10-05;AM;Armenia;181;7;52677;984
2020-10-06;AM;Armenia;406;6;53083;990
2020-10-07;AM;Armenia;672;5;53755;995
2020-10-08;AM;Armenia;718;9;54473;1004
2020-10-09;AM;Armenia;614;6;55087;1010
2020-10-10;AM;Armenia;649;6;55736;1016
2020-10-11;AM;Armenia;715;4;56451;1020
2020-10-12;AM;Armenia;370;6;56821;1026
2020-10-13;AM;Armenia;745;6;57566;1032
2020-10-14;AM;Armenia;1058;7;58624;1039
2020-10-15;AM;Armenia;1371;7;59995;1046
2020-10-16;AM;Armenia;1465;10;61460;1056
2020-10-17;AM;Armenia;1540;11;63000;1067
2020-10-18;AM;Armenia;1694;14;64694;1081
2020-10-19;AM;Armenia;766;10;65460;1091
2020-10-20;AM;Armenia;1234;10;66694;1101
2020-10-21;AM;Armenia;1836;20;68530;1121
2020-10-22;AM;Armenia;2306;10;70836;1131
2020-10-23;AM;Armenia;2474;14;73310;1145
2020-10-24;AM;Armenia;2213;12;75523;1157
2020-10-25;AM;Armenia;2314;23;77837;1180
2020-10-26;AM;Armenia;973;16;78810;1196
2020-10-27;AM;Armenia;1600;26;80410;1222
2020-10-28;AM;Armenia;2241;21;82651;1243
2020-10-29;AM;Armenia;2383;29;85034;1272
2020-10-30;AM;Armenia;2398;28;87432;1300
2020-10-31;AM;Armenia;2381;41;89813;1341
2020-11-01;AM;Armenia;2441;22;92254;1363
2020-11-02;AM;Armenia;1194;28;93448;1391
2020-11-03;AM;Armenia;1328;22;94776;1413
2020-11-04;AM;Armenia;2374;35;97150;1448
2020-11-05;AM;Armenia;2413;28;99563;1476
2020-11-06;AM;Armenia;2210;30;101773;1506
2020-11-07;AM;Armenia;2476;27;104249;1533
2020-11-08;AM;Armenia;2175;26;106424;1559
2020-11-09;AM;Armenia;1042;21;107466;1580
2020-11-10;AM;Armenia;1221;29;108687;1609
2020-11-11;AM;Armenia;1861;27;110548;1636
2020-11-12;AM;Armenia;2132;32;112680;1668
2020-11-13;AM;Armenia;1703;29;114383;1697
2020-11-14;AM;Armenia;1472;41;115855;1738
2020-11-15;AM;Armenia;1482;25;117337;1763
2020-11-16;AM;Armenia;549;25;117886;1788
2020-11-17;AM;Armenia;984;23;118870;1811
2020-11-18;AM;Armenia;1589;28;120459;1839
2020-11-19;AM;Armenia;1520;31;121979;1870
2020-11-20;AM;Armenia;1667;30;123646;1900
2020-11-21;AM;Armenia;1193;31;124839;1931
2020-11-22;AM;Armenia;1385;21;126224;1952
2020-11-23;AM;Armenia;485;24;126709;1976
2020-11-24;AM;Armenia;813;26;127522;2002
2020-11-25;AM;Armenia;1563;38;129085;2040
2020-11-26;AM;Armenia;1785;28;130870;2068
2020-11-27;AM;Armenia;1476;22;132346;2090
2020-11-28;AM;Armenia;1248;31;133594;2121
2020-11-29;AM;Armenia;1174;21;134768;2142
2020-11-30;AM;Armenia;356;22;135124;2164
2020-12-01;AM;Armenia;843;29;135967;2193
2020-12-02;AM;Armenia;1264;35;137231;2228
2020-12-03;AM;Armenia;1277;26;138508;2254
2020-12-04;AM;Armenia;1184;23;139692;2277
2020-12-05;AM;Armenia;1267;32;140959;2309
2020-12-06;AM;Armenia;978;17;141937;2326
2020-12-07;AM;Armenia;407;18;142344;2344
2020-12-08;AM;Armenia;584;28;142928;2372
2020-12-09;AM;Armenia;1138;21;144066;2393
2020-12-10;AM;Armenia;1174;23;145240;2416
2020-12-11;AM;Armenia;1077;29;146317;2445
2020-12-12;AM;Armenia;995;17;147312;2462
2020-12-13;AM;Armenia;1013;24;148325;2486
2020-12-14;AM;Armenia;357;17;148682;2503
2020-12-15;AM;Armenia;438;26;149120;2529
2020-12-16;AM;Armenia;1098;27;150218;2556
2020-12-17;AM;Armenia;1174;25;151392;2581
2020-12-18;AM;Armenia;861;15;152253;2596
2020-12-19;AM;Armenia;920;20;153173;2616
2020-12-20;AM;Armenia;652;14;153825;2630
2020-12-21;AM;Armenia;240;26;154065;2656
2020-12-22;AM;Armenia;537;17;154602;2673
2020-12-23;AM;Armenia;838;18;155440;2691
2020-12-24;AM;Armenia;702;23;156142;2714
2020-12-25;AM;Armenia;621;19;156763;2733
2020-12-26;AM;Armenia;586;19;157349;2752
2020-12-27;AM;Armenia;485;16;157834;2768
2020-12-28;AM;Armenia;114;7;157948;2775
2020-12-29;AM;Armenia;348;22;158296;2797
2020-12-30;AM;Armenia;582;10;158878;2807
2020-12-31;AM;Armenia;531;16;159409;2823
2021-01-01;AM;Armenia;329;5;159738;2828
2021-01-02;AM;Armenia;60;8;159798;2836
2021-01-03;AM;Armenia;229;14;160027;2850
2021-01-04;AM;Armenia;193;14;160220;2864
2021-01-05;AM;Armenia;324;14;160544;2878
2021-01-06;AM;Armenia;309;12;160853;2890
2021-01-07;AM;Armenia;201;11;161054;2901
2021-01-08;AM;Armenia;361;7;161415;2908
2021-01-09;AM;Armenia;379;14;161794;2922
2021-01-10;AM;Armenia;337;7;162131;2929
2021-01-11;AM;Armenia;157;2;162288;2931
2021-01-12;AM;Armenia;355;10;162643;2941
2021-01-13;AM;Armenia;485;10;163128;2951
2021-01-14;AM;Armenia;448;12;163576;2963
2021-01-15;AM;Armenia;396;11;163972;2974
2021-01-16;AM;Armenia;263;13;164235;2987
2021-01-17;AM;Armenia;351;5;164586;2992
2021-01-18;AM;Armenia;90;6;164676;2998
2021-01-19;AM;Armenia;236;9;164912;3007
2021-01-20;AM;Armenia;309;9;165221;3016
2021-01-21;AM;Armenia;307;5;165528;3021
2021-01-22;AM;Armenia;183;9;165711;3030
2021-01-23;AM;Armenia;198;4;165909;3034
2021-01-24;AM;Armenia;127;5;166036;3039
2021-01-25;AM;Armenia;58;8;166094;3047
2021-01-26;AM;Armenia;138;5;166232;3052
2021-01-27;AM;Armenia;195;4;166427;3056
2021-01-28;AM;Armenia;242;11;166669;3067
2021-01-29;AM;Armenia;59;2;166728;3069
2021-01-30;AM;Armenia;173;2;166901;3071
2021-01-31;AM;Armenia;125;9;167026;3080
2021-02-01;AM;Armenia;62;4;167088;3084
2021-02-02;AM;Armenia;143;5;167231;3089
2021-02-03;AM;Armenia;190;7;167421;3096
2021-02-04;AM;Armenia;147;11;167568;3107
2021-02-05;AM;Armenia;158;2;167726;3109
2021-02-06;AM;Armenia;211;5;167937;3114
2021-02-07;AM;Armenia;151;3;168088;3117
2021-02-08;AM;Armenia;89;6;168177;3123
2021-02-09;AM;Armenia;123;3;168300;3126
2021-02-10;AM;Armenia;196;4;168496;3130
2021-02-11;AM;Armenia;180;5;168676;3135
2021-02-12;AM;Armenia;154;3;168830;3138
2021-02-13;AM;Armenia;192;2;169022;3140
2021-02-14;AM;Armenia;145;1;169167;3141
2021-02-15;AM;Armenia;88;6;169255;3147
2021-02-16;AM;Armenia;136;3;169391;3150
2021-02-17;AM;Armenia;206;5;169597;3155
2021-02-18;AM;Armenia;223;1;169820;3156
2021-02-19;AM;Armenia;191;2;170011;3158
2021-02-20;AM;Armenia;223;1;170234;3159
2021-02-21;AM;Armenia;168;5;170402;3164
2021-02-22;AM;Armenia;104;3;170506;3167
2021-02-23;AM;Armenia;166;4;170672;3171
2021-02-24;AM;Armenia;273;4;170945;3175
2021-02-25;AM;Armenia;282;4;171227;3179
2021-02-26;AM;Armenia;283;4;171510;3183
2021-02-27;AM;Armenia;283;7;171793;3190
2021-02-28;AM;Armenia;265;2;172058;3192
2021-03-01;AM;Armenia;158;3;172216;3195
2021-03-02;AM;Armenia;240;5;172456;3200
2021-03-03;AM;Armenia;360;2;172816;3202
2021-03-04;AM;Armenia;491;6;173307;3208
2021-03-05;AM;Armenia;442;7;173749;3215
2021-03-06;AM;Armenia;508;4;174257;3219
2021-03-07;AM;Armenia;422;2;174679;3221
2021-03-08;AM;Armenia;337;4;175016;3225
2021-03-09;AM;Armenia;182;7;175198;3232
2021-03-10;AM;Armenia;340;5;175538;3237
2021-03-11;AM;Armenia;748;2;176286;3239
2021-03-12;AM;Armenia;818;4;177104;3243
2021-03-13;AM;Armenia;795;10;177899;3253
2021-03-14;AM;Armenia;486;2;178385;3255
2021-03-15;AM;Armenia;317;10;178702;3265
2021-03-16;AM;Armenia;585;12;179287;3277
2021-03-17;AM;Armenia;854;5;180141;3282
2021-03-18;AM;Armenia;1024;19;181165;3301
2021-03-19;AM;Armenia;891;19;182056;3320
2021-03-20;AM;Armenia;1071;12;183127;3332
2021-03-21;AM;Armenia;586;16;183713;3348
2021-03-22;AM;Armenia;506;12;184219;3360
2021-03-23;AM;Armenia;801;24;185020;3384
2021-03-24;AM;Armenia;1164;14;186184;3398
2021-03-25;AM;Armenia;1257;18;187441;3416
2021-03-26;AM;Armenia;1005;18;188446;3434
2021-03-27;AM;Armenia;1094;16;189540;3450
2021-03-28;AM;Armenia;777;14;190317;3464
2021-03-29;AM;Armenia;424;12;190741;3476
2021-03-30;AM;Armenia;750;21;191491;3497
2021-03-31;AM;Armenia;1148;18;192639;3515
2021-04-01;AM;Armenia;1097;18;193736;3533
2021-04-02;AM;Armenia;1116;19;194852;3552
2021-04-03;AM;Armenia;1192;23;196044;3575
2021-04-04;AM;Armenia;590;17;196634;3592
2021-04-05;AM;Armenia;479;22;197113;3614
2021-04-06;AM;Armenia;760;13;197873;3627
2021-04-07;AM;Armenia;1025;20;198898;3647
2021-04-08;AM;Armenia;1231;28;200129;3675
2021-04-09;AM;Armenia;1029;22;201158;3697
2021-04-10;AM;Armenia;1009;23;202167;3720
2021-04-11;AM;Armenia;650;15;202817;3735
2021-04-12;AM;Armenia;510;18;203327;3753
2021-04-13;AM;Armenia;726;22;204053;3775
2021-04-14;AM;Armenia;1075;19;205128;3794
2021-04-15;AM;Armenia;1014;23;206142;3817
2021-04-16;AM;Armenia;961;18;207103;3835
2021-04-17;AM;Armenia;870;24;207973;3859
2021-04-18;AM;Armenia;547;19;208520;3878
2021-04-19;AM;Armenia;298;17;208818;3895
2021-04-20;AM;Armenia;667;24;209485;3919
2021-04-21;AM;Armenia;1033;25;210518;3944
2021-04-22;AM;Armenia;881;25;211399;3969
2021-04-23;AM;Armenia;715;15;212114;3984
2021-04-24;AM;Armenia;764;17;212878;4001
2021-04-25;AM;Armenia;410;17;213288;4018
2021-04-26;AM;Armenia;181;22;213469;4040
2021-04-27;AM;Armenia;595;18;214064;4058
2021-04-28;AM;Armenia;808;13;214872;4071
2021-04-29;AM;Armenia;656;16;215528;4087
2021-04-30;AM;Armenia;536;21;216064;4108
2021-05-01;AM;Armenia;532;20;216596;4128
2021-05-02;AM;Armenia;267;11;216863;4139
2021-05-03;AM;Armenia;145;10;217008;4149
2021-05-04;AM;Armenia;399;16;217407;4165
2021-05-05;AM;Armenia;493;13;217900;4178
2021-05-06;AM;Armenia;425;14;218325;4192
2021-05-07;AM;Armenia;356;17;218681;4209
2021-05-08;AM;Armenia;411;16;219092;4225
2021-05-09;AM;Armenia;178;9;219270;4234
2021-05-10;AM;Armenia;83;15;219353;4249
2021-05-11;AM;Armenia;243;7;219596;4256
2021-05-12;AM;Armenia;354;16;219950;4272
2021-05-13;AM;Armenia;267;19;220217;4291
2021-05-14;AM;Armenia;230;10;220447;4301
2021-05-15;AM;Armenia;282;13;220729;4314
2021-05-16;AM;Armenia;131;9;220860;4323
2021-05-17;AM;Armenia;67;10;220927;4333
2021-05-18;AM;Armenia;212;13;221139;4346
2021-05-19;AM;Armenia;229;11;221368;4357
2021-05-20;AM;Armenia;191;7;221559;4364
2021-05-21;AM;Armenia;140;7;221699;4371
2021-05-22;AM;Armenia;181;15;221880;4386
2021-05-23;AM;Armenia;68;6;221948;4392
2021-05-24;AM;Armenia;34;2;221982;4394
2021-05-25;AM;Armenia;157;6;222139;4400
2021-05-26;AM;Armenia;130;11;222269;4411
2021-05-27;AM;Armenia;140;5;222409;4416
2021-05-28;AM;Armenia;104;7;222513;4423
2021-05-29;AM;Armenia;42;5;222555;4428
2021-05-30;AM;Armenia;81;4;222636;4432
2021-05-31;AM;Armenia;34;6;222670;4438
2021-06-01;AM;Armenia;108;7;222778;4445
2021-06-02;AM;Armenia;92;1;222870;4446
2021-06-03;AM;Armenia;108;2;222978;4448
2021-06-04;AM;Armenia;72;4;223050;4452
2021-06-05;AM;Armenia;93;2;223143;4454
2021-06-06;AM;Armenia;37;4;223180;4458
2021-06-07;AM;Armenia;32;5;223212;4463
2021-06-08;AM;Armenia;73;0;223285;4463
2021-06-09;AM;Armenia;99;11;223384;4474
2021-06-10;AM;Armenia;76;4;223460;4478
2021-06-11;AM;Armenia;95;4;223555;4482
2021-06-12;AM;Armenia;88;0;223643;4482
2021-06-13;AM;Armenia;39;2;223682;4484
2021-06-14;AM;Armenia;41;4;223723;4488
2021-06-15;AM;Armenia;82;1;223805;4489
2021-06-16;AM;Armenia;99;1;223904;4490
2021-06-17;AM;Armenia;96;1;224000;4491
2021-06-18;AM;Armenia;86;1;224086;4492
2021-06-19;AM;Armenia;81;4;224167;4496
2021-06-20;AM;Armenia;60;2;224227;4498
2021-06-21;AM;Armenia;26;1;224253;4499
2021-06-22;AM;Armenia;77;3;224330;4502
2021-06-23;AM;Armenia;100;1;224430;4503
2021-06-24;AM;Armenia;103;2;224533;4505
2021-06-25;AM;Armenia;102;0;224635;4505
2021-06-26;AM;Armenia;93;1;224728;4506
2021-06-27;AM;Armenia;69;2;224797;4508
2021-06-28;AM;Armenia;54;2;224851;4510
2021-06-29;AM;Armenia;116;4;224967;4514
2021-06-30;AM;Armenia;128;0;225095;4514
2021-07-01;AM;Armenia;126;3;225221;4517
2021-03-29;AW;Aruba;0;0;0;0
2021-03-30;AW;Aruba;0;0;0;0
2021-03-31;AW;Aruba;0;0;0;0
2021-04-01;AW;Aruba;0;0;0;0
2021-04-02;AW;Aruba;0;0;0;0
2021-04-03;AW;Aruba;0;0;0;0
2021-04-04;AW;Aruba;0;0;0;0
2021-04-05;AW;Aruba;0;0;0;0
2021-04-06;AW;Aruba;0;0;0;0
2021-04-07;AW;Aruba;0;0;0;0
2021-04-08;AW;Aruba;0;0;0;0
2021-04-09;AW;Aruba;0;0;0;0
2021-04-10;AW;Aruba;0;0;0;0
2021-04-11;AW;Aruba;0;0;0;0
2021-04-12;AW;Aruba;0;0;0;0
2021-04-13;AW;Aruba;0;0;0;0
2021-04-14;AW;Aruba;0;0;0;0
2021-04-15;AW;Aruba;0;0;0;0
2021-04-16;AW;Aruba;0;0;0;0
2021-04-17;AW;Aruba;0;0;0;0
2021-04-18;AW;Aruba;0;0;0;0
2021-04-19;AW;Aruba;0;0;0;0
2021-04-20;AW;Aruba;0;0;0;0
2021-04-21;AW;Aruba;0;0;0;0
2021-04-22;AW;Aruba;0;0;0;0
2021-04-23;AW;Aruba;0;0;0;0
2021-04-24;AW;Aruba;0;0;0;0
2021-04-25;AW;Aruba;0;0;0;0
2021-04-26;AW;Aruba;0;0;0;0
2021-04-27;AW;Aruba;0;0;0;0
2021-04-28;AW;Aruba;0;0;0;0
2021-04-29;AW;Aruba;0;0;0;0
2021-04-30;AW;Aruba;0;0;0;0
2021-05-01;AW;Aruba;0;0;0;0
2021-05-02;AW;Aruba;0;0;0;0
2021-05-03;AW;Aruba;0;0;0;0
2021-05-04;AW;Aruba;0;0;0;0
2021-05-05;AW;Aruba;0;0;0;0
2021-05-06;AW;Aruba;0;0;0;0
2021-05-07;AW;Aruba;0;0;0;0
2021-05-08;AW;Aruba;0;0;0;0
2021-05-09;AW;Aruba;0;0;0;0
2021-05-10;AW;Aruba;0;0;0;0
2021-05-11;AW;Aruba;0;0;0;0
2021-05-12;AW;Aruba;0;0;0;0
2021-05-13;AW;Aruba;0;0;0;0
2021-05-14;AW;Aruba;0;0;0;0
2021-05-15;AW;Aruba;0;0;0;0
2021-05-16;AW;Aruba;0;0;0;0
2021-05-17;AW;Aruba;0;0;0;0
2021-05-18;AW;Aruba;0;0;0;0
2021-05-19;AW;Aruba;0;0;0;0
2021-05-20;AW;Aruba;0;0;0;0
2021-05-21;AW;Aruba;0;0;0;0
2021-05-22;AW;Aruba;0;0;0;0
2021-05-23;AW;Aruba;0;0;0;0
2021-05-24;AW;Aruba;0;0;0;0
2021-05-25;AW;Aruba;0;0;0;0
2021-05-26;AW;Aruba;0;0;0;0
2021-05-27;AW;Aruba;0;0;0;0
2021-05-28;AW;Aruba;0;0;0;0
2021-05-29;AW;Aruba;0;0;0;0
2021-05-30;AW;Aruba;0;0;0;0
2021-05-31;AW;Aruba;0;0;0;0
2021-06-01;AW;Aruba;0;0;0;0
2021-06-02;AW;Aruba;0;0;0;0
2021-06-03;AW;Aruba;0;0;0;0
2021-06-04;AW;Aruba;0;0;0;0
2021-06-05;AW;Aruba;0;0;0;0
2021-06-06;AW;Aruba;0;0;0;0
2021-06-07;AW;Aruba;0;0;0;0
2021-06-08;AW;Aruba;0;0;0;0
2021-06-09;AW;Aruba;0;0;0;0
2021-06-10;AW;Aruba;0;0;0;0
2021-06-11;AW;Aruba;0;0;0;0
2021-06-12;AW;Aruba;0;0;0;0
2021-06-13;AW;Aruba;0;0;0;0
2021-06-14;AW;Aruba;0;0;0;0
2021-06-15;AW;Aruba;0;0;0;0
2021-06-16;AW;Aruba;0;0;0;0
2021-06-17;AW;Aruba;0;0;0;0
2021-06-18;AW;Aruba;0;0;0;0
2021-06-19;AW;Aruba;0;0;0;0
2021-06-20;AW;Aruba;0;0;0;0
2021-06-21;AW;Aruba;0;0;0;0
2021-06-22;AW;Aruba;0;0;0;0
2021-06-23;AW;Aruba;0;0;0;0
2021-06-24;AW;Aruba;0;0;0;0
2021-06-25;AW;Aruba;0;0;0;0
2021-06-26;AW;Aruba;0;0;0;0
2021-06-27;AW;Aruba;0;0;0;0
2021-06-28;AW;Aruba;0;0;0;0
2021-06-29;AW;Aruba;0;0;0;0
2021-06-30;AW;Aruba;0;0;0;0
2021-07-01;AW;Aruba;0;0;0;0
2020-01-22;;Asia;0;0;556;17
2020-01-23;;Asia;98;1;654;18
2020-01-24;;Asia;283;8;937;26
2020-01-25;;Asia;491;16;1428;42
2020-01-26;;Asia;677;14;2105;56
2020-01-27;;Asia;807;26;2912;82
2020-01-28;;Asia;2646;49;5558;131
2020-01-29;;Asia;585;2;6143;133
2020-01-30;;Asia;2065;38;8208;171
2020-01-31;;Asia;1681;42;9889;213
2020-02-01;;Asia;2102;46;11991;259
2020-02-02;;Asia;4747;103;16738;362
2020-02-03;;Asia;3089;64;19827;426
2020-02-04;;Asia;4009;66;23836;492
2020-02-05;;Asia;3743;72;27579;564
2020-02-06;;Asia;3158;70;30737;634
2020-02-07;;Asia;3527;85;34264;719
2020-02-08;;Asia;2725;87;36989;806
2020-02-09;;Asia;3024;100;40013;906
2020-02-10;;Asia;2538;107;42551;1013
2020-02-11;;Asia;2038;100;44589;1113
2020-02-12;;Asia;377;5;44966;1118
2020-02-13;;Asia;15151;253;60117;1371
2020-02-14;;Asia;6482;152;66599;1523
2020-02-15;;Asia;2075;142;68674;1665
2020-02-16;;Asia;2113;104;70787;1769
2020-02-17;;Asia;1934;98;72721;1867
2020-02-18;;Asia;1794;140;74515;2007
2020-02-19;;Asia;420;115;74935;2122
2020-02-20;;Asia;545;123;75480;2245
2020-02-21;;Asia;608;3;76088;2248
2020-02-22;;Asia;1719;206;77807;2454
2020-02-23;;Asia;223;9;78030;2463
2020-02-24;;Asia;487;156;78517;2619
2020-02-25;;Asia;743;77;79260;2696
2020-02-26;;Asia;799;57;80059;2753
2020-02-27;;Asia;1092;38;81151;2791
2020-02-28;;Asia;1079;53;82230;2844
2020-02-29;;Asia;1490;60;83720;2904
2020-03-01;;Asia;1597;48;85317;2952
2020-03-02;;Asia;1383;65;86700;3017
2020-03-03;;Asia;1868;44;88568;3061
2020-03-04;;Asia;1230;61;89798;3122
2020-03-05;;Asia;1286;47;91084;3169
2020-03-06;;Asia;2036;54;93120;3223
2020-03-07;;Asia;1756;52;94876;3275
2020-03-08;;Asia;1202;86;96078;3361
2020-03-09;;Asia;908;71;96986;3432
2020-03-10;;Asia;1189;76;98175;3508
2020-03-11;;Asia;1721;97;99896;3605
2020-03-12;;Asia;1359;98;101255;3703
2020-03-13;;Asia;1821;104;103076;3807
2020-03-14;;Asia;1908;122;104984;3929
2020-03-15;;Asia;1943;131;106927;4060
2020-03-16;;Asia;1723;151;108650;4211
2020-03-17;;Asia;1994;159;110644;4370
2020-03-18;;Asia;2137;188;112781;4558
2020-03-19;;Asia;2140;175;114921;4733
2020-03-20;;Asia;2703;176;117624;4909
2020-03-21;;Asia;2557;156;120181;5065
2020-03-22;;Asia;3234;209;123415;5274
2020-03-23;;Asia;3075;156;126490;5430
2020-03-24;;Asia;3619;170;130109;5600
2020-03-25;;Asia;5412;194;135521;5794
2020-03-26;;Asia;5722;244;141243;6038
2020-03-27;;Asia;7111;213;148354;6251
2020-03-28;;Asia;7200;213;155554;6464
2020-03-29;;Asia;7240;216;162794;6680
2020-03-30;;Asia;7256;210;170050;6890
2020-03-31;;Asia;8983;246;179033;7136
2020-04-01;;Asia;8586;303;187619;7439
2020-04-02;;Asia;9140;292;196759;7731
2020-04-03;;Asia;8740;286;205499;8017
2020-04-04;;Asia;8983;311;214482;8328
2020-04-05;;Asia;9917;306;224399;8634
2020-04-06;;Asia;9995;314;234394;8948
2020-04-07;;Asia;9567;288;243961;9236
2020-04-08;;Asia;9905;307;253866;9543
2020-04-09;;Asia;10221;362;264087;9905
2020-04-10;;Asia;11127;357;275214;10262
2020-04-11;;Asia;12001;362;287215;10624
2020-04-12;;Asia;11630;400;298845;11024
2020-04-13;;Asia;11549;334;310394;11358
2020-04-14;;Asia;11471;396;321865;11754
2020-04-15;;Asia;11381;323;333246;12077
2020-04-16;;Asia;12372;362;345618;12439
2020-04-17;;Asia;12770;1654;358388;14093
2020-04-18;;Asia;12121;337;370509;14430
2020-04-19;;Asia;12270;372;382779;14802
2020-04-20;;Asia;13993;357;396772;15159
2020-04-21;;Asia;13678;374;410450;15533
2020-04-22;;Asia;12196;358;422646;15891
2020-04-23;;Asia;12781;349;435427;16240
2020-04-24;;Asia;13017;383;448444;16623
2020-04-25;;Asia;12005;350;460449;16973
2020-04-26;;Asia;11507;297;471956;17270
2020-04-27;;Asia;11085;361;483041;17631
2020-04-28;;Asia;11909;343;494950;17974
2020-04-29;;Asia;12936;377;507886;18351
2020-04-30;;Asia;13078;355;520964;18706
2020-05-01;;Asia;13157;324;534121;19030
2020-05-02;;Asia;12077;379;546198;19409
2020-05-03;;Asia;12676;290;558874;19699
2020-05-04;;Asia;14257;453;573131;20152
2020-05-05;;Asia;15203;372;588334;20524
2020-05-06;;Asia;15422;360;603756;20884
2020-05-07;;Asia;15666;362;619422;21246
2020-05-08;;Asia;16809;322;636231;21568
2020-05-09;;Asia;15413;342;651644;21910
2020-05-10;;Asia;17955;355;669599;22265
2020-05-11;;Asia;16570;305;686169;22570
2020-05-12;;Asia;17022;356;703191;22926
2020-05-13;;Asia;17232;376;720423;23302
2020-05-14;;Asia;20615;385;741038;23687
2020-05-15;;Asia;17464;341;758502;24028
2020-05-16;;Asia;19934;353;778436;24381
2020-05-17;;Asia;20819;414;799255;24795
2020-05-18;;Asia;20821;384;820076;25179
2020-05-19;;Asia;21952;389;842028;25568
2020-05-20;;Asia;22583;350;864611;25918
2020-05-21;;Asia;24215;411;888826;26329
2020-05-22;;Asia;24194;407;913020;26736
2020-05-23;;Asia;24391;387;937411;27123
2020-05-24;;Asia;23903;386;961314;27509
2020-05-25;;Asia;21820;338;983134;27847
2020-05-26;;Asia;20189;400;1003323;28247
2020-05-27;;Asia;23908;470;1027231;28717
2020-05-28;;Asia;25848;461;1053079;29178
2020-05-29;;Asia;28818;565;1081897;29743
2020-05-30;;Asia;27649;548;1109546;30291
2020-05-31;;Asia;29232;540;1138778;30831
2020-06-01;;Asia;27964;514;1166742;31345
2020-06-02;;Asia;30573;551;1197315;31896
2020-06-03;;Asia;33386;645;1230701;32541
2020-06-04;;Asia;32311;582;1263012;33123
2020-06-05;;Asia;32939;648;1295951;33771
2020-06-06;;Asia;34432;653;1330383;34424
2020-06-07;;Asia;34586;658;1364969;35082
2020-06-08;;Asia;31149;655;1396118;35737
2020-06-09;;Asia;33943;668;1430061;36405
2020-06-10;;Asia;36520;764;1466581;37169
2020-06-11;;Asia;37842;826;1504423;37995
2020-06-12;;Asia;32688;726;1537111;38721
2020-06-13;;Asia;38916;743;1576027;39464
2020-06-14;;Asia;44950;874;1620977;40338
2020-06-15;;Asia;37260;910;1658237;41248
2020-06-16;;Asia;38536;2529;1696773;43777
2020-06-17;;Asia;41023;869;1737796;44646
2020-06-18;;Asia;41108;902;1778904;45548
2020-06-19;;Asia;42860;950;1821764;46498
2020-06-20;;Asia;41910;880;1863674;47378
2020-06-21;;Asia;39751;955;1903425;48333
2020-06-22;;Asia;40548;801;1943973;49134
2020-06-23;;Asia;42375;959;1986348;50093
2020-06-24;;Asia;43891;1015;2030239;51108
2020-06-25;;Asia;44266;955;2074505;52063
2020-06-26;;Asia;46358;937;2120863;53000
2020-06-27;;Asia;46260;948;2167123;53948
2020-06-28;;Asia;46970;875;2214093;54823
2020-06-29;;Asia;44458;1035;2258551;55858
2020-06-30;;Asia;46653;1125;2305204;56983
2020-07-01;;Asia;66783;1016;2371987;57999
2020-07-02;;Asia;50578;958;2422565;58957
2020-07-03;;Asia;50678;925;2473243;59882
2020-07-04;;Asia;53774;1160;2527017;61042
2020-07-05;;Asia;56132;1158;2583149;62200
2020-07-06;;Asia;50182;1162;2633331;63362
2020-07-07;;Asia;50107;1159;2683438;64521
2020-07-08;;Asia;53878;1048;2737316;65569
2020-07-09;;Asia;57878;1124;2795194;66693
2020-07-10;;Asia;56150;1081;2851344;67774
2020-07-11;;Asia;55405;1140;2906749;68914
2020-07-12;;Asia;54832;1445;2961581;70359
2020-07-13;;Asia;56541;1179;3018122;71538
2020-07-14;;Asia;54884;1159;3073006;72697
2020-07-15;;Asia;60814;1226;3133820;73923
2020-07-16;;Asia;60561;1280;3194381;75203
2020-07-17;;Asia;64087;1351;3258468;76554
2020-07-18;;Asia;74284;1919;3332752;78473
2020-07-19;;Asia;68454;1495;3401206;79968
2020-07-20;;Asia;61351;1403;3462557;81371
2020-07-21;;Asia;65575;1291;3528132;82662
2020-07-22;;Asia;71615;1826;3599747;84488
2020-07-23;;Asia;79839;1527;3679586;86015
2020-07-24;;Asia;75031;1339;3754617;87354
2020-07-25;;Asia;74341;1279;3828958;88633
2020-07-26;;Asia;72869;1316;3901827;89949
2020-07-27;;Asia;69237;1207;3971064;91156
2020-07-28;;Asia;77967;1554;4049031;92710
2020-07-29;;Asia;77915;1293;4126946;94003
2020-07-30;;Asia;81360;1371;4208306;95374
2020-07-31;;Asia;88212;1352;4296518;96726
2020-08-01;;Asia;77438;1348;4373956;98074
2020-08-02;;Asia;81734;1293;4455690;99367
2020-08-03;;Asia;75236;1658;4530926;101025
2020-08-04;;Asia;79322;1416;4610248;102441
2020-08-05;;Asia;85754;1474;4696002;103915
2020-08-06;;Asia;90743;1394;4786745;105309
2020-08-07;;Asia;90732;1431;4877477;106740
2020-08-08;;Asia;90993;1349;4968470;108089
2020-08-09;;Asia;86601;1548;5055071;109637
2020-08-10;;Asia;81419;1703;5136490;111340
2020-08-11;;Asia;85712;1358;5222202;112698
2020-08-12;;Asia;95418;1557;5317620;114255
2020-08-13;;Asia;92508;1505;5410128;115760
2020-08-14;;Asia;94813;1473;5504941;117233
2020-08-15;;Asia;91339;1597;5596280;118830
2020-08-16;;Asia;83767;1492;5680047;120322
2020-08-17;;Asia;77920;1365;5757967;121687
2020-08-18;;Asia;93075;1775;5851042;123462
2020-08-19;;Asia;98425;1584;5949467;125046
2020-08-20;;Asia;96920;1549;6046387;126595
2020-08-21;;Asia;97176;1009;6143563;127604
2020-08-22;;Asia;95111;1417;6238674;129021
2020-08-23;;Asia;84047;1337;6322721;130358
2020-08-24;;Asia;86293;1478;6409014;131836
2020-08-25;;Asia;82066;1499;6491080;133335
2020-08-26;;Asia;112975;1682;6604055;135017
2020-08-27;;Asia;103592;1642;6707647;136659
2020-08-28;;Asia;103903;1594;6811550;138253
2020-08-29;;Asia;104677;1489;6916227;139742
2020-08-30;;Asia;103448;1549;7019675;141291
2020-08-31;;Asia;94202;1316;7113877;142607
2020-09-01;;Asia;103828;1591;7217705;144198
2020-09-02;;Asia;110448;1666;7328153;145864
2020-09-03;;Asia;111534;1691;7439687;147555
2020-09-04;;Asia;115310;1625;7554997;149180
2020-09-05;;Asia;115186;1591;7670183;150771
2020-09-06;;Asia;117005;1630;7787188;152401
2020-09-07;;Asia;101108;1663;7888296;154064
2020-09-08;;Asia;118467;1671;8006763;155735
2020-09-09;;Asia;125634;1811;8132397;157546
2020-09-10;;Asia;127900;1829;8260297;159375
2020-09-11;;Asia;129060;1710;8389357;161085
2020-09-12;;Asia;124316;1780;8513673;162865
2020-09-13;;Asia;120881;1711;8634554;164576
2020-09-14;;Asia;115833;1902;8750387;166478
2020-09-15;;Asia;122377;1898;8872764;168376
2020-09-16;;Asia;131132;1880;9003896;170256
2020-09-17;;Asia;129591;1841;9133487;172097
2020-09-18;;Asia;126625;1853;9260112;173950
2020-09-19;;Asia;123815;1805;9383927;175755
2020-09-20;;Asia;117422;1777;9501349;177532
2020-09-21;;Asia;105947;1692;9607296;179224
2020-09-22;;Asia;117694;1754;9724990;180978
2020-09-23;;Asia;123848;1851;9848838;182829
2020-09-24;;Asia;123626;1783;9972464;184612
2020-09-25;;Asia;122511;1770;10094975;186382
2020-09-26;;Asia;121956;1787;10216931;188169
2020-09-27;;Asia;113383;1705;10330314;189874
2020-09-28;;Asia;98518;1424;10428832;191298
2020-09-29;;Asia;114131;1922;10542963;193220
2020-09-30;;Asia;125691;1897;10668654;195117
2020-10-01;;Asia;119470;1777;10788124;196894
2020-10-02;;Asia;117003;1757;10905127;198651
2020-10-03;;Asia;107538;1554;11012665;200205
2020-10-04;;Asia;108147;1639;11120812;201844
2020-10-05;;Asia;97336;1618;11218148;203462
2020-10-06;;Asia;108624;1711;11326772;205173
2020-10-07;;Asia;116789;1740;11443561;206913
2020-10-08;;Asia;108861;1795;11552422;208708
2020-10-09;;Asia;107154;1653;11659576;210361
2020-10-10;;Asia;108095;1615;11767671;211976
2020-10-11;;Asia;98877;1612;11866548;213588
2020-10-12;;Asia;90422;1406;11956970;214994
2020-10-13;;Asia;99781;1472;12056751;216466
2020-10-14;;Asia;104784;1547;12161535;218013
2020-10-15;;Asia;101840;1662;12263375;219675
2020-10-16;;Asia;100670;1592;12364045;221267
2020-10-17;;Asia;96536;1797;12460581;223064
2020-10-18;;Asia;91337;1337;12551918;224401
2020-10-19;;Asia;82337;1444;12634255;225845
2020-10-20;;Asia;90794;1526;12725049;227371
2020-10-21;;Asia;98445;1608;12823494;228979
2020-10-22;;Asia;97135;1532;12920629;230511
2020-10-23;;Asia;97524;1589;13018153;232100
2020-10-24;;Asia;88718;1398;13106871;233498
2020-10-25;;Asia;85125;1296;13191996;234794
2020-10-26;;Asia;72645;1385;13264641;236179
2020-10-27;;Asia;84773;1380;13349414;237559
2020-10-28;;Asia;93174;1492;13442588;239051
2020-10-29;;Asia;93203;1475;13535791;240526
2020-10-30;;Asia;92002;1397;13627793;241923
2020-10-31;;Asia;86834;1405;13714627;243328
2020-11-01;;Asia;87501;1433;13802128;244761
2020-11-02;;Asia;83162;1472;13885290;246233
2020-11-03;;Asia;92990;1570;13978280;247803
2020-11-04;;Asia;97230;1746;14075510;249549
2020-11-05;;Asia;96532;1620;14172042;251169
2020-11-06;;Asia;101563;1588;14273605;252757
2020-11-07;;Asia;93734;1477;14367339;254234
2020-11-08;;Asia;94807;1491;14462146;255725
2020-11-09;;Asia;85597;1536;14547743;257261
2020-11-10;;Asia;95465;1539;14643208;258800
2020-11-11;;Asia;100897;1619;14744105;260419
2020-11-12;;Asia;99160;1641;14843265;262060
2020-11-13;;Asia;99475;1586;14942740;263646
2020-11-14;;Asia;94073;1512;15036813;265158
2020-11-15;;Asia;81910;1463;15118723;266621
2020-11-16;;Asia;80715;1498;15199438;268119
2020-11-17;;Asia;94303;1591;15293741;269710
2020-11-18;;Asia;106789;1812;15400530;271522
2020-11-19;;Asia;106999;2024;15507529;273546
2020-11-20;;Asia;108445;1693;15615974;275239
2020-11-21;;Asia;103617;1621;15719591;276860
2020-11-22;;Asia;104998;1700;15824589;278560
2020-11-23;;Asia;96857;1654;15921446;280214
2020-11-24;;Asia;107278;1708;16028724;281922
2020-11-25;;Asia;109645;1815;16138369;283737
2020-11-26;;Asia;138441;1768;16276810;285505
2020-11-27;;Asia;146056;1658;16422866;287163
2020-11-28;;Asia;127578;1678;16550444;288841
2020-11-29;;Asia;125422;1682;16675866;290523
2020-11-30;;Asia;115422;1638;16791288;292161
2020-12-01;;Asia;122821;1737;16914109;293898
2020-12-02;;Asia;127191;1654;17041300;295552
2020-12-03;;Asia;131192;1711;17172492;297263
2020-12-04;;Asia;126252;1667;17298744;298930
2020-12-05;;Asia;123449;1551;17422193;300481
2020-12-06;;Asia;119639;1469;17541832;301950
2020-12-07;;Asia;108370;1520;17650202;303470
2020-12-08;;Asia;118382;1649;17768584;305119
2020-12-09;;Asia;118215;1551;17886799;306670
2020-12-10;;Asia;85319;1550;18795343;308220
2020-12-11;;Asia;114464;1525;18909807;309745
2020-12-12;;Asia;109920;1446;19019727;311191
2020-12-13;;Asia;99457;1354;19119184;312545
2020-12-14;;Asia;94301;1464;19213485;314009
2020-12-15;;Asia;107535;1629;19321020;315638
2020-12-16;;Asia;106635;1445;19427655;317083
2020-12-17;;Asia;101869;1416;19529524;318499
2020-12-18;;Asia;100404;1371;19629928;319870
2020-12-19;;Asia;96067;1396;19725995;321266
2020-12-20;;Asia;87308;1454;19813303;322720
2020-12-21;;Asia;79508;1445;19892811;324165
2020-12-22;;Asia;89485;1494;19982296;325659
2020-12-23;;Asia;90092;1423;20072388;327082
2020-12-24;;Asia;88670;1350;20161058;328432
2020-12-25;;Asia;85980;1314;20247038;329746
2020-12-26;;Asia;75795;1221;20322833;330967
2020-12-27;;Asia;71622;1329;20394455;332296
2020-12-28;;Asia;70021;1305;20464476;333601
2020-12-29;;Asia;81741;1439;20546217;335040
2020-12-30;;Asia;83545;1400;20629762;336440
2020-12-31;;Asia;65275;972;20695037;337412
2021-01-01;;Asia;76089;1347;20771126;338759
2021-01-02;;Asia;89867;1352;20860993;340111
2021-01-03;;Asia;69533;1061;20930526;341172
2021-01-04;;Asia;73454;1110;21003980;342282
2021-01-05;;Asia;82482;1226;21086462;343508
2021-01-06;;Asia;87477;1070;21173939;344578
2021-01-07;;Asia;87620;1142;21261559;345720
2021-01-08;;Asia;67431;953;21328990;346673
2021-01-09;;Asia;104961;1305;21433951;347978
2021-01-10;;Asia;76478;933;21510429;348911
2021-01-11;;Asia;74376;997;21584805;349908
2021-01-12;;Asia;81981;1418;21666786;351326
2021-01-13;;Asia;86941;1326;21753727;352652
2021-01-14;;Asia;86556;1171;21840283;353823
2021-01-15;;Asia;82588;1204;21922871;355027
2021-01-16;;Asia;85733;1112;22008604;356139
2021-01-17;;Asia;75180;978;22083784;357117
2021-01-18;;Asia;64552;1072;22148336;358189
2021-01-19;;Asia;74752;1229;22223088;359418
2021-01-20;;Asia;81734;1244;22304822;360662
2021-01-21;;Asia;76339;1249;22381161;361911
2021-01-22;;Asia;75658;1050;22456819;362961
2021-01-23;;Asia;73180;1048;22529999;364009
2021-01-24;;Asia;66904;945;22596903;364954
2021-01-25;;Asia;59715;1123;22656618;366077
2021-01-26;;Asia;75215;1296;22731833;367373
2021-01-27;;Asia;79976;1270;22811809;368643
2021-01-28;;Asia;82912;1360;22894721;370003
2021-01-29;;Asia;76797;972;22971518;370975
2021-01-30;;Asia;74274;1274;23045792;372249
2021-01-31;;Asia;67489;995;23113281;373244
2021-02-01;;Asia;65867;985;23179148;374229
2021-02-02;;Asia;69287;1120;23248435;375349
2021-02-03;;Asia;76350;1001;23324785;376350
2021-02-04;;Asia;72857;1091;23397642;377441
2021-02-05;;Asia;68761;913;23466403;378354
2021-02-06;;Asia;69700;868;23536103;379222
2021-02-07;;Asia;66056;823;23602159;380045
2021-02-08;;Asia;59428;892;23661587;380937
2021-02-09;;Asia;68005;942;23729592;381879
2021-02-10;;Asia;71053;974;23800645;382853
2021-02-11;;Asia;64988;847;23865633;383700
2021-02-12;;Asia;66795;884;23932428;384584
2021-02-13;;Asia;63055;857;23995483;385441
2021-02-14;;Asia;58675;743;24054158;386184
2021-02-15;;Asia;59368;701;24113526;386885
2021-02-16;;Asia;68749;923;24182275;387808
2021-02-17;;Asia;69490;865;24251765;388673
2021-02-18;;Asia;66719;886;24318484;389559
2021-02-19;;Asia;67228;894;24385712;390453
2021-02-20;;Asia;62703;909;24448415;391362
2021-02-21;;Asia;67481;717;24515896;392079
2021-02-22;;Asia;67249;754;24583145;392833
2021-02-23;;Asia;73702;941;24656847;393774
2021-02-24;;Asia;76427;1511;24733274;395285
2021-02-25;;Asia;75983;951;24809257;396236
2021-02-26;;Asia;74903;969;24884160;397205
2021-02-27;;Asia;70034;785;24954194;397990
2021-02-28;;Asia;67989;751;25022183;398741
2021-03-01;;Asia;69008;742;25091191;399483
2021-03-02;;Asia;76550;883;25167741;400366
2021-03-03;;Asia;80712;828;25248453;401194
2021-03-04;;Asia;81081;808;25329534;402002
2021-03-05;;Asia;81043;949;25410577;402951
2021-03-06;;Asia;76827;661;25487404;403612
2021-03-07;;Asia;78118;728;25565522;404340
2021-03-08;;Asia;79286;888;25644808;405228
2021-03-09;;Asia;83204;842;25728012;406070
2021-03-10;;Asia;89729;803;25817741;406873
2021-03-11;;Asia;91851;819;25909592;407692
2021-03-12;;Asia;93811;880;26003403;408572
2021-03-13;;Asia;88620;814;26092023;409386
2021-03-14;;Asia;90699;752;26182722;410138
2021-03-15;;Asia;93798;843;26276520;410981
2021-03-16;;Asia;102257;979;26378777;411960
2021-03-17;;Asia;115480;867;26494257;412827
2021-03-18;;Asia;120225;963;26614482;413790
2021-03-19;;Asia;121659;940;26736141;414730
2021-03-20;;Asia;119682;883;26855823;415613
2021-03-21;;Asia;125343;889;26981166;416502
2021-03-22;;Asia;120637;1058;27101803;417560
2021-03-23;;Asia;134284;1076;27236087;418636
2021-03-24;;Asia;146664;1123;27382751;419759
2021-03-25;;Asia;154999;1118;27537750;420877
2021-03-26;;Asia;156385;1111;27694135;421988
2021-03-27;;Asia;152603;1172;27846738;423160
2021-03-28;;Asia;163000;1058;28009738;424218
2021-03-29;;Asia;152823;1148;28162561;425366
2021-03-30;;Asia;161222;1262;28323783;426628
2021-03-31;;Asia;183350;1466;28507133;428094
2021-04-01;;Asia;198134;1426;28705267;429520
2021-04-02;;Asia;210422;1607;28915689;431127
2021-04-03;;Asia;208717;1499;29124406;432626
2021-04-04;;Asia;224608;1672;29349014;434298
2021-04-05;;Asia;209594;1496;29558608;435794
2021-04-06;;Asia;245560;2089;29804168;437883
2021-04-07;;Asia;268501;2009;30072669;439892
2021-04-08;;Asia;280475;2014;30353144;441906
2021-04-09;;Asia;293168;2228;30646312;444134
2021-04-10;;Asia;288819;2135;30935131;446269
2021-04-11;;Asia;305815;2155;31240946;448424
2021-04-12;;Asia;303146;2312;31544092;450736
2021-04-13;;Asia;332794;2426;31876886;453162
2021-04-14;;Asia;356853;2469;32233739;455631
2021-04-15;;Asia;371608;2694;32605347;458325
2021-04-16;;Asia;388702;2786;32994049;461111
2021-04-17;;Asia;409782;2929;33403831;464040
2021-04-18;;Asia;414773;3177;33818604;467217
2021-04-19;;Asia;399773;3333;34218377;470550
2021-04-20;;Asia;448580;3710;34666957;474260
2021-04-21;;Asia;471579;3808;35138536;478068
2021-04-22;;Asia;482745;3949;35621281;482017
2021-04-23;;Asia;487239;4278;36108520;486295
2021-04-24;;Asia;473441;4367;36581961;490662
2021-04-25;;Asia;473074;4407;37055035;495069
2021-04-26;;Asia;440992;4483;37496027;499552
2021-04-27;;Asia;490007;5000;37986034;504552
2021-04-28;;Asia;506677;5318;38492711;509870
2021-04-29;;Asia;515222;5241;39007933;515111
2021-04-30;;Asia;518375;5175;39526308;520286
2021-05-01;;Asia;497276;5185;40023584;525471
2021-05-02;;Asia;477375;4928;40500959;530399
2021-05-03;;Asia;459541;5033;40960500;535432
2021-05-04;;Asia;486940;5209;41447440;540641
2021-05-05;;Asia;518012;5681;41965452;546322
2021-05-06;;Asia;525129;5621;42490581;551943
2021-05-07;;Asia;505096;5716;42995677;557659
2021-05-08;;Asia;498748;5588;43494425;563247
2021-05-09;;Asia;456108;5372;43950533;568619
2021-05-10;;Asia;419111;5510;44369644;574129
2021-05-11;;Asia;443402;5891;44813046;580020
2021-05-12;;Asia;452792;5664;45265838;585684
2021-05-13;;Asia;430299;5465;45696137;591149
2021-05-14;;Asia;399330;5223;46095467;596372
2021-05-15;;Asia;382776;5396;46478243;601768
2021-05-16;;Asia;355902;5537;46834145;607305
2021-05-17;;Asia;346918;5928;47181063;613233
2021-05-18;;Asia;352440;6206;47533503;619439
2021-05-19;;Asia;364239;5489;47897742;624928
2021-05-20;;Asia;346662;5688;48244404;630616
2021-05-21;;Asia;344451;5653;48588855;636269
2021-05-22;;Asia;320609;5109;48909464;641378
2021-05-23;;Asia;295916;5640;49205380;647018
2021-05-24;;Asia;276661;4887;49482041;651905
2021-05-25;;Asia;292393;5430;49774434;657335
2021-05-26;;Asia;291468;5156;50065902;662491
2021-05-27;;Asia;272957;4982;50338859;667473
2021-05-28;;Asia;257555;4992;50596414;672465
2021-05-29;;Asia;240317;4699;50836731;677164
2021-05-30;;Asia;227684;4342;51064415;681506
2021-05-31;;Asia;201450;4018;51265865;685524
2021-06-01;;Asia;207507;4390;51473372;689914
2021-06-02;;Asia;210820;4307;51684192;694221
2021-06-03;;Asia;211920;4093;51896112;698314
2021-06-04;;Asia;195035;4688;52091147;703002
2021-06-05;;Asia;180429;3869;52271576;706871
2021-06-06;;Asia;166208;3628;52437784;710499
2021-06-07;;Asia;148161;3290;52585945;713789
2021-06-08;;Asia;159321;3486;52745266;717275
2021-06-09;;Asia;166855;3439;52912121;720714
2021-06-10;;Asia;165457;8524;53077578;729238
2021-06-11;;Asia;158469;5261;53236047;734499
2021-06-12;;Asia;146850;4370;53382897;738869
2021-06-13;;Asia;139580;5050;53522477;743919
2021-06-14;;Asia;131045;3933;53653522;747852
2021-06-15;;Asia;135673;3686;53789195;751538
2021-06-16;;Asia;140073;3462;53929268;755000
2021-06-17;;Asia;142980;2906;54072248;757906
2021-06-18;;Asia;136969;2824;54209217;760730
2021-06-19;;Asia;123451;2589;54332668;763319
2021-06-20;;Asia;129388;2634;54462056;765953
2021-06-21;;Asia;124465;2585;54586521;768538
2021-06-22;;Asia;131178;2582;54717699;771120
2021-06-23;;Asia;139276;2659;54856975;773779
2021-06-24;;Asia;142815;2619;54999790;776398
2021-06-25;;Asia;135876;2484;55135666;778882
2021-06-26;;Asia;129356;2377;55265022;781259
2021-06-27;;Asia;135125;2308;55400147;783567
2021-06-28;;Asia;131585;2335;55531732;785902
2021-06-29;;Asia;141740;2248;55673472;788150
2021-06-30;;Asia;147355;2439;55820827;790589
2021-07-01;;Asia;155858;2381;55976685;792970
2020-01-26;AU;Australia;4;0;4;0
2020-01-27;AU;Australia;1;0;5;0
2020-01-28;AU;Australia;0;0;5;0
2020-01-29;AU;Australia;1;0;6;0
2020-01-30;AU;Australia;3;0;9;0
2020-01-31;AU;Australia;0;0;9;0
2020-02-01;AU;Australia;3;0;12;0
2020-02-02;AU;Australia;0;0;12;0
2020-02-03;AU;Australia;0;0;12;0
2020-02-04;AU;Australia;1;0;13;0
2020-02-05;AU;Australia;0;0;13;0
2020-02-06;AU;Australia;1;0;14;0
2020-02-07;AU;Australia;1;0;15;0
2020-02-08;AU;Australia;0;0;15;0
2020-02-09;AU;Australia;0;0;15;0
2020-02-10;AU;Australia;0;0;15;0
2020-02-11;AU;Australia;0;0;15;0
2020-02-12;AU;Australia;0;0;15;0
2020-02-13;AU;Australia;0;0;15;0
2020-02-14;AU;Australia;0;0;15;0
2020-02-15;AU;Australia;0;0;15;0
2020-02-16;AU;Australia;0;0;15;0
2020-02-17;AU;Australia;0;0;15;0
2020-02-18;AU;Australia;0;0;15;0
2020-02-19;AU;Australia;0;0;15;0
2020-02-20;AU;Australia;0;0;15;0
2020-02-21;AU;Australia;0;0;15;0
2020-02-22;AU;Australia;0;0;15;0
2020-02-23;AU;Australia;0;0;15;0
2020-02-24;AU;Australia;0;0;15;0
2020-02-25;AU;Australia;0;0;15;0
2020-02-26;AU;Australia;0;0;15;0
2020-02-27;AU;Australia;0;0;15;0
2020-02-28;AU;Australia;0;0;15;0
2020-02-29;AU;Australia;10;0;25;0
2020-03-01;AU;Australia;2;1;27;1
2020-03-02;AU;Australia;3;0;30;1
2020-03-03;AU;Australia;9;0;39;1
2020-03-04;AU;Australia;13;1;52;2
2020-03-05;AU;Australia;3;0;55;2
2020-03-06;AU;Australia;5;0;60;2
2020-03-07;AU;Australia;3;0;63;2
2020-03-08;AU;Australia;13;1;76;3
2020-03-09;AU;Australia;15;0;91;3
2020-03-10;AU;Australia;16;0;107;3
2020-03-11;AU;Australia;21;0;128;3
2020-03-12;AU;Australia;0;0;128;3
2020-03-13;AU;Australia;72;0;200;3
2020-03-14;AU;Australia;50;0;250;3
2020-03-15;AU;Australia;47;0;297;3
2020-03-16;AU;Australia;80;0;377;3
2020-03-17;AU;Australia;75;2;452;5
2020-03-18;AU;Australia;116;1;568;6
2020-03-19;AU;Australia;113;0;681;6
2020-03-20;AU;Australia;110;1;791;7
2020-03-21;AU;Australia;280;0;1071;7
2020-03-22;AU;Australia;478;0;1549;7
2020-03-23;AU;Australia;133;0;1682;7
2020-03-24;AU;Australia;362;1;2044;8
2020-03-25;AU;Australia;320;0;2364;8
2020-03-26;AU;Australia;446;5;2810;13
2020-03-27;AU;Australia;333;0;3143;13
2020-03-28;AU;Australia;497;1;3640;14
2020-03-29;AU;Australia;344;2;3984;16
2020-03-30;AU;Australia;377;1;4361;17
2020-03-31;AU;Australia;198;1;4559;18
2020-04-01;AU;Australia;303;2;4862;20
2020-04-02;AU;Australia;254;4;5116;24
2020-04-03;AU;Australia;214;4;5330;28
2020-04-04;AU;Australia;220;2;5550;30
2020-04-05;AU;Australia;137;5;5687;35
2020-04-06;AU;Australia;110;5;5797;40
2020-04-07;AU;Australia;98;5;5895;45
2020-04-08;AU;Australia;115;5;6010;50
2020-04-09;AU;Australia;98;1;6108;51
2020-04-10;AU;Australia;107;3;6215;54
2020-04-11;AU;Australia;88;3;6303;57
2020-04-12;AU;Australia;12;3;6315;60
2020-04-13;AU;Australia;36;1;6351;61
2020-04-14;AU;Australia;64;1;6415;62
2020-04-15;AU;Australia;25;1;6440;63
2020-04-16;AU;Australia;22;0;6462;63
2020-04-17;AU;Australia;60;3;6522;66
2020-04-18;AU;Australia;46;1;6568;67
2020-04-19;AU;Australia;42;0;6610;67
2020-04-20;AU;Australia;13;0;6623;67
2020-04-21;AU;Australia;22;0;6645;67
2020-04-22;AU;Australia;7;0;6652;67
2020-04-23;AU;Australia;10;8;6662;75
2020-04-24;AU;Australia;15;4;6677;79
2020-04-25;AU;Australia;17;1;6694;80
2020-04-26;AU;Australia;20;3;6714;83
2020-04-27;AU;Australia;7;0;6721;83
2020-04-28;AU;Australia;23;6;6744;89
2020-04-29;AU;Australia;8;2;6752;91
2020-04-30;AU;Australia;14;2;6766;93
2020-05-01;AU;Australia;12;0;6778;93
2020-05-02;AU;Australia;21;1;6799;94
2020-05-03;AU;Australia;23;1;6822;95
2020-05-04;AU;Australia;25;1;6847;96
2020-05-05;AU;Australia;28;1;6875;97
2020-05-06;AU;Australia;19;0;6894;97
2020-05-07;AU;Australia;19;0;6913;97
2020-05-08;AU;Australia;5;0;6918;97
2020-05-09;AU;Australia;21;0;6939;97
2020-05-10;AU;Australia;9;0;6948;97
2020-05-11;AU;Australia;22;0;6970;97
2020-05-12;AU;Australia;10;1;6980;98
2020-05-13;AU;Australia;9;0;6989;98
2020-05-14;AU;Australia;30;0;7019;98
2020-05-15;AU;Australia;16;0;7035;98
2020-05-16;AU;Australia;9;0;7044;98
2020-05-17;AU;Australia;10;1;7054;99
2020-05-18;AU;Australia;14;0;7068;99
2020-05-19;AU;Australia;4;1;7072;100
2020-05-20;AU;Australia;9;0;7081;100
2020-05-21;AU;Australia;14;1;7095;101
2020-05-22;AU;Australia;4;0;7099;101
2020-05-23;AU;Australia;15;1;7114;102
2020-05-24;AU;Australia;0;0;7114;102
2020-05-25;AU;Australia;12;0;7126;102
2020-05-26;AU;Australia;13;1;7139;103
2020-05-27;AU;Australia;11;0;7150;103
2020-05-28;AU;Australia;15;0;7165;103
2020-05-29;AU;Australia;19;0;7184;103
2020-05-30;AU;Australia;8;0;7192;103
2020-05-31;AU;Australia;10;0;7202;103
2020-06-01;AU;Australia;19;-1;7221;102
2020-06-02;AU;Australia;8;0;7229;102
2020-06-03;AU;Australia;11;0;7240;102
2020-06-04;AU;Australia;7;0;7247;102
2020-06-05;AU;Australia;5;0;7252;102
2020-06-06;AU;Australia;7;0;7259;102
2020-06-07;AU;Australia;6;0;7265;102
2020-06-08;AU;Australia;2;0;7267;102
2020-06-09;AU;Australia;7;0;7274;102
2020-06-10;AU;Australia;11;0;7285;102
2020-06-11;AU;Australia;4;0;7289;102
2020-06-12;AU;Australia;5;0;7294;102
2020-06-13;AU;Australia;26;0;7320;102
2020-06-14;AU;Australia;15;0;7335;102
2020-06-15;AU;Australia;12;0;7347;102
2020-06-16;AU;Australia;23;0;7370;102
2020-06-17;AU;Australia;21;0;7391;102
2020-06-18;AU;Australia;18;0;7409;102
2020-06-19;AU;Australia;2;0;7411;102
2020-06-20;AU;Australia;50;0;7461;102
2020-06-21;AU;Australia;13;0;7474;102
2020-06-22;AU;Australia;18;0;7492;102
2020-06-23;AU;Australia;29;1;7521;103
2020-06-24;AU;Australia;37;1;7558;104
2020-06-25;AU;Australia;37;0;7595;104
2020-06-26;AU;Australia;6;0;7601;104
2020-06-27;AU;Australia;85;0;7686;104
2020-06-28;AU;Australia;78;0;7764;104
2020-06-29;AU;Australia;70;0;7834;104
2020-06-30;AU;Australia;86;0;7920;104
2020-07-01;AU;Australia;81;0;8001;104
2020-07-02;AU;Australia;65;0;8066;104
2020-07-03;AU;Australia;194;0;8260;104
2020-07-04;AU;Australia;183;0;8443;104
2020-07-05;AU;Australia;140;2;8583;106
2020-07-06;AU;Australia;172;0;8755;106
2020-07-07;AU;Australia;131;0;8886;106
2020-07-08;AU;Australia;170;0;9056;106
2020-07-09;AU;Australia;318;0;9374;106
2020-07-10;AU;Australia;179;1;9553;107
2020-07-11;AU;Australia;244;1;9797;108
2020-07-12;AU;Australia;183;0;9980;108
2020-07-13;AU;Australia;271;0;10251;108
2020-07-14;AU;Australia;236;3;10487;111
2020-07-15;AU;Australia;323;2;10810;113
2020-07-16;AU;Australia;423;3;11233;116
2020-07-17;AU;Australia;208;2;11441;118
2020-07-18;AU;Australia;361;4;11802;122
2020-07-19;AU;Australia;267;1;12069;123
2020-07-20;AU;Australia;359;3;12428;126
2020-07-21;AU;Australia;466;2;12894;128
2020-07-22;AU;Australia;408;5;13302;133
2020-07-23;AU;Australia;293;6;13595;139
2020-07-24;AU;Australia;355;6;13950;145
2020-07-25;AU;Australia;453;10;14403;155
2020-07-26;AU;Australia;532;6;14935;161
2020-07-27;AU;Australia;368;6;15303;167
2020-07-28;AU;Australia;279;9;15582;176
2020-07-29;AU;Australia;716;13;16298;189
2020-07-30;AU;Australia;605;7;16903;196
2020-07-31;AU;Australia;377;5;17280;201
2020-08-01;AU;Australia;615;7;17895;208
2020-08-02;AU;Australia;423;13;18318;221
2020-08-03;AU;Australia;412;11;18730;232
2020-08-04;AU;Australia;715;15;19445;247
2020-08-05;AU;Australia;445;8;19890;255
2020-08-06;AU;Australia;382;11;20272;266
2020-08-07;AU;Australia;426;12;20698;278
2020-08-08;AU;Australia;386;17;21084;295
2020-08-09;AU;Australia;313;18;21397;313
2020-08-10;AU;Australia;316;18;21713;331
2020-08-11;AU;Australia;414;21;22127;352
2020-08-12;AU;Australia;231;9;22358;361
2020-08-13;AU;Australia;384;14;22742;375
2020-08-14;AU;Australia;293;4;23035;379
2020-08-15;AU;Australia;252;17;23287;396
2020-08-16;AU;Australia;271;25;23558;421
2020-08-17;AU;Australia;215;17;23773;438
2020-08-18;AU;Australia;216;12;23989;450
2020-08-19;AU;Australia;247;13;24236;463
2020-08-20;AU;Australia;171;9;24407;472
2020-08-21;AU;Australia;195;13;24602;485
2020-08-22;AU;Australia;209;17;24811;502
2020-08-23;AU;Australia;104;15;24915;517
2020-08-24;AU;Australia;138;8;25053;525
2020-08-25;AU;Australia;151;24;25204;549
2020-08-26;AU;Australia;118;23;25322;572
2020-08-27;AU;Australia;126;11;25448;583
2020-08-28;AU;Australia;99;17;25547;600
2020-08-29;AU;Australia;123;11;25670;611
2020-08-30;AU;Australia;76;41;25746;652
2020-08-31;AU;Australia;73;5;25819;657
2020-09-01;AU;Australia;104;6;25923;663
2020-09-02;AU;Australia;126;15;26049;678
2020-09-03;AU;Australia;87;59;26136;737
2020-09-04;AU;Australia;71;11;26207;748
2020-09-05;AU;Australia;71;5;26278;753
2020-09-06;AU;Australia;43;9;26321;762
2020-09-07;AU;Australia;52;8;26373;770
2020-09-08;AU;Australia;92;11;26465;781
2020-09-09;AU;Australia;59;7;26524;788
2020-09-10;AU;Australia;40;9;26564;797
2020-09-11;AU;Australia;43;6;26607;803
2020-09-12;AU;Australia;44;7;26651;810
2020-09-13;AU;Australia;41;6;26692;816
2020-09-14;AU;Australia;47;0;26739;816
2020-09-15;AU;Australia;39;8;26778;824
2020-09-16;AU;Australia;35;8;26813;832
2020-09-17;AU;Australia;48;5;26861;837
2020-09-18;AU;Australia;24;7;26885;844
2020-09-19;AU;Australia;13;5;26898;849
2020-09-20;AU;Australia;14;2;26912;851
2020-09-21;AU;Australia;30;3;26942;854
2020-09-22;AU;Australia;30;5;26972;859
2020-09-23;AU;Australia;8;2;26980;861
2020-09-24;AU;Australia;20;8;27000;869
2020-09-25;AU;Australia;16;1;27016;870
2020-09-26;AU;Australia;24;2;27040;872
2020-09-27;AU;Australia;4;3;27044;875
2020-09-28;AU;Australia;11;7;27055;882
2020-09-29;AU;Australia;23;4;27078;886
2020-09-30;AU;Australia;18;2;27096;888
2020-10-01;AU;Australia;13;2;27109;890
2020-10-02;AU;Australia;12;3;27121;893
2020-10-03;AU;Australia;14;1;27135;894
2020-10-04;AU;Australia;13;0;27148;894
2020-10-05;AU;Australia;25;1;27173;895
2020-10-06;AU;Australia;8;2;27181;897
2020-10-07;AU;Australia;25;0;27206;897
2020-10-08;AU;Australia;20;0;27226;897
2020-10-09;AU;Australia;18;0;27244;897
2020-10-10;AU;Australia;19;1;27263;898
2020-10-11;AU;Australia;22;0;27285;898
2020-10-12;AU;Australia;25;1;27310;899
2020-10-13;AU;Australia;27;5;27337;904
2020-10-14;AU;Australia;20;0;27357;904
2020-10-15;AU;Australia;14;0;27371;904
2020-10-16;AU;Australia;7;0;27378;904
2020-10-17;AU;Australia;12;0;27390;904
2020-10-18;AU;Australia;9;1;27399;905
2020-10-19;AU;Australia;6;0;27405;905
2020-10-20;AU;Australia;38;0;27443;905
2020-10-21;AU;Australia;15;0;27458;905
2020-10-22;AU;Australia;18;0;27476;905
2020-10-23;AU;Australia;19;0;27495;905
2020-10-24;AU;Australia;18;0;27513;905
2020-10-25;AU;Australia;12;0;27525;905
2020-10-26;AU;Australia;14;0;27539;905
2020-10-27;AU;Australia;14;2;27553;907
2020-10-28;AU;Australia;12;0;27565;907
2020-10-29;AU;Australia;14;0;27579;907
2020-10-30;AU;Australia;6;0;27585;907
2020-10-31;AU;Australia;10;0;27595;907
2020-11-01;AU;Australia;6;0;27601;907
2020-11-02;AU;Australia;9;0;27610;907
2020-11-03;AU;Australia;12;0;27622;907
2020-11-04;AU;Australia;8;0;27630;907
2020-11-05;AU;Australia;14;0;27644;907
2020-11-06;AU;Australia;8;0;27652;907
2020-11-07;AU;Australia;6;0;27658;907
2020-11-08;AU;Australia;7;0;27665;907
2020-11-09;AU;Australia;4;0;27669;907
2020-11-10;AU;Australia;2;0;27671;907
2020-11-11;AU;Australia;4;0;27675;907
2020-11-12;AU;Australia;1;0;27676;907
2020-11-13;AU;Australia;6;0;27682;907
2020-11-14;AU;Australia;29;0;27711;907
2020-11-15;AU;Australia;38;0;27749;907
2020-11-16;AU;Australia;9;0;27758;907
2020-11-17;AU;Australia;19;0;27777;907
2020-11-18;AU;Australia;8;0;27785;907
2020-11-19;AU;Australia;7;0;27792;907
2020-11-20;AU;Australia;14;0;27806;907
2020-11-21;AU;Australia;15;0;27821;907
2020-11-22;AU;Australia;13;0;27834;907
2020-11-23;AU;Australia;9;0;27843;907
2020-11-24;AU;Australia;10;0;27853;907
2020-11-25;AU;Australia;12;0;27865;907
2020-11-26;AU;Australia;8;0;27873;907
2020-11-27;AU;Australia;13;0;27886;907
2020-11-28;AU;Australia;6;0;27892;907
2020-11-29;AU;Australia;10;1;27902;908
2020-11-30;AU;Australia;10;0;27912;908
2020-12-01;AU;Australia;11;0;27923;908
2020-12-02;AU;Australia;16;0;27939;908
2020-12-03;AU;Australia;10;0;27949;908
2020-12-04;AU;Australia;7;0;27956;908
2020-12-05;AU;Australia;9;0;27965;908
2020-12-06;AU;Australia;7;0;27972;908
2020-12-07;AU;Australia;15;0;27987;908
2020-12-08;AU;Australia;6;0;27993;908
2020-12-09;AU;Australia;7;0;28000;908
2020-12-10;AU;Australia;11;0;28011;908
2020-12-11;AU;Australia;14;0;28025;908
2020-12-12;AU;Australia;5;0;28030;908
2020-12-13;AU;Australia;7;0;28037;908
2020-12-14;AU;Australia;11;0;28048;908
2020-12-15;AU;Australia;12;0;28060;908
2020-12-16;AU;Australia;12;0;28072;908
2020-12-17;AU;Australia;21;0;28093;908
2020-12-18;AU;Australia;33;0;28126;908
2020-12-19;AU;Australia;42;0;28168;908
2020-12-20;AU;Australia;30;0;28198;908
2020-12-21;AU;Australia;21;0;28219;908
2020-12-22;AU;Australia;18;0;28237;908
2020-12-23;AU;Australia;25;0;28262;908
2020-12-24;AU;Australia;12;0;28274;908
2020-12-25;AU;Australia;23;0;28297;908
2020-12-26;AU;Australia;11;0;28308;908
2020-12-27;AU;Australia;29;1;28337;909
2020-12-28;AU;Australia;12;0;28349;909
2020-12-29;AU;Australia;32;0;28381;909
2020-12-30;AU;Australia;24;0;28405;909
2020-12-31;AU;Australia;20;0;28425;909
2021-01-01;AU;Australia;35;0;28460;909
2021-01-02;AU;Australia;24;0;28484;909
2021-01-03;AU;Australia;20;0;28504;909
2021-01-04;AU;Australia;13;0;28517;909
2021-01-05;AU;Australia;19;0;28536;909
2021-01-06;AU;Australia;10;0;28546;909
2021-01-07;AU;Australia;25;0;28571;909
2021-01-08;AU;Australia;11;0;28582;909
2021-01-09;AU;Australia;13;0;28595;909
2021-01-10;AU;Australia;19;0;28614;909
2021-01-11;AU;Australia;20;0;28634;909
2021-01-12;AU;Australia;16;0;28650;909
2021-01-13;AU;Australia;10;0;28660;909
2021-01-14;AU;Australia;9;0;28669;909
2021-01-15;AU;Australia;20;0;28689;909
2021-01-16;AU;Australia;19;0;28708;909
2021-01-17;AU;Australia;13;0;28721;909
2021-01-18;AU;Australia;10;0;28731;909
2021-01-19;AU;Australia;9;0;28740;909
2021-01-20;AU;Australia;9;0;28749;909
2021-01-21;AU;Australia;6;0;28755;909
2021-01-22;AU;Australia;5;0;28760;909
2021-01-23;AU;Australia;6;0;28766;909
2021-01-24;AU;Australia;11;0;28777;909
2021-01-25;AU;Australia;3;0;28780;909
2021-01-26;AU;Australia;6;0;28786;909
2021-01-27;AU;Australia;8;0;28794;909
2021-01-28;AU;Australia;5;0;28799;909
2021-01-29;AU;Australia;7;0;28806;909
2021-01-30;AU;Australia;5;0;28811;909
2021-01-31;AU;Australia;7;0;28818;909
2021-02-01;AU;Australia;5;0;28823;909
2021-02-02;AU;Australia;6;0;28829;909
2021-02-03;AU;Australia;9;0;28838;909
2021-02-04;AU;Australia;4;0;28842;909
2021-02-05;AU;Australia;6;0;28848;909
2021-02-06;AU;Australia;3;0;28851;909
2021-02-07;AU;Australia;6;0;28857;909
2021-02-08;AU;Australia;3;0;28860;909
2021-02-09;AU;Australia;11;0;28871;909
2021-02-10;AU;Australia;8;0;28879;909
2021-02-11;AU;Australia;8;0;28887;909
2021-02-12;AU;Australia;5;0;28892;909
2021-02-13;AU;Australia;6;0;28898;909
2021-02-14;AU;Australia;2;0;28900;909
2021-02-15;AU;Australia;5;0;28905;909
2021-02-16;AU;Australia;6;0;28911;909
2021-02-17;AU;Australia;1;0;28912;909
2021-02-18;AU;Australia;6;0;28918;909
2021-02-19;AU;Australia;2;0;28920;909
2021-02-20;AU;Australia;6;0;28926;909
2021-02-21;AU;Australia;4;0;28930;909
2021-02-22;AU;Australia;7;0;28937;909
2021-02-23;AU;Australia;2;0;28939;909
2021-02-24;AU;Australia;8;0;28947;909
2021-02-25;AU;Australia;10;0;28957;909
2021-02-26;AU;Australia;8;0;28965;909
2021-02-27;AU;Australia;5;0;28970;909
2021-02-28;AU;Australia;8;0;28978;909
2021-03-01;AU;Australia;8;0;28986;909
2021-03-02;AU;Australia;10;0;28996;909
2021-03-03;AU;Australia;11;0;29007;909
2021-03-04;AU;Australia;14;0;29021;909
2021-03-05;AU;Australia;8;0;29029;909
2021-03-06;AU;Australia;5;0;29034;909
2021-03-07;AU;Australia;12;0;29046;909
2021-03-08;AU;Australia;15;0;29061;909
2021-03-09;AU;Australia;13;0;29074;909
2021-03-10;AU;Australia;16;0;29090;909
2021-03-11;AU;Australia;12;0;29102;909
2021-03-12;AU;Australia;10;0;29112;909
2021-03-13;AU;Australia;5;0;29117;909
2021-03-14;AU;Australia;13;0;29130;909
2021-03-15;AU;Australia;7;0;29137;909
2021-03-16;AU;Australia;17;0;29154;909
2021-03-17;AU;Australia;12;0;29166;909
2021-03-18;AU;Australia;17;0;29183;909
2021-03-19;AU;Australia;9;0;29192;909
2021-03-20;AU;Australia;4;0;29196;909
2021-03-21;AU;Australia;10;0;29206;909
2021-03-22;AU;Australia;5;0;29211;909
2021-03-23;AU;Australia;10;0;29221;909
2021-03-24;AU;Australia;9;0;29230;909
2021-03-25;AU;Australia;9;0;29239;909
2021-03-26;AU;Australia;13;0;29252;909
2021-03-27;AU;Australia;7;0;29259;909
2021-03-28;AU;Australia;17;0;29276;909
2021-03-29;AU;Australia;20;0;29296;909
2021-03-30;AU;Australia;8;0;29304;909
2021-03-31;AU;Australia;18;0;29322;909
2021-04-01;AU;Australia;11;0;29333;909
2021-04-02;AU;Australia;8;0;29341;909
2021-04-03;AU;Australia;7;0;29348;909
2021-04-04;AU;Australia;9;0;29357;909
2021-04-05;AU;Australia;8;0;29365;909
2021-04-06;AU;Australia;14;0;29379;909
2021-04-07;AU;Australia;6;0;29385;909
2021-04-08;AU;Australia;5;0;29390;909
2021-04-09;AU;Australia;6;0;29396;909
2021-04-10;AU;Australia;9;0;29405;909
2021-04-11;AU;Australia;14;0;29419;909
2021-04-12;AU;Australia;10;1;29429;910
2021-04-13;AU;Australia;21;0;29450;910
2021-04-14;AU;Australia;19;0;29469;910
2021-04-15;AU;Australia;15;0;29484;910
2021-04-16;AU;Australia;15;0;29499;910
2021-04-17;AU;Australia;20;0;29519;910
2021-04-18;AU;Australia;14;0;29533;910
2021-04-19;AU;Australia;23;0;29556;910
2021-04-20;AU;Australia;20;0;29576;910
2021-04-21;AU;Australia;18;0;29594;910
2021-04-22;AU;Australia;44;0;29638;910
2021-04-23;AU;Australia;15;0;29653;910
2021-04-24;AU;Australia;10;0;29663;910
2021-04-25;AU;Australia;17;0;29680;910
2021-04-26;AU;Australia;37;0;29717;910
2021-04-27;AU;Australia;33;0;29750;910
2021-04-28;AU;Australia;23;0;29773;910
2021-04-29;AU;Australia;25;0;29798;910
2021-04-30;AU;Australia;13;0;29811;910
2021-05-01;AU;Australia;13;0;29824;910
2021-05-02;AU;Australia;14;0;29838;910
2021-05-03;AU;Australia;12;0;29850;910
2021-05-04;AU;Australia;15;0;29865;910
2021-05-05;AU;Australia;19;0;29884;910
2021-05-06;AU;Australia;9;0;29893;910
2021-05-07;AU;Australia;13;0;29906;910
2021-05-08;AU;Australia;16;0;29922;910
2021-05-09;AU;Australia;9;0;29931;910
2021-05-10;AU;Australia;7;0;29938;910
2021-05-11;AU;Australia;8;0;29946;910
2021-05-12;AU;Australia;9;0;29955;910
2021-05-13;AU;Australia;2;0;29957;910
2021-05-14;AU;Australia;7;0;29964;910
2021-05-15;AU;Australia;11;0;29975;910
2021-05-16;AU;Australia;3;0;29978;910
2021-05-17;AU;Australia;5;0;29983;910
2021-05-18;AU;Australia;9;0;29992;910
2021-05-19;AU;Australia;3;0;29995;910
2021-05-20;AU;Australia;4;0;29999;910
2021-05-21;AU;Australia;4;0;30003;910
2021-05-22;AU;Australia;4;0;30007;910
2021-05-23;AU;Australia;12;0;30019;910
2021-05-24;AU;Australia;10;0;30029;910
2021-05-25;AU;Australia;17;0;30046;910
2021-05-26;AU;Australia;17;0;30063;910
2021-05-27;AU;Australia;11;0;30074;910
2021-05-28;AU;Australia;9;0;30083;910
2021-05-29;AU;Australia;13;0;30096;910
2021-05-30;AU;Australia;9;0;30105;910
2021-05-31;AU;Australia;13;0;30118;910
2021-06-01;AU;Australia;6;0;30124;910
2021-06-02;AU;Australia;13;0;30137;910
2021-06-03;AU;Australia;4;0;30141;910
2021-06-04;AU;Australia;16;0;30157;910
2021-06-05;AU;Australia;16;0;30173;910
2021-06-06;AU;Australia;18;0;30191;910
2021-06-07;AU;Australia;14;0;30205;910
2021-06-08;AU;Australia;5;0;30210;910
2021-06-09;AU;Australia;15;0;30225;910
2021-06-10;AU;Australia;3;0;30228;910
2021-06-11;AU;Australia;6;0;30234;910
2021-06-12;AU;Australia;14;0;30248;910
2021-06-13;AU;Australia;14;0;30262;910
2021-06-14;AU;Australia;11;0;30273;910
2021-06-15;AU;Australia;13;0;30286;910
2021-06-16;AU;Australia;15;0;30301;910
2021-06-17;AU;Australia;8;0;30309;910
2021-06-18;AU;Australia;13;0;30322;910
2021-06-19;AU;Australia;9;0;30331;910
2021-06-20;AU;Australia;24;0;30355;910
2021-06-21;AU;Australia;11;0;30366;910
2021-06-22;AU;Australia;14;0;30380;910
2021-06-23;AU;Australia;24;0;30404;910
2021-06-24;AU;Australia;20;0;30424;910
2021-06-25;AU;Australia;33;0;30457;910
2021-06-26;AU;Australia;42;0;30499;910
2021-06-27;AU;Australia;29;0;30528;910
2021-06-28;AU;Australia;32;0;30560;910
2021-06-29;AU;Australia;42;0;30602;910
2021-06-30;AU;Australia;41;0;30643;910
2021-07-01;AU;Australia;41;0;30684;910
2020-02-25;AT;Austria;2;0;2;0
2020-02-26;AT;Austria;0;0;2;0
2020-02-27;AT;Austria;1;0;3;0
2020-02-28;AT;Austria;0;0;3;0
2020-02-29;AT;Austria;6;0;9;0
2020-03-01;AT;Austria;5;0;14;0
2020-03-02;AT;Austria;4;0;18;0
2020-03-03;AT;Austria;3;0;21;0
2020-03-04;AT;Austria;8;0;29;0
2020-03-05;AT;Austria;12;0;41;0
2020-03-06;AT;Austria;14;0;55;0
2020-03-07;AT;Austria;24;0;79;0
2020-03-08;AT;Austria;25;0;104;0
2020-03-09;AT;Austria;27;0;131;0
2020-03-10;AT;Austria;51;0;182;0
2020-03-11;AT;Austria;64;0;246;0
2020-03-12;AT;Austria;56;1;302;1
2020-03-13;AT;Austria;202;0;504;1
2020-03-14;AT;Austria;151;0;655;1
2020-03-15;AT;Austria;205;0;860;1
2020-03-16;AT;Austria;158;2;1018;3
2020-03-17;AT;Austria;314;0;1332;3
2020-03-18;AT;Austria;314;1;1646;4
2020-03-19;AT;Austria;367;2;2013;6
2020-03-20;AT;Austria;375;0;2388;6
2020-03-21;AT;Austria;426;2;2814;8
2020-03-22;AT;Austria;768;8;3582;16
2020-03-23;AT;Austria;892;5;4474;21
2020-03-24;AT;Austria;809;7;5283;28
2020-03-25;AT;Austria;305;2;5588;30
2020-03-26;AT;Austria;1321;19;6909;49
2020-03-27;AT;Austria;748;9;7657;58
2020-03-28;AT;Austria;614;10;8271;68
2020-03-29;AT;Austria;517;18;8788;86
2020-03-30;AT;Austria;830;22;9618;108
2020-03-31;AT;Austria;562;20;10180;128
2020-04-01;AT;Austria;531;18;10711;146
2020-04-02;AT;Austria;418;12;11129;158
2020-04-03;AT;Austria;395;10;11524;168
2020-04-04;AT;Austria;257;18;11781;186
2020-04-05;AT;Austria;270;18;12051;204
2020-04-06;AT;Austria;246;16;12297;220
2020-04-07;AT;Austria;342;23;12639;243
2020-04-08;AT;Austria;303;30;12942;273
2020-04-09;AT;Austria;302;22;13244;295
2020-04-10;AT;Austria;311;24;13555;319
2020-04-11;AT;Austria;251;18;13806;337
2020-04-12;AT;Austria;139;13;13945;350
2020-04-13;AT;Austria;96;18;14041;368
2020-04-14;AT;Austria;185;16;14226;384
2020-04-15;AT;Austria;110;9;14336;393
2020-04-16;AT;Austria;140;17;14476;410
2020-04-17;AT;Austria;119;21;14595;431
2020-04-18;AT;Austria;76;12;14671;443
2020-04-19;AT;Austria;78;9;14749;452
2020-04-20;AT;Austria;46;18;14795;470
2020-04-21;AT;Austria;78;21;14873;491
2020-04-22;AT;Austria;52;19;14925;510
2020-04-23;AT;Austria;77;12;15002;522
2020-04-24;AT;Austria;69;8;15071;530
2020-04-25;AT;Austria;77;6;15148;536
2020-04-26;AT;Austria;77;6;15225;542
2020-04-27;AT;Austria;49;7;15274;549
2020-04-28;AT;Austria;83;20;15357;569
2020-04-29;AT;Austria;45;11;15402;580
2020-04-30;AT;Austria;50;4;15452;584
2020-05-01;AT;Austria;79;5;15531;589
2020-05-02;AT;Austria;27;7;15558;596
2020-05-03;AT;Austria;39;2;15597;598
2020-05-04;AT;Austria;24;2;15621;600
2020-05-05;AT;Austria;29;6;15650;606
2020-05-06;AT;Austria;34;2;15684;608
2020-05-07;AT;Austria;68;1;15752;609
2020-05-08;AT;Austria;22;5;15774;614
2020-05-09;AT;Austria;59;1;15833;615
2020-05-10;AT;Austria;38;3;15871;618
2020-05-11;AT;Austria;11;2;15882;620
2020-05-12;AT;Austria;79;3;15961;623
2020-05-13;AT;Austria;36;1;15997;624
2020-05-14;AT;Austria;61;2;16058;626
2020-05-15;AT;Austria;51;2;16109;628
2020-05-16;AT;Austria;92;1;16201;629
2020-05-17;AT;Austria;41;0;16242;629
2020-05-18;AT;Austria;27;0;16269;629
2020-05-19;AT;Austria;52;3;16321;632
2020-05-20;AT;Austria;32;1;16353;633
2020-05-21;AT;Austria;51;0;16404;633
2020-05-22;AT;Austria;32;2;16436;635
2020-05-23;AT;Austria;50;4;16486;639
2020-05-24;AT;Austria;17;1;16503;640
2020-05-25;AT;Austria;36;1;16539;641
2020-05-26;AT;Austria;18;2;16557;643
2020-05-27;AT;Austria;34;2;16591;645
2020-05-28;AT;Austria;37;23;16628;668
2020-05-29;AT;Austria;27;0;16655;668
2020-05-30;AT;Austria;30;0;16685;668
2020-05-31;AT;Austria;46;0;16731;668
2020-06-01;AT;Austria;2;0;16733;668
2020-06-02;AT;Austria;26;1;16759;669
2020-06-03;AT;Austria;12;1;16771;670
2020-06-04;AT;Austria;34;0;16805;670
2020-06-05;AT;Austria;38;2;16843;672
2020-06-06;AT;Austria;55;0;16898;672
2020-06-07;AT;Austria;4;0;16902;672
2020-06-08;AT;Austria;66;0;16968;672
2020-06-09;AT;Austria;11;0;16979;672
2020-06-10;AT;Austria;26;1;17005;673
2020-06-11;AT;Austria;29;1;17034;674
2020-06-12;AT;Austria;30;1;17064;675
2020-06-13;AT;Austria;14;2;17078;677
2020-06-14;AT;Austria;31;0;17109;677
2020-06-15;AT;Austria;26;1;17135;678
2020-06-16;AT;Austria;54;3;17189;681
2020-06-17;AT;Austria;14;6;17203;687
2020-06-18;AT;Austria;20;1;17223;688
2020-06-19;AT;Austria;48;0;17271;688
2020-06-20;AT;Austria;52;0;17323;688
2020-06-21;AT;Austria;18;2;17341;690
2020-06-22;AT;Austria;39;0;17380;690
2020-06-23;AT;Austria;28;3;17408;693
2020-06-24;AT;Austria;41;0;17449;693
2020-06-25;AT;Austria;28;5;17477;698
2020-06-26;AT;Austria;45;0;17522;698
2020-06-27;AT;Austria;58;2;17580;700
2020-06-28;AT;Austria;74;2;17654;702
2020-06-29;AT;Austria;69;1;17723;703
2020-06-30;AT;Austria;43;2;17766;705
2020-07-01;AT;Austria;107;0;17873;705
2020-07-02;AT;Austria;68;0;17941;705
2020-07-03;AT;Austria;109;0;18050;705
2020-07-04;AT;Austria;115;0;18165;705
2020-07-05;AT;Austria;115;1;18280;706
2020-07-06;AT;Austria;85;0;18365;706
2020-07-07;AT;Austria;56;0;18421;706
2020-07-08;AT;Austria;92;0;18513;706
2020-07-09;AT;Austria;102;0;18615;706
2020-07-10;AT;Austria;94;0;18709;706
2020-07-11;AT;Austria;74;0;18783;706
2020-07-12;AT;Austria;114;2;18897;708
2020-07-13;AT;Austria;51;0;18948;708
2020-07-14;AT;Austria;73;1;19021;709
2020-07-15;AT;Austria;133;1;19154;710
2020-07-16;AT;Austria;116;1;19270;711
2020-07-17;AT;Austria;169;0;19439;711
2020-07-18;AT;Austria;134;0;19573;711
2020-07-19;AT;Austria;82;0;19655;711
2020-07-20;AT;Austria;88;0;19743;711
2020-07-21;AT;Austria;84;-1;19827;710
2020-07-22;AT;Austria;102;1;19929;711
2020-07-23;AT;Austria;170;0;20099;711
2020-07-24;AT;Austria;115;0;20214;711
2020-07-25;AT;Austria;124;1;20338;712
2020-07-26;AT;Austria;134;0;20472;712
2020-07-27;AT;Austria;86;1;20558;713
2020-07-28;AT;Austria;119;0;20677;713
2020-07-29;AT;Austria;173;3;20850;716
2020-07-30;AT;Austria;105;2;20955;718
2020-07-31;AT;Austria;175;0;21130;718
2020-08-01;AT;Austria;82;0;21212;718
2020-08-02;AT;Austria;92;0;21304;718
2020-08-03;AT;Austria;81;0;21385;718
2020-08-04;AT;Austria;96;1;21481;719
2020-08-05;AT;Austria;85;0;21566;719
2020-08-06;AT;Austria;130;0;21696;719
2020-08-07;AT;Austria;141;1;21837;720
2020-08-08;AT;Austria;82;1;21919;721
2020-08-09;AT;Austria;114;0;22033;721
2020-08-10;AT;Austria;73;2;22106;723
2020-08-11;AT;Austria;139;0;22245;723
2020-08-12;AT;Austria;194;1;22439;724
2020-08-13;AT;Austria;155;1;22594;725
2020-08-14;AT;Austria;282;0;22876;725
2020-08-15;AT;Austria;303;3;23179;728
2020-08-16;AT;Austria;191;0;23370;728
2020-08-17;AT;Austria;164;1;23534;729
2020-08-18;AT;Austria;295;0;23829;729
2020-08-19;AT;Austria;255;0;24084;729
2020-08-20;AT;Austria;347;0;24431;729
2020-08-21;AT;Austria;331;1;24762;730
2020-08-22;AT;Austria;300;2;25062;732
2020-08-23;AT;Austria;191;0;25253;732
2020-08-24;AT;Austria;242;1;25495;733
2020-08-25;AT;Austria;211;0;25706;733
2020-08-26;AT;Austria;327;0;26033;733
2020-08-27;AT;Austria;328;0;26361;733
2020-08-28;AT;Austria;229;0;26590;733
2020-08-29;AT;Austria;395;0;26985;733
2020-08-30;AT;Austria;181;0;27166;733
2020-08-31;AT;Austria;272;0;27438;733
2020-09-01;AT;Austria;204;1;27642;734
2020-09-02;AT;Austria;327;0;27969;734
2020-09-03;AT;Austria;403;1;28372;735
2020-09-04;AT;Austria;357;0;28729;735
2020-09-05;AT;Austria;358;0;29087;735
2020-09-06;AT;Austria;184;1;29271;736
2020-09-07;AT;Austria;290;10;29561;746
2020-09-08;AT;Austria;520;1;30081;747
2020-09-09;AT;Austria;502;0;30583;747
2020-09-10;AT;Austria;664;1;31247;748
2020-09-11;AT;Austria;580;2;31827;750
2020-09-12;AT;Austria;869;4;32696;754
2020-09-13;AT;Austria;463;2;33159;756
2020-09-14;AT;Austria;382;1;33541;757
2020-09-15;AT;Austria;764;0;34305;757
2020-09-16;AT;Austria;768;1;35073;758
2020-09-17;AT;Austria;780;0;35853;758
2020-09-18;AT;Austria;808;5;36661;763
2020-09-19;AT;Austria;813;2;37474;765
2020-09-20;AT;Austria;621;1;38095;766
2020-09-21;AT;Austria;563;1;38658;767
2020-09-22;AT;Austria;645;4;39303;771
2020-09-23;AT;Austria;681;6;39984;777
2020-09-24;AT;Austria;832;6;40816;783
2020-09-25;AT;Austria;684;3;41500;786
2020-09-26;AT;Austria;714;1;42214;787
2020-09-27;AT;Austria;662;0;42876;787
2020-09-28;AT;Austria;556;3;43432;790
2020-09-29;AT;Austria;609;6;44041;796
2020-09-30;AT;Austria;772;3;44813;799
2020-10-01;AT;Austria;873;3;45686;802
2020-10-02;AT;Austria;688;1;46374;803
2020-10-03;AT;Austria;1058;6;47432;809
2020-10-04;AT;Austria;714;4;48146;813
2020-10-05;AT;Austria;750;5;48896;818
2020-10-06;AT;Austria;923;4;49819;822
2020-10-07;AT;Austria;1029;8;50848;830
2020-10-08;AT;Austria;1209;8;52057;838
2020-10-09;AT;Austria;1131;4;53188;842
2020-10-10;AT;Austria;1235;10;54423;852
2020-10-11;AT;Austria;896;-1;55319;851
2020-10-12;AT;Austria;979;4;56298;855
2020-10-13;AT;Austria;1028;6;57326;861
2020-10-14;AT;Austria;1346;11;58672;872
2020-10-15;AT;Austria;1552;5;60224;877
2020-10-16;AT;Austria;1163;5;61387;882
2020-10-17;AT;Austria;1747;7;63134;889
2020-10-18;AT;Austria;1672;4;64806;893
2020-10-19;AT;Austria;1121;11;65927;904
2020-10-20;AT;Austria;1524;10;67451;914
2020-10-21;AT;Austria;1958;11;69409;925
2020-10-22;AT;Austria;2435;16;71844;941
2020-10-23;AT;Austria;2571;13;74415;954
2020-10-24;AT;Austria;3614;11;78029;965
2020-10-25;AT;Austria;2782;14;80811;979
2020-10-26;AT;Austria;2456;13;83267;992
2020-10-27;AT;Austria;2835;13;86102;1005
2020-10-28;AT;Austria;3394;22;89496;1027
2020-10-29;AT;Austria;4453;29;93949;1056
2020-10-30;AT;Austria;5627;26;99576;1082
2020-10-31;AT;Austria;5349;27;104925;1109
2020-11-01;AT;Austria;4956;21;109881;1130
2020-11-02;AT;Austria;4135;29;114016;1159
2020-11-03;AT;Austria;4182;33;118198;1192
2020-11-04;AT;Austria;6901;35;125099;1227
2020-11-05;AT;Austria;7416;41;132515;1268
2020-11-06;AT;Austria;6464;72;138979;1340
2020-11-07;AT;Austria;8241;37;147220;1377
2020-11-08;AT;Austria;5933;34;153153;1411
2020-11-09;AT;Austria;5593;43;158746;1454
2020-11-10;AT;Austria;6120;45;164866;1499
2020-11-11;AT;Austria;7514;65;172380;1564
2020-11-12;AT;Austria;9262;44;181642;1608
2020-11-13;AT;Austria;9586;53;191228;1661
2020-11-14;AT;Austria;7063;85;198291;1746
2020-11-15;AT;Austria;5665;83;203956;1829
2020-11-16;AT;Austria;4657;58;208613;1887
2020-11-17;AT;Austria;5984;58;214597;1945
2020-11-18;AT;Austria;7091;109;221688;2054
2020-11-19;AT;Austria;6995;62;228683;2116
2020-11-20;AT;Austria;6668;108;235351;2224
2020-11-21;AT;Austria;6611;104;241962;2328
2020-11-22;AT;Austria;5226;60;247188;2388
2020-11-23;AT;Austria;3145;71;250333;2459
2020-11-24;AT;Austria;4377;118;254710;2577
2020-11-25;AT;Austria;5802;90;260512;2667
2020-11-26;AT;Austria;5526;106;266038;2773
2020-11-27;AT;Austria;4954;113;270992;2886
2020-11-28;AT;Austria;4669;132;275661;3018
2020-11-29;AT;Austria;4047;87;279708;3105
2020-11-30;AT;Austria;2748;79;282456;3184
2020-12-01;AT;Austria;3033;141;285489;3325
2020-12-02;AT;Austria;3972;121;289461;3446
2020-12-03;AT;Austria;3969;92;293430;3538
2020-12-04;AT;Austria;3815;113;297245;3651
2020-12-05;AT;Austria;3444;106;300689;3757
2020-12-06;AT;Austria;2741;83;303430;3840
2020-12-07;AT;Austria;2263;57;305693;3897
2020-12-08;AT;Austria;2377;105;308070;4002
2020-12-09;AT;Austria;2932;54;311002;4056
2020-12-10;AT;Austria;2686;107;313688;4163
2020-12-11;AT;Austria;2893;126;316581;4289
2020-12-12;AT;Austria;3241;126;319822;4415
2020-12-13;AT;Austria;2641;58;322463;4473
2020-12-14;AT;Austria;2588;57;325051;4530
2020-12-15;AT;Austria;2628;118;327679;4648
2020-12-16;AT;Austria;2664;116;330343;4764
2020-12-17;AT;Austria;2485;218;332828;4982
2020-12-18;AT;Austria;2085;145;334913;5127
2020-12-19;AT;Austria;2296;82;337209;5209
2020-12-20;AT;Austria;1645;142;338854;5351
2020-12-21;AT;Austria;1519;84;340373;5435
2020-12-22;AT;Austria;1853;105;342226;5540
2020-12-23;AT;Austria;2131;114;344357;5654
2020-12-24;AT;Austria;2847;91;347204;5745
2020-12-25;AT;Austria;1851;38;349055;5783
2020-12-26;AT;Austria;1429;60;350484;5843
2020-12-27;AT;Austria;1408;38;351892;5881
2020-12-28;AT;Austria;1592;50;353484;5931
2020-12-29;AT;Austria;1868;128;355352;6059
2020-12-30;AT;Austria;2550;90;357902;6149
2020-12-31;AT;Austria;2913;73;360815;6222
2021-01-01;AT;Austria;2096;39;362911;6261
2021-01-02;AT;Austria;1391;14;364302;6275
2021-01-03;AT;Austria;1466;49;365768;6324
2021-01-04;AT;Austria;1642;33;367410;6357
2021-01-05;AT;Austria;2311;100;369721;6457
2021-01-06;AT;Austria;2469;68;372190;6525
2021-01-07;AT;Austria;2540;43;374730;6568
2021-01-08;AT;Austria;2063;73;376793;6641
2021-01-09;AT;Austria;2278;46;379071;6687
2021-01-10;AT;Austria;1651;36;380722;6723
2021-01-11;AT;Austria;1536;24;382258;6747
2021-01-12;AT;Austria;1575;72;383833;6819
2021-01-13;AT;Austria;1917;49;385750;6868
2021-01-14;AT;Austria;3510;53;389260;6921
2021-01-15;AT;Austria;1528;66;390788;6987
2021-01-16;AT;Austria;1723;66;392511;7053
2021-01-17;AT;Austria;1267;29;393778;7082
2021-01-18;AT;Austria;1161;40;394939;7122
2021-01-19;AT;Austria;1486;77;396425;7199
2021-01-20;AT;Austria;1671;38;398096;7237
2021-01-21;AT;Austria;1702;51;399798;7288
2021-01-22;AT;Austria;2088;42;401886;7330
2021-01-23;AT;Austria;1626;59;403512;7389
2021-01-24;AT;Austria;1202;29;404714;7418
2021-01-25;AT;Austria;1009;33;405723;7451
2021-01-26;AT;Austria;1417;64;407140;7515
2021-01-27;AT;Austria;1641;49;408781;7564
2021-01-28;AT;Austria;1449;43;410230;7607
2021-01-29;AT;Austria;1500;51;411730;7658
2021-01-30;AT;Austria;1478;45;413208;7703
2021-01-31;AT;Austria;1190;18;414398;7721
2021-02-01;AT;Austria;1124;57;415522;7778
2021-02-02;AT;Austria;1241;69;416763;7847
2021-02-03;AT;Austria;1520;55;418283;7902
2021-02-04;AT;Austria;1518;34;419801;7936
2021-02-05;AT;Austria;1388;37;421189;7973
2021-02-06;AT;Austria;1333;21;422522;7994
2021-02-07;AT;Austria;1317;18;423839;8012
2021-02-08;AT;Austria;1057;20;424896;8032
2021-02-09;AT;Austria;1197;39;426093;8071
2021-02-10;AT;Austria;1469;43;427562;8114
2021-02-11;AT;Austria;1577;24;429139;8138
2021-02-12;AT;Austria;1731;32;430870;8170
2021-02-13;AT;Austria;1433;25;432303;8195
2021-02-14;AT;Austria;1184;16;433487;8211
2021-02-15;AT;Austria;1225;10;434712;8221
2021-02-16;AT;Austria;1427;39;436139;8260
2021-02-17;AT;Austria;1735;30;437874;8290
2021-02-18;AT;Austria;1967;22;439841;8312
2021-02-19;AT;Austria;1818;36;441659;8348
2021-02-20;AT;Austria;1877;20;443536;8368
2021-02-21;AT;Austria;1838;18;445374;8386
2021-02-22;AT;Austria;1270;11;446644;8397
2021-02-23;AT;Austria;1727;37;448371;8434
2021-02-24;AT;Austria;2005;36;450376;8470
2021-02-25;AT;Austria;2391;23;452767;8493
2021-02-26;AT;Austria;2093;22;454860;8515
2021-02-27;AT;Austria;2457;23;457317;8538
2021-02-28;AT;Austria;2123;23;459440;8561
2021-03-01;AT;Austria;1409;13;460849;8574
2021-03-02;AT;Austria;1920;31;462769;8605
2021-03-03;AT;Austria;2553;20;465322;8625
2021-03-04;AT;Austria;2324;27;467646;8652
2021-03-05;AT;Austria;2668;17;470314;8669
2021-03-06;AT;Austria;2557;25;472871;8694
2021-03-07;AT;Austria;2199;19;475070;8713
2021-03-08;AT;Austria;1910;19;476980;8732
2021-03-09;AT;Austria;2411;25;479391;8757
2021-03-10;AT;Austria;2528;19;481919;8776
2021-03-11;AT;Austria;2997;22;484916;8798
2021-03-12;AT;Austria;3126;33;488042;8831
2021-03-13;AT;Austria;3023;25;491065;8856
2021-03-14;AT;Austria;2503;17;493568;8873
2021-03-15;AT;Austria;1896;19;495464;8892
2021-03-16;AT;Austria;2425;33;497889;8925
2021-03-17;AT;Austria;3335;31;501224;8956
2021-03-18;AT;Austria;3357;26;504581;8982
2021-03-19;AT;Austria;3515;42;508096;9024
2021-03-20;AT;Austria;3344;28;511440;9052
2021-03-21;AT;Austria;2713;22;514153;9074
2021-03-22;AT;Austria;2412;15;516565;9089
2021-03-23;AT;Austria;3415;32;519980;9121
2021-03-24;AT;Austria;3289;30;523269;9151
2021-03-25;AT;Austria;3124;27;526393;9178
2021-03-26;AT;Austria;3895;22;530288;9200
2021-03-27;AT;Austria;3498;31;533786;9231
2021-03-28;AT;Austria;2679;25;536465;9256
2021-03-29;AT;Austria;3076;19;539541;9275
2021-03-30;AT;Austria;3001;33;542542;9308
2021-03-31;AT;Austria;3687;31;546229;9339
2021-04-01;AT;Austria;3363;29;549592;9368
2021-04-02;AT;Austria;3137;29;552729;9397
2021-04-03;AT;Austria;3283;37;556012;9434
2021-04-04;AT;Austria;2743;15;558755;9449
2021-04-05;AT;Austria;2217;33;560972;9482
2021-04-06;AT;Austria;1935;35;562907;9517
2021-04-07;AT;Austria;3101;29;566008;9546
2021-04-08;AT;Austria;2906;40;568914;9586
2021-04-09;AT;Austria;2702;38;571616;9624
2021-04-10;AT;Austria;3139;38;574755;9662
2021-04-11;AT;Austria;2252;25;577007;9687
2021-04-12;AT;Austria;1943;19;578950;9706
2021-04-13;AT;Austria;2313;42;581263;9748
2021-04-14;AT;Austria;2942;31;584205;9779
2021-04-15;AT;Austria;2678;34;586883;9813
2021-04-16;AT;Austria;2416;30;589299;9843
2021-04-17;AT;Austria;2048;27;591347;9870
2021-04-18;AT;Austria;2076;28;593423;9898
2021-04-19;AT;Austria;2117;24;595540;9922
2021-04-20;AT;Austria;2026;37;597566;9959
2021-04-21;AT;Austria;2523;38;600089;9997
2021-04-22;AT;Austria;2405;29;602494;10026
2021-04-23;AT;Austria;2329;29;604823;10055
2021-04-24;AT;Austria;2131;15;606954;10070
2021-04-25;AT;Austria;2025;17;608979;10087
2021-04-26;AT;Austria;1566;11;610545;10098
2021-04-27;AT;Austria;1625;28;612170;10126
2021-04-28;AT;Austria;2340;26;614510;10152
2021-04-29;AT;Austria;2229;27;616739;10179
2021-04-30;AT;Austria;2131;26;618870;10205
2021-05-01;AT;Austria;1615;28;620485;10233
2021-05-02;AT;Austria;1625;12;622110;10245
2021-05-03;AT;Austria;1091;15;623201;10260
2021-05-04;AT;Austria;1394;31;624595;10291
2021-05-05;AT;Austria;1644;20;626239;10311
2021-05-06;AT;Austria;1245;22;627484;10333
2021-05-07;AT;Austria;1333;18;628817;10351
2021-05-08;AT;Austria;1233;23;630050;10374
2021-05-09;AT;Austria;1026;8;631076;10382
2021-05-10;AT;Austria;820;10;631896;10392
2021-05-11;AT;Austria;870;21;632766;10413
2021-05-12;AT;Austria;1194;15;633960;10428
2021-05-13;AT;Austria;933;16;634893;10444
2021-05-14;AT;Austria;887;11;635780;10455
2021-05-15;AT;Austria;644;15;636424;10470
2021-05-16;AT;Austria;673;4;637097;10474
2021-05-17;AT;Austria;476;6;637573;10480
2021-05-18;AT;Austria;582;19;638155;10499
2021-05-19;AT;Austria;899;9;639054;10508
2021-05-20;AT;Austria;562;19;639616;10527
2021-05-21;AT;Austria;677;7;640293;10534
2021-05-22;AT;Austria;583;7;640876;10541
2021-05-23;AT;Austria;504;5;641380;10546
2021-05-24;AT;Austria;360;1;641740;10547
2021-05-25;AT;Austria;398;4;642138;10551
2021-05-26;AT;Austria;445;15;642583;10566
2021-05-27;AT;Austria;585;7;643168;10573
2021-05-28;AT;Austria;541;15;643709;10588
2021-05-29;AT;Austria;498;4;644207;10592
2021-05-30;AT;Austria;379;4;644586;10596
2021-05-31;AT;Austria;229;7;644815;10603
2021-06-01;AT;Austria;337;12;645152;10615
2021-06-02;AT;Austria;400;6;645552;10621
2021-06-03;AT;Austria;282;6;645834;10627
2021-06-04;AT;Austria;333;4;646167;10631
2021-06-05;AT;Austria;271;5;646438;10636
2021-06-06;AT;Austria;362;3;646800;10639
2021-06-07;AT;Austria;279;1;647079;10640
2021-06-08;AT;Austria;243;7;647322;10647
2021-06-09;AT;Austria;366;3;647688;10650
2021-06-10;AT;Austria;283;0;647971;10650
2021-06-11;AT;Austria;216;2;648187;10652
2021-06-12;AT;Austria;200;0;648387;10652
2021-06-13;AT;Austria;233;9;648620;10661
2021-06-14;AT;Austria;112;1;648732;10662
2021-06-15;AT;Austria;117;6;648849;10668
2021-06-16;AT;Austria;153;3;649002;10671
2021-06-17;AT;Austria;179;3;649181;10674
2021-06-18;AT;Austria;128;3;649309;10677
2021-06-19;AT;Austria;136;2;649445;10679
2021-06-20;AT;Austria;131;1;649576;10680
2021-06-21;AT;Austria;94;0;649670;10680
2021-06-22;AT;Austria;58;4;649728;10684
2021-06-23;AT;Austria;117;2;649845;10686
2021-06-24;AT;Austria;77;11;649922;10697
2021-06-25;AT;Austria;94;3;650016;10700
2021-06-26;AT;Austria;176;-1;650192;10699
2021-06-27;AT;Austria;69;1;650261;10700
2021-06-28;AT;Austria;63;1;650324;10701
2021-06-29;AT;Austria;29;-1;650353;10700
2021-06-30;AT;Austria;59;2;650412;10702
2021-07-01;AT;Austria;62;4;650474;10706
2020-03-01;AZ;Azerbaijan;3;0;3;0
2020-03-02;AZ;Azerbaijan;0;0;3;0
2020-03-03;AZ;Azerbaijan;0;0;3;0
2020-03-04;AZ;Azerbaijan;0;0;3;0
2020-03-05;AZ;Azerbaijan;3;0;6;0
2020-03-06;AZ;Azerbaijan;0;0;6;0
2020-03-07;AZ;Azerbaijan;3;0;9;0
2020-03-08;AZ;Azerbaijan;0;0;9;0
2020-03-09;AZ;Azerbaijan;0;0;9;0
2020-03-10;AZ;Azerbaijan;2;0;11;0
2020-03-11;AZ;Azerbaijan;0;0;11;0
2020-03-12;AZ;Azerbaijan;0;0;11;0
2020-03-13;AZ;Azerbaijan;4;1;15;1
2020-03-14;AZ;Azerbaijan;0;0;15;1
2020-03-15;AZ;Azerbaijan;8;0;23;1
2020-03-16;AZ;Azerbaijan;5;0;28;1
2020-03-17;AZ;Azerbaijan;0;0;28;1
2020-03-18;AZ;Azerbaijan;0;0;28;1
2020-03-19;AZ;Azerbaijan;16;0;44;1
2020-03-20;AZ;Azerbaijan;0;0;44;1
2020-03-21;AZ;Azerbaijan;9;0;53;1
2020-03-22;AZ;Azerbaijan;12;0;65;1
2020-03-23;AZ;Azerbaijan;7;0;72;1
2020-03-24;AZ;Azerbaijan;15;0;87;1
2020-03-25;AZ;Azerbaijan;6;1;93;2
2020-03-26;AZ;Azerbaijan;29;1;122;3
2020-03-27;AZ;Azerbaijan;43;0;165;3
2020-03-28;AZ;Azerbaijan;17;1;182;4
2020-03-29;AZ;Azerbaijan;27;0;209;4
2020-03-30;AZ;Azerbaijan;64;0;273;4
2020-03-31;AZ;Azerbaijan;25;1;298;5
2020-04-01;AZ;Azerbaijan;61;0;359;5
2020-04-02;AZ;Azerbaijan;41;0;400;5
2020-04-03;AZ;Azerbaijan;43;0;443;5
2020-04-04;AZ;Azerbaijan;78;0;521;5
2020-04-05;AZ;Azerbaijan;63;2;584;7
2020-04-06;AZ;Azerbaijan;57;0;641;7
2020-04-07;AZ;Azerbaijan;76;1;717;8
2020-04-08;AZ;Azerbaijan;105;0;822;8
2020-04-09;AZ;Azerbaijan;104;1;926;9
2020-04-10;AZ;Azerbaijan;65;1;991;10
2020-04-11;AZ;Azerbaijan;67;1;1058;11
2020-04-12;AZ;Azerbaijan;40;0;1098;11
2020-04-13;AZ;Azerbaijan;50;1;1148;12
2020-04-14;AZ;Azerbaijan;49;1;1197;13
2020-04-15;AZ;Azerbaijan;56;0;1253;13
2020-04-16;AZ;Azerbaijan;30;2;1283;15
2020-04-17;AZ;Azerbaijan;57;0;1340;15
2020-04-18;AZ;Azerbaijan;33;3;1373;18
2020-04-19;AZ;Azerbaijan;25;1;1398;19
2020-04-20;AZ;Azerbaijan;38;0;1436;19
2020-04-21;AZ;Azerbaijan;44;1;1480;20
2020-04-22;AZ;Azerbaijan;38;0;1518;20
2020-04-23;AZ;Azerbaijan;30;0;1548;20
2020-04-24;AZ;Azerbaijan;44;1;1592;21
2020-04-25;AZ;Azerbaijan;25;0;1617;21
2020-04-26;AZ;Azerbaijan;28;0;1645;21
2020-04-27;AZ;Azerbaijan;33;1;1678;22
2020-04-28;AZ;Azerbaijan;39;0;1717;22
2020-04-29;AZ;Azerbaijan;49;1;1766;23
2020-04-30;AZ;Azerbaijan;38;1;1804;24
2020-05-01;AZ;Azerbaijan;50;1;1854;25
2020-05-02;AZ;Azerbaijan;40;0;1894;25
2020-05-03;AZ;Azerbaijan;38;0;1932;25
2020-05-04;AZ;Azerbaijan;52;1;1984;26
2020-05-05;AZ;Azerbaijan;76;0;2060;26
2020-05-06;AZ;Azerbaijan;67;2;2127;28
2020-05-07;AZ;Azerbaijan;77;0;2204;28
2020-05-08;AZ;Azerbaijan;75;0;2279;28
2020-05-09;AZ;Azerbaijan;143;3;2422;31
2020-05-10;AZ;Azerbaijan;97;1;2519;32
2020-05-11;AZ;Azerbaijan;70;0;2589;32
2020-05-12;AZ;Azerbaijan;104;1;2693;33
2020-05-13;AZ;Azerbaijan;65;2;2758;35
2020-05-14;AZ;Azerbaijan;121;0;2879;35
2020-05-15;AZ;Azerbaijan;101;1;2980;36
2020-05-16;AZ;Azerbaijan;158;0;3138;36
2020-05-17;AZ;Azerbaijan;136;3;3274;39
2020-05-18;AZ;Azerbaijan;113;1;3387;40
2020-05-19;AZ;Azerbaijan;131;1;3518;41
2020-05-20;AZ;Azerbaijan;113;2;3631;43
2020-05-21;AZ;Azerbaijan;118;1;3749;44
2020-05-22;AZ;Azerbaijan;106;2;3855;46
2020-05-23;AZ;Azerbaijan;127;3;3982;49
2020-05-24;AZ;Azerbaijan;140;0;4122;49
2020-05-25;AZ;Azerbaijan;149;2;4271;51
2020-05-26;AZ;Azerbaijan;132;1;4403;52
2020-05-27;AZ;Azerbaijan;165;2;4568;54
2020-05-28;AZ;Azerbaijan;191;2;4759;56
2020-05-29;AZ;Azerbaijan;230;2;4989;58
2020-05-30;AZ;Azerbaijan;257;3;5246;61
2020-05-31;AZ;Azerbaijan;248;2;5494;63
2020-06-01;AZ;Azerbaijan;168;5;5662;68
2020-06-02;AZ;Azerbaijan;273;3;5935;71
2020-06-03;AZ;Azerbaijan;325;5;6260;76
2020-06-04;AZ;Azerbaijan;262;2;6522;78
2020-06-05;AZ;Azerbaijan;338;4;6860;82
2020-06-06;AZ;Azerbaijan;379;2;7239;84
2020-06-07;AZ;Azerbaijan;314;4;7553;88
2020-06-08;AZ;Azerbaijan;323;5;7876;93
2020-06-09;AZ;Azerbaijan;315;5;8191;98
2020-06-10;AZ;Azerbaijan;339;4;8530;102
2020-06-11;AZ;Azerbaijan;352;6;8882;108
2020-06-12;AZ;Azerbaijan;336;5;9218;113
2020-06-13;AZ;Azerbaijan;352;2;9570;115
2020-06-14;AZ;Azerbaijan;387;4;9957;119
2020-06-15;AZ;Azerbaijan;367;3;10324;122
2020-06-16;AZ;Azerbaijan;338;4;10662;126
2020-06-17;AZ;Azerbaijan;329;7;10991;133
2020-06-18;AZ;Azerbaijan;338;6;11329;139
2020-06-19;AZ;Azerbaijan;438;4;11767;143
2020-06-20;AZ;Azerbaijan;471;5;12238;148
2020-06-21;AZ;Azerbaijan;491;6;12729;154
2020-06-22;AZ;Azerbaijan;478;7;13207;161
2020-06-23;AZ;Azerbaijan;508;6;13715;167
2020-06-24;AZ;Azerbaijan;590;7;14305;174
2020-06-25;AZ;Azerbaijan;547;6;14852;180
2020-06-26;AZ;Azerbaijan;517;7;15369;187
2020-06-27;AZ;Azerbaijan;521;6;15890;193
2020-06-28;AZ;Azerbaijan;534;5;16424;198
2020-06-29;AZ;Azerbaijan;544;8;16968;206
2020-06-30;AZ;Azerbaijan;556;7;17524;213
2020-07-01;AZ;Azerbaijan;588;7;18112;220
2020-07-02;AZ;Azerbaijan;572;8;18684;228
2020-07-03;AZ;Azerbaijan;583;7;19267;235
2020-07-04;AZ;Azerbaijan;534;6;19801;241
2020-07-05;AZ;Azerbaijan;523;9;20324;250
2020-07-06;AZ;Azerbaijan;513;8;20837;258
2020-07-07;AZ;Azerbaijan;537;7;21374;265
2020-07-08;AZ;Azerbaijan;542;9;21916;274
2020-07-09;AZ;Azerbaijan;548;10;22464;284
2020-07-10;AZ;Azerbaijan;526;8;22990;292
2020-07-11;AZ;Azerbaijan;531;6;23521;298
2020-07-12;AZ;Azerbaijan;520;8;24041;306
2020-07-13;AZ;Azerbaijan;529;7;24570;313
2020-07-14;AZ;Azerbaijan;543;6;25113;319
2020-07-15;AZ;Azerbaijan;559;7;25672;326
2020-07-16;AZ;Azerbaijan;493;8;26165;334
2020-07-17;AZ;Azerbaijan;471;7;26636;341
2020-07-18;AZ;Azerbaijan;497;8;27133;349
2020-07-19;AZ;Azerbaijan;388;5;27521;354
2020-07-20;AZ;Azerbaijan;369;9;27890;363
2020-07-21;AZ;Azerbaijan;352;13;28242;376
2020-07-22;AZ;Azerbaijan;391;9;28633;385
2020-07-23;AZ;Azerbaijan;347;6;28980;391
2020-07-24;AZ;Azerbaijan;332;9;29312;400
2020-07-25;AZ;Azerbaijan;321;8;29633;408
2020-07-26;AZ;Azerbaijan;417;9;30050;417
2020-07-27;AZ;Azerbaijan;396;6;30446;423
2020-07-28;AZ;Azerbaijan;412;7;30858;430
2020-07-29;AZ;Azerbaijan;363;8;31221;438
2020-07-30;AZ;Azerbaijan;339;3;31560;441
2020-07-31;AZ;Azerbaijan;318;7;31878;448
2020-08-01;AZ;Azerbaijan;279;6;32157;454
2020-08-02;AZ;Azerbaijan;286;8;32443;462
2020-08-03;AZ;Azerbaijan;241;6;32684;468
2020-08-04;AZ;Azerbaijan;226;5;32910;473
2020-08-05;AZ;Azerbaijan;193;3;33103;476
2020-08-06;AZ;Azerbaijan;144;3;33247;479
2020-08-07;AZ;Azerbaijan;129;4;33376;483
2020-08-08;AZ;Azerbaijan;105;5;33481;488
2020-08-09;AZ;Azerbaijan;87;2;33568;490
2020-08-10;AZ;Azerbaijan;79;2;33647;492
2020-08-11;AZ;Azerbaijan;84;3;33731;495
2020-08-12;AZ;Azerbaijan;93;2;33824;497
2020-08-13;AZ;Azerbaijan;91;3;33915;500
2020-08-14;AZ;Azerbaijan;103;4;34018;504
2020-08-15;AZ;Azerbaijan;89;2;34107;506
2020-08-16;AZ;Azerbaijan;112;0;34219;506
2020-08-17;AZ;Azerbaijan;124;2;34343;508
2020-08-18;AZ;Azerbaijan;131;1;34474;509
2020-08-19;AZ;Azerbaijan;146;1;34620;510
2020-08-20;AZ;Azerbaijan;139;0;34759;510
2020-08-21;AZ;Azerbaijan;162;2;34921;512
2020-08-22;AZ;Azerbaijan;184;3;35105;515
2020-08-23;AZ;Azerbaijan;169;3;35274;518
2020-08-24;AZ;Azerbaijan;152;1;35426;519
2020-08-25;AZ;Azerbaijan;133;2;35559;521
2020-08-26;AZ;Azerbaijan;148;1;35707;522
2020-08-27;AZ;Azerbaijan;137;2;35844;524
2020-08-28;AZ;Azerbaijan;142;3;35986;527
2020-08-29;AZ;Azerbaijan;188;2;36174;529
2020-08-30;AZ;Azerbaijan;135;2;36309;531
2020-08-31;AZ;Azerbaijan;126;3;36435;534
2020-09-01;AZ;Azerbaijan;143;2;36578;536
2020-09-02;AZ;Azerbaijan;154;2;36732;538
2020-09-03;AZ;Azerbaijan;167;3;36899;541
2020-09-04;AZ;Azerbaijan;132;2;37031;543
2020-09-05;AZ;Azerbaijan;161;2;37192;545
2020-09-06;AZ;Azerbaijan;137;3;37329;548
2020-09-07;AZ;Azerbaijan;89;3;37418;551
2020-09-08;AZ;Azerbaijan;139;1;37557;552
2020-09-09;AZ;Azerbaijan;175;3;37732;555
2020-09-10;AZ;Azerbaijan;142;1;37874;556
2020-09-11;AZ;Azerbaijan;163;1;38037;557
2020-09-12;AZ;Azerbaijan;135;2;38172;559
2020-09-13;AZ;Azerbaijan;155;3;38327;562
2020-09-14;AZ;Azerbaijan;76;2;38403;564
2020-09-15;AZ;Azerbaijan;114;2;38517;566
2020-09-16;AZ;Azerbaijan;141;3;38658;569
2020-09-17;AZ;Azerbaijan;119;2;38777;571
2020-09-18;AZ;Azerbaijan;117;1;38894;572
2020-09-19;AZ;Azerbaijan;148;2;39042;574
2020-09-20;AZ;Azerbaijan;146;1;39188;575
2020-09-21;AZ;Azerbaijan;92;1;39280;576
2020-09-22;AZ;Azerbaijan;98;2;39378;578
2020-09-23;AZ;Azerbaijan;146;2;39524;580
2020-09-24;AZ;Azerbaijan;162;1;39686;581
2020-09-25;AZ;Azerbaijan;101;2;39787;583
2020-09-26;AZ;Azerbaijan;108;2;39895;585
2020-09-27;AZ;Azerbaijan;128;1;40023;586
2020-09-28;AZ;Azerbaijan;38;2;40061;588
2020-09-29;AZ;Azerbaijan;58;2;40119;590
2020-09-30;AZ;Azerbaijan;110;1;40229;591
2020-10-01;AZ;Azerbaijan;80;2;40309;593
2020-10-02;AZ;Azerbaijan;144;1;40453;594
2020-10-03;AZ;Azerbaijan;108;1;40561;595
2020-10-04;AZ;Azerbaijan;130;1;40691;596
2020-10-05;AZ;Azerbaijan;97;2;40788;598
2020-10-06;AZ;Azerbaijan;143;2;40931;600
2020-10-07;AZ;Azerbaijan;182;2;41113;602
2020-10-08;AZ;Azerbaijan;191;1;41304;603
2020-10-09;AZ;Azerbaijan;215;2;41519;605
2020-10-10;AZ;Azerbaijan;233;3;41752;608
2020-10-11;AZ;Azerbaijan;230;1;41982;609
2020-10-12;AZ;Azerbaijan;122;0;42104;609
2020-10-13;AZ;Azerbaijan;277;3;42381;612
2020-10-14;AZ;Azerbaijan;369;4;42750;616
2020-10-15;AZ;Azerbaijan;530;3;43280;619
2020-10-16;AZ;Azerbaijan;509;2;43789;621
2020-10-17;AZ;Azerbaijan;528;2;44317;623
2020-10-18;AZ;Azerbaijan;647;3;44964;626
2020-10-19;AZ;Azerbaijan;331;4;45295;630
2020-10-20;AZ;Azerbaijan;584;5;45879;635
2020-10-21;AZ;Azerbaijan;714;7;46593;642
2020-10-22;AZ;Azerbaijan;825;6;47418;648
2020-10-23;AZ;Azerbaijan;803;8;48221;656
2020-10-24;AZ;Azerbaijan;792;8;49013;664
2020-10-25;AZ;Azerbaijan;946;7;49959;671
2020-10-26;AZ;Azerbaijan;527;8;50486;679
2020-10-27;AZ;Azerbaijan;663;9;51149;688
2020-10-28;AZ;Azerbaijan;988;11;52137;699
2020-10-29;AZ;Azerbaijan;1015;9;53152;708
2020-10-30;AZ;Azerbaijan;1022;10;54174;718
2020-10-31;AZ;Azerbaijan;1095;12;55269;730
2020-11-01;AZ;Azerbaijan;1175;10;56444;740
2020-11-02;AZ;Azerbaijan;596;13;57040;753
2020-11-03;AZ;Azerbaijan;1242;15;58282;768
2020-11-04;AZ;Azerbaijan;1227;12;59509;780
2020-11-05;AZ;Azerbaijan;1364;14;60873;794
2020-11-06;AZ;Azerbaijan;1465;17;62338;811
2020-11-07;AZ;Azerbaijan;1410;13;63748;824
2020-11-08;AZ;Azerbaijan;1663;16;65411;840
2020-11-09;AZ;Azerbaijan;635;12;66046;852
2020-11-10;AZ;Azerbaijan;1346;15;67392;867
2020-11-11;AZ;Azerbaijan;1202;18;68594;885
2020-11-12;AZ;Azerbaijan;1622;20;70216;905
2020-11-13;AZ;Azerbaijan;1364;22;71580;927
2020-11-14;AZ;Azerbaijan;1849;19;73429;946
2020-11-15;AZ;Azerbaijan;2259;21;75688;967
2020-11-16;AZ;Azerbaijan;1395;18;77083;985
2020-11-17;AZ;Azerbaijan;2075;20;79158;1005
2020-11-18;AZ;Azerbaijan;2239;25;81397;1030
2020-11-19;AZ;Azerbaijan;2597;23;83994;1053
2020-11-20;AZ;Azerbaijan;3169;26;87163;1079
2020-11-21;AZ;Azerbaijan;2735;28;89898;1107
2020-11-22;AZ;Azerbaijan;3196;24;93094;1131
2020-11-23;AZ;Azerbaijan;2187;29;95281;1160
2020-11-24;AZ;Azerbaijan;3646;34;98927;1194
2020-11-25;AZ;Azerbaijan;3469;30;102396;1224
2020-11-26;AZ;Azerbaijan;3705;32;106101;1256
2020-11-27;AZ;Azerbaijan;3712;35;109813;1291
2020-11-28;AZ;Azerbaijan;4212;32;114025;1323
2020-11-29;AZ;Azerbaijan;4170;38;118195;1361
2020-11-30;AZ;Azerbaijan;2981;31;121176;1392
2020-12-01;AZ;Azerbaijan;4426;41;125602;1433
2020-12-02;AZ;Azerbaijan;3942;37;129544;1470
2020-12-03;AZ;Azerbaijan;4189;40;133733;1510
2020-12-04;AZ;Azerbaijan;4267;41;138000;1551
2020-12-05;AZ;Azerbaijan;4323;42;142323;1593
2020-12-06;AZ;Azerbaijan;4356;39;146679;1632
2020-12-07;AZ;Azerbaijan;3086;43;149765;1675
2020-12-08;AZ;Azerbaijan;4387;38;154152;1713
2020-12-09;AZ;Azerbaijan;4403;42;158555;1755
2020-12-10;AZ;Azerbaijan;4219;38;162774;1793
2020-12-11;AZ;Azerbaijan;4381;47;167155;1840
2020-12-12;AZ;Azerbaijan;4268;43;171423;1883
2020-12-13;AZ;Azerbaijan;4451;39;175874;1922
2020-12-14;AZ;Azerbaijan;3112;44;178986;1966
2020-12-15;AZ;Azerbaijan;4273;41;183259;2007
2020-12-16;AZ;Azerbaijan;4077;43;187336;2050
2020-12-17;AZ;Azerbaijan;4124;38;191460;2088
2020-12-18;AZ;Azerbaijan;3962;45;195422;2133
2020-12-19;AZ;Azerbaijan;3705;42;199127;2175
2020-12-20;AZ;Azerbaijan;2961;35;202088;2210
2020-12-21;AZ;Azerbaijan;1505;43;203593;2253
2020-12-22;AZ;Azerbaijan;2284;41;205877;2294
2020-12-23;AZ;Azerbaijan;2334;46;208211;2340
2020-12-24;AZ;Azerbaijan;1850;40;210061;2380
2020-12-25;AZ;Azerbaijan;1703;36;211764;2416
2020-12-26;AZ;Azerbaijan;1428;38;213192;2454
2020-12-27;AZ;Azerbaijan;1519;45;214711;2499
2020-12-28;AZ;Azerbaijan;772;39;215483;2538
2020-12-29;AZ;Azerbaijan;1101;37;216584;2575
2020-12-30;AZ;Azerbaijan;1052;34;217636;2609
2020-12-31;AZ;Azerbaijan;1064;32;218700;2641
2021-01-01;AZ;Azerbaijan;341;29;219041;2670
2021-01-02;AZ;Azerbaijan;421;33;219462;2703
2021-01-03;AZ;Azerbaijan;803;30;220265;2733
2021-01-04;AZ;Azerbaijan;334;28;220599;2761
2021-01-05;AZ;Azerbaijan;802;31;221401;2792
2021-01-06;AZ;Azerbaijan;799;26;222200;2818
2021-01-07;AZ;Azerbaijan;685;27;222885;2845
2021-01-08;AZ;Azerbaijan;532;24;223417;2869
2021-01-09;AZ;Azerbaijan;633;21;224050;2890
2021-01-10;AZ;Azerbaijan;601;19;224651;2909
2021-01-11;AZ;Azerbaijan;176;17;224827;2926
2021-01-12;AZ;Azerbaijan;519;15;225346;2941
2021-01-13;AZ;Azerbaijan;474;16;225820;2957
2021-01-14;AZ;Azerbaijan;380;14;226200;2971
2021-01-15;AZ;Azerbaijan;349;12;226549;2983
2021-01-16;AZ;Azerbaijan;402;15;226951;2998
2021-01-17;AZ;Azerbaijan;322;11;227273;3009
2021-01-18;AZ;Azerbaijan;118;13;227391;3022
2021-01-19;AZ;Azerbaijan;305;10;227696;3032
2021-01-20;AZ;Azerbaijan;332;12;228028;3044
2021-01-21;AZ;Azerbaijan;218;9;228246;3053
2021-01-22;AZ;Azerbaijan;280;11;228526;3064
2021-01-23;AZ;Azerbaijan;162;8;228688;3072
2021-01-24;AZ;Azerbaijan;287;10;228975;3082
2021-01-25;AZ;Azerbaijan;57;11;229032;3093
2021-01-26;AZ;Azerbaijan;326;7;229358;3100
2021-01-27;AZ;Azerbaijan;226;5;229584;3105
2021-01-28;AZ;Azerbaijan;209;8;229793;3113
2021-01-29;AZ;Azerbaijan;142;6;229935;3119
2021-01-30;AZ;Azerbaijan;131;7;230066;3126
2021-01-31;AZ;Azerbaijan;153;6;230219;3132
2021-02-01;AZ;Azerbaijan;77;4;230296;3136
2021-02-02;AZ;Azerbaijan;159;5;230455;3141
2021-02-03;AZ;Azerbaijan;162;4;230617;3145
2021-02-04;AZ;Azerbaijan;152;3;230769;3148
2021-02-05;AZ;Azerbaijan;138;5;230907;3153
2021-02-06;AZ;Azerbaijan;115;3;231022;3156
2021-02-07;AZ;Azerbaijan;132;2;231154;3158
2021-02-08;AZ;Azerbaijan;44;3;231198;3161
2021-02-09;AZ;Azerbaijan;164;2;231362;3163
2021-02-10;AZ;Azerbaijan;147;4;231509;3167
2021-02-11;AZ;Azerbaijan;140;3;231649;3170
2021-02-12;AZ;Azerbaijan;191;3;231840;3173
2021-02-13;AZ;Azerbaijan;155;5;231995;3178
2021-02-14;AZ;Azerbaijan;128;2;232123;3180
2021-02-15;AZ;Azerbaijan;74;3;232197;3183
2021-02-16;AZ;Azerbaijan;140;2;232337;3185
2021-02-17;AZ;Azerbaijan;154;2;232491;3187
2021-02-18;AZ;Azerbaijan;145;3;232636;3190
2021-02-19;AZ;Azerbaijan;193;3;232829;3193
2021-02-20;AZ;Azerbaijan;144;2;232973;3195
2021-02-21;AZ;Azerbaijan;156;3;233129;3198
2021-02-22;AZ;Azerbaijan;72;4;233201;3202
2021-02-23;AZ;Azerbaijan;223;2;233424;3204
2021-02-24;AZ;Azerbaijan;220;2;233644;3206
2021-02-25;AZ;Azerbaijan;126;3;233770;3209
2021-02-26;AZ;Azerbaijan;219;4;233989;3213
2021-02-27;AZ;Azerbaijan;278;5;234267;3218
2021-02-28;AZ;Azerbaijan;270;2;234537;3220
2021-03-01;AZ;Azerbaijan;125;3;234662;3223
2021-03-02;AZ;Azerbaijan;352;2;235014;3225
2021-03-03;AZ;Azerbaijan;319;5;235333;3230
2021-03-04;AZ;Azerbaijan;314;2;235647;3232
2021-03-05;AZ;Azerbaijan;365;3;236012;3235
2021-03-06;AZ;Azerbaijan;353;3;236365;3238
2021-03-07;AZ;Azerbaijan;403;3;236768;3241
2021-03-08;AZ;Azerbaijan;195;6;236963;3247
2021-03-09;AZ;Azerbaijan;297;3;237260;3250
2021-03-10;AZ;Azerbaijan;515;7;237775;3257
2021-03-11;AZ;Azerbaijan;608;5;238383;3262
2021-03-12;AZ;Azerbaijan;576;6;238959;3268
2021-03-13;AZ;Azerbaijan;733;8;239692;3276
2021-03-14;AZ;Azerbaijan;603;6;240295;3282
2021-03-15;AZ;Azerbaijan;376;4;240671;3286
2021-03-16;AZ;Azerbaijan;980;12;241651;3298
2021-03-17;AZ;Azerbaijan;840;9;242491;3307
2021-03-18;AZ;Azerbaijan;933;7;243424;3314
2021-03-19;AZ;Azerbaijan;879;11;244303;3325
2021-03-20;AZ;Azerbaijan;1187;14;245490;3339
2021-03-21;AZ;Azerbaijan;814;12;246304;3351
2021-03-22;AZ;Azerbaijan;670;15;246974;3366
2021-03-23;AZ;Azerbaijan;1333;18;248307;3384
2021-03-24;AZ;Azerbaijan;1185;20;249492;3404
2021-03-25;AZ;Azerbaijan;1429;17;250921;3421
2021-03-26;AZ;Azerbaijan;1759;24;252680;3445
2021-03-27;AZ;Azerbaijan;1690;19;254370;3464
2021-03-28;AZ;Azerbaijan;1831;27;256201;3491
2021-03-29;AZ;Azerbaijan;1129;22;257330;3513
2021-03-30;AZ;Azerbaijan;2146;25;259476;3538
2021-03-31;AZ;Azerbaijan;2237;29;261713;3567
2021-04-01;AZ;Azerbaijan;2248;26;263961;3593
2021-04-02;AZ;Azerbaijan;2361;24;266322;3617
2021-04-03;AZ;Azerbaijan;1852;31;268174;3648
2021-04-04;AZ;Azerbaijan;2561;29;270735;3677
2021-04-05;AZ;Azerbaijan;1099;34;271834;3711
2021-04-06;AZ;Azerbaijan;2035;32;273869;3743
2021-04-07;AZ;Azerbaijan;2595;37;276464;3780
2021-04-08;AZ;Azerbaijan;2717;31;279181;3811
2021-04-09;AZ;Azerbaijan;2206;35;281387;3846
2021-04-10;AZ;Azerbaijan;2192;33;283579;3879
2021-04-11;AZ;Azerbaijan;2414;36;285993;3915
2021-04-12;AZ;Azerbaijan;1151;29;287144;3944
2021-04-13;AZ;Azerbaijan;2457;34;289601;3978
2021-04-14;AZ;Azerbaijan;2293;31;291894;4009
2021-04-15;AZ;Azerbaijan;2317;36;294211;4045
2021-04-16;AZ;Azerbaijan;2163;32;296374;4077
2021-04-17;AZ;Azerbaijan;2148;30;298522;4107
2021-04-18;AZ;Azerbaijan;2144;33;300666;4140
2021-04-19;AZ;Azerbaijan;995;29;301661;4169
2021-04-20;AZ;Azerbaijan;2197;34;303858;4203
2021-04-21;AZ;Azerbaijan;2075;32;305933;4235
2021-04-22;AZ;Azerbaijan;2047;39;307980;4274
2021-04-23;AZ;Azerbaijan;1809;33;309789;4307
2021-04-24;AZ;Azerbaijan;1676;35;311465;4342
2021-04-25;AZ;Azerbaijan;1541;29;313006;4371
2021-04-26;AZ;Azerbaijan;806;31;313812;4402
2021-04-27;AZ;Azerbaijan;1307;27;315119;4429
2021-04-28;AZ;Azerbaijan;1402;32;316521;4461
2021-04-29;AZ;Azerbaijan;1392;29;317913;4490
2021-04-30;AZ;Azerbaijan;1196;27;319109;4517
2021-05-01;AZ;Azerbaijan;1213;21;320322;4538
2021-05-02;AZ;Azerbaijan;1058;23;321380;4561
2021-05-03;AZ;Azerbaijan;418;19;321798;4580
2021-05-04;AZ;Azerbaijan;963;17;322761;4597
2021-05-05;AZ;Azerbaijan;1080;20;323841;4617
2021-05-06;AZ;Azerbaijan;844;18;324685;4635
2021-05-07;AZ;Azerbaijan;722;15;325407;4650
2021-05-08;AZ;Azerbaijan;649;16;326056;4666
2021-05-09;AZ;Azerbaijan;660;14;326716;4680
2021-05-10;AZ;Azerbaijan;371;18;327087;4698
2021-05-11;AZ;Azerbaijan;514;15;327601;4713
2021-05-12;AZ;Azerbaijan;558;13;328159;4726
2021-05-13;AZ;Azerbaijan;509;16;328668;4742
2021-05-14;AZ;Azerbaijan;326;12;328994;4754
2021-05-15;AZ;Azerbaijan;377;14;329371;4768
2021-05-16;AZ;Azerbaijan;472;11;329843;4779
2021-05-17;AZ;Azerbaijan;426;13;330269;4792
2021-05-18;AZ;Azerbaijan;432;10;330701;4802
2021-05-19;AZ;Azerbaijan;339;12;331040;4814
2021-05-20;AZ;Azerbaijan;437;14;331477;4828
2021-05-21;AZ;Azerbaijan;406;11;331883;4839
2021-05-22;AZ;Azerbaijan;352;12;332235;4851
2021-05-23;AZ;Azerbaijan;219;9;332454;4860
2021-05-24;AZ;Azerbaijan;156;7;332610;4867
2021-05-25;AZ;Azerbaijan;284;10;332894;4877
2021-05-26;AZ;Azerbaijan;203;8;333097;4885
2021-05-27;AZ;Azerbaijan;220;6;333317;4891
2021-05-28;AZ;Azerbaijan;242;5;333559;4896
2021-05-29;AZ;Azerbaijan;164;7;333723;4903
2021-05-30;AZ;Azerbaijan;141;4;333864;4907
2021-05-31;AZ;Azerbaijan;92;6;333956;4913
2021-06-01;AZ;Azerbaijan;176;8;334132;4921
2021-06-02;AZ;Azerbaijan;156;5;334288;4926
2021-06-03;AZ;Azerbaijan;128;3;334416;4929
2021-06-04;AZ;Azerbaijan;123;4;334539;4933
2021-06-05;AZ;Azerbaijan;108;3;334647;4936
2021-06-06;AZ;Azerbaijan;68;5;334715;4941
2021-06-07;AZ;Azerbaijan;32;4;334747;4945
2021-06-08;AZ;Azerbaijan;102;2;334849;4947
2021-06-09;AZ;Azerbaijan;68;1;334917;4948
2021-06-10;AZ;Azerbaijan;75;3;334992;4951
2021-06-11;AZ;Azerbaijan;73;0;335065;4951
2021-06-12;AZ;Azerbaijan;61;2;335126;4953
2021-06-13;AZ;Azerbaijan;45;0;335171;4953
2021-06-14;AZ;Azerbaijan;25;2;335196;4955
2021-06-15;AZ;Azerbaijan;68;3;335264;4958
2021-06-16;AZ;Azerbaijan;27;1;335291;4959
2021-06-17;AZ;Azerbaijan;48;0;335339;4959
2021-06-18;AZ;Azerbaijan;60;2;335399;4961
2021-06-19;AZ;Azerbaijan;38;0;335437;4961
2021-06-20;AZ;Azerbaijan;56;1;335493;4962
2021-06-21;AZ;Azerbaijan;28;1;335521;4963
2021-06-22;AZ;Azerbaijan;47;0;335568;4963
2021-06-23;AZ;Azerbaijan;57;2;335625;4965
2021-06-24;AZ;Azerbaijan;51;0;335676;4965
2021-06-25;AZ;Azerbaijan;65;2;335741;4967
2021-06-26;AZ;Azerbaijan;55;0;335796;4967
2021-06-27;AZ;Azerbaijan;40;1;335836;4968
2021-06-28;AZ;Azerbaijan;38;2;335874;4970
2021-06-29;AZ;Azerbaijan;87;3;335961;4973
2021-06-30;AZ;Azerbaijan;86;1;336047;4974
2021-07-01;AZ;Azerbaijan;75;1;336122;4975
2020-03-16;BS;Bahamas;1;0;1;0
2020-03-17;BS;Bahamas;0;0;1;0
2020-03-18;BS;Bahamas;0;0;1;0
2020-03-19;BS;Bahamas;2;0;3;0
2020-03-20;BS;Bahamas;0;0;3;0
2020-03-21;BS;Bahamas;1;0;4;0
2020-03-22;BS;Bahamas;0;0;4;0
2020-03-23;BS;Bahamas;0;0;4;0
2020-03-24;BS;Bahamas;1;0;5;0
2020-03-25;BS;Bahamas;0;0;5;0
2020-03-26;BS;Bahamas;4;0;9;0
2020-03-27;BS;Bahamas;1;0;10;0
2020-03-28;BS;Bahamas;0;0;10;0
2020-03-29;BS;Bahamas;1;0;11;0
2020-03-30;BS;Bahamas;3;0;14;0
2020-03-31;BS;Bahamas;0;0;14;0
2020-04-01;BS;Bahamas;7;1;21;1
2020-04-02;BS;Bahamas;3;0;24;1
2020-04-03;BS;Bahamas;0;0;24;1
2020-04-04;BS;Bahamas;4;3;28;4
2020-04-05;BS;Bahamas;0;0;28;4
2020-04-06;BS;Bahamas;1;1;29;5
2020-04-07;BS;Bahamas;4;1;33;6
2020-04-08;BS;Bahamas;7;1;40;7
2020-04-09;BS;Bahamas;1;1;41;8
2020-04-10;BS;Bahamas;1;0;42;8
2020-04-11;BS;Bahamas;4;0;46;8
2020-04-12;BS;Bahamas;0;0;46;8
2020-04-13;BS;Bahamas;1;0;47;8
2020-04-14;BS;Bahamas;2;0;49;8
2020-04-15;BS;Bahamas;0;0;49;8
2020-04-16;BS;Bahamas;4;0;53;8
2020-04-17;BS;Bahamas;1;1;54;9
2020-04-18;BS;Bahamas;1;0;55;9
2020-04-19;BS;Bahamas;0;0;55;9
2020-04-20;BS;Bahamas;5;0;60;9
2020-04-21;BS;Bahamas;5;0;65;9
2020-04-22;BS;Bahamas;0;0;65;9
2020-04-23;BS;Bahamas;7;2;72;11
2020-04-24;BS;Bahamas;1;0;73;11
2020-04-25;BS;Bahamas;5;0;78;11
2020-04-26;BS;Bahamas;2;0;80;11
2020-04-27;BS;Bahamas;0;0;80;11
2020-04-28;BS;Bahamas;0;0;80;11
2020-04-29;BS;Bahamas;0;0;80;11
2020-04-30;BS;Bahamas;1;0;81;11
2020-05-01;BS;Bahamas;0;0;81;11
2020-05-02;BS;Bahamas;2;0;83;11
2020-05-03;BS;Bahamas;0;0;83;11
2020-05-04;BS;Bahamas;0;0;83;11
2020-05-05;BS;Bahamas;6;0;89;11
2020-05-06;BS;Bahamas;3;0;92;11
2020-05-07;BS;Bahamas;0;0;92;11
2020-05-08;BS;Bahamas;0;0;92;11
2020-05-09;BS;Bahamas;0;0;92;11
2020-05-10;BS;Bahamas;0;0;92;11
2020-05-11;BS;Bahamas;1;0;93;11
2020-05-12;BS;Bahamas;0;0;93;11
2020-05-13;BS;Bahamas;1;0;94;11
2020-05-14;BS;Bahamas;2;0;96;11
2020-05-15;BS;Bahamas;0;0;96;11
2020-05-16;BS;Bahamas;0;0;96;11
2020-05-17;BS;Bahamas;0;0;96;11
2020-05-18;BS;Bahamas;0;0;96;11
2020-05-19;BS;Bahamas;0;0;96;11
2020-05-20;BS;Bahamas;1;0;97;11
2020-05-21;BS;Bahamas;0;0;97;11
2020-05-22;BS;Bahamas;0;0;97;11
2020-05-23;BS;Bahamas;3;0;100;11
2020-05-24;BS;Bahamas;0;0;100;11
2020-05-25;BS;Bahamas;0;0;100;11
2020-05-26;BS;Bahamas;0;0;100;11
2020-05-27;BS;Bahamas;0;0;100;11
2020-05-28;BS;Bahamas;1;0;101;11
2020-05-29;BS;Bahamas;1;0;102;11
2020-05-30;BS;Bahamas;0;0;102;11
2020-05-31;BS;Bahamas;0;0;102;11
2020-06-01;BS;Bahamas;0;0;102;11
2020-06-02;BS;Bahamas;0;0;102;11
2020-06-03;BS;Bahamas;0;0;102;11
2020-06-04;BS;Bahamas;0;0;102;11
2020-06-05;BS;Bahamas;0;0;102;11
2020-06-06;BS;Bahamas;1;0;103;11
2020-06-07;BS;Bahamas;0;0;103;11
2020-06-08;BS;Bahamas;0;0;103;11
2020-06-09;BS;Bahamas;0;0;103;11
2020-06-10;BS;Bahamas;0;0;103;11
2020-06-11;BS;Bahamas;0;0;103;11
2020-06-12;BS;Bahamas;0;0;103;11
2020-06-13;BS;Bahamas;0;0;103;11
2020-06-14;BS;Bahamas;0;0;103;11
2020-06-15;BS;Bahamas;0;0;103;11
2020-06-16;BS;Bahamas;1;0;104;11
2020-06-17;BS;Bahamas;0;0;104;11
2020-06-18;BS;Bahamas;0;0;104;11
2020-06-19;BS;Bahamas;0;0;104;11
2020-06-20;BS;Bahamas;0;0;104;11
2020-06-21;BS;Bahamas;0;0;104;11
2020-06-22;BS;Bahamas;0;0;104;11
2020-06-23;BS;Bahamas;0;0;104;11
2020-06-24;BS;Bahamas;0;0;104;11
2020-06-25;BS;Bahamas;0;0;104;11
2020-06-26;BS;Bahamas;0;0;104;11
2020-06-27;BS;Bahamas;0;0;104;11
2020-06-28;BS;Bahamas;0;0;104;11
2020-06-29;BS;Bahamas;0;0;104;11
2020-06-30;BS;Bahamas;0;0;104;11
2020-07-01;BS;Bahamas;0;0;104;11
2020-07-02;BS;Bahamas;0;0;104;11
2020-07-03;BS;Bahamas;0;0;104;11
2020-07-04;BS;Bahamas;0;0;104;11
2020-07-05;BS;Bahamas;0;0;104;11
2020-07-06;BS;Bahamas;0;0;104;11
2020-07-07;BS;Bahamas;0;0;104;11
2020-07-08;BS;Bahamas;2;0;106;11
2020-07-09;BS;Bahamas;1;0;107;11
2020-07-10;BS;Bahamas;1;0;108;11
2020-07-11;BS;Bahamas;3;0;111;11
2020-07-12;BS;Bahamas;0;0;111;11
2020-07-13;BS;Bahamas;2;0;113;11
2020-07-14;BS;Bahamas;3;0;116;11
2020-07-15;BS;Bahamas;3;0;119;11
2020-07-16;BS;Bahamas;5;0;124;11
2020-07-17;BS;Bahamas;5;0;129;11
2020-07-18;BS;Bahamas;9;0;138;11
2020-07-19;BS;Bahamas;15;0;153;11
2020-07-20;BS;Bahamas;21;0;174;11
2020-07-21;BS;Bahamas;20;0;194;11
2020-07-22;BS;Bahamas;25;0;219;11
2020-07-23;BS;Bahamas;55;0;274;11
2020-07-24;BS;Bahamas;42;0;316;11
2020-07-25;BS;Bahamas;10;0;326;11
2020-07-26;BS;Bahamas;16;0;342;11
2020-07-27;BS;Bahamas;40;0;382;11
2020-07-28;BS;Bahamas;65;0;447;11
2020-07-29;BS;Bahamas;37;0;484;11
2020-07-30;BS;Bahamas;24;3;508;14
2020-07-31;BS;Bahamas;66;0;574;14
2020-08-01;BS;Bahamas;25;0;599;14
2020-08-02;BS;Bahamas;49;0;648;14
2020-08-03;BS;Bahamas;31;0;679;14
2020-08-04;BS;Bahamas;36;0;715;14
2020-08-05;BS;Bahamas;36;0;751;14
2020-08-06;BS;Bahamas;10;0;761;14
2020-08-07;BS;Bahamas;69;0;830;14
2020-08-08;BS;Bahamas;48;0;878;14
2020-08-09;BS;Bahamas;20;1;898;15
2020-08-10;BS;Bahamas;47;0;945;15
2020-08-11;BS;Bahamas;44;0;989;15
2020-08-12;BS;Bahamas;47;0;1036;15
2020-08-13;BS;Bahamas;53;0;1089;15
2020-08-14;BS;Bahamas;30;2;1119;17
2020-08-15;BS;Bahamas;133;0;1252;17
2020-08-16;BS;Bahamas;63;1;1315;18
2020-08-17;BS;Bahamas;14;1;1329;19
2020-08-18;BS;Bahamas;95;1;1424;20
2020-08-19;BS;Bahamas;107;2;1531;22
2020-08-20;BS;Bahamas;79;1;1610;23
2020-08-21;BS;Bahamas;93;4;1703;27
2020-08-22;BS;Bahamas;62;0;1765;27
2020-08-23;BS;Bahamas;19;2;1784;29
2020-08-24;BS;Bahamas;14;15;1798;44
2020-08-25;BS;Bahamas;15;2;1813;46
2020-08-26;BS;Bahamas;110;2;1923;48
2020-08-27;BS;Bahamas;97;0;2020;48
2020-08-28;BS;Bahamas;37;2;2057;50
2020-08-29;BS;Bahamas;78;0;2135;50
2020-08-30;BS;Bahamas;32;0;2167;50
2020-08-31;BS;Bahamas;50;0;2217;50
2020-09-01;BS;Bahamas;59;0;2276;50
2020-09-02;BS;Bahamas;61;0;2337;50
2020-09-03;BS;Bahamas;49;0;2386;50
2020-09-04;BS;Bahamas;0;0;2386;50
2020-09-05;BS;Bahamas;90;5;2476;55
2020-09-06;BS;Bahamas;30;1;2506;56
2020-09-07;BS;Bahamas;40;2;2546;58
2020-09-08;BS;Bahamas;39;1;2585;59
2020-09-09;BS;Bahamas;136;4;2721;63
2020-09-10;BS;Bahamas;0;0;2721;63
2020-09-11;BS;Bahamas;93;2;2814;65
2020-09-12;BS;Bahamas;114;2;2928;67
2020-09-13;BS;Bahamas;0;0;2928;67
2020-09-14;BS;Bahamas;80;1;3008;68
2020-09-15;BS;Bahamas;24;1;3032;69
2020-09-16;BS;Bahamas;55;0;3087;69
2020-09-17;BS;Bahamas;90;0;3177;69
2020-09-18;BS;Bahamas;0;0;3177;69
2020-09-19;BS;Bahamas;37;4;3214;73
2020-09-20;BS;Bahamas;101;1;3315;74
2020-09-21;BS;Bahamas;103;1;3418;75
2020-09-22;BS;Bahamas;49;2;3467;77
2020-09-23;BS;Bahamas;151;3;3618;80
2020-09-24;BS;Bahamas;81;6;3699;86
2020-09-25;BS;Bahamas;91;3;3790;89
2020-09-26;BS;Bahamas;0;0;3790;89
2020-09-27;BS;Bahamas;48;0;3838;89
2020-09-28;BS;Bahamas;0;0;3838;89
2020-09-29;BS;Bahamas;65;2;3903;91
2020-09-30;BS;Bahamas;220;5;4123;96
2020-10-01;BS;Bahamas;0;0;4123;96
2020-10-02;BS;Bahamas;97;0;4220;96
2020-10-03;BS;Bahamas;112;0;4332;96
2020-10-04;BS;Bahamas;77;0;4409;96
2020-10-05;BS;Bahamas;43;0;4452;96
2020-10-06;BS;Bahamas;107;4;4559;100
2020-10-07;BS;Bahamas;154;2;4713;102
2020-10-08;BS;Bahamas;0;0;4713;102
2020-10-09;BS;Bahamas;0;0;4713;102
2020-10-10;BS;Bahamas;310;4;5023;106
2020-10-11;BS;Bahamas;55;1;5078;107
2020-10-12;BS;Bahamas;85;1;5163;108
2020-10-13;BS;Bahamas;0;0;5163;108
2020-10-14;BS;Bahamas;28;1;5191;109
2020-10-15;BS;Bahamas;194;3;5385;112
2020-10-16;BS;Bahamas;132;2;5517;114
2020-10-17;BS;Bahamas;111;2;5628;116
2020-10-18;BS;Bahamas;75;6;5703;122
2020-10-19;BS;Bahamas;70;1;5773;123
2020-10-20;BS;Bahamas;150;1;5923;124
2020-10-21;BS;Bahamas;128;3;6051;127
2020-10-22;BS;Bahamas;84;3;6135;130
2020-10-23;BS;Bahamas;133;0;6268;130
2020-10-24;BS;Bahamas;0;0;6268;130
2020-10-25;BS;Bahamas;142;2;6410;132
2020-10-26;BS;Bahamas;0;0;6410;132
2020-10-27;BS;Bahamas;92;4;6502;136
2020-10-28;BS;Bahamas;47;0;6549;136
2020-10-29;BS;Bahamas;58;2;6607;138
2020-10-30;BS;Bahamas;37;4;6644;142
2020-10-31;BS;Bahamas;70;2;6714;144
2020-11-01;BS;Bahamas;0;0;6714;144
2020-11-02;BS;Bahamas;21;2;6735;146
2020-11-03;BS;Bahamas;55;3;6790;149
2020-11-04;BS;Bahamas;53;1;6843;150
2020-11-05;BS;Bahamas;39;0;6882;150
2020-11-06;BS;Bahamas;0;0;6882;150
2020-11-07;BS;Bahamas;65;2;6947;152
2020-11-08;BS;Bahamas;0;0;6947;152
2020-11-09;BS;Bahamas;17;2;6964;154
2020-11-10;BS;Bahamas;48;0;7012;154
2020-11-11;BS;Bahamas;48;0;7060;154
2020-11-12;BS;Bahamas;64;1;7124;155
2020-11-13;BS;Bahamas;39;0;7163;155
2020-11-14;BS;Bahamas;0;0;7163;155
2020-11-15;BS;Bahamas;23;1;7186;156
2020-11-16;BS;Bahamas;70;7;7256;163
2020-11-17;BS;Bahamas;56;0;7312;163
2020-11-18;BS;Bahamas;11;0;7323;163
2020-11-19;BS;Bahamas;25;0;7348;163
2020-11-20;BS;Bahamas;19;0;7367;163
2020-11-21;BS;Bahamas;28;0;7395;163
2020-11-22;BS;Bahamas;18;0;7413;163
2020-11-23;BS;Bahamas;18;0;7431;163
2020-11-24;BS;Bahamas;29;0;7460;163
2020-11-25;BS;Bahamas;9;0;7469;163
2020-11-26;BS;Bahamas;13;0;7482;163
2020-11-27;BS;Bahamas;14;0;7496;163
2020-11-28;BS;Bahamas;0;0;7496;163
2020-11-29;BS;Bahamas;21;0;7517;163
2020-11-30;BS;Bahamas;24;0;7541;163
2020-12-01;BS;Bahamas;2;0;7543;163
2020-12-02;BS;Bahamas;0;0;7543;163
2020-12-03;BS;Bahamas;6;0;7549;163
2020-12-04;BS;Bahamas;16;0;7565;163
2020-12-05;BS;Bahamas;5;0;7570;163
2020-12-06;BS;Bahamas;0;0;7570;163
2020-12-07;BS;Bahamas;9;0;7579;163
2020-12-08;BS;Bahamas;0;0;7579;163
2020-12-09;BS;Bahamas;6;0;7585;163
2020-12-10;BS;Bahamas;0;0;7585;163
2020-12-11;BS;Bahamas;38;0;7623;163
2020-12-12;BS;Bahamas;25;0;7648;163
2020-12-13;BS;Bahamas;11;0;7659;163
2020-12-14;BS;Bahamas;15;0;7674;163
2020-12-15;BS;Bahamas;24;1;7698;164
2020-12-16;BS;Bahamas;16;0;7714;164
2020-12-17;BS;Bahamas;11;0;7725;164
2020-12-18;BS;Bahamas;8;0;7733;164
2020-12-19;BS;Bahamas;0;0;7733;164
2020-12-20;BS;Bahamas;13;0;7746;164
2020-12-21;BS;Bahamas;19;0;7765;164
2020-12-22;BS;Bahamas;7;5;7772;169
2020-12-23;BS;Bahamas;16;0;7788;169
2020-12-24;BS;Bahamas;0;0;7788;169
2020-12-25;BS;Bahamas;0;0;7788;169
2020-12-26;BS;Bahamas;0;0;7788;169
2020-12-27;BS;Bahamas;46;1;7834;170
2020-12-28;BS;Bahamas;0;0;7834;170
2020-12-29;BS;Bahamas;12;0;7846;170
2020-12-30;BS;Bahamas;11;0;7857;170
2020-12-31;BS;Bahamas;14;0;7871;170
2021-01-01;BS;Bahamas;16;1;7887;171
2021-01-02;BS;Bahamas;0;0;7887;171
2021-01-03;BS;Bahamas;27;4;7914;175
2021-01-04;BS;Bahamas;10;0;7924;175
2021-01-05;BS;Bahamas;4;0;7928;175
2021-01-06;BS;Bahamas;17;0;7945;175
2021-01-07;BS;Bahamas;14;0;7959;175
2021-01-08;BS;Bahamas;10;0;7969;175
2021-01-09;BS;Bahamas;0;0;7969;175
2021-01-10;BS;Bahamas;0;0;7969;175
2021-01-11;BS;Bahamas;35;0;8004;175
2021-01-12;BS;Bahamas;0;0;8004;175
2021-01-13;BS;Bahamas;7;0;8011;175
2021-01-14;BS;Bahamas;0;0;8011;175
2021-01-15;BS;Bahamas;10;0;8021;175
2021-01-16;BS;Bahamas;11;0;8032;175
2021-01-17;BS;Bahamas;0;0;8032;175
2021-01-18;BS;Bahamas;35;0;8067;175
2021-01-19;BS;Bahamas;1;0;8068;175
2021-01-20;BS;Bahamas;7;0;8075;175
2021-01-21;BS;Bahamas;13;0;8088;175
2021-01-22;BS;Bahamas;13;0;8101;175
2021-01-23;BS;Bahamas;0;0;8101;175
2021-01-24;BS;Bahamas;0;0;8101;175
2021-01-25;BS;Bahamas;32;0;8133;175
2021-01-26;BS;Bahamas;7;0;8140;175
2021-01-27;BS;Bahamas;21;0;8161;175
2021-01-28;BS;Bahamas;0;0;8161;175
2021-01-29;BS;Bahamas;6;0;8167;175
2021-01-30;BS;Bahamas;7;1;8174;176
2021-01-31;BS;Bahamas;0;0;8174;176
2021-02-01;BS;Bahamas;0;0;8174;176
2021-02-02;BS;Bahamas;49;0;8223;176
2021-02-03;BS;Bahamas;8;0;8231;176
2021-02-04;BS;Bahamas;16;0;8247;176
2021-02-05;BS;Bahamas;9;0;8256;176
2021-02-06;BS;Bahamas;0;0;8256;176
2021-02-07;BS;Bahamas;0;0;8256;176
2021-02-08;BS;Bahamas;33;0;8289;176
2021-02-09;BS;Bahamas;0;0;8289;176
2021-02-10;BS;Bahamas;0;0;8289;176
2021-02-11;BS;Bahamas;22;2;8311;178
2021-02-12;BS;Bahamas;0;0;8311;178
2021-02-13;BS;Bahamas;0;0;8311;178
2021-02-14;BS;Bahamas;0;0;8311;178
2021-02-15;BS;Bahamas;0;0;8311;178
2021-02-16;BS;Bahamas;72;1;8383;179
2021-02-17;BS;Bahamas;0;0;8383;179
2021-02-18;BS;Bahamas;20;0;8403;179
2021-02-19;BS;Bahamas;0;0;8403;179
2021-02-20;BS;Bahamas;0;0;8403;179
2021-02-21;BS;Bahamas;0;0;8403;179
2021-02-22;BS;Bahamas;68;0;8471;179
2021-02-23;BS;Bahamas;6;0;8477;179
2021-02-24;BS;Bahamas;19;0;8496;179
2021-02-25;BS;Bahamas;0;0;8496;179
2021-02-26;BS;Bahamas;23;0;8519;179
2021-02-27;BS;Bahamas;0;0;8519;179
2021-02-28;BS;Bahamas;0;0;8519;179
2021-03-01;BS;Bahamas;0;0;8519;179
2021-03-02;BS;Bahamas;0;0;8519;179
2021-03-03;BS;Bahamas;54;2;8573;181
2021-03-04;BS;Bahamas;0;0;8573;181
2021-03-05;BS;Bahamas;27;0;8600;181
2021-03-06;BS;Bahamas;0;0;8600;181
2021-03-07;BS;Bahamas;0;0;8600;181
2021-03-08;BS;Bahamas;0;0;8600;181
2021-03-09;BS;Bahamas;42;4;8642;185
2021-03-10;BS;Bahamas;0;0;8642;185
2021-03-11;BS;Bahamas;0;0;8642;185
2021-03-12;BS;Bahamas;16;0;8658;185
2021-03-13;BS;Bahamas;0;0;8658;185
2021-03-14;BS;Bahamas;0;0;8658;185
2021-03-15;BS;Bahamas;107;1;8765;186
2021-03-16;BS;Bahamas;11;0;8776;186
2021-03-17;BS;Bahamas;24;0;8800;186
2021-03-18;BS;Bahamas;0;0;8800;186
2021-03-19;BS;Bahamas;0;0;8800;186
2021-03-20;BS;Bahamas;0;0;8800;186
2021-03-21;BS;Bahamas;0;0;8800;186
2021-03-22;BS;Bahamas;123;2;8923;188
2021-03-23;BS;Bahamas;12;0;8935;188
2021-03-24;BS;Bahamas;0;0;8935;188
2021-03-25;BS;Bahamas;0;0;8935;188
2021-03-26;BS;Bahamas;0;0;8935;188
2021-03-27;BS;Bahamas;0;0;8935;188
2021-03-28;BS;Bahamas;0;0;8935;188
2021-03-29;BS;Bahamas;65;0;9000;188
2021-03-30;BS;Bahamas;119;0;9119;188
2021-03-31;BS;Bahamas;0;0;9119;188
2021-04-01;BS;Bahamas;52;0;9171;188
2021-04-02;BS;Bahamas;0;0;9171;188
2021-04-03;BS;Bahamas;0;0;9171;188
2021-04-04;BS;Bahamas;0;0;9171;188
2021-04-05;BS;Bahamas;0;0;9171;188
2021-04-06;BS;Bahamas;99;1;9270;189
2021-04-07;BS;Bahamas;26;0;9296;189
2021-04-08;BS;Bahamas;43;0;9339;189
2021-04-09;BS;Bahamas;25;0;9364;189
2021-04-10;BS;Bahamas;0;0;9364;189
2021-04-11;BS;Bahamas;0;0;9364;189
2021-04-12;BS;Bahamas;96;1;9460;190
2021-04-13;BS;Bahamas;45;0;9505;190
2021-04-14;BS;Bahamas;0;0;9505;190
2021-04-15;BS;Bahamas;0;0;9505;190
2021-04-16;BS;Bahamas;129;4;9634;194
2021-04-17;BS;Bahamas;0;0;9634;194
2021-04-18;BS;Bahamas;0;0;9634;194
2021-04-19;BS;Bahamas;157;0;9791;194
2021-04-20;BS;Bahamas;0;0;9791;194
2021-04-21;BS;Bahamas;77;0;9868;194
2021-04-22;BS;Bahamas;0;0;9868;194
2021-04-23;BS;Bahamas;108;2;9976;196
2021-04-24;BS;Bahamas;0;0;9976;196
2021-04-25;BS;Bahamas;74;0;10050;196
2021-04-26;BS;Bahamas;170;2;10220;198
2021-04-27;BS;Bahamas;0;0;10220;198
2021-04-28;BS;Bahamas;129;0;10349;198
2021-04-29;BS;Bahamas;0;0;10349;198
2021-04-30;BS;Bahamas;104;1;10453;199
2021-05-01;BS;Bahamas;0;0;10453;199
2021-05-02;BS;Bahamas;66;10;10519;209
2021-05-03;BS;Bahamas;57;1;10576;210
2021-05-04;BS;Bahamas;0;0;10576;210
2021-05-05;BS;Bahamas;0;0;10576;210
2021-05-06;BS;Bahamas;135;1;10711;211
2021-05-07;BS;Bahamas;62;1;10773;212
2021-05-08;BS;Bahamas;0;0;10773;212
2021-05-09;BS;Bahamas;0;0;10773;212
2021-05-10;BS;Bahamas;135;2;10908;214
2021-05-11;BS;Bahamas;0;0;10908;214
2021-05-12;BS;Bahamas;58;1;10966;215
2021-05-13;BS;Bahamas;58;1;11024;216
2021-05-14;BS;Bahamas;0;0;11024;216
2021-05-15;BS;Bahamas;0;0;11024;216
2021-05-16;BS;Bahamas;0;0;11024;216
2021-05-17;BS;Bahamas;201;5;11225;221
2021-05-18;BS;Bahamas;53;0;11278;221
2021-05-19;BS;Bahamas;43;0;11321;221
2021-05-20;BS;Bahamas;75;1;11396;222
2021-05-21;BS;Bahamas;0;0;11396;222
2021-05-22;BS;Bahamas;0;0;11396;222
2021-05-23;BS;Bahamas;0;0;11396;222
2021-05-24;BS;Bahamas;103;3;11499;225
2021-05-25;BS;Bahamas;98;0;11597;225
2021-05-26;BS;Bahamas;0;0;11597;225
2021-05-27;BS;Bahamas;25;1;11622;226
2021-05-28;BS;Bahamas;62;3;11684;229
2021-05-29;BS;Bahamas;61;0;11745;229
2021-05-30;BS;Bahamas;0;0;11745;229
2021-05-31;BS;Bahamas;51;1;11796;230
2021-06-01;BS;Bahamas;0;0;11796;230
2021-06-02;BS;Bahamas;68;0;11864;230
2021-06-03;BS;Bahamas;66;2;11930;232
2021-06-04;BS;Bahamas;0;0;11930;232
2021-06-05;BS;Bahamas;0;0;11930;232
2021-06-06;BS;Bahamas;0;0;11930;232
2021-06-07;BS;Bahamas;94;0;12024;232
2021-06-08;BS;Bahamas;0;0;12024;232
2021-06-09;BS;Bahamas;3;0;12027;232
2021-06-10;BS;Bahamas;25;2;12052;234
2021-06-11;BS;Bahamas;40;2;12092;236
2021-06-12;BS;Bahamas;0;0;12092;236
2021-06-13;BS;Bahamas;0;0;12092;236
2021-06-14;BS;Bahamas;107;1;12199;237
2021-06-15;BS;Bahamas;26;2;12225;239
2021-06-16;BS;Bahamas;17;1;12242;240
2021-06-17;BS;Bahamas;0;0;12242;240
2021-06-18;BS;Bahamas;0;0;12242;240
2021-06-19;BS;Bahamas;53;1;12295;241
2021-06-20;BS;Bahamas;0;0;12295;241
2021-06-21;BS;Bahamas;69;2;12364;243
2021-06-22;BS;Bahamas;15;1;12379;244
2021-06-23;BS;Bahamas;28;0;12407;244
2021-06-24;BS;Bahamas;0;0;12407;244
2021-06-25;BS;Bahamas;60;1;12467;245
2021-06-26;BS;Bahamas;0;0;12467;245
2021-06-27;BS;Bahamas;0;0;12467;245
2021-06-28;BS;Bahamas;0;0;12467;245
2021-06-29;BS;Bahamas;119;1;12586;246
2021-06-30;BS;Bahamas;0;0;12586;246
2021-07-01;BS;Bahamas;149;0;12735;246
2020-02-24;BH;Bahrain;1;0;1;0
2020-02-25;BH;Bahrain;22;0;23;0
2020-02-26;BH;Bahrain;10;0;33;0
2020-02-27;BH;Bahrain;0;0;33;0
2020-02-28;BH;Bahrain;3;0;36;0
2020-02-29;BH;Bahrain;5;0;41;0
2020-03-01;BH;Bahrain;6;0;47;0
2020-03-02;BH;Bahrain;2;0;49;0
2020-03-03;BH;Bahrain;0;0;49;0
2020-03-04;BH;Bahrain;3;0;52;0
2020-03-05;BH;Bahrain;3;0;55;0
2020-03-06;BH;Bahrain;5;0;60;0
2020-03-07;BH;Bahrain;25;0;85;0
2020-03-08;BH;Bahrain;0;0;85;0
2020-03-09;BH;Bahrain;10;0;95;0
2020-03-10;BH;Bahrain;15;0;110;0
2020-03-11;BH;Bahrain;85;0;195;0
2020-03-12;BH;Bahrain;0;0;195;0
2020-03-13;BH;Bahrain;0;0;195;0
2020-03-14;BH;Bahrain;15;0;210;0
2020-03-15;BH;Bahrain;4;0;214;0
2020-03-16;BH;Bahrain;0;1;214;1
2020-03-17;BH;Bahrain;14;0;228;1
2020-03-18;BH;Bahrain;28;0;256;1
2020-03-19;BH;Bahrain;22;0;278;1
2020-03-20;BH;Bahrain;7;0;285;1
2020-03-21;BH;Bahrain;20;0;305;1
2020-03-22;BH;Bahrain;29;1;334;2
2020-03-23;BH;Bahrain;43;0;377;2
2020-03-24;BH;Bahrain;15;1;392;3
2020-03-25;BH;Bahrain;27;1;419;4
2020-03-26;BH;Bahrain;39;0;458;4
2020-03-27;BH;Bahrain;8;0;466;4
2020-03-28;BH;Bahrain;10;0;476;4
2020-03-29;BH;Bahrain;23;0;499;4
2020-03-30;BH;Bahrain;16;0;515;4
2020-03-31;BH;Bahrain;52;0;567;4
2020-04-01;BH;Bahrain;2;0;569;4
2020-04-02;BH;Bahrain;74;0;643;4
2020-04-03;BH;Bahrain;29;0;672;4
2020-04-04;BH;Bahrain;16;0;688;4
2020-04-05;BH;Bahrain;12;0;700;4
2020-04-06;BH;Bahrain;56;0;756;4
2020-04-07;BH;Bahrain;55;1;811;5
2020-04-08;BH;Bahrain;12;0;823;5
2020-04-09;BH;Bahrain;64;0;887;5
2020-04-10;BH;Bahrain;38;1;925;6
2020-04-11;BH;Bahrain;115;0;1040;6
2020-04-12;BH;Bahrain;96;0;1136;6
2020-04-13;BH;Bahrain;225;0;1361;6
2020-04-14;BH;Bahrain;167;1;1528;7
2020-04-15;BH;Bahrain;143;0;1671;7
2020-04-16;BH;Bahrain;29;0;1700;7
2020-04-17;BH;Bahrain;40;0;1740;7
2020-04-18;BH;Bahrain;33;0;1773;7
2020-04-19;BH;Bahrain;108;0;1881;7
2020-04-20;BH;Bahrain;26;0;1907;7
2020-04-21;BH;Bahrain;66;0;1973;7
2020-04-22;BH;Bahrain;54;0;2027;7
2020-04-23;BH;Bahrain;190;1;2217;8
2020-04-24;BH;Bahrain;301;0;2518;8
2020-04-25;BH;Bahrain;70;0;2588;8
2020-04-26;BH;Bahrain;59;0;2647;8
2020-04-27;BH;Bahrain;76;0;2723;8
2020-04-28;BH;Bahrain;88;0;2811;8
2020-04-29;BH;Bahrain;110;0;2921;8
2020-04-30;BH;Bahrain;119;0;3040;8
2020-05-01;BH;Bahrain;130;0;3170;8
2020-05-02;BH;Bahrain;114;0;3284;8
2020-05-03;BH;Bahrain;99;0;3383;8
2020-05-04;BH;Bahrain;150;0;3533;8
2020-05-05;BH;Bahrain;187;0;3720;8
2020-05-06;BH;Bahrain;214;0;3934;8
2020-05-07;BH;Bahrain;265;0;4199;8
2020-05-08;BH;Bahrain;245;0;4444;8
2020-05-09;BH;Bahrain;330;0;4774;8
2020-05-10;BH;Bahrain;167;0;4941;8
2020-05-11;BH;Bahrain;295;0;5236;8
2020-05-12;BH;Bahrain;295;1;5531;9
2020-05-13;BH;Bahrain;285;1;5816;10
2020-05-14;BH;Bahrain;382;0;6198;10
2020-05-15;BH;Bahrain;385;2;6583;12
2020-05-16;BH;Bahrain;164;0;6747;12
2020-05-17;BH;Bahrain;209;0;6956;12
2020-05-18;BH;Bahrain;228;0;7184;12
2020-05-19;BH;Bahrain;348;0;7532;12
2020-05-20;BH;Bahrain;356;0;7888;12
2020-05-21;BH;Bahrain;286;0;8174;12
2020-05-22;BH;Bahrain;240;0;8414;12
2020-05-23;BH;Bahrain;388;1;8802;13
2020-05-24;BH;Bahrain;336;1;9138;14
2020-05-25;BH;Bahrain;33;0;9171;14
2020-05-26;BH;Bahrain;195;0;9366;14
2020-05-27;BH;Bahrain;326;1;9692;15
2020-05-28;BH;Bahrain;360;0;10052;15
2020-05-29;BH;Bahrain;397;0;10449;15
2020-05-30;BH;Bahrain;344;2;10793;17
2020-05-31;BH;Bahrain;605;2;11398;19
2020-06-01;BH;Bahrain;473;0;11871;19
2020-06-02;BH;Bahrain;440;0;12311;19
2020-06-03;BH;Bahrain;504;1;12815;20
2020-06-04;BH;Bahrain;481;1;13296;21
2020-06-05;BH;Bahrain;539;1;13835;22
2020-06-06;BH;Bahrain;548;2;14383;24
2020-06-07;BH;Bahrain;380;2;14763;26
2020-06-08;BH;Bahrain;654;1;15417;27
2020-06-09;BH;Bahrain;314;2;15731;29
2020-06-10;BH;Bahrain;469;2;16200;31
2020-06-11;BH;Bahrain;467;3;16667;34
2020-06-12;BH;Bahrain;602;2;17269;36
2020-06-13;BH;Bahrain;444;1;17713;37
2020-06-14;BH;Bahrain;514;5;18227;42
2020-06-15;BH;Bahrain;786;4;19013;46
2020-06-16;BH;Bahrain;540;1;19553;47
2020-06-17;BH;Bahrain;408;2;19961;49
2020-06-18;BH;Bahrain;469;6;20430;55
2020-06-19;BH;Bahrain;486;2;20916;57
2020-06-20;BH;Bahrain;415;3;21331;60
2020-06-21;BH;Bahrain;433;3;21764;63
2020-06-22;BH;Bahrain;643;2;22407;65
2020-06-23;BH;Bahrain;655;2;23062;67
2020-06-24;BH;Bahrain;508;2;23570;69
2020-06-25;BH;Bahrain;511;2;24081;71
2020-06-26;BH;Bahrain;724;2;24805;73
2020-06-27;BH;Bahrain;462;5;25267;78
2020-06-28;BH;Bahrain;438;5;25705;83
2020-06-29;BH;Bahrain;534;1;26239;84
2020-06-30;BH;Bahrain;519;3;26758;87
2020-07-01;BH;Bahrain;656;5;27414;92
2020-07-02;BH;Bahrain;423;2;27837;94
2020-07-03;BH;Bahrain;573;1;28410;95
2020-07-04;BH;Bahrain;447;1;28857;96
2020-07-05;BH;Bahrain;510;1;29367;97
2020-07-06;BH;Bahrain;454;1;29821;98
2020-07-07;BH;Bahrain;500;0;30321;98
2020-07-08;BH;Bahrain;610;0;30931;98
2020-07-09;BH;Bahrain;597;5;31528;103
2020-07-10;BH;Bahrain;511;1;32039;104
2020-07-11;BH;Bahrain;431;0;32470;104
2020-07-12;BH;Bahrain;471;4;32941;108
2020-07-13;BH;Bahrain;535;1;33476;109
2020-07-14;BH;Bahrain;602;2;34078;111
2020-07-15;BH;Bahrain;482;6;34560;117
2020-07-16;BH;Bahrain;524;4;35084;121
2020-07-17;BH;Bahrain;389;3;35473;124
2020-07-18;BH;Bahrain;531;0;36004;124
2020-07-19;BH;Bahrain;418;2;36422;126
2020-07-20;BH;Bahrain;514;2;36936;128
2020-07-21;BH;Bahrain;380;1;37316;129
2020-07-22;BH;Bahrain;321;1;37637;130
2020-07-23;BH;Bahrain;359;4;37996;134
2020-07-24;BH;Bahrain;462;2;38458;136
2020-07-25;BH;Bahrain;289;1;38747;137
2020-07-26;BH;Bahrain;384;3;39131;140
2020-07-27;BH;Bahrain;351;1;39482;141
2020-07-28;BH;Bahrain;439;0;39921;141
2020-07-29;BH;Bahrain;390;3;40311;144
2020-07-30;BH;Bahrain;444;2;40755;146
2020-07-31;BH;Bahrain;227;1;40982;147
2020-08-01;BH;Bahrain;208;0;41190;147
2020-08-02;BH;Bahrain;346;0;41536;147
2020-08-03;BH;Bahrain;299;3;41835;150
2020-08-04;BH;Bahrain;297;1;42132;151
2020-08-05;BH;Bahrain;382;3;42514;154
2020-08-06;BH;Bahrain;375;2;42889;156
2020-08-07;BH;Bahrain;418;3;43307;159
2020-08-08;BH;Bahrain;322;2;43629;161
2020-08-09;BH;Bahrain;382;1;44011;162
2020-08-10;BH;Bahrain;386;1;44397;163
2020-08-11;BH;Bahrain;407;2;44804;165
2020-08-12;BH;Bahrain;460;1;45264;166
2020-08-13;BH;Bahrain;462;1;45726;167
2020-08-14;BH;Bahrain;326;1;46052;168
2020-08-15;BH;Bahrain;378;2;46430;170
2020-08-16;BH;Bahrain;405;0;46835;170
2020-08-17;BH;Bahrain;350;3;47185;173
2020-08-18;BH;Bahrain;396;2;47581;175
2020-08-19;BH;Bahrain;369;3;47950;178
2020-08-20;BH;Bahrain;353;1;48303;179
2020-08-21;BH;Bahrain;358;2;48661;181
2020-08-22;BH;Bahrain;377;2;49038;183
2020-08-23;BH;Bahrain;292;1;49330;184
2020-08-24;BH;Bahrain;389;1;49719;185
2020-08-25;BH;Bahrain;357;1;50076;186
2020-08-26;BH;Bahrain;317;0;50393;186
2020-08-27;BH;Bahrain;363;2;50756;188
2020-08-28;BH;Bahrain;357;1;51113;189
2020-08-29;BH;Bahrain;278;0;51391;189
2020-08-30;BH;Bahrain;183;0;51574;189
2020-08-31;BH;Bahrain;398;1;51972;190
2020-09-01;BH;Bahrain;468;0;52440;190
2020-09-02;BH;Bahrain;367;0;52807;190
2020-09-03;BH;Bahrain;626;0;53433;190
2020-09-04;BH;Bahrain;662;5;54095;195
2020-09-05;BH;Bahrain;676;1;54771;196
2020-09-06;BH;Bahrain;644;3;55415;199
2020-09-07;BH;Bahrain;661;1;56076;200
2020-09-08;BH;Bahrain;702;2;56778;202
2020-09-09;BH;Bahrain;672;1;57450;203
2020-09-10;BH;Bahrain;757;4;58207;207
2020-09-11;BH;Bahrain;632;1;58839;208
2020-09-12;BH;Bahrain;747;3;59586;211
2020-09-13;BH;Bahrain;721;1;60307;212
2020-09-14;BH;Bahrain;658;1;60965;213
2020-09-15;BH;Bahrain;678;0;61643;213
2020-09-16;BH;Bahrain;841;3;62484;216
2020-09-17;BH;Bahrain;705;1;63189;217
2020-09-18;BH;Bahrain;690;3;63879;220
2020-09-19;BH;Bahrain;620;1;64499;221
2020-09-20;BH;Bahrain;540;0;65039;221
2020-09-21;BH;Bahrain;713;3;65752;224
2020-09-22;BH;Bahrain;650;3;66402;227
2020-09-23;BH;Bahrain;612;4;67014;231
2020-09-24;BH;Bahrain;687;0;67701;231
2020-09-25;BH;Bahrain;489;5;68190;236
2020-09-26;BH;Bahrain;585;3;68775;239
2020-09-27;BH;Bahrain;586;3;69361;242
2020-09-28;BH;Bahrain;487;3;69848;245
2020-09-29;BH;Bahrain;574;1;70422;246
2020-09-30;BH;Bahrain;442;5;70864;251
2020-10-01;BH;Bahrain;510;3;71374;254
2020-10-02;BH;Bahrain;429;1;71803;255
2020-10-03;BH;Bahrain;507;3;72310;258
2020-10-04;BH;Bahrain;352;2;72662;260
2020-10-05;BH;Bahrain;454;1;73116;261
2020-10-06;BH;Bahrain;360;1;73476;262
2020-10-07;BH;Bahrain;456;0;73932;262
2020-10-08;BH;Bahrain;490;2;74422;264
2020-10-09;BH;Bahrain;438;7;74860;271
2020-10-10;BH;Bahrain;427;2;75287;273
2020-10-11;BH;Bahrain;327;2;75614;275
2020-10-12;BH;Bahrain;334;5;75948;280
2020-10-13;BH;Bahrain;324;5;76272;285
2020-10-14;BH;Bahrain;349;2;76621;287
2020-10-15;BH;Bahrain;333;2;76954;289
2020-10-16;BH;Bahrain;371;3;77325;292
2020-10-17;BH;Bahrain;246;1;77571;293
2020-10-18;BH;Bahrain;331;7;77902;300
2020-10-19;BH;Bahrain;322;2;78224;302
2020-10-20;BH;Bahrain;309;3;78533;305
2020-10-21;BH;Bahrain;374;3;78907;308
2020-10-22;BH;Bahrain;304;0;79211;308
2020-10-23;BH;Bahrain;363;3;79574;311
2020-10-24;BH;Bahrain;401;1;79975;312
2020-10-25;BH;Bahrain;280;0;80255;312
2020-10-26;BH;Bahrain;278;4;80533;316
2020-10-27;BH;Bahrain;232;0;80765;316
2020-10-28;BH;Bahrain;257;1;81022;317
2020-10-29;BH;Bahrain;240;0;81262;317
2020-10-30;BH;Bahrain;204;2;81466;319
2020-10-31;BH;Bahrain;179;2;81645;321
2020-11-01;BH;Bahrain;278;0;81923;321
2020-11-02;BH;Bahrain;210;1;82133;322
2020-11-03;BH;Bahrain;230;2;82363;324
2020-11-04;BH;Bahrain;261;3;82624;327
2020-11-05;BH;Bahrain;162;1;82786;328
2020-11-06;BH;Bahrain;237;0;83023;328
2020-11-07;BH;Bahrain;241;1;83264;329
2020-11-08;BH;Bahrain;192;0;83456;329
2020-11-09;BH;Bahrain;176;0;83632;329
2020-11-10;BH;Bahrain;179;2;83811;331
2020-11-11;BH;Bahrain;231;1;84042;332
2020-11-12;BH;Bahrain;150;0;84192;332
2020-11-13;BH;Bahrain;157;0;84349;332
2020-11-14;BH;Bahrain;174;1;84523;333
2020-11-15;BH;Bahrain;180;1;84703;334
2020-11-16;BH;Bahrain;179;3;84882;337
2020-11-17;BH;Bahrain;126;0;85008;337
2020-11-18;BH;Bahrain;174;0;85182;337
2020-11-19;BH;Bahrain;135;0;85317;337
2020-11-20;BH;Bahrain;150;1;85467;338
2020-11-21;BH;Bahrain;124;0;85591;338
2020-11-22;BH;Bahrain;114;0;85705;338
2020-11-23;BH;Bahrain;181;1;85886;339
2020-11-24;BH;Bahrain;130;1;86016;340
2020-11-25;BH;Bahrain;169;0;86185;340
2020-11-26;BH;Bahrain;162;1;86347;341
2020-11-27;BH;Bahrain;168;0;86515;341
2020-11-28;BH;Bahrain;130;0;86645;341
2020-11-29;BH;Bahrain;142;0;86787;341
2020-11-30;BH;Bahrain;169;0;86956;341
2020-12-01;BH;Bahrain;181;0;87137;341
2020-12-02;BH;Bahrain;133;0;87270;341
2020-12-03;BH;Bahrain;162;0;87432;341
2020-12-04;BH;Bahrain;168;0;87600;341
2020-12-05;BH;Bahrain;132;0;87732;341
2020-12-06;BH;Bahrain;198;0;87930;341
2020-12-07;BH;Bahrain;181;0;88111;341
2020-12-08;BH;Bahrain;183;2;88294;343
2020-12-09;BH;Bahrain;201;4;88495;347
2020-12-10;BH;Bahrain;137;0;88632;347
2020-12-11;BH;Bahrain;188;0;88820;347
2020-12-12;BH;Bahrain;145;1;88965;348
2020-12-13;BH;Bahrain;178;0;89143;348
2020-12-14;BH;Bahrain;125;0;89268;348
2020-12-15;BH;Bahrain;176;0;89444;348
2020-12-16;BH;Bahrain;156;1;89600;349
2020-12-17;BH;Bahrain;143;0;89743;349
2020-12-18;BH;Bahrain;140;0;89883;349
2020-12-19;BH;Bahrain;179;0;90062;349
2020-12-20;BH;Bahrain;220;0;90282;349
2020-12-21;BH;Bahrain;168;1;90450;350
2020-12-22;BH;Bahrain;184;0;90634;350
2020-12-23;BH;Bahrain;183;0;90817;350
2020-12-24;BH;Bahrain;253;0;91070;350
2020-12-25;BH;Bahrain;234;1;91304;351
2020-12-26;BH;Bahrain;214;0;91518;351
2020-12-27;BH;Bahrain;215;0;91733;351
2020-12-28;BH;Bahrain;202;0;91935;351
2020-12-29;BH;Bahrain;234;0;92169;351
2020-12-30;BH;Bahrain;256;1;92425;352
2020-12-31;BH;Bahrain;250;0;92675;352
2021-01-01;BH;Bahrain;238;0;92913;352
2021-01-02;BH;Bahrain;271;0;93184;352
2021-01-03;BH;Bahrain;294;0;93478;352
2021-01-04;BH;Bahrain;288;0;93766;352
2021-01-05;BH;Bahrain;229;0;93995;352
2021-01-06;BH;Bahrain;289;1;94284;353
2021-01-07;BH;Bahrain;349;0;94633;353
2021-01-08;BH;Bahrain;397;1;95030;354
2021-01-09;BH;Bahrain;287;1;95317;355
2021-01-10;BH;Bahrain;241;1;95558;356
2021-01-11;BH;Bahrain;321;0;95879;356
2021-01-12;BH;Bahrain;316;0;96195;356
2021-01-13;BH;Bahrain;275;0;96470;356
2021-01-14;BH;Bahrain;342;0;96812;356
2021-01-15;BH;Bahrain;208;1;97020;357
2021-01-16;BH;Bahrain;248;1;97268;358
2021-01-17;BH;Bahrain;339;2;97607;360
2021-01-18;BH;Bahrain;333;0;97940;360
2021-01-19;BH;Bahrain;320;2;98260;362
2021-01-20;BH;Bahrain;313;4;98573;366
2021-01-21;BH;Bahrain;305;0;98878;366
2021-01-22;BH;Bahrain;332;0;99210;366
2021-01-23;BH;Bahrain;246;1;99456;367
2021-01-24;BH;Bahrain;361;0;99817;367
2021-01-25;BH;Bahrain;413;2;100230;369
2021-01-26;BH;Bahrain;459;1;100689;370
2021-01-27;BH;Bahrain;427;1;101116;371
2021-01-28;BH;Bahrain;387;1;101503;372
2021-01-29;BH;Bahrain;468;0;101971;372
2021-01-30;BH;Bahrain;655;0;102626;372
2021-01-31;BH;Bahrain;431;3;103057;375
2021-02-01;BH;Bahrain;525;1;103582;376
2021-02-02;BH;Bahrain;657;0;104239;376
2021-02-03;BH;Bahrain;553;0;104792;376
2021-02-04;BH;Bahrain;704;1;105496;377
2021-02-05;BH;Bahrain;702;0;106198;377
2021-02-06;BH;Bahrain;515;2;106713;379
2021-02-07;BH;Bahrain;616;1;107329;380
2021-02-08;BH;Bahrain;719;3;108048;383
2021-02-09;BH;Bahrain;759;4;108807;387
2021-02-10;BH;Bahrain;797;4;109604;391
2021-02-11;BH;Bahrain;812;2;110416;393
2021-02-12;BH;Bahrain;896;2;111312;395
2021-02-13;BH;Bahrain;790;3;112102;398
2021-02-14;BH;Bahrain;640;5;112742;403
2021-02-15;BH;Bahrain;848;3;113590;406
2021-02-16;BH;Bahrain;771;4;114361;410
2021-02-17;BH;Bahrain;696;0;115057;410
2021-02-18;BH;Bahrain;648;4;115705;414
2021-02-19;BH;Bahrain;777;4;116482;418
2021-02-20;BH;Bahrain;752;2;117234;420
2021-02-21;BH;Bahrain;575;3;117809;423
2021-02-22;BH;Bahrain;721;6;118530;429
2021-02-23;BH;Bahrain;675;4;119205;433
2021-02-24;BH;Bahrain;653;4;119858;437
2021-02-25;BH;Bahrain;637;2;120495;439
2021-02-26;BH;Bahrain;632;3;121127;442
2021-02-27;BH;Bahrain;651;2;121778;444
2021-02-28;BH;Bahrain;616;5;122394;449
2021-03-01;BH;Bahrain;645;3;123039;452
2021-03-02;BH;Bahrain;492;1;123531;453
2021-03-03;BH;Bahrain;738;5;124269;458
2021-03-04;BH;Bahrain;588;4;124857;462
2021-03-05;BH;Bahrain;657;6;125514;468
2021-03-06;BH;Bahrain;612;1;126126;469
2021-03-07;BH;Bahrain;476;3;126602;472
2021-03-08;BH;Bahrain;653;1;127255;473
2021-03-09;BH;Bahrain;545;1;127800;474
2021-03-10;BH;Bahrain;628;2;128428;476
2021-03-11;BH;Bahrain;653;2;129081;478
2021-03-12;BH;Bahrain;744;2;129825;480
2021-03-13;BH;Bahrain;579;1;130404;481
2021-03-14;BH;Bahrain;597;3;131001;484
2021-03-15;BH;Bahrain;682;1;131683;485
2021-03-16;BH;Bahrain;686;2;132369;487
2021-03-17;BH;Bahrain;768;2;133137;489
2021-03-18;BH;Bahrain;642;2;133779;491
2021-03-19;BH;Bahrain;731;2;134510;493
2021-03-20;BH;Bahrain;816;5;135326;498
2021-03-21;BH;Bahrain;656;2;135982;500
2021-03-22;BH;Bahrain;759;2;136741;502
2021-03-23;BH;Bahrain;809;1;137550;503
2021-03-24;BH;Bahrain;733;4;138283;507
2021-03-25;BH;Bahrain;841;1;139124;508
2021-03-26;BH;Bahrain;829;4;139953;512
2021-03-27;BH;Bahrain;865;1;140818;513
2021-03-28;BH;Bahrain;1027;0;141845;513
2021-03-29;BH;Bahrain;824;2;142669;515
2021-03-30;BH;Bahrain;905;2;143574;517
2021-03-31;BH;Bahrain;871;4;144445;521
2021-04-01;BH;Bahrain;935;2;145380;523
2021-04-02;BH;Bahrain;1074;4;146454;527
2021-04-03;BH;Bahrain;1316;4;147770;531
2021-04-04;BH;Bahrain;1047;5;148817;536
2021-04-05;BH;Bahrain;974;5;149791;541
2021-04-06;BH;Bahrain;1020;4;150811;545
2021-04-07;BH;Bahrain;1120;2;151931;547
2021-04-08;BH;Bahrain;1143;1;153074;548
2021-04-09;BH;Bahrain;1206;2;154280;550
2021-04-10;BH;Bahrain;1122;4;155402;554
2021-04-11;BH;Bahrain;1060;3;156462;557
2021-04-12;BH;Bahrain;1267;5;157729;562
2021-04-13;BH;Bahrain;1060;4;158789;566
2021-04-14;BH;Bahrain;1175;3;159964;569
2021-04-15;BH;Bahrain;970;5;160934;574
2021-04-16;BH;Bahrain;1155;7;162089;581
2021-04-17;BH;Bahrain;1024;7;163113;588
2021-04-18;BH;Bahrain;997;6;164110;594
2021-04-19;BH;Bahrain;1008;6;165118;600
2021-04-20;BH;Bahrain;1039;5;166157;605
2021-04-21;BH;Bahrain;1008;2;167165;607
2021-04-22;BH;Bahrain;1036;7;168201;614
2021-04-23;BH;Bahrain;1053;3;169254;617
2021-04-24;BH;Bahrain;1081;3;170335;620
2021-04-25;BH;Bahrain;1035;4;171370;624
2021-04-26;BH;Bahrain;1206;1;172576;625
2021-04-27;BH;Bahrain;972;1;173548;626
2021-04-28;BH;Bahrain;1111;6;174659;632
2021-04-29;BH;Bahrain;1093;7;175752;639
2021-04-30;BH;Bahrain;1182;7;176934;646
2021-05-01;BH;Bahrain;1063;2;177997;648
2021-05-02;BH;Bahrain;1300;3;179297;651
2021-05-03;BH;Bahrain;1165;6;180462;657
2021-05-04;BH;Bahrain;1418;5;181880;662
2021-05-05;BH;Bahrain;1450;2;183330;664
2021-05-06;BH;Bahrain;1367;6;184697;670
2021-05-07;BH;Bahrain;1706;4;186403;674
2021-05-08;BH;Bahrain;1502;4;187905;678
2021-05-09;BH;Bahrain;1451;7;189356;685
2021-05-10;BH;Bahrain;1662;6;191018;691
2021-05-11;BH;Bahrain;1732;6;192750;697
2021-05-12;BH;Bahrain;1539;8;194289;705
2021-05-13;BH;Bahrain;1816;10;196105;715
2021-05-14;BH;Bahrain;1369;17;197474;732
2021-05-15;BH;Bahrain;1619;5;199093;737
2021-05-16;BH;Bahrain;1884;9;200977;746
2021-05-17;BH;Bahrain;1579;6;202556;752
2021-05-18;BH;Bahrain;1968;13;204524;765
2021-05-19;BH;Bahrain;2354;8;206878;773
2021-05-20;BH;Bahrain;2415;7;209293;780
2021-05-21;BH;Bahrain;2858;14;212151;794
2021-05-22;BH;Bahrain;2719;15;214870;809
2021-05-23;BH;Bahrain;3177;11;218047;820
2021-05-24;BH;Bahrain;2800;28;220847;848
2021-05-25;BH;Bahrain;2766;18;223613;866
2021-05-26;BH;Bahrain;2803;16;226416;882
2021-05-27;BH;Bahrain;3052;20;229468;902
2021-05-28;BH;Bahrain;2957;21;232425;923
2021-05-29;BH;Bahrain;3273;16;235698;939
2021-05-30;BH;Bahrain;2458;14;238156;953
2021-05-31;BH;Bahrain;2375;27;240531;980
2021-06-01;BH;Bahrain;2259;29;242790;1009
2021-06-02;BH;Bahrain;1936;22;244726;1031
2021-06-03;BH;Bahrain;1932;19;246658;1050
2021-06-04;BH;Bahrain;1492;19;248150;1069
2021-06-05;BH;Bahrain;1432;22;249582;1091
2021-06-06;BH;Bahrain;1496;28;251078;1119
2021-06-07;BH;Bahrain;1522;24;252600;1143
2021-06-08;BH;Bahrain;1279;18;253879;1161
2021-06-09;BH;Bahrain;1041;10;254920;1171
2021-06-10;BH;Bahrain;1034;17;255954;1188
2021-06-11;BH;Bahrain;967;8;256921;1196
2021-06-12;BH;Bahrain;931;10;257852;1206
2021-06-13;BH;Bahrain;879;15;258731;1221
2021-06-14;BH;Bahrain;792;15;259523;1236
2021-06-15;BH;Bahrain;811;10;260334;1246
2021-06-16;BH;Bahrain;620;13;260954;1259
2021-06-17;BH;Bahrain;547;12;261501;1271
2021-06-18;BH;Bahrain;487;15;261988;1286
2021-06-19;BH;Bahrain;439;11;262427;1297
2021-06-20;BH;Bahrain;465;9;262892;1306
2021-06-21;BH;Bahrain;403;5;263295;1311
2021-06-22;BH;Bahrain;394;15;263689;1326
2021-06-23;BH;Bahrain;418;4;264107;1330
2021-06-24;BH;Bahrain;298;4;264405;1334
2021-06-25;BH;Bahrain;288;1;264693;1335
2021-06-26;BH;Bahrain;302;6;264995;1341
2021-06-27;BH;Bahrain;252;4;265247;1345
2021-06-28;BH;Bahrain;230;3;265477;1348
2021-06-29;BH;Bahrain;166;3;265643;1351
2021-06-30;BH;Bahrain;184;1;265827;1352
2021-07-01;BH;Bahrain;148;1;265975;1353
2020-03-03;BD;Bangladesh;0;0;0;0
2020-03-04;BD;Bangladesh;0;0;0;0
2020-03-05;BD;Bangladesh;0;0;0;0
2020-03-06;BD;Bangladesh;0;0;0;0
2020-03-07;BD;Bangladesh;0;0;0;0
2020-03-08;BD;Bangladesh;3;0;3;0
2020-03-09;BD;Bangladesh;0;0;3;0
2020-03-10;BD;Bangladesh;0;0;3;0
2020-03-11;BD;Bangladesh;0;0;3;0
2020-03-12;BD;Bangladesh;0;0;3;0
2020-03-13;BD;Bangladesh;0;0;3;0
2020-03-14;BD;Bangladesh;0;0;3;0
2020-03-15;BD;Bangladesh;2;0;5;0
2020-03-16;BD;Bangladesh;3;0;8;0
2020-03-17;BD;Bangladesh;2;0;10;0
2020-03-18;BD;Bangladesh;4;1;14;1
2020-03-19;BD;Bangladesh;3;0;17;1
2020-03-20;BD;Bangladesh;3;0;20;1
2020-03-21;BD;Bangladesh;5;1;25;2
2020-03-22;BD;Bangladesh;2;0;27;2
2020-03-23;BD;Bangladesh;6;1;33;3
2020-03-24;BD;Bangladesh;6;1;39;4
2020-03-25;BD;Bangladesh;0;1;39;5
2020-03-26;BD;Bangladesh;5;0;44;5
2020-03-27;BD;Bangladesh;4;0;48;5
2020-03-28;BD;Bangladesh;0;0;48;5
2020-03-29;BD;Bangladesh;0;0;48;5
2020-03-30;BD;Bangladesh;1;0;49;5
2020-03-31;BD;Bangladesh;2;0;51;5
2020-04-01;BD;Bangladesh;3;1;54;6
2020-04-02;BD;Bangladesh;2;0;56;6
2020-04-03;BD;Bangladesh;5;0;61;6
2020-04-04;BD;Bangladesh;9;2;70;8
2020-04-05;BD;Bangladesh;18;1;88;9
2020-04-06;BD;Bangladesh;35;3;123;12
2020-04-07;BD;Bangladesh;41;5;164;17
2020-04-08;BD;Bangladesh;54;3;218;20
2020-04-09;BD;Bangladesh;112;1;330;21
2020-04-10;BD;Bangladesh;94;6;424;27
2020-04-11;BD;Bangladesh;58;3;482;30
2020-04-12;BD;Bangladesh;139;4;621;34
2020-04-13;BD;Bangladesh;182;5;803;39
2020-04-14;BD;Bangladesh;209;7;1012;46
2020-04-15;BD;Bangladesh;219;4;1231;50
2020-04-16;BD;Bangladesh;341;10;1572;60
2020-04-17;BD;Bangladesh;266;15;1838;75
2020-04-18;BD;Bangladesh;306;9;2144;84
2020-04-19;BD;Bangladesh;312;7;2456;91
2020-04-20;BD;Bangladesh;492;10;2948;101
2020-04-21;BD;Bangladesh;434;9;3382;110
2020-04-22;BD;Bangladesh;390;10;3772;120
2020-04-23;BD;Bangladesh;414;7;4186;127
2020-04-24;BD;Bangladesh;503;4;4689;131
2020-04-25;BD;Bangladesh;309;9;4998;140
2020-04-26;BD;Bangladesh;418;5;5416;145
2020-04-27;BD;Bangladesh;497;7;5913;152
2020-04-28;BD;Bangladesh;549;3;6462;155
2020-04-29;BD;Bangladesh;641;8;7103;163
2020-04-30;BD;Bangladesh;564;5;7667;168
2020-05-01;BD;Bangladesh;571;2;8238;170
2020-05-02;BD;Bangladesh;552;5;8790;175
2020-05-03;BD;Bangladesh;665;2;9455;177
2020-05-04;BD;Bangladesh;688;5;10143;182
2020-05-05;BD;Bangladesh;786;1;10929;183
2020-05-06;BD;Bangladesh;790;3;11719;186
2020-05-07;BD;Bangladesh;706;13;12425;199
2020-05-08;BD;Bangladesh;709;7;13134;206
2020-05-09;BD;Bangladesh;636;8;13770;214
2020-05-10;BD;Bangladesh;887;14;14657;228
2020-05-11;BD;Bangladesh;1034;11;15691;239
2020-05-12;BD;Bangladesh;969;11;16660;250
2020-05-13;BD;Bangladesh;1162;19;17822;269
2020-05-14;BD;Bangladesh;1041;14;18863;283
2020-05-15;BD;Bangladesh;1202;15;20065;298
2020-05-16;BD;Bangladesh;930;16;20995;314
2020-05-17;BD;Bangladesh;1273;14;22268;328
2020-05-18;BD;Bangladesh;1602;21;23870;349
2020-05-19;BD;Bangladesh;1251;21;25121;370
2020-05-20;BD;Bangladesh;1617;16;26738;386
2020-05-21;BD;Bangladesh;1773;22;28511;408
2020-05-22;BD;Bangladesh;1694;24;30205;432
2020-05-23;BD;Bangladesh;1873;20;32078;452
2020-05-24;BD;Bangladesh;1532;28;33610;480
2020-05-25;BD;Bangladesh;1975;21;35585;501
2020-05-26;BD;Bangladesh;1166;21;36751;522
2020-05-27;BD;Bangladesh;1541;22;38292;544
2020-05-28;BD;Bangladesh;2029;15;40321;559
2020-05-29;BD;Bangladesh;2523;23;42844;582
2020-05-30;BD;Bangladesh;1764;28;44608;610
2020-05-31;BD;Bangladesh;2545;40;47153;650
2020-06-01;BD;Bangladesh;2381;22;49534;672
2020-06-02;BD;Bangladesh;2911;37;52445;709
2020-06-03;BD;Bangladesh;2695;37;55140;746
2020-06-04;BD;Bangladesh;2423;35;57563;781
2020-06-05;BD;Bangladesh;2828;30;60391;811
2020-06-06;BD;Bangladesh;2635;35;63026;846
2020-06-07;BD;Bangladesh;2743;42;65769;888
2020-06-08;BD;Bangladesh;2735;42;68504;930
2020-06-09;BD;Bangladesh;3171;45;71675;975
2020-06-10;BD;Bangladesh;3190;37;74865;1012
2020-06-11;BD;Bangladesh;3187;37;78052;1049
2020-06-12;BD;Bangladesh;3471;46;81523;1095
2020-06-13;BD;Bangladesh;2856;44;84379;1139
2020-06-14;BD;Bangladesh;3141;32;87520;1171
2020-06-15;BD;Bangladesh;3099;38;90619;1209
2020-06-16;BD;Bangladesh;3862;53;94481;1262
2020-06-17;BD;Bangladesh;4008;43;98489;1305
2020-06-18;BD;Bangladesh;3803;38;102292;1343
2020-06-19;BD;Bangladesh;3243;45;105535;1388
2020-06-20;BD;Bangladesh;3240;37;108775;1425
2020-06-21;BD;Bangladesh;3531;39;112306;1464
2020-06-22;BD;Bangladesh;3480;38;115786;1502
2020-06-23;BD;Bangladesh;3412;43;119198;1545
2020-06-24;BD;Bangladesh;3462;37;122660;1582
2020-06-25;BD;Bangladesh;3946;39;126606;1621
2020-06-26;BD;Bangladesh;3868;40;130474;1661
2020-06-27;BD;Bangladesh;3504;34;133978;1695
2020-06-28;BD;Bangladesh;3809;43;137787;1738
2020-06-29;BD;Bangladesh;4014;45;141801;1783
2020-06-30;BD;Bangladesh;3682;64;145483;1847
2020-07-01;BD;Bangladesh;3775;41;149258;1888
2020-07-02;BD;Bangladesh;4019;38;153277;1926
2020-07-03;BD;Bangladesh;3114;42;156391;1968
2020-07-04;BD;Bangladesh;3288;29;159679;1997
2020-07-05;BD;Bangladesh;2738;55;162417;2052
2020-07-06;BD;Bangladesh;3201;44;165618;2096
2020-07-07;BD;Bangladesh;3027;55;168645;2151
2020-07-08;BD;Bangladesh;3489;46;172134;2197
2020-07-09;BD;Bangladesh;3360;41;175494;2238
2020-07-10;BD;Bangladesh;2949;37;178443;2275
2020-07-11;BD;Bangladesh;2686;30;181129;2305
2020-07-12;BD;Bangladesh;2666;47;183795;2352
2020-07-13;BD;Bangladesh;3099;39;186894;2391
2020-07-14;BD;Bangladesh;3163;33;190057;2424
2020-07-15;BD;Bangladesh;3533;33;193590;2457
2020-07-16;BD;Bangladesh;2733;39;196323;2496
2020-07-17;BD;Bangladesh;3034;51;199357;2547
2020-07-18;BD;Bangladesh;2709;34;202066;2581
2020-07-19;BD;Bangladesh;2459;37;204525;2618
2020-07-20;BD;Bangladesh;2928;50;207453;2668
2020-07-21;BD;Bangladesh;3057;41;210510;2709
2020-07-22;BD;Bangladesh;2744;42;213254;2751
2020-07-23;BD;Bangladesh;2856;50;216110;2801
2020-07-24;BD;Bangladesh;2548;35;218658;2836
2020-07-25;BD;Bangladesh;2520;38;221178;2874
2020-07-26;BD;Bangladesh;2275;54;223453;2928
2020-07-27;BD;Bangladesh;2772;37;226225;2965
2020-07-28;BD;Bangladesh;2960;35;229185;3000
2020-07-29;BD;Bangladesh;3009;35;232194;3035
2020-07-30;BD;Bangladesh;2695;48;234889;3083
2020-07-31;BD;Bangladesh;2772;28;237661;3111
2020-08-01;BD;Bangladesh;2199;21;239860;3132
2020-08-02;BD;Bangladesh;886;22;240746;3154
2020-08-03;BD;Bangladesh;1356;30;242102;3184
2020-08-04;BD;Bangladesh;1918;50;244020;3234
2020-08-05;BD;Bangladesh;2654;33;246674;3267
2020-08-06;BD;Bangladesh;2977;39;249651;3306
2020-08-07;BD;Bangladesh;2851;27;252502;3333
2020-08-08;BD;Bangladesh;2611;32;255113;3365
2020-08-09;BD;Bangladesh;2487;34;257600;3399
2020-08-10;BD;Bangladesh;2907;39;260507;3438
2020-08-11;BD;Bangladesh;2996;33;263503;3471
2020-08-12;BD;Bangladesh;2995;42;266498;3513
2020-08-13;BD;Bangladesh;2617;44;269115;3557
2020-08-14;BD;Bangladesh;2766;34;271881;3591
2020-08-15;BD;Bangladesh;2644;34;274525;3625
2020-08-16;BD;Bangladesh;2024;32;276549;3657
2020-08-17;BD;Bangladesh;2595;37;279144;3694
2020-08-18;BD;Bangladesh;3200;46;282344;3740
2020-08-19;BD;Bangladesh;2747;41;285091;3781
2020-08-20;BD;Bangladesh;2868;41;287959;3822
2020-08-21;BD;Bangladesh;2401;39;290360;3861
2020-08-22;BD;Bangladesh;2265;46;292625;3907
2020-08-23;BD;Bangladesh;1973;34;294598;3941
2020-08-24;BD;Bangladesh;2485;42;297083;3983
2020-08-25;BD;Bangladesh;2545;45;299628;4028
2020-08-26;BD;Bangladesh;2519;54;302147;4082
2020-08-27;BD;Bangladesh;2436;45;304583;4127
2020-08-28;BD;Bangladesh;2211;47;306794;4174
2020-08-29;BD;Bangladesh;2131;32;308925;4206
2020-08-30;BD;Bangladesh;1897;42;310822;4248
2020-08-31;BD;Bangladesh;2174;33;312996;4281
2020-09-01;BD;Bangladesh;1950;35;314946;4316
2020-09-02;BD;Bangladesh;2582;35;317528;4351
2020-09-03;BD;Bangladesh;2158;32;319686;4383
2020-09-04;BD;Bangladesh;1929;29;321615;4412
2020-09-05;BD;Bangladesh;1950;35;323565;4447
2020-09-06;BD;Bangladesh;1592;32;325157;4479
2020-09-07;BD;Bangladesh;2202;37;327359;4516
2020-09-08;BD;Bangladesh;1892;36;329251;4552
2020-09-09;BD;Bangladesh;1827;41;331078;4593
2020-09-10;BD;Bangladesh;1892;41;332970;4634
2020-09-11;BD;Bangladesh;1792;34;334762;4668
2020-09-12;BD;Bangladesh;1282;34;336044;4702
2020-09-13;BD;Bangladesh;1476;31;337520;4733
2020-09-14;BD;Bangladesh;1812;26;339332;4759
2020-09-15;BD;Bangladesh;1724;43;341056;4802
2020-09-16;BD;Bangladesh;1615;21;342671;4823
2020-09-17;BD;Bangladesh;1593;36;344264;4859
2020-09-18;BD;Bangladesh;1541;22;345805;4881
2020-09-19;BD;Bangladesh;1567;32;347372;4913
2020-09-20;BD;Bangladesh;1546;26;348918;4939
2020-09-21;BD;Bangladesh;1703;40;350621;4979
2020-09-22;BD;Bangladesh;1557;28;352178;5007
2020-09-23;BD;Bangladesh;1666;37;353844;5044
2020-09-24;BD;Bangladesh;1540;28;355384;5072
2020-09-25;BD;Bangladesh;1383;21;356767;5093
2020-09-26;BD;Bangladesh;1106;36;357873;5129
2020-09-27;BD;Bangladesh;1275;32;359148;5161
2020-09-28;BD;Bangladesh;1407;32;360555;5193
2020-09-29;BD;Bangladesh;1488;26;362043;5219
2020-09-30;BD;Bangladesh;1436;32;363479;5251
2020-10-01;BD;Bangladesh;1508;21;364987;5272
2020-10-02;BD;Bangladesh;1396;33;366383;5305
2020-10-03;BD;Bangladesh;1182;20;367565;5325
2020-10-04;BD;Bangladesh;1125;23;368690;5348
2020-10-05;BD;Bangladesh;1442;27;370132;5375
2020-10-06;BD;Bangladesh;1499;30;371631;5405
2020-10-07;BD;Bangladesh;1520;35;373151;5440
2020-10-08;BD;Bangladesh;1441;20;374592;5460
2020-10-09;BD;Bangladesh;1278;17;375870;5477
2020-10-10;BD;Bangladesh;1203;23;377073;5500
2020-10-11;BD;Bangladesh;1193;24;378266;5524
2020-10-12;BD;Bangladesh;1472;31;379738;5555
2020-10-13;BD;Bangladesh;1537;22;381275;5577
2020-10-14;BD;Bangladesh;1684;16;382959;5593
2020-10-15;BD;Bangladesh;1600;15;384559;5608
2020-10-16;BD;Bangladesh;1527;15;386086;5623
2020-10-17;BD;Bangladesh;1209;23;387295;5646
2020-10-18;BD;Bangladesh;1274;14;388569;5660
2020-10-19;BD;Bangladesh;1637;21;390206;5681
2020-10-20;BD;Bangladesh;1380;18;391586;5699
2020-10-21;BD;Bangladesh;1545;24;393131;5723
2020-10-22;BD;Bangladesh;1696;24;394827;5747
2020-10-23;BD;Bangladesh;1586;14;396413;5761
2020-10-24;BD;Bangladesh;1094;19;397507;5780
2020-10-25;BD;Bangladesh;1308;23;398815;5803
2020-10-26;BD;Bangladesh;1436;15;400251;5818
2020-10-27;BD;Bangladesh;1335;20;401586;5838
2020-10-28;BD;Bangladesh;1493;23;403079;5861
2020-10-29;BD;Bangladesh;1681;25;404760;5886
2020-10-30;BD;Bangladesh;1604;19;406364;5905
2020-10-31;BD;Bangladesh;1320;18;407684;5923
2020-11-01;BD;Bangladesh;1568;18;409252;5941
2020-11-02;BD;Bangladesh;1736;25;410988;5966
2020-11-03;BD;Bangladesh;1659;17;412647;5983
2020-11-04;BD;Bangladesh;1517;21;414164;6004
2020-11-05;BD;Bangladesh;1842;17;416006;6021
2020-11-06;BD;Bangladesh;1469;15;417475;6036
2020-11-07;BD;Bangladesh;1289;13;418764;6049
2020-11-08;BD;Bangladesh;1474;18;420238;6067
2020-11-09;BD;Bangladesh;1683;25;421921;6092
2020-11-10;BD;Bangladesh;1699;16;423620;6108
2020-11-11;BD;Bangladesh;1733;19;425353;6127
2020-11-12;BD;Bangladesh;1845;13;427198;6140
2020-11-13;BD;Bangladesh;1767;19;428965;6159
2020-11-14;BD;Bangladesh;1531;14;430496;6173
2020-11-15;BD;Bangladesh;1837;21;432333;6194
2020-11-16;BD;Bangladesh;2139;21;434472;6215
2020-11-17;BD;Bangladesh;2212;39;436684;6254
2020-11-18;BD;Bangladesh;2111;21;438795;6275
2020-11-19;BD;Bangladesh;2364;30;441159;6305
2020-11-20;BD;Bangladesh;2275;17;443434;6322
2020-11-21;BD;Bangladesh;1847;28;445281;6350
2020-11-22;BD;Bangladesh;2060;38;447341;6388
2020-11-23;BD;Bangladesh;2419;28;449760;6416
2020-11-24;BD;Bangladesh;2230;32;451990;6448
2020-11-25;BD;Bangladesh;2156;39;454146;6487
2020-11-26;BD;Bangladesh;2292;37;456438;6524
2020-11-27;BD;Bangladesh;2273;20;458711;6544
2020-11-28;BD;Bangladesh;1908;36;460619;6580
2020-11-29;BD;Bangladesh;1788;29;462407;6609
2020-11-30;BD;Bangladesh;2525;35;464932;6644
2020-12-01;BD;Bangladesh;2293;31;467225;6675
2020-12-02;BD;Bangladesh;2198;38;469423;6713
2020-12-03;BD;Bangladesh;2316;35;471739;6748
2020-12-04;BD;Bangladesh;2252;24;473991;6772
2020-12-05;BD;Bangladesh;1798;35;475789;6807
2020-12-06;BD;Bangladesh;1756;31;477545;6838
2020-12-07;BD;Bangladesh;2198;36;479743;6874
2020-12-08;BD;Bangladesh;2202;32;481945;6906
2020-12-09;BD;Bangladesh;2159;24;484104;6930
2020-12-10;BD;Bangladesh;1861;37;485965;6967
2020-12-11;BD;Bangladesh;1884;19;487849;6986
2020-12-12;BD;Bangladesh;1329;34;489178;7020
2020-12-13;BD;Bangladesh;1355;32;490533;7052
2020-12-14;BD;Bangladesh;1799;37;492332;7089
2020-12-15;BD;Bangladesh;1877;40;494209;7129
2020-12-16;BD;Bangladesh;1632;27;495841;7156
2020-12-17;BD;Bangladesh;1134;36;496975;7192
2020-12-18;BD;Bangladesh;1318;25;498293;7217
2020-12-19;BD;Bangladesh;1267;25;499560;7242
2020-12-20;BD;Bangladesh;1153;38;500713;7280
2020-12-21;BD;Bangladesh;1470;32;502183;7312
2020-12-22;BD;Bangladesh;1318;17;503501;7329
2020-12-23;BD;Bangladesh;1367;30;504868;7359
2020-12-24;BD;Bangladesh;1234;19;506102;7378
2020-12-25;BD;Bangladesh;1163;20;507265;7398
2020-12-26;BD;Bangladesh;834;30;508099;7428
2020-12-27;BD;Bangladesh;1049;24;509148;7452
2020-12-28;BD;Bangladesh;932;27;510080;7479
2020-12-29;BD;Bangladesh;1181;30;511261;7509
2020-12-30;BD;Bangladesh;1235;22;512496;7531
2020-12-31;BD;Bangladesh;1014;28;513510;7559
2021-01-01;BD;Bangladesh;990;17;514500;7576
2021-01-02;BD;Bangladesh;684;23;515184;7599
2021-01-03;BD;Bangladesh;835;27;516019;7626
2021-01-04;BD;Bangladesh;910;24;516929;7650
2021-01-05;BD;Bangladesh;991;20;517920;7670
2021-01-06;BD;Bangladesh;978;17;518898;7687
2021-01-07;BD;Bangladesh;1007;31;519905;7718
2021-01-08;BD;Bangladesh;785;16;520690;7734
2021-01-09;BD;Bangladesh;692;22;521382;7756
2021-01-10;BD;Bangladesh;1071;25;522453;7781
2021-01-11;BD;Bangladesh;849;22;523302;7803
2021-01-12;BD;Bangladesh;718;16;524020;7819
2021-01-13;BD;Bangladesh;890;14;524910;7833
2021-01-14;BD;Bangladesh;813;16;525723;7849
2021-01-15;BD;Bangladesh;762;13;526485;7862
2021-01-16;BD;Bangladesh;578;21;527063;7883
2021-01-17;BD;Bangladesh;569;23;527632;7906
2021-01-18;BD;Bangladesh;697;16;528329;7922
2021-01-19;BD;Bangladesh;702;20;529031;7942
2021-01-20;BD;Bangladesh;656;8;529687;7950
2021-01-21;BD;Bangladesh;584;16;530271;7966
2021-01-22;BD;Bangladesh;619;15;530890;7981
2021-01-23;BD;Bangladesh;436;22;531326;8003
2021-01-24;BD;Bangladesh;473;20;531799;8023
2021-01-25;BD;Bangladesh;602;18;532401;8041
2021-01-26;BD;Bangladesh;515;14;532916;8055
2021-01-27;BD;Bangladesh;528;17;533444;8072
2021-01-28;BD;Bangladesh;509;15;533953;8087
2021-01-29;BD;Bangladesh;454;7;534407;8094
2021-01-30;BD;Bangladesh;363;17;534770;8111
2021-01-31;BD;Bangladesh;369;16;535139;8127
2021-02-01;BD;Bangladesh;443;10;535582;8137
2021-02-02;BD;Bangladesh;525;12;536107;8149
2021-02-03;BD;Bangladesh;438;13;536545;8162
2021-02-04;BD;Bangladesh;485;13;537030;8175
2021-02-05;BD;Bangladesh;435;7;537465;8182
2021-02-06;BD;Bangladesh;305;8;537770;8190
2021-02-07;BD;Bangladesh;292;15;538062;8205
2021-02-08;BD;Bangladesh;316;16;538378;8221
2021-02-09;BD;Bangladesh;387;8;538765;8229
2021-02-10;BD;Bangladesh;388;10;539153;8239
2021-02-11;BD;Bangladesh;378;9;539531;8248
2021-02-12;BD;Bangladesh;444;5;539975;8253
2021-02-13;BD;Bangladesh;291;13;540266;8266
2021-02-14;BD;Bangladesh;326;8;540592;8274
2021-02-15;BD;Bangladesh;446;11;541038;8285
2021-02-16;BD;Bangladesh;396;13;541434;8298
2021-02-17;BD;Bangladesh;443;16;541877;8314
2021-02-18;BD;Bangladesh;391;15;542268;8329
2021-02-19;BD;Bangladesh;406;8;542674;8337
2021-02-20;BD;Bangladesh;350;5;543024;8342
2021-02-21;BD;Bangladesh;327;7;543351;8349
2021-02-22;BD;Bangladesh;366;7;543717;8356
2021-02-23;BD;Bangladesh;399;18;544116;8374
2021-02-24;BD;Bangladesh;428;5;544544;8379
2021-02-25;BD;Bangladesh;410;5;544954;8384
2021-02-26;BD;Bangladesh;470;11;545424;8395
2021-02-27;BD;Bangladesh;407;5;545831;8400
2021-02-28;BD;Bangladesh;385;8;546216;8408
2021-03-01;BD;Bangladesh;585;8;546801;8416
2021-03-02;BD;Bangladesh;515;7;547316;8423
2021-03-03;BD;Bangladesh;614;5;547930;8428
2021-03-04;BD;Bangladesh;619;7;548549;8435
2021-03-05;BD;Bangladesh;635;6;549184;8441
2021-03-06;BD;Bangladesh;540;10;549724;8451
2021-03-07;BD;Bangladesh;606;11;550330;8462
2021-03-08;BD;Bangladesh;845;14;551175;8476
2021-03-09;BD;Bangladesh;912;13;552087;8489
2021-03-10;BD;Bangladesh;1018;7;553105;8496
2021-03-11;BD;Bangladesh;1051;6;554156;8502
2021-03-12;BD;Bangladesh;1066;13;555222;8515
2021-03-13;BD;Bangladesh;1014;12;556236;8527
2021-03-14;BD;Bangladesh;1159;18;557395;8545
2021-03-15;BD;Bangladesh;1773;26;559168;8571
2021-03-16;BD;Bangladesh;1719;26;560887;8597
2021-03-17;BD;Bangladesh;1865;11;562752;8608
2021-03-18;BD;Bangladesh;2187;16;564939;8624
2021-03-19;BD;Bangladesh;1899;18;566838;8642
2021-03-20;BD;Bangladesh;1868;26;568706;8668
2021-03-21;BD;Bangladesh;2172;22;570878;8690
2021-03-22;BD;Bangladesh;2809;30;573687;8720
2021-03-23;BD;Bangladesh;3554;18;577241;8738
2021-03-24;BD;Bangladesh;3567;25;580808;8763
2021-03-25;BD;Bangladesh;3587;34;584395;8797
2021-03-26;BD;Bangladesh;3737;33;588132;8830
2021-03-27;BD;Bangladesh;3674;39;591806;8869
2021-03-28;BD;Bangladesh;3908;35;595714;8904
2021-03-29;BD;Bangladesh;5181;45;600895;8949
2021-03-30;BD;Bangladesh;5042;45;605937;8994
2021-03-31;BD;Bangladesh;5358;52;611295;9046
2021-04-01;BD;Bangladesh;6469;59;617764;9105
2021-04-02;BD;Bangladesh;6830;50;624594;9155
2021-04-03;BD;Bangladesh;5683;58;630277;9213
2021-04-04;BD;Bangladesh;7087;53;637364;9266
2021-04-05;BD;Bangladesh;7075;52;644439;9318
2021-04-06;BD;Bangladesh;7213;66;651652;9384
2021-04-07;BD;Bangladesh;7626;63;659278;9447
2021-04-08;BD;Bangladesh;6854;74;666132;9521
2021-04-09;BD;Bangladesh;7462;63;673594;9584
2021-04-10;BD;Bangladesh;5343;77;678937;9661
2021-04-11;BD;Bangladesh;5819;78;684756;9739
2021-04-12;BD;Bangladesh;7201;83;691957;9822
2021-04-13;BD;Bangladesh;6028;69;697985;9891
2021-04-14;BD;Bangladesh;5185;96;703170;9987
2021-04-15;BD;Bangladesh;4192;94;707362;10081
2021-04-16;BD;Bangladesh;4417;101;711779;10182
2021-04-17;BD;Bangladesh;3473;101;715252;10283
2021-04-18;BD;Bangladesh;3698;102;718950;10385
2021-04-19;BD;Bangladesh;4271;112;723221;10497
2021-04-20;BD;Bangladesh;4559;91;727780;10588
2021-04-21;BD;Bangladesh;4280;95;732060;10683
2021-04-22;BD;Bangladesh;4014;98;736074;10781
2021-04-23;BD;Bangladesh;3629;88;739703;10869
2021-04-24;BD;Bangladesh;2697;83;742400;10952
2021-04-25;BD;Bangladesh;2922;101;745322;11053
2021-04-26;BD;Bangladesh;3306;97;748628;11150
2021-04-27;BD;Bangladesh;3031;78;751659;11228
2021-04-28;BD;Bangladesh;2955;77;754614;11305
2021-04-29;BD;Bangladesh;2341;88;756955;11393
2021-04-30;BD;Bangladesh;2177;57;759132;11450
2021-05-01;BD;Bangladesh;1452;60;760584;11510
2021-05-02;BD;Bangladesh;1359;69;761943;11579
2021-05-03;BD;Bangladesh;1739;65;763682;11644
2021-05-04;BD;Bangladesh;1914;61;765596;11705
2021-05-05;BD;Bangladesh;1742;50;767338;11755
2021-05-06;BD;Bangladesh;1822;41;769160;11796
2021-05-07;BD;Bangladesh;1682;37;770842;11833
2021-05-08;BD;Bangladesh;1285;45;772127;11878
2021-05-09;BD;Bangladesh;1386;56;773513;11934
2021-05-10;BD;Bangladesh;1514;38;775027;11972
2021-05-11;BD;Bangladesh;1230;33;776257;12005
2021-05-12;BD;Bangladesh;1140;40;777397;12045
2021-05-13;BD;Bangladesh;1290;31;778687;12076
2021-05-14;BD;Bangladesh;848;26;779535;12102
2021-05-15;BD;Bangladesh;261;22;779796;12124
2021-05-16;BD;Bangladesh;363;25;780159;12149
2021-05-17;BD;Bangladesh;698;32;780857;12181
2021-05-18;BD;Bangladesh;1272;30;782129;12211
2021-05-19;BD;Bangladesh;1608;37;783737;12248
2021-05-20;BD;Bangladesh;1457;36;785194;12284
2021-05-21;BD;Bangladesh;1504;26;786698;12310
2021-05-22;BD;Bangladesh;1028;38;787726;12348
2021-05-23;BD;Bangladesh;1354;28;789080;12376
2021-05-24;BD;Bangladesh;1441;25;790521;12401
2021-05-25;BD;Bangladesh;1675;40;792196;12441
2021-05-26;BD;Bangladesh;1497;17;793693;12458
2021-05-27;BD;Bangladesh;1292;22;794985;12480
2021-05-28;BD;Bangladesh;1358;31;796343;12511
2021-05-29;BD;Bangladesh;1043;38;797386;12549
2021-05-30;BD;Bangladesh;1444;34;798830;12583
2021-05-31;BD;Bangladesh;1710;36;800540;12619
2021-06-01;BD;Bangladesh;1765;41;802305;12660
2021-06-02;BD;Bangladesh;1988;34;804293;12694
2021-06-03;BD;Bangladesh;1687;30;805980;12724
2021-06-04;BD;Bangladesh;1887;34;807867;12758
2021-06-05;BD;Bangladesh;1447;43;809314;12801
2021-06-06;BD;Bangladesh;1676;38;810990;12839
2021-06-07;BD;Bangladesh;1970;30;812960;12869
2021-06-08;BD;Bangladesh;2322;44;815282;12913
2021-06-09;BD;Bangladesh;2537;36;817819;12949
2021-06-10;BD;Bangladesh;2576;40;820395;12989
2021-06-11;BD;Bangladesh;2454;43;822849;13032
2021-06-12;BD;Bangladesh;1637;39;824486;13071
2021-06-13;BD;Bangladesh;2436;47;826922;13118
2021-06-14;BD;Bangladesh;3050;54;829972;13172
2021-06-15;BD;Bangladesh;3319;50;833291;13222
2021-06-16;BD;Bangladesh;3956;60;837247;13282
2021-06-17;BD;Bangladesh;3840;63;841087;13345
2021-06-18;BD;Bangladesh;3883;54;844970;13399
2021-06-19;BD;Bangladesh;3057;67;848027;13466
2021-06-20;BD;Bangladesh;3641;82;851668;13548
2021-06-21;BD;Bangladesh;4636;78;856304;13626
2021-06-22;BD;Bangladesh;4846;76;861150;13702
2021-06-23;BD;Bangladesh;5727;85;866877;13787
2021-06-24;BD;Bangladesh;6058;81;872935;13868
2021-06-25;BD;Bangladesh;5869;108;878804;13976
2021-06-26;BD;Bangladesh;4334;77;883138;14053
2021-06-27;BD;Bangladesh;5268;119;888406;14172
2021-06-28;BD;Bangladesh;8364;104;896770;14276
2021-06-29;BD;Bangladesh;7666;112;904436;14388
2021-06-30;BD;Bangladesh;8822;115;913258;14503
2021-07-01;BD;Bangladesh;8301;143;921559;14646
2020-03-17;BB;Barbados;2;0;2;0
2020-03-18;BB;Barbados;0;0;2;0
2020-03-19;BB;Barbados;3;0;5;0
2020-03-20;BB;Barbados;0;0;5;0
2020-03-21;BB;Barbados;1;0;6;0
2020-03-22;BB;Barbados;8;0;14;0
2020-03-23;BB;Barbados;3;0;17;0
2020-03-24;BB;Barbados;1;0;18;0
2020-03-25;BB;Barbados;0;0;18;0
2020-03-26;BB;Barbados;0;0;18;0
2020-03-27;BB;Barbados;6;0;24;0
2020-03-28;BB;Barbados;2;0;26;0
2020-03-29;BB;Barbados;7;0;33;0
2020-03-30;BB;Barbados;0;0;33;0
2020-03-31;BB;Barbados;1;0;34;0
2020-04-01;BB;Barbados;0;0;34;0
2020-04-02;BB;Barbados;12;0;46;0
2020-04-03;BB;Barbados;5;0;51;0
2020-04-04;BB;Barbados;1;0;52;0
2020-04-05;BB;Barbados;4;1;56;1
2020-04-06;BB;Barbados;4;1;60;2
2020-04-07;BB;Barbados;3;1;63;3
2020-04-08;BB;Barbados;0;0;63;3
2020-04-09;BB;Barbados;3;0;66;3
2020-04-10;BB;Barbados;1;1;67;4
2020-04-11;BB;Barbados;1;0;68;4
2020-04-12;BB;Barbados;3;0;71;4
2020-04-13;BB;Barbados;1;0;72;4
2020-04-14;BB;Barbados;0;0;72;4
2020-04-15;BB;Barbados;1;1;73;5
2020-04-16;BB;Barbados;2;0;75;5
2020-04-17;BB;Barbados;0;0;75;5
2020-04-18;BB;Barbados;0;0;75;5
2020-04-19;BB;Barbados;0;0;75;5
2020-04-20;BB;Barbados;0;0;75;5
2020-04-21;BB;Barbados;0;0;75;5
2020-04-22;BB;Barbados;0;0;75;5
2020-04-23;BB;Barbados;1;1;76;6
2020-04-24;BB;Barbados;1;0;77;6
2020-04-25;BB;Barbados;2;0;79;6
2020-04-26;BB;Barbados;0;0;79;6
2020-04-27;BB;Barbados;1;0;80;6
2020-04-28;BB;Barbados;0;0;80;6
2020-04-29;BB;Barbados;0;1;80;7
2020-04-30;BB;Barbados;1;0;81;7
2020-05-01;BB;Barbados;0;0;81;7
2020-05-02;BB;Barbados;0;0;81;7
2020-05-03;BB;Barbados;1;0;82;7
2020-05-04;BB;Barbados;0;0;82;7
2020-05-05;BB;Barbados;0;0;82;7
2020-05-06;BB;Barbados;0;0;82;7
2020-05-07;BB;Barbados;0;0;82;7
2020-05-08;BB;Barbados;1;0;83;7
2020-05-09;BB;Barbados;1;0;84;7
2020-05-10;BB;Barbados;0;0;84;7
2020-05-11;BB;Barbados;0;0;84;7
2020-05-12;BB;Barbados;1;0;85;7
2020-05-13;BB;Barbados;0;0;85;7
2020-05-14;BB;Barbados;0;0;85;7
2020-05-15;BB;Barbados;0;0;85;7
2020-05-16;BB;Barbados;1;0;86;7
2020-05-17;BB;Barbados;2;0;88;7
2020-05-18;BB;Barbados;0;0;88;7
2020-05-19;BB;Barbados;2;0;90;7
2020-05-20;BB;Barbados;0;0;90;7
2020-05-21;BB;Barbados;0;0;90;7
2020-05-22;BB;Barbados;0;0;90;7
2020-05-23;BB;Barbados;2;0;92;7
2020-05-24;BB;Barbados;0;0;92;7
2020-05-25;BB;Barbados;0;0;92;7
2020-05-26;BB;Barbados;0;0;92;7
2020-05-27;BB;Barbados;0;0;92;7
2020-05-28;BB;Barbados;0;0;92;7
2020-05-29;BB;Barbados;0;0;92;7
2020-05-30;BB;Barbados;0;0;92;7
2020-05-31;BB;Barbados;0;0;92;7
2020-06-01;BB;Barbados;0;0;92;7
2020-06-02;BB;Barbados;0;0;92;7
2020-06-03;BB;Barbados;0;0;92;7
2020-06-04;BB;Barbados;0;0;92;7
2020-06-05;BB;Barbados;0;0;92;7
2020-06-06;BB;Barbados;0;0;92;7
2020-06-07;BB;Barbados;0;0;92;7
2020-06-08;BB;Barbados;0;0;92;7
2020-06-09;BB;Barbados;0;0;92;7
2020-06-10;BB;Barbados;4;0;96;7
2020-06-11;BB;Barbados;0;0;96;7
2020-06-12;BB;Barbados;0;0;96;7
2020-06-13;BB;Barbados;0;0;96;7
2020-06-14;BB;Barbados;0;0;96;7
2020-06-15;BB;Barbados;1;0;97;7
2020-06-16;BB;Barbados;0;0;97;7
2020-06-17;BB;Barbados;0;0;97;7
2020-06-18;BB;Barbados;0;0;97;7
2020-06-19;BB;Barbados;0;0;97;7
2020-06-20;BB;Barbados;0;0;97;7
2020-06-21;BB;Barbados;0;0;97;7
2020-06-22;BB;Barbados;0;0;97;7
2020-06-23;BB;Barbados;0;0;97;7
2020-06-24;BB;Barbados;0;0;97;7
2020-06-25;BB;Barbados;0;0;97;7
2020-06-26;BB;Barbados;0;0;97;7
2020-06-27;BB;Barbados;0;0;97;7
2020-06-28;BB;Barbados;0;0;97;7
2020-06-29;BB;Barbados;0;0;97;7
2020-06-30;BB;Barbados;0;0;97;7
2020-07-01;BB;Barbados;0;0;97;7
2020-07-02;BB;Barbados;0;0;97;7
2020-07-03;BB;Barbados;0;0;97;7
2020-07-04;BB;Barbados;0;0;97;7
2020-07-05;BB;Barbados;1;0;98;7
2020-07-06;BB;Barbados;0;0;98;7
2020-07-07;BB;Barbados;0;0;98;7
2020-07-08;BB;Barbados;0;0;98;7
2020-07-09;BB;Barbados;0;0;98;7
2020-07-10;BB;Barbados;0;0;98;7
2020-07-11;BB;Barbados;5;0;103;7
2020-07-12;BB;Barbados;0;0;103;7
2020-07-13;BB;Barbados;0;0;103;7
2020-07-14;BB;Barbados;0;0;103;7
2020-07-15;BB;Barbados;1;0;104;7
2020-07-16;BB;Barbados;0;0;104;7
2020-07-17;BB;Barbados;0;0;104;7
2020-07-18;BB;Barbados;0;0;104;7
2020-07-19;BB;Barbados;1;0;105;7
2020-07-20;BB;Barbados;1;0;106;7
2020-07-21;BB;Barbados;0;0;106;7
2020-07-22;BB;Barbados;0;0;106;7
2020-07-23;BB;Barbados;0;0;106;7
2020-07-24;BB;Barbados;2;0;108;7
2020-07-25;BB;Barbados;0;0;108;7
2020-07-26;BB;Barbados;2;0;110;7
2020-07-27;BB;Barbados;0;0;110;7
2020-07-28;BB;Barbados;0;0;110;7
2020-07-29;BB;Barbados;0;0;110;7
2020-07-30;BB;Barbados;0;0;110;7
2020-07-31;BB;Barbados;0;0;110;7
2020-08-01;BB;Barbados;12;0;122;7
2020-08-02;BB;Barbados;10;0;132;7
2020-08-03;BB;Barbados;0;0;132;7
2020-08-04;BB;Barbados;0;0;132;7
2020-08-05;BB;Barbados;1;0;133;7
2020-08-06;BB;Barbados;0;0;133;7
2020-08-07;BB;Barbados;5;0;138;7
2020-08-08;BB;Barbados;0;0;138;7
2020-08-09;BB;Barbados;4;0;142;7
2020-08-10;BB;Barbados;0;0;142;7
2020-08-11;BB;Barbados;1;0;143;7
2020-08-12;BB;Barbados;1;0;144;7
2020-08-13;BB;Barbados;0;0;144;7
2020-08-14;BB;Barbados;4;0;148;7
2020-08-15;BB;Barbados;2;0;150;7
2020-08-16;BB;Barbados;1;0;151;7
2020-08-17;BB;Barbados;1;0;152;7
2020-08-18;BB;Barbados;1;0;153;7
2020-08-19;BB;Barbados;2;0;155;7
2020-08-20;BB;Barbados;1;0;156;7
2020-08-21;BB;Barbados;1;0;157;7
2020-08-22;BB;Barbados;1;0;158;7
2020-08-23;BB;Barbados;3;0;161;7
2020-08-24;BB;Barbados;0;0;161;7
2020-08-25;BB;Barbados;3;0;164;7
2020-08-26;BB;Barbados;1;0;165;7
2020-08-27;BB;Barbados;0;0;165;7
2020-08-28;BB;Barbados;1;0;166;7
2020-08-29;BB;Barbados;4;0;170;7
2020-08-30;BB;Barbados;3;0;173;7
2020-08-31;BB;Barbados;1;0;174;7
2020-09-01;BB;Barbados;2;0;176;7
2020-09-02;BB;Barbados;0;0;176;7
2020-09-03;BB;Barbados;1;0;177;7
2020-09-04;BB;Barbados;1;0;178;7
2020-09-05;BB;Barbados;0;0;178;7
2020-09-06;BB;Barbados;0;0;178;7
2020-09-07;BB;Barbados;1;0;179;7
2020-09-08;BB;Barbados;1;0;180;7
2020-09-09;BB;Barbados;0;0;180;7
2020-09-10;BB;Barbados;0;0;180;7
2020-09-11;BB;Barbados;0;0;180;7
2020-09-12;BB;Barbados;0;0;180;7
2020-09-13;BB;Barbados;1;0;181;7
2020-09-14;BB;Barbados;2;0;183;7
2020-09-15;BB;Barbados;1;0;184;7
2020-09-16;BB;Barbados;1;0;185;7
2020-09-17;BB;Barbados;0;0;185;7
2020-09-18;BB;Barbados;0;0;185;7
2020-09-19;BB;Barbados;0;0;185;7
2020-09-20;BB;Barbados;4;0;189;7
2020-09-21;BB;Barbados;0;0;189;7
2020-09-22;BB;Barbados;0;0;189;7
2020-09-23;BB;Barbados;0;0;189;7
2020-09-24;BB;Barbados;0;0;189;7
2020-09-25;BB;Barbados;1;0;190;7
2020-09-26;BB;Barbados;0;0;190;7
2020-09-27;BB;Barbados;0;0;190;7
2020-09-28;BB;Barbados;0;0;190;7
2020-09-29;BB;Barbados;0;0;190;7
2020-09-30;BB;Barbados;0;0;190;7
2020-10-01;BB;Barbados;3;0;193;7
2020-10-02;BB;Barbados;0;0;193;7
2020-10-03;BB;Barbados;3;0;196;7
2020-10-04;BB;Barbados;3;0;199;7
2020-10-05;BB;Barbados;1;0;200;7
2020-10-06;BB;Barbados;0;0;200;7
2020-10-07;BB;Barbados;3;0;203;7
2020-10-08;BB;Barbados;0;0;203;7
2020-10-09;BB;Barbados;1;0;204;7
2020-10-10;BB;Barbados;2;0;206;7
2020-10-11;BB;Barbados;2;0;208;7
2020-10-12;BB;Barbados;0;0;208;7
2020-10-13;BB;Barbados;2;0;210;7
2020-10-14;BB;Barbados;5;0;215;7
2020-10-15;BB;Barbados;3;0;218;7
2020-10-16;BB;Barbados;1;0;219;7
2020-10-17;BB;Barbados;0;0;219;7
2020-10-18;BB;Barbados;2;0;221;7
2020-10-19;BB;Barbados;1;0;222;7
2020-10-20;BB;Barbados;0;0;222;7
2020-10-21;BB;Barbados;0;0;222;7
2020-10-22;BB;Barbados;2;0;224;7
2020-10-23;BB;Barbados;2;0;226;7
2020-10-24;BB;Barbados;1;0;227;7
2020-10-25;BB;Barbados;0;0;227;7
2020-10-26;BB;Barbados;6;0;233;7
2020-10-27;BB;Barbados;0;0;233;7
2020-10-28;BB;Barbados;1;0;234;7
2020-10-29;BB;Barbados;0;0;234;7
2020-10-30;BB;Barbados;2;0;236;7
2020-10-31;BB;Barbados;1;0;237;7
2020-11-01;BB;Barbados;0;0;237;7
2020-11-02;BB;Barbados;1;0;238;7
2020-11-03;BB;Barbados;0;0;238;7
2020-11-04;BB;Barbados;1;0;239;7
2020-11-05;BB;Barbados;0;0;239;7
2020-11-06;BB;Barbados;3;0;242;7
2020-11-07;BB;Barbados;0;0;242;7
2020-11-08;BB;Barbados;0;0;242;7
2020-11-09;BB;Barbados;1;0;243;7
2020-11-10;BB;Barbados;0;0;243;7
2020-11-11;BB;Barbados;6;0;249;7
2020-11-12;BB;Barbados;0;0;249;7
2020-11-13;BB;Barbados;0;0;249;7
2020-11-14;BB;Barbados;0;0;249;7
2020-11-15;BB;Barbados;1;0;250;7
2020-11-16;BB;Barbados;0;0;250;7
2020-11-17;BB;Barbados;0;0;250;7
2020-11-18;BB;Barbados;2;0;252;7
2020-11-19;BB;Barbados;1;0;253;7
2020-11-20;BB;Barbados;0;0;253;7
2020-11-21;BB;Barbados;2;0;255;7
2020-11-22;BB;Barbados;4;0;259;7
2020-11-23;BB;Barbados;1;0;260;7
2020-11-24;BB;Barbados;2;0;262;7
2020-11-25;BB;Barbados;1;0;263;7
2020-11-26;BB;Barbados;3;0;266;7
2020-11-27;BB;Barbados;4;0;270;7
2020-11-28;BB;Barbados;0;0;270;7
2020-11-29;BB;Barbados;5;0;275;7
2020-11-30;BB;Barbados;1;0;276;7
2020-12-01;BB;Barbados;2;0;278;7
2020-12-02;BB;Barbados;1;0;279;7
2020-12-03;BB;Barbados;2;0;281;7
2020-12-04;BB;Barbados;3;0;284;7
2020-12-05;BB;Barbados;1;0;285;7
2020-12-06;BB;Barbados;0;0;285;7
2020-12-07;BB;Barbados;2;0;287;7
2020-12-08;BB;Barbados;2;0;289;7
2020-12-09;BB;Barbados;1;0;290;7
2020-12-10;BB;Barbados;1;0;291;7
2020-12-11;BB;Barbados;1;0;292;7
2020-12-12;BB;Barbados;0;0;292;7
2020-12-13;BB;Barbados;0;0;292;7
2020-12-14;BB;Barbados;4;0;296;7
2020-12-15;BB;Barbados;1;0;297;7
2020-12-16;BB;Barbados;4;0;301;7
2020-12-17;BB;Barbados;4;0;305;7
2020-12-18;BB;Barbados;2;0;307;7
2020-12-19;BB;Barbados;0;0;307;7
2020-12-20;BB;Barbados;0;0;307;7
2020-12-21;BB;Barbados;14;0;321;7
2020-12-22;BB;Barbados;6;0;327;7
2020-12-23;BB;Barbados;2;0;329;7
2020-12-24;BB;Barbados;16;0;345;7
2020-12-25;BB;Barbados;2;0;347;7
2020-12-26;BB;Barbados;5;0;352;7
2020-12-27;BB;Barbados;4;0;356;7
2020-12-28;BB;Barbados;9;0;365;7
2020-12-29;BB;Barbados;6;0;371;7
2020-12-30;BB;Barbados;1;0;372;7
2020-12-31;BB;Barbados;11;0;383;7
2021-01-01;BB;Barbados;12;0;395;7
2021-01-02;BB;Barbados;0;0;395;7
2021-01-03;BB;Barbados;161;0;556;7
2021-01-04;BB;Barbados;50;0;606;7
2021-01-05;BB;Barbados;37;0;643;7
2021-01-06;BB;Barbados;100;0;743;7
2021-01-07;BB;Barbados;0;0;743;7
2021-01-08;BB;Barbados;37;0;780;7
2021-01-09;BB;Barbados;28;0;808;7
2021-01-10;BB;Barbados;70;0;878;7
2021-01-11;BB;Barbados;6;0;884;7
2021-01-12;BB;Barbados;84;0;968;7
2021-01-13;BB;Barbados;39;0;1007;7
2021-01-14;BB;Barbados;29;0;1036;7
2021-01-15;BB;Barbados;0;0;1036;7
2021-01-16;BB;Barbados;59;0;1095;7
2021-01-17;BB;Barbados;0;0;1095;7
2021-01-18;BB;Barbados;0;0;1095;7
2021-01-19;BB;Barbados;0;0;1095;7
2021-01-20;BB;Barbados;61;2;1156;9
2021-01-21;BB;Barbados;0;0;1156;9
2021-01-22;BB;Barbados;0;0;1156;9
2021-01-23;BB;Barbados;185;0;1341;9
2021-01-24;BB;Barbados;46;0;1387;9
2021-01-25;BB;Barbados;14;1;1401;10
2021-01-26;BB;Barbados;0;0;1401;10
2021-01-27;BB;Barbados;42;1;1443;11
2021-01-28;BB;Barbados;34;0;1477;11
2021-01-29;BB;Barbados;21;1;1498;12
2021-01-30;BB;Barbados;25;0;1523;12
2021-01-31;BB;Barbados;22;2;1545;14
2021-02-01;BB;Barbados;13;0;1558;14
2021-02-02;BB;Barbados;28;0;1586;14
2021-02-03;BB;Barbados;25;0;1611;14
2021-02-04;BB;Barbados;30;1;1641;15
2021-02-05;BB;Barbados;15;2;1656;17
2021-02-06;BB;Barbados;20;1;1676;18
2021-02-07;BB;Barbados;33;0;1709;18
2021-02-08;BB;Barbados;23;0;1732;18
2021-02-09;BB;Barbados;82;2;1814;20
2021-02-10;BB;Barbados;43;0;1857;20
2021-02-11;BB;Barbados;47;0;1904;20
2021-02-12;BB;Barbados;43;1;1947;21
2021-02-13;BB;Barbados;114;2;2061;23
2021-02-14;BB;Barbados;0;0;2061;23
2021-02-15;BB;Barbados;207;1;2268;24
2021-02-16;BB;Barbados;63;1;2331;25
2021-02-17;BB;Barbados;126;3;2457;28
2021-02-18;BB;Barbados;190;1;2647;29
2021-02-19;BB;Barbados;30;1;2677;30
2021-02-20;BB;Barbados;38;1;2715;31
2021-02-21;BB;Barbados;57;0;2772;31
2021-02-22;BB;Barbados;19;0;2791;31
2021-02-23;BB;Barbados;61;0;2852;31
2021-02-24;BB;Barbados;55;1;2907;32
2021-02-25;BB;Barbados;42;0;2949;32
2021-02-26;BB;Barbados;45;1;2994;33
2021-02-27;BB;Barbados;44;0;3038;33
2021-02-28;BB;Barbados;30;0;3068;33
2021-03-01;BB;Barbados;47;3;3115;36
2021-03-02;BB;Barbados;25;0;3140;36
2021-03-03;BB;Barbados;23;1;3163;37
2021-03-04;BB;Barbados;23;0;3186;37
2021-03-05;BB;Barbados;31;0;3217;37
2021-03-06;BB;Barbados;47;0;3264;37
2021-03-07;BB;Barbados;21;0;3285;37
2021-03-08;BB;Barbados;18;0;3303;37
2021-03-09;BB;Barbados;30;0;3333;37
2021-03-10;BB;Barbados;20;0;3353;37
2021-03-11;BB;Barbados;19;0;3372;37
2021-03-12;BB;Barbados;19;0;3391;37
2021-03-13;BB;Barbados;13;0;3404;37
2021-03-14;BB;Barbados;17;0;3421;37
2021-03-15;BB;Barbados;21;1;3442;38
2021-03-16;BB;Barbados;16;1;3458;39
2021-03-17;BB;Barbados;13;0;3471;39
2021-03-18;BB;Barbados;21;0;3492;39
2021-03-19;BB;Barbados;20;0;3512;39
2021-03-20;BB;Barbados;21;0;3533;39
2021-03-21;BB;Barbados;18;0;3551;39
2021-03-22;BB;Barbados;8;1;3559;40
2021-03-23;BB;Barbados;15;0;3574;40
2021-03-24;BB;Barbados;8;0;3582;40
2021-03-25;BB;Barbados;11;0;3593;40
2021-03-26;BB;Barbados;10;1;3603;41
2021-03-27;BB;Barbados;6;0;3609;41
2021-03-28;BB;Barbados;20;0;3629;41
2021-03-29;BB;Barbados;5;0;3634;41
2021-03-30;BB;Barbados;8;1;3642;42
2021-03-31;BB;Barbados;10;0;3652;42
2021-04-01;BB;Barbados;7;0;3659;42
2021-04-02;BB;Barbados;6;0;3665;42
2021-04-03;BB;Barbados;3;1;3668;43
2021-04-04;BB;Barbados;0;0;3668;43
2021-04-05;BB;Barbados;11;0;3679;43
2021-04-06;BB;Barbados;12;0;3691;43
2021-04-07;BB;Barbados;0;0;3691;43
2021-04-08;BB;Barbados;13;1;3704;44
2021-04-09;BB;Barbados;4;0;3708;44
2021-04-10;BB;Barbados;11;0;3719;44
2021-04-11;BB;Barbados;11;0;3730;44
2021-04-12;BB;Barbados;4;0;3734;44
2021-04-13;BB;Barbados;6;0;3740;44
2021-04-14;BB;Barbados;4;0;3744;44
2021-04-15;BB;Barbados;9;0;3753;44
2021-04-16;BB;Barbados;12;0;3765;44
2021-04-17;BB;Barbados;8;0;3773;44
2021-04-18;BB;Barbados;8;0;3781;44
2021-04-19;BB;Barbados;3;0;3784;44
2021-04-20;BB;Barbados;9;0;3793;44
2021-04-21;BB;Barbados;4;0;3797;44
2021-04-22;BB;Barbados;9;0;3806;44
2021-04-23;BB;Barbados;14;0;3820;44
2021-04-24;BB;Barbados;0;0;3820;44
2021-04-25;BB;Barbados;4;0;3824;44
2021-04-26;BB;Barbados;1;0;3825;44
2021-04-27;BB;Barbados;3;0;3828;44
2021-04-28;BB;Barbados;3;0;3831;44
2021-04-29;BB;Barbados;7;0;3838;44
2021-04-30;BB;Barbados;17;0;3855;44
2021-05-01;BB;Barbados;8;0;3863;44
2021-05-02;BB;Barbados;3;0;3866;44
2021-05-03;BB;Barbados;15;0;3881;44
2021-05-04;BB;Barbados;3;1;3884;45
2021-05-05;BB;Barbados;31;0;3915;45
2021-05-06;BB;Barbados;14;0;3929;45
2021-05-07;BB;Barbados;2;0;3931;45
2021-05-08;BB;Barbados;2;0;3933;45
2021-05-09;BB;Barbados;9;0;3942;45
2021-05-10;BB;Barbados;4;0;3946;45
2021-05-11;BB;Barbados;4;0;3950;45
2021-05-12;BB;Barbados;7;1;3957;46
2021-05-13;BB;Barbados;2;0;3959;46
2021-05-14;BB;Barbados;2;0;3961;46
2021-05-15;BB;Barbados;4;0;3965;46
2021-05-16;BB;Barbados;2;0;3967;46
2021-05-17;BB;Barbados;1;0;3968;46
2021-05-18;BB;Barbados;4;1;3972;47
2021-05-19;BB;Barbados;3;0;3975;47
2021-05-20;BB;Barbados;0;0;3975;47
2021-05-21;BB;Barbados;10;0;3985;47
2021-05-22;BB;Barbados;6;0;3991;47
2021-05-23;BB;Barbados;4;0;3995;47
2021-05-24;BB;Barbados;0;0;3995;47
2021-05-25;BB;Barbados;5;0;4000;47
2021-05-26;BB;Barbados;4;0;4004;47
2021-05-27;BB;Barbados;2;0;4006;47
2021-05-28;BB;Barbados;3;0;4009;47
2021-05-29;BB;Barbados;3;0;4012;47
2021-05-30;BB;Barbados;5;0;4017;47
2021-05-31;BB;Barbados;0;0;4017;47
2021-06-01;BB;Barbados;0;0;4017;47
2021-06-02;BB;Barbados;6;0;4023;47
2021-06-03;BB;Barbados;3;0;4026;47
2021-06-04;BB;Barbados;3;0;4029;47
2021-06-05;BB;Barbados;1;0;4030;47
2021-06-06;BB;Barbados;1;0;4031;47
2021-06-07;BB;Barbados;1;0;4032;47
2021-06-08;BB;Barbados;0;0;4032;47
2021-06-09;BB;Barbados;0;0;4032;47
2021-06-10;BB;Barbados;1;0;4033;47
2021-06-11;BB;Barbados;0;0;4033;47
2021-06-12;BB;Barbados;3;0;4036;47
2021-06-13;BB;Barbados;0;0;4036;47
2021-06-14;BB;Barbados;1;0;4037;47
2021-06-15;BB;Barbados;1;0;4038;47
2021-06-16;BB;Barbados;0;0;4038;47
2021-06-17;BB;Barbados;1;0;4039;47
2021-06-18;BB;Barbados;1;0;4040;47
2021-06-19;BB;Barbados;1;0;4041;47
2021-06-20;BB;Barbados;2;0;4043;47
2021-06-21;BB;Barbados;2;0;4045;47
2021-06-22;BB;Barbados;0;0;4045;47
2021-06-23;BB;Barbados;7;0;4052;47
2021-06-24;BB;Barbados;5;0;4057;47
2021-06-25;BB;Barbados;9;0;4066;47
2021-06-26;BB;Barbados;8;0;4074;47
2021-06-27;BB;Barbados;1;0;4075;47
2021-06-28;BB;Barbados;2;0;4077;47
2021-06-29;BB;Barbados;2;0;4079;47
2021-06-30;BB;Barbados;2;0;4081;47
2021-07-01;BB;Barbados;1;0;4082;47
2020-02-28;BY;Belarus;1;0;1;0
2020-02-29;BY;Belarus;0;0;1;0
2020-03-01;BY;Belarus;0;0;1;0
2020-03-02;BY;Belarus;0;0;1;0
2020-03-03;BY;Belarus;0;0;1;0
2020-03-04;BY;Belarus;5;0;6;0
2020-03-05;BY;Belarus;0;0;6;0
2020-03-06;BY;Belarus;0;0;6;0
2020-03-07;BY;Belarus;0;0;6;0
2020-03-08;BY;Belarus;0;0;6;0
2020-03-09;BY;Belarus;0;0;6;0
2020-03-10;BY;Belarus;3;0;9;0
2020-03-11;BY;Belarus;0;0;9;0
2020-03-12;BY;Belarus;3;0;12;0
2020-03-13;BY;Belarus;15;0;27;0
2020-03-14;BY;Belarus;0;0;27;0
2020-03-15;BY;Belarus;0;0;27;0
2020-03-16;BY;Belarus;9;0;36;0
2020-03-17;BY;Belarus;0;0;36;0
2020-03-18;BY;Belarus;15;0;51;0
2020-03-19;BY;Belarus;0;0;51;0
2020-03-20;BY;Belarus;18;0;69;0
2020-03-21;BY;Belarus;7;0;76;0
2020-03-22;BY;Belarus;0;0;76;0
2020-03-23;BY;Belarus;5;0;81;0
2020-03-24;BY;Belarus;0;0;81;0
2020-03-25;BY;Belarus;5;0;86;0
2020-03-26;BY;Belarus;0;0;86;0
2020-03-27;BY;Belarus;8;0;94;0
2020-03-28;BY;Belarus;0;0;94;0
2020-03-29;BY;Belarus;0;0;94;0
2020-03-30;BY;Belarus;58;0;152;0
2020-03-31;BY;Belarus;0;1;152;1
2020-04-01;BY;Belarus;11;1;163;2
2020-04-02;BY;Belarus;141;2;304;4
2020-04-03;BY;Belarus;47;0;351;4
2020-04-04;BY;Belarus;89;1;440;5
2020-04-05;BY;Belarus;122;3;562;8
2020-04-06;BY;Belarus;138;5;700;13
2020-04-07;BY;Belarus;161;0;861;13
2020-04-08;BY;Belarus;205;0;1066;13
2020-04-09;BY;Belarus;420;3;1486;16
2020-04-10;BY;Belarus;495;3;1981;19
2020-04-11;BY;Belarus;245;4;2226;23
2020-04-12;BY;Belarus;352;3;2578;26
2020-04-13;BY;Belarus;341;3;2919;29
2020-04-14;BY;Belarus;362;4;3281;33
2020-04-15;BY;Belarus;447;3;3728;36
2020-04-16;BY;Belarus;476;4;4204;40
2020-04-17;BY;Belarus;575;2;4779;42
2020-04-18;BY;Belarus;518;3;5297;45
2020-04-19;BY;Belarus;510;2;5807;47
2020-04-20;BY;Belarus;457;4;6264;51
2020-04-21;BY;Belarus;459;4;6723;55
2020-04-22;BY;Belarus;558;3;7281;58
2020-04-23;BY;Belarus;741;2;8022;60
2020-04-24;BY;Belarus;751;3;8773;63
2020-04-25;BY;Belarus;817;4;9590;67
2020-04-26;BY;Belarus;873;5;10463;72
2020-04-27;BY;Belarus;826;3;11289;75
2020-04-28;BY;Belarus;919;4;12208;79
2020-04-29;BY;Belarus;973;5;13181;84
2020-04-30;BY;Belarus;846;5;14027;89
2020-05-01;BY;Belarus;890;4;14917;93
2020-05-02;BY;Belarus;911;4;15828;97
2020-05-03;BY;Belarus;877;2;16705;99
2020-05-04;BY;Belarus;784;4;17489;103
2020-05-05;BY;Belarus;861;4;18350;107
2020-05-06;BY;Belarus;905;5;19255;112
2020-05-07;BY;Belarus;913;4;20168;116
2020-05-08;BY;Belarus;933;5;21101;121
2020-05-09;BY;Belarus;951;5;22052;126
2020-05-10;BY;Belarus;921;5;22973;131
2020-05-11;BY;Belarus;933;4;23906;135
2020-05-12;BY;Belarus;967;7;24873;142
2020-05-13;BY;Belarus;952;4;25825;146
2020-05-14;BY;Belarus;947;5;26772;151
2020-05-15;BY;Belarus;958;5;27730;156
2020-05-16;BY;Belarus;951;4;28681;160
2020-05-17;BY;Belarus;969;5;29650;165
2020-05-18;BY;Belarus;922;6;30572;171
2020-05-19;BY;Belarus;936;4;31508;175
2020-05-20;BY;Belarus;918;4;32426;179
2020-05-21;BY;Belarus;945;6;33371;185
2020-05-22;BY;Belarus;932;5;34303;190
2020-05-23;BY;Belarus;941;4;35244;194
2020-05-24;BY;Belarus;954;5;36198;199
2020-05-25;BY;Belarus;946;5;37144;204
2020-05-26;BY;Belarus;915;4;38059;208
2020-05-27;BY;Belarus;897;6;38956;214
2020-05-28;BY;Belarus;902;5;39858;219
2020-05-29;BY;Belarus;906;5;40764;224
2020-05-30;BY;Belarus;894;5;41658;229
2020-05-31;BY;Belarus;898;6;42556;235
2020-06-01;BY;Belarus;847;5;43403;240
2020-06-02;BY;Belarus;852;3;44255;243
2020-06-03;BY;Belarus;861;5;45116;248
2020-06-04;BY;Belarus;865;5;45981;253
2020-06-05;BY;Belarus;887;6;46868;259
2020-06-06;BY;Belarus;883;4;47751;263
2020-06-07;BY;Belarus;879;6;48630;269
2020-06-08;BY;Belarus;823;7;49453;276
2020-06-09;BY;Belarus;812;6;50265;282
2020-06-10;BY;Belarus;801;6;51066;288
2020-06-11;BY;Belarus;750;5;51816;293
2020-06-12;BY;Belarus;704;5;52520;298
2020-06-13;BY;Belarus;721;5;53241;303
2020-06-14;BY;Belarus;732;5;53973;308
2020-06-15;BY;Belarus;707;4;54680;312
2020-06-16;BY;Belarus;689;6;55369;318
2020-06-17;BY;Belarus;663;6;56032;324
2020-06-18;BY;Belarus;625;7;56657;331
2020-06-19;BY;Belarus;676;6;57333;337
2020-06-20;BY;Belarus;603;6;57936;343
2020-06-21;BY;Belarus;569;3;58505;346
2020-06-22;BY;Belarus;518;5;59023;351
2020-06-23;BY;Belarus;464;6;59487;357
2020-06-24;BY;Belarus;458;5;59945;362
2020-06-25;BY;Belarus;437;5;60382;367
2020-06-26;BY;Belarus;331;6;60713;373
2020-06-27;BY;Belarus;382;4;61095;377
2020-06-28;BY;Belarus;380;6;61475;383
2020-06-29;BY;Belarus;315;4;61790;387
2020-06-30;BY;Belarus;328;5;62118;392
2020-07-01;BY;Belarus;306;6;62424;398
2020-07-02;BY;Belarus;274;7;62698;405
2020-07-03;BY;Belarus;299;7;62997;412
2020-07-04;BY;Belarus;273;6;63270;418
2020-07-05;BY;Belarus;284;5;63554;423
2020-07-06;BY;Belarus;250;6;63804;429
2020-07-07;BY;Belarus;199;7;64003;436
2020-07-08;BY;Belarus;221;7;64224;443
2020-07-09;BY;Belarus;187;6;64411;449
2020-07-10;BY;Belarus;193;5;64604;454
2020-07-11;BY;Belarus;163;5;64767;459
2020-07-12;BY;Belarus;165;5;64932;464
2020-07-13;BY;Belarus;182;4;65114;468
2020-07-14;BY;Belarus;155;6;65269;474
2020-07-15;BY;Belarus;174;6;65443;480
2020-07-16;BY;Belarus;180;5;65623;485
2020-07-17;BY;Belarus;159;6;65782;491
2020-07-18;BY;Belarus;171;4;65953;495
2020-07-19;BY;Belarus;142;4;66095;499
2020-07-20;BY;Belarus;118;4;66213;503
2020-07-21;BY;Belarus;135;4;66348;507
2020-07-22;BY;Belarus;173;6;66521;513
2020-07-23;BY;Belarus;167;6;66688;519
2020-07-24;BY;Belarus;158;5;66846;524
2020-07-25;BY;Belarus;156;6;67002;530
2020-07-26;BY;Belarus;130;4;67132;534
2020-07-27;BY;Belarus;119;4;67251;538
2020-07-28;BY;Belarus;115;5;67366;543
2020-07-29;BY;Belarus;152;5;67518;548
2020-07-30;BY;Belarus;147;5;67665;553
2020-07-31;BY;Belarus;143;6;67808;559
2020-08-01;BY;Belarus;138;4;67946;563
2020-08-02;BY;Belarus;121;4;68067;567
2020-08-03;BY;Belarus;99;4;68166;571
2020-08-04;BY;Belarus;84;3;68250;574
2020-08-05;BY;Belarus;126;3;68376;577
2020-08-06;BY;Belarus;127;3;68503;580
2020-08-07;BY;Belarus;111;3;68614;583
2020-08-08;BY;Belarus;124;2;68738;585
2020-08-09;BY;Belarus;112;2;68850;587
2020-08-10;BY;Belarus;97;2;68947;589
2020-08-11;BY;Belarus;58;3;69005;592
2020-08-12;BY;Belarus;97;3;69102;595
2020-08-13;BY;Belarus;101;4;69203;599
2020-08-14;BY;Belarus;105;4;69308;603
2020-08-15;BY;Belarus;0;0;69308;603
2020-08-16;BY;Belarus;208;7;69516;610
2020-08-17;BY;Belarus;73;3;69589;613
2020-08-18;BY;Belarus;84;4;69673;617
2020-08-19;BY;Belarus;128;5;69801;622
2020-08-20;BY;Belarus;149;5;69950;627
2020-08-21;BY;Belarus;161;5;70111;632
2020-08-22;BY;Belarus;174;5;70285;637
2020-08-23;BY;Belarus;183;5;70468;642
2020-08-24;BY;Belarus;177;4;70645;646
2020-08-25;BY;Belarus;82;6;70727;652
2020-08-26;BY;Belarus;247;5;70974;657
2020-08-27;BY;Belarus;191;5;71165;662
2020-08-28;BY;Belarus;181;5;71346;667
2020-08-29;BY;Belarus;177;4;71523;671
2020-08-30;BY;Belarus;164;5;71687;676
2020-08-31;BY;Belarus;156;5;71843;681
2020-09-01;BY;Belarus;119;5;71962;686
2020-09-02;BY;Belarus;179;5;72141;691
2020-09-03;BY;Belarus;161;5;72302;696
2020-09-04;BY;Belarus;183;5;72485;701
2020-09-05;BY;Belarus;178;4;72663;705
2020-09-06;BY;Belarus;196;6;72859;711
2020-09-07;BY;Belarus;172;5;73031;716
2020-09-08;BY;Belarus;177;5;73208;721
2020-09-09;BY;Belarus;194;5;73402;726
2020-09-10;BY;Belarus;189;6;73591;732
2020-09-11;BY;Belarus;193;6;73784;738
2020-09-12;BY;Belarus;191;6;73975;744
2020-09-13;BY;Belarus;198;6;74173;750
2020-09-14;BY;Belarus;187;6;74360;756
2020-09-15;BY;Belarus;192;5;74552;761
2020-09-16;BY;Belarus;211;6;74763;767
2020-09-17;BY;Belarus;224;4;74987;771
2020-09-18;BY;Belarus;243;2;75230;773
2020-09-19;BY;Belarus;231;3;75461;776
2020-09-20;BY;Belarus;213;4;75674;780
2020-09-21;BY;Belarus;224;5;75898;785
2020-09-22;BY;Belarus;206;6;76104;791
2020-09-23;BY;Belarus;253;5;76357;796
2020-09-24;BY;Belarus;294;6;76651;802
2020-09-25;BY;Belarus;306;5;76957;807
2020-09-26;BY;Belarus;332;6;77289;813
2020-09-27;BY;Belarus;320;5;77609;818
2020-09-28;BY;Belarus;337;4;77946;822
2020-09-29;BY;Belarus;314;6;78260;828
2020-09-30;BY;Belarus;371;5;78631;833
2020-10-01;BY;Belarus;388;6;79019;839
2020-10-02;BY;Belarus;402;5;79421;844
2020-10-03;BY;Belarus;431;7;79852;851
2020-10-04;BY;Belarus;0;0;79852;851
2020-10-05;BY;Belarus;844;11;80696;862
2020-10-06;BY;Belarus;394;6;81090;868
2020-10-07;BY;Belarus;415;6;81505;874
2020-10-08;BY;Belarus;477;6;81982;880
2020-10-09;BY;Belarus;489;5;82471;885
2020-10-10;BY;Belarus;0;0;82471;885
2020-10-11;BY;Belarus;1063;11;83534;896
2020-10-12;BY;Belarus;464;5;83998;901
2020-10-13;BY;Belarus;526;5;84524;906
2020-10-14;BY;Belarus;597;5;85121;911
2020-10-15;BY;Belarus;613;5;85734;916
2020-10-16;BY;Belarus;658;5;86392;921
2020-10-17;BY;Belarus;671;4;87063;925
2020-10-18;BY;Belarus;635;4;87698;929
2020-10-19;BY;Belarus;592;4;88290;933
2020-10-20;BY;Belarus;619;4;88909;937
2020-10-21;BY;Belarus;733;4;89642;941
2020-10-22;BY;Belarus;738;4;90380;945
2020-10-23;BY;Belarus;787;0;91167;945
2020-10-24;BY;Belarus;811;8;91978;953
2020-10-25;BY;Belarus;845;4;92823;957
2020-10-26;BY;Belarus;884;4;93707;961
2020-10-27;BY;Belarus;902;4;94609;965
2020-10-28;BY;Belarus;936;4;95545;969
2020-10-29;BY;Belarus;984;4;96529;973
2020-10-30;BY;Belarus;970;4;97499;977
2020-10-31;BY;Belarus;983;3;98482;980
2020-11-01;BY;Belarus;977;5;99459;985
2020-11-02;BY;Belarus;941;4;100400;989
2020-11-03;BY;Belarus;929;3;101329;992
2020-11-04;BY;Belarus;984;3;102313;995
2020-11-05;BY;Belarus;982;3;103295;998
2020-11-06;BY;Belarus;991;3;104286;1001
2020-11-07;BY;Belarus;997;3;105283;1004
2020-11-08;BY;Belarus;996;3;106279;1007
2020-11-09;BY;Belarus;983;4;107262;1011
2020-11-10;BY;Belarus;1038;5;108300;1016
2020-11-11;BY;Belarus;1057;6;109357;1022
2020-11-12;BY;Belarus;1098;5;110455;1027
2020-11-13;BY;Belarus;1167;6;111622;1033
2020-11-14;BY;Belarus;1248;6;112870;1039
2020-11-15;BY;Belarus;1315;7;114185;1046
2020-11-16;BY;Belarus;1263;7;115448;1053
2020-11-17;BY;Belarus;1251;7;116699;1060
2020-11-18;BY;Belarus;1309;7;118008;1067
2020-11-19;BY;Belarus;1382;7;119390;1074
2020-11-20;BY;Belarus;1457;7;120847;1081
2020-11-21;BY;Belarus;1588;8;122435;1089
2020-11-22;BY;Belarus;1564;7;123999;1096
2020-11-23;BY;Belarus;1483;8;125482;1104
2020-11-24;BY;Belarus;1471;8;126953;1112
2020-11-25;BY;Belarus;1496;7;128449;1119
2020-11-26;BY;Belarus;1563;9;130012;1128
2020-11-27;BY;Belarus;1621;8;131633;1136
2020-11-28;BY;Belarus;1691;7;133324;1143
2020-11-29;BY;Belarus;1684;8;135008;1151
2020-11-30;BY;Belarus;1639;7;136647;1158
2020-12-01;BY;Belarus;1572;8;138219;1166
2020-12-02;BY;Belarus;1689;8;139908;1174
2020-12-03;BY;Belarus;1701;7;141609;1181
2020-12-04;BY;Belarus;1774;9;143383;1190
2020-12-05;BY;Belarus;1896;8;145279;1198
2020-12-06;BY;Belarus;1878;9;147157;1207
2020-12-07;BY;Belarus;1796;8;148953;1215
2020-12-08;BY;Belarus;1649;7;150602;1222
2020-12-09;BY;Belarus;1851;8;152453;1230
2020-12-10;BY;Belarus;1939;8;154392;1238
2020-12-11;BY;Belarus;1967;8;156359;1246
2020-12-12;BY;Belarus;1975;8;158334;1254
2020-12-13;BY;Belarus;1961;9;160295;1263
2020-12-14;BY;Belarus;1853;10;162148;1273
2020-12-15;BY;Belarus;1911;9;164059;1282
2020-12-16;BY;Belarus;1838;9;165897;1291
2020-12-17;BY;Belarus;1834;8;167731;1299
2020-12-18;BY;Belarus;1917;9;169648;1308
2020-12-19;BY;Belarus;1931;8;171579;1316
2020-12-20;BY;Belarus;1944;8;173523;1324
2020-12-21;BY;Belarus;1893;9;175416;1333
2020-12-22;BY;Belarus;1858;8;177274;1341
2020-12-23;BY;Belarus;1922;8;179196;1349
2020-12-24;BY;Belarus;1917;9;181113;1358
2020-12-25;BY;Belarus;1893;9;183006;1367
2020-12-26;BY;Belarus;1916;9;184922;1376
2020-12-27;BY;Belarus;1825;9;186747;1385
2020-12-28;BY;Belarus;1841;9;188588;1394
2020-12-29;BY;Belarus;1816;10;190404;1404
2020-12-30;BY;Belarus;1957;10;192361;1414
2020-12-31;BY;Belarus;1923;10;194284;1424
2021-01-01;BY;Belarus;1939;9;196223;1433
2021-01-02;BY;Belarus;1902;9;198125;1442
2021-01-03;BY;Belarus;1837;9;199962;1451
2021-01-04;BY;Belarus;1869;10;201831;1461
2021-01-05;BY;Belarus;1273;10;203104;1471
2021-01-06;BY;Belarus;1854;9;204958;1480
2021-01-07;BY;Belarus;1838;9;206796;1489
2021-01-08;BY;Belarus;1805;9;208601;1498
2021-01-09;BY;Belarus;1767;9;210368;1507
2021-01-10;BY;Belarus;1833;10;212201;1517
2021-01-11;BY;Belarus;1792;9;213993;1526
2021-01-12;BY;Belarus;1731;9;215724;1535
2021-01-13;BY;Belarus;1972;9;217696;1544
2021-01-14;BY;Belarus;1967;10;219663;1554
2021-01-15;BY;Belarus;1941;10;221604;1564
2021-01-16;BY;Belarus;1933;9;223537;1573
2021-01-17;BY;Belarus;1924;9;225461;1582
2021-01-18;BY;Belarus;1899;9;227360;1591
2021-01-19;BY;Belarus;1356;10;228716;1601
2021-01-20;BY;Belarus;1778;9;230494;1610
2021-01-21;BY;Belarus;1804;9;232298;1619
2021-01-22;BY;Belarus;1813;9;234111;1628
2021-01-23;BY;Belarus;1748;11;235859;1639
2021-01-24;BY;Belarus;1752;10;237611;1649
2021-01-25;BY;Belarus;1024;9;238635;1658
2021-01-26;BY;Belarus;847;10;239482;1668
2021-01-27;BY;Belarus;1651;10;241133;1678
2021-01-28;BY;Belarus;1718;10;242851;1688
2021-01-29;BY;Belarus;1867;10;244718;1698
2021-01-30;BY;Belarus;1852;10;246570;1708
2021-01-31;BY;Belarus;1766;10;248336;1718
2021-02-01;BY;Belarus;959;10;249295;1728
2021-02-02;BY;Belarus;699;9;249994;1737
2021-02-03;BY;Belarus;1711;9;251705;1746
2021-02-04;BY;Belarus;1708;9;253413;1755
2021-02-05;BY;Belarus;1759;9;255172;1764
2021-02-06;BY;Belarus;1787;9;256959;1773
2021-02-07;BY;Belarus;1732;10;258691;1783
2021-02-08;BY;Belarus;808;9;259499;1792
2021-02-09;BY;Belarus;561;9;260060;1801
2021-02-10;BY;Belarus;1799;10;261859;1811
2021-02-11;BY;Belarus;1692;9;263551;1820
2021-02-12;BY;Belarus;1733;10;265284;1830
2021-02-13;BY;Belarus;1745;10;267029;1840
2021-02-14;BY;Belarus;1658;9;268687;1849
2021-02-15;BY;Belarus;1100;9;269787;1858
2021-02-16;BY;Belarus;1134;9;270921;1867
2021-02-17;BY;Belarus;1352;9;272273;1876
2021-02-18;BY;Belarus;1386;9;273659;1885
2021-02-19;BY;Belarus;1663;9;275322;1894
2021-02-20;BY;Belarus;1668;9;276990;1903
2021-02-21;BY;Belarus;1322;9;278312;1912
2021-02-22;BY;Belarus;1144;9;279456;1921
2021-02-23;BY;Belarus;972;9;280428;1930
2021-02-24;BY;Belarus;1279;9;281707;1939
2021-02-25;BY;Belarus;1191;9;282898;1948
2021-02-26;BY;Belarus;1602;9;284500;1957
2021-02-27;BY;Belarus;1459;9;285959;1966
2021-02-28;BY;Belarus;1347;10;287306;1976
2021-03-01;BY;Belarus;961;9;288267;1985
2021-03-02;BY;Belarus;869;8;289136;1993
2021-03-03;BY;Belarus;1311;9;290447;2002
2021-03-04;BY;Belarus;1174;9;291621;2011
2021-03-05;BY;Belarus;1482;9;293103;2020
2021-03-06;BY;Belarus;1329;9;294432;2029
2021-03-07;BY;Belarus;1079;9;295511;2038
2021-03-08;BY;Belarus;930;9;296441;2047
2021-03-09;BY;Belarus;1073;8;297514;2055
2021-03-10;BY;Belarus;609;8;298123;2063
2021-03-11;BY;Belarus;837;7;298960;2070
2021-03-12;BY;Belarus;1186;8;300146;2078
2021-03-13;BY;Belarus;1182;9;301328;2087
2021-03-14;BY;Belarus;995;8;302323;2095
2021-03-15;BY;Belarus;947;8;303270;2103
2021-03-16;BY;Belarus;876;9;304146;2112
2021-03-17;BY;Belarus;1124;9;305270;2121
2021-03-18;BY;Belarus;1254;9;306524;2130
2021-03-19;BY;Belarus;1414;9;307938;2139
2021-03-20;BY;Belarus;1355;9;309293;2148
2021-03-21;BY;Belarus;1152;9;310445;2157
2021-03-22;BY;Belarus;983;9;311428;2166
2021-03-23;BY;Belarus;1046;9;312474;2175
2021-03-24;BY;Belarus;1378;9;313852;2184
2021-03-25;BY;Belarus;1141;9;314993;2193
2021-03-26;BY;Belarus;1425;9;316418;2202
2021-03-27;BY;Belarus;1213;9;317631;2211
2021-03-28;BY;Belarus;1050;8;318681;2219
2021-03-29;BY;Belarus;918;8;319599;2227
2021-03-30;BY;Belarus;995;10;320594;2237
2021-03-31;BY;Belarus;1213;10;321807;2247
2021-04-01;BY;Belarus;1236;10;323043;2257
2021-04-02;BY;Belarus;1651;10;324694;2267
2021-04-03;BY;Belarus;1371;9;326065;2276
2021-04-04;BY;Belarus;1239;9;327304;2285
2021-04-05;BY;Belarus;986;9;328290;2294
2021-04-06;BY;Belarus;968;10;329258;2304
2021-04-07;BY;Belarus;1278;10;330536;2314
2021-04-08;BY;Belarus;1272;10;331808;2324
2021-04-09;BY;Belarus;1622;10;333430;2334
2021-04-10;BY;Belarus;1433;10;334863;2344
2021-04-11;BY;Belarus;1175;10;336038;2354
2021-04-12;BY;Belarus;843;9;336881;2363
2021-04-13;BY;Belarus;754;10;337635;2373
2021-04-14;BY;Belarus;1166;10;338801;2383
2021-04-15;BY;Belarus;1222;10;340023;2393
2021-04-16;BY;Belarus;1516;10;341539;2403
2021-04-17;BY;Belarus;1384;10;342923;2413
2021-04-18;BY;Belarus;1300;10;344223;2423
2021-04-19;BY;Belarus;887;10;345110;2433
2021-04-20;BY;Belarus;888;10;345998;2443
2021-04-21;BY;Belarus;1318;10;347316;2453
2021-04-22;BY;Belarus;1170;10;348486;2463
2021-04-23;BY;Belarus;1735;10;350221;2473
2021-04-24;BY;Belarus;1453;10;351674;2483
2021-04-25;BY;Belarus;1276;10;352950;2493
2021-04-26;BY;Belarus;896;9;353846;2502
2021-04-27;BY;Belarus;823;10;354669;2512
2021-04-28;BY;Belarus;1255;10;355924;2522
2021-04-29;BY;Belarus;1309;10;357233;2532
2021-04-30;BY;Belarus;1505;10;358738;2542
2021-05-01;BY;Belarus;1244;10;359982;2552
2021-05-02;BY;Belarus;1081;10;361063;2562
2021-05-03;BY;Belarus;834;10;361897;2572
2021-05-04;BY;Belarus;697;10;362594;2582
2021-05-05;BY;Belarus;1138;10;363732;2592
2021-05-06;BY;Belarus;1219;10;364951;2602
2021-05-07;BY;Belarus;1354;10;366305;2612
2021-05-08;BY;Belarus;1369;10;367674;2622
2021-05-09;BY;Belarus;1214;10;368888;2632
2021-05-10;BY;Belarus;879;10;369767;2642
2021-05-11;BY;Belarus;742;10;370509;2652
2021-05-12;BY;Belarus;896;9;371405;2661
2021-05-13;BY;Belarus;837;10;372242;2671
2021-05-14;BY;Belarus;1109;10;373351;2681
2021-05-15;BY;Belarus;1363;10;374714;2691
2021-05-16;BY;Belarus;1627;10;376341;2701
2021-05-17;BY;Belarus;1191;10;377532;2711
2021-05-18;BY;Belarus;1179;10;378711;2721
2021-05-19;BY;Belarus;1378;11;380089;2732
2021-05-20;BY;Belarus;1457;10;381546;2742
2021-05-21;BY;Belarus;1756;10;383302;2752
2021-05-22;BY;Belarus;1471;9;384773;2761
2021-05-23;BY;Belarus;1252;10;386025;2771
2021-05-24;BY;Belarus;953;9;386978;2780
2021-05-25;BY;Belarus;840;11;387818;2791
2021-05-26;BY;Belarus;1169;10;388987;2801
2021-05-27;BY;Belarus;1216;10;390203;2811
2021-05-28;BY;Belarus;1434;10;391637;2821
2021-05-29;BY;Belarus;992;10;392629;2831
2021-05-30;BY;Belarus;1178;10;393807;2841
2021-05-31;BY;Belarus;632;10;394439;2851
2021-06-01;BY;Belarus;636;10;395075;2861
2021-06-02;BY;Belarus;915;10;395990;2871
2021-06-03;BY;Belarus;879;11;396869;2882
2021-06-04;BY;Belarus;1183;10;398052;2892
2021-06-05;BY;Belarus;857;8;398909;2900
2021-06-06;BY;Belarus;943;10;399852;2910
2021-06-07;BY;Belarus;570;9;400422;2919
2021-06-08;BY;Belarus;597;10;401019;2929
2021-06-09;BY;Belarus;834;10;401853;2939
2021-06-10;BY;Belarus;966;10;402819;2949
2021-06-11;BY;Belarus;1026;9;403845;2958
2021-06-12;BY;Belarus;895;11;404740;2969
2021-06-13;BY;Belarus;923;9;405663;2978
2021-06-14;BY;Belarus;697;9;406360;2987
2021-06-15;BY;Belarus;501;8;406861;2995
2021-06-16;BY;Belarus;887;11;407748;3006
2021-06-17;BY;Belarus;873;9;408621;3015
2021-06-18;BY;Belarus;764;10;409385;3025
2021-06-19;BY;Belarus;711;10;410096;3035
2021-06-20;BY;Belarus;582;9;410678;3044
2021-06-21;BY;Belarus;475;9;411153;3053
2021-06-22;BY;Belarus;398;10;411551;3063
2021-06-23;BY;Belarus;802;9;412353;3072
2021-06-24;BY;Belarus;786;10;413139;3082
2021-06-25;BY;Belarus;813;11;413952;3093
2021-06-26;BY;Belarus;778;10;414730;3103
2021-06-27;BY;Belarus;609;10;415339;3113
2021-06-28;BY;Belarus;441;9;415780;3122
2021-06-29;BY;Belarus;495;10;416275;3132
2021-06-30;BY;Belarus;914;11;417189;3143
2021-07-01;BY;Belarus;1023;10;418212;3153
2020-02-04;BE;Belgium;1;0;1;0
2020-02-05;BE;Belgium;0;0;1;0
2020-02-06;BE;Belgium;0;0;1;0
2020-02-07;BE;Belgium;0;0;1;0
2020-02-08;BE;Belgium;0;0;1;0
2020-02-09;BE;Belgium;0;0;1;0
2020-02-10;BE;Belgium;0;0;1;0
2020-02-11;BE;Belgium;0;0;1;0
2020-02-12;BE;Belgium;0;0;1;0
2020-02-13;BE;Belgium;0;0;1;0
2020-02-14;BE;Belgium;0;0;1;0
2020-02-15;BE;Belgium;0;0;1;0
2020-02-16;BE;Belgium;0;0;1;0
2020-02-17;BE;Belgium;0;0;1;0
2020-02-18;BE;Belgium;0;0;1;0
2020-02-19;BE;Belgium;0;0;1;0
2020-02-20;BE;Belgium;0;0;1;0
2020-02-21;BE;Belgium;0;0;1;0
2020-02-22;BE;Belgium;0;0;1;0
2020-02-23;BE;Belgium;0;0;1;0
2020-02-24;BE;Belgium;0;0;1;0
2020-02-25;BE;Belgium;0;0;1;0
2020-02-26;BE;Belgium;0;0;1;0
2020-02-27;BE;Belgium;0;0;1;0
2020-02-28;BE;Belgium;0;0;1;0
2020-02-29;BE;Belgium;0;0;1;0
2020-03-01;BE;Belgium;1;0;2;0
2020-03-02;BE;Belgium;6;0;8;0
2020-03-03;BE;Belgium;5;0;13;0
2020-03-04;BE;Belgium;10;0;23;0
2020-03-05;BE;Belgium;27;0;50;0
2020-03-06;BE;Belgium;59;0;109;0
2020-03-07;BE;Belgium;60;0;169;0
2020-03-08;BE;Belgium;31;0;200;0
2020-03-09;BE;Belgium;39;0;239;0
2020-03-10;BE;Belgium;28;0;267;0
2020-03-11;BE;Belgium;47;3;314;3
2020-03-12;BE;Belgium;0;0;314;3
2020-03-13;BE;Belgium;245;0;559;3
2020-03-14;BE;Belgium;130;1;689;4
2020-03-15;BE;Belgium;197;0;886;4
2020-03-16;BE;Belgium;172;1;1058;5
2020-03-17;BE;Belgium;185;5;1243;10
2020-03-18;BE;Belgium;243;4;1486;14
2020-03-19;BE;Belgium;309;7;1795;21
2020-03-20;BE;Belgium;462;16;2257;37
2020-03-21;BE;Belgium;558;30;2815;67
2020-03-22;BE;Belgium;586;8;3401;75
2020-03-23;BE;Belgium;342;13;3743;88
2020-03-24;BE;Belgium;526;34;4269;122
2020-03-25;BE;Belgium;668;56;4937;178
2020-03-26;BE;Belgium;1298;42;6235;220
2020-03-27;BE;Belgium;1049;69;7284;289
2020-03-28;BE;Belgium;1850;64;9134;353
2020-03-29;BE;Belgium;1702;78;10836;431
2020-03-30;BE;Belgium;1063;82;11899;513
2020-03-31;BE;Belgium;876;192;12775;705
2020-04-01;BE;Belgium;1189;123;13964;828
2020-04-02;BE;Belgium;1384;183;15348;1011
2020-04-03;BE;Belgium;1422;132;16770;1143
2020-04-04;BE;Belgium;1661;140;18431;1283
2020-04-05;BE;Belgium;1260;164;19691;1447
2020-04-06;BE;Belgium;1123;185;20814;1632
2020-04-07;BE;Belgium;1380;403;22194;2035
2020-04-08;BE;Belgium;1209;205;23403;2240
2020-04-09;BE;Belgium;1580;283;24983;2523
2020-04-10;BE;Belgium;1684;496;26667;3019
2020-04-11;BE;Belgium;1351;327;28018;3346
2020-04-12;BE;Belgium;1629;254;29647;3600
2020-04-13;BE;Belgium;942;303;30589;3903
2020-04-14;BE;Belgium;530;254;31119;4157
2020-04-15;BE;Belgium;2454;283;33573;4440
2020-04-16;BE;Belgium;1236;417;34809;4857
2020-04-17;BE;Belgium;1329;306;36138;5163
2020-04-18;BE;Belgium;1045;290;37183;5453
2020-04-19;BE;Belgium;1313;230;38496;5683
2020-04-20;BE;Belgium;1487;145;39983;5828
2020-04-21;BE;Belgium;973;170;40956;5998
2020-04-22;BE;Belgium;933;264;41889;6262
2020-04-23;BE;Belgium;908;228;42797;6490
2020-04-24;BE;Belgium;1496;189;44293;6679
2020-04-25;BE;Belgium;1032;238;45325;6917
2020-04-26;BE;Belgium;809;177;46134;7094
2020-04-27;BE;Belgium;553;113;46687;7207
2020-04-28;BE;Belgium;647;124;47334;7331
2020-04-29;BE;Belgium;525;170;47859;7501
2020-04-30;BE;Belgium;660;93;48519;7594
2020-05-01;BE;Belgium;513;109;49032;7703
2020-05-02;BE;Belgium;485;62;49517;7765
2020-05-03;BE;Belgium;389;79;49906;7844
2020-05-04;BE;Belgium;361;80;50267;7924
2020-05-05;BE;Belgium;242;92;50509;8016
2020-05-06;BE;Belgium;272;323;50781;8339
2020-05-07;BE;Belgium;639;76;51420;8415
2020-05-08;BE;Belgium;591;106;52011;8521
2020-05-09;BE;Belgium;585;60;52596;8581
2020-05-10;BE;Belgium;485;75;53081;8656
2020-05-11;BE;Belgium;368;51;53449;8707
2020-05-12;BE;Belgium;330;54;53779;8761
2020-05-13;BE;Belgium;202;82;53981;8843
2020-05-14;BE;Belgium;307;60;54288;8903
2020-05-15;BE;Belgium;356;56;54644;8959
2020-05-16;BE;Belgium;345;46;54989;9005
2020-05-17;BE;Belgium;291;47;55280;9052
2020-05-18;BE;Belgium;279;28;55559;9080
2020-05-19;BE;Belgium;232;28;55791;9108
2020-05-20;BE;Belgium;192;42;55983;9150
2020-05-21;BE;Belgium;252;36;56235;9186
2020-05-22;BE;Belgium;276;26;56511;9212
2020-05-23;BE;Belgium;299;25;56810;9237
2020-05-24;BE;Belgium;282;43;57092;9280
2020-05-25;BE;Belgium;250;32;57342;9312
2020-05-26;BE;Belgium;113;22;57455;9334
2020-05-27;BE;Belgium;137;30;57592;9364
2020-05-28;BE;Belgium;257;24;57849;9388
2020-05-29;BE;Belgium;212;42;58061;9430
2020-05-30;BE;Belgium;125;23;58186;9453
2020-05-31;BE;Belgium;195;14;58381;9467
2020-06-01;BE;Belgium;136;19;58517;9486
2020-06-02;BE;Belgium;98;19;58615;9505
2020-06-03;BE;Belgium;70;17;58685;9522
2020-06-04;BE;Belgium;82;26;58767;9548
2020-06-05;BE;Belgium;140;18;58907;9566
2020-06-06;BE;Belgium;165;14;59072;9580
2020-06-07;BE;Belgium;154;15;59226;9595
2020-06-08;BE;Belgium;122;11;59348;9606
2020-06-09;BE;Belgium;89;13;59437;9619
2020-06-10;BE;Belgium;132;10;59569;9629
2020-06-11;BE;Belgium;142;7;59711;9636
2020-06-12;BE;Belgium;108;10;59819;9646
2020-06-13;BE;Belgium;99;4;59918;9650
2020-06-14;BE;Belgium;111;5;60029;9655
2020-06-15;BE;Belgium;71;6;60100;9661
2020-06-16;BE;Belgium;55;2;60155;9663
2020-06-17;BE;Belgium;89;12;60244;9675
2020-06-18;BE;Belgium;104;8;60348;9683
2020-06-19;BE;Belgium;128;12;60476;9695
2020-06-20;BE;Belgium;74;1;60550;9696
2020-06-21;BE;Belgium;0;0;60550;9696
2020-06-22;BE;Belgium;0;0;60550;9696
2020-06-23;BE;Belgium;260;17;60810;9713
2020-06-24;BE;Belgium;88;9;60898;9722
2020-06-25;BE;Belgium;109;4;61007;9726
2020-06-26;BE;Belgium;99;5;61106;9731
2020-06-27;BE;Belgium;103;1;61209;9732
2020-06-28;BE;Belgium;86;0;61295;9732
2020-06-29;BE;Belgium;66;0;61361;9732
2020-06-30;BE;Belgium;66;15;61427;9747
2020-07-01;BE;Belgium;82;7;61509;9754
2020-07-02;BE;Belgium;89;7;61598;9761
2020-07-03;BE;Belgium;129;4;61727;9765
2020-07-04;BE;Belgium;111;6;61838;9771
2020-07-05;BE;Belgium;178;0;62016;9771
2020-07-06;BE;Belgium;42;3;62058;9774
2020-07-07;BE;Belgium;0;0;62058;9774
2020-07-08;BE;Belgium;65;2;62123;9776
2020-07-09;BE;Belgium;87;2;62210;9778
2020-07-10;BE;Belgium;147;3;62357;9781
2020-07-11;BE;Belgium;112;1;62469;9782
2020-07-12;BE;Belgium;238;0;62707;9782
2020-07-13;BE;Belgium;0;0;62707;9782
2020-07-14;BE;Belgium;74;5;62781;9787
2020-07-15;BE;Belgium;91;1;62872;9788
2020-07-16;BE;Belgium;366;7;63238;9795
2020-07-17;BE;Belgium;261;5;63499;9800
2020-07-18;BE;Belgium;207;0;63706;9800
2020-07-19;BE;Belgium;0;0;63706;9800
2020-07-20;BE;Belgium;388;5;64094;9805
2020-07-21;BE;Belgium;164;0;64258;9805
2020-07-22;BE;Belgium;369;3;64627;9808
2020-07-23;BE;Belgium;220;4;64847;9812
2020-07-24;BE;Belgium;352;5;65199;9817
2020-07-25;BE;Belgium;528;4;65727;9821
2020-07-26;BE;Belgium;299;0;66026;9821
2020-07-27;BE;Belgium;402;1;66428;9822
2020-07-28;BE;Belgium;234;11;66662;9833
2020-07-29;BE;Belgium;673;3;67335;9836
2020-07-30;BE;Belgium;671;4;68006;9840
2020-07-31;BE;Belgium;745;1;68751;9841
2020-08-01;BE;Belgium;651;4;69402;9845
2020-08-02;BE;Belgium;447;0;69849;9845
2020-08-03;BE;Belgium;465;5;70314;9850
2020-08-04;BE;Belgium;334;2;70648;9852
2020-08-05;BE;Belgium;510;7;71158;9859
2020-08-06;BE;Belgium;858;2;72016;9861
2020-08-07;BE;Belgium;768;5;72784;9866
2020-08-08;BE;Belgium;617;4;73401;9870
2020-08-09;BE;Belgium;751;2;74152;9872
2020-08-10;BE;Belgium;468;7;74620;9879
2020-08-11;BE;Belgium;388;6;75008;9885
2020-08-12;BE;Belgium;639;15;75647;9900
2020-08-13;BE;Belgium;544;16;76191;9916
2020-08-14;BE;Belgium;922;8;77113;9924
2020-08-15;BE;Belgium;756;11;77869;9935
2020-08-16;BE;Belgium;454;4;78323;9939
2020-08-17;BE;Belgium;211;5;78534;9944
2020-08-18;BE;Belgium;363;15;78897;9959
2020-08-19;BE;Belgium;582;10;79479;9969
2020-08-20;BE;Belgium;699;7;80178;9976
2020-08-21;BE;Belgium;716;9;80894;9985
2020-08-22;BE;Belgium;574;3;81468;9988
2020-08-23;BE;Belgium;468;4;81936;9992
2020-08-24;BE;Belgium;156;4;82092;9996
2020-08-25;BE;Belgium;355;0;82447;9996
2020-08-26;BE;Belgium;583;-117;83030;9879
2020-08-27;BE;Belgium;470;5;83500;9884
2020-08-28;BE;Belgium;452;2;83952;9886
2020-08-29;BE;Belgium;647;5;84599;9891
2020-08-30;BE;Belgium;443;3;85042;9894
2020-08-31;BE;Belgium;194;1;85236;9895
2020-09-01;BE;Belgium;251;2;85487;9897
2020-09-02;BE;Belgium;424;1;85911;9898
2020-09-03;BE;Belgium;633;1;86544;9899
2020-09-04;BE;Belgium;630;2;87174;9901
2020-09-05;BE;Belgium;651;5;87825;9906
2020-09-06;BE;Belgium;542;1;88367;9907
2020-09-07;BE;Belgium;402;2;88769;9909
2020-09-08;BE;Belgium;372;3;89141;9912
2020-09-09;BE;Belgium;550;5;89691;9917
2020-09-10;BE;Belgium;877;0;90568;9917
2020-09-11;BE;Belgium;969;2;91537;9919
2020-09-12;BE;Belgium;941;4;92478;9923
2020-09-13;BE;Belgium;977;2;93455;9925
2020-09-14;BE;Belgium;851;2;94306;9927
2020-09-15;BE;Belgium;489;3;94795;9930
2020-09-16;BE;Belgium;1153;5;95948;9935
2020-09-17;BE;Belgium;2028;1;97976;9936
2020-09-18;BE;Belgium;1673;1;99649;9937
2020-09-19;BE;Belgium;1099;7;100748;9944
2020-09-20;BE;Belgium;1547;4;102295;9948
2020-09-21;BE;Belgium;1097;2;103392;9950
2020-09-22;BE;Belgium;1834;5;105226;9955
2020-09-23;BE;Belgium;1661;4;106887;9959
2020-09-24;BE;Belgium;1881;6;108768;9965
2020-09-25;BE;Belgium;2208;4;110976;9969
2020-09-26;BE;Belgium;1827;5;112803;9974
2020-09-27;BE;Belgium;1376;6;114179;9980
2020-09-28;BE;Belgium;1174;7;115353;9987
2020-09-29;BE;Belgium;1762;14;117115;10001
2020-09-30;BE;Belgium;1337;15;118452;10016
2020-10-01;BE;Belgium;2607;7;121059;10023
2020-10-02;BE;Belgium;3175;14;124234;10037
2020-10-03;BE;Belgium;3389;7;127623;10044
2020-10-04;BE;Belgium;2612;20;130235;10064
2020-10-05;BE;Belgium;1968;14;132203;10078
2020-10-06;BE;Belgium;2088;14;134291;10092
2020-10-07;BE;Belgium;3577;16;137868;10108
2020-10-08;BE;Belgium;5728;18;143596;10126
2020-10-09;BE;Belgium;5385;25;148981;10151
2020-10-10;BE;Belgium;7950;24;156931;10175
2020-10-11;BE;Belgium;5327;16;162258;10191
2020-10-12;BE;Belgium;3622;20;165880;10211
2020-10-13;BE;Belgium;7360;33;173240;10244
2020-10-14;BE;Belgium;8271;34;181511;10278
2020-10-15;BE;Belgium;10448;49;191959;10327
2020-10-16;BE;Belgium;10192;32;202151;10359
2020-10-17;BE;Belgium;10964;33;213115;10392
2020-10-18;BE;Belgium;9138;21;222253;10413
2020-10-19;BE;Belgium;8227;30;230480;10443
2020-10-20;BE;Belgium;9679;46;240159;10489
2020-10-21;BE;Belgium;13227;50;253386;10539
2020-10-22;BE;Belgium;16746;49;270132;10588
2020-10-23;BE;Belgium;17568;70;287700;10658
2020-10-24;BE;Belgium;17709;79;305409;10737
2020-10-25;BE;Belgium;15622;73;321031;10810
2020-10-26;BE;Belgium;12687;89;333718;10899
2020-10-27;BE;Belgium;13571;139;347289;11038
2020-10-28;BE;Belgium;21048;132;368337;11170
2020-10-29;BE;Belgium;23921;138;392258;11308
2020-10-30;BE;Belgium;20056;144;412314;11452
2020-10-31;BE;Belgium;16915;173;429229;11625
2020-11-01;BE;Belgium;11789;112;441018;11737
2020-11-02;BE;Belgium;6337;121;447355;11858
2020-11-03;BE;Belgium;5186;268;452541;12126
2020-11-04;BE;Belgium;15672;205;468213;12331
2020-11-05;BE;Belgium;11128;189;479341;12520
2020-11-06;BE;Belgium;8703;188;488044;12708
2020-11-07;BE;Belgium;6124;199;494168;12907
2020-11-08;BE;Belgium;6621;148;500789;13055
2020-11-09;BE;Belgium;2393;161;503182;13216
2020-11-10;BE;Belgium;4293;345;507475;13561
2020-11-11;BE;Belgium;7916;197;515391;13758
2020-11-12;BE;Belgium;5002;133;520393;13891
2020-11-13;BE;Belgium;4619;215;525012;14106
2020-11-14;BE;Belgium;6268;197;531280;14303
2020-11-15;BE;Belgium;4659;118;535939;14421
2020-11-16;BE;Belgium;1932;195;537871;14616
2020-11-17;BE;Belgium;2734;223;540605;14839
2020-11-18;BE;Belgium;5182;186;545787;15025
2020-11-19;BE;Belgium;4477;171;550264;15196
2020-11-20;BE;Belgium;3416;156;553680;15352
2020-11-21;BE;Belgium;3224;170;556904;15522
2020-11-22;BE;Belgium;1875;96;558779;15618
2020-11-23;BE;Belgium;1123;137;559902;15755
2020-11-24;BE;Belgium;1901;183;561803;15938
2020-11-25;BE;Belgium;3164;139;564967;16077
2020-11-26;BE;Belgium;2565;142;567532;16219
2020-11-27;BE;Belgium;3297;120;570829;16339
2020-11-28;BE;Belgium;3619;122;574448;16461
2020-11-29;BE;Belgium;2151;86;576599;16547
2020-11-30;BE;Belgium;746;98;577345;16645
2020-12-01;BE;Belgium;1867;141;579212;16786
2020-12-02;BE;Belgium;3040;125;582252;16911
2020-12-03;BE;Belgium;2605;122;584857;17033
2020-12-04;BE;Belgium;2582;109;587439;17142
2020-12-05;BE;Belgium;2503;112;589942;17254
2020-12-06;BE;Belgium;1814;66;591756;17320
2020-12-07;BE;Belgium;859;66;592615;17386
2020-12-08;BE;Belgium;1957;121;594572;17507
2020-12-09;BE;Belgium;3071;96;597643;17603
2020-12-10;BE;Belgium;2754;89;600397;17692
2020-12-11;BE;Belgium;0;0;600397;17692
2020-12-12;BE;Belgium;2762;100;603159;17792
2020-12-13;BE;Belgium;4978;159;608137;17951
2020-12-14;BE;Belgium;1074;103;609211;18054
2020-12-15;BE;Belgium;2211;124;611422;18178
2020-12-16;BE;Belgium;3636;100;615058;18278
2020-12-17;BE;Belgium;3146;93;618204;18371
2020-12-18;BE;Belgium;2835;84;621039;18455
2020-12-19;BE;Belgium;2721;90;623760;18545
2020-12-20;BE;Belgium;2170;81;625930;18626
2020-12-21;BE;Belgium;981;71;626911;18697
2020-12-22;BE;Belgium;2198;124;629109;18821
2020-12-23;BE;Belgium;3212;118;632321;18939
2020-12-24;BE;Belgium;2583;99;634904;19038
2020-12-25;BE;Belgium;2342;51;637246;19089
2020-12-26;BE;Belgium;784;69;638030;19158
2020-12-27;BE;Belgium;847;42;638877;19200
2020-12-28;BE;Belgium;857;34;639734;19234
2020-12-29;BE;Belgium;1677;127;641411;19361
2020-12-30;BE;Belgium;2831;80;644242;19441
2020-12-31;BE;Belgium;2254;87;646496;19528
2021-01-01;BE;Belgium;1793;53;648289;19581
2021-01-02;BE;Belgium;880;63;649169;19644
2021-01-03;BE;Belgium;842;57;650011;19701
2021-01-04;BE;Belgium;876;49;650887;19750
2021-01-05;BE;Belgium;1848;77;652735;19827
2021-01-06;BE;Belgium;2997;56;655732;19883
2021-01-07;BE;Belgium;2923;53;658655;19936
2021-01-08;BE;Belgium;2048;56;660703;19992
2021-01-09;BE;Belgium;1991;46;662694;20038
2021-01-10;BE;Belgium;1569;40;664263;20078
2021-01-11;BE;Belgium;960;44;665223;20122
2021-01-12;BE;Belgium;2099;72;667322;20194
2021-01-13;BE;Belgium;2927;56;670249;20250
2021-01-14;BE;Belgium;2637;44;672886;20294
2021-01-15;BE;Belgium;2203;58;675089;20352
2021-01-16;BE;Belgium;2120;44;677209;20396
2021-01-17;BE;Belgium;1630;39;678839;20435
2021-01-18;BE;Belgium;932;37;679771;20472
2021-01-19;BE;Belgium;1479;82;681250;20554
2021-01-20;BE;Belgium;3006;18;684256;20572
2021-01-21;BE;Belgium;2571;48;686827;20620
2021-01-22;BE;Belgium;2444;55;689271;20675
2021-01-23;BE;Belgium;2583;51;691854;20726
2021-01-24;BE;Belgium;1812;53;693666;20779
2021-01-25;BE;Belgium;1192;35;694858;20814
2021-01-26;BE;Belgium;1784;65;696642;20879
2021-01-27;BE;Belgium;3020;54;699662;20933
2021-01-28;BE;Belgium;2775;49;702437;20982
2021-01-29;BE;Belgium;2683;36;705120;21018
2021-01-30;BE;Belgium;2717;48;707837;21066
2021-01-31;BE;Belgium;2316;26;710153;21092
2021-02-01;BE;Belgium;1264;32;711417;21124
2021-02-02;BE;Belgium;1854;49;713271;21173
2021-02-03;BE;Belgium;3124;43;716395;21216
2021-02-04;BE;Belgium;2452;44;718847;21260
2021-02-05;BE;Belgium;2585;35;721432;21295
2021-02-06;BE;Belgium;2438;57;723870;21352
2021-02-07;BE;Belgium;1740;37;725610;21389
2021-02-08;BE;Belgium;873;34;726483;21423
2021-02-09;BE;Belgium;1851;49;728334;21472
2021-02-10;BE;Belgium;2617;40;730951;21512
2021-02-11;BE;Belgium;2149;39;733100;21551
2021-02-12;BE;Belgium;2120;48;735220;21599
2021-02-13;BE;Belgium;1895;35;737115;21634
2021-02-14;BE;Belgium;1516;28;738631;21662
2021-02-15;BE;Belgium;857;40;739488;21702
2021-02-16;BE;Belgium;1717;48;741205;21750
2021-02-17;BE;Belgium;2677;43;743882;21793
2021-02-18;BE;Belgium;2420;28;746302;21821
2021-02-19;BE;Belgium;3437;38;749739;21859
2021-02-20;BE;Belgium;2640;28;752379;21887
2021-02-21;BE;Belgium;2094;16;754473;21903
2021-02-22;BE;Belgium;1121;20;755594;21923
2021-02-23;BE;Belgium;2102;33;757696;21956
2021-02-24;BE;Belgium;3113;32;760809;21988
2021-02-25;BE;Belgium;3076;18;763885;22006
2021-02-26;BE;Belgium;2769;28;766654;22034
2021-02-27;BE;Belgium;2760;18;769414;22052
2021-02-28;BE;Belgium;2097;25;771511;22077
2021-03-01;BE;Belgium;783;29;772294;22106
2021-03-02;BE;Belgium;2050;35;774344;22141
2021-03-03;BE;Belgium;3264;28;777608;22169
2021-03-04;BE;Belgium;2643;27;780251;22196
2021-03-05;BE;Belgium;2759;19;783010;22215
2021-03-06;BE;Belgium;2799;25;785809;22240
2021-03-07;BE;Belgium;2082;21;787891;22261
2021-03-08;BE;Belgium;1117;31;789008;22292
2021-03-09;BE;Belgium;2163;35;791171;22327
2021-03-10;BE;Belgium;3434;20;794605;22347
2021-03-11;BE;Belgium;3503;23;798108;22370
2021-03-12;BE;Belgium;3615;27;801723;22397
2021-03-13;BE;Belgium;3598;24;805321;22421
2021-03-14;BE;Belgium;2962;20;808283;22441
2021-03-15;BE;Belgium;1578;104;809861;22545
2021-03-16;BE;Belgium;3165;27;813026;22572
2021-03-17;BE;Belgium;5116;28;818142;22600
2021-03-18;BE;Belgium;4659;24;822801;22624
2021-03-19;BE;Belgium;5140;26;827941;22650
2021-03-20;BE;Belgium;0;0;827941;22650
2021-03-21;BE;Belgium;9065;57;837006;22707
2021-03-22;BE;Belgium;2232;21;839238;22728
2021-03-23;BE;Belgium;3537;35;842775;22763
2021-03-24;BE;Belgium;6315;23;849090;22786
2021-03-25;BE;Belgium;5518;30;854608;22816
2021-03-26;BE;Belgium;6123;36;860731;22852
2021-03-27;BE;Belgium;5332;18;866063;22870
2021-03-28;BE;Belgium;4694;27;870757;22897
2021-03-29;BE;Belgium;2179;24;872936;22921
2021-03-30;BE;Belgium;3906;45;876842;22966
2021-03-31;BE;Belgium;5611;50;882453;23016
2021-04-01;BE;Belgium;5467;29;887920;23045
2021-04-02;BE;Belgium;4665;38;892585;23083
2021-04-03;BE;Belgium;4889;47;897474;23130
2021-04-04;BE;Belgium;3522;39;900996;23169
2021-04-05;BE;Belgium;1968;33;902964;23202
2021-04-06;BE;Belgium;1709;45;904673;23247
2021-04-07;BE;Belgium;3539;54;908212;23301
2021-04-08;BE;Belgium;4845;47;913057;23348
2021-04-09;BE;Belgium;4860;42;917917;23390
2021-04-10;BE;Belgium;4570;38;922487;23428
2021-04-11;BE;Belgium;2989;45;925476;23473
2021-04-12;BE;Belgium;1753;30;927229;23503
2021-04-13;BE;Belgium;3374;63;930603;23566
2021-04-14;BE;Belgium;4713;37;935316;23603
2021-04-15;BE;Belgium;3993;33;939309;23636
2021-04-16;BE;Belgium;3904;45;943213;23681
2021-04-17;BE;Belgium;3787;37;947000;23718
2021-04-18;BE;Belgium;2996;29;949996;23747
2021-04-19;BE;Belgium;1630;35;951626;23782
2021-04-20;BE;Belgium;3430;52;955056;23834
2021-04-21;BE;Belgium;5113;33;960169;23867
2021-04-22;BE;Belgium;4357;42;964526;23909
2021-04-23;BE;Belgium;3581;45;968107;23954
2021-04-24;BE;Belgium;3934;36;972041;23990
2021-04-25;BE;Belgium;2377;34;974418;24024
2021-04-26;BE;Belgium;1670;41;976088;24065
2021-04-27;BE;Belgium;2946;39;979034;24104
2021-04-28;BE;Belgium;3925;36;982959;24140
2021-04-29;BE;Belgium;3663;45;986622;24185
2021-04-30;BE;Belgium;3607;45;990229;24230
2021-05-01;BE;Belgium;3205;28;993434;24258
2021-05-02;BE;Belgium;2128;33;995562;24291
2021-05-03;BE;Belgium;1334;31;996896;24322
2021-05-04;BE;Belgium;2731;45;999627;24367
2021-05-05;BE;Belgium;4119;39;1003746;24406
2021-05-06;BE;Belgium;3518;38;1007264;24444
2021-05-07;BE;Belgium;3723;39;1010987;24483
2021-05-08;BE;Belgium;3364;28;1014351;24511
2021-05-09;BE;Belgium;2258;40;1016609;24551
2021-05-10;BE;Belgium;1267;32;1017876;24583
2021-05-11;BE;Belgium;2456;26;1020332;24609
2021-05-12;BE;Belgium;3251;21;1023583;24630
2021-05-13;BE;Belgium;2890;15;1026473;24645
2021-05-14;BE;Belgium;1631;19;1028104;24664
2021-05-15;BE;Belgium;1967;22;1030071;24686
2021-05-16;BE;Belgium;1852;23;1031923;24709
2021-05-17;BE;Belgium;972;14;1032895;24723
2021-05-18;BE;Belgium;1819;26;1034714;24749
2021-05-19;BE;Belgium;3800;19;1038514;24768
2021-05-20;BE;Belgium;3192;26;1041706;24794
2021-05-21;BE;Belgium;2906;15;1044612;24809
2021-05-22;BE;Belgium;2516;14;1047128;24823
2021-05-23;BE;Belgium;1753;19;1048881;24842
2021-05-24;BE;Belgium;941;11;1049822;24853
2021-05-25;BE;Belgium;855;20;1050677;24873
2021-05-26;BE;Belgium;1975;16;1052652;24889
2021-05-27;BE;Belgium;2891;13;1055543;24902
2021-05-28;BE;Belgium;2360;8;1057903;24910
2021-05-29;BE;Belgium;1860;11;1059763;24921
2021-05-30;BE;Belgium;1437;19;1061200;24940
2021-05-31;BE;Belgium;801;15;1062001;24955
2021-06-01;BE;Belgium;1498;13;1063499;24968
2021-06-02;BE;Belgium;1859;14;1065358;24982
2021-06-03;BE;Belgium;1599;13;1066957;24995
2021-06-04;BE;Belgium;1449;19;1068406;25014
2021-06-05;BE;Belgium;1468;5;1069874;25019
2021-06-06;BE;Belgium;928;14;1070802;25033
2021-06-07;BE;Belgium;469;8;1071271;25041
2021-06-08;BE;Belgium;904;10;1072175;25051
2021-06-09;BE;Belgium;1183;10;1073358;25061
2021-06-10;BE;Belgium;846;7;1074204;25068
2021-06-11;BE;Belgium;784;7;1074988;25075
2021-06-12;BE;Belgium;777;6;1075765;25081
2021-06-13;BE;Belgium;573;7;1076338;25088
2021-06-14;BE;Belgium;241;5;1076579;25093
2021-06-15;BE;Belgium;508;6;1077087;25099
2021-06-16;BE;Belgium;671;11;1077758;25110
2021-06-17;BE;Belgium;493;7;1078251;25117
2021-06-18;BE;Belgium;0;0;1078251;25117
2021-06-19;BE;Belgium;833;15;1079084;25132
2021-06-20;BE;Belgium;331;4;1079415;25136
2021-06-21;BE;Belgium;225;5;1079640;25141
2021-06-22;BE;Belgium;395;3;1080035;25144
2021-06-23;BE;Belgium;1026;5;1081061;25149
2021-06-24;BE;Belgium;847;3;1081908;25152
2021-06-25;BE;Belgium;568;8;1082476;25160
2021-06-26;BE;Belgium;0;0;1082476;25160
2021-06-27;BE;Belgium;0;0;1082476;25160
2021-06-28;BE;Belgium;1002;8;1083478;25168
2021-06-29;BE;Belgium;1072;2;1084550;25170
2021-06-30;BE;Belgium;581;3;1085131;25173
2021-07-01;BE;Belgium;754;7;1085885;25180
2020-03-23;BZ;Belize;1;0;1;0
2020-03-24;BZ;Belize;0;0;1;0
2020-03-25;BZ;Belize;1;0;2;0
2020-03-26;BZ;Belize;0;0;2;0
2020-03-27;BZ;Belize;0;0;2;0
2020-03-28;BZ;Belize;0;0;2;0
2020-03-29;BZ;Belize;0;0;2;0
2020-03-30;BZ;Belize;1;0;3;0
2020-03-31;BZ;Belize;0;0;3;0
2020-04-01;BZ;Belize;0;0;3;0
2020-04-02;BZ;Belize;0;0;3;0
2020-04-03;BZ;Belize;1;0;4;0
2020-04-04;BZ;Belize;0;0;4;0
2020-04-05;BZ;Belize;1;0;5;0
2020-04-06;BZ;Belize;2;1;7;1
2020-04-07;BZ;Belize;0;0;7;1
2020-04-08;BZ;Belize;1;0;8;1
2020-04-09;BZ;Belize;1;0;9;1
2020-04-10;BZ;Belize;1;1;10;2
2020-04-11;BZ;Belize;3;0;13;2
2020-04-12;BZ;Belize;1;0;14;2
2020-04-13;BZ;Belize;4;0;18;2
2020-04-14;BZ;Belize;0;0;18;2
2020-04-15;BZ;Belize;0;0;18;2
2020-04-16;BZ;Belize;0;0;18;2
2020-04-17;BZ;Belize;0;0;18;2
2020-04-18;BZ;Belize;0;0;18;2
2020-04-19;BZ;Belize;0;0;18;2
2020-04-20;BZ;Belize;0;0;18;2
2020-04-21;BZ;Belize;0;0;18;2
2020-04-22;BZ;Belize;0;0;18;2
2020-04-23;BZ;Belize;0;0;18;2
2020-04-24;BZ;Belize;0;0;18;2
2020-04-25;BZ;Belize;0;0;18;2
2020-04-26;BZ;Belize;0;0;18;2
2020-04-27;BZ;Belize;0;0;18;2
2020-04-28;BZ;Belize;0;0;18;2
2020-04-29;BZ;Belize;0;0;18;2
2020-04-30;BZ;Belize;0;0;18;2
2020-05-01;BZ;Belize;0;0;18;2
2020-05-02;BZ;Belize;0;0;18;2
2020-05-03;BZ;Belize;0;0;18;2
2020-05-04;BZ;Belize;0;0;18;2
2020-05-05;BZ;Belize;0;0;18;2
2020-05-06;BZ;Belize;0;0;18;2
2020-05-07;BZ;Belize;0;0;18;2
2020-05-08;BZ;Belize;0;0;18;2
2020-05-09;BZ;Belize;0;0;18;2
2020-05-10;BZ;Belize;0;0;18;2
2020-05-11;BZ;Belize;0;0;18;2
2020-05-12;BZ;Belize;0;0;18;2
2020-05-13;BZ;Belize;0;0;18;2
2020-05-14;BZ;Belize;0;0;18;2
2020-05-15;BZ;Belize;0;0;18;2
2020-05-16;BZ;Belize;0;0;18;2
2020-05-17;BZ;Belize;0;0;18;2
2020-05-18;BZ;Belize;0;0;18;2
2020-05-19;BZ;Belize;0;0;18;2
2020-05-20;BZ;Belize;0;0;18;2
2020-05-21;BZ;Belize;0;0;18;2
2020-05-22;BZ;Belize;0;0;18;2
2020-05-23;BZ;Belize;0;0;18;2
2020-05-24;BZ;Belize;0;0;18;2
2020-05-25;BZ;Belize;0;0;18;2
2020-05-26;BZ;Belize;0;0;18;2
2020-05-27;BZ;Belize;0;0;18;2
2020-05-28;BZ;Belize;0;0;18;2
2020-05-29;BZ;Belize;0;0;18;2
2020-05-30;BZ;Belize;0;0;18;2
2020-05-31;BZ;Belize;0;0;18;2
2020-06-01;BZ;Belize;0;0;18;2
2020-06-02;BZ;Belize;0;0;18;2
2020-06-03;BZ;Belize;0;0;18;2
2020-06-04;BZ;Belize;0;0;18;2
2020-06-05;BZ;Belize;1;0;19;2
2020-06-06;BZ;Belize;0;0;19;2
2020-06-07;BZ;Belize;0;0;19;2
2020-06-08;BZ;Belize;0;0;19;2
2020-06-09;BZ;Belize;1;0;20;2
2020-06-10;BZ;Belize;0;0;20;2
2020-06-11;BZ;Belize;0;0;20;2
2020-06-12;BZ;Belize;0;0;20;2
2020-06-13;BZ;Belize;0;0;20;2
2020-06-14;BZ;Belize;0;0;20;2
2020-06-15;BZ;Belize;1;0;21;2
2020-06-16;BZ;Belize;1;0;22;2
2020-06-17;BZ;Belize;0;0;22;2
2020-06-18;BZ;Belize;0;0;22;2
2020-06-19;BZ;Belize;0;0;22;2
2020-06-20;BZ;Belize;0;0;22;2
2020-06-21;BZ;Belize;0;0;22;2
2020-06-22;BZ;Belize;1;0;23;2
2020-06-23;BZ;Belize;0;0;23;2
2020-06-24;BZ;Belize;0;0;23;2
2020-06-25;BZ;Belize;0;0;23;2
2020-06-26;BZ;Belize;1;0;24;2
2020-06-27;BZ;Belize;0;0;24;2
2020-06-28;BZ;Belize;0;0;24;2
2020-06-29;BZ;Belize;0;0;24;2
2020-06-30;BZ;Belize;0;0;24;2
2020-07-01;BZ;Belize;4;0;28;2
2020-07-02;BZ;Belize;0;0;28;2
2020-07-03;BZ;Belize;2;0;30;2
2020-07-04;BZ;Belize;0;0;30;2
2020-07-05;BZ;Belize;0;0;30;2
2020-07-06;BZ;Belize;0;0;30;2
2020-07-07;BZ;Belize;0;0;30;2
2020-07-08;BZ;Belize;0;0;30;2
2020-07-09;BZ;Belize;0;0;30;2
2020-07-10;BZ;Belize;7;0;37;2
2020-07-11;BZ;Belize;0;0;37;2
2020-07-12;BZ;Belize;0;0;37;2
2020-07-13;BZ;Belize;0;0;37;2
2020-07-14;BZ;Belize;2;0;39;2
2020-07-15;BZ;Belize;0;0;39;2
2020-07-16;BZ;Belize;1;0;40;2
2020-07-17;BZ;Belize;0;0;40;2
2020-07-18;BZ;Belize;0;0;40;2
2020-07-19;BZ;Belize;0;0;40;2
2020-07-20;BZ;Belize;0;0;40;2
2020-07-21;BZ;Belize;2;0;42;2
2020-07-22;BZ;Belize;1;0;43;2
2020-07-23;BZ;Belize;4;0;47;2
2020-07-24;BZ;Belize;1;0;48;2
2020-07-25;BZ;Belize;0;0;48;2
2020-07-26;BZ;Belize;0;0;48;2
2020-07-27;BZ;Belize;0;0;48;2
2020-07-28;BZ;Belize;0;0;48;2
2020-07-29;BZ;Belize;0;0;48;2
2020-07-30;BZ;Belize;0;0;48;2
2020-07-31;BZ;Belize;0;0;48;2
2020-08-01;BZ;Belize;8;0;56;2
2020-08-02;BZ;Belize;1;0;57;2
2020-08-03;BZ;Belize;0;0;57;2
2020-08-04;BZ;Belize;0;0;57;2
2020-08-05;BZ;Belize;29;0;86;2
2020-08-06;BZ;Belize;28;0;114;2
2020-08-07;BZ;Belize;0;0;114;2
2020-08-08;BZ;Belize;32;0;146;2
2020-08-09;BZ;Belize;7;0;153;2
2020-08-10;BZ;Belize;24;0;177;2
2020-08-11;BZ;Belize;0;0;177;2
2020-08-12;BZ;Belize;33;0;210;2
2020-08-13;BZ;Belize;86;0;296;2
2020-08-14;BZ;Belize;60;1;356;3
2020-08-15;BZ;Belize;32;0;388;3
2020-08-16;BZ;Belize;64;0;452;3
2020-08-17;BZ;Belize;23;1;475;4
2020-08-18;BZ;Belize;0;0;475;4
2020-08-19;BZ;Belize;78;0;553;4
2020-08-20;BZ;Belize;52;1;605;5
2020-08-21;BZ;Belize;43;0;648;5
2020-08-22;BZ;Belize;20;1;668;6
2020-08-23;BZ;Belize;18;0;686;6
2020-08-24;BZ;Belize;27;4;713;10
2020-08-25;BZ;Belize;17;0;730;10
2020-08-26;BZ;Belize;30;1;760;11
2020-08-27;BZ;Belize;58;1;818;12
2020-08-28;BZ;Belize;52;0;870;12
2020-08-29;BZ;Belize;94;1;964;13
2020-08-30;BZ;Belize;29;0;993;13
2020-08-31;BZ;Belize;14;0;1007;13
2020-09-01;BZ;Belize;43;0;1050;13
2020-09-02;BZ;Belize;51;0;1101;13
2020-09-03;BZ;Belize;0;0;1101;13
2020-09-04;BZ;Belize;51;2;1152;15
2020-09-05;BZ;Belize;42;0;1194;15
2020-09-06;BZ;Belize;0;0;1194;15
2020-09-07;BZ;Belize;113;1;1307;16
2020-09-08;BZ;Belize;54;0;1361;16
2020-09-09;BZ;Belize;4;2;1365;18
2020-09-10;BZ;Belize;0;0;1365;18
2020-09-11;BZ;Belize;70;1;1435;19
2020-09-12;BZ;Belize;23;0;1458;19
2020-09-13;BZ;Belize;22;0;1480;19
2020-09-14;BZ;Belize;21;0;1501;19
2020-09-15;BZ;Belize;27;0;1528;19
2020-09-16;BZ;Belize;8;0;1536;19
2020-09-17;BZ;Belize;31;0;1567;19
2020-09-18;BZ;Belize;23;1;1590;20
2020-09-19;BZ;Belize;16;0;1606;20
2020-09-20;BZ;Belize;21;1;1627;21
2020-09-21;BZ;Belize;8;0;1635;21
2020-09-22;BZ;Belize;0;0;1635;21
2020-09-23;BZ;Belize;71;1;1706;22
2020-09-24;BZ;Belize;0;0;1706;22
2020-09-25;BZ;Belize;102;1;1808;23
2020-09-26;BZ;Belize;17;1;1825;24
2020-09-27;BZ;Belize;0;0;1825;24
2020-09-28;BZ;Belize;66;0;1891;24
2020-09-29;BZ;Belize;0;0;1891;24
2020-09-30;BZ;Belize;101;3;1992;27
2020-10-01;BZ;Belize;0;0;1992;27
2020-10-02;BZ;Belize;88;1;2080;28
2020-10-03;BZ;Belize;0;0;2080;28
2020-10-04;BZ;Belize;51;1;2131;29
2020-10-05;BZ;Belize;65;1;2196;30
2020-10-06;BZ;Belize;47;4;2243;34
2020-10-07;BZ;Belize;67;0;2310;34
2020-10-08;BZ;Belize;63;0;2373;34
2020-10-09;BZ;Belize;54;1;2427;35
2020-10-10;BZ;Belize;0;0;2427;35
2020-10-11;BZ;Belize;104;2;2531;37
2020-10-12;BZ;Belize;38;0;2569;37
2020-10-13;BZ;Belize;16;2;2585;39
2020-10-14;BZ;Belize;34;1;2619;40
2020-10-15;BZ;Belize;63;1;2682;41
2020-10-16;BZ;Belize;46;2;2728;43
2020-10-17;BZ;Belize;47;0;2775;43
2020-10-18;BZ;Belize;38;1;2813;44
2020-10-19;BZ;Belize;20;1;2833;45
2020-10-20;BZ;Belize;53;0;2886;45
2020-10-21;BZ;Belize;51;1;2937;46
2020-10-22;BZ;Belize;58;0;2995;46
2020-10-23;BZ;Belize;55;0;3050;46
2020-10-24;BZ;Belize;56;2;3106;48
2020-10-25;BZ;Belize;39;2;3145;50
2020-10-26;BZ;Belize;0;0;3145;50
2020-10-27;BZ;Belize;55;1;3200;51
2020-10-28;BZ;Belize;61;1;3261;52
2020-10-29;BZ;Belize;0;0;3261;52
2020-10-30;BZ;Belize;201;6;3462;58
2020-10-31;BZ;Belize;25;1;3487;59
2020-11-01;BZ;Belize;90;0;3577;59
2020-11-02;BZ;Belize;47;0;3624;59
2020-11-03;BZ;Belize;166;2;3790;61
2020-11-04;BZ;Belize;115;3;3905;64
2020-11-05;BZ;Belize;72;2;3977;66
2020-11-06;BZ;Belize;39;1;4016;67
2020-11-07;BZ;Belize;60;1;4076;68
2020-11-08;BZ;Belize;100;2;4176;70
2020-11-09;BZ;Belize;54;1;4230;71
2020-11-10;BZ;Belize;184;2;4414;73
2020-11-11;BZ;Belize;106;2;4520;75
2020-11-12;BZ;Belize;76;0;4596;75
2020-11-13;BZ;Belize;119;10;4715;85
2020-11-14;BZ;Belize;68;3;4783;88
2020-11-15;BZ;Belize;78;2;4861;90
2020-11-16;BZ;Belize;22;4;4883;94
2020-11-17;BZ;Belize;37;2;4920;96
2020-11-18;BZ;Belize;38;4;4958;100
2020-11-19;BZ;Belize;60;2;5018;102
2020-11-20;BZ;Belize;38;5;5056;107
2020-11-21;BZ;Belize;54;5;5110;112
2020-11-22;BZ;Belize;73;4;5183;116
2020-11-23;BZ;Belize;66;4;5249;120
2020-11-24;BZ;Belize;86;5;5335;125
2020-11-25;BZ;Belize;88;4;5423;129
2020-11-26;BZ;Belize;92;2;5515;131
2020-11-27;BZ;Belize;72;10;5587;141
2020-11-28;BZ;Belize;60;3;5647;144
2020-11-29;BZ;Belize;96;3;5743;147
2020-11-30;BZ;Belize;111;1;5854;148
2020-12-01;BZ;Belize;0;0;5854;148
2020-12-02;BZ;Belize;0;0;5854;148
2020-12-03;BZ;Belize;1382;16;7236;164
2020-12-04;BZ;Belize;147;6;7383;170
2020-12-05;BZ;Belize;218;2;7601;172
2020-12-06;BZ;Belize;168;1;7769;173
2020-12-07;BZ;Belize;184;3;7953;176
2020-12-08;BZ;Belize;60;3;8013;179
2020-12-09;BZ;Belize;506;4;8519;183
2020-12-10;BZ;Belize;286;0;8805;183
2020-12-11;BZ;Belize;160;2;8965;185
2020-12-12;BZ;Belize;208;7;9173;192
2020-12-13;BZ;Belize;122;3;9295;195
2020-12-14;BZ;Belize;82;2;9377;197
2020-12-15;BZ;Belize;134;14;9511;211
2020-12-16;BZ;Belize;161;1;9672;212
2020-12-17;BZ;Belize;119;1;9791;213
2020-12-18;BZ;Belize;0;0;9791;213
2020-12-19;BZ;Belize;0;0;9791;213
2020-12-20;BZ;Belize;0;0;9791;213
2020-12-21;BZ;Belize;354;11;10145;224
2020-12-22;BZ;Belize;112;2;10257;226
2020-12-23;BZ;Belize;113;0;10370;226
2020-12-24;BZ;Belize;120;2;10490;228
2020-12-25;BZ;Belize;0;0;10490;228
2020-12-26;BZ;Belize;0;0;10490;228
2020-12-27;BZ;Belize;71;5;10561;233
2020-12-28;BZ;Belize;30;3;10591;236
2020-12-29;BZ;Belize;77;5;10668;241
2020-12-30;BZ;Belize;56;1;10724;242
2020-12-31;BZ;Belize;52;6;10776;248
2021-01-01;BZ;Belize;0;0;10776;248
2021-01-02;BZ;Belize;31;1;10807;249
2021-01-03;BZ;Belize;94;1;10901;250
2021-01-04;BZ;Belize;37;7;10938;257
2021-01-05;BZ;Belize;80;1;11018;258
2021-01-06;BZ;Belize;90;2;11108;260
2021-01-07;BZ;Belize;44;7;11152;267
2021-01-08;BZ;Belize;50;4;11202;271
2021-01-09;BZ;Belize;64;0;11266;271
2021-01-10;BZ;Belize;37;3;11303;274
2021-01-11;BZ;Belize;29;1;11332;275
2021-01-12;BZ;Belize;34;2;11366;277
2021-01-13;BZ;Belize;53;1;11419;278
2021-01-14;BZ;Belize;37;2;11456;280
2021-01-15;BZ;Belize;73;1;11529;281
2021-01-16;BZ;Belize;0;0;11529;281
2021-01-17;BZ;Belize;51;0;11580;281
2021-01-18;BZ;Belize;12;1;11592;282
2021-01-19;BZ;Belize;23;1;11615;283
2021-01-20;BZ;Belize;27;3;11642;286
2021-01-21;BZ;Belize;34;3;11676;289
2021-01-22;BZ;Belize;24;1;11700;290
2021-01-23;BZ;Belize;22;0;11722;290
2021-01-24;BZ;Belize;28;0;11750;290
2021-01-25;BZ;Belize;20;3;11770;293
2021-01-26;BZ;Belize;18;0;11788;293
2021-01-27;BZ;Belize;28;1;11816;294
2021-01-28;BZ;Belize;29;4;11845;298
2021-01-29;BZ;Belize;32;3;11877;301
2021-01-30;BZ;Belize;31;0;11908;301
2021-01-31;BZ;Belize;0;0;11908;301
2021-02-01;BZ;Belize;37;1;11945;302
2021-02-02;BZ;Belize;12;1;11957;303
2021-02-03;BZ;Belize;21;3;11978;306
2021-02-04;BZ;Belize;30;0;12008;306
2021-02-05;BZ;Belize;5;0;12013;306
2021-02-06;BZ;Belize;24;0;12037;306
2021-02-07;BZ;Belize;0;0;12037;306
2021-02-08;BZ;Belize;33;1;12070;307
2021-02-09;BZ;Belize;9;3;12079;310
2021-02-10;BZ;Belize;28;3;12107;313
2021-02-11;BZ;Belize;7;0;12114;313
2021-02-12;BZ;Belize;20;0;12134;313
2021-02-13;BZ;Belize;11;0;12145;313
2021-02-14;BZ;Belize;0;0;12145;313
2021-02-15;BZ;Belize;30;0;12175;313
2021-02-16;BZ;Belize;13;0;12188;313
2021-02-17;BZ;Belize;7;1;12195;314
2021-02-18;BZ;Belize;12;0;12207;314
2021-02-19;BZ;Belize;20;0;12227;314
2021-02-20;BZ;Belize;17;0;12244;314
2021-02-21;BZ;Belize;0;0;12244;314
2021-02-22;BZ;Belize;11;0;12255;314
2021-02-23;BZ;Belize;9;0;12264;314
2021-02-24;BZ;Belize;7;1;12271;315
2021-02-25;BZ;Belize;9;0;12280;315
2021-02-26;BZ;Belize;13;0;12293;315
2021-02-27;BZ;Belize;0;0;12293;315
2021-02-28;BZ;Belize;0;0;12293;315
2021-03-01;BZ;Belize;20;0;12313;315
2021-03-02;BZ;Belize;7;0;12320;315
2021-03-03;BZ;Belize;8;0;12328;315
2021-03-04;BZ;Belize;1;-1;12329;314
2021-03-05;BZ;Belize;6;1;12335;315
2021-03-06;BZ;Belize;0;0;12335;315
2021-03-07;BZ;Belize;0;0;12335;315
2021-03-08;BZ;Belize;0;0;12335;315
2021-03-09;BZ;Belize;10;1;12345;316
2021-03-10;BZ;Belize;10;0;12355;316
2021-03-11;BZ;Belize;4;0;12359;316
2021-03-12;BZ;Belize;11;0;12370;316
2021-03-13;BZ;Belize;0;0;12370;316
2021-03-14;BZ;Belize;0;0;12370;316
2021-03-15;BZ;Belize;13;0;12383;316
2021-03-16;BZ;Belize;6;0;12389;316
2021-03-17;BZ;Belize;7;0;12396;316
2021-03-18;BZ;Belize;3;0;12399;316
2021-03-19;BZ;Belize;1;0;12400;316
2021-03-20;BZ;Belize;0;0;12400;316
2021-03-21;BZ;Belize;0;0;12400;316
2021-03-22;BZ;Belize;7;0;12407;316
2021-03-23;BZ;Belize;3;0;12410;316
2021-03-24;BZ;Belize;0;1;12410;317
2021-03-25;BZ;Belize;1;0;12411;317
2021-03-26;BZ;Belize;4;0;12415;317
2021-03-27;BZ;Belize;0;0;12415;317
2021-03-28;BZ;Belize;0;0;12415;317
2021-03-29;BZ;Belize;0;0;12415;317
2021-03-30;BZ;Belize;0;0;12415;317
2021-03-31;BZ;Belize;41;0;12456;317
2021-04-01;BZ;Belize;0;0;12456;317
2021-04-02;BZ;Belize;0;0;12456;317
2021-04-03;BZ;Belize;0;0;12456;317
2021-04-04;BZ;Belize;0;0;12456;317
2021-04-05;BZ;Belize;0;0;12456;317
2021-04-06;BZ;Belize;21;1;12477;318
2021-04-07;BZ;Belize;8;0;12485;318
2021-04-08;BZ;Belize;0;0;12485;318
2021-04-09;BZ;Belize;0;0;12485;318
2021-04-10;BZ;Belize;0;0;12485;318
2021-04-11;BZ;Belize;0;0;12485;318
2021-04-12;BZ;Belize;18;0;12503;318
2021-04-13;BZ;Belize;10;0;12513;318
2021-04-14;BZ;Belize;9;0;12522;318
2021-04-15;BZ;Belize;7;0;12529;318
2021-04-16;BZ;Belize;9;0;12538;318
2021-04-17;BZ;Belize;0;0;12538;318
2021-04-18;BZ;Belize;0;0;12538;318
2021-04-19;BZ;Belize;20;0;12558;318
2021-04-20;BZ;Belize;10;0;12568;318
2021-04-21;BZ;Belize;17;0;12585;318
2021-04-22;BZ;Belize;11;2;12596;320
2021-04-23;BZ;Belize;3;1;12599;321
2021-04-24;BZ;Belize;0;0;12599;321
2021-04-25;BZ;Belize;0;0;12599;321
2021-04-26;BZ;Belize;25;1;12624;322
2021-04-27;BZ;Belize;7;0;12631;322
2021-04-28;BZ;Belize;8;1;12639;323
2021-04-29;BZ;Belize;7;0;12646;323
2021-04-30;BZ;Belize;22;0;12668;323
2021-05-01;BZ;Belize;0;0;12668;323
2021-05-02;BZ;Belize;0;0;12668;323
2021-05-03;BZ;Belize;6;0;12674;323
2021-05-04;BZ;Belize;1;0;12675;323
2021-05-05;BZ;Belize;5;0;12680;323
2021-05-06;BZ;Belize;2;0;12682;323
2021-05-07;BZ;Belize;4;0;12686;323
2021-05-08;BZ;Belize;0;0;12686;323
2021-05-09;BZ;Belize;0;0;12686;323
2021-05-10;BZ;Belize;14;0;12700;323
2021-05-11;BZ;Belize;4;0;12704;323
2021-05-12;BZ;Belize;3;0;12707;323
2021-05-13;BZ;Belize;2;0;12709;323
2021-05-14;BZ;Belize;5;0;12714;323
2021-05-15;BZ;Belize;0;0;12714;323
2021-05-16;BZ;Belize;0;0;12714;323
2021-05-17;BZ;Belize;28;0;12742;323
2021-05-18;BZ;Belize;3;0;12745;323
2021-05-19;BZ;Belize;8;0;12753;323
2021-05-20;BZ;Belize;8;0;12761;323
2021-05-21;BZ;Belize;3;0;12764;323
2021-05-22;BZ;Belize;0;0;12764;323
2021-05-23;BZ;Belize;0;0;12764;323
2021-05-24;BZ;Belize;0;0;12764;323
2021-05-25;BZ;Belize;13;0;12777;323
2021-05-26;BZ;Belize;7;0;12784;323
2021-05-27;BZ;Belize;5;0;12789;323
2021-05-28;BZ;Belize;2;1;12791;324
2021-05-29;BZ;Belize;0;0;12791;324
2021-05-30;BZ;Belize;0;0;12791;324
2021-05-31;BZ;Belize;18;0;12809;324
2021-06-01;BZ;Belize;10;1;12819;325
2021-06-02;BZ;Belize;14;0;12833;325
2021-06-03;BZ;Belize;7;0;12840;325
2021-06-04;BZ;Belize;21;0;12861;325
2021-06-05;BZ;Belize;0;0;12861;325
2021-06-06;BZ;Belize;0;0;12861;325
2021-06-07;BZ;Belize;38;0;12899;325
2021-06-08;BZ;Belize;10;0;12909;325
2021-06-09;BZ;Belize;7;0;12916;325
2021-06-10;BZ;Belize;8;0;12924;325
2021-06-11;BZ;Belize;14;0;12938;325
2021-06-12;BZ;Belize;0;0;12938;325
2021-06-13;BZ;Belize;0;0;12938;325
2021-06-14;BZ;Belize;33;1;12971;326
2021-06-15;BZ;Belize;18;0;12989;326
2021-06-16;BZ;Belize;5;1;12994;327
2021-06-17;BZ;Belize;0;0;12994;327
2021-06-18;BZ;Belize;10;1;13004;328
2021-06-19;BZ;Belize;0;0;13004;328
2021-06-20;BZ;Belize;0;0;13004;328
2021-06-21;BZ;Belize;35;1;13039;329
2021-06-22;BZ;Belize;20;0;13059;329
2021-06-23;BZ;Belize;24;0;13083;329
2021-06-24;BZ;Belize;21;0;13104;329
2021-06-25;BZ;Belize;33;0;13137;329
2021-06-26;BZ;Belize;0;0;13137;329
2021-06-27;BZ;Belize;0;0;13137;329
2021-06-28;BZ;Belize;52;0;13189;329
2021-06-29;BZ;Belize;38;0;13227;329
2021-06-30;BZ;Belize;24;0;13251;329
2021-07-01;BZ;Belize;49;0;13300;329
2020-03-16;BJ;Benin;1;0;1;0
2020-03-17;BJ;Benin;0;0;1;0
2020-03-18;BJ;Benin;1;0;2;0
2020-03-19;BJ;Benin;0;0;2;0
2020-03-20;BJ;Benin;0;0;2;0
2020-03-21;BJ;Benin;0;0;2;0
2020-03-22;BJ;Benin;0;0;2;0
2020-03-23;BJ;Benin;3;0;5;0
2020-03-24;BJ;Benin;1;0;6;0
2020-03-25;BJ;Benin;0;0;6;0
2020-03-26;BJ;Benin;0;0;6;0
2020-03-27;BJ;Benin;0;0;6;0
2020-03-28;BJ;Benin;0;0;6;0
2020-03-29;BJ;Benin;0;0;6;0
2020-03-30;BJ;Benin;0;0;6;0
2020-03-31;BJ;Benin;3;0;9;0
2020-04-01;BJ;Benin;4;0;13;0
2020-04-02;BJ;Benin;0;0;13;0
2020-04-03;BJ;Benin;3;0;16;0
2020-04-04;BJ;Benin;0;0;16;0
2020-04-05;BJ;Benin;6;0;22;0
2020-04-06;BJ;Benin;4;1;26;1
2020-04-07;BJ;Benin;0;0;26;1
2020-04-08;BJ;Benin;0;0;26;1
2020-04-09;BJ;Benin;0;0;26;1
2020-04-10;BJ;Benin;9;0;35;1
2020-04-11;BJ;Benin;0;0;35;1
2020-04-12;BJ;Benin;0;0;35;1
2020-04-13;BJ;Benin;0;0;35;1
2020-04-14;BJ;Benin;0;0;35;1
2020-04-15;BJ;Benin;0;0;35;1
2020-04-16;BJ;Benin;0;0;35;1
2020-04-17;BJ;Benin;0;0;35;1
2020-04-18;BJ;Benin;0;0;35;1
2020-04-19;BJ;Benin;0;0;35;1
2020-04-20;BJ;Benin;19;0;54;1
2020-04-21;BJ;Benin;0;0;54;1
2020-04-22;BJ;Benin;0;0;54;1
2020-04-23;BJ;Benin;0;0;54;1
2020-04-24;BJ;Benin;0;0;54;1
2020-04-25;BJ;Benin;0;0;54;1
2020-04-26;BJ;Benin;10;0;64;1
2020-04-27;BJ;Benin;0;0;64;1
2020-04-28;BJ;Benin;0;0;64;1
2020-04-29;BJ;Benin;0;0;64;1
2020-04-30;BJ;Benin;0;0;64;1
2020-05-01;BJ;Benin;26;1;90;2
2020-05-02;BJ;Benin;0;0;90;2
2020-05-03;BJ;Benin;0;0;90;2
2020-05-04;BJ;Benin;6;0;96;2
2020-05-05;BJ;Benin;0;0;96;2
2020-05-06;BJ;Benin;0;0;96;2
2020-05-07;BJ;Benin;44;0;140;2
2020-05-08;BJ;Benin;102;0;242;2
2020-05-09;BJ;Benin;42;0;284;2
2020-05-10;BJ;Benin;35;0;319;2
2020-05-11;BJ;Benin;0;0;319;2
2020-05-12;BJ;Benin;8;0;327;2
2020-05-13;BJ;Benin;0;0;327;2
2020-05-14;BJ;Benin;12;0;339;2
2020-05-15;BJ;Benin;0;0;339;2
2020-05-16;BJ;Benin;0;0;339;2
2020-05-17;BJ;Benin;0;0;339;2
2020-05-18;BJ;Benin;0;0;339;2
2020-05-19;BJ;Benin;-209;0;130;2
2020-05-20;BJ;Benin;0;0;130;2
2020-05-21;BJ;Benin;5;1;135;3
2020-05-22;BJ;Benin;0;0;135;3
2020-05-23;BJ;Benin;0;0;135;3
2020-05-24;BJ;Benin;56;0;191;3
2020-05-25;BJ;Benin;0;0;191;3
2020-05-26;BJ;Benin;17;0;208;3
2020-05-27;BJ;Benin;2;0;210;3
2020-05-28;BJ;Benin;0;0;210;3
2020-05-29;BJ;Benin;14;0;224;3
2020-05-30;BJ;Benin;0;0;224;3
2020-05-31;BJ;Benin;8;0;232;3
2020-06-01;BJ;Benin;11;0;243;3
2020-06-02;BJ;Benin;1;0;244;3
2020-06-03;BJ;Benin;0;0;244;3
2020-06-04;BJ;Benin;17;0;261;3
2020-06-05;BJ;Benin;0;0;261;3
2020-06-06;BJ;Benin;0;0;261;3
2020-06-07;BJ;Benin;0;0;261;3
2020-06-08;BJ;Benin;27;1;288;4
2020-06-09;BJ;Benin;17;0;305;4
2020-06-10;BJ;Benin;0;0;305;4
2020-06-11;BJ;Benin;0;0;305;4
2020-06-12;BJ;Benin;83;1;388;5
2020-06-13;BJ;Benin;24;1;412;6
2020-06-14;BJ;Benin;30;0;442;6
2020-06-15;BJ;Benin;41;3;483;9
2020-06-16;BJ;Benin;49;0;532;9
2020-06-17;BJ;Benin;40;0;572;9
2020-06-18;BJ;Benin;25;2;597;11
2020-06-19;BJ;Benin;53;0;650;11
2020-06-20;BJ;Benin;0;0;650;11
2020-06-21;BJ;Benin;115;2;765;13
2020-06-22;BJ;Benin;42;0;807;13
2020-06-23;BJ;Benin;43;0;850;13
2020-06-24;BJ;Benin;52;0;902;13
2020-06-25;BJ;Benin;115;1;1017;14
2020-06-26;BJ;Benin;36;0;1053;14
2020-06-27;BJ;Benin;71;0;1124;14
2020-06-28;BJ;Benin;25;2;1149;16
2020-06-29;BJ;Benin;38;3;1187;19
2020-06-30;BJ;Benin;12;2;1199;21
2020-07-01;BJ;Benin;0;0;1199;21
2020-07-02;BJ;Benin;0;0;1199;21
2020-07-03;BJ;Benin;0;0;1199;21
2020-07-04;BJ;Benin;0;0;1199;21
2020-07-05;BJ;Benin;0;0;1199;21
2020-07-06;BJ;Benin;0;0;1199;21
2020-07-07;BJ;Benin;0;0;1199;21
2020-07-08;BJ;Benin;0;0;1199;21
2020-07-09;BJ;Benin;86;2;1285;23
2020-07-10;BJ;Benin;0;0;1285;23
2020-07-11;BJ;Benin;93;3;1378;26
2020-07-12;BJ;Benin;0;0;1378;26
2020-07-13;BJ;Benin;0;0;1378;26
2020-07-14;BJ;Benin;0;0;1378;26
2020-07-15;BJ;Benin;0;0;1378;26
2020-07-16;BJ;Benin;85;2;1463;28
2020-07-17;BJ;Benin;139;3;1602;31
2020-07-18;BJ;Benin;0;0;1602;31
2020-07-19;BJ;Benin;0;0;1602;31
2020-07-20;BJ;Benin;0;0;1602;31
2020-07-21;BJ;Benin;0;0;1602;31
2020-07-22;BJ;Benin;88;3;1690;34
2020-07-23;BJ;Benin;4;0;1694;34
2020-07-24;BJ;Benin;0;0;1694;34
2020-07-25;BJ;Benin;0;0;1694;34
2020-07-26;BJ;Benin;76;1;1770;35
2020-07-27;BJ;Benin;0;0;1770;35
2020-07-28;BJ;Benin;0;0;1770;35
2020-07-29;BJ;Benin;35;1;1805;36
2020-07-30;BJ;Benin;0;0;1805;36
2020-07-31;BJ;Benin;0;0;1805;36
2020-08-01;BJ;Benin;0;0;1805;36
2020-08-02;BJ;Benin;0;0;1805;36
2020-08-03;BJ;Benin;0;0;1805;36
2020-08-04;BJ;Benin;109;2;1914;38
2020-08-05;BJ;Benin;22;0;1936;38
2020-08-06;BJ;Benin;0;0;1936;38
2020-08-07;BJ;Benin;0;0;1936;38
2020-08-08;BJ;Benin;0;0;1936;38
2020-08-09;BJ;Benin;0;0;1936;38
2020-08-10;BJ;Benin;0;0;1936;38
2020-08-11;BJ;Benin;65;0;2001;38
2020-08-12;BJ;Benin;13;0;2014;38
2020-08-13;BJ;Benin;0;0;2014;38
2020-08-14;BJ;Benin;0;0;2014;38
2020-08-15;BJ;Benin;49;1;2063;39
2020-08-16;BJ;Benin;0;0;2063;39
2020-08-17;BJ;Benin;0;0;2063;39
2020-08-18;BJ;Benin;0;0;2063;39
2020-08-19;BJ;Benin;32;0;2095;39
2020-08-20;BJ;Benin;0;0;2095;39
2020-08-21;BJ;Benin;0;0;2095;39
2020-08-22;BJ;Benin;20;0;2115;39
2020-08-23;BJ;Benin;0;0;2115;39
2020-08-24;BJ;Benin;0;0;2115;39
2020-08-25;BJ;Benin;0;0;2115;39
2020-08-26;BJ;Benin;30;1;2145;40
2020-08-27;BJ;Benin;0;0;2145;40
2020-08-28;BJ;Benin;0;0;2145;40
2020-08-29;BJ;Benin;0;0;2145;40
2020-08-30;BJ;Benin;0;0;2145;40
2020-08-31;BJ;Benin;0;0;2145;40
2020-09-01;BJ;Benin;0;0;2145;40
2020-09-02;BJ;Benin;49;0;2194;40
2020-09-03;BJ;Benin;0;0;2194;40
2020-09-04;BJ;Benin;0;0;2194;40
2020-09-05;BJ;Benin;19;0;2213;40
2020-09-06;BJ;Benin;0;0;2213;40
2020-09-07;BJ;Benin;0;0;2213;40
2020-09-08;BJ;Benin;0;0;2213;40
2020-09-09;BJ;Benin;29;0;2242;40
2020-09-10;BJ;Benin;0;0;2242;40
2020-09-11;BJ;Benin;0;0;2242;40
2020-09-12;BJ;Benin;0;0;2242;40
2020-09-13;BJ;Benin;25;0;2267;40
2020-09-14;BJ;Benin;0;0;2267;40
2020-09-15;BJ;Benin;0;0;2267;40
2020-09-16;BJ;Benin;13;0;2280;40
2020-09-17;BJ;Benin;0;0;2280;40
2020-09-18;BJ;Benin;0;0;2280;40
2020-09-19;BJ;Benin;0;0;2280;40
2020-09-20;BJ;Benin;0;0;2280;40
2020-09-21;BJ;Benin;14;0;2294;40
2020-09-22;BJ;Benin;0;0;2294;40
2020-09-23;BJ;Benin;31;0;2325;40
2020-09-24;BJ;Benin;0;0;2325;40
2020-09-25;BJ;Benin;0;0;2325;40
2020-09-26;BJ;Benin;0;0;2325;40
2020-09-27;BJ;Benin;15;0;2340;40
2020-09-28;BJ;Benin;0;0;2340;40
2020-09-29;BJ;Benin;0;0;2340;40
2020-09-30;BJ;Benin;17;1;2357;41
2020-10-01;BJ;Benin;0;0;2357;41
2020-10-02;BJ;Benin;0;0;2357;41
2020-10-03;BJ;Benin;0;0;2357;41
2020-10-04;BJ;Benin;0;0;2357;41
2020-10-05;BJ;Benin;0;0;2357;41
2020-10-06;BJ;Benin;0;0;2357;41
2020-10-07;BJ;Benin;54;0;2411;41
2020-10-08;BJ;Benin;0;0;2411;41
2020-10-09;BJ;Benin;0;0;2411;41
2020-10-10;BJ;Benin;0;0;2411;41
2020-10-11;BJ;Benin;0;0;2411;41
2020-10-12;BJ;Benin;0;0;2411;41
2020-10-13;BJ;Benin;0;0;2411;41
2020-10-14;BJ;Benin;67;0;2478;41
2020-10-15;BJ;Benin;18;0;2496;41
2020-10-16;BJ;Benin;0;0;2496;41
2020-10-17;BJ;Benin;0;0;2496;41
2020-10-18;BJ;Benin;0;0;2496;41
2020-10-19;BJ;Benin;0;0;2496;41
2020-10-20;BJ;Benin;0;0;2496;41
2020-10-21;BJ;Benin;61;0;2557;41
2020-10-22;BJ;Benin;0;0;2557;41
2020-10-23;BJ;Benin;0;0;2557;41
2020-10-24;BJ;Benin;0;0;2557;41
2020-10-25;BJ;Benin;0;0;2557;41
2020-10-26;BJ;Benin;0;0;2557;41
2020-10-27;BJ;Benin;0;0;2557;41
2020-10-28;BJ;Benin;86;0;2643;41
2020-10-29;BJ;Benin;0;0;2643;41
2020-10-30;BJ;Benin;0;0;2643;41
2020-10-31;BJ;Benin;0;0;2643;41
2020-11-01;BJ;Benin;40;0;2683;41
2020-11-02;BJ;Benin;0;0;2683;41
2020-11-03;BJ;Benin;0;0;2683;41
2020-11-04;BJ;Benin;62;2;2745;43
2020-11-05;BJ;Benin;0;0;2745;43
2020-11-06;BJ;Benin;0;0;2745;43
2020-11-07;BJ;Benin;0;0;2745;43
2020-11-08;BJ;Benin;0;0;2745;43
2020-11-09;BJ;Benin;36;0;2781;43
2020-11-10;BJ;Benin;0;0;2781;43
2020-11-11;BJ;Benin;63;0;2844;43
2020-11-12;BJ;Benin;0;0;2844;43
2020-11-13;BJ;Benin;0;0;2844;43
2020-11-14;BJ;Benin;0;0;2844;43
2020-11-15;BJ;Benin;0;0;2844;43
2020-11-16;BJ;Benin;40;0;2884;43
2020-11-17;BJ;Benin;0;0;2884;43
2020-11-18;BJ;Benin;32;0;2916;43
2020-11-19;BJ;Benin;0;0;2916;43
2020-11-20;BJ;Benin;0;0;2916;43
2020-11-21;BJ;Benin;0;0;2916;43
2020-11-22;BJ;Benin;0;0;2916;43
2020-11-23;BJ;Benin;0;0;2916;43
2020-11-24;BJ;Benin;0;0;2916;43
2020-11-25;BJ;Benin;58;0;2974;43
2020-11-26;BJ;Benin;0;0;2974;43
2020-11-27;BJ;Benin;0;0;2974;43
2020-11-28;BJ;Benin;0;0;2974;43
2020-11-29;BJ;Benin;0;0;2974;43
2020-11-30;BJ;Benin;41;0;3015;43
2020-12-01;BJ;Benin;0;0;3015;43
2020-12-02;BJ;Benin;40;1;3055;44
2020-12-03;BJ;Benin;0;0;3055;44
2020-12-04;BJ;Benin;0;0;3055;44
2020-12-05;BJ;Benin;0;0;3055;44
2020-12-06;BJ;Benin;0;0;3055;44
2020-12-07;BJ;Benin;18;0;3073;44
2020-12-08;BJ;Benin;0;0;3073;44
2020-12-09;BJ;Benin;17;0;3090;44
2020-12-10;BJ;Benin;0;0;3090;44
2020-12-11;BJ;Benin;0;0;3090;44
2020-12-12;BJ;Benin;0;0;3090;44
2020-12-13;BJ;Benin;0;0;3090;44
2020-12-14;BJ;Benin;0;0;3090;44
2020-12-15;BJ;Benin;0;0;3090;44
2020-12-16;BJ;Benin;62;0;3152;44
2020-12-17;BJ;Benin;0;0;3152;44
2020-12-18;BJ;Benin;0;0;3152;44
2020-12-19;BJ;Benin;0;0;3152;44
2020-12-20;BJ;Benin;15;0;3167;44
2020-12-21;BJ;Benin;0;0;3167;44
2020-12-22;BJ;Benin;0;0;3167;44
2020-12-23;BJ;Benin;38;0;3205;44
2020-12-24;BJ;Benin;0;0;3205;44
2020-12-25;BJ;Benin;0;0;3205;44
2020-12-26;BJ;Benin;0;0;3205;44
2020-12-27;BJ;Benin;0;0;3205;44
2020-12-28;BJ;Benin;0;0;3205;44
2020-12-29;BJ;Benin;0;0;3205;44
2020-12-30;BJ;Benin;46;0;3251;44
2020-12-31;BJ;Benin;0;0;3251;44
2021-01-01;BJ;Benin;0;0;3251;44
2021-01-02;BJ;Benin;0;0;3251;44
2021-01-03;BJ;Benin;0;0;3251;44
2021-01-04;BJ;Benin;0;0;3251;44
2021-01-05;BJ;Benin;53;0;3304;44
2021-01-06;BJ;Benin;0;0;3304;44
2021-01-07;BJ;Benin;0;0;3304;44
2021-01-08;BJ;Benin;0;0;3304;44
2021-01-09;BJ;Benin;0;0;3304;44
2021-01-10;BJ;Benin;0;0;3304;44
2021-01-11;BJ;Benin;59;2;3363;46
2021-01-12;BJ;Benin;0;0;3363;46
2021-01-13;BJ;Benin;50;0;3413;46
2021-01-14;BJ;Benin;0;0;3413;46
2021-01-15;BJ;Benin;0;0;3413;46
2021-01-16;BJ;Benin;0;0;3413;46
2021-01-17;BJ;Benin;0;0;3413;46
2021-01-18;BJ;Benin;0;0;3413;46
2021-01-19;BJ;Benin;0;0;3413;46
2021-01-20;BJ;Benin;144;0;3557;46
2021-01-21;BJ;Benin;25;2;3582;48
2021-01-22;BJ;Benin;61;0;3643;48
2021-01-23;BJ;Benin;0;0;3643;48
2021-01-24;BJ;Benin;0;0;3643;48
2021-01-25;BJ;Benin;0;0;3643;48
2021-01-26;BJ;Benin;0;0;3643;48
2021-01-27;BJ;Benin;143;0;3786;48
2021-01-28;BJ;Benin;0;0;3786;48
2021-01-29;BJ;Benin;0;0;3786;48
2021-01-30;BJ;Benin;0;0;3786;48
2021-01-31;BJ;Benin;107;4;3893;52
2021-02-01;BJ;Benin;0;0;3893;52
2021-02-02;BJ;Benin;0;0;3893;52
2021-02-03;BJ;Benin;226;2;4119;54
2021-02-04;BJ;Benin;0;0;4119;54
2021-02-05;BJ;Benin;74;1;4193;55
2021-02-06;BJ;Benin;0;0;4193;55
2021-02-07;BJ;Benin;0;0;4193;55
2021-02-08;BJ;Benin;0;0;4193;55
2021-02-09;BJ;Benin;0;0;4193;55
2021-02-10;BJ;Benin;367;1;4560;56
2021-02-11;BJ;Benin;0;0;4560;56
2021-02-12;BJ;Benin;0;0;4560;56
2021-02-13;BJ;Benin;0;0;4560;56
2021-02-14;BJ;Benin;0;0;4560;56
2021-02-15;BJ;Benin;479;6;5039;62
2021-02-16;BJ;Benin;0;0;5039;62
2021-02-17;BJ;Benin;104;3;5143;65
2021-02-18;BJ;Benin;0;0;5143;65
2021-02-19;BJ;Benin;0;0;5143;65
2021-02-20;BJ;Benin;0;0;5143;65
2021-02-21;BJ;Benin;291;5;5434;70
2021-02-22;BJ;Benin;0;0;5434;70
2021-02-23;BJ;Benin;0;0;5434;70
2021-02-24;BJ;Benin;0;0;5434;70
2021-02-25;BJ;Benin;0;0;5434;70
2021-02-26;BJ;Benin;0;0;5434;70
2021-02-27;BJ;Benin;0;0;5434;70
2021-02-28;BJ;Benin;0;0;5434;70
2021-03-01;BJ;Benin;0;0;5434;70
2021-03-02;BJ;Benin;0;0;5434;70
2021-03-03;BJ;Benin;637;5;6071;75
2021-03-04;BJ;Benin;0;0;6071;75
2021-03-05;BJ;Benin;0;0;6071;75
2021-03-06;BJ;Benin;0;0;6071;75
2021-03-07;BJ;Benin;0;0;6071;75
2021-03-08;BJ;Benin;267;6;6338;81
2021-03-09;BJ;Benin;0;0;6338;81
2021-03-10;BJ;Benin;163;0;6501;81
2021-03-11;BJ;Benin;0;0;6501;81
2021-03-12;BJ;Benin;0;0;6501;81
2021-03-13;BJ;Benin;0;0;6501;81
2021-03-14;BJ;Benin;0;0;6501;81
2021-03-15;BJ;Benin;0;0;6501;81
2021-03-16;BJ;Benin;0;0;6501;81
2021-03-17;BJ;Benin;0;0;6501;81
2021-03-18;BJ;Benin;0;0;6501;81
2021-03-19;BJ;Benin;317;9;6818;90
2021-03-20;BJ;Benin;0;0;6818;90
2021-03-21;BJ;Benin;0;0;6818;90
2021-03-22;BJ;Benin;0;0;6818;90
2021-03-23;BJ;Benin;0;0;6818;90
2021-03-24;BJ;Benin;282;0;7100;90
2021-03-25;BJ;Benin;0;0;7100;90
2021-03-26;BJ;Benin;0;0;7100;90
2021-03-27;BJ;Benin;0;0;7100;90
2021-03-28;BJ;Benin;0;0;7100;90
2021-03-29;BJ;Benin;0;0;7100;90
2021-03-30;BJ;Benin;0;0;7100;90
2021-03-31;BJ;Benin;0;0;7100;90
2021-04-01;BJ;Benin;213;3;7313;93
2021-04-02;BJ;Benin;0;0;7313;93
2021-04-03;BJ;Benin;0;0;7313;93
2021-04-04;BJ;Benin;0;0;7313;93
2021-04-05;BJ;Benin;0;0;7313;93
2021-04-06;BJ;Benin;0;0;7313;93
2021-04-07;BJ;Benin;0;0;7313;93
2021-04-08;BJ;Benin;202;0;7515;93
2021-04-09;BJ;Benin;0;0;7515;93
2021-04-10;BJ;Benin;0;0;7515;93
2021-04-11;BJ;Benin;0;0;7515;93
2021-04-12;BJ;Benin;0;0;7515;93
2021-04-13;BJ;Benin;0;0;7515;93
2021-04-14;BJ;Benin;96;2;7611;95
2021-04-15;BJ;Benin;0;0;7611;95
2021-04-16;BJ;Benin;0;0;7611;95
2021-04-17;BJ;Benin;0;0;7611;95
2021-04-18;BJ;Benin;0;0;7611;95
2021-04-19;BJ;Benin;0;0;7611;95
2021-04-20;BJ;Benin;109;2;7720;97
2021-04-21;BJ;Benin;0;0;7720;97
2021-04-22;BJ;Benin;0;0;7720;97
2021-04-23;BJ;Benin;0;0;7720;97
2021-04-24;BJ;Benin;0;0;7720;97
2021-04-25;BJ;Benin;0;0;7720;97
2021-04-26;BJ;Benin;0;0;7720;97
2021-04-27;BJ;Benin;0;0;7720;97
2021-04-28;BJ;Benin;101;2;7821;99
2021-04-29;BJ;Benin;0;0;7821;99
2021-04-30;BJ;Benin;0;0;7821;99
2021-05-01;BJ;Benin;0;0;7821;99
2021-05-02;BJ;Benin;0;0;7821;99
2021-05-03;BJ;Benin;63;1;7884;100
2021-05-04;BJ;Benin;0;0;7884;100
2021-05-05;BJ;Benin;0;0;7884;100
2021-05-06;BJ;Benin;0;0;7884;100
2021-05-07;BJ;Benin;0;0;7884;100
2021-05-08;BJ;Benin;0;0;7884;100
2021-05-09;BJ;Benin;0;0;7884;100
2021-05-10;BJ;Benin;0;0;7884;100
2021-05-11;BJ;Benin;111;1;7995;101
2021-05-12;BJ;Benin;0;0;7995;101
2021-05-13;BJ;Benin;0;0;7995;101
2021-05-14;BJ;Benin;0;0;7995;101
2021-05-15;BJ;Benin;0;0;7995;101
2021-05-16;BJ;Benin;0;0;7995;101
2021-05-17;BJ;Benin;0;0;7995;101
2021-05-18;BJ;Benin;30;0;8025;101
2021-05-19;BJ;Benin;0;0;8025;101
2021-05-20;BJ;Benin;0;0;8025;101
2021-05-21;BJ;Benin;0;0;8025;101
2021-05-22;BJ;Benin;0;0;8025;101
2021-05-23;BJ;Benin;0;0;8025;101
2021-05-24;BJ;Benin;0;0;8025;101
2021-05-25;BJ;Benin;0;0;8025;101
2021-05-26;BJ;Benin;33;0;8058;101
2021-05-27;BJ;Benin;0;0;8058;101
2021-05-28;BJ;Benin;0;0;8058;101
2021-05-29;BJ;Benin;0;0;8058;101
2021-05-30;BJ;Benin;0;0;8058;101
2021-05-31;BJ;Benin;0;0;8058;101
2021-06-01;BJ;Benin;0;0;8058;101
2021-06-02;BJ;Benin;24;1;8082;102
2021-06-03;BJ;Benin;0;0;8082;102
2021-06-04;BJ;Benin;0;0;8082;102
2021-06-05;BJ;Benin;0;0;8082;102
2021-06-06;BJ;Benin;0;0;8082;102
2021-06-07;BJ;Benin;0;0;8082;102
2021-06-08;BJ;Benin;0;0;8082;102
2021-06-09;BJ;Benin;27;0;8109;102
2021-06-10;BJ;Benin;0;0;8109;102
2021-06-11;BJ;Benin;0;0;8109;102
2021-06-12;BJ;Benin;0;0;8109;102
2021-06-13;BJ;Benin;0;0;8109;102
2021-06-14;BJ;Benin;0;0;8109;102
2021-06-15;BJ;Benin;31;1;8140;103
2021-06-16;BJ;Benin;0;0;8140;103
2021-06-17;BJ;Benin;0;0;8140;103
2021-06-18;BJ;Benin;0;0;8140;103
2021-06-19;BJ;Benin;0;0;8140;103
2021-06-20;BJ;Benin;0;0;8140;103
2021-06-21;BJ;Benin;0;0;8140;103
2021-06-22;BJ;Benin;30;1;8170;104
2021-06-23;BJ;Benin;0;0;8170;104
2021-06-24;BJ;Benin;0;0;8170;104
2021-06-25;BJ;Benin;0;0;8170;104
2021-06-26;BJ;Benin;0;0;8170;104
2021-06-27;BJ;Benin;0;0;8170;104
2021-06-28;BJ;Benin;0;0;8170;104
2021-06-29;BJ;Benin;29;0;8199;104
2021-06-30;BJ;Benin;0;0;8199;104
2021-07-01;BJ;Benin;0;0;8199;104
2021-01-10;BM;Bermuda;0;0;0;0
2021-01-11;BM;Bermuda;0;0;0;0
2021-01-12;BM;Bermuda;0;0;0;0
2021-01-13;BM;Bermuda;0;0;0;0
2021-01-14;BM;Bermuda;0;0;0;0
2021-01-15;BM;Bermuda;0;0;0;0
2021-01-16;BM;Bermuda;0;0;0;0
2021-01-17;BM;Bermuda;0;0;0;0
2021-01-18;BM;Bermuda;0;0;0;0
2021-01-19;BM;Bermuda;0;0;0;0
2021-01-20;BM;Bermuda;0;0;0;0
2021-01-21;BM;Bermuda;0;0;0;0
2021-01-22;BM;Bermuda;0;0;0;0
2021-01-23;BM;Bermuda;0;0;0;0
2021-01-24;BM;Bermuda;0;0;0;0
2021-01-25;BM;Bermuda;0;0;0;0
2021-01-26;BM;Bermuda;0;0;0;0
2021-01-27;BM;Bermuda;0;0;0;0
2021-01-28;BM;Bermuda;0;0;0;0
2021-01-29;BM;Bermuda;0;0;0;0
2021-01-30;BM;Bermuda;0;0;0;0
2021-01-31;BM;Bermuda;0;0;0;0
2021-02-01;BM;Bermuda;0;0;0;0
2021-02-02;BM;Bermuda;0;0;0;0
2021-02-03;BM;Bermuda;0;0;0;0
2021-02-04;BM;Bermuda;0;0;0;0
2021-02-05;BM;Bermuda;0;0;0;0
2021-02-06;BM;Bermuda;0;0;0;0
2021-02-07;BM;Bermuda;0;0;0;0
2021-02-08;BM;Bermuda;0;0;0;0
2021-02-09;BM;Bermuda;0;0;0;0
2021-02-10;BM;Bermuda;0;0;0;0
2021-02-11;BM;Bermuda;0;0;0;0
2021-02-12;BM;Bermuda;0;0;0;0
2021-02-13;BM;Bermuda;0;0;0;0
2021-02-14;BM;Bermuda;0;0;0;0
2021-02-15;BM;Bermuda;0;0;0;0
2021-02-16;BM;Bermuda;0;0;0;0
2021-02-17;BM;Bermuda;0;0;0;0
2021-02-18;BM;Bermuda;0;0;0;0
2021-02-19;BM;Bermuda;0;0;0;0
2021-02-20;BM;Bermuda;0;0;0;0
2021-02-21;BM;Bermuda;0;0;0;0
2021-02-22;BM;Bermuda;0;0;0;0
2021-02-23;BM;Bermuda;0;0;0;0
2021-02-24;BM;Bermuda;0;0;0;0
2021-02-25;BM;Bermuda;0;0;0;0
2021-02-26;BM;Bermuda;0;0;0;0
2021-02-27;BM;Bermuda;0;0;0;0
2021-02-28;BM;Bermuda;0;0;0;0
2021-03-01;BM;Bermuda;0;0;0;0
2021-03-02;BM;Bermuda;0;0;0;0
2021-03-03;BM;Bermuda;0;0;0;0
2021-03-04;BM;Bermuda;0;0;0;0
2021-03-05;BM;Bermuda;0;0;0;0
2021-03-06;BM;Bermuda;0;0;0;0
2021-03-07;BM;Bermuda;0;0;0;0
2021-03-08;BM;Bermuda;0;0;0;0
2021-03-09;BM;Bermuda;0;0;0;0
2021-03-10;BM;Bermuda;0;0;0;0
2021-03-11;BM;Bermuda;0;0;0;0
2021-03-12;BM;Bermuda;0;0;0;0
2021-03-13;BM;Bermuda;0;0;0;0
2021-03-14;BM;Bermuda;0;0;0;0
2021-03-15;BM;Bermuda;0;0;0;0
2021-03-16;BM;Bermuda;0;0;0;0
2021-03-17;BM;Bermuda;0;0;0;0
2021-03-18;BM;Bermuda;0;0;0;0
2021-03-19;BM;Bermuda;0;0;0;0
2021-03-20;BM;Bermuda;0;0;0;0
2021-03-21;BM;Bermuda;0;0;0;0
2021-03-22;BM;Bermuda;0;0;0;0
2021-03-23;BM;Bermuda;0;0;0;0
2021-03-24;BM;Bermuda;0;0;0;0
2021-03-25;BM;Bermuda;0;0;0;0
2021-03-26;BM;Bermuda;0;0;0;0
2021-03-27;BM;Bermuda;0;0;0;0
2021-03-28;BM;Bermuda;0;0;0;0
2021-03-29;BM;Bermuda;0;0;0;0
2021-03-30;BM;Bermuda;0;0;0;0
2021-03-31;BM;Bermuda;0;0;0;0
2021-04-01;BM;Bermuda;0;0;0;0
2021-04-02;BM;Bermuda;0;0;0;0
2021-04-03;BM;Bermuda;0;0;0;0
2021-04-04;BM;Bermuda;0;0;0;0
2021-04-05;BM;Bermuda;0;0;0;0
2021-04-06;BM;Bermuda;0;0;0;0
2021-04-07;BM;Bermuda;0;0;0;0
2021-04-08;BM;Bermuda;0;0;0;0
2021-04-09;BM;Bermuda;0;0;0;0
2021-04-10;BM;Bermuda;0;0;0;0
2021-04-11;BM;Bermuda;0;0;0;0
2021-04-12;BM;Bermuda;0;0;0;0
2021-04-13;BM;Bermuda;0;0;0;0
2021-04-14;BM;Bermuda;0;0;0;0
2021-04-15;BM;Bermuda;0;0;0;0
2021-04-16;BM;Bermuda;0;0;0;0
2021-04-17;BM;Bermuda;0;0;0;0
2021-04-18;BM;Bermuda;0;0;0;0
2021-04-19;BM;Bermuda;0;0;0;0
2021-04-20;BM;Bermuda;0;0;0;0
2021-04-21;BM;Bermuda;0;0;0;0
2021-04-22;BM;Bermuda;0;0;0;0
2021-04-23;BM;Bermuda;0;0;0;0
2021-04-24;BM;Bermuda;0;0;0;0
2021-04-25;BM;Bermuda;0;0;0;0
2021-04-26;BM;Bermuda;0;0;0;0
2021-04-27;BM;Bermuda;0;0;0;0
2021-04-28;BM;Bermuda;0;0;0;0
2021-04-29;BM;Bermuda;0;0;0;0
2021-04-30;BM;Bermuda;0;0;0;0
2021-05-01;BM;Bermuda;0;0;0;0
2021-05-02;BM;Bermuda;0;0;0;0
2021-05-03;BM;Bermuda;0;0;0;0
2021-05-04;BM;Bermuda;0;0;0;0
2021-05-05;BM;Bermuda;0;0;0;0
2021-05-06;BM;Bermuda;0;0;0;0
2021-05-07;BM;Bermuda;0;0;0;0
2021-05-08;BM;Bermuda;0;0;0;0
2021-05-09;BM;Bermuda;0;0;0;0
2021-05-10;BM;Bermuda;0;0;0;0
2021-05-11;BM;Bermuda;0;0;0;0
2021-05-12;BM;Bermuda;0;0;0;0
2021-05-13;BM;Bermuda;0;0;0;0
2021-05-14;BM;Bermuda;0;0;0;0
2021-05-15;BM;Bermuda;0;0;0;0
2021-05-16;BM;Bermuda;0;0;0;0
2021-05-17;BM;Bermuda;0;0;0;0
2021-05-18;BM;Bermuda;0;0;0;0
2021-05-19;BM;Bermuda;0;0;0;0
2021-05-20;BM;Bermuda;0;0;0;0
2021-05-21;BM;Bermuda;0;0;0;0
2021-05-22;BM;Bermuda;0;0;0;0
2021-05-23;BM;Bermuda;0;0;0;0
2021-05-24;BM;Bermuda;0;0;0;0
2021-05-25;BM;Bermuda;0;0;0;0
2021-05-26;BM;Bermuda;0;0;0;0
2021-05-27;BM;Bermuda;0;0;0;0
2021-05-28;BM;Bermuda;0;0;0;0
2021-05-29;BM;Bermuda;0;0;0;0
2021-05-30;BM;Bermuda;0;0;0;0
2021-05-31;BM;Bermuda;0;0;0;0
2021-06-01;BM;Bermuda;0;0;0;0
2021-06-02;BM;Bermuda;0;0;0;0
2021-06-03;BM;Bermuda;0;0;0;0
2021-06-04;BM;Bermuda;0;0;0;0
2021-06-05;BM;Bermuda;0;0;0;0
2021-06-06;BM;Bermuda;0;0;0;0
2021-06-07;BM;Bermuda;0;0;0;0
2021-06-08;BM;Bermuda;0;0;0;0
2021-06-09;BM;Bermuda;0;0;0;0
2021-06-10;BM;Bermuda;0;0;0;0
2021-06-11;BM;Bermuda;0;0;0;0
2021-06-12;BM;Bermuda;0;0;0;0
2021-06-13;BM;Bermuda;0;0;0;0
2021-06-14;BM;Bermuda;0;0;0;0
2021-06-15;BM;Bermuda;0;0;0;0
2021-06-16;BM;Bermuda;0;0;0;0
2021-06-17;BM;Bermuda;0;0;0;0
2021-06-18;BM;Bermuda;0;0;0;0
2021-06-19;BM;Bermuda;0;0;0;0
2021-06-20;BM;Bermuda;0;0;0;0
2021-06-21;BM;Bermuda;0;0;0;0
2021-06-22;BM;Bermuda;0;0;0;0
2021-06-23;BM;Bermuda;0;0;0;0
2021-06-24;BM;Bermuda;0;0;0;0
2021-06-25;BM;Bermuda;0;0;0;0
2021-06-26;BM;Bermuda;0;0;0;0
2021-06-27;BM;Bermuda;0;0;0;0
2021-06-28;BM;Bermuda;0;0;0;0
2021-06-29;BM;Bermuda;0;0;0;0
2020-03-06;BT;Bhutan;1;0;1;0
2020-03-07;BT;Bhutan;0;0;1;0
2020-03-08;BT;Bhutan;0;0;1;0
2020-03-09;BT;Bhutan;0;0;1;0
2020-03-10;BT;Bhutan;0;0;1;0
2020-03-11;BT;Bhutan;0;0;1;0
2020-03-12;BT;Bhutan;0;0;1;0
2020-03-13;BT;Bhutan;0;0;1;0
2020-03-14;BT;Bhutan;0;0;1;0
2020-03-15;BT;Bhutan;0;0;1;0
2020-03-16;BT;Bhutan;0;0;1;0
2020-03-17;BT;Bhutan;0;0;1;0
2020-03-18;BT;Bhutan;0;0;1;0
2020-03-19;BT;Bhutan;0;0;1;0
2020-03-20;BT;Bhutan;1;0;2;0
2020-03-21;BT;Bhutan;0;0;2;0
2020-03-22;BT;Bhutan;0;0;2;0
2020-03-23;BT;Bhutan;0;0;2;0
2020-03-24;BT;Bhutan;0;0;2;0
2020-03-25;BT;Bhutan;0;0;2;0
2020-03-26;BT;Bhutan;0;0;2;0
2020-03-27;BT;Bhutan;1;0;3;0
2020-03-28;BT;Bhutan;0;0;3;0
2020-03-29;BT;Bhutan;1;0;4;0
2020-03-30;BT;Bhutan;0;0;4;0
2020-03-31;BT;Bhutan;0;0;4;0
2020-04-01;BT;Bhutan;0;0;4;0
2020-04-02;BT;Bhutan;1;0;5;0
2020-04-03;BT;Bhutan;0;0;5;0
2020-04-04;BT;Bhutan;0;0;5;0
2020-04-05;BT;Bhutan;0;0;5;0
2020-04-06;BT;Bhutan;0;0;5;0
2020-04-07;BT;Bhutan;0;0;5;0
2020-04-08;BT;Bhutan;0;0;5;0
2020-04-09;BT;Bhutan;0;0;5;0
2020-04-10;BT;Bhutan;0;0;5;0
2020-04-11;BT;Bhutan;0;0;5;0
2020-04-12;BT;Bhutan;0;0;5;0
2020-04-13;BT;Bhutan;0;0;5;0
2020-04-14;BT;Bhutan;0;0;5;0
2020-04-15;BT;Bhutan;0;0;5;0
2020-04-16;BT;Bhutan;0;0;5;0
2020-04-17;BT;Bhutan;0;0;5;0
2020-04-18;BT;Bhutan;0;0;5;0
2020-04-19;BT;Bhutan;0;0;5;0
2020-04-20;BT;Bhutan;0;0;5;0
2020-04-21;BT;Bhutan;1;0;6;0
2020-04-22;BT;Bhutan;0;0;6;0
2020-04-23;BT;Bhutan;1;0;7;0
2020-04-24;BT;Bhutan;0;0;7;0
2020-04-25;BT;Bhutan;0;0;7;0
2020-04-26;BT;Bhutan;0;0;7;0
2020-04-27;BT;Bhutan;0;0;7;0
2020-04-28;BT;Bhutan;0;0;7;0
2020-04-29;BT;Bhutan;0;0;7;0
2020-04-30;BT;Bhutan;0;0;7;0
2020-05-01;BT;Bhutan;0;0;7;0
2020-05-02;BT;Bhutan;0;0;7;0
2020-05-03;BT;Bhutan;0;0;7;0
2020-05-04;BT;Bhutan;0;0;7;0
2020-05-05;BT;Bhutan;0;0;7;0
2020-05-06;BT;Bhutan;0;0;7;0
2020-05-07;BT;Bhutan;0;0;7;0
2020-05-08;BT;Bhutan;0;0;7;0
2020-05-09;BT;Bhutan;0;0;7;0
2020-05-10;BT;Bhutan;0;0;7;0
2020-05-11;BT;Bhutan;2;0;9;0
2020-05-12;BT;Bhutan;2;0;11;0
2020-05-13;BT;Bhutan;4;0;15;0
2020-05-14;BT;Bhutan;5;0;20;0
2020-05-15;BT;Bhutan;1;0;21;0
2020-05-16;BT;Bhutan;0;0;21;0
2020-05-17;BT;Bhutan;0;0;21;0
2020-05-18;BT;Bhutan;0;0;21;0
2020-05-19;BT;Bhutan;0;0;21;0
2020-05-20;BT;Bhutan;0;0;21;0
2020-05-21;BT;Bhutan;0;0;21;0
2020-05-22;BT;Bhutan;0;0;21;0
2020-05-23;BT;Bhutan;3;0;24;0
2020-05-24;BT;Bhutan;0;0;24;0
2020-05-25;BT;Bhutan;3;0;27;0
2020-05-26;BT;Bhutan;0;0;27;0
2020-05-27;BT;Bhutan;1;0;28;0
2020-05-28;BT;Bhutan;3;0;31;0
2020-05-29;BT;Bhutan;0;0;31;0
2020-05-30;BT;Bhutan;2;0;33;0
2020-05-31;BT;Bhutan;10;0;43;0
2020-06-01;BT;Bhutan;0;0;43;0
2020-06-02;BT;Bhutan;4;0;47;0
2020-06-03;BT;Bhutan;0;0;47;0
2020-06-04;BT;Bhutan;0;0;47;0
2020-06-05;BT;Bhutan;1;0;48;0
2020-06-06;BT;Bhutan;0;0;48;0
2020-06-07;BT;Bhutan;11;0;59;0
2020-06-08;BT;Bhutan;0;0;59;0
2020-06-09;BT;Bhutan;0;0;59;0
2020-06-10;BT;Bhutan;0;0;59;0
2020-06-11;BT;Bhutan;3;0;62;0
2020-06-12;BT;Bhutan;0;0;62;0
2020-06-13;BT;Bhutan;4;0;66;0
2020-06-14;BT;Bhutan;0;0;66;0
2020-06-15;BT;Bhutan;1;0;67;0
2020-06-16;BT;Bhutan;0;0;67;0
2020-06-17;BT;Bhutan;0;0;67;0
2020-06-18;BT;Bhutan;0;0;67;0
2020-06-19;BT;Bhutan;1;0;68;0
2020-06-20;BT;Bhutan;0;0;68;0
2020-06-21;BT;Bhutan;0;0;68;0
2020-06-22;BT;Bhutan;0;0;68;0
2020-06-23;BT;Bhutan;2;0;70;0
2020-06-24;BT;Bhutan;0;0;70;0
2020-06-25;BT;Bhutan;0;0;70;0
2020-06-26;BT;Bhutan;0;0;70;0
2020-06-27;BT;Bhutan;5;0;75;0
2020-06-28;BT;Bhutan;1;0;76;0
2020-06-29;BT;Bhutan;1;0;77;0
2020-06-30;BT;Bhutan;0;0;77;0
2020-07-01;BT;Bhutan;0;0;77;0
2020-07-02;BT;Bhutan;0;0;77;0
2020-07-03;BT;Bhutan;0;0;77;0
2020-07-04;BT;Bhutan;1;0;78;0
2020-07-05;BT;Bhutan;2;0;80;0
2020-07-06;BT;Bhutan;0;0;80;0
2020-07-07;BT;Bhutan;0;0;80;0
2020-07-08;BT;Bhutan;0;0;80;0
2020-07-09;BT;Bhutan;0;0;80;0
2020-07-10;BT;Bhutan;0;0;80;0
2020-07-11;BT;Bhutan;2;0;82;0
2020-07-12;BT;Bhutan;2;0;84;0
2020-07-13;BT;Bhutan;0;0;84;0
2020-07-14;BT;Bhutan;0;0;84;0
2020-07-15;BT;Bhutan;0;0;84;0
2020-07-16;BT;Bhutan;2;0;86;0
2020-07-17;BT;Bhutan;1;0;87;0
2020-07-18;BT;Bhutan;0;0;87;0
2020-07-19;BT;Bhutan;2;0;89;0
2020-07-20;BT;Bhutan;1;0;90;0
2020-07-21;BT;Bhutan;2;0;92;0
2020-07-22;BT;Bhutan;0;0;92;0
2020-07-23;BT;Bhutan;0;0;92;0
2020-07-24;BT;Bhutan;0;0;92;0
2020-07-25;BT;Bhutan;0;0;92;0
2020-07-26;BT;Bhutan;3;0;95;0
2020-07-27;BT;Bhutan;4;0;99;0
2020-07-28;BT;Bhutan;0;0;99;0
2020-07-29;BT;Bhutan;0;0;99;0
2020-07-30;BT;Bhutan;2;0;101;0
2020-07-31;BT;Bhutan;0;0;101;0
2020-08-01;BT;Bhutan;1;0;102;0
2020-08-02;BT;Bhutan;0;0;102;0
2020-08-03;BT;Bhutan;1;0;103;0
2020-08-04;BT;Bhutan;2;0;105;0
2020-08-05;BT;Bhutan;0;0;105;0
2020-08-06;BT;Bhutan;3;0;108;0
2020-08-07;BT;Bhutan;0;0;108;0
2020-08-08;BT;Bhutan;0;0;108;0
2020-08-09;BT;Bhutan;2;0;110;0
2020-08-10;BT;Bhutan;0;0;110;0
2020-08-11;BT;Bhutan;3;0;113;0
2020-08-12;BT;Bhutan;0;0;113;0
2020-08-13;BT;Bhutan;15;0;128;0
2020-08-14;BT;Bhutan;5;0;133;0
2020-08-15;BT;Bhutan;0;0;133;0
2020-08-16;BT;Bhutan;5;0;138;0
2020-08-17;BT;Bhutan;3;0;141;0
2020-08-18;BT;Bhutan;6;0;147;0
2020-08-19;BT;Bhutan;0;0;147;0
2020-08-20;BT;Bhutan;6;0;153;0
2020-08-21;BT;Bhutan;1;0;154;0
2020-08-22;BT;Bhutan;1;0;155;0
2020-08-23;BT;Bhutan;0;0;155;0
2020-08-24;BT;Bhutan;1;0;156;0
2020-08-25;BT;Bhutan;17;0;173;0
2020-08-26;BT;Bhutan;0;0;173;0
2020-08-27;BT;Bhutan;11;0;184;0
2020-08-28;BT;Bhutan;11;0;195;0
2020-08-29;BT;Bhutan;0;0;195;0
2020-08-30;BT;Bhutan;29;0;224;0
2020-08-31;BT;Bhutan;1;0;225;0
2020-09-01;BT;Bhutan;2;0;227;0
2020-09-02;BT;Bhutan;0;0;227;0
2020-09-03;BT;Bhutan;0;0;227;0
2020-09-04;BT;Bhutan;1;0;228;0
2020-09-05;BT;Bhutan;0;0;228;0
2020-09-06;BT;Bhutan;0;0;228;0
2020-09-07;BT;Bhutan;5;0;233;0
2020-09-08;BT;Bhutan;1;0;234;0
2020-09-09;BT;Bhutan;0;0;234;0
2020-09-10;BT;Bhutan;4;0;238;0
2020-09-11;BT;Bhutan;3;0;241;0
2020-09-12;BT;Bhutan;3;0;244;0
2020-09-13;BT;Bhutan;1;0;245;0
2020-09-14;BT;Bhutan;0;0;245;0
2020-09-15;BT;Bhutan;1;0;246;0
2020-09-16;BT;Bhutan;0;0;246;0
2020-09-17;BT;Bhutan;0;0;246;0
2020-09-18;BT;Bhutan;6;0;252;0
2020-09-19;BT;Bhutan;7;0;259;0
2020-09-20;BT;Bhutan;2;0;261;0
2020-09-21;BT;Bhutan;0;0;261;0
2020-09-22;BT;Bhutan;0;0;261;0
2020-09-23;BT;Bhutan;0;0;261;0
2020-09-24;BT;Bhutan;2;0;263;0
2020-09-25;BT;Bhutan;0;0;263;0
2020-09-26;BT;Bhutan;8;0;271;0
2020-09-27;BT;Bhutan;2;0;273;0
2020-09-28;BT;Bhutan;7;0;280;0
2020-09-29;BT;Bhutan;1;0;281;0
2020-09-30;BT;Bhutan;1;0;282;0
2020-10-01;BT;Bhutan;0;0;282;0
2020-10-02;BT;Bhutan;1;0;283;0
2020-10-03;BT;Bhutan;0;0;283;0
2020-10-04;BT;Bhutan;15;0;298;0
2020-10-05;BT;Bhutan;1;0;299;0
2020-10-06;BT;Bhutan;1;0;300;0
2020-10-07;BT;Bhutan;4;0;304;0
2020-10-08;BT;Bhutan;0;0;304;0
2020-10-09;BT;Bhutan;2;0;306;0
2020-10-10;BT;Bhutan;0;0;306;0
2020-10-11;BT;Bhutan;3;0;309;0
2020-10-12;BT;Bhutan;0;0;309;0
2020-10-13;BT;Bhutan;4;0;313;0
2020-10-14;BT;Bhutan;3;0;316;0
2020-10-15;BT;Bhutan;0;0;316;0
2020-10-16;BT;Bhutan;0;0;316;0
2020-10-17;BT;Bhutan;9;0;325;0
2020-10-18;BT;Bhutan;2;0;327;0
2020-10-19;BT;Bhutan;3;0;330;0
2020-10-20;BT;Bhutan;1;0;331;0
2020-10-21;BT;Bhutan;1;0;332;0
2020-10-22;BT;Bhutan;4;0;336;0
2020-10-23;BT;Bhutan;0;0;336;0
2020-10-24;BT;Bhutan;4;0;340;0
2020-10-25;BT;Bhutan;2;0;342;0
2020-10-26;BT;Bhutan;0;0;342;0
2020-10-27;BT;Bhutan;3;0;345;0
2020-10-28;BT;Bhutan;1;0;346;0
2020-10-29;BT;Bhutan;0;0;346;0
2020-10-30;BT;Bhutan;2;0;348;0
2020-10-31;BT;Bhutan;1;0;349;0
2020-11-01;BT;Bhutan;5;0;354;0
2020-11-02;BT;Bhutan;2;0;356;0
2020-11-03;BT;Bhutan;2;0;358;0
2020-11-04;BT;Bhutan;0;0;358;0
2020-11-05;BT;Bhutan;0;0;358;0
2020-11-06;BT;Bhutan;0;0;358;0
2020-11-07;BT;Bhutan;1;0;359;0
2020-11-08;BT;Bhutan;0;0;359;0
2020-11-09;BT;Bhutan;5;0;364;0
2020-11-10;BT;Bhutan;0;0;364;0
2020-11-11;BT;Bhutan;0;0;364;0
2020-11-12;BT;Bhutan;5;0;369;0
2020-11-13;BT;Bhutan;0;0;369;0
2020-11-14;BT;Bhutan;6;0;375;0
2020-11-15;BT;Bhutan;0;0;375;0
2020-11-16;BT;Bhutan;2;0;377;0
2020-11-17;BT;Bhutan;1;0;378;0
2020-11-18;BT;Bhutan;0;0;378;0
2020-11-19;BT;Bhutan;0;0;378;0
2020-11-20;BT;Bhutan;0;0;378;0
2020-11-21;BT;Bhutan;1;0;379;0
2020-11-22;BT;Bhutan;3;0;382;0
2020-11-23;BT;Bhutan;4;0;386;0
2020-11-24;BT;Bhutan;0;0;386;0
2020-11-25;BT;Bhutan;0;0;386;0
2020-11-26;BT;Bhutan;3;0;389;0
2020-11-27;BT;Bhutan;6;0;395;0
2020-11-28;BT;Bhutan;1;0;396;0
2020-11-29;BT;Bhutan;0;0;396;0
2020-11-30;BT;Bhutan;14;0;410;0
2020-12-01;BT;Bhutan;4;0;414;0
2020-12-02;BT;Bhutan;1;0;415;0
2020-12-03;BT;Bhutan;3;0;418;0
2020-12-04;BT;Bhutan;6;0;424;0
2020-12-05;BT;Bhutan;2;0;426;0
2020-12-06;BT;Bhutan;4;0;430;0
2020-12-07;BT;Bhutan;2;0;432;0
2020-12-08;BT;Bhutan;1;0;433;0
2020-12-09;BT;Bhutan;0;0;433;0
2020-12-10;BT;Bhutan;1;0;434;0
2020-12-11;BT;Bhutan;2;0;436;0
2020-12-12;BT;Bhutan;1;0;437;0
2020-12-13;BT;Bhutan;1;0;438;0
2020-12-14;BT;Bhutan;0;0;438;0
2020-12-15;BT;Bhutan;1;0;439;0
2020-12-16;BT;Bhutan;1;0;440;0
2020-12-17;BT;Bhutan;0;0;440;0
2020-12-18;BT;Bhutan;3;0;443;0
2020-12-19;BT;Bhutan;0;0;443;0
2020-12-20;BT;Bhutan;3;0;446;0
2020-12-21;BT;Bhutan;33;0;479;0
2020-12-22;BT;Bhutan;0;0;479;0
2020-12-23;BT;Bhutan;40;0;519;0
2020-12-24;BT;Bhutan;0;0;519;0
2020-12-25;BT;Bhutan;57;0;576;0
2020-12-26;BT;Bhutan;21;0;597;0
2020-12-27;BT;Bhutan;26;0;623;0
2020-12-28;BT;Bhutan;0;0;623;0
2020-12-29;BT;Bhutan;13;0;636;0
2020-12-30;BT;Bhutan;19;0;655;0
2020-12-31;BT;Bhutan;15;0;670;0
2021-01-01;BT;Bhutan;19;0;689;0
2021-01-02;BT;Bhutan;21;0;710;0
2021-01-03;BT;Bhutan;6;0;716;0
2021-01-04;BT;Bhutan;18;0;734;0
2021-01-05;BT;Bhutan;0;0;734;0
2021-01-06;BT;Bhutan;21;0;755;0
2021-01-07;BT;Bhutan;12;0;767;0
2021-01-08;BT;Bhutan;4;1;771;1
2021-01-09;BT;Bhutan;39;0;810;1
2021-01-10;BT;Bhutan;3;0;813;1
2021-01-11;BT;Bhutan;12;0;825;1
2021-01-12;BT;Bhutan;6;0;831;1
2021-01-13;BT;Bhutan;2;0;833;1
2021-01-14;BT;Bhutan;1;0;834;1
2021-01-15;BT;Bhutan;3;0;837;1
2021-01-16;BT;Bhutan;5;0;842;1
2021-01-17;BT;Bhutan;0;0;842;1
2021-01-18;BT;Bhutan;1;0;843;1
2021-01-19;BT;Bhutan;5;0;848;1
2021-01-20;BT;Bhutan;2;0;850;1
2021-01-21;BT;Bhutan;0;0;850;1
2021-01-22;BT;Bhutan;1;0;851;1
2021-01-23;BT;Bhutan;3;0;854;1
2021-01-24;BT;Bhutan;1;0;855;1
2021-01-25;BT;Bhutan;1;0;856;1
2021-01-26;BT;Bhutan;0;0;856;1
2021-01-27;BT;Bhutan;0;0;856;1
2021-01-28;BT;Bhutan;1;0;857;1
2021-01-29;BT;Bhutan;1;0;858;1
2021-01-30;BT;Bhutan;0;0;858;1
2021-01-31;BT;Bhutan;1;0;859;1
2021-02-01;BT;Bhutan;0;0;859;1
2021-02-02;BT;Bhutan;0;0;859;1
2021-02-03;BT;Bhutan;0;0;859;1
2021-02-04;BT;Bhutan;0;0;859;1
2021-02-05;BT;Bhutan;2;0;861;1
2021-02-06;BT;Bhutan;0;0;861;1
2021-02-07;BT;Bhutan;0;0;861;1
2021-02-08;BT;Bhutan;0;0;861;1
2021-02-09;BT;Bhutan;0;0;861;1
2021-02-10;BT;Bhutan;0;0;861;1
2021-02-11;BT;Bhutan;0;0;861;1
2021-02-12;BT;Bhutan;2;0;863;1
2021-02-13;BT;Bhutan;0;0;863;1
2021-02-14;BT;Bhutan;1;0;864;1
2021-02-15;BT;Bhutan;2;0;866;1
2021-02-16;BT;Bhutan;0;0;866;1
2021-02-17;BT;Bhutan;0;0;866;1
2021-02-18;BT;Bhutan;0;0;866;1
2021-02-19;BT;Bhutan;0;0;866;1
2021-02-20;BT;Bhutan;0;0;866;1
2021-02-21;BT;Bhutan;0;0;866;1
2021-02-22;BT;Bhutan;0;0;866;1
2021-02-23;BT;Bhutan;1;0;867;1
2021-02-24;BT;Bhutan;0;0;867;1
2021-02-25;BT;Bhutan;0;0;867;1
2021-02-26;BT;Bhutan;0;0;867;1
2021-02-27;BT;Bhutan;0;0;867;1
2021-02-28;BT;Bhutan;0;0;867;1
2021-03-01;BT;Bhutan;0;0;867;1
2021-03-02;BT;Bhutan;0;0;867;1
2021-03-03;BT;Bhutan;0;0;867;1
2021-03-04;BT;Bhutan;0;0;867;1
2021-03-05;BT;Bhutan;0;0;867;1
2021-03-06;BT;Bhutan;1;0;868;1
2021-03-07;BT;Bhutan;0;0;868;1
2021-03-08;BT;Bhutan;0;0;868;1
2021-03-09;BT;Bhutan;0;0;868;1
2021-03-10;BT;Bhutan;0;0;868;1
2021-03-11;BT;Bhutan;0;0;868;1
2021-03-12;BT;Bhutan;0;0;868;1
2021-03-13;BT;Bhutan;0;0;868;1
2021-03-14;BT;Bhutan;0;0;868;1
2021-03-15;BT;Bhutan;0;0;868;1
2021-03-16;BT;Bhutan;0;0;868;1
2021-03-17;BT;Bhutan;0;0;868;1
2021-03-18;BT;Bhutan;0;0;868;1
2021-03-19;BT;Bhutan;0;0;868;1
2021-03-20;BT;Bhutan;1;0;869;1
2021-03-21;BT;Bhutan;0;0;869;1
2021-03-22;BT;Bhutan;0;0;869;1
2021-03-23;BT;Bhutan;0;0;869;1
2021-03-24;BT;Bhutan;1;0;870;1
2021-03-25;BT;Bhutan;0;0;870;1
2021-03-26;BT;Bhutan;0;0;870;1
2021-03-27;BT;Bhutan;1;0;871;1
2021-03-28;BT;Bhutan;1;0;872;1
2021-03-29;BT;Bhutan;0;0;872;1
2021-03-30;BT;Bhutan;0;0;872;1
2021-03-31;BT;Bhutan;1;0;873;1
2021-04-01;BT;Bhutan;13;0;886;1
2021-04-02;BT;Bhutan;3;0;889;1
2021-04-03;BT;Bhutan;2;0;891;1
2021-04-04;BT;Bhutan;0;0;891;1
2021-04-05;BT;Bhutan;0;0;891;1
2021-04-06;BT;Bhutan;5;0;896;1
2021-04-07;BT;Bhutan;4;0;900;1
2021-04-08;BT;Bhutan;0;0;900;1
2021-04-09;BT;Bhutan;6;0;906;1
2021-04-10;BT;Bhutan;4;0;910;1
2021-04-11;BT;Bhutan;8;0;918;1
2021-04-12;BT;Bhutan;3;0;921;1
2021-04-13;BT;Bhutan;6;0;927;1
2021-04-14;BT;Bhutan;2;0;929;1
2021-04-15;BT;Bhutan;5;0;934;1
2021-04-16;BT;Bhutan;7;0;941;1
2021-04-17;BT;Bhutan;11;0;952;1
2021-04-18;BT;Bhutan;5;0;957;1
2021-04-19;BT;Bhutan;4;0;961;1
2021-04-20;BT;Bhutan;5;0;966;1
2021-04-21;BT;Bhutan;20;0;986;1
2021-04-22;BT;Bhutan;6;0;992;1
2021-04-23;BT;Bhutan;16;0;1008;1
2021-04-24;BT;Bhutan;10;0;1018;1
2021-04-25;BT;Bhutan;4;0;1022;1
2021-04-26;BT;Bhutan;4;0;1026;1
2021-04-27;BT;Bhutan;27;0;1053;1
2021-04-28;BT;Bhutan;6;0;1059;1
2021-04-29;BT;Bhutan;7;0;1066;1
2021-04-30;BT;Bhutan;8;0;1074;1
2021-05-01;BT;Bhutan;32;0;1106;1
2021-05-02;BT;Bhutan;5;0;1111;1
2021-05-03;BT;Bhutan;8;0;1119;1
2021-05-04;BT;Bhutan;16;0;1135;1
2021-05-05;BT;Bhutan;9;0;1144;1
2021-05-06;BT;Bhutan;17;0;1161;1
2021-05-07;BT;Bhutan;29;0;1190;1
2021-05-08;BT;Bhutan;12;0;1202;1
2021-05-09;BT;Bhutan;19;0;1221;1
2021-05-10;BT;Bhutan;20;0;1241;1
2021-05-11;BT;Bhutan;6;0;1247;1
2021-05-12;BT;Bhutan;10;0;1257;1
2021-05-13;BT;Bhutan;6;0;1263;1
2021-05-14;BT;Bhutan;13;0;1276;1
2021-05-15;BT;Bhutan;3;0;1279;1
2021-05-16;BT;Bhutan;7;0;1286;1
2021-05-17;BT;Bhutan;10;0;1296;1
2021-05-18;BT;Bhutan;13;0;1309;1
2021-05-19;BT;Bhutan;13;0;1322;1
2021-05-20;BT;Bhutan;16;0;1338;1
2021-05-21;BT;Bhutan;36;0;1374;1
2021-05-22;BT;Bhutan;18;0;1392;1
2021-05-23;BT;Bhutan;2;0;1394;1
2021-05-24;BT;Bhutan;17;0;1411;1
2021-05-25;BT;Bhutan;12;0;1423;1
2021-05-26;BT;Bhutan;41;0;1464;1
2021-05-27;BT;Bhutan;27;0;1491;1
2021-05-28;BT;Bhutan;12;0;1503;1
2021-05-29;BT;Bhutan;100;0;1603;1
2021-05-30;BT;Bhutan;9;0;1612;1
2021-05-31;BT;Bhutan;8;0;1620;1
2021-06-01;BT;Bhutan;12;0;1632;1
2021-06-02;BT;Bhutan;7;0;1639;1
2021-06-03;BT;Bhutan;15;0;1654;1
2021-06-04;BT;Bhutan;15;0;1669;1
2021-06-05;BT;Bhutan;13;0;1682;1
2021-06-06;BT;Bhutan;5;0;1687;1
2021-06-07;BT;Bhutan;16;0;1703;1
2021-06-08;BT;Bhutan;21;0;1724;1
2021-06-09;BT;Bhutan;15;0;1739;1
2021-06-10;BT;Bhutan;30;0;1769;1
2021-06-11;BT;Bhutan;20;0;1789;1
2021-06-12;BT;Bhutan;19;0;1808;1
2021-06-13;BT;Bhutan;5;0;1813;1
2021-06-14;BT;Bhutan;13;0;1826;1
2021-06-15;BT;Bhutan;16;0;1842;1
2021-06-16;BT;Bhutan;12;0;1854;1
2021-06-17;BT;Bhutan;28;0;1882;1
2021-06-18;BT;Bhutan;7;0;1889;1
2021-06-19;BT;Bhutan;14;0;1903;1
2021-06-20;BT;Bhutan;21;0;1924;1
2021-06-21;BT;Bhutan;15;0;1939;1
2021-06-22;BT;Bhutan;24;0;1963;1
2021-06-23;BT;Bhutan;7;0;1970;1
2021-06-24;BT;Bhutan;36;0;2006;1
2021-06-25;BT;Bhutan;7;0;2013;1
2021-06-26;BT;Bhutan;14;0;2027;1
2021-06-27;BT;Bhutan;25;0;2052;1
2021-06-28;BT;Bhutan;10;0;2062;1
2021-06-29;BT;Bhutan;14;0;2076;1
2021-06-30;BT;Bhutan;24;0;2100;1
2021-07-01;BT;Bhutan;4;0;2104;1
2020-03-11;BO;Bolivia;2;0;2;0
2020-03-12;BO;Bolivia;0;0;2;0
2020-03-13;BO;Bolivia;1;0;3;0
2020-03-14;BO;Bolivia;7;0;10;0
2020-03-15;BO;Bolivia;0;0;10;0
2020-03-16;BO;Bolivia;1;0;11;0
2020-03-17;BO;Bolivia;0;0;11;0
2020-03-18;BO;Bolivia;1;0;12;0
2020-03-19;BO;Bolivia;0;0;12;0
2020-03-20;BO;Bolivia;3;0;15;0
2020-03-21;BO;Bolivia;4;0;19;0
2020-03-22;BO;Bolivia;5;0;24;0
2020-03-23;BO;Bolivia;3;0;27;0
2020-03-24;BO;Bolivia;2;0;29;0
2020-03-25;BO;Bolivia;3;0;32;0
2020-03-26;BO;Bolivia;11;0;43;0
2020-03-27;BO;Bolivia;18;0;61;0
2020-03-28;BO;Bolivia;13;0;74;0
2020-03-29;BO;Bolivia;7;1;81;1
2020-03-30;BO;Bolivia;16;3;97;4
2020-03-31;BO;Bolivia;10;2;107;6
2020-04-01;BO;Bolivia;8;1;115;7
2020-04-02;BO;Bolivia;8;1;123;8
2020-04-03;BO;Bolivia;9;1;132;9
2020-04-04;BO;Bolivia;7;1;139;10
2020-04-05;BO;Bolivia;18;0;157;10
2020-04-06;BO;Bolivia;26;1;183;11
2020-04-07;BO;Bolivia;11;3;194;14
2020-04-08;BO;Bolivia;16;1;210;15
2020-04-09;BO;Bolivia;54;3;264;18
2020-04-10;BO;Bolivia;4;1;268;19
2020-04-11;BO;Bolivia;7;1;275;20
2020-04-12;BO;Bolivia;25;4;300;24
2020-04-13;BO;Bolivia;30;3;330;27
2020-04-14;BO;Bolivia;24;1;354;28
2020-04-15;BO;Bolivia;43;0;397;28
2020-04-16;BO;Bolivia;44;1;441;29
2020-04-17;BO;Bolivia;24;2;465;31
2020-04-18;BO;Bolivia;28;0;493;31
2020-04-19;BO;Bolivia;27;1;520;32
2020-04-20;BO;Bolivia;44;1;564;33
2020-04-21;BO;Bolivia;34;1;598;34
2020-04-22;BO;Bolivia;11;3;609;37
2020-04-23;BO;Bolivia;94;6;703;43
2020-04-24;BO;Bolivia;104;1;807;44
2020-04-25;BO;Bolivia;59;2;866;46
2020-04-26;BO;Bolivia;84;4;950;50
2020-04-27;BO;Bolivia;64;3;1014;53
2020-04-28;BO;Bolivia;39;2;1053;55
2020-04-29;BO;Bolivia;57;4;1110;59
2020-04-30;BO;Bolivia;57;3;1167;62
2020-05-01;BO;Bolivia;62;4;1229;66
2020-05-02;BO;Bolivia;241;5;1470;71
2020-05-03;BO;Bolivia;124;5;1594;76
2020-05-04;BO;Bolivia;87;6;1681;82
2020-05-05;BO;Bolivia;121;4;1802;86
2020-05-06;BO;Bolivia;84;5;1886;91
2020-05-07;BO;Bolivia;195;11;2081;102
2020-05-08;BO;Bolivia;185;4;2266;106
2020-05-09;BO;Bolivia;171;8;2437;114
2020-05-10;BO;Bolivia;119;4;2556;118
2020-05-11;BO;Bolivia;275;4;2831;122
2020-05-12;BO;Bolivia;133;6;2964;128
2020-05-13;BO;Bolivia;184;14;3148;142
2020-05-14;BO;Bolivia;224;10;3372;152
2020-05-15;BO;Bolivia;205;12;3577;164
2020-05-16;BO;Bolivia;249;1;3826;165
2020-05-17;BO;Bolivia;262;4;4088;169
2020-05-18;BO;Bolivia;175;5;4263;174
2020-05-19;BO;Bolivia;218;15;4481;189
2020-05-20;BO;Bolivia;438;10;4919;199
2020-05-21;BO;Bolivia;268;16;5187;215
2020-05-22;BO;Bolivia;392;15;5579;230
2020-05-23;BO;Bolivia;336;10;5915;240
2020-05-24;BO;Bolivia;348;10;6263;250
2020-05-25;BO;Bolivia;397;11;6660;261
2020-05-26;BO;Bolivia;476;13;7136;274
2020-05-27;BO;Bolivia;632;6;7768;280
2020-05-28;BO;Bolivia;619;13;8387;293
2020-05-29;BO;Bolivia;344;7;8731;300
2020-05-30;BO;Bolivia;861;10;9592;310
2020-05-31;BO;Bolivia;390;3;9982;313
2020-06-01;BO;Bolivia;549;30;10531;343
2020-06-02;BO;Bolivia;460;33;10991;376
2020-06-03;BO;Bolivia;647;24;11638;400
2020-06-04;BO;Bolivia;607;15;12245;415
2020-06-05;BO;Bolivia;483;12;12728;427
2020-06-06;BO;Bolivia;630;27;13358;454
2020-06-07;BO;Bolivia;285;11;13643;465
2020-06-08;BO;Bolivia;306;10;13949;475
2020-06-09;BO;Bolivia;695;12;14644;487
2020-06-10;BO;Bolivia;637;25;15281;512
2020-06-11;BO;Bolivia;884;21;16165;533
2020-06-12;BO;Bolivia;764;26;16929;559
2020-06-13;BO;Bolivia;913;26;17842;585
2020-06-14;BO;Bolivia;617;26;18459;611
2020-06-15;BO;Bolivia;614;21;19073;632
2020-06-16;BO;Bolivia;810;27;19883;659
2020-06-17;BO;Bolivia;802;20;20685;679
2020-06-18;BO;Bolivia;814;18;21499;697
2020-06-19;BO;Bolivia;977;18;22476;715
2020-06-20;BO;Bolivia;1036;25;23512;740
2020-06-21;BO;Bolivia;876;33;24388;773
2020-06-22;BO;Bolivia;1105;47;25493;820
2020-06-23;BO;Bolivia;896;26;26389;846
2020-06-24;BO;Bolivia;1098;30;27487;876
2020-06-25;BO;Bolivia;1016;37;28503;913
2020-06-26;BO;Bolivia;920;21;29423;934
2020-06-27;BO;Bolivia;1253;36;30676;970
2020-06-28;BO;Bolivia;848;44;31524;1014
2020-06-29;BO;Bolivia;601;57;32125;1071
2020-06-30;BO;Bolivia;1094;52;33219;1123
2020-07-01;BO;Bolivia;1008;78;34227;1201
2020-07-02;BO;Bolivia;1301;70;35528;1271
2020-07-03;BO;Bolivia;1290;49;36818;1320
2020-07-04;BO;Bolivia;1253;58;38071;1378
2020-07-05;BO;Bolivia;1226;56;39297;1434
2020-07-06;BO;Bolivia;1212;42;40509;1476
2020-07-07;BO;Bolivia;1036;54;41545;1530
2020-07-08;BO;Bolivia;1439;47;42984;1577
2020-07-09;BO;Bolivia;1129;61;44113;1638
2020-07-10;BO;Bolivia;1452;64;45565;1702
2020-07-11;BO;Bolivia;1635;52;47200;1754
2020-07-12;BO;Bolivia;987;53;48187;1807
2020-07-13;BO;Bolivia;1063;59;49250;1866
2020-07-14;BO;Bolivia;1617;32;50867;1898
2020-07-15;BO;Bolivia;1351;44;52218;1942
2020-07-16;BO;Bolivia;1938;42;54156;1984
2020-07-17;BO;Bolivia;1946;65;56102;2049
2020-07-18;BO;Bolivia;2036;57;58138;2106
2020-07-19;BO;Bolivia;1444;45;59582;2151
2020-07-20;BO;Bolivia;1409;67;60991;2218
2020-07-21;BO;Bolivia;1366;55;62357;2273
2020-07-22;BO;Bolivia;1778;55;64135;2328
2020-07-23;BO;Bolivia;1117;79;65252;2407
2020-07-24;BO;Bolivia;1204;66;66456;2473
2020-07-25;BO;Bolivia;1825;62;68281;2535
2020-07-26;BO;Bolivia;1148;48;69429;2583
2020-07-27;BO;Bolivia;1752;64;71181;2647
2020-07-28;BO;Bolivia;1146;73;72327;2720
2020-07-29;BO;Bolivia;1207;88;73534;2808
2020-07-30;BO;Bolivia;1700;86;75234;2894
2020-07-31;BO;Bolivia;1555;83;76789;2977
2020-08-01;BO;Bolivia;2004;87;78793;3064
2020-08-02;BO;Bolivia;1360;89;80153;3153
2020-08-03;BO;Bolivia;1693;75;81846;3228
2020-08-04;BO;Bolivia;1515;92;83361;3320
2020-08-05;BO;Bolivia;1780;65;85141;3385
2020-08-06;BO;Bolivia;1282;80;86423;3465
2020-08-07;BO;Bolivia;1468;59;87891;3524
2020-08-08;BO;Bolivia;1164;63;89055;3587
2020-08-09;BO;Bolivia;944;53;89999;3640
2020-08-10;BO;Bolivia;1636;72;91635;3712
2020-08-11;BO;Bolivia;1693;49;93328;3761
2020-08-12;BO;Bolivia;1743;66;95071;3827
2020-08-13;BO;Bolivia;1388;57;96459;3884
2020-08-14;BO;Bolivia;1491;55;97950;3939
2020-08-15;BO;Bolivia;1196;64;99146;4003
2020-08-16;BO;Bolivia;1198;55;100344;4058
2020-08-17;BO;Bolivia;879;65;101223;4123
2020-08-18;BO;Bolivia;1796;49;103019;4172
2020-08-19;BO;Bolivia;2031;61;105050;4233
2020-08-20;BO;Bolivia;1015;72;106065;4305
2020-08-21;BO;Bolivia;1370;61;107435;4366
2020-08-22;BO;Bolivia;992;76;108427;4442
2020-08-23;BO;Bolivia;722;67;109149;4509
2020-08-24;BO;Bolivia;999;69;110148;4578
2020-08-25;BO;Bolivia;851;86;110999;4664
2020-08-26;BO;Bolivia;1095;62;112094;4726
2020-08-27;BO;Bolivia;1035;65;113129;4791
2020-08-28;BO;Bolivia;1280;55;114409;4846
2020-08-29;BO;Bolivia;945;92;115354;4938
2020-08-30;BO;Bolivia;614;28;115968;4966
2020-08-31;BO;Bolivia;630;61;116598;5027
2020-09-01;BO;Bolivia;669;74;117267;5101
2020-09-02;BO;Bolivia;661;102;117928;5203
2020-09-03;BO;Bolivia;853;85;118781;5288
2020-09-04;BO;Bolivia;799;55;119580;5343
2020-09-05;BO;Bolivia;661;55;120241;5398
2020-09-06;BO;Bolivia;528;0;120769;5398
2020-09-07;BO;Bolivia;835;1656;121604;7054
2020-09-08;BO;Bolivia;704;43;122308;7097
2020-09-09;BO;Bolivia;1037;49;123345;7146
2020-09-10;BO;Bolivia;860;47;124205;7193
2020-09-11;BO;Bolivia;967;57;125172;7250
2020-09-12;BO;Bolivia;810;47;125982;7297
2020-09-13;BO;Bolivia;809;47;126791;7344
2020-09-14;BO;Bolivia;828;50;127619;7394
2020-09-15;BO;Bolivia;667;53;128286;7447
2020-09-16;BO;Bolivia;586;31;128872;7478
2020-09-17;BO;Bolivia;547;33;129419;7511
2020-09-18;BO;Bolivia;632;39;130051;7550
2020-09-19;BO;Bolivia;419;36;130470;7586
2020-09-20;BO;Bolivia;206;31;130676;7617
2020-09-21;BO;Bolivia;310;37;130986;7654
2020-09-22;BO;Bolivia;467;39;131453;7693
2020-09-23;BO;Bolivia;537;38;131990;7731
2020-09-24;BO;Bolivia;628;34;132618;7765
2020-09-25;BO;Bolivia;604;35;133222;7800
2020-09-26;BO;Bolivia;370;28;133592;7828
2020-09-27;BO;Bolivia;309;30;133901;7858
2020-09-28;BO;Bolivia;322;42;134223;7900
2020-09-29;BO;Bolivia;418;31;134641;7931
2020-09-30;BO;Bolivia;670;34;135311;7965
2020-10-01;BO;Bolivia;405;36;135716;8001
2020-10-02;BO;Bolivia;503;44;136219;8045
2020-10-03;BO;Bolivia;350;28;136569;8073
2020-10-04;BO;Bolivia;299;28;136868;8101
2020-10-05;BO;Bolivia;239;28;137107;8129
2020-10-06;BO;Bolivia;361;27;137468;8156
2020-10-07;BO;Bolivia;238;36;137706;8192
2020-10-08;BO;Bolivia;263;36;137969;8228
2020-10-09;BO;Bolivia;257;34;138226;8262
2020-10-10;BO;Bolivia;237;30;138463;8292
2020-10-11;BO;Bolivia;111;16;138574;8308
2020-10-12;BO;Bolivia;121;18;138695;8326
2020-10-13;BO;Bolivia;227;25;138922;8351
2020-10-14;BO;Bolivia;219;26;139141;8377
2020-10-15;BO;Bolivia;178;30;139319;8407
2020-10-16;BO;Bolivia;243;32;139562;8439
2020-10-17;BO;Bolivia;148;24;139710;8463
2020-10-18;BO;Bolivia;61;18;139771;8481
2020-10-19;BO;Bolivia;119;21;139890;8502
2020-10-20;BO;Bolivia;147;24;140037;8526
2020-10-21;BO;Bolivia;191;32;140228;8558
2020-10-22;BO;Bolivia;217;26;140445;8584
2020-10-23;BO;Bolivia;167;24;140612;8608
2020-10-24;BO;Bolivia;167;19;140779;8627
2020-10-25;BO;Bolivia;74;18;140853;8645
2020-10-26;BO;Bolivia;99;13;140952;8658
2020-10-27;BO;Bolivia;172;14;141124;8672
2020-10-28;BO;Bolivia;197;22;141321;8694
2020-10-29;BO;Bolivia;163;11;141484;8705
2020-10-30;BO;Bolivia;147;10;141631;8715
2020-10-31;BO;Bolivia;126;10;141757;8725
2020-11-01;BO;Bolivia;76;6;141833;8731
2020-11-02;BO;Bolivia;34;10;141867;8741
2020-11-03;BO;Bolivia;69;10;141936;8751
2020-11-04;BO;Bolivia;126;7;142062;8758
2020-11-05;BO;Bolivia;139;10;142201;8768
2020-11-06;BO;Bolivia;142;13;142343;8781
2020-11-07;BO;Bolivia;84;9;142427;8790
2020-11-08;BO;Bolivia;48;5;142475;8795
2020-11-09;BO;Bolivia;86;7;142561;8802
2020-11-10;BO;Bolivia;103;6;142664;8808
2020-11-11;BO;Bolivia;112;10;142776;8818
2020-11-12;BO;Bolivia;113;7;142889;8825
2020-11-13;BO;Bolivia;180;10;143069;8835
2020-11-14;BO;Bolivia;112;6;143181;8841
2020-11-15;BO;Bolivia;65;8;143246;8849
2020-11-16;BO;Bolivia;125;10;143371;8859
2020-11-17;BO;Bolivia;102;7;143473;8866
2020-11-18;BO;Bolivia;96;9;143569;8875
2020-11-19;BO;Bolivia;187;14;143756;8889
2020-11-20;BO;Bolivia;98;11;143854;8900
2020-11-21;BO;Bolivia;68;4;143922;8904
2020-11-22;BO;Bolivia;56;3;143978;8907
2020-11-23;BO;Bolivia;56;9;144034;8916
2020-11-24;BO;Bolivia;113;12;144147;8928
2020-11-25;BO;Bolivia;129;5;144276;8933
2020-11-26;BO;Bolivia;114;6;144390;8939
2020-11-27;BO;Bolivia;104;4;144494;8943
2020-11-28;BO;Bolivia;98;6;144592;8949
2020-11-29;BO;Bolivia;30;3;144622;8952
2020-11-30;BO;Bolivia;86;5;144708;8957
2020-12-01;BO;Bolivia;102;6;144810;8963
2020-12-02;BO;Bolivia;184;9;144994;8972
2020-12-03;BO;Bolivia;192;10;145186;8982
2020-12-04;BO;Bolivia;139;5;145325;8987
2020-12-05;BO;Bolivia;167;5;145492;8992
2020-12-06;BO;Bolivia;68;3;145560;8995
2020-12-07;BO;Bolivia;97;2;145657;8997
2020-12-08;BO;Bolivia;189;5;145846;9002
2020-12-09;BO;Bolivia;214;2;146060;9004
2020-12-10;BO;Bolivia;325;4;146385;9008
2020-12-11;BO;Bolivia;312;5;146697;9013
2020-12-12;BO;Bolivia;333;1;147030;9014
2020-12-13;BO;Bolivia;120;4;147150;9018
2020-12-14;BO;Bolivia;195;6;147345;9024
2020-12-15;BO;Bolivia;371;2;147716;9026
2020-12-16;BO;Bolivia;498;3;148214;9029
2020-12-17;BO;Bolivia;451;2;148665;9031
2020-12-18;BO;Bolivia;484;2;149149;9033
2020-12-19;BO;Bolivia;621;2;149770;9035
2020-12-20;BO;Bolivia;253;1;150023;9036
2020-12-21;BO;Bolivia;362;7;150385;9043
2020-12-22;BO;Bolivia;674;9;151059;9052
2020-12-23;BO;Bolivia;1005;13;152064;9065
2020-12-24;BO;Bolivia;1057;11;153121;9076
2020-12-25;BO;Bolivia;469;7;153590;9083
2020-12-26;BO;Bolivia;759;10;154349;9093
2020-12-27;BO;Bolivia;494;5;154843;9098
2020-12-28;BO;Bolivia;751;8;155594;9106
2020-12-29;BO;Bolivia;1293;29;156887;9135
2020-12-30;BO;Bolivia;1485;14;158372;9149
2020-12-31;BO;Bolivia;1752;16;160124;9165
2021-01-01;BO;Bolivia;861;10;160985;9175
2021-01-02;BO;Bolivia;1070;11;162055;9186
2021-01-03;BO;Bolivia;606;15;162661;9201
2021-01-04;BO;Bolivia;1010;18;163671;9219
2021-01-05;BO;Bolivia;1597;22;165268;9241
2021-01-06;BO;Bolivia;1713;46;166981;9287
2021-01-07;BO;Bolivia;1910;17;168891;9304
2021-01-08;BO;Bolivia;2263;24;171154;9328
2021-01-09;BO;Bolivia;1644;23;172798;9351
2021-01-10;BO;Bolivia;1098;25;173896;9376
2021-01-11;BO;Bolivia;1392;39;175288;9415
2021-01-12;BO;Bolivia;1473;39;176761;9454
2021-01-13;BO;Bolivia;2057;39;178818;9493
2021-01-14;BO;Bolivia;2198;37;181016;9530
2021-01-15;BO;Bolivia;2573;41;183589;9571
2021-01-16;BO;Bolivia;2091;25;185680;9596
2021-01-17;BO;Bolivia;1503;40;187183;9636
2021-01-18;BO;Bolivia;1550;44;188733;9680
2021-01-19;BO;Bolivia;2357;42;191090;9722
2021-01-20;BO;Bolivia;2655;42;193745;9764
2021-01-21;BO;Bolivia;2648;54;196393;9818
2021-01-22;BO;Bolivia;1864;53;198257;9871
2021-01-23;BO;Bolivia;1732;56;199989;9927
2021-01-24;BO;Bolivia;1048;58;201037;9985
2021-01-25;BO;Bolivia;1781;66;202818;10051
2021-01-26;BO;Bolivia;2390;54;205208;10105
2021-01-27;BO;Bolivia;2866;62;208074;10167
2021-01-28;BO;Bolivia;2652;59;210726;10226
2021-01-29;BO;Bolivia;2666;53;213392;10279
2021-01-30;BO;Bolivia;2005;51;215397;10330
2021-01-31;BO;Bolivia;1438;49;216835;10379
2021-02-01;BO;Bolivia;1464;60;218299;10439
2021-02-02;BO;Bolivia;2127;74;220426;10513
2021-02-03;BO;Bolivia;2021;58;222447;10571
2021-02-04;BO;Bolivia;1787;62;224234;10633
2021-02-05;BO;Bolivia;1676;54;225910;10687
2021-02-06;BO;Bolivia;1218;66;227128;10753
2021-02-07;BO;Bolivia;839;43;227967;10796
2021-02-08;BO;Bolivia;1220;68;229187;10864
2021-02-09;BO;Bolivia;1544;65;230731;10929
2021-02-10;BO;Bolivia;1771;67;232502;10996
2021-02-11;BO;Bolivia;1352;48;233854;11044
2021-02-12;BO;Bolivia;1244;63;235098;11107
2021-02-13;BO;Bolivia;938;48;236036;11155
2021-02-14;BO;Bolivia;696;47;236732;11202
2021-02-15;BO;Bolivia;412;32;237144;11234
2021-02-16;BO;Bolivia;562;40;237706;11274
2021-02-17;BO;Bolivia;789;29;238495;11303
2021-02-18;BO;Bolivia;1029;50;239524;11353
2021-02-19;BO;Bolivia;1152;37;240676;11390
2021-02-20;BO;Bolivia;1095;27;241771;11417
2021-02-21;BO;Bolivia;521;24;242292;11441
2021-02-22;BO;Bolivia;884;29;243176;11470
2021-02-23;BO;Bolivia;1204;38;244380;11508
2021-02-24;BO;Bolivia;1339;39;245719;11547
2021-02-25;BO;Bolivia;1103;30;246822;11577
2021-02-26;BO;Bolivia;1069;32;247891;11609
2021-02-27;BO;Bolivia;656;19;248547;11628
2021-02-28;BO;Bolivia;463;21;249010;11649
2021-03-01;BO;Bolivia;757;17;249767;11666
2021-03-02;BO;Bolivia;790;37;250557;11703
2021-03-03;BO;Bolivia;834;31;251391;11734
2021-03-04;BO;Bolivia;969;27;252360;11761
2021-03-05;BO;Bolivia;937;28;253297;11789
2021-03-06;BO;Bolivia;653;18;253950;11807
2021-03-07;BO;Bolivia;323;16;254273;11823
2021-03-08;BO;Bolivia;463;22;254736;11845
2021-03-09;BO;Bolivia;885;13;255621;11858
2021-03-10;BO;Bolivia;841;26;256462;11884
2021-03-11;BO;Bolivia;778;19;257240;11903
2021-03-12;BO;Bolivia;1084;27;258324;11930
2021-03-13;BO;Bolivia;680;14;259004;11944
2021-03-14;BO;Bolivia;385;14;259389;11958
2021-03-15;BO;Bolivia;670;16;260059;11974
2021-03-16;BO;Bolivia;929;23;260988;11997
2021-03-17;BO;Bolivia;1068;18;262056;12015
2021-03-18;BO;Bolivia;885;13;262941;12028
2021-03-19;BO;Bolivia;867;13;263808;12041
2021-03-20;BO;Bolivia;603;10;264411;12051
2021-03-21;BO;Bolivia;223;9;264634;12060
2021-03-22;BO;Bolivia;573;14;265207;12074
2021-03-23;BO;Bolivia;879;19;266086;12093
2021-03-24;BO;Bolivia;973;14;267059;12107
2021-03-25;BO;Bolivia;774;24;267833;12131
2021-03-26;BO;Bolivia;878;12;268711;12143
2021-03-27;BO;Bolivia;591;22;269302;12165
2021-03-28;BO;Bolivia;326;21;269628;12186
2021-03-29;BO;Bolivia;719;25;270347;12211
2021-03-30;BO;Bolivia;1072;28;271419;12239
2021-03-31;BO;Bolivia;992;18;272411;12257
2021-04-01;BO;Bolivia;916;23;273327;12280
2021-04-02;BO;Bolivia;620;25;273947;12305
2021-04-03;BO;Bolivia;520;11;274467;12316
2021-04-04;BO;Bolivia;467;8;274934;12324
2021-04-05;BO;Bolivia;458;20;275392;12344
2021-04-06;BO;Bolivia;1498;22;276890;12366
2021-04-07;BO;Bolivia;1076;19;277966;12385
2021-04-08;BO;Bolivia;1241;27;279207;12412
2021-04-09;BO;Bolivia;1442;16;280649;12428
2021-04-10;BO;Bolivia;921;14;281570;12442
2021-04-11;BO;Bolivia;525;9;282095;12451
2021-04-12;BO;Bolivia;989;18;283084;12469
2021-04-13;BO;Bolivia;1099;27;284183;12496
2021-04-14;BO;Bolivia;1108;23;285291;12519
2021-04-15;BO;Bolivia;823;84;286114;12603
2021-04-16;BO;Bolivia;1246;22;287360;12625
2021-04-17;BO;Bolivia;0;0;287360;12625
2021-04-18;BO;Bolivia;1706;23;289066;12648
2021-04-19;BO;Bolivia;1296;18;290362;12666
2021-04-20;BO;Bolivia;1313;29;291675;12695
2021-04-21;BO;Bolivia;1386;36;293061;12731
2021-04-22;BO;Bolivia;1330;27;294391;12758
2021-04-23;BO;Bolivia;1501;25;295892;12783
2021-04-24;BO;Bolivia;1293;29;297185;12812
2021-04-25;BO;Bolivia;474;12;297659;12824
2021-04-26;BO;Bolivia;1119;37;298778;12861
2021-04-27;BO;Bolivia;1480;24;300258;12885
2021-04-28;BO;Bolivia;1573;35;301831;12920
2021-04-29;BO;Bolivia;0;0;301831;12920
2021-04-30;BO;Bolivia;1901;31;303732;12951
2021-05-01;BO;Bolivia;2795;58;306527;13009
2021-05-02;BO;Bolivia;0;0;306527;13009
2021-05-03;BO;Bolivia;2457;26;308984;13035
2021-05-04;BO;Bolivia;0;0;308984;13035
2021-05-05;BO;Bolivia;1588;47;310572;13082
2021-05-06;BO;Bolivia;3618;69;314190;13151
2021-05-07;BO;Bolivia;0;0;314190;13151
2021-05-08;BO;Bolivia;3357;54;317547;13205
2021-05-09;BO;Bolivia;0;0;317547;13205
2021-05-10;BO;Bolivia;1063;23;318610;13228
2021-05-11;BO;Bolivia;1599;30;320209;13258
2021-05-12;BO;Bolivia;2369;50;322578;13308
2021-05-13;BO;Bolivia;2290;37;324868;13345
2021-05-14;BO;Bolivia;2356;64;327224;13409
2021-05-15;BO;Bolivia;2509;42;329733;13451
2021-05-16;BO;Bolivia;2834;66;332567;13517
2021-05-17;BO;Bolivia;2257;49;334824;13566
2021-05-18;BO;Bolivia;0;0;334824;13566
2021-05-19;BO;Bolivia;2617;69;337441;13635
2021-05-20;BO;Bolivia;2766;58;340207;13693
2021-05-21;BO;Bolivia;2858;87;343065;13780
2021-05-22;BO;Bolivia;3005;77;346070;13857
2021-05-23;BO;Bolivia;3583;108;349653;13965
2021-05-24;BO;Bolivia;0;0;349653;13965
2021-05-25;BO;Bolivia;5696;159;355349;14124
2021-05-26;BO;Bolivia;3213;102;358562;14226
2021-05-27;BO;Bolivia;3018;86;361580;14312
2021-05-28;BO;Bolivia;2990;65;364570;14377
2021-05-29;BO;Bolivia;2144;58;366714;14435
2021-05-30;BO;Bolivia;1760;36;368474;14471
2021-05-31;BO;Bolivia;2805;53;371279;14524
2021-06-01;BO;Bolivia;3439;115;374718;14639
2021-06-02;BO;Bolivia;3310;93;378028;14732
2021-06-03;BO;Bolivia;2429;100;380457;14832
2021-06-04;BO;Bolivia;3000;68;383457;14900
2021-06-05;BO;Bolivia;2277;81;385734;14981
2021-06-06;BO;Bolivia;1428;43;387162;15024
2021-06-07;BO;Bolivia;0;0;387162;15024
2021-06-08;BO;Bolivia;5813;153;392975;15177
2021-06-09;BO;Bolivia;0;0;392975;15177
2021-06-10;BO;Bolivia;7072;144;400047;15321
2021-06-11;BO;Bolivia;0;0;400047;15321
2021-06-12;BO;Bolivia;5300;164;405347;15485
2021-06-13;BO;Bolivia;1607;57;406954;15542
2021-06-14;BO;Bolivia;2152;72;409106;15614
2021-06-15;BO;Bolivia;2571;124;411677;15738
2021-06-16;BO;Bolivia;2836;88;414513;15826
2021-06-17;BO;Bolivia;2682;98;417195;15924
2021-06-18;BO;Bolivia;0;0;417195;15924
2021-06-19;BO;Bolivia;3766;164;420961;16088
2021-06-20;BO;Bolivia;1086;44;422047;16132
2021-06-21;BO;Bolivia;764;42;422811;16174
2021-06-22;BO;Bolivia;1667;69;424478;16243
2021-06-23;BO;Bolivia;2270;86;426748;16329
2021-06-24;BO;Bolivia;2430;85;429178;16414
2021-06-25;BO;Bolivia;2182;82;431360;16496
2021-06-26;BO;Bolivia;1653;55;433013;16551
2021-06-27;BO;Bolivia;922;30;433935;16581
2021-06-28;BO;Bolivia;1633;50;435568;16631
2021-06-29;BO;Bolivia;2055;71;437623;16702
2021-06-30;BO;Bolivia;2001;65;439624;16767
2021-07-01;BO;Bolivia;1662;55;441286;16822
2021-04-09;BQ;Bonaire Sint Eustatius and Saba;0;0;0;0
2020-03-05;BA;Bosnia and Herzegovina;2;0;2;0
2020-03-06;BA;Bosnia and Herzegovina;0;0;2;0
2020-03-07;BA;Bosnia and Herzegovina;1;0;3;0
2020-03-08;BA;Bosnia and Herzegovina;0;0;3;0
2020-03-09;BA;Bosnia and Herzegovina;0;0;3;0
2020-03-10;BA;Bosnia and Herzegovina;2;0;5;0
2020-03-11;BA;Bosnia and Herzegovina;2;0;7;0
2020-03-12;BA;Bosnia and Herzegovina;4;0;11;0
2020-03-13;BA;Bosnia and Herzegovina;2;0;13;0
2020-03-14;BA;Bosnia and Herzegovina;5;0;18;0
2020-03-15;BA;Bosnia and Herzegovina;6;0;24;0
2020-03-16;BA;Bosnia and Herzegovina;1;0;25;0
2020-03-17;BA;Bosnia and Herzegovina;1;0;26;0
2020-03-18;BA;Bosnia and Herzegovina;12;0;38;0
2020-03-19;BA;Bosnia and Herzegovina;25;0;63;0
2020-03-20;BA;Bosnia and Herzegovina;26;0;89;0
2020-03-21;BA;Bosnia and Herzegovina;4;1;93;1
2020-03-22;BA;Bosnia and Herzegovina;33;0;126;1
2020-03-23;BA;Bosnia and Herzegovina;10;0;136;1
2020-03-24;BA;Bosnia and Herzegovina;30;2;166;3
2020-03-25;BA;Bosnia and Herzegovina;10;0;176;3
2020-03-26;BA;Bosnia and Herzegovina;15;0;191;3
2020-03-27;BA;Bosnia and Herzegovina;46;1;237;4
2020-03-28;BA;Bosnia and Herzegovina;21;1;258;5
2020-03-29;BA;Bosnia and Herzegovina;65;1;323;6
2020-03-30;BA;Bosnia and Herzegovina;45;4;368;10
2020-03-31;BA;Bosnia and Herzegovina;52;3;420;13
2020-04-01;BA;Bosnia and Herzegovina;39;0;459;13
2020-04-02;BA;Bosnia and Herzegovina;74;3;533;16
2020-04-03;BA;Bosnia and Herzegovina;46;1;579;17
2020-04-04;BA;Bosnia and Herzegovina;45;4;624;21
2020-04-05;BA;Bosnia and Herzegovina;30;2;654;23
2020-04-06;BA;Bosnia and Herzegovina;20;6;674;29
2020-04-07;BA;Bosnia and Herzegovina;90;4;764;33
2020-04-08;BA;Bosnia and Herzegovina;40;1;804;34
2020-04-09;BA;Bosnia and Herzegovina;54;1;858;35
2020-04-10;BA;Bosnia and Herzegovina;43;1;901;36
2020-04-11;BA;Bosnia and Herzegovina;45;1;946;37
2020-04-12;BA;Bosnia and Herzegovina;63;2;1009;39
2020-04-13;BA;Bosnia and Herzegovina;28;0;1037;39
2020-04-14;BA;Bosnia and Herzegovina;46;1;1083;40
2020-04-15;BA;Bosnia and Herzegovina;27;1;1110;41
2020-04-16;BA;Bosnia and Herzegovina;57;2;1167;43
2020-04-17;BA;Bosnia and Herzegovina;47;3;1214;46
2020-04-18;BA;Bosnia and Herzegovina;54;1;1268;47
2020-04-19;BA;Bosnia and Herzegovina;17;1;1285;48
2020-04-20;BA;Bosnia and Herzegovina;24;1;1309;49
2020-04-21;BA;Bosnia and Herzegovina;33;2;1342;51
2020-04-22;BA;Bosnia and Herzegovina;26;2;1368;53
2020-04-23;BA;Bosnia and Herzegovina;45;1;1413;54
2020-04-24;BA;Bosnia and Herzegovina;8;1;1421;55
2020-04-25;BA;Bosnia and Herzegovina;65;2;1486;57
2020-04-26;BA;Bosnia and Herzegovina;30;2;1516;59
2020-04-27;BA;Bosnia and Herzegovina;49;1;1565;60
2020-04-28;BA;Bosnia and Herzegovina;20;3;1585;63
2020-04-29;BA;Bosnia and Herzegovina;92;2;1677;65
2020-04-30;BA;Bosnia and Herzegovina;80;4;1757;69
2020-05-01;BA;Bosnia and Herzegovina;24;1;1781;70
2020-05-02;BA;Bosnia and Herzegovina;58;2;1839;72
2020-05-03;BA;Bosnia and Herzegovina;18;5;1857;77
2020-05-04;BA;Bosnia and Herzegovina;69;1;1926;78
2020-05-05;BA;Bosnia and Herzegovina;20;1;1946;79
2020-05-06;BA;Bosnia and Herzegovina;41;7;1987;86
2020-05-07;BA;Bosnia and Herzegovina;40;4;2027;90
2020-05-08;BA;Bosnia and Herzegovina;43;8;2070;98
2020-05-09;BA;Bosnia and Herzegovina;20;4;2090;102
2020-05-10;BA;Bosnia and Herzegovina;27;5;2117;107
2020-05-11;BA;Bosnia and Herzegovina;24;6;2141;113
2020-05-12;BA;Bosnia and Herzegovina;17;4;2158;117
2020-05-13;BA;Bosnia and Herzegovina;23;3;2181;120
2020-05-14;BA;Bosnia and Herzegovina;37;2;2218;122
2020-05-15;BA;Bosnia and Herzegovina;18;6;2236;128
2020-05-16;BA;Bosnia and Herzegovina;31;1;2267;129
2020-05-17;BA;Bosnia and Herzegovina;23;4;2290;133
2020-05-18;BA;Bosnia and Herzegovina;14;0;2304;133
2020-05-19;BA;Bosnia and Herzegovina;17;1;2321;134
2020-05-20;BA;Bosnia and Herzegovina;17;2;2338;136
2020-05-21;BA;Bosnia and Herzegovina;12;4;2350;140
2020-05-22;BA;Bosnia and Herzegovina;22;1;2372;141
2020-05-23;BA;Bosnia and Herzegovina;19;0;2391;141
2020-05-24;BA;Bosnia and Herzegovina;10;3;2401;144
2020-05-25;BA;Bosnia and Herzegovina;5;2;2406;146
2020-05-26;BA;Bosnia and Herzegovina;10;3;2416;149
2020-05-27;BA;Bosnia and Herzegovina;19;2;2435;151
2020-05-28;BA;Bosnia and Herzegovina;27;2;2462;153
2020-05-29;BA;Bosnia and Herzegovina;23;0;2485;153
2020-05-30;BA;Bosnia and Herzegovina;9;0;2494;153
2020-05-31;BA;Bosnia and Herzegovina;16;0;2510;153
2020-06-01;BA;Bosnia and Herzegovina;14;1;2524;154
2020-06-02;BA;Bosnia and Herzegovina;11;3;2535;157
2020-06-03;BA;Bosnia and Herzegovina;16;0;2551;157
2020-06-04;BA;Bosnia and Herzegovina;43;2;2594;159
2020-06-05;BA;Bosnia and Herzegovina;12;0;2606;159
2020-06-06;BA;Bosnia and Herzegovina;0;0;2606;159
2020-06-07;BA;Bosnia and Herzegovina;0;0;2606;159
2020-06-08;BA;Bosnia and Herzegovina;98;1;2704;160
2020-06-09;BA;Bosnia and Herzegovina;24;0;2728;160
2020-06-10;BA;Bosnia and Herzegovina;47;1;2775;161
2020-06-11;BA;Bosnia and Herzegovina;57;0;2832;161
2020-06-12;BA;Bosnia and Herzegovina;61;2;2893;163
2020-06-13;BA;Bosnia and Herzegovina;0;0;2893;163
2020-06-14;BA;Bosnia and Herzegovina;0;0;2893;163
2020-06-15;BA;Bosnia and Herzegovina;147;2;3040;165
2020-06-16;BA;Bosnia and Herzegovina;45;3;3085;168
2020-06-17;BA;Bosnia and Herzegovina;56;0;3141;168
2020-06-18;BA;Bosnia and Herzegovina;33;0;3174;168
2020-06-19;BA;Bosnia and Herzegovina;99;1;3273;169
2020-06-20;BA;Bosnia and Herzegovina;0;0;3273;169
2020-06-21;BA;Bosnia and Herzegovina;0;0;3273;169
2020-06-22;BA;Bosnia and Herzegovina;252;2;3525;171
2020-06-23;BA;Bosnia and Herzegovina;63;1;3588;172
2020-06-24;BA;Bosnia and Herzegovina;88;1;3676;173
2020-06-25;BA;Bosnia and Herzegovina;120;2;3796;175
2020-06-26;BA;Bosnia and Herzegovina;139;3;3935;178
2020-06-27;BA;Bosnia and Herzegovina;0;0;3935;178
2020-06-28;BA;Bosnia and Herzegovina;0;0;3935;178
2020-06-29;BA;Bosnia and Herzegovina;390;6;4325;184
2020-06-30;BA;Bosnia and Herzegovina;128;2;4453;186
2020-07-01;BA;Bosnia and Herzegovina;153;2;4606;188
2020-07-02;BA;Bosnia and Herzegovina;182;1;4788;189
2020-07-03;BA;Bosnia and Herzegovina;174;2;4962;191
2020-07-04;BA;Bosnia and Herzegovina;0;0;4962;191
2020-07-05;BA;Bosnia and Herzegovina;0;0;4962;191
2020-07-06;BA;Bosnia and Herzegovina;496;8;5458;199
2020-07-07;BA;Bosnia and Herzegovina;163;8;5621;207
2020-07-08;BA;Bosnia and Herzegovina;248;2;5869;209
2020-07-09;BA;Bosnia and Herzegovina;217;5;6086;214
2020-07-10;BA;Bosnia and Herzegovina;316;2;6402;216
2020-07-11;BA;Bosnia and Herzegovina;317;3;6719;219
2020-07-12;BA;Bosnia and Herzegovina;158;2;6877;221
2020-07-13;BA;Bosnia and Herzegovina;104;5;6981;226
2020-07-14;BA;Bosnia and Herzegovina;0;0;6981;226
2020-07-15;BA;Bosnia and Herzegovina;430;9;7411;235
2020-07-16;BA;Bosnia and Herzegovina;270;5;7681;240
2020-07-17;BA;Bosnia and Herzegovina;227;5;7908;245
2020-07-18;BA;Bosnia and Herzegovina;253;1;8161;246
2020-07-19;BA;Bosnia and Herzegovina;179;3;8340;249
2020-07-20;BA;Bosnia and Herzegovina;139;6;8479;255
2020-07-21;BA;Bosnia and Herzegovina;308;9;8787;264
2020-07-22;BA;Bosnia and Herzegovina;328;4;9115;268
2020-07-23;BA;Bosnia and Herzegovina;347;6;9462;274
2020-07-24;BA;Bosnia and Herzegovina;305;6;9767;280
2020-07-25;BA;Bosnia and Herzegovina;0;0;9767;280
2020-07-26;BA;Bosnia and Herzegovina;0;0;9767;280
2020-07-27;BA;Bosnia and Herzegovina;731;14;10498;294
2020-07-28;BA;Bosnia and Herzegovina;268;3;10766;297
2020-07-29;BA;Bosnia and Herzegovina;361;19;11127;316
2020-07-30;BA;Bosnia and Herzegovina;317;12;11444;328
2020-07-31;BA;Bosnia and Herzegovina;432;11;11876;339
2020-08-01;BA;Bosnia and Herzegovina;0;0;11876;339
2020-08-02;BA;Bosnia and Herzegovina;420;13;12296;352
2020-08-03;BA;Bosnia and Herzegovina;166;10;12462;362
2020-08-04;BA;Bosnia and Herzegovina;394;11;12856;373
2020-08-05;BA;Bosnia and Herzegovina;282;6;13138;379
2020-08-06;BA;Bosnia and Herzegovina;258;5;13396;384
2020-08-07;BA;Bosnia and Herzegovina;291;10;13687;394
2020-08-08;BA;Bosnia and Herzegovina;0;0;13687;394
2020-08-09;BA;Bosnia and Herzegovina;0;0;13687;394
2020-08-10;BA;Bosnia and Herzegovina;811;31;14498;425
2020-08-11;BA;Bosnia and Herzegovina;210;22;14708;447
2020-08-12;BA;Bosnia and Herzegovina;253;6;14961;453
2020-08-13;BA;Bosnia and Herzegovina;223;5;15184;458
2020-08-14;BA;Bosnia and Herzegovina;351;11;15535;469
2020-08-15;BA;Bosnia and Herzegovina;266;2;15801;471
2020-08-16;BA;Bosnia and Herzegovina;0;0;15801;471
2020-08-17;BA;Bosnia and Herzegovina;310;15;16111;486
2020-08-18;BA;Bosnia and Herzegovina;240;9;16351;495
2020-08-19;BA;Bosnia and Herzegovina;340;12;16691;507
2020-08-20;BA;Bosnia and Herzegovina;338;8;17029;515
2020-08-21;BA;Bosnia and Herzegovina;367;11;17396;526
2020-08-22;BA;Bosnia and Herzegovina;319;6;17715;532
2020-08-23;BA;Bosnia and Herzegovina;0;0;17715;532
2020-08-24;BA;Bosnia and Herzegovina;314;15;18029;547
2020-08-25;BA;Bosnia and Herzegovina;297;13;18326;560
2020-08-26;BA;Bosnia and Herzegovina;283;11;18609;571
2020-08-27;BA;Bosnia and Herzegovina;311;11;18920;582
2020-08-28;BA;Bosnia and Herzegovina;294;9;19214;591
2020-08-29;BA;Bosnia and Herzegovina;336;3;19550;594
2020-08-30;BA;Bosnia and Herzegovina;243;4;19793;598
2020-08-31;BA;Bosnia and Herzegovina;171;11;19964;609
2020-09-01;BA;Bosnia and Herzegovina;270;11;20234;620
2020-09-02;BA;Bosnia and Herzegovina;283;7;20517;627
2020-09-03;BA;Bosnia and Herzegovina;287;9;20804;636
2020-09-04;BA;Bosnia and Herzegovina;338;3;21142;639
2020-09-05;BA;Bosnia and Herzegovina;297;12;21439;651
2020-09-06;BA;Bosnia and Herzegovina;121;4;21560;655
2020-09-07;BA;Bosnia and Herzegovina;100;9;21660;664
2020-09-08;BA;Bosnia and Herzegovina;301;5;21961;669
2020-09-09;BA;Bosnia and Herzegovina;297;6;22258;675
2020-09-10;BA;Bosnia and Herzegovina;286;5;22544;680
2020-09-11;BA;Bosnia and Herzegovina;290;6;22834;686
2020-09-12;BA;Bosnia and Herzegovina;304;4;23138;690
2020-09-13;BA;Bosnia and Herzegovina;327;6;23465;696
2020-09-14;BA;Bosnia and Herzegovina;170;9;23635;705
2020-09-15;BA;Bosnia and Herzegovina;294;20;23929;725
2020-09-16;BA;Bosnia and Herzegovina;282;11;24211;736
2020-09-17;BA;Bosnia and Herzegovina;394;11;24605;747
2020-09-18;BA;Bosnia and Herzegovina;292;5;24897;752
2020-09-19;BA;Bosnia and Herzegovina;320;6;25217;758
2020-09-20;BA;Bosnia and Herzegovina;211;5;25428;763
2020-09-21;BA;Bosnia and Herzegovina;93;7;25521;770
2020-09-22;BA;Bosnia and Herzegovina;216;8;25737;778
2020-09-23;BA;Bosnia and Herzegovina;344;12;26081;790
2020-09-24;BA;Bosnia and Herzegovina;235;12;26316;802
2020-09-25;BA;Bosnia and Herzegovina;248;6;26564;808
2020-09-26;BA;Bosnia and Herzegovina;233;12;26797;820
2020-09-27;BA;Bosnia and Herzegovina;123;2;26920;822
2020-09-28;BA;Bosnia and Herzegovina;81;7;27001;829
2020-09-29;BA;Bosnia and Herzegovina;225;14;27226;843
2020-09-30;BA;Bosnia and Herzegovina;243;13;27469;856
2020-10-01;BA;Bosnia and Herzegovina;280;5;27749;861
2020-10-02;BA;Bosnia and Herzegovina;226;10;27975;871
2020-10-03;BA;Bosnia and Herzegovina;0;0;27975;871
2020-10-04;BA;Bosnia and Herzegovina;379;8;28354;879
2020-10-05;BA;Bosnia and Herzegovina;95;9;28449;888
2020-10-06;BA;Bosnia and Herzegovina;261;15;28710;903
2020-10-07;BA;Bosnia and Herzegovina;365;5;29075;908
2020-10-08;BA;Bosnia and Herzegovina;453;5;29528;913
2020-10-09;BA;Bosnia and Herzegovina;389;13;29917;926
2020-10-10;BA;Bosnia and Herzegovina;428;1;30345;927
2020-10-11;BA;Bosnia and Herzegovina;302;1;30647;928
2020-10-12;BA;Bosnia and Herzegovina;190;8;30837;936
2020-10-13;BA;Bosnia and Herzegovina;336;11;31173;947
2020-10-14;BA;Bosnia and Herzegovina;482;11;31655;958
2020-10-15;BA;Bosnia and Herzegovina;569;14;32224;972
2020-10-16;BA;Bosnia and Herzegovina;621;8;32845;980
2020-10-17;BA;Bosnia and Herzegovina;716;1;33561;981
2020-10-18;BA;Bosnia and Herzegovina;551;3;34112;984
2020-10-19;BA;Bosnia and Herzegovina;549;13;34661;997
2020-10-20;BA;Bosnia and Herzegovina;728;20;35389;1017
2020-10-21;BA;Bosnia and Herzegovina;926;14;36315;1031
2020-10-22;BA;Bosnia and Herzegovina;999;20;37314;1051
2020-10-23;BA;Bosnia and Herzegovina;1179;14;38493;1065
2020-10-24;BA;Bosnia and Herzegovina;1265;10;39758;1075
2020-10-25;BA;Bosnia and Herzegovina;1135;11;40893;1086
2020-10-26;BA;Bosnia and Herzegovina;703;18;41596;1104
2020-10-27;BA;Bosnia and Herzegovina;1555;21;43151;1125
2020-10-28;BA;Bosnia and Herzegovina;1586;36;44737;1161
2020-10-29;BA;Bosnia and Herzegovina;1902;21;46639;1182
2020-10-30;BA;Bosnia and Herzegovina;1498;30;48137;1212
2020-10-31;BA;Bosnia and Herzegovina;1953;22;50090;1234
2020-11-01;BA;Bosnia and Herzegovina;1415;14;51505;1248
2020-11-02;BA;Bosnia and Herzegovina;764;32;52269;1280
2020-11-03;BA;Bosnia and Herzegovina;1553;37;53822;1317
2020-11-04;BA;Bosnia and Herzegovina;1776;41;55598;1358
2020-11-05;BA;Bosnia and Herzegovina;1908;44;57506;1402
2020-11-06;BA;Bosnia and Herzegovina;1921;55;59427;1457
2020-11-07;BA;Bosnia and Herzegovina;1785;33;61212;1490
2020-11-08;BA;Bosnia and Herzegovina;1211;20;62423;1510
2020-11-09;BA;Bosnia and Herzegovina;996;73;63419;1583
2020-11-10;BA;Bosnia and Herzegovina;1605;46;65024;1629
2020-11-11;BA;Bosnia and Herzegovina;1541;72;66565;1701
2020-11-12;BA;Bosnia and Herzegovina;1728;49;68293;1750
2020-11-13;BA;Bosnia and Herzegovina;1332;58;69625;1808
2020-11-14;BA;Bosnia and Herzegovina;1275;49;70900;1857
2020-11-15;BA;Bosnia and Herzegovina;1056;32;71956;1889
2020-11-16;BA;Bosnia and Herzegovina;733;84;72689;1973
2020-11-17;BA;Bosnia and Herzegovina;1255;69;73944;2042
2020-11-18;BA;Bosnia and Herzegovina;1633;47;75577;2089
2020-11-19;BA;Bosnia and Herzegovina;1180;64;76757;2153
2020-11-20;BA;Bosnia and Herzegovina;1237;56;77994;2209
2020-11-21;BA;Bosnia and Herzegovina;1315;37;79309;2246
2020-11-22;BA;Bosnia and Herzegovina;697;30;80006;2276
2020-11-23;BA;Bosnia and Herzegovina;547;66;80553;2342
2020-11-24;BA;Bosnia and Herzegovina;1186;52;81739;2394
2020-11-25;BA;Bosnia and Herzegovina;1589;35;83328;2429
2020-11-26;BA;Bosnia and Herzegovina;924;51;84252;2480
2020-11-27;BA;Bosnia and Herzegovina;1179;62;85431;2542
2020-11-28;BA;Bosnia and Herzegovina;1279;34;86710;2576
2020-11-29;BA;Bosnia and Herzegovina;664;44;87374;2620
2020-11-30;BA;Bosnia and Herzegovina;527;61;87901;2681
2020-12-01;BA;Bosnia and Herzegovina;1184;46;89085;2727
2020-12-02;BA;Bosnia and Herzegovina;1293;46;90378;2773
2020-12-03;BA;Bosnia and Herzegovina;1161;39;91539;2812
2020-12-04;BA;Bosnia and Herzegovina;1254;53;92793;2865
2020-12-05;BA;Bosnia and Herzegovina;975;57;93768;2922
2020-12-06;BA;Bosnia and Herzegovina;739;30;94507;2952
2020-12-07;BA;Bosnia and Herzegovina;437;60;94944;3012
2020-12-08;BA;Bosnia and Herzegovina;1077;69;96021;3081
2020-12-09;BA;Bosnia and Herzegovina;1296;70;97317;3151
2020-12-10;BA;Bosnia and Herzegovina;1286;48;98603;3199
2020-12-11;BA;Bosnia and Herzegovina;940;51;99543;3250
2020-12-12;BA;Bosnia and Herzegovina;763;48;100306;3298
2020-12-13;BA;Bosnia and Herzegovina;811;38;101117;3336
2020-12-14;BA;Bosnia and Herzegovina;344;55;101461;3391
2020-12-15;BA;Bosnia and Herzegovina;869;66;102330;3457
2020-12-16;BA;Bosnia and Herzegovina;902;54;103232;3511
2020-12-17;BA;Bosnia and Herzegovina;855;38;104087;3549
2020-12-18;BA;Bosnia and Herzegovina;794;34;104881;3583
2020-12-19;BA;Bosnia and Herzegovina;643;42;105524;3625
2020-12-20;BA;Bosnia and Herzegovina;0;0;105524;3625
2020-12-21;BA;Bosnia and Herzegovina;698;81;106222;3706
2020-12-22;BA;Bosnia and Herzegovina;764;86;106986;3792
2020-12-23;BA;Bosnia and Herzegovina;584;46;107570;3838
2020-12-24;BA;Bosnia and Herzegovina;728;40;108298;3878
2020-12-25;BA;Bosnia and Herzegovina;593;23;108891;3901
2020-12-26;BA;Bosnia and Herzegovina;439;22;109330;3923
2020-12-27;BA;Bosnia and Herzegovina;361;30;109691;3953
2020-12-28;BA;Bosnia and Herzegovina;220;-11;109911;3942
2020-12-29;BA;Bosnia and Herzegovina;543;82;110454;4024
2020-12-30;BA;Bosnia and Herzegovina;531;26;110985;4050
2020-12-31;BA;Bosnia and Herzegovina;0;0;110985;4050
2021-01-01;BA;Bosnia and Herzegovina;1158;36;112143;4086
2021-01-02;BA;Bosnia and Herzegovina;0;0;112143;4086
2021-01-03;BA;Bosnia and Herzegovina;502;45;112645;4131
2021-01-04;BA;Bosnia and Herzegovina;0;0;112645;4131
2021-01-05;BA;Bosnia and Herzegovina;747;80;113392;4211
2021-01-06;BA;Bosnia and Herzegovina;0;0;113392;4211
2021-01-07;BA;Bosnia and Herzegovina;0;0;113392;4211
2021-01-08;BA;Bosnia and Herzegovina;1528;74;114920;4285
2021-01-09;BA;Bosnia and Herzegovina;459;20;115379;4305
2021-01-10;BA;Bosnia and Herzegovina;254;25;115633;4330
2021-01-11;BA;Bosnia and Herzegovina;0;0;115633;4330
2021-01-12;BA;Bosnia and Herzegovina;567;43;116200;4373
2021-01-13;BA;Bosnia and Herzegovina;468;26;116668;4399
2021-01-14;BA;Bosnia and Herzegovina;343;12;117011;4411
2021-01-15;BA;Bosnia and Herzegovina;0;0;117011;4411
2021-01-16;BA;Bosnia and Herzegovina;0;0;117011;4411
2021-01-17;BA;Bosnia and Herzegovina;0;0;117011;4411
2021-01-18;BA;Bosnia and Herzegovina;1072;75;118083;4486
2021-01-19;BA;Bosnia and Herzegovina;300;23;118383;4509
2021-01-20;BA;Bosnia and Herzegovina;334;12;118717;4521
2021-01-21;BA;Bosnia and Herzegovina;489;15;119206;4536
2021-01-22;BA;Bosnia and Herzegovina;214;19;119420;4555
2021-01-23;BA;Bosnia and Herzegovina;0;0;119420;4555
2021-01-24;BA;Bosnia and Herzegovina;0;0;119420;4555
2021-01-25;BA;Bosnia and Herzegovina;723;38;120143;4593
2021-01-26;BA;Bosnia and Herzegovina;389;28;120532;4621
2021-01-27;BA;Bosnia and Herzegovina;332;22;120864;4643
2021-01-28;BA;Bosnia and Herzegovina;330;16;121194;4659
2021-01-29;BA;Bosnia and Herzegovina;303;20;121497;4679
2021-01-30;BA;Bosnia and Herzegovina;0;0;121497;4679
2021-01-31;BA;Bosnia and Herzegovina;0;0;121497;4679
2021-02-01;BA;Bosnia and Herzegovina;702;45;122199;4724
2021-02-02;BA;Bosnia and Herzegovina;262;13;122461;4737
2021-02-03;BA;Bosnia and Herzegovina;367;8;122828;4745
2021-02-04;BA;Bosnia and Herzegovina;0;0;122828;4745
2021-02-05;BA;Bosnia and Herzegovina;606;30;123434;4775
2021-02-06;BA;Bosnia and Herzegovina;0;0;123434;4775
2021-02-07;BA;Bosnia and Herzegovina;0;0;123434;4775
2021-02-08;BA;Bosnia and Herzegovina;667;38;124101;4813
2021-02-09;BA;Bosnia and Herzegovina;342;21;124443;4834
2021-02-10;BA;Bosnia and Herzegovina;253;19;124696;4853
2021-02-11;BA;Bosnia and Herzegovina;427;15;125123;4868
2021-02-12;BA;Bosnia and Herzegovina;279;13;125402;4881
2021-02-13;BA;Bosnia and Herzegovina;0;0;125402;4881
2021-02-14;BA;Bosnia and Herzegovina;0;0;125402;4881
2021-02-15;BA;Bosnia and Herzegovina;737;35;126139;4916
2021-02-16;BA;Bosnia and Herzegovina;274;19;126413;4935
2021-02-17;BA;Bosnia and Herzegovina;368;14;126781;4949
2021-02-18;BA;Bosnia and Herzegovina;354;13;127135;4962
2021-02-19;BA;Bosnia and Herzegovina;402;17;127537;4979
2021-02-20;BA;Bosnia and Herzegovina;0;0;127537;4979
2021-02-21;BA;Bosnia and Herzegovina;0;0;127537;4979
2021-02-22;BA;Bosnia and Herzegovina;1124;37;128661;5016
2021-02-23;BA;Bosnia and Herzegovina;515;18;129176;5034
2021-02-24;BA;Bosnia and Herzegovina;577;17;129753;5051
2021-02-25;BA;Bosnia and Herzegovina;757;11;130510;5062
2021-02-26;BA;Bosnia and Herzegovina;469;9;130979;5071
2021-02-27;BA;Bosnia and Herzegovina;0;0;130979;5071
2021-02-28;BA;Bosnia and Herzegovina;0;0;130979;5071
2021-03-01;BA;Bosnia and Herzegovina;0;0;130979;5071
2021-03-02;BA;Bosnia and Herzegovina;2109;74;133088;5145
2021-03-03;BA;Bosnia and Herzegovina;894;29;133982;5174
2021-03-04;BA;Bosnia and Herzegovina;910;26;134892;5200
2021-03-05;BA;Bosnia and Herzegovina;621;28;135513;5228
2021-03-06;BA;Bosnia and Herzegovina;0;0;135513;5228
2021-03-07;BA;Bosnia and Herzegovina;0;0;135513;5228
2021-03-08;BA;Bosnia and Herzegovina;1778;69;137291;5297
2021-03-09;BA;Bosnia and Herzegovina;1251;48;138542;5345
2021-03-10;BA;Bosnia and Herzegovina;1110;37;139652;5382
2021-03-11;BA;Bosnia and Herzegovina;1338;28;140990;5410
2021-03-12;BA;Bosnia and Herzegovina;1170;36;142160;5446
2021-03-13;BA;Bosnia and Herzegovina;0;0;142160;5446
2021-03-14;BA;Bosnia and Herzegovina;0;0;142160;5446
2021-03-15;BA;Bosnia and Herzegovina;2671;138;144831;5584
2021-03-16;BA;Bosnia and Herzegovina;1606;53;146437;5637
2021-03-17;BA;Bosnia and Herzegovina;1726;35;148163;5672
2021-03-18;BA;Bosnia and Herzegovina;1728;57;149891;5729
2021-03-19;BA;Bosnia and Herzegovina;1446;44;151337;5773
2021-03-20;BA;Bosnia and Herzegovina;0;0;151337;5773
2021-03-21;BA;Bosnia and Herzegovina;0;0;151337;5773
2021-03-22;BA;Bosnia and Herzegovina;3290;165;154627;5938
2021-03-23;BA;Bosnia and Herzegovina;1719;67;156346;6005
2021-03-24;BA;Bosnia and Herzegovina;1852;62;158198;6067
2021-03-25;BA;Bosnia and Herzegovina;1965;77;160163;6144
2021-03-26;BA;Bosnia and Herzegovina;1869;76;162032;6220
2021-03-27;BA;Bosnia and Herzegovina;0;0;162032;6220
2021-03-28;BA;Bosnia and Herzegovina;0;0;162032;6220
2021-03-29;BA;Bosnia and Herzegovina;3755;207;165787;6427
2021-03-30;BA;Bosnia and Herzegovina;1867;92;167654;6519
2021-03-31;BA;Bosnia and Herzegovina;1972;80;169626;6599
2021-04-01;BA;Bosnia and Herzegovina;1698;76;171324;6675
2021-04-02;BA;Bosnia and Herzegovina;2154;88;173478;6763
2021-04-03;BA;Bosnia and Herzegovina;0;0;173478;6763
2021-04-04;BA;Bosnia and Herzegovina;0;0;173478;6763
2021-04-05;BA;Bosnia and Herzegovina;2935;190;176413;6953
2021-04-06;BA;Bosnia and Herzegovina;1093;99;177506;7052
2021-04-07;BA;Bosnia and Herzegovina;1742;80;179248;7132
2021-04-08;BA;Bosnia and Herzegovina;1583;84;180831;7216
2021-04-09;BA;Bosnia and Herzegovina;1096;82;181927;7298
2021-04-10;BA;Bosnia and Herzegovina;0;0;181927;7298
2021-04-11;BA;Bosnia and Herzegovina;0;0;181927;7298
2021-04-12;BA;Bosnia and Herzegovina;2771;189;184698;7487
2021-04-13;BA;Bosnia and Herzegovina;0;0;184698;7487
2021-04-14;BA;Bosnia and Herzegovina;1674;155;186372;7642
2021-04-15;BA;Bosnia and Herzegovina;1343;60;187715;7702
2021-04-16;BA;Bosnia and Herzegovina;1279;86;188994;7788
2021-04-17;BA;Bosnia and Herzegovina;0;0;188994;7788
2021-04-18;BA;Bosnia and Herzegovina;0;0;188994;7788
2021-04-19;BA;Bosnia and Herzegovina;2160;150;191154;7938
2021-04-20;BA;Bosnia and Herzegovina;722;87;191876;8025
2021-04-21;BA;Bosnia and Herzegovina;1239;57;193115;8082
2021-04-22;BA;Bosnia and Herzegovina;1256;82;194371;8164
2021-04-23;BA;Bosnia and Herzegovina;362;39;194733;8203
2021-04-24;BA;Bosnia and Herzegovina;0;0;194733;8203
2021-04-25;BA;Bosnia and Herzegovina;0;0;194733;8203
2021-04-26;BA;Bosnia and Herzegovina;1238;147;195971;8350
2021-04-27;BA;Bosnia and Herzegovina;761;68;196732;8418
2021-04-28;BA;Bosnia and Herzegovina;646;46;197378;8464
2021-04-29;BA;Bosnia and Herzegovina;488;48;197866;8512
2021-04-30;BA;Bosnia and Herzegovina;595;39;198461;8551
2021-05-01;BA;Bosnia and Herzegovina;0;0;198461;8551
2021-05-02;BA;Bosnia and Herzegovina;0;0;198461;8551
2021-05-03;BA;Bosnia and Herzegovina;0;0;198461;8551
2021-05-04;BA;Bosnia and Herzegovina;1002;162;199463;8713
2021-05-05;BA;Bosnia and Herzegovina;419;23;199882;8736
2021-05-06;BA;Bosnia and Herzegovina;471;26;200353;8762
2021-05-07;BA;Bosnia and Herzegovina;340;28;200693;8790
2021-05-08;BA;Bosnia and Herzegovina;0;0;200693;8790
2021-05-09;BA;Bosnia and Herzegovina;0;0;200693;8790
2021-05-10;BA;Bosnia and Herzegovina;524;72;201217;8862
2021-05-11;BA;Bosnia and Herzegovina;295;50;201512;8912
2021-05-12;BA;Bosnia and Herzegovina;284;31;201796;8943
2021-05-13;BA;Bosnia and Herzegovina;207;15;202003;8958
2021-05-14;BA;Bosnia and Herzegovina;140;23;202143;8981
2021-05-15;BA;Bosnia and Herzegovina;0;0;202143;8981
2021-05-16;BA;Bosnia and Herzegovina;0;0;202143;8981
2021-05-17;BA;Bosnia and Herzegovina;347;70;202490;9051
2021-05-18;BA;Bosnia and Herzegovina;185;19;202675;9070
2021-05-19;BA;Bosnia and Herzegovina;172;16;202847;9086
2021-05-20;BA;Bosnia and Herzegovina;171;10;203018;9096
2021-05-21;BA;Bosnia and Herzegovina;132;12;203150;9108
2021-05-22;BA;Bosnia and Herzegovina;0;0;203150;9108
2021-05-23;BA;Bosnia and Herzegovina;0;0;203150;9108
2021-05-24;BA;Bosnia and Herzegovina;241;42;203391;9150
2021-05-25;BA;Bosnia and Herzegovina;122;18;203513;9168
2021-05-26;BA;Bosnia and Herzegovina;145;16;203658;9184
2021-05-27;BA;Bosnia and Herzegovina;104;10;203762;9194
2021-05-28;BA;Bosnia and Herzegovina;77;17;203839;9211
2021-05-29;BA;Bosnia and Herzegovina;0;0;203839;9211
2021-05-30;BA;Bosnia and Herzegovina;0;0;203839;9211
2021-05-31;BA;Bosnia and Herzegovina;173;42;204012;9253
2021-06-01;BA;Bosnia and Herzegovina;81;17;204093;9270
2021-06-02;BA;Bosnia and Herzegovina;79;33;204172;9303
2021-06-03;BA;Bosnia and Herzegovina;80;29;204252;9332
2021-06-04;BA;Bosnia and Herzegovina;52;42;204304;9374
2021-06-05;BA;Bosnia and Herzegovina;0;0;204304;9374
2021-06-06;BA;Bosnia and Herzegovina;0;0;204304;9374
2021-06-07;BA;Bosnia and Herzegovina;106;37;204410;9411
2021-06-08;BA;Bosnia and Herzegovina;45;49;204455;9460
2021-06-09;BA;Bosnia and Herzegovina;57;7;204512;9467
2021-06-10;BA;Bosnia and Herzegovina;55;6;204567;9473
2021-06-11;BA;Bosnia and Herzegovina;30;6;204597;9479
2021-06-12;BA;Bosnia and Herzegovina;0;0;204597;9479
2021-06-13;BA;Bosnia and Herzegovina;0;0;204597;9479
2021-06-14;BA;Bosnia and Herzegovina;71;16;204668;9495
2021-06-15;BA;Bosnia and Herzegovina;29;39;204697;9534
2021-06-16;BA;Bosnia and Herzegovina;33;74;204730;9608
2021-06-17;BA;Bosnia and Herzegovina;61;18;204791;9626
2021-06-18;BA;Bosnia and Herzegovina;23;4;204814;9630
2021-06-19;BA;Bosnia and Herzegovina;0;0;204814;9630
2021-06-20;BA;Bosnia and Herzegovina;0;0;204814;9630
2021-06-21;BA;Bosnia and Herzegovina;46;13;204860;9643
2021-06-22;BA;Bosnia and Herzegovina;26;5;204886;9648
2021-06-23;BA;Bosnia and Herzegovina;24;3;204910;9651
2021-06-24;BA;Bosnia and Herzegovina;26;2;204936;9653
2021-06-25;BA;Bosnia and Herzegovina;9;2;204945;9655
2021-06-26;BA;Bosnia and Herzegovina;0;0;204945;9655
2021-06-27;BA;Bosnia and Herzegovina;0;0;204945;9655
2021-06-28;BA;Bosnia and Herzegovina;46;3;204991;9658
2021-06-29;BA;Bosnia and Herzegovina;13;5;205004;9663
2021-06-30;BA;Bosnia and Herzegovina;18;2;205022;9665
2021-07-01;BA;Bosnia and Herzegovina;10;2;205032;9667
2020-03-30;BW;Botswana;3;0;3;0
2020-03-31;BW;Botswana;1;1;4;1
2020-04-01;BW;Botswana;0;0;4;1
2020-04-02;BW;Botswana;0;0;4;1
2020-04-03;BW;Botswana;0;0;4;1
2020-04-04;BW;Botswana;0;0;4;1
2020-04-05;BW;Botswana;2;0;6;1
2020-04-06;BW;Botswana;0;0;6;1
2020-04-07;BW;Botswana;0;0;6;1
2020-04-08;BW;Botswana;0;0;6;1
2020-04-09;BW;Botswana;7;0;13;1
2020-04-10;BW;Botswana;0;0;13;1
2020-04-11;BW;Botswana;0;0;13;1
2020-04-12;BW;Botswana;0;0;13;1
2020-04-13;BW;Botswana;0;0;13;1
2020-04-14;BW;Botswana;0;0;13;1
2020-04-15;BW;Botswana;0;0;13;1
2020-04-16;BW;Botswana;2;0;15;1
2020-04-17;BW;Botswana;0;0;15;1
2020-04-18;BW;Botswana;0;0;15;1
2020-04-19;BW;Botswana;5;0;20;1
2020-04-20;BW;Botswana;0;0;20;1
2020-04-21;BW;Botswana;0;0;20;1
2020-04-22;BW;Botswana;2;0;22;1
2020-04-23;BW;Botswana;0;0;22;1
2020-04-24;BW;Botswana;0;0;22;1
2020-04-25;BW;Botswana;0;0;22;1
2020-04-26;BW;Botswana;0;0;22;1
2020-04-27;BW;Botswana;0;0;22;1
2020-04-28;BW;Botswana;1;0;23;1
2020-04-29;BW;Botswana;0;0;23;1
2020-04-30;BW;Botswana;0;0;23;1
2020-05-01;BW;Botswana;0;0;23;1
2020-05-02;BW;Botswana;0;0;23;1
2020-05-03;BW;Botswana;0;0;23;1
2020-05-04;BW;Botswana;0;0;23;1
2020-05-05;BW;Botswana;0;0;23;1
2020-05-06;BW;Botswana;0;0;23;1
2020-05-07;BW;Botswana;0;0;23;1
2020-05-08;BW;Botswana;0;0;23;1
2020-05-09;BW;Botswana;0;0;23;1
2020-05-10;BW;Botswana;0;0;23;1
2020-05-11;BW;Botswana;1;0;24;1
2020-05-12;BW;Botswana;0;0;24;1
2020-05-13;BW;Botswana;0;0;24;1
2020-05-14;BW;Botswana;0;0;24;1
2020-05-15;BW;Botswana;0;0;24;1
2020-05-16;BW;Botswana;0;0;24;1
2020-05-17;BW;Botswana;1;0;25;1
2020-05-18;BW;Botswana;0;0;25;1
2020-05-19;BW;Botswana;0;0;25;1
2020-05-20;BW;Botswana;0;0;25;1
2020-05-21;BW;Botswana;4;0;29;1
2020-05-22;BW;Botswana;1;0;30;1
2020-05-23;BW;Botswana;0;0;30;1
2020-05-24;BW;Botswana;5;0;35;1
2020-05-25;BW;Botswana;0;0;35;1
2020-05-26;BW;Botswana;0;0;35;1
2020-05-27;BW;Botswana;0;0;35;1
2020-05-28;BW;Botswana;0;0;35;1
2020-05-29;BW;Botswana;0;0;35;1
2020-05-30;BW;Botswana;0;0;35;1
2020-05-31;BW;Botswana;0;0;35;1
2020-06-01;BW;Botswana;3;0;38;1
2020-06-02;BW;Botswana;2;0;40;1
2020-06-03;BW;Botswana;0;0;40;1
2020-06-04;BW;Botswana;0;0;40;1
2020-06-05;BW;Botswana;0;0;40;1
2020-06-06;BW;Botswana;0;0;40;1
2020-06-07;BW;Botswana;0;0;40;1
2020-06-08;BW;Botswana;2;0;42;1
2020-06-09;BW;Botswana;0;0;42;1
2020-06-10;BW;Botswana;6;0;48;1
2020-06-11;BW;Botswana;0;0;48;1
2020-06-12;BW;Botswana;0;0;48;1
2020-06-13;BW;Botswana;12;0;60;1
2020-06-14;BW;Botswana;0;0;60;1
2020-06-15;BW;Botswana;0;0;60;1
2020-06-16;BW;Botswana;0;0;60;1
2020-06-17;BW;Botswana;19;0;79;1
2020-06-18;BW;Botswana;0;0;79;1
2020-06-19;BW;Botswana;10;0;89;1
2020-06-20;BW;Botswana;0;0;89;1
2020-06-21;BW;Botswana;0;0;89;1
2020-06-22;BW;Botswana;0;0;89;1
2020-06-23;BW;Botswana;0;0;89;1
2020-06-24;BW;Botswana;3;0;92;1
2020-06-25;BW;Botswana;0;0;92;1
2020-06-26;BW;Botswana;0;0;92;1
2020-06-27;BW;Botswana;0;0;92;1
2020-06-28;BW;Botswana;0;0;92;1
2020-06-29;BW;Botswana;83;0;175;1
2020-06-30;BW;Botswana;52;0;227;1
2020-07-01;BW;Botswana;0;0;227;1
2020-07-02;BW;Botswana;0;0;227;1
2020-07-03;BW;Botswana;50;0;277;1
2020-07-04;BW;Botswana;0;0;277;1
2020-07-05;BW;Botswana;0;0;277;1
2020-07-06;BW;Botswana;37;0;314;1
2020-07-07;BW;Botswana;0;0;314;1
2020-07-08;BW;Botswana;0;0;314;1
2020-07-09;BW;Botswana;0;0;314;1
2020-07-10;BW;Botswana;0;0;314;1
2020-07-11;BW;Botswana;0;0;314;1
2020-07-12;BW;Botswana;85;0;399;1
2020-07-13;BW;Botswana;0;0;399;1
2020-07-14;BW;Botswana;0;0;399;1
2020-07-15;BW;Botswana;0;0;399;1
2020-07-16;BW;Botswana;123;0;522;1
2020-07-17;BW;Botswana;0;0;522;1
2020-07-18;BW;Botswana;0;0;522;1
2020-07-19;BW;Botswana;0;0;522;1
2020-07-20;BW;Botswana;0;0;522;1
2020-07-21;BW;Botswana;0;0;522;1
2020-07-22;BW;Botswana;0;0;522;1
2020-07-23;BW;Botswana;70;0;592;1
2020-07-24;BW;Botswana;94;0;686;1
2020-07-25;BW;Botswana;0;0;686;1
2020-07-26;BW;Botswana;0;0;686;1
2020-07-27;BW;Botswana;53;1;739;2
2020-07-28;BW;Botswana;0;0;739;2
2020-07-29;BW;Botswana;65;0;804;2
2020-07-30;BW;Botswana;0;0;804;2
2020-07-31;BW;Botswana;0;0;804;2
2020-08-01;BW;Botswana;0;0;804;2
2020-08-02;BW;Botswana;0;0;804;2
2020-08-03;BW;Botswana;0;0;804;2
2020-08-04;BW;Botswana;0;0;804;2
2020-08-05;BW;Botswana;0;0;804;2
2020-08-06;BW;Botswana;0;0;804;2
2020-08-07;BW;Botswana;0;0;804;2
2020-08-08;BW;Botswana;0;0;804;2
2020-08-09;BW;Botswana;0;0;804;2
2020-08-10;BW;Botswana;262;0;1066;2
2020-08-11;BW;Botswana;0;0;1066;2
2020-08-12;BW;Botswana;0;0;1066;2
2020-08-13;BW;Botswana;148;1;1214;3
2020-08-14;BW;Botswana;0;0;1214;3
2020-08-15;BW;Botswana;0;0;1214;3
2020-08-16;BW;Botswana;0;0;1214;3
2020-08-17;BW;Botswana;94;0;1308;3
2020-08-18;BW;Botswana;0;0;1308;3
2020-08-19;BW;Botswana;0;0;1308;3
2020-08-20;BW;Botswana;0;0;1308;3
2020-08-21;BW;Botswana;0;0;1308;3
2020-08-22;BW;Botswana;0;0;1308;3
2020-08-23;BW;Botswana;0;0;1308;3
2020-08-24;BW;Botswana;254;0;1562;3
2020-08-25;BW;Botswana;0;0;1562;3
2020-08-26;BW;Botswana;0;0;1562;3
2020-08-27;BW;Botswana;0;0;1562;3
2020-08-28;BW;Botswana;0;0;1562;3
2020-08-29;BW;Botswana;0;0;1562;3
2020-08-30;BW;Botswana;71;3;1633;6
2020-08-31;BW;Botswana;0;0;1633;6
2020-09-01;BW;Botswana;91;0;1724;6
2020-09-02;BW;Botswana;0;0;1724;6
2020-09-03;BW;Botswana;0;0;1724;6
2020-09-04;BW;Botswana;278;2;2002;8
2020-09-05;BW;Botswana;0;0;2002;8
2020-09-06;BW;Botswana;0;0;2002;8
2020-09-07;BW;Botswana;124;1;2126;9
2020-09-08;BW;Botswana;0;0;2126;9
2020-09-09;BW;Botswana;0;0;2126;9
2020-09-10;BW;Botswana;126;1;2252;10
2020-09-11;BW;Botswana;0;0;2252;10
2020-09-12;BW;Botswana;0;0;2252;10
2020-09-13;BW;Botswana;0;0;2252;10
2020-09-14;BW;Botswana;211;1;2463;11
2020-09-15;BW;Botswana;0;0;2463;11
2020-09-16;BW;Botswana;0;0;2463;11
2020-09-17;BW;Botswana;104;2;2567;13
2020-09-18;BW;Botswana;0;0;2567;13
2020-09-19;BW;Botswana;0;0;2567;13
2020-09-20;BW;Botswana;0;0;2567;13
2020-09-21;BW;Botswana;0;0;2567;13
2020-09-22;BW;Botswana;0;0;2567;13
2020-09-23;BW;Botswana;0;0;2567;13
2020-09-24;BW;Botswana;354;3;2921;16
2020-09-25;BW;Botswana;0;0;2921;16
2020-09-26;BW;Botswana;0;0;2921;16
2020-09-27;BW;Botswana;0;0;2921;16
2020-09-28;BW;Botswana;251;0;3172;16
2020-09-29;BW;Botswana;0;0;3172;16
2020-09-30;BW;Botswana;0;0;3172;16
2020-10-01;BW;Botswana;0;0;3172;16
2020-10-02;BW;Botswana;0;0;3172;16
2020-10-03;BW;Botswana;0;0;3172;16
2020-10-04;BW;Botswana;0;0;3172;16
2020-10-05;BW;Botswana;0;0;3172;16
2020-10-06;BW;Botswana;0;2;3172;18
2020-10-07;BW;Botswana;0;0;3172;18
2020-10-08;BW;Botswana;47;0;3219;18
2020-10-09;BW;Botswana;0;0;3219;18
2020-10-10;BW;Botswana;0;0;3219;18
2020-10-11;BW;Botswana;0;0;3219;18
2020-10-12;BW;Botswana;296;2;3515;20
2020-10-13;BW;Botswana;0;0;3515;20
2020-10-14;BW;Botswana;0;0;3515;20
2020-10-15;BW;Botswana;399;0;3914;20
2020-10-16;BW;Botswana;1328;0;5242;20
2020-10-17;BW;Botswana;0;0;5242;20
2020-10-18;BW;Botswana;0;0;5242;20
2020-10-19;BW;Botswana;367;1;5609;21
2020-10-20;BW;Botswana;0;0;5609;21
2020-10-21;BW;Botswana;0;0;5609;21
2020-10-22;BW;Botswana;314;0;5923;21
2020-10-23;BW;Botswana;0;0;5923;21
2020-10-24;BW;Botswana;0;0;5923;21
2020-10-25;BW;Botswana;0;0;5923;21
2020-10-26;BW;Botswana;360;0;6283;21
2020-10-27;BW;Botswana;0;0;6283;21
2020-10-28;BW;Botswana;0;0;6283;21
2020-10-29;BW;Botswana;359;3;6642;24
2020-10-30;BW;Botswana;0;0;6642;24
2020-10-31;BW;Botswana;0;0;6642;24
2020-11-01;BW;Botswana;0;0;6642;24
2020-11-02;BW;Botswana;0;0;6642;24
2020-11-03;BW;Botswana;0;0;6642;24
2020-11-04;BW;Botswana;0;0;6642;24
2020-11-05;BW;Botswana;1193;3;7835;27
2020-11-06;BW;Botswana;0;0;7835;27
2020-11-07;BW;Botswana;0;0;7835;27
2020-11-08;BW;Botswana;0;0;7835;27
2020-11-09;BW;Botswana;0;0;7835;27
2020-11-10;BW;Botswana;0;0;7835;27
2020-11-11;BW;Botswana;0;0;7835;27
2020-11-12;BW;Botswana;390;0;8225;27
2020-11-13;BW;Botswana;0;0;8225;27
2020-11-14;BW;Botswana;0;0;8225;27
2020-11-15;BW;Botswana;0;0;8225;27
2020-11-16;BW;Botswana;878;3;9103;30
2020-11-17;BW;Botswana;0;0;9103;30
2020-11-18;BW;Botswana;0;0;9103;30
2020-11-19;BW;Botswana;491;1;9594;31
2020-11-20;BW;Botswana;0;0;9594;31
2020-11-21;BW;Botswana;0;0;9594;31
2020-11-22;BW;Botswana;0;0;9594;31
2020-11-23;BW;Botswana;398;0;9992;31
2020-11-24;BW;Botswana;0;0;9992;31
2020-11-25;BW;Botswana;0;0;9992;31
2020-11-26;BW;Botswana;266;0;10258;31
2020-11-27;BW;Botswana;0;0;10258;31
2020-11-28;BW;Botswana;0;0;10258;31
2020-11-29;BW;Botswana;0;0;10258;31
2020-11-30;BW;Botswana;484;3;10742;34
2020-12-01;BW;Botswana;0;0;10742;34
2020-12-02;BW;Botswana;0;0;10742;34
2020-12-03;BW;Botswana;789;0;11531;34
2020-12-04;BW;Botswana;0;0;11531;34
2020-12-05;BW;Botswana;0;0;11531;34
2020-12-06;BW;Botswana;0;0;11531;34
2020-12-07;BW;Botswana;527;2;12058;36
2020-12-08;BW;Botswana;0;0;12058;36
2020-12-09;BW;Botswana;0;0;12058;36
2020-12-10;BW;Botswana;443;1;12501;37
2020-12-11;BW;Botswana;0;0;12501;37
2020-12-12;BW;Botswana;0;0;12501;37
2020-12-13;BW;Botswana;0;0;12501;37
2020-12-14;BW;Botswana;372;1;12873;38
2020-12-15;BW;Botswana;0;0;12873;38
2020-12-16;BW;Botswana;0;0;12873;38
2020-12-17;BW;Botswana;141;0;13014;38
2020-12-18;BW;Botswana;0;0;13014;38
2020-12-19;BW;Botswana;0;0;13014;38
2020-12-20;BW;Botswana;0;0;13014;38
2020-12-21;BW;Botswana;608;0;13622;38
2020-12-22;BW;Botswana;0;0;13622;38
2020-12-23;BW;Botswana;0;0;13622;38
2020-12-24;BW;Botswana;403;2;14025;40
2020-12-25;BW;Botswana;0;0;14025;40
2020-12-26;BW;Botswana;0;0;14025;40
2020-12-27;BW;Botswana;0;0;14025;40
2020-12-28;BW;Botswana;0;0;14025;40
2020-12-29;BW;Botswana;0;0;14025;40
2020-12-30;BW;Botswana;675;0;14700;40
2020-12-31;BW;Botswana;105;2;14805;42
2021-01-01;BW;Botswana;0;0;14805;42
2021-01-02;BW;Botswana;0;0;14805;42
2021-01-03;BW;Botswana;0;0;14805;42
2021-01-04;BW;Botswana;563;3;15368;45
2021-01-05;BW;Botswana;72;0;15440;45
2021-01-06;BW;Botswana;0;0;15440;45
2021-01-07;BW;Botswana;610;3;16050;48
2021-01-08;BW;Botswana;0;0;16050;48
2021-01-09;BW;Botswana;0;0;16050;48
2021-01-10;BW;Botswana;0;0;16050;48
2021-01-11;BW;Botswana;718;11;16768;59
2021-01-12;BW;Botswana;0;0;16768;59
2021-01-13;BW;Botswana;0;0;16768;59
2021-01-14;BW;Botswana;597;12;17365;71
2021-01-15;BW;Botswana;0;0;17365;71
2021-01-16;BW;Botswana;0;0;17365;71
2021-01-17;BW;Botswana;0;0;17365;71
2021-01-18;BW;Botswana;1265;17;18630;88
2021-01-19;BW;Botswana;0;0;18630;88
2021-01-20;BW;Botswana;0;0;18630;88
2021-01-21;BW;Botswana;1024;17;19654;105
2021-01-22;BW;Botswana;0;0;19654;105
2021-01-23;BW;Botswana;0;0;19654;105
2021-01-24;BW;Botswana;0;0;19654;105
2021-01-25;BW;Botswana;1004;19;20658;124
2021-01-26;BW;Botswana;0;0;20658;124
2021-01-27;BW;Botswana;0;0;20658;124
2021-01-28;BW;Botswana;635;10;21293;134
2021-01-29;BW;Botswana;0;0;21293;134
2021-01-30;BW;Botswana;0;0;21293;134
2021-01-31;BW;Botswana;0;0;21293;134
2021-02-01;BW;Botswana;1445;14;22738;148
2021-02-02;BW;Botswana;0;0;22738;148
2021-02-03;BW;Botswana;0;0;22738;148
2021-02-04;BW;Botswana;765;15;23503;163
2021-02-05;BW;Botswana;0;0;23503;163
2021-02-06;BW;Botswana;0;0;23503;163
2021-02-07;BW;Botswana;0;0;23503;163
2021-02-08;BW;Botswana;932;16;24435;179
2021-02-09;BW;Botswana;0;0;24435;179
2021-02-10;BW;Botswana;0;0;24435;179
2021-02-11;BW;Botswana;491;23;24926;202
2021-02-12;BW;Botswana;0;0;24926;202
2021-02-13;BW;Botswana;0;0;24926;202
2021-02-14;BW;Botswana;0;0;24926;202
2021-02-15;BW;Botswana;876;24;25802;226
2021-02-16;BW;Botswana;0;0;25802;226
2021-02-17;BW;Botswana;0;0;25802;226
2021-02-18;BW;Botswana;722;28;26524;254
2021-02-19;BW;Botswana;0;0;26524;254
2021-02-20;BW;Botswana;0;0;26524;254
2021-02-21;BW;Botswana;0;0;26524;254
2021-02-22;BW;Botswana;1197;46;27721;300
2021-02-23;BW;Botswana;0;0;27721;300
2021-02-24;BW;Botswana;0;0;27721;300
2021-02-25;BW;Botswana;650;10;28371;310
2021-02-26;BW;Botswana;0;0;28371;310
2021-02-27;BW;Botswana;0;0;28371;310
2021-02-28;BW;Botswana;0;0;28371;310
2021-03-01;BW;Botswana;2356;22;30727;332
2021-03-02;BW;Botswana;0;0;30727;332
2021-03-03;BW;Botswana;0;0;30727;332
2021-03-04;BW;Botswana;1019;27;31746;359
2021-03-05;BW;Botswana;0;0;31746;359
2021-03-06;BW;Botswana;0;0;31746;359
2021-03-07;BW;Botswana;0;0;31746;359
2021-03-08;BW;Botswana;1166;54;32912;413
2021-03-09;BW;Botswana;0;0;32912;413
2021-03-10;BW;Botswana;0;0;32912;413
2021-03-11;BW;Botswana;1186;11;34098;424
2021-03-12;BW;Botswana;0;0;34098;424
2021-03-13;BW;Botswana;0;0;34098;424
2021-03-14;BW;Botswana;0;0;34098;424
2021-03-15;BW;Botswana;901;23;34999;447
2021-03-16;BW;Botswana;0;0;34999;447
2021-03-17;BW;Botswana;0;0;34999;447
2021-03-18;BW;Botswana;494;11;35493;458
2021-03-19;BW;Botswana;0;0;35493;458
2021-03-20;BW;Botswana;0;0;35493;458
2021-03-21;BW;Botswana;0;0;35493;458
2021-03-22;BW;Botswana;2066;27;37559;485
2021-03-23;BW;Botswana;0;0;37559;485
2021-03-24;BW;Botswana;0;0;37559;485
2021-03-25;BW;Botswana;907;21;38466;506
2021-03-26;BW;Botswana;0;0;38466;506
2021-03-27;BW;Botswana;0;0;38466;506
2021-03-28;BW;Botswana;0;0;38466;506
2021-03-29;BW;Botswana;1382;62;39848;568
2021-03-30;BW;Botswana;0;0;39848;568
2021-03-31;BW;Botswana;0;0;39848;568
2021-04-01;BW;Botswana;1030;23;40878;591
2021-04-02;BW;Botswana;0;0;40878;591
2021-04-03;BW;Botswana;0;0;40878;591
2021-04-04;BW;Botswana;0;0;40878;591
2021-04-05;BW;Botswana;832;25;41710;616
2021-04-06;BW;Botswana;0;0;41710;616
2021-04-07;BW;Botswana;0;0;41710;616
2021-04-08;BW;Botswana;0;0;41710;616
2021-04-09;BW;Botswana;964;20;42674;636
2021-04-10;BW;Botswana;0;0;42674;636
2021-04-11;BW;Botswana;0;0;42674;636
2021-04-12;BW;Botswana;770;27;43444;663
2021-04-13;BW;Botswana;0;0;43444;663
2021-04-14;BW;Botswana;0;0;43444;663
2021-04-15;BW;Botswana;631;8;44075;671
2021-04-16;BW;Botswana;0;0;44075;671
2021-04-17;BW;Botswana;0;0;44075;671
2021-04-18;BW;Botswana;0;0;44075;671
2021-04-19;BW;Botswana;627;13;44702;684
2021-04-20;BW;Botswana;0;0;44702;684
2021-04-21;BW;Botswana;0;0;44702;684
2021-04-22;BW;Botswana;1153;7;45855;691
2021-04-23;BW;Botswana;0;0;45855;691
2021-04-24;BW;Botswana;0;0;45855;691
2021-04-25;BW;Botswana;0;0;45855;691
2021-04-26;BW;Botswana;0;0;45855;691
2021-04-27;BW;Botswana;745;11;46600;702
2021-04-28;BW;Botswana;0;0;46600;702
2021-04-29;BW;Botswana;334;10;46934;712
2021-04-30;BW;Botswana;0;0;46934;712
2021-05-01;BW;Botswana;0;0;46934;712
2021-05-02;BW;Botswana;0;0;46934;712
2021-05-03;BW;Botswana;917;12;47851;724
2021-05-04;BW;Botswana;0;0;47851;724
2021-05-05;BW;Botswana;0;0;47851;724
2021-05-06;BW;Botswana;566;10;48417;734
2021-05-07;BW;Botswana;0;0;48417;734
2021-05-08;BW;Botswana;0;0;48417;734
2021-05-09;BW;Botswana;0;0;48417;734
2021-05-10;BW;Botswana;624;17;49041;751
2021-05-11;BW;Botswana;0;0;49041;751
2021-05-12;BW;Botswana;0;0;49041;751
2021-05-13;BW;Botswana;0;0;49041;751
2021-05-14;BW;Botswana;615;10;49656;761
2021-05-15;BW;Botswana;0;0;49656;761
2021-05-16;BW;Botswana;0;0;49656;761
2021-05-17;BW;Botswana;1144;13;50800;774
2021-05-18;BW;Botswana;0;0;50800;774
2021-05-19;BW;Botswana;0;0;50800;774
2021-05-20;BW;Botswana;820;10;51620;784
2021-05-21;BW;Botswana;0;0;51620;784
2021-05-22;BW;Botswana;0;0;51620;784
2021-05-23;BW;Botswana;0;0;51620;784
2021-05-24;BW;Botswana;1245;25;52865;809
2021-05-25;BW;Botswana;0;0;52865;809
2021-05-26;BW;Botswana;0;0;52865;809
2021-05-27;BW;Botswana;906;22;53771;831
2021-05-28;BW;Botswana;0;0;53771;831
2021-05-29;BW;Botswana;0;0;53771;831
2021-05-30;BW;Botswana;0;0;53771;831
2021-05-31;BW;Botswana;1202;18;54973;849
2021-06-01;BW;Botswana;0;0;54973;849
2021-06-02;BW;Botswana;0;0;54973;849
2021-06-03;BW;Botswana;1244;17;56217;866
2021-06-04;BW;Botswana;0;0;56217;866
2021-06-05;BW;Botswana;0;0;56217;866
2021-06-06;BW;Botswana;0;0;56217;866
2021-06-07;BW;Botswana;1878;19;58095;885
2021-06-08;BW;Botswana;0;0;58095;885
2021-06-09;BW;Botswana;0;0;58095;885
2021-06-10;BW;Botswana;1385;11;59480;896
2021-06-11;BW;Botswana;0;0;59480;896
2021-06-12;BW;Botswana;0;0;59480;896
2021-06-13;BW;Botswana;0;0;59480;896
2021-06-14;BW;Botswana;1977;30;61457;926
2021-06-15;BW;Botswana;0;0;61457;926
2021-06-16;BW;Botswana;0;0;61457;926
2021-06-17;BW;Botswana;1790;14;63247;940
2021-06-18;BW;Botswana;0;0;63247;940
2021-06-19;BW;Botswana;0;0;63247;940
2021-06-20;BW;Botswana;0;0;63247;940
2021-06-21;BW;Botswana;2561;129;65808;1069
2021-06-22;BW;Botswana;0;0;65808;1069
2021-06-23;BW;Botswana;0;0;65808;1069
2021-06-24;BW;Botswana;1684;26;67492;1095
2021-06-25;BW;Botswana;0;0;67492;1095
2021-06-26;BW;Botswana;0;0;67492;1095
2021-06-27;BW;Botswana;0;0;67492;1095
2021-06-28;BW;Botswana;2188;30;69680;1125
2021-06-29;BW;Botswana;0;0;69680;1125
2021-06-30;BW;Botswana;0;0;69680;1125
2021-07-01;BW;Botswana;1763;33;71443;1158
2020-02-26;BR;Brazil;1;0;1;0
2020-02-27;BR;Brazil;0;0;1;0
2020-02-28;BR;Brazil;0;0;1;0
2020-02-29;BR;Brazil;1;0;2;0
2020-03-01;BR;Brazil;0;0;2;0
2020-03-02;BR;Brazil;0;0;2;0
2020-03-03;BR;Brazil;0;0;2;0
2020-03-04;BR;Brazil;2;0;4;0
2020-03-05;BR;Brazil;0;0;4;0
2020-03-06;BR;Brazil;9;0;13;0
2020-03-07;BR;Brazil;0;0;13;0
2020-03-08;BR;Brazil;7;0;20;0
2020-03-09;BR;Brazil;5;0;25;0
2020-03-10;BR;Brazil;6;0;31;0
2020-03-11;BR;Brazil;7;0;38;0
2020-03-12;BR;Brazil;14;0;52;0
2020-03-13;BR;Brazil;99;0;151;0
2020-03-14;BR;Brazil;0;0;151;0
2020-03-15;BR;Brazil;11;0;162;0
2020-03-16;BR;Brazil;38;0;200;0
2020-03-17;BR;Brazil;121;1;321;1
2020-03-18;BR;Brazil;51;2;372;3
2020-03-19;BR;Brazil;249;3;621;6
2020-03-20;BR;Brazil;172;5;793;11
2020-03-21;BR;Brazil;228;4;1021;15
2020-03-22;BR;Brazil;525;10;1546;25
2020-03-23;BR;Brazil;378;9;1924;34
2020-03-24;BR;Brazil;323;12;2247;46
2020-03-25;BR;Brazil;307;13;2554;59
2020-03-26;BR;Brazil;431;18;2985;77
2020-03-27;BR;Brazil;432;15;3417;92
2020-03-28;BR;Brazil;487;19;3904;111
2020-03-29;BR;Brazil;352;25;4256;136
2020-03-30;BR;Brazil;323;23;4579;159
2020-03-31;BR;Brazil;1138;42;5717;201
2020-04-01;BR;Brazil;1119;39;6836;240
2020-04-02;BR;Brazil;1208;84;8044;324
2020-04-03;BR;Brazil;1012;35;9056;359
2020-04-04;BR;Brazil;1304;86;10360;445
2020-04-05;BR;Brazil;770;41;11130;486
2020-04-06;BR;Brazil;1031;78;12161;564
2020-04-07;BR;Brazil;1873;122;14034;686
2020-04-08;BR;Brazil;2136;133;16170;819
2020-04-09;BR;Brazil;1922;131;18092;950
2020-04-10;BR;Brazil;1546;107;19638;1057
2020-04-11;BR;Brazil;1089;67;20727;1124
2020-04-12;BR;Brazil;1465;99;22192;1223
2020-04-13;BR;Brazil;1238;105;23430;1328
2020-04-14;BR;Brazil;1832;204;25262;1532
2020-04-15;BR;Brazil;3058;204;28320;1736
2020-04-16;BR;Brazil;2105;188;30425;1924
2020-04-17;BR;Brazil;3257;217;33682;2141
2020-04-18;BR;Brazil;2976;213;36658;2354
2020-04-19;BR;Brazil;1996;108;38654;2462
2020-04-20;BR;Brazil;2089;125;40743;2587
2020-04-21;BR;Brazil;2336;154;43079;2741
2020-04-22;BR;Brazil;2678;165;45757;2906
2020-04-23;BR;Brazil;4279;425;50036;3331
2020-04-24;BR;Brazil;4007;373;54043;3704
2020-04-25;BR;Brazil;5281;353;59324;4057
2020-04-26;BR;Brazil;3776;229;63100;4286
2020-04-27;BR;Brazil;4346;317;67446;4603
2020-04-28;BR;Brazil;5789;480;73235;5083
2020-04-29;BR;Brazil;6450;430;79685;5513
2020-04-30;BR;Brazil;7502;493;87187;6006
2020-05-01;BR;Brazil;5015;406;92202;6412
2020-05-02;BR;Brazil;4898;349;97100;6761
2020-05-03;BR;Brazil;4726;290;101826;7051
2020-05-04;BR;Brazil;6794;316;108620;7367
2020-05-05;BR;Brazil;6835;571;115455;7938
2020-05-06;BR;Brazil;11156;650;126611;8588
2020-05-07;BR;Brazil;9162;602;135773;9190
2020-05-08;BR;Brazil;11121;827;146894;10017
2020-05-09;BR;Brazil;9167;639;156061;10656
2020-05-10;BR;Brazil;6638;467;162699;11123
2020-05-11;BR;Brazil;6895;530;169594;11653
2020-05-12;BR;Brazil;8620;808;178214;12461
2020-05-13;BR;Brazil;11923;779;190137;13240
2020-05-14;BR;Brazil;13028;759;203165;13999
2020-05-15;BR;Brazil;17126;963;220291;14962
2020-05-16;BR;Brazil;13220;700;233511;15662
2020-05-17;BR;Brazil;7569;456;241080;16118
2020-05-18;BR;Brazil;14288;735;255368;16853
2020-05-19;BR;Brazil;16517;1130;271885;17983
2020-05-20;BR;Brazil;19694;876;291579;18859
2020-05-21;BR;Brazil;18508;1188;310087;20047
2020-05-22;BR;Brazil;20803;1001;330890;21048
2020-05-23;BR;Brazil;16508;965;347398;22013
2020-05-24;BR;Brazil;15813;653;363211;22666
2020-05-25;BR;Brazil;11687;807;374898;23473
2020-05-26;BR;Brazil;16324;1039;391222;24512
2020-05-27;BR;Brazil;20599;1086;411821;25598
2020-05-28;BR;Brazil;26417;1156;438238;26754
2020-05-29;BR;Brazil;26928;1124;465166;27878
2020-05-30;BR;Brazil;33274;956;498440;28834
2020-05-31;BR;Brazil;16409;480;514849;29314
2020-06-01;BR;Brazil;11598;623;526447;29937
2020-06-02;BR;Brazil;28936;1262;555383;31199
2020-06-03;BR;Brazil;28633;1349;584016;32548
2020-06-04;BR;Brazil;30925;1473;614941;34021
2020-06-05;BR;Brazil;30830;1005;645771;35026
2020-06-06;BR;Brazil;27075;904;672846;35930
2020-06-07;BR;Brazil;18912;525;691758;36455
2020-06-08;BR;Brazil;15654;679;707412;37134
2020-06-09;BR;Brazil;32091;1272;739503;38406
2020-06-10;BR;Brazil;32913;1274;772416;39680
2020-06-11;BR;Brazil;30412;1239;802828;40919
2020-06-12;BR;Brazil;25982;909;828810;41828
2020-06-13;BR;Brazil;21704;892;850514;42720
2020-06-14;BR;Brazil;17110;612;867624;43332
2020-06-15;BR;Brazil;20647;627;888271;43959
2020-06-16;BR;Brazil;34918;1282;923189;45241
2020-06-17;BR;Brazil;32188;1269;955377;46510
2020-06-18;BR;Brazil;22765;1238;978142;47748
2020-06-19;BR;Brazil;54771;1206;1032913;48954
2020-06-20;BR;Brazil;34666;1022;1067579;49976
2020-06-21;BR;Brazil;15762;615;1083341;50591
2020-06-22;BR;Brazil;23129;680;1106470;51271
2020-06-23;BR;Brazil;39436;1374;1145906;52645
2020-06-24;BR;Brazil;42725;1185;1188631;53830
2020-06-25;BR;Brazil;39483;1141;1228114;54971
2020-06-26;BR;Brazil;46860;990;1274974;55961
2020-06-27;BR;Brazil;38693;1109;1313667;57070
2020-06-28;BR;Brazil;30476;552;1344143;57622
2020-06-29;BR;Brazil;24052;692;1368195;58314
2020-06-30;BR;Brazil;33846;1280;1402041;59594
2020-07-01;BR;Brazil;46712;1038;1448753;60632
2020-07-02;BR;Brazil;48105;1252;1496858;61884
2020-07-03;BR;Brazil;42223;1290;1539081;63174
2020-07-04;BR;Brazil;37923;1091;1577004;64265
2020-07-05;BR;Brazil;26051;602;1603055;64867
2020-07-06;BR;Brazil;20229;620;1623284;65487
2020-07-07;BR;Brazil;45305;1254;1668589;66741
2020-07-08;BR;Brazil;44571;1223;1713160;67964
2020-07-09;BR;Brazil;42619;1220;1755779;69184
2020-07-10;BR;Brazil;45048;1214;1800827;70398
2020-07-11;BR;Brazil;39023;1071;1839850;71469
2020-07-12;BR;Brazil;24831;631;1864681;72100
2020-07-13;BR;Brazil;20286;733;1884967;72833
2020-07-14;BR;Brazil;41857;1300;1926824;74133
2020-07-15;BR;Brazil;39924;1233;1966748;75366
2020-07-16;BR;Brazil;45403;1322;2012151;76688
2020-07-17;BR;Brazil;34177;1163;2046328;77851
2020-07-18;BR;Brazil;28532;921;2074860;78772
2020-07-19;BR;Brazil;23529;716;2098389;79488
2020-07-20;BR;Brazil;20257;632;2118646;80120
2020-07-21;BR;Brazil;41008;1367;2159654;81487
2020-07-22;BR;Brazil;67860;1284;2227514;82771
2020-07-23;BR;Brazil;59961;1311;2287475;84082
2020-07-24;BR;Brazil;55891;1156;2343366;85238
2020-07-25;BR;Brazil;51147;1211;2394513;86449
2020-07-26;BR;Brazil;24578;555;2419091;87004
2020-07-27;BR;Brazil;23284;614;2442375;87618
2020-07-28;BR;Brazil;40816;921;2483191;88539
2020-07-29;BR;Brazil;69074;1595;2552265;90134
2020-07-30;BR;Brazil;57837;1129;2610102;91263
2020-07-31;BR;Brazil;52383;1212;2662485;92475
2020-08-01;BR;Brazil;45392;1088;2707877;93563
2020-08-02;BR;Brazil;25800;541;2733677;94104
2020-08-03;BR;Brazil;16641;561;2750318;94665
2020-08-04;BR;Brazil;51603;1154;2801921;95819
2020-08-05;BR;Brazil;57152;1437;2859073;97256
2020-08-06;BR;Brazil;53139;1237;2912212;98493
2020-08-07;BR;Brazil;50230;1079;2962442;99572
2020-08-08;BR;Brazil;49970;905;3012412;100477
2020-08-09;BR;Brazil;23010;572;3035422;101049
2020-08-10;BR;Brazil;22048;703;3057470;101752
2020-08-11;BR;Brazil;52160;1274;3109630;103026
2020-08-12;BR;Brazil;55155;1175;3164785;104201
2020-08-13;BR;Brazil;60091;1262;3224876;105463
2020-08-14;BR;Brazil;50644;1060;3275520;106523
2020-08-15;BR;Brazil;41576;709;3317096;107232
2020-08-16;BR;Brazil;23101;620;3340197;107852
2020-08-17;BR;Brazil;19373;684;3359570;108536
2020-08-18;BR;Brazil;47784;1352;3407354;109888
2020-08-19;BR;Brazil;49298;1212;3456652;111100
2020-08-20;BR;Brazil;45323;1204;3501975;112304
2020-08-21;BR;Brazil;30355;1054;3532330;113358
2020-08-22;BR;Brazil;50032;892;3582362;114250
2020-08-23;BR;Brazil;23421;494;3605783;114744
2020-08-24;BR;Brazil;17078;565;3622861;115309
2020-08-25;BR;Brazil;47134;1271;3669995;116580
2020-08-26;BR;Brazil;47161;1085;3717156;117665
2020-08-27;BR;Brazil;44235;984;3761391;118649
2020-08-28;BR;Brazil;43412;855;3804803;119504
2020-08-29;BR;Brazil;41350;758;3846153;120262
2020-08-30;BR;Brazil;16158;566;3862311;120828
2020-08-31;BR;Brazil;45961;553;3908272;121381
2020-09-01;BR;Brazil;42659;1215;3950931;122596
2020-09-02;BR;Brazil;46934;1184;3997865;123780
2020-09-03;BR;Brazil;43773;834;4041638;124614
2020-09-04;BR;Brazil;50163;888;4091801;125502
2020-09-05;BR;Brazil;31199;701;4123000;126203
2020-09-06;BR;Brazil;14521;447;4137521;126650
2020-09-07;BR;Brazil;10273;310;4147794;126960
2020-09-08;BR;Brazil;14279;504;4162073;127464
2020-09-09;BR;Brazil;35816;1075;4197889;128539
2020-09-10;BR;Brazil;40557;983;4238446;129522
2020-09-11;BR;Brazil;43718;874;4282164;130396
2020-09-12;BR;Brazil;33523;814;4315687;131210
2020-09-13;BR;Brazil;14768;415;4330455;131625
2020-09-14;BR;Brazil;15155;381;4345610;132006
2020-09-15;BR;Brazil;36653;1113;4382263;133119
2020-09-16;BR;Brazil;36820;987;4419083;134106
2020-09-17;BR;Brazil;36303;829;4455386;134935
2020-09-18;BR;Brazil;39797;858;4495183;135793
2020-09-19;BR;Brazil;33057;739;4528240;136532
2020-09-20;BR;Brazil;16389;363;4544629;136895
2020-09-21;BR;Brazil;13411;377;4558040;137272
2020-09-22;BR;Brazil;33324;833;4591364;138105
2020-09-23;BR;Brazil;0;0;4591364;138105
2020-09-24;BR;Brazil;66338;1703;4657702;139808
2020-09-25;BR;Brazil;31911;729;4689613;140537
2020-09-26;BR;Brazil;28378;869;4717991;141406
2020-09-27;BR;Brazil;14318;335;4732309;141741
2020-09-28;BR;Brazil;13155;317;4745464;142058
2020-09-29;BR;Brazil;32058;863;4777522;142921
2020-09-30;BR;Brazil;33413;1031;4810935;143952
2020-10-01;BR;Brazil;36157;728;4847092;144680
2020-10-02;BR;Brazil;0;0;4847092;144680
2020-10-03;BR;Brazil;59741;1307;4906833;145987
2020-10-04;BR;Brazil;8456;365;4915289;146352
2020-10-05;BR;Brazil;11946;323;4927235;146675
2020-10-06;BR;Brazil;41906;819;4969141;147494
2020-10-07;BR;Brazil;31553;734;5000694;148228
2020-10-08;BR;Brazil;27750;729;5028444;148957
2020-10-09;BR;Brazil;27444;682;5055888;149639
2020-10-10;BR;Brazil;26749;559;5082637;150198
2020-10-11;BR;Brazil;12342;290;5094979;150488
2020-10-12;BR;Brazil;8429;201;5103408;150689
2020-10-13;BR;Brazil;10220;309;5113628;150998
2020-10-14;BR;Brazil;27235;749;5140863;151747
2020-10-15;BR;Brazil;28523;713;5169386;152460
2020-10-16;BR;Brazil;30914;754;5200300;153214
2020-10-17;BR;Brazil;24062;461;5224362;153675
2020-10-18;BR;Brazil;0;0;5224362;153675
2020-10-19;BR;Brazil;26365;501;5250727;154176
2020-10-20;BR;Brazil;23227;661;5273954;154837
2020-10-21;BR;Brazil;24818;566;5298772;155403
2020-10-22;BR;Brazil;24858;497;5323630;155900
2020-10-23;BR;Brazil;30026;571;5353656;156471
2020-10-24;BR;Brazil;26979;432;5380635;156903
2020-10-25;BR;Brazil;13493;231;5394128;157134
2020-10-26;BR;Brazil;15726;263;5409854;157397
2020-10-27;BR;Brazil;29787;549;5439641;157946
2020-10-28;BR;Brazil;28629;510;5468270;158456
2020-10-29;BR;Brazil;26106;513;5494376;158969
2020-10-30;BR;Brazil;22282;508;5516658;159477
2020-10-31;BR;Brazil;18947;407;5535605;159884
2020-11-01;BR;Brazil;10100;190;5545705;160074
2020-11-02;BR;Brazil;8501;179;5554206;160253
2020-11-03;BR;Brazil;11843;243;5566049;160496
2020-11-04;BR;Brazil;23976;610;5590025;161106
2020-11-05;BR;Brazil;0;0;5590025;161106
2020-11-06;BR;Brazil;41156;909;5631181;162015
2020-11-07;BR;Brazil;22380;254;5653561;162269
2020-11-08;BR;Brazil;10554;128;5664115;162397
2020-11-09;BR;Brazil;10917;231;5675032;162628
2020-11-10;BR;Brazil;23973;174;5699005;162802
2020-11-11;BR;Brazil;48655;566;5747660;163368
2020-11-12;BR;Brazil;33922;913;5781582;164281
2020-11-13;BR;Brazil;29070;456;5810652;164737
2020-11-14;BR;Brazil;38307;921;5848959;165658
2020-11-15;BR;Brazil;14134;140;5863093;165798
2020-11-16;BR;Brazil;13371;216;5876464;166014
2020-11-17;BR;Brazil;35294;685;5911758;166699
2020-11-18;BR;Brazil;34091;756;5945849;167455
2020-11-19;BR;Brazil;35918;606;5981767;168061
2020-11-20;BR;Brazil;38397;552;6020164;168613
2020-11-21;BR;Brazil;32622;376;6052786;168989
2020-11-22;BR;Brazil;18615;194;6071401;169183
2020-11-23;BR;Brazil;16207;302;6087608;169485
2020-11-24;BR;Brazil;31100;630;6118708;170115
2020-11-25;BR;Brazil;47898;654;6166606;170769
2020-11-26;BR;Brazil;37614;691;6204220;171460
2020-11-27;BR;Brazil;34130;514;6238350;171974
2020-11-28;BR;Brazil;51922;587;6290272;172561
2020-11-29;BR;Brazil;24468;272;6314740;172833
2020-11-30;BR;Brazil;21138;287;6335878;173120
2020-12-01;BR;Brazil;50909;697;6386787;173817
2020-12-02;BR;Brazil;49863;698;6436650;174515
2020-12-03;BR;Brazil;50434;755;6487084;175270
2020-12-04;BR;Brazil;46884;694;6533968;175964
2020-12-05;BR;Brazil;43209;664;6577177;176628
2020-12-06;BR;Brazil;26363;313;6603540;176941
2020-12-07;BR;Brazil;20371;376;6623911;177317
2020-12-08;BR;Brazil;51088;842;6674999;178159
2020-12-09;BR;Brazil;53453;836;6728452;178995
2020-12-10;BR;Brazil;53347;770;6781799;179765
2020-12-11;BR;Brazil;54428;672;6836227;180437
2020-12-12;BR;Brazil;43900;686;6880127;181123
2020-12-13;BR;Brazil;21825;279;6901952;181402
2020-12-14;BR;Brazil;25193;433;6927145;181835
2020-12-15;BR;Brazil;42889;964;6970034;182799
2020-12-16;BR;Brazil;70574;936;7040608;183735
2020-12-17;BR;Brazil;69826;1092;7110434;184827
2020-12-18;BR;Brazil;52544;823;7162978;185650
2020-12-19;BR;Brazil;50177;706;7213155;186356
2020-12-20;BR;Brazil;25445;408;7238600;186764
2020-12-21;BR;Brazil;25019;527;7263619;187291
2020-12-22;BR;Brazil;55202;968;7318821;188259
2020-12-23;BR;Brazil;46696;961;7365517;189220
2020-12-24;BR;Brazil;58428;762;7423945;189982
2020-12-25;BR;Brazil;24615;506;7448560;190488
2020-12-26;BR;Brazil;17246;307;7465806;190795
2020-12-27;BR;Brazil;18479;344;7484285;191139
2020-12-28;BR;Brazil;20548;431;7504833;191570
2020-12-29;BR;Brazil;58718;1111;7563551;192681
2020-12-30;BR;Brazil;55649;1194;7619200;193875
2020-12-31;BR;Brazil;56773;1074;7675973;194949
2021-01-01;BR;Brazil;24605;462;7700578;195411
2021-01-02;BR;Brazil;15827;314;7716405;195725
2021-01-03;BR;Brazil;17341;293;7733746;196018
2021-01-04;BR;Brazil;20006;543;7753752;196561
2021-01-05;BR;Brazil;56648;1171;7810400;197732
2021-01-06;BR;Brazil;63430;1242;7873830;198974
2021-01-07;BR;Brazil;87843;1524;7961673;200498
2021-01-08;BR;Brazil;52035;962;8013708;201460
2021-01-09;BR;Brazil;62290;1171;8075998;202631
2021-01-10;BR;Brazil;29792;469;8105790;203100
2021-01-11;BR;Brazil;25822;480;8131612;203580
2021-01-12;BR;Brazil;64025;1110;8195637;204690
2021-01-13;BR;Brazil;60899;1274;8256536;205964
2021-01-14;BR;Brazil;67758;1131;8324294;207095
2021-01-15;BR;Brazil;69198;1151;8393492;208246
2021-01-16;BR;Brazil;61567;1050;8455059;209296
2021-01-17;BR;Brazil;33040;551;8488099;209847
2021-01-18;BR;Brazil;23671;452;8511770;210299
2021-01-19;BR;Brazil;62094;1192;8573864;211491
2021-01-20;BR;Brazil;64385;1340;8638249;212831
2021-01-21;BR;Brazil;59119;1316;8697368;214147
2021-01-22;BR;Brazil;56552;1096;8753920;215243
2021-01-23;BR;Brazil;62334;1202;8816254;216445
2021-01-24;BR;Brazil;28323;592;8844577;217037
2021-01-25;BR;Brazil;26816;627;8871393;217664
2021-01-26;BR;Brazil;61963;1214;8933356;218878
2021-01-27;BR;Brazil;63520;1283;8996876;220161
2021-01-28;BR;Brazil;61811;1386;9058687;221547
2021-01-29;BR;Brazil;59826;1119;9118513;222666
2021-01-30;BR;Brazil;58462;1279;9176975;223945
2021-01-31;BR;Brazil;27756;559;9204731;224504
2021-02-01;BR;Brazil;24591;595;9229322;225099
2021-02-02;BR;Brazil;54096;1210;9283418;226309
2021-02-03;BR;Brazil;56002;1254;9339420;227563
2021-02-04;BR;Brazil;56873;1232;9396293;228795
2021-02-05;BR;Brazil;50872;1239;9447165;230034
2021-02-06;BR;Brazil;0;0;9447165;230034
2021-02-07;BR;Brazil;77475;1500;9524640;231534
2021-02-08;BR;Brazil;0;0;9524640;231534
2021-02-09;BR;Brazil;74925;1986;9599565;233520
2021-02-10;BR;Brazil;59602;1330;9659167;234850
2021-02-11;BR;Brazil;54742;1351;9713909;236201
2021-02-12;BR;Brazil;51546;1288;9765455;237489
2021-02-13;BR;Brazil;44299;1043;9809754;238532
2021-02-14;BR;Brazil;24759;713;9834513;239245
2021-02-15;BR;Brazil;32197;528;9866710;239773
2021-02-16;BR;Brazil;55271;1167;9921981;240940
2021-02-17;BR;Brazil;56766;1150;9978747;242090
2021-02-18;BR;Brazil;51879;1367;10030626;243457
2021-02-19;BR;Brazil;53582;1280;10084208;244737
2021-02-20;BR;Brazil;54940;1240;10139148;245977
2021-02-21;BR;Brazil;29026;527;10168174;246504
2021-02-22;BR;Brazil;26986;639;10195160;247143
2021-02-23;BR;Brazil;62715;1386;10257875;248529
2021-02-24;BR;Brazil;66588;1428;10324463;249957
2021-02-25;BR;Brazil;65998;1541;10390461;251498
2021-02-26;BR;Brazil;65169;1337;10455630;252835
2021-02-27;BR;Brazil;61602;1386;10517232;254221
2021-02-28;BR;Brazil;34027;721;10551259;254942
2021-03-01;BR;Brazil;35742;778;10587001;255720
2021-03-02;BR;Brazil;59925;1641;10646926;257361
2021-03-03;BR;Brazil;71704;1910;10718630;259271
2021-03-04;BR;Brazil;75102;1699;10793732;260970
2021-03-05;BR;Brazil;75495;1800;10869227;262770
2021-03-06;BR;Brazil;69609;1555;10938836;264325
2021-03-07;BR;Brazil;80508;1086;11019344;265411
2021-03-08;BR;Brazil;32321;987;11051665;266398
2021-03-09;BR;Brazil;70764;1972;11122429;268370
2021-03-10;BR;Brazil;79876;2286;11202305;270656
2021-03-11;BR;Brazil;75412;2233;11277717;272889
2021-03-12;BR;Brazil;85663;2216;11363380;275105
2021-03-13;BR;Brazil;76178;1997;11439558;277102
2021-03-14;BR;Brazil;43812;1127;11483370;278229
2021-03-15;BR;Brazil;36239;1057;11519609;279286
2021-03-16;BR;Brazil;83926;2841;11603535;282127
2021-03-17;BR;Brazil;90303;2648;11693838;284775
2021-03-18;BR;Brazil;86982;2724;11780820;287499
2021-03-19;BR;Brazil;90570;2815;11871390;290314
2021-03-20;BR;Brazil;79069;2438;11950459;292752
2021-03-21;BR;Brazil;47774;1290;11998233;294042
2021-03-22;BR;Brazil;49293;1383;12047526;295425
2021-03-23;BR;Brazil;82493;3251;12130019;298676
2021-03-24;BR;Brazil;89992;2009;12220011;300685
2021-03-25;BR;Brazil;100158;2777;12320169;303462
2021-03-26;BR;Brazil;84245;3650;12404414;307112
2021-03-27;BR;Brazil;85948;3438;12490362;310550
2021-03-28;BR;Brazil;44326;1656;12534688;312206
2021-03-29;BR;Brazil;38927;1660;12573615;313866
2021-03-30;BR;Brazil;84494;3780;12658109;317646
2021-03-31;BR;Brazil;90638;3869;12748747;321515
2021-04-01;BR;Brazil;91097;3769;12839844;325284
2021-04-02;BR;Brazil;70238;2922;12910082;328206
2021-04-03;BR;Brazil;43515;1987;12953597;330193
2021-04-04;BR;Brazil;31359;1240;12984956;331433
2021-04-05;BR;Brazil;28645;1319;13013601;332752
2021-04-06;BR;Brazil;86979;4195;13100580;336947
2021-04-07;BR;Brazil;92625;3829;13193205;340776
2021-04-08;BR;Brazil;86652;4249;13279857;345025
2021-04-09;BR;Brazil;93317;3693;13373174;348718
2021-04-10;BR;Brazil;71832;2616;13445006;351334
2021-04-11;BR;Brazil;37017;1803;13482023;353137
2021-04-12;BR;Brazil;35785;1480;13517808;354617
2021-04-13;BR;Brazil;82186;3808;13599994;358425
2021-04-14;BR;Brazil;73513;3459;13673507;361884
2021-04-15;BR;Brazil;73174;3560;13746681;365444
2021-04-16;BR;Brazil;85774;3305;13832455;368749
2021-04-17;BR;Brazil;67636;2929;13900091;371678
2021-04-18;BR;Brazil;42980;1657;13943071;373335
2021-04-19;BR;Brazil;30624;1347;13973695;374682
2021-04-20;BR;Brazil;69381;3321;14043076;378003
2021-04-21;BR;Brazil;79719;3472;14122795;381475
2021-04-22;BR;Brazil;45178;2027;14167973;383502
2021-04-23;BR;Brazil;69105;2914;14237078;386416
2021-04-24;BR;Brazil;71137;3076;14308215;389492
2021-04-25;BR;Brazil;32572;1305;14340787;390797
2021-04-26;BR;Brazil;28636;1139;14369423;391936
2021-04-27;BR;Brazil;72140;3086;14441563;395022
2021-04-28;BR;Brazil;79726;3163;14521289;398185
2021-04-29;BR;Brazil;69389;3001;14590678;401186
2021-04-30;BR;Brazil;68333;2595;14659011;403781
2021-05-01;BR;Brazil;66964;2656;14725975;406437
2021-05-02;BR;Brazil;28935;1202;14754910;407639
2021-05-03;BR;Brazil;24619;983;14779529;408622
2021-05-04;BR;Brazil;77359;2966;14856888;411588
2021-05-05;BR;Brazil;73295;2811;14930183;414399
2021-05-06;BR;Brazil;73380;2550;15003563;416949
2021-05-07;BR;Brazil;78886;2165;15082449;419114
2021-05-08;BR;Brazil;63430;2202;15145879;421316
2021-05-09;BR;Brazil;38911;1024;15184790;422340
2021-05-10;BR;Brazil;25200;889;15209990;423229
2021-05-11;BR;Brazil;72715;2311;15282705;425540
2021-05-12;BR;Brazil;76692;2494;15359397;428034
2021-05-13;BR;Brazil;74592;2383;15433989;430417
2021-05-14;BR;Brazil;85536;2211;15519525;432628
2021-05-15;BR;Brazil;67009;2087;15586534;434715
2021-05-16;BR;Brazil;40709;1036;15627243;435751
2021-05-17;BR;Brazil;30148;786;15657391;436537
2021-05-18;BR;Brazil;75445;2513;15732836;439050
2021-05-19;BR;Brazil;79219;2641;15812055;441691
2021-05-20;BR;Brazil;82039;2403;15894094;444094
2021-05-21;BR;Brazil;76855;2215;15970949;446309
2021-05-22;BR;Brazil;76490;1899;16047439;448208
2021-05-23;BR;Brazil;35819;860;16083258;449068
2021-05-24;BR;Brazil;37498;790;16120756;449858
2021-05-25;BR;Brazil;73453;2173;16194209;452031
2021-05-26;BR;Brazil;80486;2398;16274695;454429
2021-05-27;BR;Brazil;67467;2245;16342162;456674
2021-05-28;BR;Brazil;49768;2371;16391930;459045
2021-05-29;BR;Brazil;79670;2012;16471600;461057
2021-05-30;BR;Brazil;43520;874;16515120;461931
2021-05-31;BR;Brazil;30434;860;16545554;462791
2021-06-01;BR;Brazil;78926;2408;16624480;465199
2021-06-02;BR;Brazil;95601;2507;16720081;467706
2021-06-03;BR;Brazil;83391;1682;16803472;469388
2021-06-04;BR;Brazil;37936;1454;16841408;470842
2021-06-05;BR;Brazil;66017;1689;16907425;472531
2021-06-06;BR;Brazil;39637;873;16947062;473404
2021-06-07;BR;Brazil;37156;1010;16984218;474414
2021-06-08;BR;Brazil;52911;2378;17037129;476792
2021-06-09;BR;Brazil;85748;2723;17122877;479515
2021-06-10;BR;Brazil;88092;2504;17210969;482019
2021-06-11;BR;Brazil;85149;2216;17296118;484235
2021-06-12;BR;Brazil;78700;2037;17374818;486272
2021-06-13;BR;Brazil;37948;1129;17412766;487401
2021-06-14;BR;Brazil;39846;827;17452612;488228
2021-06-15;BR;Brazil;80609;2468;17533221;490696
2021-06-16;BR;Brazil;95367;2997;17628588;493693
2021-06-17;BR;Brazil;74042;2311;17702630;496004
2021-06-18;BR;Brazil;98832;2495;17801462;498499
2021-06-19;BR;Brazil;82288;2301;17883750;500800
2021-06-20;BR;Brazil;44178;1025;17927928;501825
2021-06-21;BR;Brazil;38903;761;17966831;502586
2021-06-22;BR;Brazil;87822;2131;18054653;504717
2021-06-23;BR;Brazil;115228;2392;18169881;507109
2021-06-24;BR;Brazil;73602;2032;18243483;509141
2021-06-25;BR;Brazil;79277;2001;18322760;511142
2021-06-26;BR;Brazil;64134;1593;18386894;512735
2021-06-27;BR;Brazil;33704;739;18420598;513474
2021-06-28;BR;Brazil;27804;618;18448402;514092
2021-06-29;BR;Brazil;64903;1893;18513305;515985
2021-06-30;BR;Brazil;43836;2081;18557141;518066
2021-07-01;BR;Brazil;65163;2029;18622304;520095
2021-05-21;VG;British Virgin Islands;0;0;0;0
2021-05-22;VG;British Virgin Islands;0;0;0;0
2021-05-23;VG;British Virgin Islands;0;0;0;0
2021-05-24;VG;British Virgin Islands;0;0;0;0
2021-05-25;VG;British Virgin Islands;0;0;0;0
2021-05-26;VG;British Virgin Islands;0;0;0;0
2021-05-27;VG;British Virgin Islands;0;0;0;0
2021-05-28;VG;British Virgin Islands;0;0;0;0
2021-05-29;VG;British Virgin Islands;0;0;0;0
2021-05-30;VG;British Virgin Islands;0;0;0;0
2021-05-31;VG;British Virgin Islands;0;0;0;0
2021-06-01;VG;British Virgin Islands;0;0;0;0
2021-06-02;VG;British Virgin Islands;0;0;0;0
2021-06-03;VG;British Virgin Islands;0;0;0;0
2021-06-04;VG;British Virgin Islands;0;0;0;0
2021-06-05;VG;British Virgin Islands;0;0;0;0
2021-06-06;VG;British Virgin Islands;0;0;0;0
2021-06-07;VG;British Virgin Islands;0;0;0;0
2021-06-08;VG;British Virgin Islands;0;0;0;0
2021-06-09;VG;British Virgin Islands;0;0;0;0
2021-06-10;VG;British Virgin Islands;0;0;0;0
2021-06-11;VG;British Virgin Islands;0;0;0;0
2021-06-12;VG;British Virgin Islands;0;0;0;0
2021-06-13;VG;British Virgin Islands;0;0;0;0
2021-06-14;VG;British Virgin Islands;0;0;0;0
2021-06-15;VG;British Virgin Islands;0;0;0;0
2021-06-16;VG;British Virgin Islands;0;0;0;0
2021-06-17;VG;British Virgin Islands;0;0;0;0
2021-06-18;VG;British Virgin Islands;0;0;0;0
2021-06-19;VG;British Virgin Islands;0;0;0;0
2021-06-20;VG;British Virgin Islands;0;0;0;0
2021-06-21;VG;British Virgin Islands;0;0;0;0
2021-06-22;VG;British Virgin Islands;0;0;0;0
2021-06-23;VG;British Virgin Islands;0;0;0;0
2021-06-24;VG;British Virgin Islands;0;0;0;0
2021-06-25;VG;British Virgin Islands;0;0;0;0
2020-03-09;BN;Brunei;1;0;1;0
2020-03-10;BN;Brunei;0;0;1;0
2020-03-11;BN;Brunei;10;0;11;0
2020-03-12;BN;Brunei;0;0;11;0
2020-03-13;BN;Brunei;26;0;37;0
2020-03-14;BN;Brunei;3;0;40;0
2020-03-15;BN;Brunei;10;0;50;0
2020-03-16;BN;Brunei;4;0;54;0
2020-03-17;BN;Brunei;2;0;56;0
2020-03-18;BN;Brunei;12;0;68;0
2020-03-19;BN;Brunei;7;0;75;0
2020-03-20;BN;Brunei;3;0;78;0
2020-03-21;BN;Brunei;5;0;83;0
2020-03-22;BN;Brunei;5;0;88;0
2020-03-23;BN;Brunei;3;0;91;0
2020-03-24;BN;Brunei;13;0;104;0
2020-03-25;BN;Brunei;5;0;109;0
2020-03-26;BN;Brunei;5;0;114;0
2020-03-27;BN;Brunei;1;0;115;0
2020-03-28;BN;Brunei;5;1;120;1
2020-03-29;BN;Brunei;6;0;126;1
2020-03-30;BN;Brunei;1;0;127;1
2020-03-31;BN;Brunei;2;0;129;1
2020-04-01;BN;Brunei;2;0;131;1
2020-04-02;BN;Brunei;2;0;133;1
2020-04-03;BN;Brunei;1;0;134;1
2020-04-04;BN;Brunei;1;0;135;1
2020-04-05;BN;Brunei;0;0;135;1
2020-04-06;BN;Brunei;0;0;135;1
2020-04-07;BN;Brunei;0;0;135;1
2020-04-08;BN;Brunei;0;0;135;1
2020-04-09;BN;Brunei;0;0;135;1
2020-04-10;BN;Brunei;1;0;136;1
2020-04-11;BN;Brunei;0;0;136;1
2020-04-12;BN;Brunei;0;0;136;1
2020-04-13;BN;Brunei;0;0;136;1
2020-04-14;BN;Brunei;0;0;136;1
2020-04-15;BN;Brunei;0;0;136;1
2020-04-16;BN;Brunei;0;0;136;1
2020-04-17;BN;Brunei;0;0;136;1
2020-04-18;BN;Brunei;1;0;137;1
2020-04-19;BN;Brunei;1;0;138;1
2020-04-20;BN;Brunei;0;0;138;1
2020-04-21;BN;Brunei;0;0;138;1
2020-04-22;BN;Brunei;0;0;138;1
2020-04-23;BN;Brunei;0;0;138;1
2020-04-24;BN;Brunei;0;0;138;1
2020-04-25;BN;Brunei;0;0;138;1
2020-04-26;BN;Brunei;0;0;138;1
2020-04-27;BN;Brunei;0;0;138;1
2020-04-28;BN;Brunei;0;0;138;1
2020-04-29;BN;Brunei;0;0;138;1
2020-04-30;BN;Brunei;0;0;138;1
2020-05-01;BN;Brunei;0;0;138;1
2020-05-02;BN;Brunei;0;0;138;1
2020-05-03;BN;Brunei;0;0;138;1
2020-05-04;BN;Brunei;0;0;138;1
2020-05-05;BN;Brunei;0;0;138;1
2020-05-06;BN;Brunei;1;0;139;1
2020-05-07;BN;Brunei;2;0;141;1
2020-05-08;BN;Brunei;0;0;141;1
2020-05-09;BN;Brunei;0;0;141;1
2020-05-10;BN;Brunei;0;0;141;1
2020-05-11;BN;Brunei;0;0;141;1
2020-05-12;BN;Brunei;0;0;141;1
2020-05-13;BN;Brunei;0;0;141;1
2020-05-14;BN;Brunei;0;0;141;1
2020-05-15;BN;Brunei;0;0;141;1
2020-05-16;BN;Brunei;0;0;141;1
2020-05-17;BN;Brunei;0;0;141;1
2020-05-18;BN;Brunei;0;0;141;1
2020-05-19;BN;Brunei;0;0;141;1
2020-05-20;BN;Brunei;0;0;141;1
2020-05-21;BN;Brunei;0;0;141;1
2020-05-22;BN;Brunei;0;0;141;1
2020-05-23;BN;Brunei;0;0;141;1
2020-05-24;BN;Brunei;0;0;141;1
2020-05-25;BN;Brunei;0;0;141;1
2020-05-26;BN;Brunei;0;0;141;1
2020-05-27;BN;Brunei;0;1;141;2
2020-05-28;BN;Brunei;0;0;141;2
2020-05-29;BN;Brunei;0;0;141;2
2020-05-30;BN;Brunei;0;0;141;2
2020-05-31;BN;Brunei;0;0;141;2
2020-06-01;BN;Brunei;0;0;141;2
2020-06-02;BN;Brunei;0;0;141;2
2020-06-03;BN;Brunei;0;0;141;2
2020-06-04;BN;Brunei;0;0;141;2
2020-06-05;BN;Brunei;0;0;141;2
2020-06-06;BN;Brunei;0;0;141;2
2020-06-07;BN;Brunei;0;0;141;2
2020-06-08;BN;Brunei;0;0;141;2
2020-06-09;BN;Brunei;0;0;141;2
2020-06-10;BN;Brunei;0;0;141;2
2020-06-11;BN;Brunei;0;0;141;2
2020-06-12;BN;Brunei;0;0;141;2
2020-06-13;BN;Brunei;0;0;141;2
2020-06-14;BN;Brunei;0;0;141;2
2020-06-15;BN;Brunei;0;0;141;2
2020-06-16;BN;Brunei;0;1;141;3
2020-06-17;BN;Brunei;0;0;141;3
2020-06-18;BN;Brunei;0;0;141;3
2020-06-19;BN;Brunei;0;0;141;3
2020-06-20;BN;Brunei;0;0;141;3
2020-06-21;BN;Brunei;0;0;141;3
2020-06-22;BN;Brunei;0;0;141;3
2020-06-23;BN;Brunei;0;0;141;3
2020-06-24;BN;Brunei;0;0;141;3
2020-06-25;BN;Brunei;0;0;141;3
2020-06-26;BN;Brunei;0;0;141;3
2020-06-27;BN;Brunei;0;0;141;3
2020-06-28;BN;Brunei;0;0;141;3
2020-06-29;BN;Brunei;0;0;141;3
2020-06-30;BN;Brunei;0;0;141;3
2020-07-01;BN;Brunei;0;0;141;3
2020-07-02;BN;Brunei;0;0;141;3
2020-07-03;BN;Brunei;0;0;141;3
2020-07-04;BN;Brunei;0;0;141;3
2020-07-05;BN;Brunei;0;0;141;3
2020-07-06;BN;Brunei;0;0;141;3
2020-07-07;BN;Brunei;0;0;141;3
2020-07-08;BN;Brunei;0;0;141;3
2020-07-09;BN;Brunei;0;0;141;3
2020-07-10;BN;Brunei;0;0;141;3
2020-07-11;BN;Brunei;0;0;141;3
2020-07-12;BN;Brunei;0;0;141;3
2020-07-13;BN;Brunei;0;0;141;3
2020-07-14;BN;Brunei;0;0;141;3
2020-07-15;BN;Brunei;0;0;141;3
2020-07-16;BN;Brunei;0;0;141;3
2020-07-17;BN;Brunei;0;0;141;3
2020-07-18;BN;Brunei;0;0;141;3
2020-07-19;BN;Brunei;0;0;141;3
2020-07-20;BN;Brunei;0;0;141;3
2020-07-21;BN;Brunei;0;0;141;3
2020-07-22;BN;Brunei;0;0;141;3
2020-07-23;BN;Brunei;0;0;141;3
2020-07-24;BN;Brunei;0;0;141;3
2020-07-25;BN;Brunei;0;0;141;3
2020-07-26;BN;Brunei;0;0;141;3
2020-07-27;BN;Brunei;0;0;141;3
2020-07-28;BN;Brunei;0;0;141;3
2020-07-29;BN;Brunei;0;0;141;3
2020-07-30;BN;Brunei;0;0;141;3
2020-07-31;BN;Brunei;0;0;141;3
2020-08-01;BN;Brunei;0;0;141;3
2020-08-02;BN;Brunei;0;0;141;3
2020-08-03;BN;Brunei;0;0;141;3
2020-08-04;BN;Brunei;0;0;141;3
2020-08-05;BN;Brunei;0;0;141;3
2020-08-06;BN;Brunei;0;0;141;3
2020-08-07;BN;Brunei;1;0;142;3
2020-08-08;BN;Brunei;0;0;142;3
2020-08-09;BN;Brunei;0;0;142;3
2020-08-10;BN;Brunei;0;0;142;3
2020-08-11;BN;Brunei;0;0;142;3
2020-08-12;BN;Brunei;0;0;142;3
2020-08-13;BN;Brunei;0;0;142;3
2020-08-14;BN;Brunei;0;0;142;3
2020-08-15;BN;Brunei;0;0;142;3
2020-08-16;BN;Brunei;0;0;142;3
2020-08-17;BN;Brunei;0;0;142;3
2020-08-18;BN;Brunei;0;0;142;3
2020-08-19;BN;Brunei;1;0;143;3
2020-08-20;BN;Brunei;0;0;143;3
2020-08-21;BN;Brunei;0;0;143;3
2020-08-22;BN;Brunei;0;0;143;3
2020-08-23;BN;Brunei;0;0;143;3
2020-08-24;BN;Brunei;0;0;143;3
2020-08-25;BN;Brunei;1;0;144;3
2020-08-26;BN;Brunei;0;0;144;3
2020-08-27;BN;Brunei;0;0;144;3
2020-08-28;BN;Brunei;0;0;144;3
2020-08-29;BN;Brunei;0;0;144;3
2020-08-30;BN;Brunei;0;0;144;3
2020-08-31;BN;Brunei;0;0;144;3
2020-09-01;BN;Brunei;0;0;144;3
2020-09-02;BN;Brunei;0;0;144;3
2020-09-03;BN;Brunei;1;0;145;3
2020-09-04;BN;Brunei;0;0;145;3
2020-09-05;BN;Brunei;0;0;145;3
2020-09-06;BN;Brunei;0;0;145;3
2020-09-07;BN;Brunei;0;0;145;3
2020-09-08;BN;Brunei;0;0;145;3
2020-09-09;BN;Brunei;0;0;145;3
2020-09-10;BN;Brunei;0;0;145;3
2020-09-11;BN;Brunei;0;0;145;3
2020-09-12;BN;Brunei;0;0;145;3
2020-09-13;BN;Brunei;0;0;145;3
2020-09-14;BN;Brunei;0;0;145;3
2020-09-15;BN;Brunei;0;0;145;3
2020-09-16;BN;Brunei;0;0;145;3
2020-09-17;BN;Brunei;0;0;145;3
2020-09-18;BN;Brunei;0;0;145;3
2020-09-19;BN;Brunei;0;0;145;3
2020-09-20;BN;Brunei;0;0;145;3
2020-09-21;BN;Brunei;0;0;145;3
2020-09-22;BN;Brunei;0;0;145;3
2020-09-23;BN;Brunei;0;0;145;3
2020-09-24;BN;Brunei;1;0;146;3
2020-09-25;BN;Brunei;0;0;146;3
2020-09-26;BN;Brunei;0;0;146;3
2020-09-27;BN;Brunei;0;0;146;3
2020-09-28;BN;Brunei;0;0;146;3
2020-09-29;BN;Brunei;0;0;146;3
2020-09-30;BN;Brunei;0;0;146;3
2020-10-01;BN;Brunei;0;0;146;3
2020-10-02;BN;Brunei;0;0;146;3
2020-10-03;BN;Brunei;0;0;146;3
2020-10-04;BN;Brunei;0;0;146;3
2020-10-05;BN;Brunei;0;0;146;3
2020-10-06;BN;Brunei;0;0;146;3
2020-10-07;BN;Brunei;0;0;146;3
2020-10-08;BN;Brunei;0;0;146;3
2020-10-09;BN;Brunei;0;0;146;3
2020-10-10;BN;Brunei;0;0;146;3
2020-10-11;BN;Brunei;0;0;146;3
2020-10-12;BN;Brunei;0;0;146;3
2020-10-13;BN;Brunei;0;0;146;3
2020-10-14;BN;Brunei;1;0;147;3
2020-10-15;BN;Brunei;0;0;147;3
2020-10-16;BN;Brunei;0;0;147;3
2020-10-17;BN;Brunei;0;0;147;3
2020-10-18;BN;Brunei;0;0;147;3
2020-10-19;BN;Brunei;0;0;147;3
2020-10-20;BN;Brunei;0;0;147;3
2020-10-21;BN;Brunei;0;0;147;3
2020-10-22;BN;Brunei;1;0;148;3
2020-10-23;BN;Brunei;0;0;148;3
2020-10-24;BN;Brunei;0;0;148;3
2020-10-25;BN;Brunei;0;0;148;3
2020-10-26;BN;Brunei;0;0;148;3
2020-10-27;BN;Brunei;0;0;148;3
2020-10-28;BN;Brunei;0;0;148;3
2020-10-29;BN;Brunei;0;0;148;3
2020-10-30;BN;Brunei;0;0;148;3
2020-10-31;BN;Brunei;0;0;148;3
2020-11-01;BN;Brunei;0;0;148;3
2020-11-02;BN;Brunei;0;0;148;3
2020-11-03;BN;Brunei;0;0;148;3
2020-11-04;BN;Brunei;0;0;148;3
2020-11-05;BN;Brunei;0;0;148;3
2020-11-06;BN;Brunei;0;0;148;3
2020-11-07;BN;Brunei;0;0;148;3
2020-11-08;BN;Brunei;0;0;148;3
2020-11-09;BN;Brunei;0;0;148;3
2020-11-10;BN;Brunei;0;0;148;3
2020-11-11;BN;Brunei;0;0;148;3
2020-11-12;BN;Brunei;0;0;148;3
2020-11-13;BN;Brunei;0;0;148;3
2020-11-14;BN;Brunei;0;0;148;3
2020-11-15;BN;Brunei;0;0;148;3
2020-11-16;BN;Brunei;0;0;148;3
2020-11-17;BN;Brunei;0;0;148;3
2020-11-18;BN;Brunei;0;0;148;3
2020-11-19;BN;Brunei;0;0;148;3
2020-11-20;BN;Brunei;0;0;148;3
2020-11-21;BN;Brunei;0;0;148;3
2020-11-22;BN;Brunei;0;0;148;3
2020-11-23;BN;Brunei;1;0;149;3
2020-11-24;BN;Brunei;1;0;150;3
2020-11-25;BN;Brunei;0;0;150;3
2020-11-26;BN;Brunei;0;0;150;3
2020-11-27;BN;Brunei;0;0;150;3
2020-11-28;BN;Brunei;0;0;150;3
2020-11-29;BN;Brunei;0;0;150;3
2020-11-30;BN;Brunei;0;0;150;3
2020-12-01;BN;Brunei;1;0;151;3
2020-12-02;BN;Brunei;0;0;151;3
2020-12-03;BN;Brunei;0;0;151;3
2020-12-04;BN;Brunei;0;0;151;3
2020-12-05;BN;Brunei;0;0;151;3
2020-12-06;BN;Brunei;0;0;151;3
2020-12-07;BN;Brunei;0;0;151;3
2020-12-08;BN;Brunei;1;0;152;3
2020-12-09;BN;Brunei;0;0;152;3
2020-12-10;BN;Brunei;0;0;152;3
2020-12-11;BN;Brunei;0;0;152;3
2020-12-12;BN;Brunei;0;0;152;3
2020-12-13;BN;Brunei;0;0;152;3
2020-12-14;BN;Brunei;0;0;152;3
2020-12-15;BN;Brunei;0;0;152;3
2020-12-16;BN;Brunei;0;0;152;3
2020-12-17;BN;Brunei;0;0;152;3
2020-12-18;BN;Brunei;0;0;152;3
2020-12-19;BN;Brunei;0;0;152;3
2020-12-20;BN;Brunei;0;0;152;3
2020-12-21;BN;Brunei;0;0;152;3
2020-12-22;BN;Brunei;0;0;152;3
2020-12-23;BN;Brunei;0;0;152;3
2020-12-24;BN;Brunei;0;0;152;3
2020-12-25;BN;Brunei;0;0;152;3
2020-12-26;BN;Brunei;0;0;152;3
2020-12-27;BN;Brunei;0;0;152;3
2020-12-28;BN;Brunei;0;0;152;3
2020-12-29;BN;Brunei;0;0;152;3
2020-12-30;BN;Brunei;5;0;157;3
2020-12-31;BN;Brunei;0;0;157;3
2021-01-01;BN;Brunei;0;0;157;3
2021-01-02;BN;Brunei;0;0;157;3
2021-01-03;BN;Brunei;15;0;172;3
2021-01-04;BN;Brunei;0;0;172;3
2021-01-05;BN;Brunei;0;0;172;3
2021-01-06;BN;Brunei;0;0;172;3
2021-01-07;BN;Brunei;1;0;173;3
2021-01-08;BN;Brunei;0;0;173;3
2021-01-09;BN;Brunei;0;0;173;3
2021-01-10;BN;Brunei;0;0;173;3
2021-01-11;BN;Brunei;0;0;173;3
2021-01-12;BN;Brunei;1;0;174;3
2021-01-13;BN;Brunei;0;0;174;3
2021-01-14;BN;Brunei;0;0;174;3
2021-01-15;BN;Brunei;0;0;174;3
2021-01-16;BN;Brunei;0;0;174;3
2021-01-17;BN;Brunei;0;0;174;3
2021-01-18;BN;Brunei;0;0;174;3
2021-01-19;BN;Brunei;0;0;174;3
2021-01-20;BN;Brunei;0;0;174;3
2021-01-21;BN;Brunei;0;0;174;3
2021-01-22;BN;Brunei;1;0;175;3
2021-01-23;BN;Brunei;0;0;175;3
2021-01-24;BN;Brunei;0;0;175;3
2021-01-25;BN;Brunei;0;0;175;3
2021-01-26;BN;Brunei;1;0;176;3
2021-01-27;BN;Brunei;0;0;176;3
2021-01-28;BN;Brunei;4;0;180;3
2021-01-29;BN;Brunei;0;0;180;3
2021-01-30;BN;Brunei;0;0;180;3
2021-01-31;BN;Brunei;0;0;180;3
2021-02-01;BN;Brunei;0;0;180;3
2021-02-02;BN;Brunei;0;0;180;3
2021-02-03;BN;Brunei;0;0;180;3
2021-02-04;BN;Brunei;0;0;180;3
2021-02-05;BN;Brunei;0;0;180;3
2021-02-06;BN;Brunei;1;0;181;3
2021-02-07;BN;Brunei;0;0;181;3
2021-02-08;BN;Brunei;1;0;182;3
2021-02-09;BN;Brunei;0;0;182;3
2021-02-10;BN;Brunei;0;0;182;3
2021-02-11;BN;Brunei;1;0;183;3
2021-02-12;BN;Brunei;1;0;184;3
2021-02-13;BN;Brunei;0;0;184;3
2021-02-14;BN;Brunei;0;0;184;3
2021-02-15;BN;Brunei;0;0;184;3
2021-02-16;BN;Brunei;0;0;184;3
2021-02-17;BN;Brunei;1;0;185;3
2021-02-18;BN;Brunei;0;0;185;3
2021-02-19;BN;Brunei;0;0;185;3
2021-02-20;BN;Brunei;0;0;185;3
2021-02-21;BN;Brunei;0;0;185;3
2021-02-22;BN;Brunei;0;0;185;3
2021-02-23;BN;Brunei;0;0;185;3
2021-02-24;BN;Brunei;0;0;185;3
2021-02-25;BN;Brunei;0;0;185;3
2021-02-26;BN;Brunei;0;0;185;3
2021-02-27;BN;Brunei;1;0;186;3
2021-02-28;BN;Brunei;0;0;186;3
2021-03-01;BN;Brunei;0;0;186;3
2021-03-02;BN;Brunei;1;0;187;3
2021-03-03;BN;Brunei;0;0;187;3
2021-03-04;BN;Brunei;1;0;188;3
2021-03-05;BN;Brunei;0;0;188;3
2021-03-06;BN;Brunei;1;0;189;3
2021-03-07;BN;Brunei;0;0;189;3
2021-03-08;BN;Brunei;1;0;190;3
2021-03-09;BN;Brunei;1;0;191;3
2021-03-10;BN;Brunei;1;0;192;3
2021-03-11;BN;Brunei;0;0;192;3
2021-03-12;BN;Brunei;0;0;192;3
2021-03-13;BN;Brunei;0;0;192;3
2021-03-14;BN;Brunei;7;0;199;3
2021-03-15;BN;Brunei;0;0;199;3
2021-03-16;BN;Brunei;3;0;202;3
2021-03-17;BN;Brunei;1;0;203;3
2021-03-18;BN;Brunei;0;0;203;3
2021-03-19;BN;Brunei;0;0;203;3
2021-03-20;BN;Brunei;2;0;205;3
2021-03-21;BN;Brunei;1;0;206;3
2021-03-22;BN;Brunei;0;0;206;3
2021-03-23;BN;Brunei;0;0;206;3
2021-03-24;BN;Brunei;0;0;206;3
2021-03-25;BN;Brunei;0;0;206;3
2021-03-26;BN;Brunei;0;0;206;3
2021-03-27;BN;Brunei;0;0;206;3
2021-03-28;BN;Brunei;1;0;207;3
2021-03-29;BN;Brunei;0;0;207;3
2021-03-30;BN;Brunei;3;0;210;3
2021-03-31;BN;Brunei;2;0;212;3
2021-04-01;BN;Brunei;1;0;213;3
2021-04-02;BN;Brunei;0;0;213;3
2021-04-03;BN;Brunei;1;0;214;3
2021-04-04;BN;Brunei;0;0;214;3
2021-04-05;BN;Brunei;0;0;214;3
2021-04-06;BN;Brunei;0;0;214;3
2021-04-07;BN;Brunei;1;0;215;3
2021-04-08;BN;Brunei;1;0;216;3
2021-04-09;BN;Brunei;3;0;219;3
2021-04-10;BN;Brunei;0;0;219;3
2021-04-11;BN;Brunei;0;0;219;3
2021-04-12;BN;Brunei;0;0;219;3
2021-04-13;BN;Brunei;0;0;219;3
2021-04-14;BN;Brunei;0;0;219;3
2021-04-15;BN;Brunei;2;0;221;3
2021-04-16;BN;Brunei;0;0;221;3
2021-04-17;BN;Brunei;0;0;221;3
2021-04-18;BN;Brunei;0;0;221;3
2021-04-19;BN;Brunei;0;0;221;3
2021-04-20;BN;Brunei;2;0;223;3
2021-04-21;BN;Brunei;0;0;223;3
2021-04-22;BN;Brunei;0;0;223;3
2021-04-23;BN;Brunei;0;0;223;3
2021-04-24;BN;Brunei;0;0;223;3
2021-04-25;BN;Brunei;0;0;223;3
2021-04-26;BN;Brunei;0;0;223;3
2021-04-27;BN;Brunei;0;0;223;3
2021-04-28;BN;Brunei;1;0;224;3
2021-04-29;BN;Brunei;0;0;224;3
2021-04-30;BN;Brunei;0;0;224;3
2021-05-01;BN;Brunei;3;0;227;3
2021-05-02;BN;Brunei;0;0;227;3
2021-05-03;BN;Brunei;0;0;227;3
2021-05-04;BN;Brunei;1;0;228;3
2021-05-05;BN;Brunei;0;0;228;3
2021-05-06;BN;Brunei;0;0;228;3
2021-05-07;BN;Brunei;1;0;229;3
2021-05-08;BN;Brunei;1;0;230;3
2021-05-09;BN;Brunei;0;0;230;3
2021-05-10;BN;Brunei;0;0;230;3
2021-05-11;BN;Brunei;0;0;230;3
2021-05-12;BN;Brunei;1;0;231;3
2021-05-13;BN;Brunei;1;0;232;3
2021-05-14;BN;Brunei;0;0;232;3
2021-05-15;BN;Brunei;0;0;232;3
2021-05-16;BN;Brunei;0;0;232;3
2021-05-17;BN;Brunei;0;0;232;3
2021-05-18;BN;Brunei;0;0;232;3
2021-05-19;BN;Brunei;3;0;235;3
2021-05-20;BN;Brunei;0;0;235;3
2021-05-21;BN;Brunei;0;0;235;3
2021-05-22;BN;Brunei;0;0;235;3
2021-05-23;BN;Brunei;0;0;235;3
2021-05-24;BN;Brunei;1;0;236;3
2021-05-25;BN;Brunei;0;0;236;3
2021-05-26;BN;Brunei;4;0;240;3
2021-05-27;BN;Brunei;1;0;241;3
2021-05-28;BN;Brunei;0;0;241;3
2021-05-29;BN;Brunei;0;0;241;3
2021-05-30;BN;Brunei;0;0;241;3
2021-05-31;BN;Brunei;1;0;242;3
2021-06-01;BN;Brunei;2;0;244;3
2021-06-02;BN;Brunei;0;0;244;3
2021-06-03;BN;Brunei;0;0;244;3
2021-06-04;BN;Brunei;0;0;244;3
2021-06-05;BN;Brunei;0;0;244;3
2021-06-06;BN;Brunei;0;0;244;3
2021-06-07;BN;Brunei;0;0;244;3
2021-06-08;BN;Brunei;2;0;246;3
2021-06-09;BN;Brunei;0;0;246;3
2021-06-10;BN;Brunei;2;0;248;3
2021-06-11;BN;Brunei;0;0;248;3
2021-06-12;BN;Brunei;0;0;248;3
2021-06-13;BN;Brunei;0;0;248;3
2021-06-14;BN;Brunei;0;0;248;3
2021-06-15;BN;Brunei;2;0;250;3
2021-06-16;BN;Brunei;0;0;250;3
2021-06-17;BN;Brunei;0;0;250;3
2021-06-18;BN;Brunei;1;0;251;3
2021-06-19;BN;Brunei;0;0;251;3
2021-06-20;BN;Brunei;4;0;255;3
2021-06-21;BN;Brunei;0;0;255;3
2021-06-22;BN;Brunei;1;0;256;3
2021-06-23;BN;Brunei;0;0;256;3
2021-06-24;BN;Brunei;0;0;256;3
2021-06-25;BN;Brunei;0;0;256;3
2021-06-26;BN;Brunei;3;0;259;3
2021-06-27;BN;Brunei;0;0;259;3
2021-06-28;BN;Brunei;0;0;259;3
2021-06-29;BN;Brunei;0;0;259;3
2021-06-30;BN;Brunei;1;0;260;3
2021-07-01;BN;Brunei;1;0;261;3
2020-03-08;BG;Bulgaria;4;0;4;0
2020-03-09;BG;Bulgaria;0;0;4;0
2020-03-10;BG;Bulgaria;0;0;4;0
2020-03-11;BG;Bulgaria;3;1;7;1
2020-03-12;BG;Bulgaria;0;0;7;1
2020-03-13;BG;Bulgaria;16;0;23;1
2020-03-14;BG;Bulgaria;18;1;41;2
2020-03-15;BG;Bulgaria;10;0;51;2
2020-03-16;BG;Bulgaria;1;0;52;2
2020-03-17;BG;Bulgaria;15;0;67;2
2020-03-18;BG;Bulgaria;25;0;92;2
2020-03-19;BG;Bulgaria;2;1;94;3
2020-03-20;BG;Bulgaria;33;0;127;3
2020-03-21;BG;Bulgaria;36;0;163;3
2020-03-22;BG;Bulgaria;24;0;187;3
2020-03-23;BG;Bulgaria;14;0;201;3
2020-03-24;BG;Bulgaria;17;0;218;3
2020-03-25;BG;Bulgaria;24;0;242;3
2020-03-26;BG;Bulgaria;22;0;264;3
2020-03-27;BG;Bulgaria;29;0;293;3
2020-03-28;BG;Bulgaria;38;4;331;7
2020-03-29;BG;Bulgaria;15;1;346;8
2020-03-30;BG;Bulgaria;13;0;359;8
2020-03-31;BG;Bulgaria;40;0;399;8
2020-04-01;BG;Bulgaria;23;2;422;10
2020-04-02;BG;Bulgaria;35;0;457;10
2020-04-03;BG;Bulgaria;28;4;485;14
2020-04-04;BG;Bulgaria;18;3;503;17
2020-04-05;BG;Bulgaria;28;3;531;20
2020-04-06;BG;Bulgaria;18;2;549;22
2020-04-07;BG;Bulgaria;28;1;577;23
2020-04-08;BG;Bulgaria;16;1;593;24
2020-04-09;BG;Bulgaria;25;0;618;24
2020-04-10;BG;Bulgaria;17;1;635;25
2020-04-11;BG;Bulgaria;26;3;661;28
2020-04-12;BG;Bulgaria;14;1;675;29
2020-04-13;BG;Bulgaria;10;3;685;32
2020-04-14;BG;Bulgaria;28;3;713;35
2020-04-15;BG;Bulgaria;34;1;747;36
2020-04-16;BG;Bulgaria;53;2;800;38
2020-04-17;BG;Bulgaria;46;3;846;41
2020-04-18;BG;Bulgaria;32;0;878;41
2020-04-19;BG;Bulgaria;16;1;894;42
2020-04-20;BG;Bulgaria;35;1;929;43
2020-04-21;BG;Bulgaria;46;2;975;45
2020-04-22;BG;Bulgaria;49;4;1024;49
2020-04-23;BG;Bulgaria;73;3;1097;52
2020-04-24;BG;Bulgaria;137;2;1234;54
2020-04-25;BG;Bulgaria;13;1;1247;55
2020-04-26;BG;Bulgaria;53;1;1300;56
2020-04-27;BG;Bulgaria;63;2;1363;58
2020-04-28;BG;Bulgaria;36;0;1399;58
2020-04-29;BG;Bulgaria;48;6;1447;64
2020-04-30;BG;Bulgaria;59;2;1506;66
2020-05-01;BG;Bulgaria;49;2;1555;68
2020-05-02;BG;Bulgaria;39;4;1594;72
2020-05-03;BG;Bulgaria;24;1;1618;73
2020-05-04;BG;Bulgaria;34;5;1652;78
2020-05-05;BG;Bulgaria;52;2;1704;80
2020-05-06;BG;Bulgaria;74;4;1778;84
2020-05-07;BG;Bulgaria;51;0;1829;84
2020-05-08;BG;Bulgaria;43;2;1872;86
2020-05-09;BG;Bulgaria;49;4;1921;90
2020-05-10;BG;Bulgaria;44;1;1965;91
2020-05-11;BG;Bulgaria;25;2;1990;93
2020-05-12;BG;Bulgaria;33;2;2023;95
2020-05-13;BG;Bulgaria;46;1;2069;96
2020-05-14;BG;Bulgaria;31;3;2100;99
2020-05-15;BG;Bulgaria;38;3;2138;102
2020-05-16;BG;Bulgaria;37;3;2175;105
2020-05-17;BG;Bulgaria;36;3;2211;108
2020-05-18;BG;Bulgaria;24;2;2235;110
2020-05-19;BG;Bulgaria;24;2;2259;112
2020-05-20;BG;Bulgaria;33;4;2292;116
2020-05-21;BG;Bulgaria;39;4;2331;120
2020-05-22;BG;Bulgaria;41;5;2372;125
2020-05-23;BG;Bulgaria;36;1;2408;126
2020-05-24;BG;Bulgaria;19;4;2427;130
2020-05-25;BG;Bulgaria;6;0;2433;130
2020-05-26;BG;Bulgaria;10;0;2443;130
2020-05-27;BG;Bulgaria;17;3;2460;133
2020-05-28;BG;Bulgaria;17;1;2477;134
2020-05-29;BG;Bulgaria;8;2;2485;136
2020-05-30;BG;Bulgaria;14;3;2499;139
2020-05-31;BG;Bulgaria;14;1;2513;140
2020-06-01;BG;Bulgaria;6;0;2519;140
2020-06-02;BG;Bulgaria;19;4;2538;144
2020-06-03;BG;Bulgaria;22;2;2560;146
2020-06-04;BG;Bulgaria;25;1;2585;147
2020-06-05;BG;Bulgaria;42;12;2627;159
2020-06-06;BG;Bulgaria;84;1;2711;160
2020-06-07;BG;Bulgaria;16;0;2727;160
2020-06-08;BG;Bulgaria;83;4;2810;164
2020-06-09;BG;Bulgaria;79;3;2889;167
2020-06-10;BG;Bulgaria;104;0;2993;167
2020-06-11;BG;Bulgaria;93;1;3086;168
2020-06-12;BG;Bulgaria;105;4;3191;172
2020-06-13;BG;Bulgaria;75;0;3266;172
2020-06-14;BG;Bulgaria;24;2;3290;174
2020-06-15;BG;Bulgaria;51;2;3341;176
2020-06-16;BG;Bulgaria;112;5;3453;181
2020-06-17;BG;Bulgaria;89;3;3542;184
2020-06-18;BG;Bulgaria;132;6;3674;190
2020-06-19;BG;Bulgaria;81;3;3755;193
2020-06-20;BG;Bulgaria;117;6;3872;199
2020-06-21;BG;Bulgaria;33;0;3905;199
2020-06-22;BG;Bulgaria;79;8;3984;207
2020-06-23;BG;Bulgaria;130;1;4114;208
2020-06-24;BG;Bulgaria;128;1;4242;209
2020-06-25;BG;Bulgaria;166;2;4408;211
2020-06-26;BG;Bulgaria;105;4;4513;215
2020-06-27;BG;Bulgaria;112;1;4625;216
2020-06-28;BG;Bulgaria;66;3;4691;219
2020-06-29;BG;Bulgaria;140;4;4831;223
2020-06-30;BG;Bulgaria;158;7;4989;230
2020-07-01;BG;Bulgaria;165;2;5154;232
2020-07-02;BG;Bulgaria;161;0;5315;232
2020-07-03;BG;Bulgaria;182;7;5497;239
2020-07-04;BG;Bulgaria;180;2;5677;241
2020-07-05;BG;Bulgaria;63;5;5740;246
2020-07-06;BG;Bulgaria;174;4;5914;250
2020-07-07;BG;Bulgaria;188;4;6102;254
2020-07-08;BG;Bulgaria;240;5;6342;259
2020-07-09;BG;Bulgaria;330;3;6672;262
2020-07-10;BG;Bulgaria;292;5;6964;267
2020-07-11;BG;Bulgaria;211;0;7175;267
2020-07-12;BG;Bulgaria;77;1;7252;268
2020-07-13;BG;Bulgaria;159;8;7411;276
2020-07-14;BG;Bulgaria;234;7;7645;283
2020-07-15;BG;Bulgaria;232;6;7877;289
2020-07-16;BG;Bulgaria;267;4;8144;293
2020-07-17;BG;Bulgaria;298;4;8442;297
2020-07-18;BG;Bulgaria;196;2;8638;299
2020-07-19;BG;Bulgaria;95;1;8733;300
2020-07-20;BG;Bulgaria;196;8;8929;308
2020-07-21;BG;Bulgaria;325;5;9254;313
2020-07-22;BG;Bulgaria;330;8;9584;321
2020-07-23;BG;Bulgaria;269;8;9853;329
2020-07-24;BG;Bulgaria;270;8;10123;337
2020-07-25;BG;Bulgaria;189;1;10312;338
2020-07-26;BG;Bulgaria;115;2;10427;340
2020-07-27;BG;Bulgaria;194;7;10621;347
2020-07-28;BG;Bulgaria;250;8;10871;355
2020-07-29;BG;Bulgaria;284;13;11155;368
2020-07-30;BG;Bulgaria;265;6;11420;374
2020-07-31;BG;Bulgaria;270;9;11690;383
2020-08-01;BG;Bulgaria;146;2;11836;385
2020-08-02;BG;Bulgaria;119;3;11955;388
2020-08-03;BG;Bulgaria;204;16;12159;404
2020-08-04;BG;Bulgaria;255;11;12414;415
2020-08-05;BG;Bulgaria;303;9;12717;424
2020-08-06;BG;Bulgaria;297;11;13014;435
2020-08-07;BG;Bulgaria;195;7;13209;442
2020-08-08;BG;Bulgaria;134;3;13343;445
2020-08-09;BG;Bulgaria;53;2;13396;447
2020-08-10;BG;Bulgaria;116;12;13512;459
2020-08-11;BG;Bulgaria;210;12;13722;471
2020-08-12;BG;Bulgaria;171;11;13893;482
2020-08-13;BG;Bulgaria;0;0;13893;482
2020-08-14;BG;Bulgaria;350;10;14243;492
2020-08-15;BG;Bulgaria;90;3;14333;495
2020-08-16;BG;Bulgaria;32;3;14365;498
2020-08-17;BG;Bulgaria;135;14;14500;512
2020-08-18;BG;Bulgaria;169;7;14669;519
2020-08-19;BG;Bulgaria;151;8;14820;527
2020-08-20;BG;Bulgaria;142;5;14962;532
2020-08-21;BG;Bulgaria;169;7;15131;539
2020-08-22;BG;Bulgaria;0;0;15131;539
2020-08-23;BG;Bulgaria;156;6;15287;545
2020-08-24;BG;Bulgaria;99;18;15386;563
2020-08-25;BG;Bulgaria;203;9;15589;572
2020-08-26;BG;Bulgaria;162;14;15751;586
2020-08-27;BG;Bulgaria;157;8;15908;594
2020-08-28;BG;Bulgaria;157;9;16065;603
2020-08-29;BG;Bulgaria;99;2;16164;605
2020-08-30;BG;Bulgaria;26;8;16190;613
2020-08-31;BG;Bulgaria;76;16;16266;629
2020-09-01;BG;Bulgaria;188;13;16454;642
2020-09-02;BG;Bulgaria;163;6;16617;648
2020-09-03;BG;Bulgaria;158;10;16775;658
2020-09-04;BG;Bulgaria;179;7;16954;665
2020-09-05;BG;Bulgaria;96;6;17050;671
2020-09-06;BG;Bulgaria;39;5;17089;676
2020-09-07;BG;Bulgaria;57;1;17146;677
2020-09-08;BG;Bulgaria;167;15;17313;692
2020-09-09;BG;Bulgaria;122;10;17435;702
2020-09-10;BG;Bulgaria;163;4;17598;706
2020-09-11;BG;Bulgaria;201;7;17799;713
2020-09-12;BG;Bulgaria;92;4;17891;717
2020-09-13;BG;Bulgaria;27;3;17918;720
2020-09-14;BG;Bulgaria;143;9;18061;729
2020-09-15;BG;Bulgaria;155;7;18216;736
2020-09-16;BG;Bulgaria;174;3;18390;739
2020-09-17;BG;Bulgaria;154;10;18544;749
2020-09-18;BG;Bulgaria;189;4;18733;753
2020-09-19;BG;Bulgaria;86;2;18819;755
2020-09-20;BG;Bulgaria;44;6;18863;761
2020-09-21;BG;Bulgaria;151;4;19014;765
2020-09-22;BG;Bulgaria;109;2;19123;767
2020-09-23;BG;Bulgaria;160;12;19283;779
2020-09-24;BG;Bulgaria;290;6;19573;785
2020-09-25;BG;Bulgaria;255;4;19828;789
2020-09-26;BG;Bulgaria;169;0;19997;789
2020-09-27;BG;Bulgaria;58;7;20055;796
2020-09-28;BG;Bulgaria;216;11;20271;807
2020-09-29;BG;Bulgaria;276;6;20547;813
2020-09-30;BG;Bulgaria;286;12;20833;825
2020-10-01;BG;Bulgaria;0;0;20833;825
2020-10-02;BG;Bulgaria;503;13;21336;838
2020-10-03;BG;Bulgaria;182;3;21518;841
2020-10-04;BG;Bulgaria;69;3;21587;844
2020-10-05;BG;Bulgaria;283;10;21870;854
2020-10-06;BG;Bulgaria;436;8;22306;862
2020-10-07;BG;Bulgaria;437;11;22743;873
2020-10-08;BG;Bulgaria;516;7;23259;880
2020-10-09;BG;Bulgaria;612;7;23871;887
2020-10-10;BG;Bulgaria;448;4;24319;891
2020-10-11;BG;Bulgaria;83;1;24402;892
2020-10-12;BG;Bulgaria;587;23;24989;915
2020-10-13;BG;Bulgaria;785;8;25774;923
2020-10-14;BG;Bulgaria;819;6;26593;929
2020-10-15;BG;Bulgaria;914;15;27507;944
2020-10-16;BG;Bulgaria;998;14;28505;958
2020-10-17;BG;Bulgaria;603;10;29108;968
2020-10-18;BG;Bulgaria;395;18;29503;986
2020-10-19;BG;Bulgaria;1024;22;30527;1008
2020-10-20;BG;Bulgaria;1336;11;31863;1019
2020-10-21;BG;Bulgaria;1472;29;33335;1048
2020-10-22;BG;Bulgaria;1595;16;34930;1064
2020-10-23;BG;Bulgaria;1589;13;36519;1077
2020-10-24;BG;Bulgaria;1043;7;37562;1084
2020-10-25;BG;Bulgaria;327;10;37889;1094
2020-10-26;BG;Bulgaria;2243;42;40132;1136
2020-10-27;BG;Bulgaria;2569;25;42701;1161
2020-10-28;BG;Bulgaria;2760;36;45461;1197
2020-10-29;BG;Bulgaria;2689;28;48150;1225
2020-10-30;BG;Bulgaria;2891;29;51041;1254
2020-10-31;BG;Bulgaria;1803;25;52844;1279
2020-11-01;BG;Bulgaria;1225;19;54069;1298
2020-11-02;BG;Bulgaria;2427;51;56496;1349
2020-11-03;BG;Bulgaria;4041;63;60537;1412
2020-11-04;BG;Bulgaria;4054;54;64591;1466
2020-11-05;BG;Bulgaria;3754;52;68345;1518
2020-11-06;BG;Bulgaria;3839;58;72184;1576
2020-11-07;BG;Bulgaria;2301;56;74485;1632
2020-11-08;BG;Bulgaria;675;33;75160;1665
2020-11-09;BG;Bulgaria;3816;106;78976;1771
2020-11-10;BG;Bulgaria;4390;80;83366;1851
2020-11-11;BG;Bulgaria;3945;47;87311;1898
2020-11-12;BG;Bulgaria;3414;72;90725;1970
2020-11-13;BG;Bulgaria;4212;85;94937;2055
2020-11-14;BG;Bulgaria;2498;36;97435;2091
2020-11-15;BG;Bulgaria;816;39;98251;2130
2020-11-16;BG;Bulgaria;3519;152;101770;2282
2020-11-17;BG;Bulgaria;4828;131;106598;2413
2020-11-18;BG;Bulgaria;3938;117;110536;2530
2020-11-19;BG;Bulgaria;3899;119;114435;2649
2020-11-20;BG;Bulgaria;3983;129;118418;2778
2020-11-21;BG;Bulgaria;2279;42;120697;2820
2020-11-22;BG;Bulgaria;1123;60;121820;2880
2020-11-23;BG;Bulgaria;3146;189;124966;3069
2020-11-24;BG;Bulgaria;4382;157;129348;3226
2020-11-25;BG;Bulgaria;3712;141;133060;3367
2020-11-26;BG;Bulgaria;3568;162;136628;3529
2020-11-27;BG;Bulgaria;3327;151;139955;3680
2020-11-28;BG;Bulgaria;1792;69;141747;3749
2020-11-29;BG;Bulgaria;739;65;142486;3814
2020-11-30;BG;Bulgaria;2814;221;145300;4035
2020-12-01;BG;Bulgaria;3475;153;148775;4188
2020-12-02;BG;Bulgaria;3138;159;151913;4347
2020-12-03;BG;Bulgaria;3280;156;155193;4503
2020-12-04;BG;Bulgaria;3614;147;158807;4650
2020-12-05;BG;Bulgaria;2037;79;160844;4729
2020-12-06;BG;Bulgaria;577;68;161421;4797
2020-12-07;BG;Bulgaria;2764;213;164185;5010
2020-12-08;BG;Bulgaria;3980;146;168165;5156
2020-12-09;BG;Bulgaria;3328;127;171493;5283
2020-12-10;BG;Bulgaria;3075;122;174568;5405
2020-12-11;BG;Bulgaria;3097;157;177665;5562
2020-12-12;BG;Bulgaria;1287;64;178952;5626
2020-12-13;BG;Bulgaria;497;62;179449;5688
2020-12-14;BG;Bulgaria;2095;150;181544;5838
2020-12-15;BG;Bulgaria;2743;167;184287;6005
2020-12-16;BG;Bulgaria;1959;191;186246;6196
2020-12-17;BG;Bulgaria;2042;143;188288;6339
2020-12-18;BG;Bulgaria;1739;157;190027;6496
2020-12-19;BG;Bulgaria;1002;55;191029;6551
2020-12-20;BG;Bulgaria;166;58;191195;6609
2020-12-21;BG;Bulgaria;1277;156;192472;6765
2020-12-22;BG;Bulgaria;1799;114;194271;6879
2020-12-23;BG;Bulgaria;1615;99;195886;6978
2020-12-24;BG;Bulgaria;772;45;196658;7023
2020-12-25;BG;Bulgaria;257;50;196915;7073
2020-12-26;BG;Bulgaria;469;50;197384;7123
2020-12-27;BG;Bulgaria;332;41;197716;7164
2020-12-28;BG;Bulgaria;337;87;198053;7251
2020-12-29;BG;Bulgaria;1438;154;199491;7405
2020-12-30;BG;Bulgaria;1729;110;201220;7515
2020-12-31;BG;Bulgaria;1046;61;202266;7576
2021-01-01;BG;Bulgaria;274;28;202540;7604
2021-01-02;BG;Bulgaria;340;40;202880;7644
2021-01-03;BG;Bulgaria;171;34;203051;7678
2021-01-04;BG;Bulgaria;1029;157;204080;7835
2021-01-05;BG;Bulgaria;1310;67;205390;7902
2021-01-06;BG;Bulgaria;1002;59;206392;7961
2021-01-07;BG;Bulgaria;867;56;207259;8017
2021-01-08;BG;Bulgaria;753;61;208012;8078
2021-01-09;BG;Bulgaria;394;19;208406;8097
2021-01-10;BG;Bulgaria;105;29;208511;8126
2021-01-11;BG;Bulgaria;620;106;209131;8232
2021-01-12;BG;Bulgaria;750;47;209881;8279
2021-01-13;BG;Bulgaria;535;70;210416;8349
2021-01-14;BG;Bulgaria;535;47;210951;8396
2021-01-15;BG;Bulgaria;552;61;211503;8457
2021-01-16;BG;Bulgaria;233;17;211736;8474
2021-01-17;BG;Bulgaria;77;9;211813;8483
2021-01-18;BG;Bulgaria;570;82;212383;8565
2021-01-19;BG;Bulgaria;544;49;212927;8614
2021-01-20;BG;Bulgaria;482;37;213409;8651
2021-01-21;BG;Bulgaria;455;90;213864;8741
2021-01-22;BG;Bulgaria;566;58;214430;8799
2021-01-23;BG;Bulgaria;266;12;214696;8811
2021-01-24;BG;Bulgaria;121;9;214817;8820
2021-01-25;BG;Bulgaria;772;60;215589;8880
2021-01-26;BG;Bulgaria;827;36;216416;8916
2021-01-27;BG;Bulgaria;598;28;217014;8944
2021-01-28;BG;Bulgaria;560;29;217574;8973
2021-01-29;BG;Bulgaria;695;35;218269;9008
2021-01-30;BG;Bulgaria;349;20;218618;9028
2021-01-31;BG;Bulgaria;130;17;218748;9045
2021-02-01;BG;Bulgaria;832;97;219580;9142
2021-02-02;BG;Bulgaria;967;36;220547;9178
2021-02-03;BG;Bulgaria;719;40;221266;9218
2021-02-04;BG;Bulgaria;883;54;222149;9272
2021-02-05;BG;Bulgaria;910;30;223059;9302
2021-02-06;BG;Bulgaria;493;9;223552;9311
2021-02-07;BG;Bulgaria;182;20;223734;9331
2021-02-08;BG;Bulgaria;1115;89;224849;9420
2021-02-09;BG;Bulgaria;1212;62;226061;9482
2021-02-10;BG;Bulgaria;913;45;226974;9527
2021-02-11;BG;Bulgaria;1070;34;228044;9561
2021-02-12;BG;Bulgaria;966;33;229010;9594
2021-02-13;BG;Bulgaria;506;14;229516;9608
2021-02-14;BG;Bulgaria;163;16;229679;9624
2021-02-15;BG;Bulgaria;1068;47;230747;9671
2021-02-16;BG;Bulgaria;1349;32;232096;9703
2021-02-17;BG;Bulgaria;1246;41;233342;9744
2021-02-18;BG;Bulgaria;1086;42;234428;9786
2021-02-19;BG;Bulgaria;1463;35;235891;9821
2021-02-20;BG;Bulgaria;548;18;236439;9839
2021-02-21;BG;Bulgaria;227;15;236666;9854
2021-02-22;BG;Bulgaria;1925;79;238591;9933
2021-02-23;BG;Bulgaria;1800;45;240391;9978
2021-02-24;BG;Bulgaria;1733;48;242124;10026
2021-02-25;BG;Bulgaria;1822;53;243946;10079
2021-02-26;BG;Bulgaria;1681;49;245627;10128
2021-02-27;BG;Bulgaria;1079;39;246706;10167
2021-02-28;BG;Bulgaria;332;24;247038;10191
2021-03-01;BG;Bulgaria;2588;117;249626;10308
2021-03-02;BG;Bulgaria;2403;83;252029;10391
2021-03-03;BG;Bulgaria;1154;22;253183;10413
2021-03-04;BG;Bulgaria;2198;93;255381;10506
2021-03-05;BG;Bulgaria;3004;65;258385;10571
2021-03-06;BG;Bulgaria;1426;22;259811;10593
2021-03-07;BG;Bulgaria;497;21;260308;10614
2021-03-08;BG;Bulgaria;2995;150;263303;10764
2021-03-09;BG;Bulgaria;3502;138;266805;10902
2021-03-10;BG;Bulgaria;2774;97;269579;10999
2021-03-11;BG;Bulgaria;3121;95;272700;11094
2021-03-12;BG;Bulgaria;3159;102;275859;11196
2021-03-13;BG;Bulgaria;2019;38;277878;11234
2021-03-14;BG;Bulgaria;679;51;278557;11285
2021-03-15;BG;Bulgaria;4637;187;283194;11472
2021-03-16;BG;Bulgaria;4374;107;287568;11579
2021-03-17;BG;Bulgaria;4201;136;291769;11715
2021-03-18;BG;Bulgaria;4008;102;295777;11817
2021-03-19;BG;Bulgaria;4162;115;299939;11932
2021-03-20;BG;Bulgaria;2541;34;302480;11966
2021-03-21;BG;Bulgaria;943;53;303423;12019
2021-03-22;BG;Bulgaria;4467;169;307890;12188
2021-03-23;BG;Bulgaria;4851;119;312741;12307
2021-03-24;BG;Bulgaria;4375;106;317116;12413
2021-03-25;BG;Bulgaria;3988;99;321104;12512
2021-03-26;BG;Bulgaria;4129;89;325233;12601
2021-03-27;BG;Bulgaria;2537;49;327770;12650
2021-03-28;BG;Bulgaria;983;60;328753;12710
2021-03-29;BG;Bulgaria;4497;203;333250;12913
2021-03-30;BG;Bulgaria;5176;155;338426;13068
2021-03-31;BG;Bulgaria;4207;129;342633;13197
2021-04-01;BG;Bulgaria;3694;116;346327;13313
2021-04-02;BG;Bulgaria;4013;125;350340;13438
2021-04-03;BG;Bulgaria;1919;69;352259;13507
2021-04-04;BG;Bulgaria;740;82;352999;13589
2021-04-05;BG;Bulgaria;3860;197;356859;13786
2021-04-06;BG;Bulgaria;0;0;356859;13786
2021-04-07;BG;Bulgaria;7560;248;364419;14034
2021-04-08;BG;Bulgaria;2957;136;367376;14170
2021-04-09;BG;Bulgaria;2803;138;370179;14308
2021-04-10;BG;Bulgaria;1352;43;371531;14351
2021-04-11;BG;Bulgaria;462;67;371993;14418
2021-04-12;BG;Bulgaria;3122;201;375115;14619
2021-04-13;BG;Bulgaria;2944;127;378059;14746
2021-04-14;BG;Bulgaria;2517;125;380576;14871
2021-04-15;BG;Bulgaria;2185;108;382761;14979
2021-04-16;BG;Bulgaria;2126;121;384887;15100
2021-04-17;BG;Bulgaria;1076;38;385963;15138
2021-04-18;BG;Bulgaria;418;57;386381;15195
2021-04-19;BG;Bulgaria;2434;217;388815;15412
2021-04-20;BG;Bulgaria;2096;106;390911;15518
2021-04-21;BG;Bulgaria;2002;100;392913;15618
2021-04-22;BG;Bulgaria;0;0;392913;15618
2021-04-23;BG;Bulgaria;3389;208;396302;15826
2021-04-24;BG;Bulgaria;798;33;397100;15859
2021-04-25;BG;Bulgaria;400;48;397500;15907
2021-04-26;BG;Bulgaria;1759;194;399259;16101
2021-04-27;BG;Bulgaria;1850;81;401109;16182
2021-04-28;BG;Bulgaria;1382;96;402491;16278
2021-04-29;BG;Bulgaria;1237;90;403728;16368
2021-04-30;BG;Bulgaria;652;31;404380;16399
2021-05-01;BG;Bulgaria;466;45;404846;16444
2021-05-02;BG;Bulgaria;348;48;405194;16492
2021-05-03;BG;Bulgaria;631;56;405825;16548
2021-05-04;BG;Bulgaria;367;61;406192;16609
2021-05-05;BG;Bulgaria;1635;164;407827;16773
2021-05-06;BG;Bulgaria;545;27;408372;16800
2021-05-07;BG;Bulgaria;1123;86;409495;16886
2021-05-08;BG;Bulgaria;466;16;409961;16902
2021-05-09;BG;Bulgaria;241;27;410202;16929
2021-05-10;BG;Bulgaria;1078;116;411280;17045
2021-05-11;BG;Bulgaria;877;59;412157;17104
2021-05-12;BG;Bulgaria;657;46;412814;17150
2021-05-13;BG;Bulgaria;506;44;413320;17194
2021-05-14;BG;Bulgaria;518;49;413838;17243
2021-05-15;BG;Bulgaria;203;7;414041;17250
2021-05-16;BG;Bulgaria;151;9;414192;17259
2021-05-17;BG;Bulgaria;677;84;414869;17343
2021-05-18;BG;Bulgaria;457;36;415326;17379
2021-05-19;BG;Bulgaria;361;37;415687;17416
2021-05-20;BG;Bulgaria;368;31;416055;17447
2021-05-21;BG;Bulgaria;362;27;416417;17474
2021-05-22;BG;Bulgaria;148;13;416565;17487
2021-05-23;BG;Bulgaria;81;9;416646;17496
2021-05-24;BG;Bulgaria;81;17;416727;17513
2021-05-25;BG;Bulgaria;406;68;417133;17581
2021-05-26;BG;Bulgaria;393;36;417526;17617
2021-05-27;BG;Bulgaria;293;20;417819;17637
2021-05-28;BG;Bulgaria;287;15;418106;17652
2021-05-29;BG;Bulgaria;115;5;418221;17657
2021-05-30;BG;Bulgaria;53;5;418274;17662
2021-05-31;BG;Bulgaria;303;38;418577;17700
2021-06-01;BG;Bulgaria;236;26;418813;17726
2021-06-02;BG;Bulgaria;197;21;419010;17747
2021-06-03;BG;Bulgaria;170;45;419180;17792
2021-06-04;BG;Bulgaria;157;18;419337;17810
2021-06-05;BG;Bulgaria;89;3;419426;17813
2021-06-06;BG;Bulgaria;47;7;419473;17820
2021-06-07;BG;Bulgaria;208;34;419681;17854
2021-06-08;BG;Bulgaria;178;6;419859;17860
2021-06-09;BG;Bulgaria;131;12;419990;17872
2021-06-10;BG;Bulgaria;100;15;420090;17887
2021-06-11;BG;Bulgaria;123;6;420213;17893
2021-06-12;BG;Bulgaria;81;5;420294;17898
2021-06-13;BG;Bulgaria;42;2;420336;17900
2021-06-14;BG;Bulgaria;157;15;420493;17915
2021-06-15;BG;Bulgaria;161;17;420654;17932
2021-06-16;BG;Bulgaria;95;25;420749;17957
2021-06-17;BG;Bulgaria;110;23;420859;17980
2021-06-18;BG;Bulgaria;105;7;420964;17987
2021-06-19;BG;Bulgaria;41;2;421005;17989
2021-06-20;BG;Bulgaria;27;1;421032;17990
2021-06-21;BG;Bulgaria;120;10;421152;18000
2021-06-22;BG;Bulgaria;94;8;421246;18008
2021-06-23;BG;Bulgaria;93;5;421339;18013
2021-06-24;BG;Bulgaria;62;9;421401;18022
2021-06-25;BG;Bulgaria;86;4;421487;18026
2021-06-26;BG;Bulgaria;28;1;421515;18027
2021-06-27;BG;Bulgaria;16;0;421531;18027
2021-06-28;BG;Bulgaria;115;13;421646;18040
2021-06-29;BG;Bulgaria;105;9;421751;18049
2021-06-30;BG;Bulgaria;78;12;421829;18061
2021-07-01;BG;Bulgaria;73;6;421902;18067
2020-03-10;BF;Burkina Faso;1;0;1;0
2020-03-11;BF;Burkina Faso;1;0;2;0
2020-03-12;BF;Burkina Faso;0;0;2;0
2020-03-13;BF;Burkina Faso;0;0;2;0
2020-03-14;BF;Burkina Faso;0;0;2;0
2020-03-15;BF;Burkina Faso;1;0;3;0
2020-03-16;BF;Burkina Faso;12;0;15;0
2020-03-17;BF;Burkina Faso;0;0;15;0
2020-03-18;BF;Burkina Faso;5;1;20;1
2020-03-19;BF;Burkina Faso;13;0;33;1
2020-03-20;BF;Burkina Faso;7;0;40;1
2020-03-21;BF;Burkina Faso;24;1;64;2
2020-03-22;BF;Burkina Faso;11;2;75;4
2020-03-23;BF;Burkina Faso;24;0;99;4
2020-03-24;BF;Burkina Faso;15;0;114;4
2020-03-25;BF;Burkina Faso;32;0;146;4
2020-03-26;BF;Burkina Faso;6;3;152;7
2020-03-27;BF;Burkina Faso;28;2;180;9
2020-03-28;BF;Burkina Faso;27;2;207;11
2020-03-29;BF;Burkina Faso;15;1;222;12
2020-03-30;BF;Burkina Faso;24;0;246;12
2020-03-31;BF;Burkina Faso;15;2;261;14
2020-04-01;BF;Burkina Faso;21;2;282;16
2020-04-02;BF;Burkina Faso;6;0;288;16
2020-04-03;BF;Burkina Faso;14;0;302;16
2020-04-04;BF;Burkina Faso;16;0;318;16
2020-04-05;BF;Burkina Faso;27;1;345;17
2020-04-06;BF;Burkina Faso;19;1;364;18
2020-04-07;BF;Burkina Faso;20;1;384;19
2020-04-08;BF;Burkina Faso;30;4;414;23
2020-04-09;BF;Burkina Faso;29;1;443;24
2020-04-10;BF;Burkina Faso;0;0;443;24
2020-04-11;BF;Burkina Faso;41;3;484;27
2020-04-12;BF;Burkina Faso;13;0;497;27
2020-04-13;BF;Burkina Faso;0;0;497;27
2020-04-14;BF;Burkina Faso;31;3;528;30
2020-04-15;BF;Burkina Faso;14;2;542;32
2020-04-16;BF;Burkina Faso;4;0;546;32
2020-04-17;BF;Burkina Faso;11;3;557;35
2020-04-18;BF;Burkina Faso;8;1;565;36
2020-04-19;BF;Burkina Faso;11;0;576;36
2020-04-20;BF;Burkina Faso;5;2;581;38
2020-04-21;BF;Burkina Faso;19;0;600;38
2020-04-22;BF;Burkina Faso;9;1;609;39
2020-04-23;BF;Burkina Faso;7;2;616;41
2020-04-24;BF;Burkina Faso;13;0;629;41
2020-04-25;BF;Burkina Faso;0;0;629;41
2020-04-26;BF;Burkina Faso;3;1;632;42
2020-04-27;BF;Burkina Faso;3;0;635;42
2020-04-28;BF;Burkina Faso;3;0;638;42
2020-04-29;BF;Burkina Faso;3;1;641;43
2020-04-30;BF;Burkina Faso;4;0;645;43
2020-05-01;BF;Burkina Faso;4;1;649;44
2020-05-02;BF;Burkina Faso;3;0;652;44
2020-05-03;BF;Burkina Faso;10;1;662;45
2020-05-04;BF;Burkina Faso;10;1;672;46
2020-05-05;BF;Burkina Faso;16;2;688;48
2020-05-06;BF;Burkina Faso;41;0;729;48
2020-05-07;BF;Burkina Faso;7;0;736;48
2020-05-08;BF;Burkina Faso;8;0;744;48
2020-05-09;BF;Burkina Faso;4;0;748;48
2020-05-10;BF;Burkina Faso;3;1;751;49
2020-05-11;BF;Burkina Faso;9;1;760;50
2020-05-12;BF;Burkina Faso;6;1;766;51
2020-05-13;BF;Burkina Faso;7;0;773;51
2020-05-14;BF;Burkina Faso;0;0;773;51
2020-05-15;BF;Burkina Faso;7;0;780;51
2020-05-16;BF;Burkina Faso;2;0;782;51
2020-05-17;BF;Burkina Faso;14;0;796;51
2020-05-18;BF;Burkina Faso;0;0;796;51
2020-05-19;BF;Burkina Faso;0;0;796;51
2020-05-20;BF;Burkina Faso;13;1;809;52
2020-05-21;BF;Burkina Faso;3;0;812;52
2020-05-22;BF;Burkina Faso;2;0;814;52
2020-05-23;BF;Burkina Faso;0;0;814;52
2020-05-24;BF;Burkina Faso;0;0;814;52
2020-05-25;BF;Burkina Faso;18;0;832;52
2020-05-26;BF;Burkina Faso;0;0;832;52
2020-05-27;BF;Burkina Faso;13;1;845;53
2020-05-28;BF;Burkina Faso;2;0;847;53
2020-05-29;BF;Burkina Faso;0;0;847;53
2020-05-30;BF;Burkina Faso;0;0;847;53
2020-05-31;BF;Burkina Faso;0;0;847;53
2020-06-01;BF;Burkina Faso;0;0;847;53
2020-06-02;BF;Burkina Faso;34;0;881;53
2020-06-03;BF;Burkina Faso;3;0;884;53
2020-06-04;BF;Burkina Faso;1;0;885;53
2020-06-05;BF;Burkina Faso;3;0;888;53
2020-06-06;BF;Burkina Faso;0;0;888;53
2020-06-07;BF;Burkina Faso;1;0;889;53
2020-06-08;BF;Burkina Faso;1;0;890;53
2020-06-09;BF;Burkina Faso;1;0;891;53
2020-06-10;BF;Burkina Faso;0;0;891;53
2020-06-11;BF;Burkina Faso;1;0;892;53
2020-06-12;BF;Burkina Faso;0;0;892;53
2020-06-13;BF;Burkina Faso;0;0;892;53
2020-06-14;BF;Burkina Faso;2;0;894;53
2020-06-15;BF;Burkina Faso;0;0;894;53
2020-06-16;BF;Burkina Faso;1;0;895;53
2020-06-17;BF;Burkina Faso;4;0;899;53
2020-06-18;BF;Burkina Faso;0;0;899;53
2020-06-19;BF;Burkina Faso;1;0;900;53
2020-06-20;BF;Burkina Faso;1;0;901;53
2020-06-21;BF;Burkina Faso;2;0;903;53
2020-06-22;BF;Burkina Faso;0;0;903;53
2020-06-23;BF;Burkina Faso;4;0;907;53
2020-06-24;BF;Burkina Faso;12;0;919;53
2020-06-25;BF;Burkina Faso;15;0;934;53
2020-06-26;BF;Burkina Faso;7;0;941;53
2020-06-27;BF;Burkina Faso;0;0;941;53
2020-06-28;BF;Burkina Faso;18;0;959;53
2020-06-29;BF;Burkina Faso;0;0;959;53
2020-06-30;BF;Burkina Faso;3;0;962;53
2020-07-01;BF;Burkina Faso;0;0;962;53
2020-07-02;BF;Burkina Faso;5;0;967;53
2020-07-03;BF;Burkina Faso;13;0;980;53
2020-07-04;BF;Burkina Faso;7;0;987;53
2020-07-05;BF;Burkina Faso;0;0;987;53
2020-07-06;BF;Burkina Faso;13;0;1000;53
2020-07-07;BF;Burkina Faso;3;0;1003;53
2020-07-08;BF;Burkina Faso;0;0;1003;53
2020-07-09;BF;Burkina Faso;2;0;1005;53
2020-07-10;BF;Burkina Faso;15;0;1020;53
2020-07-11;BF;Burkina Faso;13;0;1033;53
2020-07-12;BF;Burkina Faso;3;0;1036;53
2020-07-13;BF;Burkina Faso;0;0;1036;53
2020-07-14;BF;Burkina Faso;1;0;1037;53
2020-07-15;BF;Burkina Faso;1;0;1038;53
2020-07-16;BF;Burkina Faso;0;0;1038;53
2020-07-17;BF;Burkina Faso;7;0;1045;53
2020-07-18;BF;Burkina Faso;2;0;1047;53
2020-07-19;BF;Burkina Faso;5;0;1052;53
2020-07-20;BF;Burkina Faso;13;0;1065;53
2020-07-21;BF;Burkina Faso;0;0;1065;53
2020-07-22;BF;Burkina Faso;1;0;1066;53
2020-07-23;BF;Burkina Faso;4;0;1070;53
2020-07-24;BF;Burkina Faso;5;0;1075;53
2020-07-25;BF;Burkina Faso;11;0;1086;53
2020-07-26;BF;Burkina Faso;0;0;1086;53
2020-07-27;BF;Burkina Faso;14;0;1100;53
2020-07-28;BF;Burkina Faso;5;0;1105;53
2020-07-29;BF;Burkina Faso;0;0;1105;53
2020-07-30;BF;Burkina Faso;1;0;1106;53
2020-07-31;BF;Burkina Faso;0;0;1106;53
2020-08-01;BF;Burkina Faso;37;0;1143;53
2020-08-02;BF;Burkina Faso;0;0;1143;53
2020-08-03;BF;Burkina Faso;7;0;1150;53
2020-08-04;BF;Burkina Faso;3;1;1153;54
2020-08-05;BF;Burkina Faso;0;0;1153;54
2020-08-06;BF;Burkina Faso;5;0;1158;54
2020-08-07;BF;Burkina Faso;0;0;1158;54
2020-08-08;BF;Burkina Faso;17;0;1175;54
2020-08-09;BF;Burkina Faso;0;0;1175;54
2020-08-10;BF;Burkina Faso;29;0;1204;54
2020-08-11;BF;Burkina Faso;7;0;1211;54
2020-08-12;BF;Burkina Faso;2;0;1213;54
2020-08-13;BF;Burkina Faso;15;0;1228;54
2020-08-14;BF;Burkina Faso;10;0;1238;54
2020-08-15;BF;Burkina Faso;2;0;1240;54
2020-08-16;BF;Burkina Faso;27;1;1267;55
2020-08-17;BF;Burkina Faso;13;0;1280;55
2020-08-18;BF;Burkina Faso;0;0;1280;55
2020-08-19;BF;Burkina Faso;5;0;1285;55
2020-08-20;BF;Burkina Faso;12;0;1297;55
2020-08-21;BF;Burkina Faso;0;0;1297;55
2020-08-22;BF;Burkina Faso;0;0;1297;55
2020-08-23;BF;Burkina Faso;23;0;1320;55
2020-08-24;BF;Burkina Faso;18;0;1338;55
2020-08-25;BF;Burkina Faso;0;0;1338;55
2020-08-26;BF;Burkina Faso;14;0;1352;55
2020-08-27;BF;Burkina Faso;0;0;1352;55
2020-08-28;BF;Burkina Faso;0;0;1352;55
2020-08-29;BF;Burkina Faso;0;0;1352;55
2020-08-30;BF;Burkina Faso;5;0;1357;55
2020-08-31;BF;Burkina Faso;11;0;1368;55
2020-09-01;BF;Burkina Faso;2;0;1370;55
2020-09-02;BF;Burkina Faso;0;0;1370;55
2020-09-03;BF;Burkina Faso;5;0;1375;55
2020-09-04;BF;Burkina Faso;33;0;1408;55
2020-09-05;BF;Burkina Faso;0;0;1408;55
2020-09-06;BF;Burkina Faso;44;0;1452;55
2020-09-07;BF;Burkina Faso;11;1;1463;56
2020-09-08;BF;Burkina Faso;3;0;1466;56
2020-09-09;BF;Burkina Faso;10;0;1476;56
2020-09-10;BF;Burkina Faso;10;0;1486;56
2020-09-11;BF;Burkina Faso;13;0;1499;56
2020-09-12;BF;Burkina Faso;15;0;1514;56
2020-09-13;BF;Burkina Faso;193;0;1707;56
2020-09-14;BF;Burkina Faso;10;0;1717;56
2020-09-15;BF;Burkina Faso;16;0;1733;56
2020-09-16;BF;Burkina Faso;15;0;1748;56
2020-09-17;BF;Burkina Faso;19;0;1767;56
2020-09-18;BF;Burkina Faso;30;0;1797;56
2020-09-19;BF;Burkina Faso;19;0;1816;56
2020-09-20;BF;Burkina Faso;30;0;1846;56
2020-09-21;BF;Burkina Faso;50;0;1896;56
2020-09-22;BF;Burkina Faso;11;0;1907;56
2020-09-23;BF;Burkina Faso;22;0;1929;56
2020-09-24;BF;Burkina Faso;21;0;1950;56
2020-09-25;BF;Burkina Faso;12;0;1962;56
2020-09-26;BF;Burkina Faso;11;0;1973;56
2020-09-27;BF;Burkina Faso;35;0;2008;56
2020-09-28;BF;Burkina Faso;20;1;2028;57
2020-09-29;BF;Burkina Faso;4;1;2032;58
2020-09-30;BF;Burkina Faso;24;0;2056;58
2020-10-01;BF;Burkina Faso;32;0;2088;58
2020-10-02;BF;Burkina Faso;35;1;2123;59
2020-10-03;BF;Burkina Faso;31;0;2154;59
2020-10-04;BF;Burkina Faso;13;0;2167;59
2020-10-05;BF;Burkina Faso;17;0;2184;59
2020-10-06;BF;Burkina Faso;13;0;2197;59
2020-10-07;BF;Burkina Faso;25;0;2222;59
2020-10-08;BF;Burkina Faso;19;1;2241;60
2020-10-09;BF;Burkina Faso;13;0;2254;60
2020-10-10;BF;Burkina Faso;17;1;2271;61
2020-10-11;BF;Burkina Faso;0;0;2271;61
2020-10-12;BF;Burkina Faso;23;2;2294;63
2020-10-13;BF;Burkina Faso;11;0;2305;63
2020-10-14;BF;Burkina Faso;0;0;2305;63
2020-10-15;BF;Burkina Faso;30;2;2335;65
2020-10-16;BF;Burkina Faso;8;0;2343;65
2020-10-17;BF;Burkina Faso;0;0;2343;65
2020-10-18;BF;Burkina Faso;38;0;2381;65
2020-10-19;BF;Burkina Faso;6;0;2387;65
2020-10-20;BF;Burkina Faso;19;0;2406;65
2020-10-21;BF;Burkina Faso;0;0;2406;65
2020-10-22;BF;Burkina Faso;8;0;2414;65
2020-10-23;BF;Burkina Faso;19;0;2433;65
2020-10-24;BF;Burkina Faso;11;0;2444;65
2020-10-25;BF;Burkina Faso;7;0;2451;65
2020-10-26;BF;Burkina Faso;8;2;2459;67
2020-10-27;BF;Burkina Faso;7;0;2466;67
2020-10-28;BF;Burkina Faso;0;0;2466;67
2020-10-29;BF;Burkina Faso;5;0;2471;67
2020-10-30;BF;Burkina Faso;6;0;2477;67
2020-10-31;BF;Burkina Faso;23;0;2500;67
2020-11-01;BF;Burkina Faso;0;0;2500;67
2020-11-02;BF;Burkina Faso;17;0;2517;67
2020-11-03;BF;Burkina Faso;13;0;2530;67
2020-11-04;BF;Burkina Faso;9;0;2539;67
2020-11-05;BF;Burkina Faso;11;0;2550;67
2020-11-06;BF;Burkina Faso;12;0;2562;67
2020-11-07;BF;Burkina Faso;3;0;2565;67
2020-11-08;BF;Burkina Faso;4;0;2569;67
2020-11-09;BF;Burkina Faso;12;0;2581;67
2020-11-10;BF;Burkina Faso;1;0;2582;67
2020-11-11;BF;Burkina Faso;4;0;2586;67
2020-11-12;BF;Burkina Faso;0;0;2586;67
2020-11-13;BF;Burkina Faso;23;1;2609;68
2020-11-14;BF;Burkina Faso;26;0;2635;68
2020-11-15;BF;Burkina Faso;6;0;2641;68
2020-11-16;BF;Burkina Faso;11;0;2652;68
2020-11-17;BF;Burkina Faso;0;0;2652;68
2020-11-18;BF;Burkina Faso;18;0;2670;68
2020-11-19;BF;Burkina Faso;16;0;2686;68
2020-11-20;BF;Burkina Faso;0;0;2686;68
2020-11-21;BF;Burkina Faso;17;0;2703;68
2020-11-22;BF;Burkina Faso;32;0;2735;68
2020-11-23;BF;Burkina Faso;19;0;2754;68
2020-11-24;BF;Burkina Faso;3;0;2757;68
2020-11-25;BF;Burkina Faso;20;0;2777;68
2020-11-26;BF;Burkina Faso;0;0;2777;68
2020-11-27;BF;Burkina Faso;39;0;2816;68
2020-11-28;BF;Burkina Faso;0;0;2816;68
2020-11-29;BF;Burkina Faso;40;0;2856;68
2020-11-30;BF;Burkina Faso;30;0;2886;68
2020-12-01;BF;Burkina Faso;45;0;2931;68
2020-12-02;BF;Burkina Faso;79;0;3010;68
2020-12-03;BF;Burkina Faso;52;0;3062;68
2020-12-04;BF;Burkina Faso;29;0;3091;68
2020-12-05;BF;Burkina Faso;65;0;3156;68
2020-12-06;BF;Burkina Faso;56;0;3212;68
2020-12-07;BF;Burkina Faso;103;0;3315;68
2020-12-08;BF;Burkina Faso;154;1;3469;69
2020-12-09;BF;Burkina Faso;0;0;3469;69
2020-12-10;BF;Burkina Faso;110;0;3579;69
2020-12-11;BF;Burkina Faso;0;0;3579;69
2020-12-12;BF;Burkina Faso;315;2;3894;71
2020-12-13;BF;Burkina Faso;136;0;4030;71
2020-12-14;BF;Burkina Faso;179;0;4209;71
2020-12-15;BF;Burkina Faso;91;2;4300;73
2020-12-16;BF;Burkina Faso;149;0;4449;73
2020-12-17;BF;Burkina Faso;162;0;4611;73
2020-12-18;BF;Burkina Faso;221;1;4832;74
2020-12-19;BF;Burkina Faso;122;0;4954;74
2020-12-20;BF;Burkina Faso;206;2;5160;76
2020-12-21;BF;Burkina Faso;141;0;5301;76
2020-12-22;BF;Burkina Faso;160;1;5461;77
2020-12-23;BF;Burkina Faso;188;0;5649;77
2020-12-24;BF;Burkina Faso;292;0;5941;77
2020-12-25;BF;Burkina Faso;193;0;6134;77
2020-12-26;BF;Burkina Faso;121;0;6255;77
2020-12-27;BF;Burkina Faso;89;1;6344;78
2020-12-28;BF;Burkina Faso;0;0;6344;78
2020-12-29;BF;Burkina Faso;193;4;6537;82
2020-12-30;BF;Burkina Faso;94;2;6631;84
2020-12-31;BF;Burkina Faso;76;1;6707;85
2021-01-01;BF;Burkina Faso;121;0;6828;85
2021-01-02;BF;Burkina Faso;112;1;6940;86
2021-01-03;BF;Burkina Faso;111;0;7051;86
2021-01-04;BF;Burkina Faso;75;0;7126;86
2021-01-05;BF;Burkina Faso;216;0;7342;86
2021-01-06;BF;Burkina Faso;221;3;7563;89
2021-01-07;BF;Burkina Faso;150;0;7713;89
2021-01-08;BF;Burkina Faso;153;0;7866;89
2021-01-09;BF;Burkina Faso;0;0;7866;89
2021-01-10;BF;Burkina Faso;216;0;8082;89
2021-01-11;BF;Burkina Faso;197;0;8279;89
2021-01-12;BF;Burkina Faso;184;3;8463;92
2021-01-13;BF;Burkina Faso;83;1;8546;93
2021-01-14;BF;Burkina Faso;263;4;8809;97
2021-01-15;BF;Burkina Faso;73;0;8882;97
2021-01-16;BF;Burkina Faso;118;4;9000;101
2021-01-17;BF;Burkina Faso;188;1;9188;102
2021-01-18;BF;Burkina Faso;164;3;9352;105
2021-01-19;BF;Burkina Faso;0;0;9352;105
2021-01-20;BF;Burkina Faso;201;1;9553;106
2021-01-21;BF;Burkina Faso;166;0;9719;106
2021-01-22;BF;Burkina Faso;138;1;9857;107
2021-01-23;BF;Burkina Faso;110;2;9967;109
2021-01-24;BF;Burkina Faso;71;3;10038;112
2021-01-25;BF;Burkina Faso;65;5;10103;117
2021-01-26;BF;Burkina Faso;54;1;10157;118
2021-01-27;BF;Burkina Faso;60;2;10217;120
2021-01-28;BF;Burkina Faso;160;0;10377;120
2021-01-29;BF;Burkina Faso;46;0;10423;120
2021-01-30;BF;Burkina Faso;157;0;10580;120
2021-01-31;BF;Burkina Faso;102;0;10682;120
2021-02-01;BF;Burkina Faso;86;1;10768;121
2021-02-02;BF;Burkina Faso;136;5;10904;126
2021-02-03;BF;Burkina Faso;54;1;10958;127
2021-02-04;BF;Burkina Faso;95;5;11053;132
2021-02-05;BF;Burkina Faso;90;0;11143;132
2021-02-06;BF;Burkina Faso;84;2;11227;134
2021-02-07;BF;Burkina Faso;58;0;11285;134
2021-02-08;BF;Burkina Faso;24;0;11309;134
2021-02-09;BF;Burkina Faso;58;0;11367;134
2021-02-10;BF;Burkina Faso;59;0;11426;134
2021-02-11;BF;Burkina Faso;0;0;11426;134
2021-02-12;BF;Burkina Faso;112;3;11538;137
2021-02-13;BF;Burkina Faso;50;1;11588;138
2021-02-14;BF;Burkina Faso;0;0;11588;138
2021-02-15;BF;Burkina Faso;42;0;11630;138
2021-02-16;BF;Burkina Faso;0;0;11630;138
2021-02-17;BF;Burkina Faso;42;0;11672;138
2021-02-18;BF;Burkina Faso;31;1;11703;139
2021-02-19;BF;Burkina Faso;60;0;11763;139
2021-02-20;BF;Burkina Faso;20;0;11783;139
2021-02-21;BF;Burkina Faso;14;0;11797;139
2021-02-22;BF;Burkina Faso;50;0;11847;139
2021-02-23;BF;Burkina Faso;21;2;11868;141
2021-02-24;BF;Burkina Faso;19;1;11887;142
2021-02-25;BF;Burkina Faso;27;0;11914;142
2021-02-26;BF;Burkina Faso;25;0;11939;142
2021-02-27;BF;Burkina Faso;43;0;11982;142
2021-02-28;BF;Burkina Faso;0;0;11982;142
2021-03-01;BF;Burkina Faso;48;1;12030;143
2021-03-02;BF;Burkina Faso;17;0;12047;143
2021-03-03;BF;Burkina Faso;24;0;12071;143
2021-03-04;BF;Burkina Faso;32;0;12103;143
2021-03-05;BF;Burkina Faso;20;0;12123;143
2021-03-06;BF;Burkina Faso;30;0;12153;143
2021-03-07;BF;Burkina Faso;28;0;12181;143
2021-03-08;BF;Burkina Faso;0;0;12181;143
2021-03-09;BF;Burkina Faso;6;0;12187;143
2021-03-10;BF;Burkina Faso;43;0;12230;143
2021-03-11;BF;Burkina Faso;45;0;12275;143
2021-03-12;BF;Burkina Faso;30;1;12305;144
2021-03-13;BF;Burkina Faso;45;0;12350;144
2021-03-14;BF;Burkina Faso;22;0;12372;144
2021-03-15;BF;Burkina Faso;6;0;12378;144
2021-03-16;BF;Burkina Faso;0;0;12378;144
2021-03-17;BF;Burkina Faso;21;0;12399;144
2021-03-18;BF;Burkina Faso;51;1;12450;145
2021-03-19;BF;Burkina Faso;0;0;12450;145
2021-03-20;BF;Burkina Faso;66;0;12516;145
2021-03-21;BF;Burkina Faso;19;0;12535;145
2021-03-22;BF;Burkina Faso;24;0;12559;145
2021-03-23;BF;Burkina Faso;13;0;12572;145
2021-03-24;BF;Burkina Faso;24;0;12596;145
2021-03-25;BF;Burkina Faso;23;0;12619;145
2021-03-26;BF;Burkina Faso;31;0;12650;145
2021-03-27;BF;Burkina Faso;23;0;12673;145
2021-03-28;BF;Burkina Faso;19;0;12692;145
2021-03-29;BF;Burkina Faso;10;0;12702;145
2021-03-30;BF;Burkina Faso;15;1;12717;146
2021-03-31;BF;Burkina Faso;0;0;12717;146
2021-04-01;BF;Burkina Faso;57;3;12774;149
2021-04-02;BF;Burkina Faso;17;1;12791;150
2021-04-03;BF;Burkina Faso;12;0;12803;150
2021-04-04;BF;Burkina Faso;14;0;12817;150
2021-04-05;BF;Burkina Faso;8;0;12825;150
2021-04-06;BF;Burkina Faso;20;0;12845;150
2021-04-07;BF;Burkina Faso;28;0;12873;150
2021-04-08;BF;Burkina Faso;31;2;12904;152
2021-04-09;BF;Burkina Faso;20;0;12924;152
2021-04-10;BF;Burkina Faso;32;0;12956;152
2021-04-11;BF;Burkina Faso;0;0;12956;152
2021-04-12;BF;Burkina Faso;33;1;12989;153
2021-04-13;BF;Burkina Faso;0;0;12989;153
2021-04-14;BF;Burkina Faso;61;1;13050;154
2021-04-15;BF;Burkina Faso;14;0;13064;154
2021-04-16;BF;Burkina Faso;19;0;13083;154
2021-04-17;BF;Burkina Faso;31;0;13114;154
2021-04-18;BF;Burkina Faso;15;0;13129;154
2021-04-19;BF;Burkina Faso;19;0;13148;154
2021-04-20;BF;Burkina Faso;19;1;13167;155
2021-04-21;BF;Burkina Faso;0;0;13167;155
2021-04-22;BF;Burkina Faso;45;1;13212;156
2021-04-23;BF;Burkina Faso;19;0;13231;156
2021-04-24;BF;Burkina Faso;0;0;13231;156
2021-04-25;BF;Burkina Faso;32;0;13263;156
2021-04-26;BF;Burkina Faso;0;0;13263;156
2021-04-27;BF;Burkina Faso;0;0;13263;156
2021-04-28;BF;Burkina Faso;23;1;13286;157
2021-04-29;BF;Burkina Faso;23;0;13309;157
2021-04-30;BF;Burkina Faso;1;0;13310;157
2021-05-01;BF;Burkina Faso;9;0;13319;157
2021-05-02;BF;Burkina Faso;0;0;13319;157
2021-05-03;BF;Burkina Faso;5;0;13324;157
2021-05-04;BF;Burkina Faso;15;4;13339;161
2021-05-05;BF;Burkina Faso;6;0;13345;161
2021-05-06;BF;Burkina Faso;8;1;13353;162
2021-05-07;BF;Burkina Faso;0;0;13353;162
2021-05-08;BF;Burkina Faso;24;0;13377;162
2021-05-09;BF;Burkina Faso;2;0;13379;162
2021-05-10;BF;Burkina Faso;3;0;13382;162
2021-05-11;BF;Burkina Faso;2;2;13384;164
2021-05-12;BF;Burkina Faso;3;0;13387;164
2021-05-13;BF;Burkina Faso;0;0;13387;164
2021-05-14;BF;Burkina Faso;7;0;13394;164
2021-05-15;BF;Burkina Faso;1;0;13395;164
2021-05-16;BF;Burkina Faso;2;0;13397;164
2021-05-17;BF;Burkina Faso;0;0;13397;164
2021-05-18;BF;Burkina Faso;7;1;13404;165
2021-05-19;BF;Burkina Faso;3;0;13407;165
2021-05-20;BF;Burkina Faso;1;0;13408;165
2021-05-21;BF;Burkina Faso;2;0;13410;165
2021-05-22;BF;Burkina Faso;4;0;13414;165
2021-05-23;BF;Burkina Faso;1;0;13415;165
2021-05-24;BF;Burkina Faso;0;0;13415;165
2021-05-25;BF;Burkina Faso;1;1;13416;166
2021-05-26;BF;Burkina Faso;3;0;13419;166
2021-05-27;BF;Burkina Faso;2;0;13421;166
2021-05-28;BF;Burkina Faso;3;0;13424;166
2021-05-29;BF;Burkina Faso;6;0;13430;166
2021-05-30;BF;Burkina Faso;0;0;13430;166
2021-05-31;BF;Burkina Faso;4;0;13434;166
2021-06-01;BF;Burkina Faso;1;1;13435;167
2021-06-02;BF;Burkina Faso;0;0;13435;167
2021-06-03;BF;Burkina Faso;11;0;13446;167
2021-06-04;BF;Burkina Faso;1;0;13447;167
2021-06-05;BF;Burkina Faso;5;0;13452;167
2021-06-06;BF;Burkina Faso;1;0;13453;167
2021-06-07;BF;Burkina Faso;0;0;13453;167
2021-06-08;BF;Burkina Faso;1;0;13454;167
2021-06-09;BF;Burkina Faso;0;0;13454;167
2021-06-10;BF;Burkina Faso;2;0;13456;167
2021-06-11;BF;Burkina Faso;0;0;13456;167
2021-06-12;BF;Burkina Faso;3;0;13459;167
2021-06-13;BF;Burkina Faso;0;0;13459;167
2021-06-14;BF;Burkina Faso;0;0;13459;167
2021-06-15;BF;Burkina Faso;0;0;13459;167
2021-06-16;BF;Burkina Faso;1;0;13460;167
2021-06-17;BF;Burkina Faso;0;0;13460;167
2021-06-18;BF;Burkina Faso;2;0;13462;167
2021-06-19;BF;Burkina Faso;6;0;13468;167
2021-06-20;BF;Burkina Faso;1;0;13469;167
2021-06-21;BF;Burkina Faso;0;0;13469;167
2021-06-22;BF;Burkina Faso;0;1;13469;168
2021-06-23;BF;Burkina Faso;4;0;13473;168
2021-06-24;BF;Burkina Faso;1;0;13474;168
2021-06-25;BF;Burkina Faso;3;0;13477;168
2021-06-26;BF;Burkina Faso;1;0;13478;168
2021-06-27;BF;Burkina Faso;0;0;13478;168
2021-06-28;BF;Burkina Faso;1;0;13479;168
2021-06-29;BF;Burkina Faso;0;0;13479;168
2021-06-30;BF;Burkina Faso;0;0;13479;168
2021-07-01;BF;Burkina Faso;6;0;13485;168
2020-03-31;BI;Burundi;2;0;2;0
2020-04-01;BI;Burundi;0;0;2;0
2020-04-02;BI;Burundi;1;0;3;0
2020-04-03;BI;Burundi;0;0;3;0
2020-04-04;BI;Burundi;0;0;3;0
2020-04-05;BI;Burundi;0;0;3;0
2020-04-06;BI;Burundi;0;0;3;0
2020-04-07;BI;Burundi;0;0;3;0
2020-04-08;BI;Burundi;0;0;3;0
2020-04-09;BI;Burundi;0;0;3;0
2020-04-10;BI;Burundi;0;0;3;0
2020-04-11;BI;Burundi;2;0;5;0
2020-04-12;BI;Burundi;0;0;5;0
2020-04-13;BI;Burundi;0;1;5;1
2020-04-14;BI;Burundi;0;0;5;1
2020-04-15;BI;Burundi;0;0;5;1
2020-04-16;BI;Burundi;0;0;5;1
2020-04-17;BI;Burundi;0;0;5;1
2020-04-18;BI;Burundi;0;0;5;1
2020-04-19;BI;Burundi;0;0;5;1
2020-04-20;BI;Burundi;0;0;5;1
2020-04-21;BI;Burundi;0;0;5;1
2020-04-22;BI;Burundi;6;0;11;1
2020-04-23;BI;Burundi;0;0;11;1
2020-04-24;BI;Burundi;0;0;11;1
2020-04-25;BI;Burundi;0;0;11;1
2020-04-26;BI;Burundi;0;0;11;1
2020-04-27;BI;Burundi;0;0;11;1
2020-04-28;BI;Burundi;0;0;11;1
2020-04-29;BI;Burundi;0;0;11;1
2020-04-30;BI;Burundi;0;0;11;1
2020-05-01;BI;Burundi;0;0;11;1
2020-05-02;BI;Burundi;4;0;15;1
2020-05-03;BI;Burundi;0;0;15;1
2020-05-04;BI;Burundi;0;0;15;1
2020-05-05;BI;Burundi;0;0;15;1
2020-05-06;BI;Burundi;0;0;15;1
2020-05-07;BI;Burundi;0;0;15;1
2020-05-08;BI;Burundi;0;0;15;1
2020-05-09;BI;Burundi;0;0;15;1
2020-05-10;BI;Burundi;0;0;15;1
2020-05-11;BI;Burundi;0;0;15;1
2020-05-12;BI;Burundi;0;0;15;1
2020-05-13;BI;Burundi;0;0;15;1
2020-05-14;BI;Burundi;0;0;15;1
2020-05-15;BI;Burundi;0;0;15;1
2020-05-16;BI;Burundi;0;0;15;1
2020-05-17;BI;Burundi;8;0;23;1
2020-05-18;BI;Burundi;19;0;42;1
2020-05-19;BI;Burundi;0;0;42;1
2020-05-20;BI;Burundi;0;0;42;1
2020-05-21;BI;Burundi;0;0;42;1
2020-05-22;BI;Burundi;0;0;42;1
2020-05-23;BI;Burundi;0;0;42;1
2020-05-24;BI;Burundi;0;0;42;1
2020-05-25;BI;Burundi;0;0;42;1
2020-05-26;BI;Burundi;0;0;42;1
2020-05-27;BI;Burundi;0;0;42;1
2020-05-28;BI;Burundi;0;0;42;1
2020-05-29;BI;Burundi;0;0;42;1
2020-05-30;BI;Burundi;21;0;63;1
2020-05-31;BI;Burundi;0;0;63;1
2020-06-01;BI;Burundi;0;0;63;1
2020-06-02;BI;Burundi;0;0;63;1
2020-06-03;BI;Burundi;0;0;63;1
2020-06-04;BI;Burundi;0;0;63;1
2020-06-05;BI;Burundi;0;0;63;1
2020-06-06;BI;Burundi;20;0;83;1
2020-06-07;BI;Burundi;0;0;83;1
2020-06-08;BI;Burundi;0;0;83;1
2020-06-09;BI;Burundi;0;0;83;1
2020-06-10;BI;Burundi;0;0;83;1
2020-06-11;BI;Burundi;2;0;85;1
2020-06-12;BI;Burundi;0;0;85;1
2020-06-13;BI;Burundi;0;0;85;1
2020-06-14;BI;Burundi;0;0;85;1
2020-06-15;BI;Burundi;0;0;85;1
2020-06-16;BI;Burundi;19;0;104;1
2020-06-17;BI;Burundi;0;0;104;1
2020-06-18;BI;Burundi;0;0;104;1
2020-06-19;BI;Burundi;0;0;104;1
2020-06-20;BI;Burundi;0;0;104;1
2020-06-21;BI;Burundi;40;0;144;1
2020-06-22;BI;Burundi;0;0;144;1
2020-06-23;BI;Burundi;0;0;144;1
2020-06-24;BI;Burundi;0;0;144;1
2020-06-25;BI;Burundi;0;0;144;1
2020-06-26;BI;Burundi;0;0;144;1
2020-06-27;BI;Burundi;26;0;170;1
2020-06-28;BI;Burundi;0;0;170;1
2020-06-29;BI;Burundi;0;0;170;1
2020-06-30;BI;Burundi;0;0;170;1
2020-07-01;BI;Burundi;0;0;170;1
2020-07-02;BI;Burundi;0;0;170;1
2020-07-03;BI;Burundi;21;0;191;1
2020-07-04;BI;Burundi;0;0;191;1
2020-07-05;BI;Burundi;0;0;191;1
2020-07-06;BI;Burundi;0;0;191;1
2020-07-07;BI;Burundi;0;0;191;1
2020-07-08;BI;Burundi;0;0;191;1
2020-07-09;BI;Burundi;0;0;191;1
2020-07-10;BI;Burundi;0;0;191;1
2020-07-11;BI;Burundi;0;0;191;1
2020-07-12;BI;Burundi;0;0;191;1
2020-07-13;BI;Burundi;78;0;269;1
2020-07-14;BI;Burundi;0;0;269;1
2020-07-15;BI;Burundi;0;0;269;1
2020-07-16;BI;Burundi;34;0;303;1
2020-07-17;BI;Burundi;7;0;310;1
2020-07-18;BI;Burundi;0;0;310;1
2020-07-19;BI;Burundi;0;0;310;1
2020-07-20;BI;Burundi;12;0;322;1
2020-07-21;BI;Burundi;6;0;328;1
2020-07-22;BI;Burundi;0;0;328;1
2020-07-23;BI;Burundi;17;0;345;1
2020-07-24;BI;Burundi;0;0;345;1
2020-07-25;BI;Burundi;16;0;361;1
2020-07-26;BI;Burundi;0;0;361;1
2020-07-27;BI;Burundi;17;0;378;1
2020-07-28;BI;Burundi;0;0;378;1
2020-07-29;BI;Burundi;9;0;387;1
2020-07-30;BI;Burundi;0;0;387;1
2020-07-31;BI;Burundi;0;0;387;1
2020-08-01;BI;Burundi;8;0;395;1
2020-08-02;BI;Burundi;0;0;395;1
2020-08-03;BI;Burundi;0;0;395;1
2020-08-04;BI;Burundi;0;0;395;1
2020-08-05;BI;Burundi;0;0;395;1
2020-08-06;BI;Burundi;5;0;400;1
2020-08-07;BI;Burundi;0;0;400;1
2020-08-08;BI;Burundi;5;0;405;1
2020-08-09;BI;Burundi;3;0;408;1
2020-08-10;BI;Burundi;0;0;408;1
2020-08-11;BI;Burundi;0;0;408;1
2020-08-12;BI;Burundi;1;0;409;1
2020-08-13;BI;Burundi;1;0;410;1
2020-08-14;BI;Burundi;2;0;412;1
2020-08-15;BI;Burundi;0;0;412;1
2020-08-16;BI;Burundi;1;0;413;1
2020-08-17;BI;Burundi;0;0;413;1
2020-08-18;BI;Burundi;3;0;416;1
2020-08-19;BI;Burundi;6;0;422;1
2020-08-20;BI;Burundi;0;0;422;1
2020-08-21;BI;Burundi;4;0;426;1
2020-08-22;BI;Burundi;3;0;429;1
2020-08-23;BI;Burundi;1;0;430;1
2020-08-24;BI;Burundi;0;0;430;1
2020-08-25;BI;Burundi;0;0;430;1
2020-08-26;BI;Burundi;0;0;430;1
2020-08-27;BI;Burundi;1;0;431;1
2020-08-28;BI;Burundi;2;0;433;1
2020-08-29;BI;Burundi;12;0;445;1
2020-08-30;BI;Burundi;0;0;445;1
2020-08-31;BI;Burundi;0;0;445;1
2020-09-01;BI;Burundi;0;0;445;1
2020-09-02;BI;Burundi;3;0;448;1
2020-09-03;BI;Burundi;0;0;448;1
2020-09-04;BI;Burundi;3;0;451;1
2020-09-05;BI;Burundi;9;0;460;1
2020-09-06;BI;Burundi;2;0;462;1
2020-09-07;BI;Burundi;4;0;466;1
2020-09-08;BI;Burundi;0;0;466;1
2020-09-09;BI;Burundi;0;0;466;1
2020-09-10;BI;Burundi;3;0;469;1
2020-09-11;BI;Burundi;0;0;469;1
2020-09-12;BI;Burundi;2;0;471;1
2020-09-13;BI;Burundi;1;0;472;1
2020-09-14;BI;Burundi;0;0;472;1
2020-09-15;BI;Burundi;0;0;472;1
2020-09-16;BI;Burundi;0;0;472;1
2020-09-17;BI;Burundi;1;0;473;1
2020-09-18;BI;Burundi;0;0;473;1
2020-09-19;BI;Burundi;0;0;473;1
2020-09-20;BI;Burundi;0;0;473;1
2020-09-21;BI;Burundi;1;0;474;1
2020-09-22;BI;Burundi;0;0;474;1
2020-09-23;BI;Burundi;2;0;476;1
2020-09-24;BI;Burundi;1;0;477;1
2020-09-25;BI;Burundi;6;0;483;1
2020-09-26;BI;Burundi;2;0;485;1
2020-09-27;BI;Burundi;0;0;485;1
2020-09-28;BI;Burundi;17;0;502;1
2020-09-29;BI;Burundi;4;0;506;1
2020-09-30;BI;Burundi;2;0;508;1
2020-10-01;BI;Burundi;2;0;510;1
2020-10-02;BI;Burundi;3;0;513;1
2020-10-03;BI;Burundi;0;0;513;1
2020-10-04;BI;Burundi;0;0;513;1
2020-10-05;BI;Burundi;1;0;514;1
2020-10-06;BI;Burundi;0;0;514;1
2020-10-07;BI;Burundi;1;0;515;1
2020-10-08;BI;Burundi;0;0;515;1
2020-10-09;BI;Burundi;0;0;515;1
2020-10-10;BI;Burundi;2;0;517;1
2020-10-11;BI;Burundi;7;0;524;1
2020-10-12;BI;Burundi;1;0;525;1
2020-10-13;BI;Burundi;4;0;529;1
2020-10-14;BI;Burundi;0;0;529;1
2020-10-15;BI;Burundi;0;0;529;1
2020-10-16;BI;Burundi;2;0;531;1
2020-10-17;BI;Burundi;5;0;536;1
2020-10-18;BI;Burundi;6;0;542;1
2020-10-19;BI;Burundi;7;0;549;1
2020-10-20;BI;Burundi;1;0;550;1
2020-10-21;BI;Burundi;0;0;550;1
2020-10-22;BI;Burundi;1;0;551;1
2020-10-23;BI;Burundi;2;0;553;1
2020-10-24;BI;Burundi;2;0;555;1
2020-10-25;BI;Burundi;2;0;557;1
2020-10-26;BI;Burundi;0;0;557;1
2020-10-27;BI;Burundi;1;0;558;1
2020-10-28;BI;Burundi;1;0;559;1
2020-10-29;BI;Burundi;1;0;560;1
2020-10-30;BI;Burundi;22;0;582;1
2020-10-31;BI;Burundi;3;0;585;1
2020-11-01;BI;Burundi;4;0;589;1
2020-11-02;BI;Burundi;0;0;589;1
2020-11-03;BI;Burundi;8;0;597;1
2020-11-04;BI;Burundi;9;0;606;1
2020-11-05;BI;Burundi;0;0;606;1
2020-11-06;BI;Burundi;0;0;606;1
2020-11-07;BI;Burundi;6;0;612;1
2020-11-08;BI;Burundi;0;0;612;1
2020-11-09;BI;Burundi;2;0;614;1
2020-11-10;BI;Burundi;1;0;615;1
2020-11-11;BI;Burundi;5;0;620;1
2020-11-12;BI;Burundi;3;0;623;1
2020-11-13;BI;Burundi;1;0;624;1
2020-11-14;BI;Burundi;3;0;627;1
2020-11-15;BI;Burundi;1;0;628;1
2020-11-16;BI;Burundi;2;0;630;1
2020-11-17;BI;Burundi;1;0;631;1
2020-11-18;BI;Burundi;10;0;641;1
2020-11-19;BI;Burundi;0;0;641;1
2020-11-20;BI;Burundi;8;0;649;1
2020-11-21;BI;Burundi;7;0;656;1
2020-11-22;BI;Burundi;6;0;662;1
2020-11-23;BI;Burundi;2;0;664;1
2020-11-24;BI;Burundi;9;0;673;1
2020-11-25;BI;Burundi;0;0;673;1
2020-11-26;BI;Burundi;4;0;677;1
2020-11-27;BI;Burundi;4;0;681;1
2020-11-28;BI;Burundi;0;0;681;1
2020-11-29;BI;Burundi;0;0;681;1
2020-11-30;BI;Burundi;7;0;688;1
2020-12-01;BI;Burundi;1;0;689;1
2020-12-02;BI;Burundi;0;0;689;1
2020-12-03;BI;Burundi;3;0;692;1
2020-12-04;BI;Burundi;0;0;692;1
2020-12-05;BI;Burundi;2;0;694;1
2020-12-06;BI;Burundi;0;0;694;1
2020-12-07;BI;Burundi;4;0;698;1
2020-12-08;BI;Burundi;18;0;716;1
2020-12-09;BI;Burundi;4;0;720;1
2020-12-10;BI;Burundi;0;0;720;1
2020-12-11;BI;Burundi;3;0;723;1
2020-12-12;BI;Burundi;5;0;728;1
2020-12-13;BI;Burundi;1;0;729;1
2020-12-14;BI;Burundi;0;0;729;1
2020-12-15;BI;Burundi;6;0;735;1
2020-12-16;BI;Burundi;6;0;741;1
2020-12-17;BI;Burundi;10;0;751;1
2020-12-18;BI;Burundi;0;0;751;1
2020-12-19;BI;Burundi;10;1;761;2
2020-12-20;BI;Burundi;0;0;761;2
2020-12-21;BI;Burundi;1;0;762;2
2020-12-22;BI;Burundi;0;0;762;2
2020-12-23;BI;Burundi;11;0;773;2
2020-12-24;BI;Burundi;0;0;773;2
2020-12-25;BI;Burundi;13;0;786;2
2020-12-26;BI;Burundi;0;0;786;2
2020-12-27;BI;Burundi;18;0;804;2
2020-12-28;BI;Burundi;0;0;804;2
2020-12-29;BI;Burundi;5;0;809;2
2020-12-30;BI;Burundi;0;0;809;2
2020-12-31;BI;Burundi;9;0;818;2
2021-01-01;BI;Burundi;4;0;822;2
2021-01-02;BI;Burundi;0;0;822;2
2021-01-03;BI;Burundi;11;0;833;2
2021-01-04;BI;Burundi;9;0;842;2
2021-01-05;BI;Burundi;0;0;842;2
2021-01-06;BI;Burundi;42;0;884;2
2021-01-07;BI;Burundi;1;0;885;2
2021-01-08;BI;Burundi;0;0;885;2
2021-01-09;BI;Burundi;0;0;885;2
2021-01-10;BI;Burundi;101;0;986;2
2021-01-11;BI;Burundi;33;0;1019;2
2021-01-12;BI;Burundi;0;0;1019;2
2021-01-13;BI;Burundi;43;0;1062;2
2021-01-14;BI;Burundi;41;0;1103;2
2021-01-15;BI;Burundi;47;0;1150;2
2021-01-16;BI;Burundi;35;0;1185;2
2021-01-17;BI;Burundi;51;0;1236;2
2021-01-18;BI;Burundi;9;0;1245;2
2021-01-19;BI;Burundi;8;0;1253;2
2021-01-20;BI;Burundi;69;0;1322;2
2021-01-21;BI;Burundi;36;0;1358;2
2021-01-22;BI;Burundi;22;0;1380;2
2021-01-23;BI;Burundi;58;0;1438;2
2021-01-24;BI;Burundi;34;0;1472;2
2021-01-25;BI;Burundi;7;0;1479;2
2021-01-26;BI;Burundi;2;0;1481;2
2021-01-27;BI;Burundi;61;0;1542;2
2021-01-28;BI;Burundi;42;0;1584;2
2021-01-29;BI;Burundi;20;0;1604;2
2021-01-30;BI;Burundi;9;0;1613;2
2021-01-31;BI;Burundi;19;0;1632;2
2021-02-01;BI;Burundi;3;0;1635;2
2021-02-02;BI;Burundi;6;0;1641;2
2021-02-03;BI;Burundi;23;0;1664;2
2021-02-04;BI;Burundi;22;0;1686;2
2021-02-05;BI;Burundi;12;1;1698;3
2021-02-06;BI;Burundi;19;0;1717;3
2021-02-07;BI;Burundi;6;0;1723;3
2021-02-08;BI;Burundi;5;0;1728;3
2021-02-09;BI;Burundi;2;0;1730;3
2021-02-10;BI;Burundi;21;0;1751;3
2021-02-11;BI;Burundi;20;0;1771;3
2021-02-12;BI;Burundi;26;0;1797;3
2021-02-13;BI;Burundi;27;0;1824;3
2021-02-14;BI;Burundi;0;0;1824;3
2021-02-15;BI;Burundi;25;0;1849;3
2021-02-16;BI;Burundi;6;0;1855;3
2021-02-17;BI;Burundi;40;0;1895;3
2021-02-18;BI;Burundi;33;0;1928;3
2021-02-19;BI;Burundi;27;0;1955;3
2021-02-20;BI;Burundi;28;0;1983;3
2021-02-21;BI;Burundi;48;0;2031;3
2021-02-22;BI;Burundi;3;0;2034;3
2021-02-23;BI;Burundi;7;0;2041;3
2021-02-24;BI;Burundi;28;0;2069;3
2021-02-25;BI;Burundi;37;0;2106;3
2021-02-26;BI;Burundi;37;0;2143;3
2021-02-27;BI;Burundi;38;0;2181;3
2021-02-28;BI;Burundi;28;0;2209;3
2021-03-01;BI;Burundi;8;0;2217;3
2021-03-02;BI;Burundi;7;0;2224;3
2021-03-03;BI;Burundi;16;0;2240;3
2021-03-04;BI;Burundi;28;0;2268;3
2021-03-05;BI;Burundi;15;0;2283;3
2021-03-06;BI;Burundi;16;0;2299;3
2021-03-07;BI;Burundi;20;0;2319;3
2021-03-08;BI;Burundi;15;0;2334;3
2021-03-09;BI;Burundi;5;0;2339;3
2021-03-10;BI;Burundi;30;0;2369;3
2021-03-11;BI;Burundi;27;0;2396;3
2021-03-12;BI;Burundi;24;0;2420;3
2021-03-13;BI;Burundi;21;0;2441;3
2021-03-14;BI;Burundi;20;0;2461;3
2021-03-15;BI;Burundi;0;0;2461;3
2021-03-16;BI;Burundi;0;0;2461;3
2021-03-17;BI;Burundi;0;0;2461;3
2021-03-18;BI;Burundi;81;0;2542;3
2021-03-19;BI;Burundi;21;0;2563;3
2021-03-20;BI;Burundi;0;0;2563;3
2021-03-21;BI;Burundi;50;3;2613;6
2021-03-22;BI;Burundi;5;0;2618;6
2021-03-23;BI;Burundi;10;0;2628;6
2021-03-24;BI;Burundi;29;0;2657;6
2021-03-25;BI;Burundi;0;0;2657;6
2021-03-26;BI;Burundi;0;0;2657;6
2021-03-27;BI;Burundi;0;0;2657;6
2021-03-28;BI;Burundi;100;0;2757;6
2021-03-29;BI;Burundi;0;0;2757;6
2021-03-30;BI;Burundi;0;0;2757;6
2021-03-31;BI;Burundi;53;0;2810;6
2021-04-01;BI;Burundi;32;0;2842;6
2021-04-02;BI;Burundi;0;0;2842;6
2021-04-03;BI;Burundi;69;0;2911;6
2021-04-04;BI;Burundi;0;0;2911;6
2021-04-05;BI;Burundi;53;0;2964;6
2021-04-06;BI;Burundi;6;0;2970;6
2021-04-07;BI;Burundi;47;0;3017;6
2021-04-08;BI;Burundi;10;0;3027;6
2021-04-09;BI;Burundi;51;0;3078;6
2021-04-10;BI;Burundi;41;0;3119;6
2021-04-11;BI;Burundi;35;0;3154;6
2021-04-12;BI;Burundi;0;0;3154;6
2021-04-13;BI;Burundi;108;0;3262;6
2021-04-14;BI;Burundi;71;0;3333;6
2021-04-15;BI;Burundi;91;0;3424;6
2021-04-16;BI;Burundi;53;0;3477;6
2021-04-17;BI;Burundi;0;0;3477;6
2021-04-18;BI;Burundi;0;0;3477;6
2021-04-19;BI;Burundi;0;0;3477;6
2021-04-20;BI;Burundi;166;0;3643;6
2021-04-21;BI;Burundi;63;0;3706;6
2021-04-22;BI;Burundi;26;0;3732;6
2021-04-23;BI;Burundi;27;0;3759;6
2021-04-24;BI;Burundi;46;0;3805;6
2021-04-25;BI;Burundi;48;0;3853;6
2021-04-26;BI;Burundi;21;0;3874;6
2021-04-27;BI;Burundi;10;0;3884;6
2021-04-28;BI;Burundi;57;0;3941;6
2021-04-29;BI;Burundi;44;0;3985;6
2021-04-30;BI;Burundi;10;0;3995;6
2021-05-01;BI;Burundi;23;0;4018;6
2021-05-02;BI;Burundi;20;0;4038;6
2021-05-03;BI;Burundi;8;0;4046;6
2021-05-04;BI;Burundi;6;0;4052;6
2021-05-05;BI;Burundi;17;0;4069;6
2021-05-06;BI;Burundi;24;0;4093;6
2021-05-07;BI;Burundi;39;0;4132;6
2021-05-08;BI;Burundi;17;0;4149;6
2021-05-09;BI;Burundi;28;0;4177;6
2021-05-10;BI;Burundi;23;0;4200;6
2021-05-11;BI;Burundi;8;0;4208;6
2021-05-12;BI;Burundi;25;0;4233;6
2021-05-13;BI;Burundi;28;0;4261;6
2021-05-14;BI;Burundi;21;0;4282;6
2021-05-15;BI;Burundi;8;0;4290;6
2021-05-16;BI;Burundi;39;0;4329;6
2021-05-17;BI;Burundi;18;0;4347;6
2021-05-18;BI;Burundi;6;0;4353;6
2021-05-19;BI;Burundi;29;0;4382;6
2021-05-20;BI;Burundi;36;0;4418;6
2021-05-21;BI;Burundi;33;0;4451;6
2021-05-22;BI;Burundi;43;0;4494;6
2021-05-23;BI;Burundi;0;0;4494;6
2021-05-24;BI;Burundi;52;0;4546;6
2021-05-25;BI;Burundi;22;0;4568;6
2021-05-26;BI;Burundi;24;0;4592;6
2021-05-27;BI;Burundi;58;0;4650;6
2021-05-28;BI;Burundi;19;0;4669;6
2021-05-29;BI;Burundi;46;0;4715;6
2021-05-30;BI;Burundi;39;0;4754;6
2021-05-31;BI;Burundi;36;0;4790;6
2021-06-01;BI;Burundi;13;0;4803;6
2021-06-02;BI;Burundi;25;0;4828;6
2021-06-03;BI;Burundi;16;0;4844;6
2021-06-04;BI;Burundi;17;0;4861;6
2021-06-05;BI;Burundi;20;0;4881;6
2021-06-06;BI;Burundi;24;2;4905;8
2021-06-07;BI;Burundi;20;0;4925;8
2021-06-08;BI;Burundi;0;0;4925;8
2021-06-09;BI;Burundi;17;0;4942;8
2021-06-10;BI;Burundi;18;0;4960;8
2021-06-11;BI;Burundi;15;0;4975;8
2021-06-12;BI;Burundi;20;0;4995;8
2021-06-13;BI;Burundi;18;0;5013;8
2021-06-14;BI;Burundi;13;0;5026;8
2021-06-15;BI;Burundi;11;0;5037;8
2021-06-16;BI;Burundi;45;0;5082;8
2021-06-17;BI;Burundi;16;0;5098;8
2021-06-18;BI;Burundi;23;0;5121;8
2021-06-19;BI;Burundi;0;0;5121;8
2021-06-20;BI;Burundi;0;0;5121;8
2021-06-21;BI;Burundi;121;0;5242;8
2021-06-22;BI;Burundi;31;0;5273;8
2021-06-23;BI;Burundi;27;0;5300;8
2021-06-24;BI;Burundi;34;0;5334;8
2021-06-25;BI;Burundi;14;0;5348;8
2021-06-26;BI;Burundi;0;0;5348;8
2021-06-27;BI;Burundi;0;0;5348;8
2021-06-28;BI;Burundi;75;0;5423;8
2021-06-29;BI;Burundi;5;0;5428;8
2021-06-30;BI;Burundi;24;0;5452;8
2021-07-01;BI;Burundi;30;0;5482;8
2020-01-27;KH;Cambodia;1;0;1;0
2020-01-28;KH;Cambodia;0;0;1;0
2020-01-29;KH;Cambodia;0;0;1;0
2020-01-30;KH;Cambodia;0;0;1;0
2020-01-31;KH;Cambodia;0;0;1;0
2020-02-01;KH;Cambodia;0;0;1;0
2020-02-02;KH;Cambodia;0;0;1;0
2020-02-03;KH;Cambodia;0;0;1;0
2020-02-04;KH;Cambodia;0;0;1;0
2020-02-05;KH;Cambodia;0;0;1;0
2020-02-06;KH;Cambodia;0;0;1;0
2020-02-07;KH;Cambodia;0;0;1;0
2020-02-08;KH;Cambodia;0;0;1;0
2020-02-09;KH;Cambodia;0;0;1;0
2020-02-10;KH;Cambodia;0;0;1;0
2020-02-11;KH;Cambodia;0;0;1;0
2020-02-12;KH;Cambodia;0;0;1;0
2020-02-13;KH;Cambodia;0;0;1;0
2020-02-14;KH;Cambodia;0;0;1;0
2020-02-15;KH;Cambodia;0;0;1;0
2020-02-16;KH;Cambodia;0;0;1;0
2020-02-17;KH;Cambodia;0;0;1;0
2020-02-18;KH;Cambodia;0;0;1;0
2020-02-19;KH;Cambodia;0;0;1;0
2020-02-20;KH;Cambodia;0;0;1;0
2020-02-21;KH;Cambodia;0;0;1;0
2020-02-22;KH;Cambodia;0;0;1;0
2020-02-23;KH;Cambodia;0;0;1;0
2020-02-24;KH;Cambodia;0;0;1;0
2020-02-25;KH;Cambodia;0;0;1;0
2020-02-26;KH;Cambodia;0;0;1;0
2020-02-27;KH;Cambodia;0;0;1;0
2020-02-28;KH;Cambodia;0;0;1;0
2020-02-29;KH;Cambodia;0;0;1;0
2020-03-01;KH;Cambodia;0;0;1;0
2020-03-02;KH;Cambodia;0;0;1;0
2020-03-03;KH;Cambodia;0;0;1;0
2020-03-04;KH;Cambodia;0;0;1;0
2020-03-05;KH;Cambodia;0;0;1;0
2020-03-06;KH;Cambodia;0;0;1;0
2020-03-07;KH;Cambodia;0;0;1;0
2020-03-08;KH;Cambodia;1;0;2;0
2020-03-09;KH;Cambodia;0;0;2;0
2020-03-10;KH;Cambodia;0;0;2;0
2020-03-11;KH;Cambodia;1;0;3;0
2020-03-12;KH;Cambodia;0;0;3;0
2020-03-13;KH;Cambodia;2;0;5;0
2020-03-14;KH;Cambodia;2;0;7;0
2020-03-15;KH;Cambodia;0;0;7;0
2020-03-16;KH;Cambodia;0;0;7;0
2020-03-17;KH;Cambodia;26;0;33;0
2020-03-18;KH;Cambodia;2;0;35;0
2020-03-19;KH;Cambodia;2;0;37;0
2020-03-20;KH;Cambodia;14;0;51;0
2020-03-21;KH;Cambodia;2;0;53;0
2020-03-22;KH;Cambodia;31;0;84;0
2020-03-23;KH;Cambodia;3;0;87;0
2020-03-24;KH;Cambodia;4;0;91;0
2020-03-25;KH;Cambodia;5;0;96;0
2020-03-26;KH;Cambodia;0;0;96;0
2020-03-27;KH;Cambodia;3;0;99;0
2020-03-28;KH;Cambodia;0;0;99;0
2020-03-29;KH;Cambodia;4;0;103;0
2020-03-30;KH;Cambodia;4;0;107;0
2020-03-31;KH;Cambodia;2;0;109;0
2020-04-01;KH;Cambodia;0;0;109;0
2020-04-02;KH;Cambodia;1;0;110;0
2020-04-03;KH;Cambodia;4;0;114;0
2020-04-04;KH;Cambodia;0;0;114;0
2020-04-05;KH;Cambodia;0;0;114;0
2020-04-06;KH;Cambodia;0;0;114;0
2020-04-07;KH;Cambodia;1;0;115;0
2020-04-08;KH;Cambodia;2;0;117;0
2020-04-09;KH;Cambodia;2;0;119;0
2020-04-10;KH;Cambodia;0;0;119;0
2020-04-11;KH;Cambodia;1;0;120;0
2020-04-12;KH;Cambodia;2;0;122;0
2020-04-13;KH;Cambodia;0;0;122;0
2020-04-14;KH;Cambodia;0;0;122;0
2020-04-15;KH;Cambodia;0;0;122;0
2020-04-16;KH;Cambodia;0;0;122;0
2020-04-17;KH;Cambodia;0;0;122;0
2020-04-18;KH;Cambodia;0;0;122;0
2020-04-19;KH;Cambodia;0;0;122;0
2020-04-20;KH;Cambodia;0;0;122;0
2020-04-21;KH;Cambodia;0;0;122;0
2020-04-22;KH;Cambodia;0;0;122;0
2020-04-23;KH;Cambodia;0;0;122;0
2020-04-24;KH;Cambodia;0;0;122;0
2020-04-25;KH;Cambodia;0;0;122;0
2020-04-26;KH;Cambodia;0;0;122;0
2020-04-27;KH;Cambodia;0;0;122;0
2020-04-28;KH;Cambodia;0;0;122;0
2020-04-29;KH;Cambodia;0;0;122;0
2020-04-30;KH;Cambodia;0;0;122;0
2020-05-01;KH;Cambodia;0;0;122;0
2020-05-02;KH;Cambodia;0;0;122;0
2020-05-03;KH;Cambodia;0;0;122;0
2020-05-04;KH;Cambodia;0;0;122;0
2020-05-05;KH;Cambodia;0;0;122;0
2020-05-06;KH;Cambodia;0;0;122;0
2020-05-07;KH;Cambodia;0;0;122;0
2020-05-08;KH;Cambodia;0;0;122;0
2020-05-09;KH;Cambodia;0;0;122;0
2020-05-10;KH;Cambodia;0;0;122;0
2020-05-11;KH;Cambodia;0;0;122;0
2020-05-12;KH;Cambodia;0;0;122;0
2020-05-13;KH;Cambodia;0;0;122;0
2020-05-14;KH;Cambodia;0;0;122;0
2020-05-15;KH;Cambodia;0;0;122;0
2020-05-16;KH;Cambodia;0;0;122;0
2020-05-17;KH;Cambodia;0;0;122;0
2020-05-18;KH;Cambodia;0;0;122;0
2020-05-19;KH;Cambodia;0;0;122;0
2020-05-20;KH;Cambodia;0;0;122;0
2020-05-21;KH;Cambodia;1;0;123;0
2020-05-22;KH;Cambodia;0;0;123;0
2020-05-23;KH;Cambodia;1;0;124;0
2020-05-24;KH;Cambodia;0;0;124;0
2020-05-25;KH;Cambodia;0;0;124;0
2020-05-26;KH;Cambodia;0;0;124;0
2020-05-27;KH;Cambodia;0;0;124;0
2020-05-28;KH;Cambodia;0;0;124;0
2020-05-29;KH;Cambodia;0;0;124;0
2020-05-30;KH;Cambodia;1;0;125;0
2020-05-31;KH;Cambodia;0;0;125;0
2020-06-01;KH;Cambodia;0;0;125;0
2020-06-02;KH;Cambodia;0;0;125;0
2020-06-03;KH;Cambodia;0;0;125;0
2020-06-04;KH;Cambodia;0;0;125;0
2020-06-05;KH;Cambodia;0;0;125;0
2020-06-06;KH;Cambodia;0;0;125;0
2020-06-07;KH;Cambodia;1;0;126;0
2020-06-08;KH;Cambodia;0;0;126;0
2020-06-09;KH;Cambodia;0;0;126;0
2020-06-10;KH;Cambodia;0;0;126;0
2020-06-11;KH;Cambodia;0;0;126;0
2020-06-12;KH;Cambodia;0;0;126;0
2020-06-13;KH;Cambodia;2;0;128;0
2020-06-14;KH;Cambodia;0;0;128;0
2020-06-15;KH;Cambodia;0;0;128;0
2020-06-16;KH;Cambodia;0;0;128;0
2020-06-17;KH;Cambodia;0;0;128;0
2020-06-18;KH;Cambodia;1;0;129;0
2020-06-19;KH;Cambodia;0;0;129;0
2020-06-20;KH;Cambodia;0;0;129;0
2020-06-21;KH;Cambodia;0;0;129;0
2020-06-22;KH;Cambodia;1;0;130;0
2020-06-23;KH;Cambodia;0;0;130;0
2020-06-24;KH;Cambodia;0;0;130;0
2020-06-25;KH;Cambodia;0;0;130;0
2020-06-26;KH;Cambodia;9;0;139;0
2020-06-27;KH;Cambodia;2;0;141;0
2020-06-28;KH;Cambodia;0;0;141;0
2020-06-29;KH;Cambodia;0;0;141;0
2020-06-30;KH;Cambodia;0;0;141;0
2020-07-01;KH;Cambodia;0;0;141;0
2020-07-02;KH;Cambodia;0;0;141;0
2020-07-03;KH;Cambodia;0;0;141;0
2020-07-04;KH;Cambodia;0;0;141;0
2020-07-05;KH;Cambodia;0;0;141;0
2020-07-06;KH;Cambodia;0;0;141;0
2020-07-07;KH;Cambodia;0;0;141;0
2020-07-08;KH;Cambodia;0;0;141;0
2020-07-09;KH;Cambodia;0;0;141;0
2020-07-10;KH;Cambodia;0;0;141;0
2020-07-11;KH;Cambodia;15;0;156;0
2020-07-12;KH;Cambodia;0;0;156;0
2020-07-13;KH;Cambodia;9;0;165;0
2020-07-14;KH;Cambodia;0;0;165;0
2020-07-15;KH;Cambodia;1;0;166;0
2020-07-16;KH;Cambodia;5;0;171;0
2020-07-17;KH;Cambodia;0;0;171;0
2020-07-18;KH;Cambodia;0;0;171;0
2020-07-19;KH;Cambodia;0;0;171;0
2020-07-20;KH;Cambodia;0;0;171;0
2020-07-21;KH;Cambodia;26;0;197;0
2020-07-22;KH;Cambodia;1;0;198;0
2020-07-23;KH;Cambodia;4;0;202;0
2020-07-24;KH;Cambodia;0;0;202;0
2020-07-25;KH;Cambodia;23;0;225;0
2020-07-26;KH;Cambodia;0;0;225;0
2020-07-27;KH;Cambodia;1;0;226;0
2020-07-28;KH;Cambodia;0;0;226;0
2020-07-29;KH;Cambodia;0;0;226;0
2020-07-30;KH;Cambodia;8;0;234;0
2020-07-31;KH;Cambodia;5;0;239;0
2020-08-01;KH;Cambodia;1;0;240;0
2020-08-02;KH;Cambodia;0;0;240;0
2020-08-03;KH;Cambodia;0;0;240;0
2020-08-04;KH;Cambodia;3;0;243;0
2020-08-05;KH;Cambodia;0;0;243;0
2020-08-06;KH;Cambodia;0;0;243;0
2020-08-07;KH;Cambodia;3;0;246;0
2020-08-08;KH;Cambodia;2;0;248;0
2020-08-09;KH;Cambodia;3;0;251;0
2020-08-10;KH;Cambodia;0;0;251;0
2020-08-11;KH;Cambodia;17;0;268;0
2020-08-12;KH;Cambodia;4;0;272;0
2020-08-13;KH;Cambodia;1;0;273;0
2020-08-14;KH;Cambodia;0;0;273;0
2020-08-15;KH;Cambodia;0;0;273;0
2020-08-16;KH;Cambodia;0;0;273;0
2020-08-17;KH;Cambodia;0;0;273;0
2020-08-18;KH;Cambodia;0;0;273;0
2020-08-19;KH;Cambodia;0;0;273;0
2020-08-20;KH;Cambodia;0;0;273;0
2020-08-21;KH;Cambodia;0;0;273;0
2020-08-22;KH;Cambodia;0;0;273;0
2020-08-23;KH;Cambodia;0;0;273;0
2020-08-24;KH;Cambodia;0;0;273;0
2020-08-25;KH;Cambodia;0;0;273;0
2020-08-26;KH;Cambodia;0;0;273;0
2020-08-27;KH;Cambodia;0;0;273;0
2020-08-28;KH;Cambodia;0;0;273;0
2020-08-29;KH;Cambodia;0;0;273;0
2020-08-30;KH;Cambodia;0;0;273;0
2020-08-31;KH;Cambodia;1;0;274;0
2020-09-01;KH;Cambodia;0;0;274;0
2020-09-02;KH;Cambodia;0;0;274;0
2020-09-03;KH;Cambodia;0;0;274;0
2020-09-04;KH;Cambodia;0;0;274;0
2020-09-05;KH;Cambodia;0;0;274;0
2020-09-06;KH;Cambodia;0;0;274;0
2020-09-07;KH;Cambodia;0;0;274;0
2020-09-08;KH;Cambodia;0;0;274;0
2020-09-09;KH;Cambodia;0;0;274;0
2020-09-10;KH;Cambodia;0;0;274;0
2020-09-11;KH;Cambodia;0;0;274;0
2020-09-12;KH;Cambodia;1;0;275;0
2020-09-13;KH;Cambodia;0;0;275;0
2020-09-14;KH;Cambodia;0;0;275;0
2020-09-15;KH;Cambodia;0;0;275;0
2020-09-16;KH;Cambodia;0;0;275;0
2020-09-17;KH;Cambodia;0;0;275;0
2020-09-18;KH;Cambodia;0;0;275;0
2020-09-19;KH;Cambodia;0;0;275;0
2020-09-20;KH;Cambodia;0;0;275;0
2020-09-21;KH;Cambodia;0;0;275;0
2020-09-22;KH;Cambodia;0;0;275;0
2020-09-23;KH;Cambodia;0;0;275;0
2020-09-24;KH;Cambodia;0;0;275;0
2020-09-25;KH;Cambodia;0;0;275;0
2020-09-26;KH;Cambodia;1;0;276;0
2020-09-27;KH;Cambodia;0;0;276;0
2020-09-28;KH;Cambodia;1;0;277;0
2020-09-29;KH;Cambodia;0;0;277;0
2020-09-30;KH;Cambodia;0;0;277;0
2020-10-01;KH;Cambodia;1;0;278;0
2020-10-02;KH;Cambodia;0;0;278;0
2020-10-03;KH;Cambodia;0;0;278;0
2020-10-04;KH;Cambodia;0;0;278;0
2020-10-05;KH;Cambodia;2;0;280;0
2020-10-06;KH;Cambodia;0;0;280;0
2020-10-07;KH;Cambodia;1;0;281;0
2020-10-08;KH;Cambodia;0;0;281;0
2020-10-09;KH;Cambodia;2;0;283;0
2020-10-10;KH;Cambodia;0;0;283;0
2020-10-11;KH;Cambodia;0;0;283;0
2020-10-12;KH;Cambodia;0;0;283;0
2020-10-13;KH;Cambodia;0;0;283;0
2020-10-14;KH;Cambodia;0;0;283;0
2020-10-15;KH;Cambodia;0;0;283;0
2020-10-16;KH;Cambodia;0;0;283;0
2020-10-17;KH;Cambodia;0;0;283;0
2020-10-18;KH;Cambodia;0;0;283;0
2020-10-19;KH;Cambodia;2;0;285;0
2020-10-20;KH;Cambodia;1;0;286;0
2020-10-21;KH;Cambodia;0;0;286;0
2020-10-22;KH;Cambodia;0;0;286;0
2020-10-23;KH;Cambodia;1;0;287;0
2020-10-24;KH;Cambodia;0;0;287;0
2020-10-25;KH;Cambodia;0;0;287;0
2020-10-26;KH;Cambodia;1;0;288;0
2020-10-27;KH;Cambodia;2;0;290;0
2020-10-28;KH;Cambodia;0;0;290;0
2020-10-29;KH;Cambodia;1;0;291;0
2020-10-30;KH;Cambodia;0;0;291;0
2020-10-31;KH;Cambodia;0;0;291;0
2020-11-01;KH;Cambodia;1;0;292;0
2020-11-02;KH;Cambodia;0;0;292;0
2020-11-03;KH;Cambodia;0;0;292;0
2020-11-04;KH;Cambodia;0;0;292;0
2020-11-05;KH;Cambodia;0;0;292;0
2020-11-06;KH;Cambodia;2;0;294;0
2020-11-07;KH;Cambodia;1;0;295;0
2020-11-08;KH;Cambodia;2;0;297;0
2020-11-09;KH;Cambodia;3;0;300;0
2020-11-10;KH;Cambodia;0;0;300;0
2020-11-11;KH;Cambodia;1;0;301;0
2020-11-12;KH;Cambodia;0;0;301;0
2020-11-13;KH;Cambodia;1;0;302;0
2020-11-14;KH;Cambodia;0;0;302;0
2020-11-15;KH;Cambodia;0;0;302;0
2020-11-16;KH;Cambodia;1;0;303;0
2020-11-17;KH;Cambodia;1;0;304;0
2020-11-18;KH;Cambodia;0;0;304;0
2020-11-19;KH;Cambodia;0;0;304;0
2020-11-20;KH;Cambodia;1;0;305;0
2020-11-21;KH;Cambodia;1;0;306;0
2020-11-22;KH;Cambodia;0;0;306;0
2020-11-23;KH;Cambodia;0;0;306;0
2020-11-24;KH;Cambodia;1;0;307;0
2020-11-25;KH;Cambodia;0;0;307;0
2020-11-26;KH;Cambodia;0;0;307;0
2020-11-27;KH;Cambodia;1;0;308;0
2020-11-28;KH;Cambodia;7;0;315;0
2020-11-29;KH;Cambodia;8;0;323;0
2020-11-30;KH;Cambodia;3;0;326;0
2020-12-01;KH;Cambodia;3;0;329;0
2020-12-02;KH;Cambodia;2;0;331;0
2020-12-03;KH;Cambodia;4;0;335;0
2020-12-04;KH;Cambodia;10;0;345;0
2020-12-05;KH;Cambodia;1;0;346;0
2020-12-06;KH;Cambodia;2;0;348;0
2020-12-07;KH;Cambodia;2;0;350;0
2020-12-08;KH;Cambodia;4;0;354;0
2020-12-09;KH;Cambodia;2;0;356;0
2020-12-10;KH;Cambodia;1;0;357;0
2020-12-11;KH;Cambodia;0;0;357;0
2020-12-12;KH;Cambodia;2;0;359;0
2020-12-13;KH;Cambodia;0;0;359;0
2020-12-14;KH;Cambodia;3;0;362;0
2020-12-15;KH;Cambodia;0;0;362;0
2020-12-16;KH;Cambodia;0;0;362;0
2020-12-17;KH;Cambodia;0;0;362;0
2020-12-18;KH;Cambodia;0;0;362;0
2020-12-19;KH;Cambodia;0;0;362;0
2020-12-20;KH;Cambodia;1;0;363;0
2020-12-21;KH;Cambodia;0;0;363;0
2020-12-22;KH;Cambodia;0;0;363;0
2020-12-23;KH;Cambodia;0;0;363;0
2020-12-24;KH;Cambodia;0;0;363;0
2020-12-25;KH;Cambodia;0;0;363;0
2020-12-26;KH;Cambodia;1;0;364;0
2020-12-27;KH;Cambodia;0;0;364;0
2020-12-28;KH;Cambodia;0;0;364;0
2020-12-29;KH;Cambodia;0;0;364;0
2020-12-30;KH;Cambodia;2;0;366;0
2020-12-31;KH;Cambodia;12;0;378;0
2021-01-01;KH;Cambodia;1;0;379;0
2021-01-02;KH;Cambodia;2;0;381;0
2021-01-03;KH;Cambodia;1;0;382;0
2021-01-04;KH;Cambodia;0;0;382;0
2021-01-05;KH;Cambodia;1;0;383;0
2021-01-06;KH;Cambodia;2;0;385;0
2021-01-07;KH;Cambodia;1;0;386;0
2021-01-08;KH;Cambodia;1;0;387;0
2021-01-09;KH;Cambodia;4;0;391;0
2021-01-10;KH;Cambodia;0;0;391;0
2021-01-11;KH;Cambodia;1;0;392;0
2021-01-12;KH;Cambodia;6;0;398;0
2021-01-13;KH;Cambodia;13;0;411;0
2021-01-14;KH;Cambodia;15;0;426;0
2021-01-15;KH;Cambodia;10;0;436;0
2021-01-16;KH;Cambodia;3;0;439;0
2021-01-17;KH;Cambodia;0;0;439;0
2021-01-18;KH;Cambodia;2;0;441;0
2021-01-19;KH;Cambodia;7;0;448;0
2021-01-20;KH;Cambodia;5;0;453;0
2021-01-21;KH;Cambodia;3;0;456;0
2021-01-22;KH;Cambodia;0;0;456;0
2021-01-23;KH;Cambodia;2;0;458;0
2021-01-24;KH;Cambodia;0;0;458;0
2021-01-25;KH;Cambodia;2;0;460;0
2021-01-26;KH;Cambodia;0;0;460;0
2021-01-27;KH;Cambodia;0;0;460;0
2021-01-28;KH;Cambodia;3;0;463;0
2021-01-29;KH;Cambodia;0;0;463;0
2021-01-30;KH;Cambodia;2;0;465;0
2021-01-31;KH;Cambodia;1;0;466;0
2021-02-01;KH;Cambodia;0;0;466;0
2021-02-02;KH;Cambodia;0;0;466;0
2021-02-03;KH;Cambodia;1;0;467;0
2021-02-04;KH;Cambodia;3;0;470;0
2021-02-05;KH;Cambodia;2;0;472;0
2021-02-06;KH;Cambodia;2;0;474;0
2021-02-07;KH;Cambodia;0;0;474;0
2021-02-08;KH;Cambodia;2;0;476;0
2021-02-09;KH;Cambodia;0;0;476;0
2021-02-10;KH;Cambodia;2;0;478;0
2021-02-11;KH;Cambodia;1;0;479;0
2021-02-12;KH;Cambodia;0;0;479;0
2021-02-13;KH;Cambodia;0;0;479;0
2021-02-14;KH;Cambodia;0;0;479;0
2021-02-15;KH;Cambodia;0;0;479;0
2021-02-16;KH;Cambodia;0;0;479;0
2021-02-17;KH;Cambodia;4;0;483;0
2021-02-18;KH;Cambodia;1;0;484;0
2021-02-19;KH;Cambodia;0;0;484;0
2021-02-20;KH;Cambodia;49;0;533;0
2021-02-21;KH;Cambodia;35;0;568;0
2021-02-22;KH;Cambodia;25;0;593;0
2021-02-23;KH;Cambodia;40;0;633;0
2021-02-24;KH;Cambodia;64;0;697;0
2021-02-25;KH;Cambodia;44;0;741;0
2021-02-26;KH;Cambodia;26;0;767;0
2021-02-27;KH;Cambodia;38;0;805;0
2021-02-28;KH;Cambodia;15;0;820;0
2021-03-01;KH;Cambodia;24;0;844;0
2021-03-02;KH;Cambodia;34;0;878;0
2021-03-03;KH;Cambodia;31;0;909;0
2021-03-04;KH;Cambodia;23;0;932;0
2021-03-05;KH;Cambodia;21;0;953;0
2021-03-06;KH;Cambodia;34;0;987;0
2021-03-07;KH;Cambodia;24;0;1011;0
2021-03-08;KH;Cambodia;0;0;1011;0
2021-03-09;KH;Cambodia;113;0;1124;0
2021-03-10;KH;Cambodia;39;0;1163;0
2021-03-11;KH;Cambodia;62;1;1225;1
2021-03-12;KH;Cambodia;39;0;1264;1
2021-03-13;KH;Cambodia;41;0;1305;1
2021-03-14;KH;Cambodia;20;0;1325;1
2021-03-15;KH;Cambodia;0;0;1325;1
2021-03-16;KH;Cambodia;180;0;1505;1
2021-03-17;KH;Cambodia;36;0;1541;1
2021-03-18;KH;Cambodia;37;0;1578;1
2021-03-19;KH;Cambodia;0;1;1578;2
2021-03-20;KH;Cambodia;0;0;1578;2
2021-03-21;KH;Cambodia;175;1;1753;3
2021-03-22;KH;Cambodia;35;1;1788;4
2021-03-23;KH;Cambodia;29;1;1817;5
2021-03-24;KH;Cambodia;55;0;1872;5
2021-03-25;KH;Cambodia;0;0;1872;5
2021-03-26;KH;Cambodia;96;3;1968;8
2021-03-27;KH;Cambodia;179;0;2147;8
2021-03-28;KH;Cambodia;86;2;2233;10
2021-03-29;KH;Cambodia;145;1;2378;11
2021-03-30;KH;Cambodia;62;0;2440;11
2021-03-31;KH;Cambodia;0;0;2440;11
2021-04-01;KH;Cambodia;37;3;2477;14
2021-04-02;KH;Cambodia;69;2;2546;16
2021-04-03;KH;Cambodia;143;3;2689;19
2021-04-04;KH;Cambodia;0;0;2689;19
2021-04-05;KH;Cambodia;63;2;2752;21
2021-04-06;KH;Cambodia;163;1;2915;22
2021-04-07;KH;Cambodia;0;0;2915;22
2021-04-08;KH;Cambodia;113;2;3028;24
2021-04-09;KH;Cambodia;576;0;3604;24
2021-04-10;KH;Cambodia;477;2;4081;26
2021-04-11;KH;Cambodia;434;4;4515;30
2021-04-12;KH;Cambodia;0;0;4515;30
2021-04-13;KH;Cambodia;181;3;4696;33
2021-04-14;KH;Cambodia;178;2;4874;35
2021-04-15;KH;Cambodia;344;1;5218;36
2021-04-16;KH;Cambodia;262;2;5480;38
2021-04-17;KH;Cambodia;291;1;5771;39
2021-04-18;KH;Cambodia;618;4;6389;43
2021-04-19;KH;Cambodia;624;2;7013;45
2021-04-20;KH;Cambodia;431;4;7444;49
2021-04-21;KH;Cambodia;303;5;7747;54
2021-04-22;KH;Cambodia;446;5;8193;59
2021-04-23;KH;Cambodia;655;2;8848;61
2021-04-24;KH;Cambodia;511;10;9359;71
2021-04-25;KH;Cambodia;616;3;9975;74
2021-04-26;KH;Cambodia;580;5;10555;79
2021-04-27;KH;Cambodia;508;3;11063;82
2021-04-28;KH;Cambodia;698;6;11761;88
2021-04-29;KH;Cambodia;880;3;12641;91
2021-04-30;KH;Cambodia;761;2;13402;93
2021-05-01;KH;Cambodia;388;3;13790;96
2021-05-02;KH;Cambodia;730;7;14520;103
2021-05-03;KH;Cambodia;841;3;15361;106
2021-05-04;KH;Cambodia;938;1;16299;107
2021-05-05;KH;Cambodia;672;3;16971;110
2021-05-06;KH;Cambodia;650;4;17621;114
2021-05-07;KH;Cambodia;558;0;18179;114
2021-05-08;KH;Cambodia;538;0;18717;114
2021-05-09;KH;Cambodia;520;6;19237;120
2021-05-10;KH;Cambodia;506;6;19743;126
2021-05-11;KH;Cambodia;480;5;20223;131
2021-05-12;KH;Cambodia;472;5;20695;136
2021-05-13;KH;Cambodia;446;6;21141;142
2021-05-14;KH;Cambodia;358;5;21499;147
2021-05-15;KH;Cambodia;335;0;21834;147
2021-05-16;KH;Cambodia;350;3;22184;150
2021-05-17;KH;Cambodia;360;4;22544;154
2021-05-18;KH;Cambodia;345;2;22889;156
2021-05-19;KH;Cambodia;393;3;23282;159
2021-05-20;KH;Cambodia;415;5;23697;164
2021-05-21;KH;Cambodia;460;1;24157;165
2021-05-22;KH;Cambodia;488;2;24645;167
2021-05-23;KH;Cambodia;560;9;25205;176
2021-05-24;KH;Cambodia;556;3;25761;179
2021-05-25;KH;Cambodia;568;4;26329;183
2021-05-26;KH;Cambodia;660;7;26989;190
2021-05-27;KH;Cambodia;649;4;27638;194
2021-05-28;KH;Cambodia;599;2;28237;196
2021-05-29;KH;Cambodia;588;7;28825;203
2021-05-30;KH;Cambodia;579;6;29404;209
2021-05-31;KH;Cambodia;690;5;30094;214
2021-06-01;KH;Cambodia;616;6;30710;220
2021-06-02;KH;Cambodia;750;10;31460;230
2021-06-03;KH;Cambodia;729;6;32189;236
2021-06-04;KH;Cambodia;886;6;33075;242
2021-06-05;KH;Cambodia;538;10;33613;252
2021-06-06;KH;Cambodia;631;11;34244;263
2021-06-07;KH;Cambodia;589;3;34833;266
2021-06-08;KH;Cambodia;678;12;35511;278
2021-06-09;KH;Cambodia;729;11;36240;289
2021-06-10;KH;Cambodia;426;11;36666;300
2021-06-11;KH;Cambodia;655;11;37321;311
2021-06-12;KH;Cambodia;638;9;37959;320
2021-06-13;KH;Cambodia;468;15;38427;335
2021-06-14;KH;Cambodia;542;13;38969;348
2021-06-15;KH;Cambodia;495;13;39464;361
2021-06-16;KH;Cambodia;693;7;40157;368
2021-06-17;KH;Cambodia;625;12;40782;380
2021-06-18;KH;Cambodia;799;14;41581;394
2021-06-19;KH;Cambodia;471;20;42052;414
2021-06-20;KH;Cambodia;659;17;42711;431
2021-06-21;KH;Cambodia;735;10;43446;441
2021-06-22;KH;Cambodia;678;18;44124;459
2021-06-23;KH;Cambodia;587;16;44711;475
2021-06-24;KH;Cambodia;655;18;45366;493
2021-06-25;KH;Cambodia;699;16;46065;509
2021-06-26;KH;Cambodia;745;14;46810;523
2021-06-27;KH;Cambodia;839;17;47649;540
2021-06-28;KH;Cambodia;883;16;48532;556
2021-06-29;KH;Cambodia;723;19;49255;575
2021-06-30;KH;Cambodia;1130;27;50385;602
2021-07-01;KH;Cambodia;999;26;51384;628
2020-03-06;CM;Cameroon;1;0;1;0
2020-03-07;CM;Cameroon;0;0;1;0
2020-03-08;CM;Cameroon;1;0;2;0
2020-03-09;CM;Cameroon;0;0;2;0
2020-03-10;CM;Cameroon;0;0;2;0
2020-03-11;CM;Cameroon;0;0;2;0
2020-03-12;CM;Cameroon;0;0;2;0
2020-03-13;CM;Cameroon;0;0;2;0
2020-03-14;CM;Cameroon;0;0;2;0
2020-03-15;CM;Cameroon;0;0;2;0
2020-03-16;CM;Cameroon;2;0;4;0
2020-03-17;CM;Cameroon;6;0;10;0
2020-03-18;CM;Cameroon;0;0;10;0
2020-03-19;CM;Cameroon;3;0;13;0
2020-03-20;CM;Cameroon;7;0;20;0
2020-03-21;CM;Cameroon;7;0;27;0
2020-03-22;CM;Cameroon;13;0;40;0
2020-03-23;CM;Cameroon;16;0;56;0
2020-03-24;CM;Cameroon;10;0;66;0
2020-03-25;CM;Cameroon;9;1;75;1
2020-03-26;CM;Cameroon;0;0;75;1
2020-03-27;CM;Cameroon;16;1;91;2
2020-03-28;CM;Cameroon;0;0;91;2
2020-03-29;CM;Cameroon;48;4;139;6
2020-03-30;CM;Cameroon;0;0;139;6
2020-03-31;CM;Cameroon;54;0;193;6
2020-04-01;CM;Cameroon;40;0;233;6
2020-04-02;CM;Cameroon;73;1;306;7
2020-04-03;CM;Cameroon;203;1;509;8
2020-04-04;CM;Cameroon;46;1;555;9
2020-04-05;CM;Cameroon;95;0;650;9
2020-04-06;CM;Cameroon;8;0;658;9
2020-04-07;CM;Cameroon;0;0;658;9
2020-04-08;CM;Cameroon;72;1;730;10
2020-04-09;CM;Cameroon;0;0;730;10
2020-04-10;CM;Cameroon;90;2;820;12
2020-04-11;CM;Cameroon;0;0;820;12
2020-04-12;CM;Cameroon;0;0;820;12
2020-04-13;CM;Cameroon;0;0;820;12
2020-04-14;CM;Cameroon;28;2;848;14
2020-04-15;CM;Cameroon;0;3;848;17
2020-04-16;CM;Cameroon;148;5;996;22
2020-04-17;CM;Cameroon;0;0;996;22
2020-04-18;CM;Cameroon;21;0;1017;22
2020-04-19;CM;Cameroon;0;20;1017;42
2020-04-20;CM;Cameroon;146;0;1163;42
2020-04-21;CM;Cameroon;0;1;1163;43
2020-04-22;CM;Cameroon;0;0;1163;43
2020-04-23;CM;Cameroon;171;0;1334;43
2020-04-24;CM;Cameroon;96;0;1430;43
2020-04-25;CM;Cameroon;88;10;1518;53
2020-04-26;CM;Cameroon;103;3;1621;56
2020-04-27;CM;Cameroon;84;2;1705;58
2020-04-28;CM;Cameroon;0;0;1705;58
2020-04-29;CM;Cameroon;127;3;1832;61
2020-04-30;CM;Cameroon;0;0;1832;61
2020-05-01;CM;Cameroon;0;0;1832;61
2020-05-02;CM;Cameroon;245;3;2077;64
2020-05-03;CM;Cameroon;0;0;2077;64
2020-05-04;CM;Cameroon;27;0;2104;64
2020-05-05;CM;Cameroon;0;0;2104;64
2020-05-06;CM;Cameroon;161;44;2265;108
2020-05-07;CM;Cameroon;2;0;2267;108
2020-05-08;CM;Cameroon;0;0;2267;108
2020-05-09;CM;Cameroon;7;0;2274;108
2020-05-10;CM;Cameroon;305;6;2579;114
2020-05-11;CM;Cameroon;110;11;2689;125
2020-05-12;CM;Cameroon;0;0;2689;125
2020-05-13;CM;Cameroon;111;11;2800;136
2020-05-14;CM;Cameroon;154;3;2954;139
2020-05-15;CM;Cameroon;151;1;3105;140
2020-05-16;CM;Cameroon;0;0;3105;140
2020-05-17;CM;Cameroon;0;0;3105;140
2020-05-18;CM;Cameroon;424;0;3529;140
2020-05-19;CM;Cameroon;0;0;3529;140
2020-05-20;CM;Cameroon;204;6;3733;146
2020-05-21;CM;Cameroon;555;10;4288;156
2020-05-22;CM;Cameroon;112;3;4400;159
2020-05-23;CM;Cameroon;0;0;4400;159
2020-05-24;CM;Cameroon;490;6;4890;165
2020-05-25;CM;Cameroon;0;0;4890;165
2020-05-26;CM;Cameroon;546;10;5436;175
2020-05-27;CM;Cameroon;0;0;5436;175
2020-05-28;CM;Cameroon;0;0;5436;175
2020-05-29;CM;Cameroon;0;2;5436;177
2020-05-30;CM;Cameroon;468;14;5904;191
2020-05-31;CM;Cameroon;0;0;5904;191
2020-06-01;CM;Cameroon;493;8;6397;199
2020-06-02;CM;Cameroon;188;1;6585;200
2020-06-03;CM;Cameroon;0;0;6585;200
2020-06-04;CM;Cameroon;204;3;6789;203
2020-06-05;CM;Cameroon;603;2;7392;205
2020-06-06;CM;Cameroon;207;7;7599;212
2020-06-07;CM;Cameroon;309;0;7908;212
2020-06-08;CM;Cameroon;152;0;8060;212
2020-06-09;CM;Cameroon;252;0;8312;212
2020-06-10;CM;Cameroon;369;0;8681;212
2020-06-11;CM;Cameroon;0;0;8681;212
2020-06-12;CM;Cameroon;0;0;8681;212
2020-06-13;CM;Cameroon;0;0;8681;212
2020-06-14;CM;Cameroon;0;0;8681;212
2020-06-15;CM;Cameroon;1183;64;9864;276
2020-06-16;CM;Cameroon;0;0;9864;276
2020-06-17;CM;Cameroon;0;0;9864;276
2020-06-18;CM;Cameroon;0;0;9864;276
2020-06-19;CM;Cameroon;774;6;10638;282
2020-06-20;CM;Cameroon;972;19;11610;301
2020-06-21;CM;Cameroon;282;2;11892;303
2020-06-22;CM;Cameroon;149;5;12041;308
2020-06-23;CM;Cameroon;229;5;12270;313
2020-06-24;CM;Cameroon;322;0;12592;313
2020-06-25;CM;Cameroon;0;0;12592;313
2020-06-26;CM;Cameroon;0;0;12592;313
2020-06-27;CM;Cameroon;0;0;12592;313
2020-06-28;CM;Cameroon;0;0;12592;313
2020-06-29;CM;Cameroon;0;0;12592;313
2020-06-30;CM;Cameroon;0;0;12592;313
2020-07-01;CM;Cameroon;0;0;12592;313
2020-07-02;CM;Cameroon;0;0;12592;313
2020-07-03;CM;Cameroon;0;0;12592;313
2020-07-04;CM;Cameroon;0;0;12592;313
2020-07-05;CM;Cameroon;0;0;12592;313
2020-07-06;CM;Cameroon;0;0;12592;313
2020-07-07;CM;Cameroon;2324;46;14916;359
2020-07-08;CM;Cameroon;0;0;14916;359
2020-07-09;CM;Cameroon;0;0;14916;359
2020-07-10;CM;Cameroon;0;0;14916;359
2020-07-11;CM;Cameroon;257;0;15173;359
2020-07-12;CM;Cameroon;0;0;15173;359
2020-07-13;CM;Cameroon;0;0;15173;359
2020-07-14;CM;Cameroon;0;0;15173;359
2020-07-15;CM;Cameroon;0;0;15173;359
2020-07-16;CM;Cameroon;984;14;16157;373
2020-07-17;CM;Cameroon;0;0;16157;373
2020-07-18;CM;Cameroon;0;0;16157;373
2020-07-19;CM;Cameroon;0;0;16157;373
2020-07-20;CM;Cameroon;0;0;16157;373
2020-07-21;CM;Cameroon;365;9;16522;382
2020-07-22;CM;Cameroon;0;0;16522;382
2020-07-23;CM;Cameroon;0;0;16522;382
2020-07-24;CM;Cameroon;186;3;16708;385
2020-07-25;CM;Cameroon;0;0;16708;385
2020-07-26;CM;Cameroon;0;0;16708;385
2020-07-27;CM;Cameroon;402;6;17110;391
2020-07-28;CM;Cameroon;69;0;17179;391
2020-07-29;CM;Cameroon;76;0;17255;391
2020-07-30;CM;Cameroon;0;0;17255;391
2020-07-31;CM;Cameroon;0;0;17255;391
2020-08-01;CM;Cameroon;0;0;17255;391
2020-08-02;CM;Cameroon;0;0;17255;391
2020-08-03;CM;Cameroon;0;0;17255;391
2020-08-04;CM;Cameroon;463;0;17718;391
2020-08-05;CM;Cameroon;0;0;17718;391
2020-08-06;CM;Cameroon;0;0;17718;391
2020-08-07;CM;Cameroon;0;0;17718;391
2020-08-08;CM;Cameroon;324;4;18042;395
2020-08-09;CM;Cameroon;0;0;18042;395
2020-08-10;CM;Cameroon;0;0;18042;395
2020-08-11;CM;Cameroon;171;3;18213;398
2020-08-12;CM;Cameroon;50;3;18263;401
2020-08-13;CM;Cameroon;45;0;18308;401
2020-08-14;CM;Cameroon;161;0;18469;401
2020-08-15;CM;Cameroon;0;0;18469;401
2020-08-16;CM;Cameroon;0;0;18469;401
2020-08-17;CM;Cameroon;113;2;18582;403
2020-08-18;CM;Cameroon;17;3;18599;406
2020-08-19;CM;Cameroon;25;0;18624;406
2020-08-20;CM;Cameroon;138;2;18762;408
2020-08-21;CM;Cameroon;0;0;18762;408
2020-08-22;CM;Cameroon;0;0;18762;408
2020-08-23;CM;Cameroon;0;0;18762;408
2020-08-24;CM;Cameroon;0;0;18762;408
2020-08-25;CM;Cameroon;211;2;18973;410
2020-08-26;CM;Cameroon;0;0;18973;410
2020-08-27;CM;Cameroon;169;1;19142;411
2020-08-28;CM;Cameroon;0;0;19142;411
2020-08-29;CM;Cameroon;0;0;19142;411
2020-08-30;CM;Cameroon;0;0;19142;411
2020-08-31;CM;Cameroon;0;0;19142;411
2020-09-01;CM;Cameroon;267;3;19409;414
2020-09-02;CM;Cameroon;51;1;19460;415
2020-09-03;CM;Cameroon;144;0;19604;415
2020-09-04;CM;Cameroon;0;0;19604;415
2020-09-05;CM;Cameroon;0;0;19604;415
2020-09-06;CM;Cameroon;0;0;19604;415
2020-09-07;CM;Cameroon;0;0;19604;415
2020-09-08;CM;Cameroon;244;0;19848;415
2020-09-09;CM;Cameroon;0;0;19848;415
2020-09-10;CM;Cameroon;161;0;20009;415
2020-09-11;CM;Cameroon;0;0;20009;415
2020-09-12;CM;Cameroon;0;0;20009;415
2020-09-13;CM;Cameroon;158;0;20167;415
2020-09-14;CM;Cameroon;61;0;20228;415
2020-09-15;CM;Cameroon;43;0;20271;415
2020-09-16;CM;Cameroon;32;0;20303;415
2020-09-17;CM;Cameroon;0;0;20303;415
2020-09-18;CM;Cameroon;68;1;20371;416
2020-09-19;CM;Cameroon;60;0;20431;416
2020-09-20;CM;Cameroon;0;0;20431;416
2020-09-21;CM;Cameroon;167;0;20598;416
2020-09-22;CM;Cameroon;0;0;20598;416
2020-09-23;CM;Cameroon;92;0;20690;416
2020-09-24;CM;Cameroon;22;2;20712;418
2020-09-25;CM;Cameroon;0;0;20712;418
2020-09-26;CM;Cameroon;23;0;20735;418
2020-09-27;CM;Cameroon;0;0;20735;418
2020-09-28;CM;Cameroon;103;0;20838;418
2020-09-29;CM;Cameroon;0;0;20838;418
2020-09-30;CM;Cameroon;0;0;20838;418
2020-10-01;CM;Cameroon;0;0;20838;418
2020-10-02;CM;Cameroon;86;2;20924;420
2020-10-03;CM;Cameroon;0;0;20924;420
2020-10-04;CM;Cameroon;0;0;20924;420
2020-10-05;CM;Cameroon;0;0;20924;420
2020-10-06;CM;Cameroon;0;0;20924;420
2020-10-07;CM;Cameroon;0;0;20924;420
2020-10-08;CM;Cameroon;279;3;21203;423
2020-10-09;CM;Cameroon;0;0;21203;423
2020-10-10;CM;Cameroon;0;0;21203;423
2020-10-11;CM;Cameroon;0;0;21203;423
2020-10-12;CM;Cameroon;0;0;21203;423
2020-10-13;CM;Cameroon;0;0;21203;423
2020-10-14;CM;Cameroon;238;0;21441;423
2020-10-15;CM;Cameroon;0;0;21441;423
2020-10-16;CM;Cameroon;0;0;21441;423
2020-10-17;CM;Cameroon;0;0;21441;423
2020-10-18;CM;Cameroon;0;0;21441;423
2020-10-19;CM;Cameroon;65;1;21506;424
2020-10-20;CM;Cameroon;64;1;21570;425
2020-10-21;CM;Cameroon;0;0;21570;425
2020-10-22;CM;Cameroon;0;0;21570;425
2020-10-23;CM;Cameroon;0;0;21570;425
2020-10-24;CM;Cameroon;0;0;21570;425
2020-10-25;CM;Cameroon;0;0;21570;425
2020-10-26;CM;Cameroon;223;1;21793;426
2020-10-27;CM;Cameroon;0;0;21793;426
2020-10-28;CM;Cameroon;0;0;21793;426
2020-10-29;CM;Cameroon;0;0;21793;426
2020-10-30;CM;Cameroon;0;0;21793;426
2020-10-31;CM;Cameroon;0;0;21793;426
2020-11-01;CM;Cameroon;310;3;22103;429
2020-11-02;CM;Cameroon;0;0;22103;429
2020-11-03;CM;Cameroon;0;0;22103;429
2020-11-04;CM;Cameroon;0;0;22103;429
2020-11-05;CM;Cameroon;0;0;22103;429
2020-11-06;CM;Cameroon;0;0;22103;429
2020-11-07;CM;Cameroon;239;0;22342;429
2020-11-08;CM;Cameroon;79;4;22421;433
2020-11-09;CM;Cameroon;0;0;22421;433
2020-11-10;CM;Cameroon;0;0;22421;433
2020-11-11;CM;Cameroon;69;0;22490;433
2020-11-12;CM;Cameroon;0;0;22490;433
2020-11-13;CM;Cameroon;93;0;22583;433
2020-11-14;CM;Cameroon;109;0;22692;433
2020-11-15;CM;Cameroon;0;0;22692;433
2020-11-16;CM;Cameroon;0;0;22692;433
2020-11-17;CM;Cameroon;204;0;22896;433
2020-11-18;CM;Cameroon;0;0;22896;433
2020-11-19;CM;Cameroon;632;2;23528;435
2020-11-20;CM;Cameroon;0;0;23528;435
2020-11-21;CM;Cameroon;0;0;23528;435
2020-11-22;CM;Cameroon;0;0;23528;435
2020-11-23;CM;Cameroon;314;0;23842;435
2020-11-24;CM;Cameroon;27;1;23869;436
2020-11-25;CM;Cameroon;46;1;23915;437
2020-11-26;CM;Cameroon;107;0;24022;437
2020-11-27;CM;Cameroon;95;0;24117;437
2020-11-28;CM;Cameroon;0;0;24117;437
2020-11-29;CM;Cameroon;0;0;24117;437
2020-11-30;CM;Cameroon;328;0;24445;437
2020-12-01;CM;Cameroon;42;4;24487;441
2020-12-02;CM;Cameroon;0;0;24487;441
2020-12-03;CM;Cameroon;0;0;24487;441
2020-12-04;CM;Cameroon;265;2;24752;443
2020-12-05;CM;Cameroon;0;0;24752;443
2020-12-06;CM;Cameroon;0;0;24752;443
2020-12-07;CM;Cameroon;0;0;24752;443
2020-12-08;CM;Cameroon;0;0;24752;443
2020-12-09;CM;Cameroon;211;0;24963;443
2020-12-10;CM;Cameroon;0;0;24963;443
2020-12-11;CM;Cameroon;124;0;25087;443
2020-12-12;CM;Cameroon;56;0;25143;443
2020-12-13;CM;Cameroon;0;0;25143;443
2020-12-14;CM;Cameroon;71;0;25214;443
2020-12-15;CM;Cameroon;145;2;25359;445
2020-12-16;CM;Cameroon;113;0;25472;445
2020-12-17;CM;Cameroon;0;0;25472;445
2020-12-18;CM;Cameroon;0;0;25472;445
2020-12-19;CM;Cameroon;252;0;25724;445
2020-12-20;CM;Cameroon;125;3;25849;448
2020-12-21;CM;Cameroon;0;0;25849;448
2020-12-22;CM;Cameroon;0;0;25849;448
2020-12-23;CM;Cameroon;0;0;25849;448
2020-12-24;CM;Cameroon;428;0;26277;448
2020-12-25;CM;Cameroon;0;0;26277;448
2020-12-26;CM;Cameroon;0;0;26277;448
2020-12-27;CM;Cameroon;0;0;26277;448
2020-12-28;CM;Cameroon;0;0;26277;448
2020-12-29;CM;Cameroon;0;0;26277;448
2020-12-30;CM;Cameroon;0;0;26277;448
2020-12-31;CM;Cameroon;0;0;26277;448
2021-01-01;CM;Cameroon;571;0;26848;448
2021-01-02;CM;Cameroon;0;0;26848;448
2021-01-03;CM;Cameroon;0;0;26848;448
2021-01-04;CM;Cameroon;0;0;26848;448
2021-01-05;CM;Cameroon;0;0;26848;448
2021-01-06;CM;Cameroon;0;0;26848;448
2021-01-07;CM;Cameroon;0;0;26848;448
2021-01-08;CM;Cameroon;0;0;26848;448
2021-01-09;CM;Cameroon;0;0;26848;448
2021-01-10;CM;Cameroon;0;0;26848;448
2021-01-11;CM;Cameroon;0;0;26848;448
2021-01-12;CM;Cameroon;488;3;27336;451
2021-01-13;CM;Cameroon;0;0;27336;451
2021-01-14;CM;Cameroon;0;0;27336;451
2021-01-15;CM;Cameroon;0;0;27336;451
2021-01-16;CM;Cameroon;674;4;28010;455
2021-01-17;CM;Cameroon;0;0;28010;455
2021-01-18;CM;Cameroon;0;0;28010;455
2021-01-19;CM;Cameroon;0;0;28010;455
2021-01-20;CM;Cameroon;0;0;28010;455
2021-01-21;CM;Cameroon;0;0;28010;455
2021-01-22;CM;Cameroon;0;0;28010;455
2021-01-23;CM;Cameroon;1607;7;29617;462
2021-01-24;CM;Cameroon;0;0;29617;462
2021-01-25;CM;Cameroon;0;0;29617;462
2021-01-26;CM;Cameroon;0;0;29617;462
2021-01-27;CM;Cameroon;0;0;29617;462
2021-01-28;CM;Cameroon;0;0;29617;462
2021-01-29;CM;Cameroon;0;0;29617;462
2021-01-30;CM;Cameroon;0;0;29617;462
2021-01-31;CM;Cameroon;0;0;29617;462
2021-02-01;CM;Cameroon;0;0;29617;462
2021-02-02;CM;Cameroon;696;12;30313;474
2021-02-03;CM;Cameroon;0;0;30313;474
2021-02-04;CM;Cameroon;0;0;30313;474
2021-02-05;CM;Cameroon;0;0;30313;474
2021-02-06;CM;Cameroon;1081;0;31394;474
2021-02-07;CM;Cameroon;0;0;31394;474
2021-02-08;CM;Cameroon;0;0;31394;474
2021-02-09;CM;Cameroon;0;0;31394;474
2021-02-10;CM;Cameroon;0;0;31394;474
2021-02-11;CM;Cameroon;0;0;31394;474
2021-02-12;CM;Cameroon;704;5;32098;479
2021-02-13;CM;Cameroon;0;0;32098;479
2021-02-14;CM;Cameroon;0;0;32098;479
2021-02-15;CM;Cameroon;0;0;32098;479
2021-02-16;CM;Cameroon;0;0;32098;479
2021-02-17;CM;Cameroon;0;0;32098;479
2021-02-18;CM;Cameroon;1651;44;33749;523
2021-02-19;CM;Cameroon;0;0;33749;523
2021-02-20;CM;Cameroon;0;0;33749;523
2021-02-21;CM;Cameroon;0;0;33749;523
2021-02-22;CM;Cameroon;0;0;33749;523
2021-02-23;CM;Cameroon;0;0;33749;523
2021-02-24;CM;Cameroon;0;0;33749;523
2021-02-25;CM;Cameroon;1965;28;35714;551
2021-02-26;CM;Cameroon;0;0;35714;551
2021-02-27;CM;Cameroon;0;0;35714;551
2021-02-28;CM;Cameroon;0;0;35714;551
2021-03-01;CM;Cameroon;0;0;35714;551
2021-03-02;CM;Cameroon;0;0;35714;551
2021-03-03;CM;Cameroon;0;0;35714;551
2021-03-04;CM;Cameroon;0;0;35714;551
2021-03-05;CM;Cameroon;0;0;35714;551
2021-03-06;CM;Cameroon;0;0;35714;551
2021-03-07;CM;Cameroon;0;0;35714;551
2021-03-08;CM;Cameroon;1080;15;36794;566
2021-03-09;CM;Cameroon;0;0;36794;566
2021-03-10;CM;Cameroon;0;0;36794;566
2021-03-11;CM;Cameroon;3828;35;40622;601
2021-03-12;CM;Cameroon;0;0;40622;601
2021-03-13;CM;Cameroon;0;0;40622;601
2021-03-14;CM;Cameroon;0;0;40622;601
2021-03-15;CM;Cameroon;0;0;40622;601
2021-03-16;CM;Cameroon;0;0;40622;601
2021-03-17;CM;Cameroon;0;0;40622;601
2021-03-18;CM;Cameroon;0;0;40622;601
2021-03-19;CM;Cameroon;0;0;40622;601
2021-03-20;CM;Cameroon;0;0;40622;601
2021-03-21;CM;Cameroon;0;0;40622;601
2021-03-22;CM;Cameroon;0;0;40622;601
2021-03-23;CM;Cameroon;0;0;40622;601
2021-03-24;CM;Cameroon;0;0;40622;601
2021-03-25;CM;Cameroon;0;0;40622;601
2021-03-26;CM;Cameroon;7047;120;47669;721
2021-03-27;CM;Cameroon;0;0;47669;721
2021-03-28;CM;Cameroon;0;0;47669;721
2021-03-29;CM;Cameroon;0;0;47669;721
2021-03-30;CM;Cameroon;0;0;47669;721
2021-03-31;CM;Cameroon;0;0;47669;721
2021-04-01;CM;Cameroon;9668;130;57337;851
2021-04-02;CM;Cameroon;0;0;57337;851
2021-04-03;CM;Cameroon;0;0;57337;851
2021-04-04;CM;Cameroon;0;0;57337;851
2021-04-05;CM;Cameroon;0;0;57337;851
2021-04-06;CM;Cameroon;0;0;57337;851
2021-04-07;CM;Cameroon;0;0;57337;851
2021-04-08;CM;Cameroon;4394;68;61731;919
2021-04-09;CM;Cameroon;0;0;61731;919
2021-04-10;CM;Cameroon;0;0;61731;919
2021-04-11;CM;Cameroon;0;0;61731;919
2021-04-12;CM;Cameroon;0;0;61731;919
2021-04-13;CM;Cameroon;0;0;61731;919
2021-04-14;CM;Cameroon;0;0;61731;919
2021-04-15;CM;Cameroon;0;0;61731;919
2021-04-16;CM;Cameroon;0;0;61731;919
2021-04-17;CM;Cameroon;3078;20;64809;939
2021-04-18;CM;Cameroon;0;0;64809;939
2021-04-19;CM;Cameroon;0;0;64809;939
2021-04-20;CM;Cameroon;0;0;64809;939
2021-04-21;CM;Cameroon;0;0;64809;939
2021-04-22;CM;Cameroon;0;0;64809;939
2021-04-23;CM;Cameroon;1189;52;65998;991
2021-04-24;CM;Cameroon;0;0;65998;991
2021-04-25;CM;Cameroon;0;0;65998;991
2021-04-26;CM;Cameroon;0;0;65998;991
2021-04-27;CM;Cameroon;0;0;65998;991
2021-04-28;CM;Cameroon;0;0;65998;991
2021-04-29;CM;Cameroon;6252;116;72250;1107
2021-04-30;CM;Cameroon;0;0;72250;1107
2021-05-01;CM;Cameroon;0;0;72250;1107
2021-05-02;CM;Cameroon;0;0;72250;1107
2021-05-03;CM;Cameroon;0;0;72250;1107
2021-05-04;CM;Cameroon;0;0;72250;1107
2021-05-05;CM;Cameroon;0;0;72250;1107
2021-05-06;CM;Cameroon;2696;45;74946;1152
2021-05-07;CM;Cameroon;0;0;74946;1152
2021-05-08;CM;Cameroon;0;0;74946;1152
2021-05-09;CM;Cameroon;0;0;74946;1152
2021-05-10;CM;Cameroon;0;0;74946;1152
2021-05-11;CM;Cameroon;0;0;74946;1152
2021-05-12;CM;Cameroon;0;0;74946;1152
2021-05-13;CM;Cameroon;0;0;74946;1152
2021-05-14;CM;Cameroon;0;0;74946;1152
2021-05-15;CM;Cameroon;0;0;74946;1152
2021-05-16;CM;Cameroon;0;0;74946;1152
2021-05-17;CM;Cameroon;0;0;74946;1152
2021-05-18;CM;Cameroon;2483;37;77429;1189
2021-05-19;CM;Cameroon;0;0;77429;1189
2021-05-20;CM;Cameroon;0;0;77429;1189
2021-05-21;CM;Cameroon;304;50;77733;1239
2021-05-22;CM;Cameroon;0;0;77733;1239
2021-05-23;CM;Cameroon;0;0;77733;1239
2021-05-24;CM;Cameroon;0;0;77733;1239
2021-05-25;CM;Cameroon;0;0;77733;1239
2021-05-26;CM;Cameroon;249;31;77982;1270
2021-05-27;CM;Cameroon;0;0;77982;1270
2021-05-28;CM;Cameroon;0;0;77982;1270
2021-05-29;CM;Cameroon;947;5;78929;1275
2021-05-30;CM;Cameroon;0;0;78929;1275
2021-05-31;CM;Cameroon;0;0;78929;1275
2021-06-01;CM;Cameroon;0;0;78929;1275
2021-06-02;CM;Cameroon;0;0;78929;1275
2021-06-03;CM;Cameroon;0;0;78929;1275
2021-06-04;CM;Cameroon;0;0;78929;1275
2021-06-05;CM;Cameroon;0;0;78929;1275
2021-06-06;CM;Cameroon;0;0;78929;1275
2021-06-07;CM;Cameroon;0;0;78929;1275
2021-06-08;CM;Cameroon;975;27;79904;1302
2021-06-09;CM;Cameroon;0;0;79904;1302
2021-06-10;CM;Cameroon;0;0;79904;1302
2021-06-11;CM;Cameroon;186;8;80090;1310
2021-06-12;CM;Cameroon;0;0;80090;1310
2021-06-13;CM;Cameroon;0;0;80090;1310
2021-06-14;CM;Cameroon;0;0;80090;1310
2021-06-15;CM;Cameroon;0;0;80090;1310
2021-06-16;CM;Cameroon;238;3;80328;1313
2021-06-17;CM;Cameroon;0;0;80328;1313
2021-06-18;CM;Cameroon;0;0;80328;1313
2021-06-19;CM;Cameroon;0;0;80328;1313
2021-06-20;CM;Cameroon;0;0;80328;1313
2021-06-21;CM;Cameroon;0;0;80328;1313
2021-06-22;CM;Cameroon;159;7;80487;1320
2021-06-23;CM;Cameroon;0;0;80487;1320
2021-06-24;CM;Cameroon;0;0;80487;1320
2021-06-25;CM;Cameroon;0;0;80487;1320
2021-06-26;CM;Cameroon;0;0;80487;1320
2021-06-27;CM;Cameroon;0;0;80487;1320
2021-06-28;CM;Cameroon;0;0;80487;1320
2021-06-29;CM;Cameroon;371;4;80858;1324
2021-06-30;CM;Cameroon;0;0;80858;1324
2021-07-01;CM;Cameroon;0;0;80858;1324
2020-01-26;CA;Canada;1;0;1;0
2020-01-27;CA;Canada;0;0;1;0
2020-01-28;CA;Canada;1;0;2;0
2020-01-29;CA;Canada;0;0;2;0
2020-01-30;CA;Canada;0;0;2;0
2020-01-31;CA;Canada;2;0;4;0
2020-02-01;CA;Canada;0;0;4;0
2020-02-02;CA;Canada;0;0;4;0
2020-02-03;CA;Canada;0;0;4;0
2020-02-04;CA;Canada;0;0;4;0
2020-02-05;CA;Canada;1;0;5;0
2020-02-06;CA;Canada;0;0;5;0
2020-02-07;CA;Canada;2;0;7;0
2020-02-08;CA;Canada;0;0;7;0
2020-02-09;CA;Canada;0;0;7;0
2020-02-10;CA;Canada;0;0;7;0
2020-02-11;CA;Canada;0;0;7;0
2020-02-12;CA;Canada;0;0;7;0
2020-02-13;CA;Canada;0;0;7;0
2020-02-14;CA;Canada;0;0;7;0
2020-02-15;CA;Canada;0;0;7;0
2020-02-16;CA;Canada;0;0;7;0
2020-02-17;CA;Canada;1;0;8;0
2020-02-18;CA;Canada;0;0;8;0
2020-02-19;CA;Canada;0;0;8;0
2020-02-20;CA;Canada;0;0;8;0
2020-02-21;CA;Canada;1;0;9;0
2020-02-22;CA;Canada;0;0;9;0
2020-02-23;CA;Canada;0;0;9;0
2020-02-24;CA;Canada;1;0;10;0
2020-02-25;CA;Canada;1;0;11;0
2020-02-26;CA;Canada;0;0;11;0
2020-02-27;CA;Canada;2;0;13;0
2020-02-28;CA;Canada;1;0;14;0
2020-02-29;CA;Canada;6;0;20;0
2020-03-01;CA;Canada;4;0;24;0
2020-03-02;CA;Canada;3;0;27;0
2020-03-03;CA;Canada;3;0;30;0
2020-03-04;CA;Canada;3;0;33;0
2020-03-05;CA;Canada;4;0;37;0
2020-03-06;CA;Canada;12;0;49;0
2020-03-07;CA;Canada;5;0;54;0
2020-03-08;CA;Canada;10;0;64;0
2020-03-09;CA;Canada;13;1;77;1
2020-03-10;CA;Canada;2;0;79;1
2020-03-11;CA;Canada;29;0;108;1
2020-03-12;CA;Canada;9;0;117;1
2020-03-13;CA;Canada;76;0;193;1
2020-03-14;CA;Canada;5;0;198;1
2020-03-15;CA;Canada;54;0;252;1
2020-03-16;CA;Canada;163;3;415;4
2020-03-17;CA;Canada;63;2;478;6
2020-03-18;CA;Canada;179;5;657;11
2020-03-19;CA;Canada;143;0;800;11
2020-03-20;CA;Canada;143;4;943;15
2020-03-21;CA;Canada;334;4;1277;19
2020-03-22;CA;Canada;192;3;1469;22
2020-03-23;CA;Canada;619;7;2088;29
2020-03-24;CA;Canada;702;4;2790;33
2020-03-25;CA;Canada;461;9;3251;42
2020-03-26;CA;Canada;791;15;4042;57
2020-03-27;CA;Canada;640;9;4682;66
2020-03-28;CA;Canada;894;16;5576;82
2020-03-29;CA;Canada;704;14;6280;96
2020-03-30;CA;Canada;1118;29;7398;125
2020-03-31;CA;Canada;1129;27;8527;152
2020-04-01;CA;Canada;1033;23;9560;175
2020-04-02;CA;Canada;1724;49;11284;224
2020-04-03;CA;Canada;1153;53;12437;277
2020-04-04;CA;Canada;541;83;12978;360
2020-04-05;CA;Canada;2778;75;15756;435
2020-04-06;CA;Canada;807;85;16563;520
2020-04-07;CA;Canada;1309;61;17872;581
2020-04-08;CA;Canada;1269;67;19141;648
2020-04-09;CA;Canada;1513;123;20654;771
2020-04-10;CA;Canada;1405;96;22059;867
2020-04-11;CA;Canada;1257;119;23316;986
2020-04-12;CA;Canada;983;109;24299;1095
2020-04-13;CA;Canada;1381;130;25680;1225
2020-04-14;CA;Canada;1355;136;27035;1361
2020-04-15;CA;Canada;1174;154;28209;1515
2020-04-16;CA;Canada;2600;203;30809;1718
2020-04-17;CA;Canada;2005;126;32814;1844
2020-04-18;CA;Canada;1542;143;34356;1987
2020-04-19;CA;Canada;1277;158;35633;2145
2020-04-20;CA;Canada;2025;146;37658;2291
2020-04-21;CA;Canada;1744;193;39402;2484
2020-04-22;CA;Canada;2261;195;41663;2679
2020-04-23;CA;Canada;1636;171;43299;2850
2020-04-24;CA;Canada;1620;180;44919;3030
2020-04-25;CA;Canada;1452;187;46371;3217
2020-04-26;CA;Canada;1662;157;48033;3374
2020-04-27;CA;Canada;1583;185;49616;3559
2020-04-28;CA;Canada;1534;197;51150;3756
2020-04-29;CA;Canada;1715;244;52865;4000
2020-04-30;CA;Canada;1592;179;54457;4179
2020-05-01;CA;Canada;1886;202;56343;4381
2020-05-02;CA;Canada;1583;148;57926;4529
2020-05-03;CA;Canada;2578;140;60504;4669
2020-05-04;CA;Canada;1453;242;61957;4911
2020-05-05;CA;Canada;1258;170;63215;5081
2020-05-06;CA;Canada;1479;159;64694;5240
2020-05-07;CA;Canada;1507;147;66201;5387
2020-05-08;CA;Canada;1473;153;67674;5540
2020-05-09;CA;Canada;1244;164;68918;5704
2020-05-10;CA;Canada;1173;118;70091;5822
2020-05-11;CA;Canada;1173;134;71264;5956
2020-05-12;CA;Canada;1155;151;72419;6107
2020-05-13;CA;Canada;1149;103;73568;6210
2020-05-14;CA;Canada;1213;121;74781;6331
2020-05-15;CA;Canada;1178;121;75959;6452
2020-05-16;CA;Canada;1247;119;77206;6571
2020-05-17;CA;Canada;1126;90;78332;6661
2020-05-18;CA;Canada;1079;92;79411;6753
2020-05-19;CA;Canada;1082;75;80493;6828
2020-05-20;CA;Canada;1082;122;81575;6950
2020-05-21;CA;Canada;1167;96;82742;7046
2020-05-22;CA;Canada;1205;98;83947;7144
2020-05-23;CA;Canada;1204;94;85151;7238
2020-05-24;CA;Canada;955;88;86106;7326
2020-05-25;CA;Canada;1013;94;87119;7420
2020-05-26;CA;Canada;971;92;88090;7512
2020-05-27;CA;Canada;899;94;88989;7606
2020-05-28;CA;Canada;987;111;89976;7717
2020-05-29;CA;Canada;933;80;90909;7797
2020-05-30;CA;Canada;772;60;91681;7857
2020-05-31;CA;Canada;798;49;92479;7906
2020-06-01;CA;Canada;809;46;93288;7952
2020-06-02;CA;Canada;672;56;93960;8008
2020-06-03;CA;Canada;681;54;94641;8062
2020-06-04;CA;Canada;628;64;95269;8126
2020-06-05;CA;Canada;678;40;95947;8166
2020-06-06;CA;Canada;528;62;96475;8228
2020-06-07;CA;Canada;703;41;97178;8269
2020-06-08;CA;Canada;601;44;97779;8313
2020-06-09;CA;Canada;462;34;98241;8347
2020-06-10;CA;Canada;479;35;98720;8382
2020-06-11;CA;Canada;439;31;99159;8413
2020-06-12;CA;Canada;436;29;99595;8442
2020-06-13;CA;Canada;448;28;100043;8470
2020-06-14;CA;Canada;361;19;100404;8489
2020-06-15;CA;Canada;359;8;100763;8497
2020-06-16;CA;Canada;324;24;101087;8521
2020-06-17;CA;Canada;404;21;101491;8542
2020-06-18;CA;Canada;386;13;101877;8555
2020-06-19;CA;Canada;437;25;102314;8580
2020-06-20;CA;Canada;448;29;102762;8609
2020-06-21;CA;Canada;316;17;103078;8626
2020-06-22;CA;Canada;340;20;103418;8646
2020-06-23;CA;Canada;349;24;103767;8670
2020-06-24;CA;Canada;320;30;104087;8700
2020-06-25;CA;Canada;376;23;104463;8723
2020-06-26;CA;Canada;166;7;104629;8730
2020-06-27;CA;Canada;249;9;104878;8739
2020-06-28;CA;Canada;315;10;105193;8749
2020-06-29;CA;Canada;637;19;105830;8768
2020-06-30;CA;Canada;267;12;106097;8780
2020-07-01;CA;Canada;191;10;106288;8790
2020-07-02;CA;Canada;355;16;106643;8806
2020-07-03;CA;Canada;319;7;106962;8813
2020-07-04;CA;Canada;223;8;107185;8821
2020-07-05;CA;Canada;209;2;107394;8823
2020-07-06;CA;Canada;421;13;107815;8836
2020-07-07;CA;Canada;208;7;108023;8843
2020-07-08;CA;Canada;311;12;108334;8855
2020-07-09;CA;Canada;322;10;108656;8865
2020-07-10;CA;Canada;328;14;108984;8879
2020-07-11;CA;Canada;166;3;109150;8882
2020-07-12;CA;Canada;198;5;109348;8887
2020-07-13;CA;Canada;636;8;109984;8895
2020-07-14;CA;Canada;366;5;110350;8900
2020-07-15;CA;Canada;343;14;110693;8914
2020-07-16;CA;Canada;451;12;111144;8926
2020-07-17;CA;Canada;415;10;111559;8936
2020-07-18;CA;Canada;316;3;111875;8939
2020-07-19;CA;Canada;293;4;112168;8943
2020-07-20;CA;Canada;770;4;112938;8947
2020-07-21;CA;Canada;535;7;113473;8954
2020-07-22;CA;Canada;317;4;113790;8958
2020-07-23;CA;Canada;608;8;114398;8966
2020-07-24;CA;Canada;717;4;115115;8970
2020-07-25;CA;Canada;355;4;115470;8974
2020-07-26;CA;Canada;319;4;115789;8978
2020-07-27;CA;Canada;682;13;116471;8991
2020-07-28;CA;Canada;400;10;116871;9001
2020-07-29;CA;Canada;486;5;117357;9006
2020-07-30;CA;Canada;320;13;117677;9019
2020-07-31;CA;Canada;604;6;118281;9025
2020-08-01;CA;Canada;242;4;118523;9029
2020-08-02;CA;Canada;245;3;118768;9032
2020-08-03;CA;Canada;205;3;118973;9035
2020-08-04;CA;Canada;686;8;119659;9043
2020-08-05;CA;Canada;374;6;120033;9049
2020-08-06;CA;Canada;354;6;120387;9055
2020-08-07;CA;Canada;516;5;120903;9060
2020-08-08;CA;Canada;245;4;121148;9064
2020-08-09;CA;Canada;219;3;121367;9067
2020-08-10;CA;Canada;686;7;122053;9074
2020-08-11;CA;Canada;336;6;122389;9080
2020-08-12;CA;Canada;314;5;122703;9085
2020-08-13;CA;Canada;477;6;123180;9091
2020-08-14;CA;Canada;425;4;123605;9095
2020-08-15;CA;Canada;220;6;123825;9101
2020-08-16;CA;Canada;179;5;124004;9106
2020-08-17;CA;Canada;214;2;124218;9108
2020-08-18;CA;Canada;866;10;125084;9118
2020-08-19;CA;Canada;324;6;125408;9124
2020-08-20;CA;Canada;217;3;125625;9127
2020-08-21;CA;Canada;694;14;126319;9141
2020-08-22;CA;Canada;241;1;126560;9142
2020-08-23;CA;Canada;257;4;126817;9146
2020-08-24;CA;Canada;777;8;127594;9154
2020-08-25;CA;Canada;309;5;127903;9159
2020-08-26;CA;Canada;477;5;128380;9164
2020-08-27;CA;Canada;456;4;128836;9168
2020-08-28;CA;Canada;506;13;129342;9181
2020-08-29;CA;Canada;297;3;129639;9184
2020-08-30;CA;Canada;249;1;129888;9185
2020-08-31;CA;Canada;1030;8;130918;9193
2020-09-01;CA;Canada;504;4;131422;9197
2020-09-02;CA;Canada;519;2;131941;9199
2020-09-03;CA;Canada;586;6;132527;9205
2020-09-04;CA;Canada;614;1;133141;9206
2020-09-05;CA;Canada;370;1;133511;9207
2020-09-06;CA;Canada;379;2;133890;9209
2020-09-07;CA;Canada;405;3;134295;9212
2020-09-08;CA;Canada;1462;7;135757;9219
2020-09-09;CA;Canada;378;4;136135;9223
2020-09-10;CA;Canada;821;8;136956;9231
2020-09-11;CA;Canada;720;0;137676;9231
2020-09-12;CA;Canada;488;2;138164;9233
2020-09-13;CA;Canada;476;3;138640;9236
2020-09-14;CA;Canada;1458;13;140098;9249
2020-09-15;CA;Canada;802;8;140900;9257
2020-09-16;CA;Canada;952;5;141852;9262
2020-09-17;CA;Canada;1027;5;142879;9267
2020-09-18;CA;Canada;1174;12;144053;9279
2020-09-19;CA;Canada;554;7;144607;9286
2020-09-20;CA;Canada;1143;2;145750;9288
2020-09-21;CA;Canada;1833;12;147583;9300
2020-09-22;CA;Canada;1272;9;148855;9309
2020-09-23;CA;Canada;1084;8;149939;9317
2020-09-24;CA;Canada;1148;8;151087;9325
2020-09-25;CA;Canada;1630;7;152717;9332
2020-09-26;CA;Canada;1053;6;153770;9338
2020-09-27;CA;Canada;1658;5;155428;9343
2020-09-28;CA;Canada;1791;17;157219;9360
2020-09-29;CA;Canada;1772;13;158991;9373
2020-09-30;CA;Canada;2116;18;161107;9391
2020-10-01;CA;Canada;1823;16;162930;9407
2020-10-02;CA;Canada;2124;98;165054;9505
2020-10-03;CA;Canada;1306;21;166360;9526
2020-10-04;CA;Canada;2141;44;168501;9570
2020-10-05;CA;Canada;2883;29;171384;9599
2020-10-06;CA;Canada;2372;18;173756;9617
2020-10-07;CA;Canada;1624;19;175380;9636
2020-10-08;CA;Canada;2350;18;177730;9654
2020-10-09;CA;Canada;2895;14;180625;9668
2020-10-10;CA;Canada;2142;26;182767;9694
2020-10-11;CA;Canada;1636;14;184403;9708
2020-10-12;CA;Canada;975;12;185378;9720
2020-10-13;CA;Canada;4111;32;189489;9752
2020-10-14;CA;Canada;2575;25;192064;9777
2020-10-15;CA;Canada;2298;19;194362;9796
2020-10-16;CA;Canada;2566;32;196928;9828
2020-10-17;CA;Canada;139;8;197067;9836
2020-10-18;CA;Canada;3737;24;200804;9860
2020-10-19;CA;Canada;3307;31;204111;9891
2020-10-20;CA;Canada;2238;18;206349;9909
2020-10-21;CA;Canada;2687;37;209036;9946
2020-10-22;CA;Canada;2581;31;211617;9977
2020-10-23;CA;Canada;2902;27;214519;10004
2020-10-24;CA;Canada;1532;22;216051;10026
2020-10-25;CA;Canada;2823;31;218874;10057
2020-10-26;CA;Canada;4099;38;222973;10095
2020-10-27;CA;Canada;2730;25;225703;10120
2020-10-28;CA;Canada;2663;38;228366;10158
2020-10-29;CA;Canada;3017;34;231383;10192
2020-10-30;CA;Canada;3556;45;234939;10237
2020-10-31;CA;Canada;2374;39;237313;10276
2020-11-01;CA;Canada;2336;37;239649;10313
2020-11-02;CA;Canada;3529;32;243178;10345
2020-11-03;CA;Canada;4738;58;247916;10403
2020-11-04;CA;Canada;2782;41;250698;10444
2020-11-05;CA;Canada;2784;40;253482;10484
2020-11-06;CA;Canada;5393;62;258875;10546
2020-11-07;CA;Canada;4346;47;263221;10593
2020-11-08;CA;Canada;3944;48;267165;10641
2020-11-09;CA;Canada;4871;61;272036;10702
2020-11-10;CA;Canada;4445;67;276481;10769
2020-11-11;CA;Canada;3984;63;280465;10832
2020-11-12;CA;Canada;5474;73;285939;10905
2020-11-13;CA;Canada;4770;46;290709;10951
2020-11-14;CA;Canada;4430;62;295139;11013
2020-11-15;CA;Canada;4301;65;299440;11078
2020-11-16;CA;Canada;6033;74;305473;11152
2020-11-17;CA;Canada;4462;68;309935;11220
2020-11-18;CA;Canada;4518;104;314453;11324
2020-11-19;CA;Canada;4794;70;319247;11394
2020-11-20;CA;Canada;4987;67;324234;11461
2020-11-21;CA;Canada;4957;66;329191;11527
2020-11-22;CA;Canada;4745;56;333936;11583
2020-11-23;CA;Canada;6795;79;340731;11662
2020-11-24;CA;Canada;5282;100;346013;11762
2020-11-25;CA;Canada;4958;58;350971;11820
2020-11-26;CA;Canada;5679;82;356650;11902
2020-11-27;CA;Canada;5954;86;362604;11988
2020-11-28;CA;Canada;5675;68;368279;12056
2020-11-29;CA;Canada;5383;74;373662;12130
2020-11-30;CA;Canada;7895;109;381557;12239
2020-12-01;CA;Canada;5495;78;387052;12317
2020-12-02;CA;Canada;6454;106;393506;12423
2020-12-03;CA;Canada;6264;90;399770;12513
2020-12-04;CA;Canada;6419;103;406189;12616
2020-12-05;CA;Canada;6354;74;412543;12690
2020-12-06;CA;Canada;6305;85;418848;12775
2020-12-07;CA;Canada;7724;121;426572;12896
2020-12-08;CA;Canada;6171;97;432743;12993
2020-12-09;CA;Canada;6399;116;439142;13109
2020-12-10;CA;Canada;6686;118;445828;13227
2020-12-11;CA;Canada;6715;128;452543;13355
2020-12-12;CA;Canada;5984;98;458527;13453
2020-12-13;CA;Canada;5916;84;464443;13537
2020-12-14;CA;Canada;8377;140;472820;13677
2020-12-15;CA;Canada;6244;116;479064;13793
2020-12-16;CA;Canada;6512;118;485576;13911
2020-12-17;CA;Canada;7006;156;492582;14067
2020-12-18;CA;Canada;6700;113;499282;14180
2020-12-19;CA;Canada;6459;104;505741;14284
2020-12-20;CA;Canada;6007;90;511748;14374
2020-12-21;CA;Canada;7577;107;519325;14481
2020-12-22;CA;Canada;6260;126;525585;14607
2020-12-23;CA;Canada;6921;145;532506;14752
2020-12-24;CA;Canada;6684;150;539190;14902
2020-12-25;CA;Canada;1749;64;540939;14966
2020-12-26;CA;Canada;3114;85;544053;15051
2020-12-27;CA;Canada;10100;120;554153;15171
2020-12-28;CA;Canada;6465;157;560618;15328
2020-12-29;CA;Canada;8189;200;568807;15528
2020-12-30;CA;Canada;8459;122;577266;15650
2020-12-31;CA;Canada;7143;112;584409;15762
2021-01-01;CA;Canada;991;44;585400;15806
2021-01-02;CA;Canada;4535;108;589935;15914
2021-01-03;CA;Canada;16141;92;606076;16006
2021-01-04;CA;Canada;10058;241;616134;16247
2021-01-05;CA;Canada;7250;142;623384;16389
2021-01-06;CA;Canada;8082;150;631466;16539
2021-01-07;CA;Canada;8227;165;639693;16704
2021-01-08;CA;Canada;9237;142;648930;16846
2021-01-09;CA;Canada;8393;138;657323;16984
2021-01-10;CA;Canada;7283;90;664606;17074
2021-01-11;CA;Canada;8325;125;672931;17199
2021-01-12;CA;Canada;6141;160;679072;17359
2021-01-13;CA;Canada;7139;180;686211;17539
2021-01-14;CA;Canada;7447;147;693658;17686
2021-01-15;CA;Canada;6880;170;700538;17856
2021-01-16;CA;Canada;6359;122;706897;17978
2021-01-17;CA;Canada;6284;128;713181;18106
2021-01-18;CA;Canada;6420;125;719601;18231
2021-01-19;CA;Canada;5028;151;724629;18382
2021-01-20;CA;Canada;5701;185;730330;18567
2021-01-21;CA;Canada;6111;139;736441;18706
2021-01-22;CA;Canada;5827;181;742268;18887
2021-01-23;CA;Canada;5094;105;747362;18992
2021-01-24;CA;Canada;4679;127;752041;19119
2021-01-25;CA;Canada;5617;126;757658;19245
2021-01-26;CA;Canada;4041;147;761699;19392
2021-01-27;CA;Canada;4320;93;766019;19485
2021-01-28;CA;Canada;4806;191;770825;19676
2021-01-29;CA;Canada;4827;149;775652;19825
2021-01-30;CA;Canada;4110;133;779762;19958
2021-01-31;CA;Canada;3933;83;783695;20041
2021-02-01;CA;Canada;4502;104;788197;20145
2021-02-02;CA;Canada;2948;97;791145;20242
2021-02-03;CA;Canada;3267;119;794412;20361
2021-02-04;CA;Canada;3982;125;798394;20486
2021-02-05;CA;Canada;4136;121;802530;20607
2021-02-06;CA;Canada;3264;93;805794;20700
2021-02-07;CA;Canada;3207;60;809001;20760
2021-02-08;CA;Canada;3803;70;812804;20830
2021-02-09;CA;Canada;2683;84;815487;20914
2021-02-10;CA;Canada;3268;93;818755;21007
2021-02-11;CA;Canada;3177;82;821932;21089
2021-02-12;CA;Canada;2679;79;824611;21168
2021-02-13;CA;Canada;3797;70;828408;21238
2021-02-14;CA;Canada;2204;23;830612;21261
2021-02-15;CA;Canada;1763;37;832375;21298
2021-02-16;CA;Canada;4219;97;836594;21395
2021-02-17;CA;Canada;2561;44;839155;21439
2021-02-18;CA;Canada;3435;70;842590;21509
2021-02-19;CA;Canada;3083;72;845673;21581
2021-02-20;CA;Canada;2657;50;848330;21631
2021-02-21;CA;Canada;2407;44;850737;21675
2021-02-22;CA;Canada;3453;45;854190;21720
2021-02-23;CA;Canada;3213;41;857403;21761
2021-02-24;CA;Canada;2945;49;860348;21810
2021-02-25;CA;Canada;3147;58;863495;21868
2021-02-26;CA;Canada;3172;47;866667;21915
2021-02-27;CA;Canada;2680;46;869347;21961
2021-02-28;CA;Canada;2347;29;871694;21990
2021-03-01;CA;Canada;3694;24;875388;22014
2021-03-02;CA;Canada;2663;29;878051;22043
2021-03-03;CA;Canada;2784;62;880835;22105
2021-03-04;CA;Canada;2980;47;883815;22152
2021-03-05;CA;Canada;2967;31;886782;22183
2021-03-06;CA;Canada;2769;29;889551;22212
2021-03-07;CA;Canada;2648;22;892199;22234
2021-03-08;CA;Canada;4048;37;896247;22271
2021-03-09;CA;Canada;2928;31;899175;22302
2021-03-10;CA;Canada;3059;28;902234;22330
2021-03-11;CA;Canada;3105;37;905339;22367
2021-03-12;CA;Canada;3515;30;908854;22397
2021-03-13;CA;Canada;3030;29;911884;22426
2021-03-14;CA;Canada;2711;29;914595;22455
2021-03-15;CA;Canada;3811;29;918406;22484
2021-03-16;CA;Canada;2857;25;921263;22509
2021-03-17;CA;Canada;3407;34;924670;22543
2021-03-18;CA;Canada;3613;34;928283;22577
2021-03-19;CA;Canada;4232;28;932515;22605
2021-03-20;CA;Canada;3417;30;935932;22635
2021-03-21;CA;Canada;3125;21;939057;22656
2021-03-22;CA;Canada;4863;39;943920;22695
2021-03-23;CA;Canada;3569;20;947489;22715
2021-03-24;CA;Canada;3949;24;951438;22739
2021-03-25;CA;Canada;5104;32;956542;22771
2021-03-26;CA;Canada;5025;38;961567;22809
2021-03-27;CA;Canada;4315;21;965882;22830
2021-03-28;CA;Canada;4183;25;970065;22855
2021-03-29;CA;Canada;6262;16;976327;22871
2021-03-30;CA;Canada;3753;21;980080;22892
2021-03-31;CA;Canada;8728;68;988808;22960
2021-04-01;CA;Canada;5741;38;994549;22998
2021-04-02;CA;Canada;3659;13;998208;23011
2021-04-03;CA;Canada;7088;27;1005296;23038
2021-04-04;CA;Canada;3512;22;1008808;23060
2021-04-05;CA;Canada;8322;23;1017130;23083
2021-04-06;CA;Canada;10724;49;1027854;23132
2021-04-07;CA;Canada;7388;28;1035242;23160
2021-04-08;CA;Canada;8236;36;1043478;23196
2021-04-09;CA;Canada;9082;40;1052560;23236
2021-04-10;CA;Canada;7492;34;1060052;23270
2021-04-11;CA;Canada;7712;24;1067764;23294
2021-04-12;CA;Canada;10718;42;1078482;23336
2021-04-13;CA;Canada;7423;34;1085905;23370
2021-04-14;CA;Canada;8994;58;1094899;23428
2021-04-15;CA;Canada;9609;54;1104508;23482
2021-04-16;CA;Canada;9329;49;1113837;23531
2021-04-17;CA;Canada;7325;41;1121162;23572
2021-04-18;CA;Canada;8209;39;1129371;23611
2021-04-19;CA;Canada;10220;38;1139591;23649
2021-04-20;CA;Canada;7226;49;1146817;23698
2021-04-21;CA;Canada;8236;63;1155053;23761
2021-04-22;CA;Canada;9055;49;1164108;23810
2021-04-23;CA;Canada;8589;60;1172697;23870
2021-04-24;CA;Canada;7368;42;1180065;23912
2021-04-25;CA;Canada;6926;38;1186991;23950
2021-04-26;CA;Canada;8836;61;1195827;24011
2021-04-27;CA;Canada;6845;37;1202672;24048
2021-04-28;CA;Canada;8246;62;1210918;24110
2021-04-29;CA;Canada;9190;55;1220108;24165
2021-04-30;CA;Canada;8259;55;1228367;24220
2021-05-01;CA;Canada;6545;25;1234912;24245
2021-05-02;CA;Canada;5966;24;1240878;24269
2021-05-03;CA;Canada;10933;65;1251811;24334
2021-05-04;CA;Canada;6638;66;1258449;24400
2021-05-05;CA;Canada;7800;37;1266249;24437
2021-05-06;CA;Canada;7957;42;1274206;24479
2021-05-07;CA;Canada;7640;44;1281846;24523
2021-05-08;CA;Canada;6086;31;1287932;24554
2021-05-09;CA;Canada;5693;23;1293625;24577
2021-05-10;CA;Canada;8864;83;1302489;24660
2021-05-11;CA;Canada;5374;33;1307863;24693
2021-05-12;CA;Canada;6557;62;1314420;24755
2021-05-13;CA;Canada;5786;47;1320206;24802
2021-05-14;CA;Canada;6783;55;1326989;24857
2021-05-15;CA;Canada;4491;27;1331480;24884
2021-05-16;CA;Canada;4302;20;1335782;24904
2021-05-17;CA;Canada;6424;60;1342206;24964
2021-05-18;CA;Canada;3877;35;1346083;24999
2021-05-19;CA;Canada;4814;51;1350897;25050
2021-05-20;CA;Canada;4836;43;1355733;25093
2021-05-21;CA;Canada;4531;55;1360264;25148
2021-05-22;CA;Canada;3255;32;1363519;25180
2021-05-23;CA;Canada;2956;26;1366475;25206
2021-05-24;CA;Canada;1766;25;1368241;25231
2021-05-25;CA;Canada;3700;38;1371941;25269
2021-05-26;CA;Canada;2331;34;1374272;25303
2021-05-27;CA;Canada;4721;90;1378993;25393
2021-05-28;CA;Canada;3114;31;1382107;25424
2021-05-29;CA;Canada;2266;27;1384373;25451
2021-05-30;CA;Canada;1985;22;1386358;25473
2021-05-31;CA;Canada;2970;55;1389328;25528
2021-06-01;CA;Canada;1651;18;1390979;25546
2021-06-02;CA;Canada;2184;44;1393163;25590
2021-06-03;CA;Canada;2173;37;1395336;25627
2021-06-04;CA;Canada;2034;41;1397370;25668
2021-06-05;CA;Canada;1349;18;1398719;25686
2021-06-06;CA;Canada;1374;8;1400093;25694
2021-06-07;CA;Canada;1819;47;1401912;25741
2021-06-08;CA;Canada;1071;33;1402983;25774
2021-06-09;CA;Canada;1460;42;1404443;25816
2021-06-10;CA;Canada;1463;33;1405906;25849
2021-06-11;CA;Canada;1398;14;1407304;25863
2021-06-12;CA;Canada;1186;20;1408490;25883
2021-06-13;CA;Canada;1006;12;1409496;25895
2021-06-14;CA;Canada;1332;26;1410828;25921
2021-06-15;CA;Canada;824;22;1411652;25943
2021-06-16;CA;Canada;1085;49;1412737;25992
2021-06-17;CA;Canada;1103;12;1413840;26004
2021-06-18;CA;Canada;965;12;1414805;26016
2021-06-19;CA;Canada;809;26;1415614;26042
2021-06-20;CA;Canada;589;13;1416203;26055
2021-06-21;CA;Canada;1033;48;1417236;26103
2021-06-22;CA;Canada;466;18;1417702;26121
2021-06-23;CA;Canada;765;23;1418467;26144
2021-06-24;CA;Canada;731;18;1419198;26162
2021-06-25;CA;Canada;606;12;1419804;26174
2021-06-26;CA;Canada;454;10;1420258;26184
2021-06-27;CA;Canada;349;3;1420607;26187
2021-06-28;CA;Canada;1088;28;1421695;26215
2021-06-29;CA;Canada;531;31;1422226;26246
2021-06-30;CA;Canada;604;27;1422830;26273
2021-07-01;CA;Canada;72;0;1422902;26273
2020-03-20;CV;Cape Verde;1;0;1;0
2020-03-21;CV;Cape Verde;2;0;3;0
2020-03-22;CV;Cape Verde;0;0;3;0
2020-03-23;CV;Cape Verde;0;0;3;0
2020-03-24;CV;Cape Verde;0;1;3;1
2020-03-25;CV;Cape Verde;1;0;4;1
2020-03-26;CV;Cape Verde;0;0;4;1
2020-03-27;CV;Cape Verde;1;0;5;1
2020-03-28;CV;Cape Verde;0;0;5;1
2020-03-29;CV;Cape Verde;1;0;6;1
2020-03-30;CV;Cape Verde;0;0;6;1
2020-03-31;CV;Cape Verde;0;0;6;1
2020-04-01;CV;Cape Verde;0;0;6;1
2020-04-02;CV;Cape Verde;0;0;6;1
2020-04-03;CV;Cape Verde;0;0;6;1
2020-04-04;CV;Cape Verde;1;0;7;1
2020-04-05;CV;Cape Verde;0;0;7;1
2020-04-06;CV;Cape Verde;0;0;7;1
2020-04-07;CV;Cape Verde;0;0;7;1
2020-04-08;CV;Cape Verde;0;0;7;1
2020-04-09;CV;Cape Verde;0;0;7;1
2020-04-10;CV;Cape Verde;0;0;7;1
2020-04-11;CV;Cape Verde;1;0;8;1
2020-04-12;CV;Cape Verde;0;0;8;1
2020-04-13;CV;Cape Verde;2;0;10;1
2020-04-14;CV;Cape Verde;1;0;11;1
2020-04-15;CV;Cape Verde;45;0;56;1
2020-04-16;CV;Cape Verde;0;0;56;1
2020-04-17;CV;Cape Verde;0;0;56;1
2020-04-18;CV;Cape Verde;2;0;58;1
2020-04-19;CV;Cape Verde;3;0;61;1
2020-04-20;CV;Cape Verde;6;0;67;1
2020-04-21;CV;Cape Verde;1;0;68;1
2020-04-22;CV;Cape Verde;5;0;73;1
2020-04-23;CV;Cape Verde;9;0;82;1
2020-04-24;CV;Cape Verde;6;0;88;1
2020-04-25;CV;Cape Verde;2;0;90;1
2020-04-26;CV;Cape Verde;16;0;106;1
2020-04-27;CV;Cape Verde;3;0;109;1
2020-04-28;CV;Cape Verde;5;0;114;1
2020-04-29;CV;Cape Verde;0;0;114;1
2020-04-30;CV;Cape Verde;7;0;121;1
2020-05-01;CV;Cape Verde;1;0;122;1
2020-05-02;CV;Cape Verde;30;1;152;2
2020-05-03;CV;Cape Verde;13;0;165;2
2020-05-04;CV;Cape Verde;10;0;175;2
2020-05-05;CV;Cape Verde;11;0;186;2
2020-05-06;CV;Cape Verde;5;0;191;2
2020-05-07;CV;Cape Verde;27;0;218;2
2020-05-08;CV;Cape Verde;12;0;230;2
2020-05-09;CV;Cape Verde;6;0;236;2
2020-05-10;CV;Cape Verde;10;0;246;2
2020-05-11;CV;Cape Verde;14;0;260;2
2020-05-12;CV;Cape Verde;7;0;267;2
2020-05-13;CV;Cape Verde;22;0;289;2
2020-05-14;CV;Cape Verde;26;0;315;2
2020-05-15;CV;Cape Verde;11;0;326;2
2020-05-16;CV;Cape Verde;2;1;328;3
2020-05-17;CV;Cape Verde;0;0;328;3
2020-05-18;CV;Cape Verde;0;0;328;3
2020-05-19;CV;Cape Verde;7;0;335;3
2020-05-20;CV;Cape Verde;14;0;349;3
2020-05-21;CV;Cape Verde;7;0;356;3
2020-05-22;CV;Cape Verde;6;0;362;3
2020-05-23;CV;Cape Verde;9;0;371;3
2020-05-24;CV;Cape Verde;9;0;380;3
2020-05-25;CV;Cape Verde;10;0;390;3
2020-05-26;CV;Cape Verde;0;1;390;4
2020-05-27;CV;Cape Verde;0;0;390;4
2020-05-28;CV;Cape Verde;0;0;390;4
2020-05-29;CV;Cape Verde;15;0;405;4
2020-05-30;CV;Cape Verde;16;0;421;4
2020-05-31;CV;Cape Verde;14;0;435;4
2020-06-01;CV;Cape Verde;23;0;458;4
2020-06-02;CV;Cape Verde;8;1;466;5
2020-06-03;CV;Cape Verde;11;0;477;5
2020-06-04;CV;Cape Verde;25;0;502;5
2020-06-05;CV;Cape Verde;34;0;536;5
2020-06-06;CV;Cape Verde;6;0;542;5
2020-06-07;CV;Cape Verde;12;0;554;5
2020-06-08;CV;Cape Verde;13;0;567;5
2020-06-09;CV;Cape Verde;18;0;585;5
2020-06-10;CV;Cape Verde;30;0;615;5
2020-06-11;CV;Cape Verde;42;1;657;6
2020-06-12;CV;Cape Verde;40;0;697;6
2020-06-13;CV;Cape Verde;29;0;726;6
2020-06-14;CV;Cape Verde;24;0;750;6
2020-06-15;CV;Cape Verde;10;1;760;7
2020-06-16;CV;Cape Verde;21;0;781;7
2020-06-17;CV;Cape Verde;11;0;792;7
2020-06-18;CV;Cape Verde;31;0;823;7
2020-06-19;CV;Cape Verde;25;1;848;8
2020-06-20;CV;Cape Verde;15;0;863;8
2020-06-21;CV;Cape Verde;27;0;890;8
2020-06-22;CV;Cape Verde;54;0;944;8
2020-06-23;CV;Cape Verde;38;0;982;8
2020-06-24;CV;Cape Verde;17;0;999;8
2020-06-25;CV;Cape Verde;4;0;1003;8
2020-06-26;CV;Cape Verde;24;2;1027;10
2020-06-27;CV;Cape Verde;64;2;1091;12
2020-06-28;CV;Cape Verde;64;0;1155;12
2020-06-29;CV;Cape Verde;10;0;1165;12
2020-06-30;CV;Cape Verde;62;3;1227;15
2020-07-01;CV;Cape Verde;40;0;1267;15
2020-07-02;CV;Cape Verde;34;0;1301;15
2020-07-03;CV;Cape Verde;81;0;1382;15
2020-07-04;CV;Cape Verde;39;1;1421;16
2020-07-05;CV;Cape Verde;30;1;1451;17
2020-07-06;CV;Cape Verde;12;0;1463;17
2020-07-07;CV;Cape Verde;36;1;1499;18
2020-07-08;CV;Cape Verde;43;0;1542;18
2020-07-09;CV;Cape Verde;10;0;1552;18
2020-07-10;CV;Cape Verde;39;1;1591;19
2020-07-11;CV;Cape Verde;32;0;1623;19
2020-07-12;CV;Cape Verde;0;0;1623;19
2020-07-13;CV;Cape Verde;75;0;1698;19
2020-07-14;CV;Cape Verde;24;0;1722;19
2020-07-15;CV;Cape Verde;58;0;1780;19
2020-07-16;CV;Cape Verde;114;0;1894;19
2020-07-17;CV;Cape Verde;45;0;1939;19
2020-07-18;CV;Cape Verde;75;2;2014;21
2020-07-19;CV;Cape Verde;31;0;2045;21
2020-07-20;CV;Cape Verde;26;0;2071;21
2020-07-21;CV;Cape Verde;36;0;2107;21
2020-07-22;CV;Cape Verde;47;0;2154;21
2020-07-23;CV;Cape Verde;36;0;2190;21
2020-07-24;CV;Cape Verde;30;1;2220;22
2020-07-25;CV;Cape Verde;38;0;2258;22
2020-07-26;CV;Cape Verde;49;0;2307;22
2020-07-27;CV;Cape Verde;21;0;2328;22
2020-07-28;CV;Cape Verde;26;0;2354;22
2020-07-29;CV;Cape Verde;19;1;2373;23
2020-07-30;CV;Cape Verde;45;0;2418;23
2020-07-31;CV;Cape Verde;33;0;2451;23
2020-08-01;CV;Cape Verde;29;1;2480;24
2020-08-02;CV;Cape Verde;67;0;2547;24
2020-08-03;CV;Cape Verde;36;1;2583;25
2020-08-04;CV;Cape Verde;48;1;2631;26
2020-08-05;CV;Cape Verde;58;1;2689;27
2020-08-06;CV;Cape Verde;45;0;2734;27
2020-08-07;CV;Cape Verde;46;2;2780;29
2020-08-08;CV;Cape Verde;55;3;2835;32
2020-08-09;CV;Cape Verde;23;0;2858;32
2020-08-10;CV;Cape Verde;25;0;2883;32
2020-08-11;CV;Cape Verde;37;1;2920;33
2020-08-12;CV;Cape Verde;80;0;3000;33
2020-08-13;CV;Cape Verde;73;0;3073;33
2020-08-14;CV;Cape Verde;63;0;3136;33
2020-08-15;CV;Cape Verde;27;1;3163;34
2020-08-16;CV;Cape Verde;16;1;3179;35
2020-08-17;CV;Cape Verde;24;1;3203;36
2020-08-18;CV;Cape Verde;50;0;3253;36
2020-08-19;CV;Cape Verde;68;0;3321;36
2020-08-20;CV;Cape Verde;47;1;3368;37
2020-08-21;CV;Cape Verde;44;0;3412;37
2020-08-22;CV;Cape Verde;43;0;3455;37
2020-08-23;CV;Cape Verde;54;0;3509;37
2020-08-24;CV;Cape Verde;23;0;3532;37
2020-08-25;CV;Cape Verde;36;0;3568;37
2020-08-26;CV;Cape Verde;62;1;3630;38
2020-08-27;CV;Cape Verde;69;0;3699;38
2020-08-28;CV;Cape Verde;46;0;3745;38
2020-08-29;CV;Cape Verde;33;1;3778;39
2020-08-30;CV;Cape Verde;74;1;3852;40
2020-08-31;CV;Cape Verde;32;0;3884;40
2020-09-01;CV;Cape Verde;86;0;3970;40
2020-09-02;CV;Cape Verde;78;1;4048;41
2020-09-03;CV;Cape Verde;77;0;4125;41
2020-09-04;CV;Cape Verde;75;0;4200;41
2020-09-05;CV;Cape Verde;75;1;4275;42
2020-09-06;CV;Cape Verde;55;0;4330;42
2020-09-07;CV;Cape Verde;28;0;4358;42
2020-09-08;CV;Cape Verde;42;0;4400;42
2020-09-09;CV;Cape Verde;73;1;4473;43
2020-09-10;CV;Cape Verde;84;0;4557;43
2020-09-11;CV;Cape Verde;94;1;4651;44
2020-09-12;CV;Cape Verde;60;0;4711;44
2020-09-13;CV;Cape Verde;102;0;4813;44
2020-09-14;CV;Cape Verde;26;1;4839;45
2020-09-15;CV;Cape Verde;65;1;4904;46
2020-09-16;CV;Cape Verde;74;1;4978;47
2020-09-17;CV;Cape Verde;85;2;5063;49
2020-09-18;CV;Cape Verde;78;1;5141;50
2020-09-19;CV;Cape Verde;45;0;5186;50
2020-09-20;CV;Cape Verde;71;1;5257;51
2020-09-21;CV;Cape Verde;24;1;5281;52
2020-09-22;CV;Cape Verde;56;0;5337;52
2020-09-23;CV;Cape Verde;75;2;5412;54
2020-09-24;CV;Cape Verde;67;1;5479;55
2020-09-25;CV;Cape Verde;149;0;5628;55
2020-09-26;CV;Cape Verde;73;1;5701;56
2020-09-27;CV;Cape Verde;70;1;5771;57
2020-09-28;CV;Cape Verde;46;2;5817;59
2020-09-29;CV;Cape Verde;83;0;5900;59
2020-09-30;CV;Cape Verde;124;1;6024;60
2020-10-01;CV;Cape Verde;102;1;6126;61
2020-10-02;CV;Cape Verde;79;1;6205;62
2020-10-03;CV;Cape Verde;91;0;6296;62
2020-10-04;CV;Cape Verde;64;3;6360;65
2020-10-05;CV;Cape Verde;73;3;6433;68
2020-10-06;CV;Cape Verde;85;1;6518;69
2020-10-07;CV;Cape Verde;106;2;6624;71
2020-10-08;CV;Cape Verde;93;0;6717;71
2020-10-09;CV;Cape Verde;92;2;6809;73
2020-10-10;CV;Cape Verde;104;1;6913;74
2020-10-11;CV;Cape Verde;159;1;7072;75
2020-10-12;CV;Cape Verde;83;0;7155;75
2020-10-13;CV;Cape Verde;99;2;7254;77
2020-10-14;CV;Cape Verde;117;2;7371;79
2020-10-15;CV;Cape Verde;73;0;7444;79
2020-10-16;CV;Cape Verde;82;3;7526;82
2020-10-17;CV;Cape Verde;112;3;7638;85
2020-10-18;CV;Cape Verde;114;1;7752;86
2020-10-19;CV;Cape Verde;48;1;7800;87
2020-10-20;CV;Cape Verde;101;0;7901;87
2020-10-21;CV;Cape Verde;132;3;8033;90
2020-10-22;CV;Cape Verde;89;1;8122;91
2020-10-23;CV;Cape Verde;76;3;8198;94
2020-10-24;CV;Cape Verde;124;0;8322;94
2020-10-25;CV;Cape Verde;74;0;8396;94
2020-10-26;CV;Cape Verde;27;0;8423;94
2020-10-27;CV;Cape Verde;49;0;8472;94
2020-10-28;CV;Cape Verde;76;0;8548;94
2020-10-29;CV;Cape Verde;55;1;8603;95
2020-10-30;CV;Cape Verde;91;0;8694;95
2020-10-31;CV;Cape Verde;99;0;8793;95
2020-11-01;CV;Cape Verde;55;0;8848;95
2020-11-02;CV;Cape Verde;34;0;8882;95
2020-11-03;CV;Cape Verde;62;0;8944;95
2020-11-04;CV;Cape Verde;109;0;9053;95
2020-11-05;CV;Cape Verde;96;2;9149;97
2020-11-06;CV;Cape Verde;75;3;9224;100
2020-11-07;CV;Cape Verde;67;0;9291;100
2020-11-08;CV;Cape Verde;78;0;9369;100
2020-11-09;CV;Cape Verde;50;0;9419;100
2020-11-10;CV;Cape Verde;80;1;9499;101
2020-11-11;CV;Cape Verde;61;1;9560;102
2020-11-12;CV;Cape Verde;134;0;9694;102
2020-11-13;CV;Cape Verde;47;0;9741;102
2020-11-14;CV;Cape Verde;39;0;9780;102
2020-11-15;CV;Cape Verde;42;1;9822;103
2020-11-16;CV;Cape Verde;18;0;9840;103
2020-11-17;CV;Cape Verde;120;0;9960;103
2020-11-18;CV;Cape Verde;40;1;10000;104
2020-11-19;CV;Cape Verde;82;0;10082;104
2020-11-20;CV;Cape Verde;70;0;10152;104
2020-11-21;CV;Cape Verde;82;0;10234;104
2020-11-22;CV;Cape Verde;42;0;10276;104
2020-11-23;CV;Cape Verde;26;0;10302;104
2020-11-24;CV;Cape Verde;98;0;10400;104
2020-11-25;CV;Cape Verde;126;0;10526;104
2020-11-26;CV;Cape Verde;44;1;10570;105
2020-11-27;CV;Cape Verde;56;0;10626;105
2020-11-28;CV;Cape Verde;74;0;10700;105
2020-11-29;CV;Cape Verde;47;0;10747;105
2020-11-30;CV;Cape Verde;14;0;10761;105
2020-12-01;CV;Cape Verde;55;1;10816;106
2020-12-02;CV;Cape Verde;51;0;10867;106
2020-12-03;CV;Cape Verde;71;1;10938;107
2020-12-04;CV;Cape Verde;58;1;10996;108
2020-12-05;CV;Cape Verde;40;1;11036;109
2020-12-06;CV;Cape Verde;27;0;11063;109
2020-12-07;CV;Cape Verde;35;0;11098;109
2020-12-08;CV;Cape Verde;20;0;11118;109
2020-12-09;CV;Cape Verde;74;0;11192;109
2020-12-10;CV;Cape Verde;11;0;11203;109
2020-12-11;CV;Cape Verde;59;1;11262;110
2020-12-12;CV;Cape Verde;40;0;11302;110
2020-12-13;CV;Cape Verde;55;0;11357;110
2020-12-14;CV;Cape Verde;4;0;11361;110
2020-12-15;CV;Cape Verde;34;0;11395;110
2020-12-16;CV;Cape Verde;63;0;11458;110
2020-12-17;CV;Cape Verde;44;0;11502;110
2020-12-18;CV;Cape Verde;24;0;11526;110
2020-12-19;CV;Cape Verde;41;1;11567;111
2020-12-20;CV;Cape Verde;12;0;11579;111
2020-12-21;CV;Cape Verde;21;0;11600;111
2020-12-22;CV;Cape Verde;36;1;11636;112
2020-12-23;CV;Cape Verde;32;0;11668;112
2020-12-24;CV;Cape Verde;20;0;11688;112
2020-12-25;CV;Cape Verde;8;0;11696;112
2020-12-26;CV;Cape Verde;2;0;11698;112
2020-12-27;CV;Cape Verde;16;0;11714;112
2020-12-28;CV;Cape Verde;9;0;11723;112
2020-12-29;CV;Cape Verde;29;0;11752;112
2020-12-30;CV;Cape Verde;41;0;11793;112
2020-12-31;CV;Cape Verde;47;1;11840;113
2021-01-01;CV;Cape Verde;32;0;11872;113
2021-01-02;CV;Cape Verde;11;0;11883;113
2021-01-03;CV;Cape Verde;37;0;11920;113
2021-01-04;CV;Cape Verde;29;0;11949;113
2021-01-05;CV;Cape Verde;34;0;11983;113
2021-01-06;CV;Cape Verde;69;0;12052;113
2021-01-07;CV;Cape Verde;94;0;12146;113
2021-01-08;CV;Cape Verde;91;1;12237;114
2021-01-09;CV;Cape Verde;79;0;12316;114
2021-01-10;CV;Cape Verde;76;0;12392;114
2021-01-11;CV;Cape Verde;41;1;12433;115
2021-01-12;CV;Cape Verde;73;0;12506;115
2021-01-13;CV;Cape Verde;86;0;12592;115
2021-01-14;CV;Cape Verde;72;0;12664;115
2021-01-15;CV;Cape Verde;112;3;12776;118
2021-01-16;CV;Cape Verde;125;1;12901;119
2021-01-17;CV;Cape Verde;92;0;12993;119
2021-01-18;CV;Cape Verde;53;1;13046;120
2021-01-19;CV;Cape Verde;93;0;13139;120
2021-01-20;CV;Cape Verde;85;1;13224;121
2021-01-21;CV;Cape Verde;83;1;13307;122
2021-01-22;CV;Cape Verde;74;0;13381;122
2021-01-23;CV;Cape Verde;33;2;13414;124
2021-01-24;CV;Cape Verde;75;3;13489;127
2021-01-25;CV;Cape Verde;68;0;13557;127
2021-01-26;CV;Cape Verde;62;2;13619;129
2021-01-27;CV;Cape Verde;103;0;13722;129
2021-01-28;CV;Cape Verde;62;2;13784;131
2021-01-29;CV;Cape Verde;113;0;13897;131
2021-01-30;CV;Cape Verde;84;2;13981;133
2021-01-31;CV;Cape Verde;89;1;14070;134
2021-02-01;CV;Cape Verde;28;0;14098;134
2021-02-02;CV;Cape Verde;54;0;14152;134
2021-02-03;CV;Cape Verde;62;1;14214;135
2021-02-04;CV;Cape Verde;76;0;14290;135
2021-02-05;CV;Cape Verde;16;0;14306;135
2021-02-06;CV;Cape Verde;74;0;14380;135
2021-02-07;CV;Cape Verde;43;0;14423;135
2021-02-08;CV;Cape Verde;28;1;14451;136
2021-02-09;CV;Cape Verde;28;1;14479;137
2021-02-10;CV;Cape Verde;64;1;14543;138
2021-02-11;CV;Cape Verde;58;0;14601;138
2021-02-12;CV;Cape Verde;46;1;14647;139
2021-02-13;CV;Cape Verde;53;0;14700;139
2021-02-14;CV;Cape Verde;41;0;14741;139
2021-02-15;CV;Cape Verde;20;0;14761;139
2021-02-16;CV;Cape Verde;24;1;14785;140
2021-02-17;CV;Cape Verde;63;1;14848;141
2021-02-18;CV;Cape Verde;37;1;14885;142
2021-02-19;CV;Cape Verde;63;0;14948;142
2021-02-20;CV;Cape Verde;51;1;14999;143
2021-02-21;CV;Cape Verde;49;1;15048;144
2021-02-22;CV;Cape Verde;24;0;15072;144
2021-02-23;CV;Cape Verde;17;0;15089;144
2021-02-24;CV;Cape Verde;72;1;15161;145
2021-02-25;CV;Cape Verde;40;0;15201;145
2021-02-26;CV;Cape Verde;52;1;15253;146
2021-02-27;CV;Cape Verde;71;1;15324;147
2021-02-28;CV;Cape Verde;76;0;15400;147
2021-03-01;CV;Cape Verde;32;0;15432;147
2021-03-02;CV;Cape Verde;51;1;15483;148
2021-03-03;CV;Cape Verde;75;2;15558;150
2021-03-04;CV;Cape Verde;63;2;15621;152
2021-03-05;CV;Cape Verde;62;0;15683;152
2021-03-06;CV;Cape Verde;41;0;15724;152
2021-03-07;CV;Cape Verde;58;2;15782;154
2021-03-08;CV;Cape Verde;24;0;15806;154
2021-03-09;CV;Cape Verde;20;0;15826;154
2021-03-10;CV;Cape Verde;66;1;15892;155
2021-03-11;CV;Cape Verde;40;0;15932;155
2021-03-12;CV;Cape Verde;54;0;15986;155
2021-03-13;CV;Cape Verde;49;1;16035;156
2021-03-14;CV;Cape Verde;66;0;16101;156
2021-03-15;CV;Cape Verde;19;0;16120;156
2021-03-16;CV;Cape Verde;34;1;16154;157
2021-03-17;CV;Cape Verde;96;1;16250;158
2021-03-18;CV;Cape Verde;48;0;16298;158
2021-03-19;CV;Cape Verde;76;1;16374;159
2021-03-20;CV;Cape Verde;66;0;16440;159
2021-03-21;CV;Cape Verde;51;0;16491;159
2021-03-22;CV;Cape Verde;26;1;16517;160
2021-03-23;CV;Cape Verde;38;3;16555;163
2021-03-24;CV;Cape Verde;106;0;16661;163
2021-03-25;CV;Cape Verde;126;1;16787;164
2021-03-26;CV;Cape Verde;124;1;16911;165
2021-03-27;CV;Cape Verde;107;0;17018;165
2021-03-28;CV;Cape Verde;107;0;17125;165
2021-03-29;CV;Cape Verde;65;0;17190;165
2021-03-30;CV;Cape Verde;89;3;17279;168
2021-03-31;CV;Cape Verde;191;0;17470;168
2021-04-01;CV;Cape Verde;117;1;17587;169
2021-04-02;CV;Cape Verde;130;2;17717;171
2021-04-03;CV;Cape Verde;104;0;17821;171
2021-04-04;CV;Cape Verde;50;2;17871;173
2021-04-05;CV;Cape Verde;68;0;17939;173
2021-04-06;CV;Cape Verde;84;0;18023;173
2021-04-07;CV;Cape Verde;191;2;18214;175
2021-04-08;CV;Cape Verde;208;1;18422;176
2021-04-09;CV;Cape Verde;207;1;18629;177
2021-04-10;CV;Cape Verde;0;0;18629;177
2021-04-11;CV;Cape Verde;376;5;19005;182
2021-04-12;CV;Cape Verde;105;2;19110;184
2021-04-13;CV;Cape Verde;121;3;19231;187
2021-04-14;CV;Cape Verde;294;1;19525;188
2021-04-15;CV;Cape Verde;255;0;19780;188
2021-04-16;CV;Cape Verde;195;1;19975;189
2021-04-17;CV;Cape Verde;0;0;19975;189
2021-04-18;CV;Cape Verde;491;3;20466;192
2021-04-19;CV;Cape Verde;161;1;20627;193
2021-04-20;CV;Cape Verde;154;1;20781;194
2021-04-21;CV;Cape Verde;398;4;21179;198
2021-04-22;CV;Cape Verde;321;1;21500;199
2021-04-23;CV;Cape Verde;284;2;21784;201
2021-04-24;CV;Cape Verde;310;0;22094;201
2021-04-25;CV;Cape Verde;255;2;22349;203
2021-04-26;CV;Cape Verde;237;5;22586;208
2021-04-27;CV;Cape Verde;186;3;22772;211
2021-04-28;CV;Cape Verde;409;2;23181;213
2021-04-29;CV;Cape Verde;373;0;23554;213
2021-04-30;CV;Cape Verde;328;4;23882;217
2021-05-01;CV;Cape Verde;245;3;24127;220
2021-05-02;CV;Cape Verde;241;3;24368;223
2021-05-03;CV;Cape Verde;180;3;24548;226
2021-05-04;CV;Cape Verde;194;2;24742;228
2021-05-05;CV;Cape Verde;417;1;25159;229
2021-05-06;CV;Cape Verde;367;1;25526;230
2021-05-07;CV;Cape Verde;311;1;25837;231
2021-05-08;CV;Cape Verde;274;1;26111;232
2021-05-09;CV;Cape Verde;330;0;26441;232
2021-05-10;CV;Cape Verde;137;3;26578;235
2021-05-11;CV;Cape Verde;131;1;26709;236
2021-05-12;CV;Cape Verde;320;2;27029;238
2021-05-13;CV;Cape Verde;357;5;27386;243
2021-05-14;CV;Cape Verde;286;1;27672;244
2021-05-15;CV;Cape Verde;279;2;27951;246
2021-05-16;CV;Cape Verde;217;3;28168;249
2021-05-17;CV;Cape Verde;113;2;28281;251
2021-05-18;CV;Cape Verde;129;1;28410;252
2021-05-19;CV;Cape Verde;289;1;28699;253
2021-05-20;CV;Cape Verde;199;0;28898;253
2021-05-21;CV;Cape Verde;135;1;29033;254
2021-05-22;CV;Cape Verde;165;2;29198;256
2021-05-23;CV;Cape Verde;136;0;29334;256
2021-05-24;CV;Cape Verde;77;2;29411;258
2021-05-25;CV;Cape Verde;138;1;29549;259
2021-05-26;CV;Cape Verde;214;0;29763;259
2021-05-27;CV;Cape Verde;176;0;29939;259
2021-05-28;CV;Cape Verde;183;2;30122;261
2021-05-29;CV;Cape Verde;151;2;30273;263
2021-05-30;CV;Cape Verde;86;1;30359;264
2021-05-31;CV;Cape Verde;80;0;30439;264
2021-06-01;CV;Cape Verde;84;0;30523;264
2021-06-02;CV;Cape Verde;171;2;30694;266
2021-06-03;CV;Cape Verde;80;0;30774;266
2021-06-04;CV;Cape Verde;133;1;30907;267
2021-06-05;CV;Cape Verde;96;0;31003;267
2021-06-06;CV;Cape Verde;94;0;31097;267
2021-06-07;CV;Cape Verde;50;0;31147;267
2021-06-08;CV;Cape Verde;78;2;31225;269
2021-06-09;CV;Cape Verde;114;1;31339;270
2021-06-10;CV;Cape Verde;94;1;31433;271
2021-06-11;CV;Cape Verde;79;1;31512;272
2021-06-12;CV;Cape Verde;59;1;31571;273
2021-06-13;CV;Cape Verde;0;0;31571;273
2021-06-14;CV;Cape Verde;76;3;31647;276
2021-06-15;CV;Cape Verde;57;0;31704;276
2021-06-16;CV;Cape Verde;79;3;31783;279
2021-06-17;CV;Cape Verde;75;1;31858;280
2021-06-18;CV;Cape Verde;52;1;31910;281
2021-06-19;CV;Cape Verde;54;0;31964;281
2021-06-20;CV;Cape Verde;38;2;32002;283
2021-06-21;CV;Cape Verde;37;0;32039;283
2021-06-22;CV;Cape Verde;72;1;32111;284
2021-06-23;CV;Cape Verde;81;0;32192;284
2021-06-24;CV;Cape Verde;65;1;32257;285
2021-06-25;CV;Cape Verde;56;1;32313;286
2021-06-26;CV;Cape Verde;31;0;32344;286
2021-06-27;CV;Cape Verde;28;0;32372;286
2021-06-28;CV;Cape Verde;27;0;32399;286
2021-06-29;CV;Cape Verde;58;0;32457;286
2021-06-30;CV;Cape Verde;0;0;32457;286
2021-07-01;CV;Cape Verde;137;1;32594;287
2020-12-26;KY;Cayman Islands;0;0;0;0
2020-12-27;KY;Cayman Islands;0;0;0;0
2020-12-28;KY;Cayman Islands;0;0;0;0
2020-12-29;KY;Cayman Islands;0;0;0;0
2020-12-30;KY;Cayman Islands;0;0;0;0
2020-12-31;KY;Cayman Islands;0;0;0;0
2021-01-01;KY;Cayman Islands;0;0;0;0
2021-01-02;KY;Cayman Islands;0;0;0;0
2021-01-03;KY;Cayman Islands;0;0;0;0
2021-01-04;KY;Cayman Islands;0;0;0;0
2021-01-05;KY;Cayman Islands;0;0;0;0
2021-01-06;KY;Cayman Islands;0;0;0;0
2021-01-07;KY;Cayman Islands;0;0;0;0
2021-01-08;KY;Cayman Islands;0;0;0;0
2021-01-09;KY;Cayman Islands;0;0;0;0
2021-01-10;KY;Cayman Islands;0;0;0;0
2021-01-11;KY;Cayman Islands;0;0;0;0
2021-01-12;KY;Cayman Islands;0;0;0;0
2021-01-13;KY;Cayman Islands;0;0;0;0
2021-01-14;KY;Cayman Islands;0;0;0;0
2021-01-15;KY;Cayman Islands;0;0;0;0
2021-01-16;KY;Cayman Islands;0;0;0;0
2021-01-17;KY;Cayman Islands;0;0;0;0
2021-01-18;KY;Cayman Islands;0;0;0;0
2021-01-19;KY;Cayman Islands;0;0;0;0
2021-01-20;KY;Cayman Islands;0;0;0;0
2021-01-21;KY;Cayman Islands;0;0;0;0
2021-01-22;KY;Cayman Islands;0;0;0;0
2021-01-23;KY;Cayman Islands;0;0;0;0
2021-01-24;KY;Cayman Islands;0;0;0;0
2021-01-25;KY;Cayman Islands;0;0;0;0
2021-01-26;KY;Cayman Islands;0;0;0;0
2021-01-27;KY;Cayman Islands;0;0;0;0
2021-01-28;KY;Cayman Islands;0;0;0;0
2021-01-29;KY;Cayman Islands;0;0;0;0
2021-01-30;KY;Cayman Islands;0;0;0;0
2021-01-31;KY;Cayman Islands;0;0;0;0
2021-02-01;KY;Cayman Islands;0;0;0;0
2021-02-02;KY;Cayman Islands;0;0;0;0
2021-02-03;KY;Cayman Islands;0;0;0;0
2021-02-04;KY;Cayman Islands;0;0;0;0
2021-02-05;KY;Cayman Islands;0;0;0;0
2021-02-06;KY;Cayman Islands;0;0;0;0
2021-02-07;KY;Cayman Islands;0;0;0;0
2021-02-08;KY;Cayman Islands;0;0;0;0
2021-02-09;KY;Cayman Islands;0;0;0;0
2021-02-10;KY;Cayman Islands;0;0;0;0
2021-02-11;KY;Cayman Islands;0;0;0;0
2021-02-12;KY;Cayman Islands;0;0;0;0
2021-02-13;KY;Cayman Islands;0;0;0;0
2021-02-14;KY;Cayman Islands;0;0;0;0
2021-02-15;KY;Cayman Islands;0;0;0;0
2021-02-16;KY;Cayman Islands;0;0;0;0
2021-02-17;KY;Cayman Islands;0;0;0;0
2021-02-18;KY;Cayman Islands;0;0;0;0
2021-02-19;KY;Cayman Islands;0;0;0;0
2021-02-20;KY;Cayman Islands;0;0;0;0
2021-02-21;KY;Cayman Islands;0;0;0;0
2021-02-22;KY;Cayman Islands;0;0;0;0
2021-02-23;KY;Cayman Islands;0;0;0;0
2021-02-24;KY;Cayman Islands;0;0;0;0
2021-02-25;KY;Cayman Islands;0;0;0;0
2021-02-26;KY;Cayman Islands;0;0;0;0
2021-02-27;KY;Cayman Islands;0;0;0;0
2021-02-28;KY;Cayman Islands;0;0;0;0
2021-03-01;KY;Cayman Islands;0;0;0;0
2021-03-02;KY;Cayman Islands;0;0;0;0
2021-03-03;KY;Cayman Islands;0;0;0;0
2021-03-04;KY;Cayman Islands;0;0;0;0
2021-03-05;KY;Cayman Islands;0;0;0;0
2021-03-06;KY;Cayman Islands;0;0;0;0
2021-03-07;KY;Cayman Islands;0;0;0;0
2021-03-08;KY;Cayman Islands;0;0;0;0
2021-03-09;KY;Cayman Islands;0;0;0;0
2021-03-10;KY;Cayman Islands;0;0;0;0
2021-03-11;KY;Cayman Islands;0;0;0;0
2021-03-12;KY;Cayman Islands;0;0;0;0
2021-03-13;KY;Cayman Islands;0;0;0;0
2021-03-14;KY;Cayman Islands;0;0;0;0
2021-03-15;KY;Cayman Islands;0;0;0;0
2021-03-16;KY;Cayman Islands;0;0;0;0
2021-03-17;KY;Cayman Islands;0;0;0;0
2021-03-18;KY;Cayman Islands;0;0;0;0
2021-03-19;KY;Cayman Islands;0;0;0;0
2021-03-20;KY;Cayman Islands;0;0;0;0
2021-03-21;KY;Cayman Islands;0;0;0;0
2021-03-22;KY;Cayman Islands;0;0;0;0
2021-03-23;KY;Cayman Islands;0;0;0;0
2021-03-24;KY;Cayman Islands;0;0;0;0
2021-03-25;KY;Cayman Islands;0;0;0;0
2021-03-26;KY;Cayman Islands;0;0;0;0
2021-03-27;KY;Cayman Islands;0;0;0;0
2021-03-28;KY;Cayman Islands;0;0;0;0
2021-03-29;KY;Cayman Islands;0;0;0;0
2021-03-30;KY;Cayman Islands;0;0;0;0
2021-03-31;KY;Cayman Islands;0;0;0;0
2021-04-01;KY;Cayman Islands;0;0;0;0
2021-04-02;KY;Cayman Islands;0;0;0;0
2021-04-03;KY;Cayman Islands;0;0;0;0
2021-04-04;KY;Cayman Islands;0;0;0;0
2021-04-05;KY;Cayman Islands;0;0;0;0
2021-04-06;KY;Cayman Islands;0;0;0;0
2021-04-07;KY;Cayman Islands;0;0;0;0
2021-04-08;KY;Cayman Islands;0;0;0;0
2021-04-09;KY;Cayman Islands;0;0;0;0
2021-04-10;KY;Cayman Islands;0;0;0;0
2021-04-11;KY;Cayman Islands;0;0;0;0
2021-04-12;KY;Cayman Islands;0;0;0;0
2021-04-13;KY;Cayman Islands;0;0;0;0
2021-04-14;KY;Cayman Islands;0;0;0;0
2021-04-15;KY;Cayman Islands;0;0;0;0
2021-04-16;KY;Cayman Islands;0;0;0;0
2021-04-17;KY;Cayman Islands;0;0;0;0
2021-04-18;KY;Cayman Islands;0;0;0;0
2021-04-19;KY;Cayman Islands;0;0;0;0
2021-04-20;KY;Cayman Islands;0;0;0;0
2021-04-21;KY;Cayman Islands;0;0;0;0
2021-04-22;KY;Cayman Islands;0;0;0;0
2021-04-23;KY;Cayman Islands;0;0;0;0
2021-04-24;KY;Cayman Islands;0;0;0;0
2021-04-25;KY;Cayman Islands;0;0;0;0
2021-04-26;KY;Cayman Islands;0;0;0;0
2021-04-27;KY;Cayman Islands;0;0;0;0
2021-04-28;KY;Cayman Islands;0;0;0;0
2021-04-29;KY;Cayman Islands;0;0;0;0
2021-04-30;KY;Cayman Islands;0;0;0;0
2021-05-01;KY;Cayman Islands;0;0;0;0
2021-05-02;KY;Cayman Islands;0;0;0;0
2021-05-03;KY;Cayman Islands;0;0;0;0
2021-05-04;KY;Cayman Islands;0;0;0;0
2021-05-05;KY;Cayman Islands;0;0;0;0
2021-05-06;KY;Cayman Islands;0;0;0;0
2021-05-07;KY;Cayman Islands;0;0;0;0
2021-05-08;KY;Cayman Islands;0;0;0;0
2021-05-09;KY;Cayman Islands;0;0;0;0
2021-05-10;KY;Cayman Islands;0;0;0;0
2021-05-11;KY;Cayman Islands;0;0;0;0
2021-05-12;KY;Cayman Islands;0;0;0;0
2021-05-13;KY;Cayman Islands;0;0;0;0
2021-05-14;KY;Cayman Islands;0;0;0;0
2021-05-15;KY;Cayman Islands;0;0;0;0
2021-05-16;KY;Cayman Islands;0;0;0;0
2021-05-17;KY;Cayman Islands;0;0;0;0
2021-05-18;KY;Cayman Islands;0;0;0;0
2021-05-19;KY;Cayman Islands;0;0;0;0
2021-05-20;KY;Cayman Islands;0;0;0;0
2021-05-21;KY;Cayman Islands;0;0;0;0
2021-05-22;KY;Cayman Islands;0;0;0;0
2021-05-23;KY;Cayman Islands;0;0;0;0
2021-05-24;KY;Cayman Islands;0;0;0;0
2021-05-25;KY;Cayman Islands;0;0;0;0
2021-05-26;KY;Cayman Islands;0;0;0;0
2021-05-27;KY;Cayman Islands;0;0;0;0
2021-05-28;KY;Cayman Islands;0;0;0;0
2021-05-29;KY;Cayman Islands;0;0;0;0
2021-05-30;KY;Cayman Islands;0;0;0;0
2021-05-31;KY;Cayman Islands;0;0;0;0
2021-06-01;KY;Cayman Islands;0;0;0;0
2021-06-02;KY;Cayman Islands;0;0;0;0
2021-06-03;KY;Cayman Islands;0;0;0;0
2021-06-04;KY;Cayman Islands;0;0;0;0
2021-06-05;KY;Cayman Islands;0;0;0;0
2021-06-06;KY;Cayman Islands;0;0;0;0
2021-06-07;KY;Cayman Islands;0;0;0;0
2021-06-08;KY;Cayman Islands;0;0;0;0
2021-06-09;KY;Cayman Islands;0;0;0;0
2021-06-10;KY;Cayman Islands;0;0;0;0
2021-06-11;KY;Cayman Islands;0;0;0;0
2021-06-12;KY;Cayman Islands;0;0;0;0
2021-06-13;KY;Cayman Islands;0;0;0;0
2021-06-14;KY;Cayman Islands;0;0;0;0
2021-06-15;KY;Cayman Islands;0;0;0;0
2021-06-16;KY;Cayman Islands;0;0;0;0
2021-06-17;KY;Cayman Islands;0;0;0;0
2021-06-18;KY;Cayman Islands;0;0;0;0
2021-06-19;KY;Cayman Islands;0;0;0;0
2021-06-20;KY;Cayman Islands;0;0;0;0
2021-06-21;KY;Cayman Islands;0;0;0;0
2021-06-22;KY;Cayman Islands;0;0;0;0
2021-06-23;KY;Cayman Islands;0;0;0;0
2021-06-24;KY;Cayman Islands;0;0;0;0
2021-06-25;KY;Cayman Islands;0;0;0;0
2021-06-26;KY;Cayman Islands;0;0;0;0
2021-06-27;KY;Cayman Islands;0;0;0;0
2021-06-28;KY;Cayman Islands;0;0;0;0
2021-06-29;KY;Cayman Islands;0;0;0;0
2021-06-30;KY;Cayman Islands;0;0;0;0
2021-07-01;KY;Cayman Islands;0;0;0;0
2020-03-15;CF;Central African Republic;1;0;1;0
2020-03-16;CF;Central African Republic;0;0;1;0
2020-03-17;CF;Central African Republic;0;0;1;0
2020-03-18;CF;Central African Republic;0;0;1;0
2020-03-19;CF;Central African Republic;0;0;1;0
2020-03-20;CF;Central African Republic;2;0;3;0
2020-03-21;CF;Central African Republic;0;0;3;0
2020-03-22;CF;Central African Republic;0;0;3;0
2020-03-23;CF;Central African Republic;0;0;3;0
2020-03-24;CF;Central African Republic;0;0;3;0
2020-03-25;CF;Central African Republic;0;0;3;0
2020-03-26;CF;Central African Republic;0;0;3;0
2020-03-27;CF;Central African Republic;0;0;3;0
2020-03-28;CF;Central African Republic;0;0;3;0
2020-03-29;CF;Central African Republic;0;0;3;0
2020-03-30;CF;Central African Republic;0;0;3;0
2020-03-31;CF;Central African Republic;0;0;3;0
2020-04-01;CF;Central African Republic;0;0;3;0
2020-04-02;CF;Central African Republic;0;0;3;0
2020-04-03;CF;Central African Republic;5;0;8;0
2020-04-04;CF;Central African Republic;0;0;8;0
2020-04-05;CF;Central African Republic;0;0;8;0
2020-04-06;CF;Central African Republic;0;0;8;0
2020-04-07;CF;Central African Republic;0;0;8;0
2020-04-08;CF;Central African Republic;0;0;8;0
2020-04-09;CF;Central African Republic;0;0;8;0
2020-04-10;CF;Central African Republic;0;0;8;0
2020-04-11;CF;Central African Republic;0;0;8;0
2020-04-12;CF;Central African Republic;0;0;8;0
2020-04-13;CF;Central African Republic;3;0;11;0
2020-04-14;CF;Central African Republic;0;0;11;0
2020-04-15;CF;Central African Republic;1;0;12;0
2020-04-16;CF;Central African Republic;0;0;12;0
2020-04-17;CF;Central African Republic;0;0;12;0
2020-04-18;CF;Central African Republic;0;0;12;0
2020-04-19;CF;Central African Republic;0;0;12;0
2020-04-20;CF;Central African Republic;0;0;12;0
2020-04-21;CF;Central African Republic;2;0;14;0
2020-04-22;CF;Central African Republic;0;0;14;0
2020-04-23;CF;Central African Republic;2;0;16;0
2020-04-24;CF;Central African Republic;0;0;16;0
2020-04-25;CF;Central African Republic;0;0;16;0
2020-04-26;CF;Central African Republic;3;0;19;0
2020-04-27;CF;Central African Republic;0;0;19;0
2020-04-28;CF;Central African Republic;31;0;50;0
2020-04-29;CF;Central African Republic;0;0;50;0
2020-04-30;CF;Central African Republic;0;0;50;0
2020-05-01;CF;Central African Republic;22;0;72;0
2020-05-02;CF;Central African Republic;0;0;72;0
2020-05-03;CF;Central African Republic;0;0;72;0
2020-05-04;CF;Central African Republic;13;0;85;0
2020-05-05;CF;Central African Republic;0;0;85;0
2020-05-06;CF;Central African Republic;9;0;94;0
2020-05-07;CF;Central African Republic;0;0;94;0
2020-05-08;CF;Central African Republic;49;0;143;0
2020-05-09;CF;Central African Republic;0;0;143;0
2020-05-10;CF;Central African Republic;0;0;143;0
2020-05-11;CF;Central African Republic;0;0;143;0
2020-05-12;CF;Central African Republic;0;0;143;0
2020-05-13;CF;Central African Republic;0;0;143;0
2020-05-14;CF;Central African Republic;0;0;143;0
2020-05-15;CF;Central African Republic;158;0;301;0
2020-05-16;CF;Central African Republic;26;0;327;0
2020-05-17;CF;Central African Republic;0;0;327;0
2020-05-18;CF;Central African Republic;0;0;327;0
2020-05-19;CF;Central African Republic;39;0;366;0
2020-05-20;CF;Central African Republic;52;0;418;0
2020-05-21;CF;Central African Republic;18;0;436;0
2020-05-22;CF;Central African Republic;43;0;479;0
2020-05-23;CF;Central African Republic;73;1;552;1
2020-05-24;CF;Central African Republic;52;0;604;1
2020-05-25;CF;Central African Republic;48;0;652;1
2020-05-26;CF;Central African Republic;19;0;671;1
2020-05-27;CF;Central African Republic;31;0;702;1
2020-05-28;CF;Central African Republic;53;0;755;1
2020-05-29;CF;Central African Republic;119;0;874;1
2020-05-30;CF;Central African Republic;88;0;962;1
2020-05-31;CF;Central African Republic;49;1;1011;2
2020-06-01;CF;Central African Republic;58;2;1069;4
2020-06-02;CF;Central African Republic;0;0;1069;4
2020-06-03;CF;Central African Republic;104;0;1173;4
2020-06-04;CF;Central African Republic;115;0;1288;4
2020-06-05;CF;Central African Republic;163;0;1451;4
2020-06-06;CF;Central African Republic;119;1;1570;5
2020-06-07;CF;Central African Republic;64;0;1634;5
2020-06-08;CF;Central African Republic;216;0;1850;5
2020-06-09;CF;Central African Republic;0;0;1850;5
2020-06-10;CF;Central African Republic;38;0;1888;5
2020-06-11;CF;Central African Republic;64;0;1952;5
2020-06-12;CF;Central African Republic;92;2;2044;7
2020-06-13;CF;Central African Republic;13;0;2057;7
2020-06-14;CF;Central African Republic;0;0;2057;7
2020-06-15;CF;Central African Republic;165;0;2222;7
2020-06-16;CF;Central African Republic;188;7;2410;14
2020-06-17;CF;Central African Republic;154;4;2564;18
2020-06-18;CF;Central African Republic;41;1;2605;19
2020-06-19;CF;Central African Republic;0;0;2605;19
2020-06-20;CF;Central African Republic;81;0;2686;19
2020-06-21;CF;Central African Republic;122;4;2808;23
2020-06-22;CF;Central African Republic;155;7;2963;30
2020-06-23;CF;Central African Republic;88;7;3051;37
2020-06-24;CF;Central African Republic;48;1;3099;38
2020-06-25;CF;Central African Republic;145;2;3244;40
2020-06-26;CF;Central African Republic;96;0;3340;40
2020-06-27;CF;Central African Republic;89;5;3429;45
2020-06-28;CF;Central African Republic;0;0;3429;45
2020-06-29;CF;Central African Republic;184;2;3613;47
2020-06-30;CF;Central African Republic;132;0;3745;47
2020-07-01;CF;Central African Republic;0;0;3745;47
2020-07-02;CF;Central African Republic;43;0;3788;47
2020-07-03;CF;Central African Republic;130;1;3918;48
2020-07-04;CF;Central African Republic;51;0;3969;48
2020-07-05;CF;Central African Republic;0;0;3969;48
2020-07-06;CF;Central African Republic;64;4;4033;52
2020-07-07;CF;Central African Republic;38;0;4071;52
2020-07-08;CF;Central African Republic;38;0;4109;52
2020-07-09;CF;Central African Republic;91;0;4200;52
2020-07-10;CF;Central African Republic;59;1;4259;53
2020-07-11;CF;Central African Republic;29;0;4288;53
2020-07-12;CF;Central African Republic;0;0;4288;53
2020-07-13;CF;Central African Republic;33;0;4321;53
2020-07-14;CF;Central African Republic;35;0;4356;53
2020-07-15;CF;Central African Republic;6;0;4362;53
2020-07-16;CF;Central African Republic;11;0;4373;53
2020-07-17;CF;Central African Republic;16;0;4389;53
2020-07-18;CF;Central African Republic;96;2;4485;55
2020-07-19;CF;Central African Republic;0;0;4485;55
2020-07-20;CF;Central African Republic;63;0;4548;55
2020-07-21;CF;Central African Republic;13;0;4561;55
2020-07-22;CF;Central African Republic;13;2;4574;57
2020-07-23;CF;Central African Republic;16;1;4590;58
2020-07-24;CF;Central African Republic;3;1;4593;59
2020-07-25;CF;Central African Republic;5;0;4598;59
2020-07-26;CF;Central African Republic;1;0;4599;59
2020-07-27;CF;Central African Republic;0;0;4599;59
2020-07-28;CF;Central African Republic;0;0;4599;59
2020-07-29;CF;Central African Republic;6;0;4605;59
2020-07-30;CF;Central African Republic;0;0;4605;59
2020-07-31;CF;Central African Republic;3;0;4608;59
2020-08-01;CF;Central African Republic;6;0;4614;59
2020-08-02;CF;Central African Republic;0;0;4614;59
2020-08-03;CF;Central African Republic;0;0;4614;59
2020-08-04;CF;Central African Republic;4;0;4618;59
2020-08-05;CF;Central African Republic;0;0;4618;59
2020-08-06;CF;Central African Republic;2;0;4620;59
2020-08-07;CF;Central African Republic;21;0;4641;59
2020-08-08;CF;Central African Republic;0;0;4641;59
2020-08-09;CF;Central African Republic;0;1;4641;60
2020-08-10;CF;Central African Republic;0;0;4641;60
2020-08-11;CF;Central African Republic;4;1;4645;61
2020-08-12;CF;Central African Republic;7;0;4652;61
2020-08-13;CF;Central African Republic;0;0;4652;61
2020-08-14;CF;Central African Republic;0;0;4652;61
2020-08-15;CF;Central African Republic;0;0;4652;61
2020-08-16;CF;Central African Republic;0;0;4652;61
2020-08-17;CF;Central African Republic;15;0;4667;61
2020-08-18;CF;Central African Republic;12;0;4679;61
2020-08-19;CF;Central African Republic;0;0;4679;61
2020-08-20;CF;Central African Republic;0;0;4679;61
2020-08-21;CF;Central African Republic;0;0;4679;61
2020-08-22;CF;Central African Republic;0;0;4679;61
2020-08-23;CF;Central African Republic;0;0;4679;61
2020-08-24;CF;Central African Republic;0;0;4679;61
2020-08-25;CF;Central African Republic;12;0;4691;61
2020-08-26;CF;Central African Republic;7;0;4698;61
2020-08-27;CF;Central African Republic;0;0;4698;61
2020-08-28;CF;Central African Republic;2;0;4700;61
2020-08-29;CF;Central African Republic;0;0;4700;61
2020-08-30;CF;Central African Republic;0;0;4700;61
2020-08-31;CF;Central African Republic;11;1;4711;62
2020-09-01;CF;Central African Republic;0;0;4711;62
2020-09-02;CF;Central African Republic;1;0;4712;62
2020-09-03;CF;Central African Republic;17;0;4729;62
2020-09-04;CF;Central African Republic;0;0;4729;62
2020-09-05;CF;Central African Republic;0;0;4729;62
2020-09-06;CF;Central African Republic;0;0;4729;62
2020-09-07;CF;Central African Republic;0;0;4729;62
2020-09-08;CF;Central African Republic;6;0;4735;62
2020-09-09;CF;Central African Republic;1;0;4736;62
2020-09-10;CF;Central African Republic;11;0;4747;62
2020-09-11;CF;Central African Republic;2;0;4749;62
2020-09-12;CF;Central African Republic;0;0;4749;62
2020-09-13;CF;Central African Republic;0;0;4749;62
2020-09-14;CF;Central African Republic;23;0;4772;62
2020-09-15;CF;Central African Republic;0;0;4772;62
2020-09-16;CF;Central African Republic;10;0;4782;62
2020-09-17;CF;Central African Republic;0;0;4782;62
2020-09-18;CF;Central African Republic;4;0;4786;62
2020-09-19;CF;Central African Republic;0;0;4786;62
2020-09-20;CF;Central African Republic;0;0;4786;62
2020-09-21;CF;Central African Republic;0;0;4786;62
2020-09-22;CF;Central African Republic;16;0;4802;62
2020-09-23;CF;Central African Republic;0;0;4802;62
2020-09-24;CF;Central African Republic;2;0;4804;62
2020-09-25;CF;Central African Republic;2;0;4806;62
2020-09-26;CF;Central African Republic;0;0;4806;62
2020-09-27;CF;Central African Republic;0;0;4806;62
2020-09-28;CF;Central African Republic;0;0;4806;62
2020-09-29;CF;Central African Republic;0;0;4806;62
2020-09-30;CF;Central African Republic;23;0;4829;62
2020-10-01;CF;Central African Republic;0;0;4829;62
2020-10-02;CF;Central African Republic;0;0;4829;62
2020-10-03;CF;Central African Republic;16;0;4845;62
2020-10-04;CF;Central African Republic;0;0;4845;62
2020-10-05;CF;Central African Republic;0;0;4845;62
2020-10-06;CF;Central African Republic;7;0;4852;62
2020-10-07;CF;Central African Republic;0;0;4852;62
2020-10-08;CF;Central African Republic;1;0;4853;62
2020-10-09;CF;Central African Republic;0;0;4853;62
2020-10-10;CF;Central African Republic;1;0;4854;62
2020-10-11;CF;Central African Republic;0;0;4854;62
2020-10-12;CF;Central African Republic;0;0;4854;62
2020-10-13;CF;Central African Republic;0;0;4854;62
2020-10-14;CF;Central African Republic;1;0;4855;62
2020-10-15;CF;Central African Republic;0;0;4855;62
2020-10-16;CF;Central African Republic;0;0;4855;62
2020-10-17;CF;Central African Republic;0;0;4855;62
2020-10-18;CF;Central African Republic;0;0;4855;62
2020-10-19;CF;Central African Republic;1;0;4856;62
2020-10-20;CF;Central African Republic;2;0;4858;62
2020-10-21;CF;Central African Republic;0;0;4858;62
2020-10-22;CF;Central African Republic;4;0;4862;62
2020-10-23;CF;Central African Republic;0;0;4862;62
2020-10-24;CF;Central African Republic;0;0;4862;62
2020-10-25;CF;Central African Republic;0;0;4862;62
2020-10-26;CF;Central African Republic;1;0;4863;62
2020-10-27;CF;Central African Republic;0;0;4863;62
2020-10-28;CF;Central African Republic;0;0;4863;62
2020-10-29;CF;Central African Republic;0;0;4863;62
2020-10-30;CF;Central African Republic;3;0;4866;62
2020-10-31;CF;Central African Republic;0;0;4866;62
2020-11-01;CF;Central African Republic;0;0;4866;62
2020-11-02;CF;Central African Republic;0;0;4866;62
2020-11-03;CF;Central African Republic;0;0;4866;62
2020-11-04;CF;Central African Republic;0;0;4866;62
2020-11-05;CF;Central African Republic;0;0;4866;62
2020-11-06;CF;Central African Republic;0;0;4866;62
2020-11-07;CF;Central African Republic;13;0;4879;62
2020-11-08;CF;Central African Republic;0;0;4879;62
2020-11-09;CF;Central African Republic;1;0;4880;62
2020-11-10;CF;Central African Republic;4;0;4884;62
2020-11-11;CF;Central African Republic;0;0;4884;62
2020-11-12;CF;Central African Republic;4;0;4888;62
2020-11-13;CF;Central African Republic;0;0;4888;62
2020-11-14;CF;Central African Republic;8;1;4896;63
2020-11-15;CF;Central African Republic;4;0;4900;63
2020-11-16;CF;Central African Republic;0;0;4900;63
2020-11-17;CF;Central African Republic;0;0;4900;63
2020-11-18;CF;Central African Republic;0;0;4900;63
2020-11-19;CF;Central African Republic;7;0;4907;63
2020-11-20;CF;Central African Republic;4;0;4911;63
2020-11-21;CF;Central African Republic;0;0;4911;63
2020-11-22;CF;Central African Republic;0;0;4911;63
2020-11-23;CF;Central African Republic;0;0;4911;63
2020-11-24;CF;Central African Republic;0;0;4911;63
2020-11-25;CF;Central African Republic;0;0;4911;63
2020-11-26;CF;Central African Republic;2;0;4913;63
2020-11-27;CF;Central African Republic;0;0;4913;63
2020-11-28;CF;Central African Republic;0;0;4913;63
2020-11-29;CF;Central African Republic;0;0;4913;63
2020-11-30;CF;Central African Republic;0;0;4913;63
2020-12-01;CF;Central African Republic;5;0;4918;63
2020-12-02;CF;Central African Republic;0;0;4918;63
2020-12-03;CF;Central African Republic;0;0;4918;63
2020-12-04;CF;Central African Republic;0;0;4918;63
2020-12-05;CF;Central African Republic;4;0;4922;63
2020-12-06;CF;Central African Republic;0;0;4922;63
2020-12-07;CF;Central African Republic;0;0;4922;63
2020-12-08;CF;Central African Republic;5;0;4927;63
2020-12-09;CF;Central African Republic;0;0;4927;63
2020-12-10;CF;Central African Republic;0;0;4927;63
2020-12-11;CF;Central African Republic;9;0;4936;63
2020-12-12;CF;Central African Republic;0;0;4936;63
2020-12-13;CF;Central African Republic;0;0;4936;63
2020-12-14;CF;Central African Republic;0;0;4936;63
2020-12-15;CF;Central African Republic;0;0;4936;63
2020-12-16;CF;Central African Republic;0;0;4936;63
2020-12-17;CF;Central African Republic;0;0;4936;63
2020-12-18;CF;Central African Republic;0;0;4936;63
2020-12-19;CF;Central African Republic;0;0;4936;63
2020-12-20;CF;Central African Republic;0;0;4936;63
2020-12-21;CF;Central African Republic;0;0;4936;63
2020-12-22;CF;Central African Republic;0;0;4936;63
2020-12-23;CF;Central African Republic;12;0;4948;63
2020-12-24;CF;Central African Republic;0;0;4948;63
2020-12-25;CF;Central African Republic;0;0;4948;63
2020-12-26;CF;Central African Republic;0;0;4948;63
2020-12-27;CF;Central African Republic;0;0;4948;63
2020-12-28;CF;Central African Republic;0;0;4948;63
2020-12-29;CF;Central African Republic;13;0;4961;63
2020-12-30;CF;Central African Republic;2;0;4963;63
2020-12-31;CF;Central African Republic;0;0;4963;63
2021-01-01;CF;Central African Republic;0;0;4963;63
2021-01-02;CF;Central African Republic;0;0;4963;63
2021-01-03;CF;Central African Republic;0;0;4963;63
2021-01-04;CF;Central African Republic;0;0;4963;63
2021-01-05;CF;Central African Republic;0;0;4963;63
2021-01-06;CF;Central African Republic;0;0;4963;63
2021-01-07;CF;Central African Republic;6;0;4969;63
2021-01-08;CF;Central African Republic;0;0;4969;63
2021-01-09;CF;Central African Republic;0;0;4969;63
2021-01-10;CF;Central African Republic;4;0;4973;63
2021-01-11;CF;Central African Republic;0;0;4973;63
2021-01-12;CF;Central African Republic;0;0;4973;63
2021-01-13;CF;Central African Republic;0;0;4973;63
2021-01-14;CF;Central African Republic;0;0;4973;63
2021-01-15;CF;Central African Republic;0;0;4973;63
2021-01-16;CF;Central African Republic;0;0;4973;63
2021-01-17;CF;Central African Republic;0;0;4973;63
2021-01-18;CF;Central African Republic;0;0;4973;63
2021-01-19;CF;Central African Republic;0;0;4973;63
2021-01-20;CF;Central African Republic;1;0;4974;63
2021-01-21;CF;Central African Republic;0;0;4974;63
2021-01-22;CF;Central African Republic;0;0;4974;63
2021-01-23;CF;Central African Republic;0;0;4974;63
2021-01-24;CF;Central African Republic;6;0;4980;63
2021-01-25;CF;Central African Republic;0;0;4980;63
2021-01-26;CF;Central African Republic;0;0;4980;63
2021-01-27;CF;Central African Republic;0;0;4980;63
2021-01-28;CF;Central African Republic;1;0;4981;63
2021-01-29;CF;Central African Republic;0;0;4981;63
2021-01-30;CF;Central African Republic;0;0;4981;63
2021-01-31;CF;Central African Republic;0;0;4981;63
2021-02-01;CF;Central African Republic;8;0;4989;63
2021-02-02;CF;Central African Republic;0;0;4989;63
2021-02-03;CF;Central African Republic;0;0;4989;63
2021-02-04;CF;Central African Republic;0;0;4989;63
2021-02-05;CF;Central African Republic;0;0;4989;63
2021-02-06;CF;Central African Republic;0;0;4989;63
2021-02-07;CF;Central African Republic;0;0;4989;63
2021-02-08;CF;Central African Republic;0;0;4989;63
2021-02-09;CF;Central African Republic;0;0;4989;63
2021-02-10;CF;Central African Republic;0;0;4989;63
2021-02-11;CF;Central African Republic;7;0;4996;63
2021-02-12;CF;Central African Republic;0;0;4996;63
2021-02-13;CF;Central African Republic;0;0;4996;63
2021-02-14;CF;Central African Republic;0;0;4996;63
2021-02-15;CF;Central African Republic;0;0;4996;63
2021-02-16;CF;Central African Republic;0;0;4996;63
2021-02-17;CF;Central African Republic;1;0;4997;63
2021-02-18;CF;Central African Republic;0;0;4997;63
2021-02-19;CF;Central African Republic;4;0;5001;63
2021-02-20;CF;Central African Republic;0;0;5001;63
2021-02-21;CF;Central African Republic;0;0;5001;63
2021-02-22;CF;Central African Republic;0;0;5001;63
2021-02-23;CF;Central African Republic;0;0;5001;63
2021-02-24;CF;Central African Republic;3;0;5004;63
2021-02-25;CF;Central African Republic;0;0;5004;63
2021-02-26;CF;Central African Republic;0;0;5004;63
2021-02-27;CF;Central African Republic;0;0;5004;63
2021-02-28;CF;Central African Republic;0;0;5004;63
2021-03-01;CF;Central African Republic;0;0;5004;63
2021-03-02;CF;Central African Republic;0;0;5004;63
2021-03-03;CF;Central African Republic;0;0;5004;63
2021-03-04;CF;Central African Republic;14;0;5018;63
2021-03-05;CF;Central African Republic;0;0;5018;63
2021-03-06;CF;Central African Republic;0;0;5018;63
2021-03-07;CF;Central African Republic;3;0;5021;63
2021-03-08;CF;Central African Republic;0;0;5021;63
2021-03-09;CF;Central African Republic;2;0;5023;63
2021-03-10;CF;Central African Republic;0;0;5023;63
2021-03-11;CF;Central African Republic;0;0;5023;63
2021-03-12;CF;Central African Republic;0;0;5023;63
2021-03-13;CF;Central African Republic;0;0;5023;63
2021-03-14;CF;Central African Republic;0;0;5023;63
2021-03-15;CF;Central African Republic;0;0;5023;63
2021-03-16;CF;Central African Republic;2;0;5025;63
2021-03-17;CF;Central African Republic;39;0;5064;63
2021-03-18;CF;Central African Republic;11;1;5075;64
2021-03-19;CF;Central African Republic;0;0;5075;64
2021-03-20;CF;Central African Republic;0;0;5075;64
2021-03-21;CF;Central African Republic;12;0;5087;64
2021-03-22;CF;Central African Republic;0;0;5087;64
2021-03-23;CF;Central African Republic;0;0;5087;64
2021-03-24;CF;Central African Republic;1;0;5088;64
2021-03-25;CF;Central African Republic;0;0;5088;64
2021-03-26;CF;Central African Republic;0;0;5088;64
2021-03-27;CF;Central African Republic;0;0;5088;64
2021-03-28;CF;Central African Republic;0;0;5088;64
2021-03-29;CF;Central African Republic;0;0;5088;64
2021-03-30;CF;Central African Republic;73;3;5161;67
2021-03-31;CF;Central African Republic;0;0;5161;67
2021-04-01;CF;Central African Republic;61;5;5222;72
2021-04-02;CF;Central African Republic;23;0;5245;72
2021-04-03;CF;Central African Republic;0;0;5245;72
2021-04-04;CF;Central African Republic;0;0;5245;72
2021-04-05;CF;Central African Republic;68;1;5313;73
2021-04-06;CF;Central African Republic;0;0;5313;73
2021-04-07;CF;Central African Republic;40;0;5353;73
2021-04-08;CF;Central African Republic;49;1;5402;74
2021-04-09;CF;Central African Republic;0;0;5402;74
2021-04-10;CF;Central African Republic;89;0;5491;74
2021-04-11;CF;Central African Republic;0;0;5491;74
2021-04-12;CF;Central African Republic;0;0;5491;74
2021-04-13;CF;Central African Republic;191;1;5682;75
2021-04-14;CF;Central African Republic;0;0;5682;75
2021-04-15;CF;Central African Republic;0;0;5682;75
2021-04-16;CF;Central African Republic;46;0;5728;75
2021-04-17;CF;Central African Republic;0;0;5728;75
2021-04-18;CF;Central African Republic;59;0;5787;75
2021-04-19;CF;Central African Republic;0;0;5787;75
2021-04-20;CF;Central African Republic;142;4;5929;79
2021-04-21;CF;Central African Republic;246;6;6175;85
2021-04-22;CF;Central African Republic;0;0;6175;85
2021-04-23;CF;Central African Republic;49;0;6224;85
2021-04-24;CF;Central African Republic;0;0;6224;85
2021-04-25;CF;Central African Republic;0;0;6224;85
2021-04-26;CF;Central African Republic;0;0;6224;85
2021-04-27;CF;Central African Republic;135;2;6359;87
2021-04-28;CF;Central African Republic;0;0;6359;87
2021-04-29;CF;Central African Republic;52;1;6411;88
2021-04-30;CF;Central African Republic;0;0;6411;88
2021-05-01;CF;Central African Republic;0;0;6411;88
2021-05-02;CF;Central African Republic;0;0;6411;88
2021-05-03;CF;Central African Republic;0;0;6411;88
2021-05-04;CF;Central African Republic;110;3;6521;91
2021-05-05;CF;Central African Republic;0;0;6521;91
2021-05-06;CF;Central African Republic;153;2;6674;93
2021-05-07;CF;Central African Republic;0;0;6674;93
2021-05-08;CF;Central African Republic;0;0;6674;93
2021-05-09;CF;Central African Republic;0;0;6674;93
2021-05-10;CF;Central African Republic;0;0;6674;93
2021-05-11;CF;Central African Republic;0;0;6674;93
2021-05-12;CF;Central African Republic;192;2;6866;95
2021-05-13;CF;Central African Republic;0;0;6866;95
2021-05-14;CF;Central African Republic;0;0;6866;95
2021-05-15;CF;Central African Republic;0;0;6866;95
2021-05-16;CF;Central African Republic;0;0;6866;95
2021-05-17;CF;Central African Republic;0;0;6866;95
2021-05-18;CF;Central African Republic;144;1;7010;96
2021-05-19;CF;Central African Republic;0;0;7010;96
2021-05-20;CF;Central African Republic;0;0;7010;96
2021-05-21;CF;Central African Republic;0;0;7010;96
2021-05-22;CF;Central African Republic;0;0;7010;96
2021-05-23;CF;Central African Republic;69;1;7079;97
2021-05-24;CF;Central African Republic;0;0;7079;97
2021-05-25;CF;Central African Republic;0;0;7079;97
2021-05-26;CF;Central African Republic;4;0;7083;97
2021-05-27;CF;Central African Republic;0;0;7083;97
2021-05-28;CF;Central African Republic;2;1;7085;98
2021-05-29;CF;Central African Republic;0;0;7085;98
2021-05-30;CF;Central African Republic;6;0;7091;98
2021-05-31;CF;Central African Republic;0;0;7091;98
2021-06-01;CF;Central African Republic;0;0;7091;98
2021-06-02;CF;Central African Republic;0;0;7091;98
2021-06-03;CF;Central African Republic;0;0;7091;98
2021-06-04;CF;Central African Republic;0;0;7091;98
2021-06-05;CF;Central African Republic;0;0;7091;98
2021-06-06;CF;Central African Republic;0;0;7091;98
2021-06-07;CF;Central African Republic;10;0;7101;98
2021-06-08;CF;Central African Republic;0;0;7101;98
2021-06-09;CF;Central African Republic;0;0;7101;98
2021-06-10;CF;Central African Republic;0;0;7101;98
2021-06-11;CF;Central African Republic;0;0;7101;98
2021-06-12;CF;Central African Republic;0;0;7101;98
2021-06-13;CF;Central African Republic;0;0;7101;98
2021-06-14;CF;Central African Republic;0;0;7101;98
2021-06-15;CF;Central African Republic;0;0;7101;98
2021-06-16;CF;Central African Republic;0;0;7101;98
2021-06-17;CF;Central African Republic;0;0;7101;98
2021-06-18;CF;Central African Republic;0;0;7101;98
2021-06-19;CF;Central African Republic;0;0;7101;98
2021-06-20;CF;Central African Republic;0;0;7101;98
2021-06-21;CF;Central African Republic;28;0;7129;98
2021-06-22;CF;Central African Republic;8;0;7137;98
2021-06-23;CF;Central African Republic;2;0;7139;98
2021-06-24;CF;Central African Republic;0;0;7139;98
2021-06-25;CF;Central African Republic;0;0;7139;98
2021-06-26;CF;Central African Republic;0;0;7139;98
2021-06-27;CF;Central African Republic;0;0;7139;98
2021-06-28;CF;Central African Republic;2;0;7141;98
2021-06-29;CF;Central African Republic;0;0;7141;98
2021-06-30;CF;Central African Republic;0;0;7141;98
2021-07-01;CF;Central African Republic;0;0;7141;98
2020-03-19;TD;Chad;1;0;1;0
2020-03-20;TD;Chad;0;0;1;0
2020-03-21;TD;Chad;0;0;1;0
2020-03-22;TD;Chad;0;0;1;0
2020-03-23;TD;Chad;0;0;1;0
2020-03-24;TD;Chad;2;0;3;0
2020-03-25;TD;Chad;0;0;3;0
2020-03-26;TD;Chad;0;0;3;0
2020-03-27;TD;Chad;0;0;3;0
2020-03-28;TD;Chad;0;0;3;0
2020-03-29;TD;Chad;0;0;3;0
2020-03-30;TD;Chad;2;0;5;0
2020-03-31;TD;Chad;2;0;7;0
2020-04-01;TD;Chad;0;0;7;0
2020-04-02;TD;Chad;1;0;8;0
2020-04-03;TD;Chad;0;0;8;0
2020-04-04;TD;Chad;1;0;9;0
2020-04-05;TD;Chad;0;0;9;0
2020-04-06;TD;Chad;0;0;9;0
2020-04-07;TD;Chad;1;0;10;0
2020-04-08;TD;Chad;0;0;10;0
2020-04-09;TD;Chad;1;0;11;0
2020-04-10;TD;Chad;0;0;11;0
2020-04-11;TD;Chad;0;0;11;0
2020-04-12;TD;Chad;7;0;18;0
2020-04-13;TD;Chad;5;0;23;0
2020-04-14;TD;Chad;0;0;23;0
2020-04-15;TD;Chad;0;0;23;0
2020-04-16;TD;Chad;4;0;27;0
2020-04-17;TD;Chad;0;0;27;0
2020-04-18;TD;Chad;6;0;33;0
2020-04-19;TD;Chad;0;0;33;0
2020-04-20;TD;Chad;0;0;33;0
2020-04-21;TD;Chad;0;0;33;0
2020-04-22;TD;Chad;0;0;33;0
2020-04-23;TD;Chad;0;0;33;0
2020-04-24;TD;Chad;7;0;40;0
2020-04-25;TD;Chad;6;0;46;0
2020-04-26;TD;Chad;0;0;46;0
2020-04-27;TD;Chad;0;0;46;0
2020-04-28;TD;Chad;6;2;52;2
2020-04-29;TD;Chad;0;0;52;2
2020-04-30;TD;Chad;21;3;73;5
2020-05-01;TD;Chad;0;0;73;5
2020-05-02;TD;Chad;44;5;117;10
2020-05-03;TD;Chad;0;0;117;10
2020-05-04;TD;Chad;0;0;117;10
2020-05-05;TD;Chad;53;7;170;17
2020-05-06;TD;Chad;0;0;170;17
2020-05-07;TD;Chad;83;10;253;27
2020-05-08;TD;Chad;7;1;260;28
2020-05-09;TD;Chad;62;3;322;31
2020-05-10;TD;Chad;0;0;322;31
2020-05-11;TD;Chad;0;0;322;31
2020-05-12;TD;Chad;35;9;357;40
2020-05-13;TD;Chad;15;2;372;42
2020-05-14;TD;Chad;27;4;399;46
2020-05-15;TD;Chad;29;2;428;48
2020-05-16;TD;Chad;46;2;474;50
2020-05-17;TD;Chad;29;3;503;53
2020-05-18;TD;Chad;16;0;519;53
2020-05-19;TD;Chad;26;3;545;56
2020-05-20;TD;Chad;20;1;565;57
2020-05-21;TD;Chad;23;1;588;58
2020-05-22;TD;Chad;23;0;611;58
2020-05-23;TD;Chad;37;2;648;60
2020-05-24;TD;Chad;27;0;675;60
2020-05-25;TD;Chad;12;1;687;61
2020-05-26;TD;Chad;13;1;700;62
2020-05-27;TD;Chad;15;2;715;64
2020-05-28;TD;Chad;11;1;726;65
2020-05-29;TD;Chad;33;0;759;65
2020-05-30;TD;Chad;0;0;759;65
2020-05-31;TD;Chad;19;0;778;65
2020-06-01;TD;Chad;12;1;790;66
2020-06-02;TD;Chad;13;0;803;66
2020-06-03;TD;Chad;17;0;820;66
2020-06-04;TD;Chad;8;0;828;66
2020-06-05;TD;Chad;8;2;836;68
2020-06-06;TD;Chad;0;1;836;69
2020-06-07;TD;Chad;1;0;837;69
2020-06-08;TD;Chad;2;1;839;70
2020-06-09;TD;Chad;5;1;844;71
2020-06-10;TD;Chad;2;1;846;72
2020-06-11;TD;Chad;2;0;848;72
2020-06-12;TD;Chad;0;0;848;72
2020-06-13;TD;Chad;0;0;848;72
2020-06-14;TD;Chad;2;1;850;73
2020-06-15;TD;Chad;0;0;850;73
2020-06-16;TD;Chad;3;1;853;74
2020-06-17;TD;Chad;1;0;854;74
2020-06-18;TD;Chad;0;0;854;74
2020-06-19;TD;Chad;4;0;858;74
2020-06-20;TD;Chad;0;0;858;74
2020-06-21;TD;Chad;0;0;858;74
2020-06-22;TD;Chad;0;0;858;74
2020-06-23;TD;Chad;2;0;860;74
2020-06-24;TD;Chad;0;0;860;74
2020-06-25;TD;Chad;3;0;863;74
2020-06-26;TD;Chad;2;0;865;74
2020-06-27;TD;Chad;0;0;865;74
2020-06-28;TD;Chad;1;0;866;74
2020-06-29;TD;Chad;0;0;866;74
2020-06-30;TD;Chad;0;0;866;74
2020-07-01;TD;Chad;0;0;866;74
2020-07-02;TD;Chad;2;0;868;74
2020-07-03;TD;Chad;3;0;871;74
2020-07-04;TD;Chad;0;0;871;74
2020-07-05;TD;Chad;1;0;872;74
2020-07-06;TD;Chad;0;0;872;74
2020-07-07;TD;Chad;1;0;873;74
2020-07-08;TD;Chad;0;0;873;74
2020-07-09;TD;Chad;0;0;873;74
2020-07-10;TD;Chad;1;0;874;74
2020-07-11;TD;Chad;0;0;874;74
2020-07-12;TD;Chad;6;1;880;75
2020-07-13;TD;Chad;0;0;880;75
2020-07-14;TD;Chad;4;0;884;75
2020-07-15;TD;Chad;1;0;885;75
2020-07-16;TD;Chad;1;0;886;75
2020-07-17;TD;Chad;1;0;887;75
2020-07-18;TD;Chad;2;0;889;75
2020-07-19;TD;Chad;0;0;889;75
2020-07-20;TD;Chad;0;0;889;75
2020-07-21;TD;Chad;0;0;889;75
2020-07-22;TD;Chad;0;0;889;75
2020-07-23;TD;Chad;26;0;915;75
2020-07-24;TD;Chad;0;0;915;75
2020-07-25;TD;Chad;0;0;915;75
2020-07-26;TD;Chad;0;0;915;75
2020-07-27;TD;Chad;7;0;922;75
2020-07-28;TD;Chad;4;0;926;75
2020-07-29;TD;Chad;0;0;926;75
2020-07-30;TD;Chad;9;0;935;75
2020-07-31;TD;Chad;1;0;936;75
2020-08-01;TD;Chad;0;0;936;75
2020-08-02;TD;Chad;0;0;936;75
2020-08-03;TD;Chad;0;0;936;75
2020-08-04;TD;Chad;2;0;938;75
2020-08-05;TD;Chad;1;0;939;75
2020-08-06;TD;Chad;3;1;942;76
2020-08-07;TD;Chad;0;0;942;76
2020-08-08;TD;Chad;0;0;942;76
2020-08-09;TD;Chad;2;0;944;76
2020-08-10;TD;Chad;1;0;945;76
2020-08-11;TD;Chad;1;0;946;76
2020-08-12;TD;Chad;3;0;949;76
2020-08-13;TD;Chad;0;0;949;76
2020-08-14;TD;Chad;2;0;951;76
2020-08-15;TD;Chad;1;0;952;76
2020-08-16;TD;Chad;4;0;956;76
2020-08-17;TD;Chad;3;0;959;76
2020-08-18;TD;Chad;11;0;970;76
2020-08-19;TD;Chad;1;0;971;76
2020-08-20;TD;Chad;1;0;972;76
2020-08-21;TD;Chad;9;0;981;76
2020-08-22;TD;Chad;1;0;982;76
2020-08-23;TD;Chad;4;0;986;76
2020-08-24;TD;Chad;1;0;987;76
2020-08-25;TD;Chad;8;1;995;77
2020-08-26;TD;Chad;3;0;998;77
2020-08-27;TD;Chad;6;0;1004;77
2020-08-28;TD;Chad;4;0;1008;77
2020-08-29;TD;Chad;0;0;1008;77
2020-08-30;TD;Chad;4;0;1012;77
2020-08-31;TD;Chad;1;0;1013;77
2020-09-01;TD;Chad;4;0;1017;77
2020-09-02;TD;Chad;0;0;1017;77
2020-09-03;TD;Chad;1;0;1018;77
2020-09-04;TD;Chad;5;0;1023;77
2020-09-05;TD;Chad;11;0;1034;77
2020-09-06;TD;Chad;5;2;1039;79
2020-09-07;TD;Chad;1;0;1040;79
2020-09-08;TD;Chad;5;0;1045;79
2020-09-09;TD;Chad;3;0;1048;79
2020-09-10;TD;Chad;3;0;1051;79
2020-09-11;TD;Chad;30;0;1081;79
2020-09-12;TD;Chad;2;1;1083;80
2020-09-13;TD;Chad;1;0;1084;80
2020-09-14;TD;Chad;1;1;1085;81
2020-09-15;TD;Chad;2;0;1087;81
2020-09-16;TD;Chad;3;0;1090;81
2020-09-17;TD;Chad;25;0;1115;81
2020-09-18;TD;Chad;32;0;1147;81
2020-09-19;TD;Chad;2;0;1149;81
2020-09-20;TD;Chad;2;0;1151;81
2020-09-21;TD;Chad;2;0;1153;81
2020-09-22;TD;Chad;2;0;1155;81
2020-09-23;TD;Chad;9;1;1164;82
2020-09-24;TD;Chad;7;0;1171;82
2020-09-25;TD;Chad;4;1;1175;83
2020-09-26;TD;Chad;2;0;1177;83
2020-09-27;TD;Chad;1;1;1178;84
2020-09-28;TD;Chad;7;1;1185;85
2020-09-29;TD;Chad;8;0;1193;85
2020-09-30;TD;Chad;7;0;1200;85
2020-10-01;TD;Chad;3;0;1203;85
2020-10-02;TD;Chad;8;0;1211;85
2020-10-03;TD;Chad;3;0;1214;85
2020-10-04;TD;Chad;3;1;1217;86
2020-10-05;TD;Chad;6;0;1223;86
2020-10-06;TD;Chad;15;2;1238;88
2020-10-07;TD;Chad;13;1;1251;89
2020-10-08;TD;Chad;11;0;1262;89
2020-10-09;TD;Chad;12;1;1274;90
2020-10-10;TD;Chad;17;2;1291;92
2020-10-11;TD;Chad;13;0;1304;92
2020-10-12;TD;Chad;4;0;1308;92
2020-10-13;TD;Chad;13;0;1321;92
2020-10-14;TD;Chad;8;0;1329;92
2020-10-15;TD;Chad;21;0;1350;92
2020-10-16;TD;Chad;11;1;1361;93
2020-10-17;TD;Chad;4;0;1365;93
2020-10-18;TD;Chad;14;0;1379;93
2020-10-19;TD;Chad;11;0;1390;93
2020-10-20;TD;Chad;9;0;1399;93
2020-10-21;TD;Chad;5;3;1404;96
2020-10-22;TD;Chad;6;0;1410;96
2020-10-23;TD;Chad;13;0;1423;96
2020-10-24;TD;Chad;11;0;1434;96
2020-10-25;TD;Chad;3;0;1437;96
2020-10-26;TD;Chad;4;0;1441;96
2020-10-27;TD;Chad;19;0;1460;96
2020-10-28;TD;Chad;8;1;1468;97
2020-10-29;TD;Chad;5;0;1473;97
2020-10-30;TD;Chad;10;1;1483;98
2020-10-31;TD;Chad;0;0;1483;98
2020-11-01;TD;Chad;15;0;1498;98
2020-11-02;TD;Chad;1;0;1499;98
2020-11-03;TD;Chad;14;0;1513;98
2020-11-04;TD;Chad;4;1;1517;99
2020-11-05;TD;Chad;12;0;1529;99
2020-11-06;TD;Chad;9;0;1538;99
2020-11-07;TD;Chad;5;0;1543;99
2020-11-08;TD;Chad;4;0;1547;99
2020-11-09;TD;Chad;4;0;1551;99
2020-11-10;TD;Chad;10;0;1561;99
2020-11-11;TD;Chad;4;0;1565;99
2020-11-12;TD;Chad;13;1;1578;100
2020-11-13;TD;Chad;11;0;1589;100
2020-11-14;TD;Chad;2;0;1591;100
2020-11-15;TD;Chad;6;1;1597;101
2020-11-16;TD;Chad;6;0;1603;101
2020-11-17;TD;Chad;5;0;1608;101
2020-11-18;TD;Chad;8;0;1616;101
2020-11-19;TD;Chad;4;0;1620;101
2020-11-20;TD;Chad;6;0;1626;101
2020-11-21;TD;Chad;7;0;1633;101
2020-11-22;TD;Chad;9;0;1642;101
2020-11-23;TD;Chad;6;0;1648;101
2020-11-24;TD;Chad;1;0;1649;101
2020-11-25;TD;Chad;6;0;1655;101
2020-11-26;TD;Chad;6;0;1661;101
2020-11-27;TD;Chad;2;0;1663;101
2020-11-28;TD;Chad;0;0;1663;101
2020-11-29;TD;Chad;19;0;1682;101
2020-11-30;TD;Chad;6;0;1688;101
2020-12-01;TD;Chad;12;1;1700;102
2020-12-02;TD;Chad;5;0;1705;102
2020-12-03;TD;Chad;3;0;1708;102
2020-12-04;TD;Chad;11;0;1719;102
2020-12-05;TD;Chad;3;0;1722;102
2020-12-06;TD;Chad;3;0;1725;102
2020-12-07;TD;Chad;3;0;1728;102
2020-12-08;TD;Chad;1;0;1729;102
2020-12-09;TD;Chad;3;0;1732;102
2020-12-10;TD;Chad;7;0;1739;102
2020-12-11;TD;Chad;6;0;1745;102
2020-12-12;TD;Chad;6;0;1751;102
2020-12-13;TD;Chad;19;0;1770;102
2020-12-14;TD;Chad;1;0;1771;102
2020-12-15;TD;Chad;13;0;1784;102
2020-12-16;TD;Chad;16;0;1800;102
2020-12-17;TD;Chad;18;0;1818;102
2020-12-18;TD;Chad;21;0;1839;102
2020-12-19;TD;Chad;28;0;1867;102
2020-12-20;TD;Chad;23;0;1890;102
2020-12-21;TD;Chad;12;0;1902;102
2020-12-22;TD;Chad;14;0;1916;102
2020-12-23;TD;Chad;22;0;1938;102
2020-12-24;TD;Chad;20;0;1958;102
2020-12-25;TD;Chad;13;0;1971;102
2020-12-26;TD;Chad;15;1;1986;103
2020-12-27;TD;Chad;19;1;2005;104
2020-12-28;TD;Chad;10;0;2015;104
2020-12-29;TD;Chad;33;0;2048;104
2020-12-30;TD;Chad;29;0;2077;104
2020-12-31;TD;Chad;36;0;2113;104
2021-01-01;TD;Chad;28;0;2141;104
2021-01-02;TD;Chad;28;0;2169;104
2021-01-03;TD;Chad;44;0;2213;104
2021-01-04;TD;Chad;16;0;2229;104
2021-01-05;TD;Chad;60;1;2289;105
2021-01-06;TD;Chad;39;0;2328;105
2021-01-07;TD;Chad;30;0;2358;105
2021-01-08;TD;Chad;61;1;2419;106
2021-01-09;TD;Chad;91;1;2510;107
2021-01-10;TD;Chad;27;0;2537;107
2021-01-11;TD;Chad;52;0;2589;107
2021-01-12;TD;Chad;79;1;2668;108
2021-01-13;TD;Chad;41;1;2709;109
2021-01-14;TD;Chad;64;1;2773;110
2021-01-15;TD;Chad;34;1;2807;111
2021-01-16;TD;Chad;48;0;2855;111
2021-01-17;TD;Chad;40;0;2895;111
2021-01-18;TD;Chad;24;2;2919;113
2021-01-19;TD;Chad;58;1;2977;114
2021-01-20;TD;Chad;35;0;3012;114
2021-01-21;TD;Chad;53;0;3065;114
2021-01-22;TD;Chad;39;1;3104;115
2021-01-23;TD;Chad;33;0;3137;115
2021-01-24;TD;Chad;24;1;3161;116
2021-01-25;TD;Chad;21;0;3182;116
2021-01-26;TD;Chad;43;0;3225;116
2021-01-27;TD;Chad;44;1;3269;117
2021-01-28;TD;Chad;27;1;3296;118
2021-01-29;TD;Chad;25;0;3321;118
2021-01-30;TD;Chad;26;0;3347;118
2021-01-31;TD;Chad;29;0;3376;118
2021-02-01;TD;Chad;9;3;3385;121
2021-02-02;TD;Chad;19;0;3404;121
2021-02-03;TD;Chad;15;0;3419;121
2021-02-04;TD;Chad;14;0;3433;121
2021-02-05;TD;Chad;17;3;3450;124
2021-02-06;TD;Chad;23;1;3473;125
2021-02-07;TD;Chad;24;0;3497;125
2021-02-08;TD;Chad;11;0;3508;125
2021-02-09;TD;Chad;31;0;3539;125
2021-02-10;TD;Chad;29;1;3568;126
2021-02-11;TD;Chad;13;0;3581;126
2021-02-12;TD;Chad;16;2;3597;128
2021-02-13;TD;Chad;25;0;3622;128
2021-02-14;TD;Chad;23;1;3645;129
2021-02-15;TD;Chad;19;2;3664;131
2021-02-16;TD;Chad;25;0;3689;131
2021-02-17;TD;Chad;35;1;3724;132
2021-02-18;TD;Chad;27;0;3751;132
2021-02-19;TD;Chad;25;0;3776;132
2021-02-20;TD;Chad;18;1;3794;133
2021-02-21;TD;Chad;55;1;3849;134
2021-02-22;TD;Chad;19;1;3868;135
2021-02-23;TD;Chad;14;1;3882;136
2021-02-24;TD;Chad;22;0;3904;136
2021-02-25;TD;Chad;30;1;3934;137
2021-02-26;TD;Chad;23;1;3957;138
2021-02-27;TD;Chad;16;2;3973;140
2021-02-28;TD;Chad;0;0;3973;140
2021-03-01;TD;Chad;13;0;3986;140
2021-03-02;TD;Chad;13;0;3999;140
2021-03-03;TD;Chad;57;0;4056;140
2021-03-04;TD;Chad;33;0;4089;140
2021-03-05;TD;Chad;0;0;4089;140
2021-03-06;TD;Chad;72;0;4161;140
2021-03-07;TD;Chad;16;0;4177;140
2021-03-08;TD;Chad;16;6;4193;146
2021-03-09;TD;Chad;21;2;4214;148
2021-03-10;TD;Chad;17;1;4231;149
2021-03-11;TD;Chad;15;2;4246;151
2021-03-12;TD;Chad;28;1;4274;152
2021-03-13;TD;Chad;14;1;4288;153
2021-03-14;TD;Chad;21;1;4309;154
2021-03-15;TD;Chad;19;1;4328;155
2021-03-16;TD;Chad;16;0;4344;155
2021-03-17;TD;Chad;13;1;4357;156
2021-03-18;TD;Chad;23;1;4380;157
2021-03-19;TD;Chad;15;0;4395;157
2021-03-20;TD;Chad;15;0;4410;157
2021-03-21;TD;Chad;10;0;4420;157
2021-03-22;TD;Chad;7;0;4427;157
2021-03-23;TD;Chad;13;1;4440;158
2021-03-24;TD;Chad;13;0;4453;158
2021-03-25;TD;Chad;12;0;4465;158
2021-03-26;TD;Chad;15;0;4480;158
2021-03-27;TD;Chad;21;2;4501;160
2021-03-28;TD;Chad;5;2;4506;162
2021-03-29;TD;Chad;4;2;4510;164
2021-03-30;TD;Chad;13;0;4523;164
2021-03-31;TD;Chad;10;0;4533;164
2021-04-01;TD;Chad;19;0;4552;164
2021-04-02;TD;Chad;21;0;4573;164
2021-04-03;TD;Chad;16;0;4589;164
2021-04-04;TD;Chad;6;1;4595;165
2021-04-05;TD;Chad;0;1;4595;166
2021-04-06;TD;Chad;8;0;4603;166
2021-04-07;TD;Chad;3;0;4606;166
2021-04-08;TD;Chad;10;1;4616;167
2021-04-09;TD;Chad;3;0;4619;167
2021-04-10;TD;Chad;6;0;4625;167
2021-04-11;TD;Chad;11;0;4636;167
2021-04-12;TD;Chad;5;0;4641;167
2021-04-13;TD;Chad;11;0;4652;167
2021-04-14;TD;Chad;10;0;4662;167
2021-04-15;TD;Chad;11;1;4673;168
2021-04-16;TD;Chad;13;0;4686;168
2021-04-17;TD;Chad;5;0;4691;168
2021-04-18;TD;Chad;15;1;4706;169
2021-04-19;TD;Chad;2;0;4708;169
2021-04-20;TD;Chad;15;0;4723;169
2021-04-21;TD;Chad;8;0;4731;169
2021-04-22;TD;Chad;4;0;4735;169
2021-04-23;TD;Chad;12;0;4747;169
2021-04-24;TD;Chad;5;0;4752;169
2021-04-25;TD;Chad;18;0;4770;169
2021-04-26;TD;Chad;2;0;4772;169
2021-04-27;TD;Chad;7;1;4779;170
2021-04-28;TD;Chad;10;0;4789;170
2021-04-29;TD;Chad;21;0;4810;170
2021-04-30;TD;Chad;7;0;4817;170
2021-05-01;TD;Chad;7;0;4824;170
2021-05-02;TD;Chad;4;0;4828;170
2021-05-03;TD;Chad;0;0;4828;170
2021-05-04;TD;Chad;7;0;4835;170
2021-05-05;TD;Chad;12;0;4847;170
2021-05-06;TD;Chad;7;0;4854;170
2021-05-07;TD;Chad;8;0;4862;170
2021-05-08;TD;Chad;12;1;4874;171
2021-05-09;TD;Chad;3;0;4877;171
2021-05-10;TD;Chad;5;0;4882;171
2021-05-11;TD;Chad;6;1;4888;172
2021-05-12;TD;Chad;3;0;4891;172
2021-05-13;TD;Chad;4;0;4895;172
2021-05-14;TD;Chad;2;1;4897;173
2021-05-15;TD;Chad;4;0;4901;173
2021-05-16;TD;Chad;3;0;4904;173
2021-05-17;TD;Chad;0;0;4904;173
2021-05-18;TD;Chad;1;0;4905;173
2021-05-19;TD;Chad;9;0;4914;173
2021-05-20;TD;Chad;4;0;4918;173
2021-05-21;TD;Chad;1;0;4919;173
2021-05-22;TD;Chad;4;0;4923;173
2021-05-23;TD;Chad;1;0;4924;173
2021-05-24;TD;Chad;0;0;4924;173
2021-05-25;TD;Chad;0;0;4924;173
2021-05-26;TD;Chad;1;0;4925;173
2021-05-27;TD;Chad;1;0;4926;173
2021-05-28;TD;Chad;1;0;4927;173
2021-05-29;TD;Chad;1;0;4928;173
2021-05-30;TD;Chad;1;0;4929;173
2021-05-31;TD;Chad;2;0;4931;173
2021-06-01;TD;Chad;3;0;4934;173
2021-06-02;TD;Chad;1;0;4935;173
2021-06-03;TD;Chad;0;0;4935;173
2021-06-04;TD;Chad;3;1;4938;174
2021-06-05;TD;Chad;1;0;4939;174
2021-06-06;TD;Chad;0;0;4939;174
2021-06-07;TD;Chad;1;0;4940;174
2021-06-08;TD;Chad;2;0;4942;174
2021-06-09;TD;Chad;0;0;4942;174
2021-06-10;TD;Chad;0;0;4942;174
2021-06-11;TD;Chad;0;0;4942;174
2021-06-12;TD;Chad;0;0;4942;174
2021-06-13;TD;Chad;0;0;4942;174
2021-06-14;TD;Chad;1;0;4943;174
2021-06-15;TD;Chad;0;0;4943;174
2021-06-16;TD;Chad;0;0;4943;174
2021-06-17;TD;Chad;1;0;4944;174
2021-06-18;TD;Chad;1;0;4945;174
2021-06-19;TD;Chad;1;0;4946;174
2021-06-20;TD;Chad;0;0;4946;174
2021-06-21;TD;Chad;1;0;4947;174
2021-06-22;TD;Chad;1;0;4948;174
2021-06-23;TD;Chad;3;0;4951;174
2021-06-24;TD;Chad;0;0;4951;174
2021-06-25;TD;Chad;0;0;4951;174
2021-06-26;TD;Chad;0;0;4951;174
2021-06-27;TD;Chad;0;0;4951;174
2021-06-28;TD;Chad;0;0;4951;174
2021-06-29;TD;Chad;0;0;4951;174
2021-06-30;TD;Chad;0;0;4951;174
2021-07-01;TD;Chad;0;0;4951;174
2020-02-23;CL;Chile;2;0;2;0
2020-02-24;CL;Chile;0;0;2;0
2020-02-25;CL;Chile;0;0;2;0
2020-02-26;CL;Chile;0;0;2;0
2020-02-27;CL;Chile;0;0;2;0
2020-02-28;CL;Chile;0;0;2;0
2020-02-29;CL;Chile;0;0;2;0
2020-03-01;CL;Chile;7;0;9;0
2020-03-02;CL;Chile;0;0;9;0
2020-03-03;CL;Chile;1;0;10;0
2020-03-04;CL;Chile;0;0;10;0
2020-03-05;CL;Chile;3;0;13;0
2020-03-06;CL;Chile;0;0;13;0
2020-03-07;CL;Chile;0;0;13;0
2020-03-08;CL;Chile;7;0;20;0
2020-03-09;CL;Chile;0;0;20;0
2020-03-10;CL;Chile;5;0;25;0
2020-03-11;CL;Chile;10;0;35;0
2020-03-12;CL;Chile;0;0;35;0
2020-03-13;CL;Chile;20;0;55;0
2020-03-14;CL;Chile;33;0;88;0
2020-03-15;CL;Chile;13;0;101;0
2020-03-16;CL;Chile;81;0;182;0
2020-03-17;CL;Chile;46;0;228;0
2020-03-18;CL;Chile;37;0;265;0
2020-03-19;CL;Chile;0;0;265;0
2020-03-20;CL;Chile;196;0;461;0
2020-03-21;CL;Chile;131;0;592;0
2020-03-22;CL;Chile;95;1;687;1
2020-03-23;CL;Chile;114;1;801;2
2020-03-24;CL;Chile;176;0;977;2
2020-03-25;CL;Chile;220;1;1197;3
2020-03-26;CL;Chile;164;1;1361;4
2020-03-27;CL;Chile;304;1;1665;5
2020-03-28;CL;Chile;350;1;2015;6
2020-03-29;CL;Chile;230;1;2245;7
2020-03-30;CL;Chile;310;1;2555;8
2020-03-31;CL;Chile;289;4;2844;12
2020-04-01;CL;Chile;293;4;3137;16
2020-04-02;CL;Chile;373;2;3510;18
2020-04-03;CL;Chile;333;4;3843;22
2020-04-04;CL;Chile;512;5;4355;27
2020-04-05;CL;Chile;310;7;4665;34
2020-04-06;CL;Chile;344;3;5009;37
2020-04-07;CL;Chile;301;6;5310;43
2020-04-08;CL;Chile;430;5;5740;48
2020-04-09;CL;Chile;426;9;6166;57
2020-04-10;CL;Chile;529;8;6695;65
2020-04-11;CL;Chile;671;8;7366;73
2020-04-12;CL;Chile;286;7;7652;80
2020-04-13;CL;Chile;312;2;7964;82
2020-04-14;CL;Chile;392;10;8356;92
2020-04-15;CL;Chile;356;2;8712;94
2020-04-16;CL;Chile;534;11;9246;105
2020-04-17;CL;Chile;445;11;9691;116
2020-04-18;CL;Chile;907;10;10598;126
2020-04-19;CL;Chile;358;7;10956;133
2020-04-20;CL;Chile;419;6;11375;139
2020-04-21;CL;Chile;325;8;11700;147
2020-04-22;CL;Chile;464;13;12164;160
2020-04-23;CL;Chile;516;8;12680;168
2020-04-24;CL;Chile;494;6;13174;174
2020-04-25;CL;Chile;1363;7;14537;181
2020-04-26;CL;Chile;473;8;15010;189
2020-04-27;CL;Chile;482;9;15492;198
2020-04-28;CL;Chile;552;9;16044;207
2020-04-29;CL;Chile;520;9;16564;216
2020-04-30;CL;Chile;1138;11;17702;227
2020-05-01;CL;Chile;985;7;18687;234
2020-05-02;CL;Chile;2526;13;21213;247
2020-05-03;CL;Chile;1228;13;22441;260
2020-05-04;CL;Chile;980;10;23421;270
2020-05-05;CL;Chile;1373;5;24794;275
2020-05-06;CL;Chile;1032;6;25826;281
2020-05-07;CL;Chile;1533;4;27359;285
2020-05-08;CL;Chile;1391;9;28750;294
2020-05-09;CL;Chile;3458;10;32208;304
2020-05-10;CL;Chile;1647;8;33855;312
2020-05-11;CL;Chile;1197;11;35052;323
2020-05-12;CL;Chile;1658;12;36710;335
2020-05-13;CL;Chile;2660;11;39370;346
2020-05-14;CL;Chile;2659;22;42029;368
2020-05-15;CL;Chile;2502;26;44531;394
2020-05-16;CL;Chile;5485;27;50016;421
2020-05-17;CL;Chile;2353;29;52369;450
2020-05-18;CL;Chile;2278;28;54647;478
2020-05-19;CL;Chile;3520;31;58167;509
2020-05-20;CL;Chile;4038;35;62205;544
2020-05-21;CL;Chile;3964;45;66169;589
2020-05-22;CL;Chile;4276;41;70445;630
2020-05-23;CL;Chile;9842;43;80287;673
2020-05-24;CL;Chile;3709;45;83996;718
2020-05-25;CL;Chile;4895;43;88891;761
2020-05-26;CL;Chile;3964;45;92855;806
2020-05-27;CL;Chile;4328;35;97183;841
2020-05-28;CL;Chile;4654;49;101837;890
2020-05-29;CL;Chile;3695;54;105532;944
2020-05-30;CL;Chile;13188;53;118720;997
2020-05-31;CL;Chile;4830;57;123550;1054
2020-06-01;CL;Chile;5470;59;129020;1113
2020-06-02;CL;Chile;3528;75;132548;1188
2020-06-03;CL;Chile;4942;87;137490;1275
2020-06-04;CL;Chile;4664;81;142154;1356
2020-06-05;CL;Chile;4207;92;146361;1448
2020-06-06;CL;Chile;13990;93;160351;1541
2020-06-07;CL;Chile;6405;96;166756;1637
2020-06-08;CL;Chile;4696;627;171452;2264
2020-06-09;CL;Chile;3913;19;175365;2283
2020-06-10;CL;Chile;5697;192;181062;2475
2020-06-11;CL;Chile;5636;173;186698;2648
2020-06-12;CL;Chile;6754;222;193452;2870
2020-06-13;CL;Chile;8182;231;201634;3101
2020-06-14;CL;Chile;6938;222;208572;3323
2020-06-15;CL;Chile;5143;39;213715;3362
2020-06-16;CL;Chile;5013;21;218728;3383
2020-06-17;CL;Chile;1900;232;220628;3615
2020-06-18;CL;Chile;4475;226;225103;3841
2020-06-19;CL;Chile;6290;252;231393;4093
2020-06-20;CL;Chile;5355;202;236748;4295
2020-06-21;CL;Chile;5607;184;242355;4479
2020-06-22;CL;Chile;4608;23;246963;4502
2020-06-23;CL;Chile;3804;3;250767;4505
2020-06-24;CL;Chile;3649;226;254416;4731
2020-06-25;CL;Chile;4648;172;259064;4903
2020-06-26;CL;Chile;4296;165;263360;5068
2020-06-27;CL;Chile;4406;279;267766;5347
2020-06-28;CL;Chile;4216;162;271982;5509
2020-06-29;CL;Chile;4017;66;275999;5575
2020-06-30;CL;Chile;3394;113;279393;5688
2020-07-01;CL;Chile;2650;65;282043;5753
2020-07-02;CL;Chile;2498;167;284541;5920
2020-07-03;CL;Chile;3548;131;288089;6051
2020-07-04;CL;Chile;3758;141;291847;6192
2020-07-05;CL;Chile;3685;116;295532;6308
2020-07-06;CL;Chile;3025;76;298557;6384
2020-07-07;CL;Chile;2462;50;301019;6434
2020-07-08;CL;Chile;2064;139;303083;6573
2020-07-09;CL;Chile;3133;109;306216;6682
2020-07-10;CL;Chile;3058;99;309274;6781
2020-07-11;CL;Chile;2755;100;312029;6881
2020-07-12;CL;Chile;3012;98;315041;6979
2020-07-13;CL;Chile;2616;45;317657;7024
2020-07-14;CL;Chile;1836;45;319493;7069
2020-07-15;CL;Chile;1712;117;321205;7186
2020-07-16;CL;Chile;2493;104;323698;7290
2020-07-17;CL;Chile;2741;1057;326439;8347
2020-07-18;CL;Chile;2407;98;328846;8445
2020-07-19;CL;Chile;2084;58;330930;8503
2020-07-20;CL;Chile;2099;130;333029;8633
2020-07-21;CL;Chile;1654;44;334683;8677
2020-07-22;CL;Chile;1719;45;336402;8722
2020-07-23;CL;Chile;2357;116;338759;8838
2020-07-24;CL;Chile;2545;76;341304;8914
2020-07-25;CL;Chile;2288;106;343592;9020
2020-07-26;CL;Chile;2198;92;345790;9112
2020-07-27;CL;Chile;2133;75;347923;9187
2020-07-28;CL;Chile;1877;53;349800;9240
2020-07-29;CL;Chile;1775;38;351575;9278
2020-07-30;CL;Chile;1961;99;353536;9377
2020-07-31;CL;Chile;2131;80;355667;9457
2020-08-01;CL;Chile;1991;76;357658;9533
2020-08-02;CL;Chile;2073;75;359731;9608
2020-08-03;CL;Chile;1762;99;361493;9707
2020-08-04;CL;Chile;1469;38;362962;9745
2020-08-05;CL;Chile;1761;47;364723;9792
2020-08-06;CL;Chile;1948;97;366671;9889
2020-08-07;CL;Chile;2154;69;368825;9958
2020-08-08;CL;Chile;2198;53;371023;10011
2020-08-09;CL;Chile;2033;66;373056;10077
2020-08-10;CL;Chile;1988;62;375044;10139
2020-08-11;CL;Chile;1572;39;376616;10178
2020-08-12;CL;Chile;1552;27;378168;10205
2020-08-13;CL;Chile;1866;94;380034;10299
2020-08-14;CL;Chile;2077;41;382111;10340
2020-08-15;CL;Chile;1791;55;383902;10395
2020-08-16;CL;Chile;2044;57;385946;10452
2020-08-17;CL;Chile;1556;61;387502;10513
2020-08-18;CL;Chile;1353;33;388855;10546
2020-08-19;CL;Chile;1182;32;390037;10578
2020-08-20;CL;Chile;1812;93;391849;10671
2020-08-21;CL;Chile;1920;52;393769;10723
2020-08-22;CL;Chile;1939;69;395708;10792
2020-08-23;CL;Chile;1957;60;397665;10852
2020-08-24;CL;Chile;1903;64;399568;10916
2020-08-25;CL;Chile;1417;42;400985;10958
2020-08-26;CL;Chile;1380;32;402365;10990
2020-08-27;CL;Chile;1737;82;404102;11072
2020-08-28;CL;Chile;1870;60;405972;11132
2020-08-29;CL;Chile;2037;49;408009;11181
2020-08-30;CL;Chile;1965;63;409974;11244
2020-08-31;CL;Chile;1752;45;411726;11289
2020-09-01;CL;Chile;1419;32;413145;11321
2020-09-02;CL;Chile;1594;23;414739;11344
2020-09-03;CL;Chile;1762;78;416501;11422
2020-09-04;CL;Chile;1968;72;418469;11494
2020-09-05;CL;Chile;1965;57;420434;11551
2020-09-06;CL;Chile;2076;41;422510;11592
2020-09-07;CL;Chile;1764;60;424274;11652
2020-09-08;CL;Chile;1267;30;425541;11682
2020-09-09;CL;Chile;1486;20;427027;11702
2020-09-10;CL;Chile;1642;79;428669;11781
2020-09-11;CL;Chile;1866;69;430535;11850
2020-09-12;CL;Chile;2131;45;432666;11895
2020-09-13;CL;Chile;2082;54;434748;11949
2020-09-14;CL;Chile;1685;64;436433;12013
2020-09-15;CL;Chile;1550;27;437983;12040
2020-09-16;CL;Chile;1304;18;439287;12058
2020-09-17;CL;Chile;1863;84;441150;12142
2020-09-18;CL;Chile;1677;57;442827;12199
2020-09-19;CL;Chile;1847;55;444674;12254
2020-09-20;CL;Chile;1600;32;446274;12286
2020-09-21;CL;Chile;1194;12;447468;12298
2020-09-22;CL;Chile;1055;23;448523;12321
2020-09-23;CL;Chile;1380;24;449903;12345
2020-09-24;CL;Chile;1731;124;451634;12469
2020-09-25;CL;Chile;2234;58;453868;12527
2020-09-26;CL;Chile;2111;64;455979;12591
2020-09-27;CL;Chile;1922;50;457901;12641
2020-09-28;CL;Chile;1770;57;459671;12698
2020-09-29;CL;Chile;1629;27;461300;12725
2020-09-30;CL;Chile;1691;16;462991;12741
2020-10-01;CL;Chile;1759;81;464750;12822
2020-10-02;CL;Chile;1840;45;466590;12867
2020-10-03;CL;Chile;1881;52;468471;12919
2020-10-04;CL;Chile;1708;60;470179;12979
2020-10-05;CL;Chile;1567;58;471746;13037
2020-10-06;CL;Chile;1560;33;473306;13070
2020-10-07;CL;Chile;1134;20;474440;13090
2020-10-08;CL;Chile;1576;77;476016;13167
2020-10-09;CL;Chile;1753;53;477769;13220
2020-10-10;CL;Chile;1826;52;479595;13272
2020-10-11;CL;Chile;1776;46;481371;13318
2020-10-12;CL;Chile;1461;58;482832;13376
2020-10-13;CL;Chile;1448;20;484280;13396
2020-10-14;CL;Chile;1092;19;485372;13415
2020-10-15;CL;Chile;1124;19;486496;13434
2020-10-16;CL;Chile;1694;95;488190;13529
2020-10-17;CL;Chile;1813;59;490003;13588
2020-10-18;CL;Chile;1757;47;491760;13635
2020-10-19;CL;Chile;1545;41;493305;13676
2020-10-20;CL;Chile;1173;26;494478;13702
2020-10-21;CL;Chile;1159;17;495637;13719
2020-10-22;CL;Chile;1494;73;497131;13792
2020-10-23;CL;Chile;1775;52;498906;13844
2020-10-24;CL;Chile;1636;48;500542;13892
2020-10-25;CL;Chile;1521;52;502063;13944
2020-10-26;CL;Chile;1535;59;503598;14003
2020-10-27;CL;Chile;927;23;504525;14026
2020-10-28;CL;Chile;1005;6;505530;14032
2020-10-29;CL;Chile;1520;86;507050;14118
2020-10-30;CL;Chile;1521;40;508571;14158
2020-10-31;CL;Chile;1685;49;510256;14207
2020-11-01;CL;Chile;1608;40;511864;14247
2020-11-02;CL;Chile;1276;55;513140;14302
2020-11-03;CL;Chile;1062;17;514202;14319
2020-11-04;CL;Chile;840;21;515042;14340
2020-11-05;CL;Chile;1540;64;516582;14404
2020-11-06;CL;Chile;1808;46;518390;14450
2020-11-07;CL;Chile;1587;49;519977;14499
2020-11-08;CL;Chile;1581;44;521558;14543
2020-11-09;CL;Chile;1321;45;522879;14588
2020-11-10;CL;Chile;1028;23;523907;14611
2020-11-11;CL;Chile;897;22;524804;14633
2020-11-12;CL;Chile;1634;66;526438;14699
2020-11-13;CL;Chile;1592;39;528030;14738
2020-11-14;CL;Chile;1646;39;529676;14777
2020-11-15;CL;Chile;1597;42;531273;14819
2020-11-16;CL;Chile;1331;44;532604;14863
2020-11-17;CL;Chile;1006;20;533610;14883
2020-11-18;CL;Chile;948;14;534558;14897
2020-11-19;CL;Chile;1454;58;536012;14955
2020-11-20;CL;Chile;1573;48;537585;15003
2020-11-21;CL;Chile;1558;27;539143;15030
2020-11-22;CL;Chile;1497;39;540640;15069
2020-11-23;CL;Chile;1440;37;542080;15106
2020-11-24;CL;Chile;1007;25;543087;15131
2020-11-25;CL;Chile;1005;7;544092;15138
2020-11-26;CL;Chile;1570;97;545662;15235
2020-11-27;CL;Chile;1581;43;547243;15278
2020-11-28;CL;Chile;1698;44;548941;15322
2020-11-29;CL;Chile;1489;34;550430;15356
2020-11-30;CL;Chile;1313;54;551743;15410
2020-12-01;CL;Chile;1121;20;552864;15430
2020-12-02;CL;Chile;1034;8;553898;15438
2020-12-03;CL;Chile;1508;81;555406;15519
2020-12-04;CL;Chile;1729;39;557135;15558
2020-12-05;CL;Chile;1533;34;558668;15592
2020-12-06;CL;Chile;1714;36;560382;15628
2020-12-07;CL;Chile;1760;35;562142;15663
2020-12-08;CL;Chile;1392;17;563534;15680
2020-12-09;CL;Chile;1244;10;564778;15690
2020-12-10;CL;Chile;1662;84;566440;15774
2020-12-11;CL;Chile;1534;8;567974;15782
2020-12-12;CL;Chile;1807;64;569781;15846
2020-12-13;CL;Chile;2138;40;571919;15886
2020-12-14;CL;Chile;1911;45;573830;15931
2020-12-15;CL;Chile;1499;18;575329;15949
2020-12-16;CL;Chile;1402;10;576731;15959
2020-12-17;CL;Chile;2001;48;578732;16007
2020-12-18;CL;Chile;2403;44;581135;16051
2020-12-19;CL;Chile;2220;50;583355;16101
2020-12-20;CL;Chile;2191;53;585546;16154
2020-12-21;CL;Chile;2447;43;587993;16197
2020-12-22;CL;Chile;1196;20;589189;16217
2020-12-23;CL;Chile;1725;11;590914;16228
2020-12-24;CL;Chile;3238;75;594152;16303
2020-12-25;CL;Chile;1679;55;595831;16358
2020-12-26;CL;Chile;2563;46;598394;16404
2020-12-27;CL;Chile;1711;39;600105;16443
2020-12-28;CL;Chile;1923;0;602028;16443
2020-12-29;CL;Chile;1958;45;603986;16488
2020-12-30;CL;Chile;2964;11;606950;16499
2020-12-31;CL;Chile;2023;109;608973;16608
2021-01-01;CL;Chile;3591;52;612564;16660
2021-01-02;CL;Chile;3338;64;615902;16724
2021-01-03;CL;Chile;2289;43;618191;16767
2021-01-04;CL;Chile;2450;0;620641;16767
2021-01-05;CL;Chile;2460;21;623101;16788
2021-01-06;CL;Chile;2382;28;625483;16816
2021-01-07;CL;Chile;3693;97;629176;16913
2021-01-08;CL;Chile;4205;61;633381;16974
2021-01-09;CL;Chile;4361;63;637742;17037
2021-01-10;CL;Chile;4181;59;641923;17096
2021-01-11;CL;Chile;3969;66;645892;17162
2021-01-12;CL;Chile;3243;20;649135;17182
2021-01-13;CL;Chile;3390;22;652525;17204
2021-01-14;CL;Chile;4187;90;656712;17294
2021-01-15;CL;Chile;4468;75;661180;17369
2021-01-16;CL;Chile;4313;66;665493;17435
2021-01-17;CL;Chile;4339;42;669832;17477
2021-01-18;CL;Chile;3918;70;673750;17547
2021-01-19;CL;Chile;3401;26;677151;17573
2021-01-20;CL;Chile;3589;21;680740;17594
2021-01-21;CL;Chile;4367;108;685107;17702
2021-01-22;CL;Chile;4959;84;690066;17786
2021-01-23;CL;Chile;4581;68;694647;17854
2021-01-24;CL;Chile;4463;79;699110;17933
2021-01-25;CL;Chile;4068;66;703178;17999
2021-01-26;CL;Chile;3322;24;706500;18023
2021-01-27;CL;Chile;3388;17;709888;18040
2021-01-28;CL;Chile;4255;134;714143;18174
2021-01-29;CL;Chile;4606;83;718749;18257
2021-01-30;CL;Chile;4151;82;722900;18339
2021-01-31;CL;Chile;4209;113;727109;18452
2021-02-01;CL;Chile;3779;85;730888;18537
2021-02-02;CL;Chile;3147;22;734035;18559
2021-02-03;CL;Chile;2610;17;736645;18576
2021-02-04;CL;Chile;3592;155;740237;18731
2021-02-05;CL;Chile;3782;77;744019;18808
2021-02-06;CL;Chile;4063;87;748082;18895
2021-02-07;CL;Chile;3804;79;751886;18974
2021-02-08;CL;Chile;3464;82;755350;19056
2021-02-09;CL;Chile;2839;28;758189;19084
2021-02-10;CL;Chile;2387;21;760576;19105
2021-02-11;CL;Chile;3731;157;764307;19262
2021-02-12;CL;Chile;4164;83;768471;19345
2021-02-13;CL;Chile;3925;98;772396;19443
2021-02-14;CL;Chile;3813;98;776209;19541
2021-02-15;CL;Chile;3332;83;779541;19624
2021-02-16;CL;Chile;2498;20;782039;19644
2021-02-17;CL;Chile;2275;15;784314;19659
2021-02-18;CL;Chile;3828;139;788142;19798
2021-02-19;CL;Chile;3797;99;791939;19897
2021-02-20;CL;Chile;3906;77;795845;19974
2021-02-21;CL;Chile;3615;68;799460;20042
2021-02-22;CL;Chile;3549;84;803009;20126
2021-02-23;CL;Chile;2308;25;805317;20151
2021-02-24;CL;Chile;2555;22;807872;20173
2021-02-25;CL;Chile;4472;137;812344;20310
2021-02-26;CL;Chile;4585;90;816929;20400
2021-02-27;CL;Chile;4489;76;821418;20476
2021-02-28;CL;Chile;3207;96;824625;20572
2021-03-01;CL;Chile;5145;88;829770;20660
2021-03-02;CL;Chile;2742;24;832512;20684
2021-03-03;CL;Chile;3040;20;835552;20704
2021-03-04;CL;Chile;4567;134;840119;20838
2021-03-05;CL;Chile;5331;90;845450;20928
2021-03-06;CL;Chile;5033;80;850483;21008
2021-03-07;CL;Chile;5302;69;855785;21077
2021-03-08;CL;Chile;4748;86;860533;21163
2021-03-09;CL;Chile;3531;19;864064;21182
2021-03-10;CL;Chile;3885;24;867949;21206
2021-03-11;CL;Chile;5563;156;873512;21362
2021-03-12;CL;Chile;5973;89;879485;21451
2021-03-13;CL;Chile;5894;123;885379;21574
2021-03-14;CL;Chile;5731;100;891110;21674
2021-03-15;CL;Chile;5121;98;896231;21772
2021-03-16;CL;Chile;4551;17;900782;21789
2021-03-17;CL;Chile;3430;27;904212;21816
2021-03-18;CL;Chile;7257;172;911469;21988
2021-03-19;CL;Chile;6584;99;918053;22087
2021-03-20;CL;Chile;7036;93;925089;22180
2021-03-21;CL;Chile;6850;99;931939;22279
2021-03-22;CL;Chile;6155;80;938094;22359
2021-03-23;CL;Chile;4864;25;942958;22384
2021-03-24;CL;Chile;4825;18;947783;22402
2021-03-25;CL;Chile;7060;122;954843;22524
2021-03-26;CL;Chile;7478;63;962321;22587
2021-03-27;CL;Chile;7592;66;969913;22653
2021-03-28;CL;Chile;7330;101;977243;22754
2021-03-29;CL;Chile;7241;316;984484;23070
2021-03-30;CL;Chile;5008;37;989492;23107
2021-03-31;CL;Chile;6046;28;995538;23135
2021-04-01;CL;Chile;7868;193;1003406;23328
2021-04-02;CL;Chile;8079;93;1011485;23421
2021-04-03;CL;Chile;7993;103;1019478;23524
2021-04-04;CL;Chile;7307;120;1026785;23644
2021-04-05;CL;Chile;5827;33;1032612;23677
2021-04-06;CL;Chile;5168;57;1037780;23734
2021-04-07;CL;Chile;5242;62;1043022;23796
2021-04-08;CL;Chile;8248;183;1051270;23979
2021-04-09;CL;Chile;9151;129;1060421;24108
2021-04-10;CL;Chile;8101;105;1068522;24213
2021-04-11;CL;Chile;7977;133;1076499;24346
2021-04-12;CL;Chile;6421;137;1082920;24483
2021-04-13;CL;Chile;5790;35;1088710;24518
2021-04-14;CL;Chile;5557;30;1094267;24548
2021-04-15;CL;Chile;7431;218;1101698;24766
2021-04-16;CL;Chile;7613;157;1109311;24923
2021-04-17;CL;Chile;8037;132;1117348;25055
2021-04-18;CL;Chile;7370;122;1124718;25177
2021-04-19;CL;Chile;6622;100;1131340;25277
2021-04-20;CL;Chile;4849;40;1136189;25317
2021-04-21;CL;Chile;5214;36;1141403;25353
2021-04-22;CL;Chile;6917;179;1148320;25532
2021-04-23;CL;Chile;7582;109;1155902;25641
2021-04-24;CL;Chile;6909;101;1162811;25742
2021-04-25;CL;Chile;6725;114;1169536;25856
2021-04-26;CL;Chile;6078;119;1175614;25975
2021-04-27;CL;Chile;4158;45;1179772;26020
2021-04-28;CL;Chile;4499;53;1184271;26073
2021-04-29;CL;Chile;6720;174;1190991;26247
2021-04-30;CL;Chile;7254;106;1198245;26353
2021-05-01;CL;Chile;5510;104;1203755;26457
2021-05-02;CL;Chile;7165;104;1210920;26561
2021-05-03;CL;Chile;4895;98;1215815;26659
2021-05-04;CL;Chile;3249;37;1219064;26696
2021-05-05;CL;Chile;3885;30;1222949;26726
2021-05-06;CL;Chile;6299;169;1229248;26895
2021-05-07;CL;Chile;6530;109;1235778;27004
2021-05-08;CL;Chile;6198;97;1241976;27101
2021-05-09;CL;Chile;5493;117;1247469;27218
2021-05-10;CL;Chile;5339;100;1252808;27318
2021-05-11;CL;Chile;3738;38;1256546;27356
2021-05-12;CL;Chile;3902;28;1260448;27384
2021-05-13;CL;Chile;6153;136;1266601;27520
2021-05-14;CL;Chile;6915;127;1273516;27647
2021-05-15;CL;Chile;6736;87;1280252;27734
2021-05-16;CL;Chile;6296;98;1286548;27832
2021-05-17;CL;Chile;5548;102;1292096;27934
2021-05-18;CL;Chile;3766;31;1295862;27965
2021-05-19;CL;Chile;4767;32;1300629;27997
2021-05-20;CL;Chile;7682;172;1308311;28169
2021-05-21;CL;Chile;7602;121;1315913;28290
2021-05-22;CL;Chile;7500;96;1323413;28386
2021-05-23;CL;Chile;6505;132;1329918;28518
2021-05-24;CL;Chile;5343;30;1335261;28548
2021-05-25;CL;Chile;4160;37;1339421;28585
2021-05-26;CL;Chile;5197;39;1344618;28624
2021-05-27;CL;Chile;8105;185;1352723;28809
2021-05-28;CL;Chile;8658;119;1361381;28928
2021-05-29;CL;Chile;8216;119;1369597;29047
2021-05-30;CL;Chile;7910;121;1377507;29168
2021-05-31;CL;Chile;6839;132;1384346;29300
2021-06-01;CL;Chile;5011;44;1389357;29344
2021-06-02;CL;Chile;5616;41;1394973;29385
2021-06-03;CL;Chile;8128;213;1403101;29598
2021-06-04;CL;Chile;8245;98;1411346;29696
2021-06-05;CL;Chile;8920;120;1420266;29816
2021-06-06;CL;Chile;7690;121;1427956;29937
2021-06-07;CL;Chile;6928;121;1434884;30058
2021-06-08;CL;Chile;5533;46;1440417;30104
2021-06-09;CL;Chile;5351;37;1445768;30141
2021-06-10;CL;Chile;7709;198;1453477;30339
2021-06-11;CL;Chile;7942;133;1461419;30472
2021-06-12;CL;Chile;7573;107;1468992;30579
2021-06-13;CL;Chile;7481;128;1476473;30707
2021-06-14;CL;Chile;6190;97;1482663;30804
2021-06-15;CL;Chile;4576;61;1487239;30865
2021-06-16;CL;Chile;4322;57;1491561;30922
2021-06-17;CL;Chile;6670;218;1498231;31140
2021-06-18;CL;Chile;6770;119;1505001;31259
2021-06-19;CL;Chile;6274;133;1511275;31392
2021-06-20;CL;Chile;5743;121;1517018;31513
2021-06-21;CL;Chile;5205;132;1522223;31645
2021-06-22;CL;Chile;3710;45;1525933;31690
2021-06-23;CL;Chile;2476;56;1528409;31746
2021-06-24;CL;Chile;3463;51;1531872;31797
2021-06-25;CL;Chile;5599;215;1537471;32012
2021-06-26;CL;Chile;5171;151;1542642;32163
2021-06-27;CL;Chile;4461;135;1547103;32298
2021-06-28;CL;Chile;4034;156;1551137;32454
2021-06-29;CL;Chile;2637;35;1553774;32489
2021-06-30;CL;Chile;2128;56;1555902;32545
2021-07-01;CL;Chile;2655;43;1558557;32588
2020-01-22;CN;China;0;0;548;17
2020-01-23;CN;China;93;1;641;18
2020-01-24;CN;China;277;8;918;26
2020-01-25;CN;China;483;16;1401;42
2020-01-26;CN;China;666;14;2067;56
2020-01-27;CN;China;802;26;2869;82
2020-01-28;CN;China;2632;49;5501;131
2020-01-29;CN;China;576;2;6077;133
2020-01-30;CN;China;2054;38;8131;171
2020-01-31;CN;China;1659;42;9790;213
2020-02-01;CN;China;2088;46;11878;259
2020-02-02;CN;China;4737;102;16615;361
2020-02-03;CN;China;3086;64;19701;425
2020-02-04;CN;China;3989;65;23690;490
2020-02-05;CN;China;3729;72;27419;562
2020-02-06;CN;China;3144;70;30563;632
2020-02-07;CN;China;3522;85;34085;717
2020-02-08;CN;China;2703;87;36788;804
2020-02-09;CN;China;3012;100;39800;904
2020-02-10;CN;China;2516;107;42316;1011
2020-02-11;CN;China;2021;100;44337;1111
2020-02-12;CN;China;372;5;44709;1116
2020-02-13;CN;China;15133;252;59842;1368
2020-02-14;CN;China;6460;152;66302;1520
2020-02-15;CN;China;2055;142;68357;1662
2020-02-16;CN;China;2099;103;70456;1765
2020-02-17;CN;China;1918;98;72374;1863
2020-02-18;CN;China;1775;139;74149;2002
2020-02-19;CN;China;407;112;74556;2114
2020-02-20;CN;China;453;122;75009;2236
2020-02-21;CN;China;473;0;75482;2236
2020-02-22;CN;China;1450;205;76932;2441
2020-02-23;CN;China;16;2;76948;2443
2020-02-24;CN;China;214;150;77162;2593
2020-02-25;CN;China;508;70;77670;2663
2020-02-26;CN;China;405;52;78075;2715
2020-02-27;CN;China;433;29;78508;2744
2020-02-28;CN;China;326;44;78834;2788
2020-02-29;CN;China;427;47;79261;2835
2020-03-01;CN;China;575;35;79836;2870
2020-03-02;CN;China;200;42;80036;2912
2020-03-03;CN;China;125;33;80161;2945
2020-03-04;CN;China;120;36;80281;2981
2020-03-05;CN;China;151;32;80432;3013
2020-03-06;CN;China;151;29;80583;3042
2020-03-07;CN;China;79;28;80662;3070
2020-03-08;CN;China;47;27;80709;3097
2020-03-09;CN;China;36;23;80745;3120
2020-03-10;CN;China;22;16;80767;3136
2020-03-11;CN;China;28;22;80795;3158
2020-03-12;CN;China;8;11;80803;3169
2020-03-13;CN;China;8;7;80811;3176
2020-03-14;CN;China;26;13;80837;3189
2020-03-15;CN;China;21;10;80858;3199
2020-03-16;CN;China;20;14;80878;3213
2020-03-17;CN;China;18;13;80896;3226
2020-03-18;CN;China;25;11;80921;3237
2020-03-19;CN;China;27;8;80948;3245
2020-03-20;CN;China;46;4;80994;3249
2020-03-21;CN;China;38;6;81032;3255
2020-03-22;CN;China;86;15;81118;3270
2020-03-23;CN;China;24;0;81142;3270
2020-03-24;CN;China;63;7;81205;3277
2020-03-25;CN;China;46;4;81251;3281
2020-03-26;CN;China;78;6;81329;3287
2020-03-27;CN;China;49;5;81378;3292
2020-03-28;CN;China;60;3;81438;3295
2020-03-29;CN;China;43;5;81481;3300
2020-03-30;CN;China;35;4;81516;3304
2020-03-31;CN;China;49;1;81565;3305
2020-04-01;CN;China;31;7;81596;3312
2020-04-02;CN;China;34;6;81630;3318
2020-04-03;CN;China;36;4;81666;3322
2020-04-04;CN;China;15;4;81681;3326
2020-04-05;CN;China;31;3;81712;3329
2020-04-06;CN;China;39;2;81751;3331
2020-04-07;CN;China;32;0;81783;3331
2020-04-08;CN;China;66;2;81849;3333
2020-04-09;CN;China;61;2;81910;3335
2020-04-10;CN;China;42;1;81952;3336
2020-04-11;CN;China;62;3;82014;3339
2020-04-12;CN;China;116;0;82130;3339
2020-04-13;CN;China;74;2;82204;3341
2020-04-14;CN;China;90;0;82294;3341
2020-04-15;CN;China;45;1;82339;3342
2020-04-16;CN;China;47;0;82386;3342
2020-04-17;CN;China;353;1290;82739;4632
2020-04-18;CN;China;24;0;82763;4632
2020-04-19;CN;China;17;0;82780;4632
2020-04-20;CN;China;12;0;82792;4632
2020-04-21;CN;China;32;0;82824;4632
2020-04-22;CN;China;11;0;82835;4632
2020-04-23;CN;China;14;0;82849;4632
2020-04-24;CN;China;15;0;82864;4632
2020-04-25;CN;China;8;0;82872;4632
2020-04-26;CN;China;3;1;82875;4633
2020-04-27;CN;China;6;0;82881;4633
2020-04-28;CN;China;22;0;82903;4633
2020-04-29;CN;China;4;0;82907;4633
2020-04-30;CN;China;12;0;82919;4633
2020-05-01;CN;China;1;0;82920;4633
2020-05-02;CN;China;0;0;82920;4633
2020-05-03;CN;China;5;0;82925;4633
2020-05-04;CN;China;1;0;82926;4633
2020-05-05;CN;China;2;0;82928;4633
2020-05-06;CN;China;2;0;82930;4633
2020-05-07;CN;China;1;0;82931;4633
2020-05-08;CN;China;1;0;82932;4633
2020-05-09;CN;China;14;0;82946;4633
2020-05-10;CN;China;17;0;82963;4633
2020-05-11;CN;China;1;0;82964;4633
2020-05-12;CN;China;7;0;82971;4633
2020-05-13;CN;China;3;0;82974;4633
2020-05-14;CN;China;4;0;82978;4633
2020-05-15;CN;China;8;0;82986;4633
2020-05-16;CN;China;6;1;82992;4634
2020-05-17;CN;China;7;0;82999;4634
2020-05-18;CN;China;9;0;83008;4634
2020-05-19;CN;China;0;0;83008;4634
2020-05-20;CN;China;0;0;83008;4634
2020-05-21;CN;China;0;0;83008;4634
2020-05-22;CN;China;8;0;83016;4634
2020-05-23;CN;China;3;0;83019;4634
2020-05-24;CN;China;11;0;83030;4634
2020-05-25;CN;China;7;0;83037;4634
2020-05-26;CN;China;1;0;83038;4634
2020-05-27;CN;China;2;0;83040;4634
2020-05-28;CN;China;0;0;83040;4634
2020-05-29;CN;China;4;0;83044;4634
2020-05-30;CN;China;2;0;83046;4634
2020-05-31;CN;China;16;0;83062;4634
2020-06-01;CN;China;5;0;83067;4634
2020-06-02;CN;China;1;0;83068;4634
2020-06-03;CN;China;-1;0;83067;4634
2020-06-04;CN;China;5;0;83072;4634
2020-06-05;CN;China;3;0;83075;4634
2020-06-06;CN;China;6;0;83081;4634
2020-06-07;CN;China;4;0;83085;4634
2020-06-08;CN;China;3;0;83088;4634
2020-06-09;CN;China;3;0;83091;4634
2020-06-10;CN;China;11;0;83102;4634
2020-06-11;CN;China;7;0;83109;4634
2020-06-12;CN;China;11;0;83120;4634
2020-06-13;CN;China;57;0;83177;4634
2020-06-14;CN;China;49;0;83226;4634
2020-06-15;CN;China;40;0;83266;4634
2020-06-16;CN;China;44;0;83310;4634
2020-06-17;CN;China;28;0;83338;4634
2020-06-18;CN;China;32;0;83370;4634
2020-06-19;CN;China;0;0;83370;4634
2020-06-20;CN;China;55;0;83425;4634
2020-06-21;CN;China;16;0;83441;4634
2020-06-22;CN;China;22;0;83463;4634
2020-06-23;CN;China;13;0;83476;4634
2020-06-24;CN;China;18;0;83494;4634
2020-06-25;CN;China;14;0;83508;4634
2020-06-26;CN;China;21;0;83529;4634
2020-06-27;CN;China;17;0;83546;4634
2020-06-28;CN;China;12;0;83558;4634
2020-06-29;CN;China;19;0;83577;4634
2020-06-30;CN;China;3;0;83580;4634
2020-07-01;CN;China;3;0;83583;4634
2020-07-02;CN;China;5;0;83588;4634
2020-07-03;CN;China;3;0;83591;4634
2020-07-04;CN;China;8;0;83599;4634
2020-07-05;CN;China;4;0;83603;4634
2020-07-06;CN;China;1;0;83604;4634
2020-07-07;CN;China;14;0;83618;4634
2020-07-08;CN;China;9;0;83627;4634
2020-07-09;CN;China;0;0;83627;4634
2020-07-10;CN;China;0;0;83627;4634
2020-07-11;CN;China;13;0;83640;4634
2020-07-12;CN;China;8;0;83648;4634
2020-07-13;CN;China;0;0;83648;4634
2020-07-14;CN;China;9;0;83657;4634
2020-07-15;CN;China;1;0;83658;4634
2020-07-16;CN;China;14;0;83672;4634
2020-07-17;CN;China;17;0;83689;4634
2020-07-18;CN;China;16;0;83705;4634
2020-07-19;CN;China;21;0;83726;4634
2020-07-20;CN;China;11;0;83737;4634
2020-07-21;CN;China;13;0;83750;4634
2020-07-22;CN;China;25;0;83775;4634
2020-07-23;CN;China;21;0;83796;4634
2020-07-24;CN;China;34;0;83830;4634
2020-07-25;CN;China;46;0;83876;4634
2020-07-26;CN;China;61;0;83937;4634
2020-07-27;CN;China;68;0;84005;4634
2020-07-28;CN;China;101;0;84106;4634
2020-07-29;CN;China;105;0;84211;4634
2020-07-30;CN;China;127;0;84338;4634
2020-07-31;CN;China;45;0;84383;4634
2020-08-01;CN;China;48;0;84431;4634
2020-08-02;CN;China;43;0;84474;4634
2020-08-03;CN;China;36;0;84510;4634
2020-08-04;CN;China;27;0;84537;4634
2020-08-05;CN;China;37;0;84574;4634
2020-08-06;CN;China;37;0;84611;4634
2020-08-07;CN;China;31;0;84642;4634
2020-08-08;CN;China;23;0;84665;4634
2020-08-09;CN;China;49;0;84714;4634
2020-08-10;CN;China;44;0;84758;4634
2020-08-11;CN;China;19;0;84777;4634
2020-08-12;CN;China;25;0;84802;4634
2020-08-13;CN;China;30;0;84832;4634
2020-08-14;CN;China;22;0;84854;4634
2020-08-15;CN;China;19;0;84873;4634
2020-08-16;CN;China;22;0;84895;4634
2020-08-17;CN;China;22;0;84917;4634
2020-08-18;CN;China;17;0;84934;4634
2020-08-19;CN;China;7;0;84941;4634
2020-08-20;CN;China;22;0;84963;4634
2020-08-21;CN;China;22;0;84985;4634
2020-08-22;CN;China;12;0;84997;4634
2020-08-23;CN;China;16;0;85013;4634
2020-08-24;CN;China;14;0;85027;4634
2020-08-25;CN;China;15;0;85042;4634
2020-08-26;CN;China;8;0;85050;4634
2020-08-27;CN;China;9;0;85059;4634
2020-08-28;CN;China;9;0;85068;4634
2020-08-29;CN;China;9;0;85077;4634
2020-08-30;CN;China;17;0;85094;4634
2020-08-31;CN;China;10;0;85104;4634
2020-09-01;CN;China;7;0;85111;4634
2020-09-02;CN;China;12;0;85123;4634
2020-09-03;CN;China;25;0;85148;4634
2020-09-04;CN;China;10;0;85158;4634
2020-09-05;CN;China;10;0;85168;4634
2020-09-06;CN;China;12;0;85180;4634
2020-09-07;CN;China;9;0;85189;4634
2020-09-08;CN;China;3;0;85192;4634
2020-09-09;CN;China;7;0;85199;4634
2020-09-10;CN;China;15;0;85214;4634
2020-09-11;CN;China;6;0;85220;4634
2020-09-12;CN;China;10;0;85230;4634
2020-09-13;CN;China;10;0;85240;4634
2020-09-14;CN;China;8;0;85248;4634
2020-09-15;CN;China;12;0;85260;4634
2020-09-16;CN;China;9;0;85269;4634
2020-09-17;CN;China;32;0;85301;4634
2020-09-18;CN;China;14;0;85315;4634
2020-09-19;CN;China;10;0;85325;4634
2020-09-20;CN;China;12;0;85337;4634
2020-09-21;CN;China;6;0;85343;4634
2020-09-22;CN;China;10;0;85353;4634
2020-09-23;CN;China;7;0;85360;4634
2020-09-24;CN;China;8;0;85368;4634
2020-09-25;CN;China;15;0;85383;4634
2020-09-26;CN;China;14;0;85397;4634
2020-09-27;CN;China;21;0;85418;4634
2020-09-28;CN;China;12;0;85430;4634
2020-09-29;CN;China;19;0;85449;4634
2020-09-30;CN;China;9;0;85458;4634
2020-10-01;CN;China;12;0;85470;4634
2020-10-02;CN;China;10;0;85480;4634
2020-10-03;CN;China;16;0;85496;4634
2020-10-04;CN;China;20;0;85516;4634
2020-10-05;CN;China;12;0;85528;4634
2020-10-06;CN;China;7;0;85535;4634
2020-10-07;CN;China;9;0;85544;4634
2020-10-08;CN;China;23;0;85567;4634
2020-10-09;CN;China;15;0;85582;4634
2020-10-10;CN;China;21;0;85603;4634
2020-10-11;CN;China;27;0;85630;4634
2020-10-12;CN;China;7;0;85637;4634
2020-10-13;CN;China;20;0;85657;4634
2020-10-14;CN;China;11;0;85668;4634
2020-10-15;CN;China;24;0;85692;4634
2020-10-16;CN;China;13;0;85705;4634
2020-10-17;CN;China;13;0;85718;4634
2020-10-18;CN;China;13;0;85731;4634
2020-10-19;CN;China;19;0;85750;4634
2020-10-20;CN;China;11;0;85761;4634
2020-10-21;CN;China;14;0;85775;4634
2020-10-22;CN;China;18;0;85793;4634
2020-10-23;CN;China;31;0;85824;4634
2020-10-24;CN;China;15;0;85839;4634
2020-10-25;CN;China;17;0;85856;4634
2020-10-26;CN;China;16;0;85872;4634
2020-10-27;CN;China;42;0;85914;4634
2020-10-28;CN;China;47;0;85961;4634
2020-10-29;CN;China;25;0;85986;4634
2020-10-30;CN;China;33;0;86019;4634
2020-10-31;CN;China;24;0;86043;4634
2020-11-01;CN;China;24;0;86067;4634
2020-11-02;CN;China;49;0;86116;4634
2020-11-03;CN;China;17;0;86133;4634
2020-11-04;CN;China;28;0;86161;4634
2020-11-05;CN;China;36;0;86197;4634
2020-11-06;CN;China;33;0;86230;4634
2020-11-07;CN;China;28;0;86258;4634
2020-11-08;CN;China;33;0;86291;4634
2020-11-09;CN;China;22;0;86313;4634
2020-11-10;CN;China;17;0;86330;4634
2020-11-11;CN;China;15;0;86345;4634
2020-11-12;CN;China;8;0;86353;4634
2020-11-13;CN;China;18;0;86371;4634
2020-11-14;CN;China;13;0;86384;4634
2020-11-15;CN;China;8;0;86392;4634
2020-11-16;CN;China;14;0;86406;4634
2020-11-17;CN;China;9;0;86415;4634
2020-11-18;CN;China;12;0;86427;4634
2020-11-19;CN;China;17;0;86444;4634
2020-11-20;CN;China;16;0;86460;4634
2020-11-21;CN;China;17;0;86477;4634
2020-11-22;CN;China;11;0;86488;4634
2020-11-23;CN;China;22;0;86510;4634
2020-11-24;CN;China;5;0;86515;4634
2020-11-25;CN;China;21;0;86536;4634
2020-11-26;CN;China;5;0;86541;4634
2020-11-27;CN;China;6;0;86547;4634
2020-11-28;CN;China;11;0;86558;4634
2020-11-29;CN;China;18;0;86576;4634
2020-11-30;CN;China;12;0;86588;4634
2020-12-01;CN;China;9;0;86597;4634
2020-12-02;CN;China;17;0;86614;4634
2020-12-03;CN;China;18;0;86632;4634
2020-12-04;CN;China;15;0;86647;4634
2020-12-05;CN;China;18;0;86665;4634
2020-12-06;CN;China;15;0;86680;4634
2020-12-07;CN;China;15;0;86695;4634
2020-12-08;CN;China;12;0;86707;4634
2020-12-09;CN;China;12;0;86719;4634
2020-12-10;CN;China;15;0;86734;4634
2020-12-11;CN;China;13;0;86747;4634
2020-12-12;CN;China;24;0;86771;4634
2020-12-13;CN;China;16;0;86787;4634
2020-12-14;CN;China;17;0;86804;4634
2020-12-15;CN;China;12;0;86816;4634
2020-12-16;CN;China;7;0;86823;4634
2020-12-17;CN;China;12;0;86835;4634
2020-12-18;CN;China;17;0;86852;4634
2020-12-19;CN;China;23;0;86875;4634
2020-12-20;CN;China;23;0;86898;4634
2020-12-21;CN;China;15;0;86913;4634
2020-12-22;CN;China;15;0;86928;4634
2020-12-23;CN;China;17;0;86945;4634
2020-12-24;CN;China;14;0;86959;4634
2020-12-25;CN;China;20;0;86979;4634
2020-12-26;CN;China;22;0;87001;4634
2020-12-27;CN;China;21;0;87022;4634
2020-12-28;CN;China;27;0;87049;4634
2020-12-29;CN;China;24;0;87073;4634
2020-12-30;CN;China;25;0;87098;4634
2020-12-31;CN;China;19;0;87117;4634
2021-01-01;CN;China;18;0;87135;4634
2021-01-02;CN;China;28;0;87163;4634
2021-01-03;CN;China;33;0;87196;4634
2021-01-04;CN;China;33;0;87229;4634
2021-01-05;CN;China;32;0;87261;4634
2021-01-06;CN;China;63;0;87324;4634
2021-01-07;CN;China;53;0;87377;4634
2021-01-08;CN;China;33;0;87410;4634
2021-01-09;CN;China;69;0;87479;4634
2021-01-10;CN;China;103;0;87582;4634
2021-01-11;CN;China;55;0;87637;4634
2021-01-12;CN;China;115;0;87752;4634
2021-01-13;CN;China;138;1;87890;4635
2021-01-14;CN;China;144;0;88034;4635
2021-01-15;CN;China;130;0;88164;4635
2021-01-16;CN;China;109;0;88273;4635
2021-01-17;CN;China;109;0;88382;4635
2021-01-18;CN;China;118;0;88500;4635
2021-01-19;CN;China;103;0;88603;4635
2021-01-20;CN;China;144;0;88747;4635
2021-01-21;CN;China;111;0;88858;4635
2021-01-22;CN;China;100;0;88958;4635
2021-01-23;CN;China;80;0;89038;4635
2021-01-24;CN;China;124;0;89162;4635
2021-01-25;CN;China;82;1;89244;4636
2021-01-26;CN;China;75;0;89319;4636
2021-01-27;CN;China;54;0;89373;4636
2021-01-28;CN;China;52;0;89425;4636
2021-01-29;CN;China;52;0;89477;4636
2021-01-30;CN;China;92;0;89569;4636
2021-01-31;CN;China;42;0;89611;4636
2021-02-01;CN;China;30;0;89641;4636
2021-02-02;CN;China;25;0;89666;4636
2021-02-03;CN;China;30;0;89696;4636
2021-02-04;CN;China;20;0;89716;4636
2021-02-05;CN;China;13;0;89729;4636
2021-02-06;CN;China;11;0;89740;4636
2021-02-07;CN;China;14;0;89754;4636
2021-02-08;CN;China;14;0;89768;4636
2021-02-09;CN;China;14;0;89782;4636
2021-02-10;CN;China;2;0;89784;4636
2021-02-11;CN;China;12;0;89796;4636
2021-02-12;CN;China;8;0;89804;4636
2021-02-13;CN;China;7;0;89811;4636
2021-02-14;CN;China;9;0;89820;4636
2021-02-15;CN;China;16;0;89836;4636
2021-02-16;CN;China;7;0;89843;4636
2021-02-17;CN;China;11;0;89854;4636
2021-02-18;CN;China;10;0;89864;4636
2021-02-19;CN;China;8;0;89872;4636
2021-02-20;CN;China;7;0;89879;4636
2021-02-21;CN;China;11;0;89890;4636
2021-02-22;CN;China;10;0;89900;4636
2021-02-23;CN;China;12;0;89912;4636
2021-02-24;CN;China;7;0;89919;4636
2021-02-25;CN;China;6;0;89925;4636
2021-02-26;CN;China;10;0;89935;4636
2021-02-27;CN;China;6;0;89941;4636
2021-02-28;CN;China;19;0;89960;4636
2021-03-01;CN;China;11;0;89971;4636
2021-03-02;CN;China;10;0;89981;4636
2021-03-03;CN;China;10;0;89991;4636
2021-03-04;CN;China;9;0;90000;4636
2021-03-05;CN;China;10;0;90010;4636
2021-03-06;CN;China;13;0;90023;4636
2021-03-07;CN;China;19;0;90042;4636
2021-03-08;CN;China;8;0;90050;4636
2021-03-09;CN;China;5;0;90055;4636
2021-03-10;CN;China;11;0;90066;4636
2021-03-11;CN;China;9;0;90075;4636
2021-03-12;CN;China;7;0;90082;4636
2021-03-13;CN;China;10;0;90092;4636
2021-03-14;CN;China;5;0;90097;4636
2021-03-15;CN;China;13;0;90110;4636
2021-03-16;CN;China;4;0;90114;4636
2021-03-17;CN;China;6;0;90120;4636
2021-03-18;CN;China;11;0;90131;4636
2021-03-19;CN;China;4;0;90135;4636
2021-03-20;CN;China;12;0;90147;4636
2021-03-21;CN;China;7;0;90154;4636
2021-03-22;CN;China;9;0;90163;4636
2021-03-23;CN;China;10;0;90173;4636
2021-03-24;CN;China;11;0;90184;4636
2021-03-25;CN;China;11;0;90195;4636
2021-03-26;CN;China;12;0;90207;4636
2021-03-27;CN;China;11;0;90218;4636
2021-03-28;CN;China;12;0;90230;4636
2021-03-29;CN;China;8;0;90238;4636
2021-03-30;CN;China;11;0;90249;4636
2021-03-31;CN;China;16;0;90265;4636
2021-04-01;CN;China;9;0;90274;4636
2021-04-02;CN;China;26;0;90300;4636
2021-04-03;CN;China;20;0;90320;4636
2021-04-04;CN;China;33;0;90353;4636
2021-04-05;CN;China;24;0;90377;4636
2021-04-06;CN;China;12;0;90389;4636
2021-04-07;CN;China;25;0;90414;4636
2021-04-08;CN;China;21;0;90435;4636
2021-04-09;CN;China;14;0;90449;4636
2021-04-10;CN;China;10;0;90459;4636
2021-04-11;CN;China;16;0;90475;4636
2021-04-12;CN;China;9;0;90484;4636
2021-04-13;CN;China;12;0;90496;4636
2021-04-14;CN;China;10;0;90506;4636
2021-04-15;CN;China;11;0;90517;4636
2021-04-16;CN;China;15;0;90532;4636
2021-04-17;CN;China;16;0;90548;4636
2021-04-18;CN;China;11;0;90559;4636
2021-04-19;CN;China;10;0;90569;4636
2021-04-20;CN;China;21;0;90590;4636
2021-04-21;CN;China;6;0;90596;4636
2021-04-22;CN;China;19;0;90615;4636
2021-04-23;CN;China;9;0;90624;4636
2021-04-24;CN;China;13;0;90637;4636
2021-04-25;CN;China;11;0;90648;4636
2021-04-26;CN;China;11;0;90659;4636
2021-04-27;CN;China;12;0;90671;4636
2021-04-28;CN;China;20;0;90691;4636
2021-04-29;CN;China;13;0;90704;4636
2021-04-30;CN;China;16;0;90720;4636
2021-05-01;CN;China;15;0;90735;4636
2021-05-02;CN;China;11;0;90746;4636
2021-05-03;CN;China;17;0;90763;4636
2021-05-04;CN;China;7;0;90770;4636
2021-05-05;CN;China;5;0;90775;4636
2021-05-06;CN;China;13;0;90788;4636
2021-05-07;CN;China;7;0;90795;4636
2021-05-08;CN;China;12;0;90807;4636
2021-05-09;CN;China;11;0;90818;4636
2021-05-10;CN;China;14;0;90832;4636
2021-05-11;CN;China;16;0;90848;4636
2021-05-12;CN;China;9;0;90857;4636
2021-05-13;CN;China;7;0;90864;4636
2021-05-14;CN;China;14;0;90878;4636
2021-05-15;CN;China;18;0;90896;4636
2021-05-16;CN;China;26;0;90922;4636
2021-05-17;CN;China;22;0;90944;4636
2021-05-18;CN;China;14;0;90958;4636
2021-05-19;CN;China;12;0;90970;4636
2021-05-20;CN;China;24;0;90994;4636
2021-05-21;CN;China;10;0;91004;4636
2021-05-22;CN;China;19;0;91023;4636
2021-05-23;CN;China;18;0;91041;4636
2021-05-24;CN;China;16;0;91057;4636
2021-05-25;CN;China;13;0;91070;4636
2021-05-26;CN;China;19;0;91089;4636
2021-05-27;CN;China;7;0;91096;4636
2021-05-28;CN;China;16;0;91112;4636
2021-05-29;CN;China;11;0;91123;4636
2021-05-30;CN;China;27;0;91150;4636
2021-05-31;CN;China;23;0;91173;4636
2021-06-01;CN;China;24;0;91197;4636
2021-06-02;CN;China;24;0;91221;4636
2021-06-03;CN;China;24;0;91245;4636
2021-06-04;CN;China;24;0;91269;4636
2021-06-05;CN;China;30;0;91299;4636
2021-06-06;CN;China;19;0;91318;4636
2021-06-07;CN;China;33;0;91351;4636
2021-06-08;CN;China;16;0;91367;4636
2021-06-09;CN;China;22;0;91389;4636
2021-06-10;CN;China;22;0;91411;4636
2021-06-11;CN;China;35;0;91446;4636
2021-06-12;CN;China;34;0;91480;4636
2021-06-13;CN;China;23;0;91503;4636
2021-06-14;CN;China;20;0;91523;4636
2021-06-15;CN;China;21;0;91544;4636
2021-06-16;CN;China;19;0;91563;4636
2021-06-17;CN;China;23;0;91586;4636
2021-06-18;CN;China;31;0;91617;4636
2021-06-19;CN;China;23;0;91640;4636
2021-06-20;CN;China;17;0;91657;4636
2021-06-21;CN;China;25;0;91682;4636
2021-06-22;CN;China;24;0;91706;4636
2021-06-23;CN;China;16;0;91722;4636
2021-06-24;CN;China;24;0;91746;4636
2021-06-25;CN;China;25;0;91771;4636
2021-06-26;CN;China;14;0;91785;4636
2021-06-27;CN;China;22;0;91807;4636
2021-06-28;CN;China;18;0;91825;4636
2021-06-29;CN;China;9;0;91834;4636
2021-06-30;CN;China;12;0;91846;4636
2021-07-01;CN;China;18;0;91864;4636
2020-03-06;CO;Colombia;1;0;1;0
2020-03-07;CO;Colombia;0;0;1;0
2020-03-08;CO;Colombia;0;0;1;0
2020-03-09;CO;Colombia;0;0;1;0
2020-03-10;CO;Colombia;2;0;3;0
2020-03-11;CO;Colombia;6;0;9;0
2020-03-12;CO;Colombia;0;0;9;0
2020-03-13;CO;Colombia;4;0;13;0
2020-03-14;CO;Colombia;9;0;22;0
2020-03-15;CO;Colombia;12;0;34;0
2020-03-16;CO;Colombia;23;0;57;0
2020-03-17;CO;Colombia;18;0;75;0
2020-03-18;CO;Colombia;27;0;102;0
2020-03-19;CO;Colombia;6;0;108;0
2020-03-20;CO;Colombia;50;0;158;0
2020-03-21;CO;Colombia;38;0;196;0
2020-03-22;CO;Colombia;35;2;231;2
2020-03-23;CO;Colombia;46;1;277;3
2020-03-24;CO;Colombia;101;0;378;3
2020-03-25;CO;Colombia;92;1;470;4
2020-03-26;CO;Colombia;21;2;491;6
2020-03-27;CO;Colombia;48;0;539;6
2020-03-28;CO;Colombia;69;0;608;6
2020-03-29;CO;Colombia;94;4;702;10
2020-03-30;CO;Colombia;96;2;798;12
2020-03-31;CO;Colombia;108;4;906;16
2020-04-01;CO;Colombia;159;1;1065;17
2020-04-02;CO;Colombia;96;2;1161;19
2020-04-03;CO;Colombia;106;6;1267;25
2020-04-04;CO;Colombia;139;7;1406;32
2020-04-05;CO;Colombia;79;3;1485;35
2020-04-06;CO;Colombia;94;11;1579;46
2020-04-07;CO;Colombia;201;4;1780;50
2020-04-08;CO;Colombia;274;4;2054;54
2020-04-09;CO;Colombia;169;15;2223;69
2020-04-10;CO;Colombia;250;11;2473;80
2020-04-11;CO;Colombia;236;20;2709;100
2020-04-12;CO;Colombia;67;9;2776;109
2020-04-13;CO;Colombia;76;3;2852;112
2020-04-14;CO;Colombia;127;15;2979;127
2020-04-15;CO;Colombia;126;4;3105;131
2020-04-16;CO;Colombia;128;13;3233;144
2020-04-17;CO;Colombia;206;9;3439;153
2020-04-18;CO;Colombia;182;13;3621;166
2020-04-19;CO;Colombia;171;13;3792;179
2020-04-20;CO;Colombia;185;10;3977;189
2020-04-21;CO;Colombia;172;7;4149;196
2020-04-22;CO;Colombia;207;10;4356;206
2020-04-23;CO;Colombia;205;9;4561;215
2020-04-24;CO;Colombia;320;10;4881;225
2020-04-25;CO;Colombia;261;8;5142;233
2020-04-26;CO;Colombia;237;11;5379;244
2020-04-27;CO;Colombia;218;9;5597;253
2020-04-28;CO;Colombia;352;16;5949;269
2020-04-29;CO;Colombia;258;9;6207;278
2020-04-30;CO;Colombia;300;15;6507;293
2020-05-01;CO;Colombia;499;21;7006;314
2020-05-02;CO;Colombia;279;10;7285;324
2020-05-03;CO;Colombia;383;16;7668;340
2020-05-04;CO;Colombia;305;18;7973;358
2020-05-05;CO;Colombia;640;20;8613;378
2020-05-06;CO;Colombia;346;19;8959;397
2020-05-07;CO;Colombia;497;10;9456;407
2020-05-08;CO;Colombia;595;21;10051;428
2020-05-09;CO;Colombia;444;17;10495;445
2020-05-10;CO;Colombia;568;18;11063;463
2020-05-11;CO;Colombia;550;16;11613;479
2020-05-12;CO;Colombia;659;14;12272;493
2020-05-13;CO;Colombia;658;16;12930;509
2020-05-14;CO;Colombia;680;16;13610;525
2020-05-15;CO;Colombia;606;21;14216;546
2020-05-16;CO;Colombia;723;16;14939;562
2020-05-17;CO;Colombia;635;12;15574;574
2020-05-18;CO;Colombia;721;18;16295;592
2020-05-19;CO;Colombia;640;21;16935;613
2020-05-20;CO;Colombia;752;17;17687;630
2020-05-21;CO;Colombia;643;22;18330;652
2020-05-22;CO;Colombia;801;30;19131;682
2020-05-23;CO;Colombia;1046;23;20177;705
2020-05-24;CO;Colombia;998;22;21175;727
2020-05-25;CO;Colombia;806;23;21981;750
2020-05-26;CO;Colombia;1022;26;23003;776
2020-05-27;CO;Colombia;1101;27;24104;803
2020-05-28;CO;Colombia;1262;19;25366;822
2020-05-29;CO;Colombia;1322;31;26688;853
2020-05-30;CO;Colombia;1548;37;28236;890
2020-05-31;CO;Colombia;1147;49;29383;939
2020-06-01;CO;Colombia;1110;30;30493;969
2020-06-02;CO;Colombia;1340;40;31833;1009
2020-06-03;CO;Colombia;1521;36;33354;1045
2020-06-04;CO;Colombia;1766;42;35120;1087
2020-06-05;CO;Colombia;1515;58;36635;1145
2020-06-06;CO;Colombia;1392;60;38027;1205
2020-06-07;CO;Colombia;1209;54;39236;1259
2020-06-08;CO;Colombia;1483;49;40719;1308
2020-06-09;CO;Colombia;1359;64;42078;1372
2020-06-10;CO;Colombia;1604;61;43682;1433
2020-06-11;CO;Colombia;1530;55;45212;1488
2020-06-12;CO;Colombia;1646;57;46858;1545
2020-06-13;CO;Colombia;1888;47;48746;1592
2020-06-14;CO;Colombia;2193;75;50939;1667
2020-06-15;CO;Colombia;2124;59;53063;1726
2020-06-16;CO;Colombia;1868;75;54931;1801
2020-06-17;CO;Colombia;2115;63;57046;1864
2020-06-18;CO;Colombia;3171;86;60217;1950
2020-06-19;CO;Colombia;3059;95;63276;2045
2020-06-20;CO;Colombia;2357;81;65633;2126
2020-06-21;CO;Colombia;3019;111;68652;2237
2020-06-22;CO;Colombia;2531;73;71183;2310
2020-06-23;CO;Colombia;2389;94;73572;2404
2020-06-24;CO;Colombia;3541;87;77113;2491
2020-06-25;CO;Colombia;3486;163;80599;2654
2020-06-26;CO;Colombia;3843;157;84442;2811
2020-06-27;CO;Colombia;4149;128;88591;2939
2020-06-28;CO;Colombia;3178;239;91769;3178
2020-06-29;CO;Colombia;3274;96;95043;3274
2020-06-30;CO;Colombia;2803;60;97846;3334
2020-07-01;CO;Colombia;4163;136;102009;3470
2020-07-02;CO;Colombia;4101;171;106110;3641
2020-07-03;CO;Colombia;3395;136;109505;3777
2020-07-04;CO;Colombia;3884;165;113389;3942
2020-07-05;CO;Colombia;3721;122;117110;4064
2020-07-06;CO;Colombia;3171;146;120281;4210
2020-07-07;CO;Colombia;4213;149;124494;4359
2020-07-08;CO;Colombia;4144;168;128638;4527
2020-07-09;CO;Colombia;5335;187;133973;4714
2020-07-10;CO;Colombia;6803;211;140776;4925
2020-07-11;CO;Colombia;4856;194;145632;5119
2020-07-12;CO;Colombia;4813;188;150445;5307
2020-07-13;CO;Colombia;3832;148;154277;5455
2020-07-14;CO;Colombia;5621;170;159898;5625
2020-07-15;CO;Colombia;5271;189;165169;5814
2020-07-16;CO;Colombia;8037;215;173206;6029
2020-07-17;CO;Colombia;8934;259;182140;6288
2020-07-18;CO;Colombia;8560;228;190700;6516
2020-07-19;CO;Colombia;6578;220;197278;6736
2020-07-20;CO;Colombia;6727;193;204005;6929
2020-07-21;CO;Colombia;7033;237;211038;7166
2020-07-22;CO;Colombia;7390;207;218428;7373
2020-07-23;CO;Colombia;7945;315;226373;7688
2020-07-24;CO;Colombia;7168;287;233541;7975
2020-07-25;CO;Colombia;7254;294;240795;8269
2020-07-26;CO;Colombia;8181;256;248976;8525
2020-07-27;CO;Colombia;8125;252;257101;8777
2020-07-28;CO;Colombia;10284;297;267385;9074
2020-07-29;CO;Colombia;8670;380;276055;9454
2020-07-30;CO;Colombia;9965;356;286020;9810
2020-07-31;CO;Colombia;9488;295;295508;10105
2020-08-01;CO;Colombia;10673;225;306181;10330
2020-08-02;CO;Colombia;11470;320;317651;10650
2020-08-03;CO;Colombia;10199;367;327850;11017
2020-08-04;CO;Colombia;7129;298;334979;11315
2020-08-05;CO;Colombia;10735;309;345714;11624
2020-08-06;CO;Colombia;11996;315;357710;11939
2020-08-07;CO;Colombia;9494;311;367204;12250
2020-08-08;CO;Colombia;9666;290;376870;12540
2020-08-09;CO;Colombia;10611;302;387481;12842
2020-08-10;CO;Colombia;10142;312;397623;13154
2020-08-11;CO;Colombia;12830;321;410453;13475
2020-08-12;CO;Colombia;12066;362;422519;13837
2020-08-13;CO;Colombia;11286;308;433805;14145
2020-08-14;CO;Colombia;11306;347;445111;14492
2020-08-15;CO;Colombia;11578;318;456689;14810
2020-08-16;CO;Colombia;11643;287;468332;15097
2020-08-17;CO;Colombia;8328;275;476660;15372
2020-08-18;CO;Colombia;12462;247;489122;15619
2020-08-19;CO;Colombia;13056;360;502178;15979
2020-08-20;CO;Colombia;11541;204;513719;16183
2020-08-21;CO;Colombia;8419;385;522138;16568
2020-08-22;CO;Colombia;10965;400;533103;16968
2020-08-23;CO;Colombia;8036;348;541139;17316
2020-08-24;CO;Colombia;10549;296;551688;17612
2020-08-25;CO;Colombia;10425;277;562113;17889
2020-08-26;CO;Colombia;10130;295;572243;18184
2020-08-27;CO;Colombia;9752;283;581995;18467
2020-08-28;CO;Colombia;8497;299;590492;18766
2020-08-29;CO;Colombia;9392;297;599884;19063
2020-08-30;CO;Colombia;8020;300;607904;19363
2020-08-31;CO;Colombia;7190;299;615094;19662
2020-09-01;CO;Colombia;8932;388;624026;20050
2020-09-02;CO;Colombia;9295;295;633321;20345
2020-09-03;CO;Colombia;8253;273;641574;20618
2020-09-04;CO;Colombia;8489;270;650063;20888
2020-09-05;CO;Colombia;8393;268;658456;21156
2020-09-06;CO;Colombia;8065;256;666521;21412
2020-09-07;CO;Colombia;5327;203;671848;21615
2020-09-08;CO;Colombia;7665;202;679513;21817
2020-09-09;CO;Colombia;7338;236;686851;22053
2020-09-10;CO;Colombia;7813;222;694664;22275
2020-09-11;CO;Colombia;7424;243;702088;22518
2020-09-12;CO;Colombia;6876;216;708964;22734
2020-09-13;CO;Colombia;7355;190;716319;22924
2020-09-14;CO;Colombia;5573;199;721892;23123
2020-09-15;CO;Colombia;6698;165;728590;23288
2020-09-16;CO;Colombia;7787;190;736377;23478
2020-09-17;CO;Colombia;7568;187;743945;23665
2020-09-18;CO;Colombia;6526;0;750471;23665
2020-09-19;CO;Colombia;7927;374;758398;24039
2020-09-20;CO;Colombia;6678;169;765076;24208
2020-09-21;CO;Colombia;5359;189;770435;24397
2020-09-22;CO;Colombia;7102;0;777537;24397
2020-09-23;CO;Colombia;6731;349;784268;24746
2020-09-24;CO;Colombia;6555;0;790823;24746
2020-09-25;CO;Colombia;7494;357;798317;25103
2020-09-26;CO;Colombia;7721;193;806038;25296
2020-09-27;CO;Colombia;7018;192;813056;25488
2020-09-28;CO;Colombia;5147;153;818203;25641
2020-09-29;CO;Colombia;5839;187;824042;25828
2020-09-30;CO;Colombia;5637;170;829679;25998
2020-10-01;CO;Colombia;5660;198;835339;26196
2020-10-02;CO;Colombia;6193;201;841532;26397
2020-10-03;CO;Colombia;6615;159;848147;26556
2020-10-04;CO;Colombia;6905;156;855052;26712
2020-10-05;CO;Colombia;7106;132;862158;26844
2020-10-06;CO;Colombia;7650;173;869808;27017
2020-10-07;CO;Colombia;7876;163;877684;27180
2020-10-08;CO;Colombia;8495;0;886179;27180
2020-10-09;CO;Colombia;8121;315;894300;27495
2020-10-10;CO;Colombia;8447;165;902747;27660
2020-10-11;CO;Colombia;8569;174;911316;27834
2020-10-12;CO;Colombia;7768;151;919084;27985
2020-10-13;CO;Colombia;5014;156;924098;28141
2020-10-14;CO;Colombia;6061;165;930159;28306
2020-10-15;CO;Colombia;6823;151;936982;28457
2020-10-16;CO;Colombia;8372;159;945354;28616
2020-10-17;CO;Colombia;7017;187;952371;28803
2020-10-18;CO;Colombia;7201;167;959572;28970
2020-10-19;CO;Colombia;6311;132;965883;29102
2020-10-20;CO;Colombia;8256;170;974139;29272
2020-10-21;CO;Colombia;7561;192;981700;29464
2020-10-22;CO;Colombia;8673;173;990373;29637
2020-10-23;CO;Colombia;8569;165;998942;29802
2020-10-24;CO;Colombia;8769;198;1007711;30000
2020-10-25;CO;Colombia;8174;154;1015885;30154
2020-10-26;CO;Colombia;9167;194;1025052;30348
2020-10-27;CO;Colombia;8166;217;1033218;30565
2020-10-28;CO;Colombia;8717;188;1041935;30753
2020-10-29;CO;Colombia;11187;173;1053122;30926
2020-10-30;CO;Colombia;10029;209;1063151;31135
2020-10-31;CO;Colombia;11033;179;1074184;31314
2020-11-01;CO;Colombia;9137;201;1083321;31515
2020-11-02;CO;Colombia;9935;138;1093256;31653
2020-11-03;CO;Colombia;6136;194;1099392;31847
2020-11-04;CO;Colombia;8694;166;1108086;32013
2020-11-05;CO;Colombia;9891;196;1117977;32209
2020-11-06;CO;Colombia;9756;196;1127733;32405
2020-11-07;CO;Colombia;8714;190;1136447;32595
2020-11-08;CO;Colombia;7440;196;1143887;32791
2020-11-09;CO;Colombia;5177;183;1149064;32974
2020-11-10;CO;Colombia;6292;154;1155356;33128
2020-11-11;CO;Colombia;9970;184;1165326;33312
2020-11-12;CO;Colombia;8686;179;1174012;33491
2020-11-13;CO;Colombia;8685;178;1182697;33669
2020-11-14;CO;Colombia;8937;160;1191634;33829
2020-11-15;CO;Colombia;7112;202;1198746;34031
2020-11-16;CO;Colombia;6471;192;1205217;34223
2020-11-17;CO;Colombia;5911;158;1211128;34381
2020-11-18;CO;Colombia;6875;182;1218003;34563
2020-11-19;CO;Colombia;7487;198;1225490;34761
2020-11-20;CO;Colombia;7954;168;1233444;34929
2020-11-21;CO;Colombia;7049;175;1240493;35104
2020-11-22;CO;Colombia;7924;183;1248417;35287
2020-11-23;CO;Colombia;6562;192;1254979;35479
2020-11-24;CO;Colombia;7515;198;1262494;35677
2020-11-25;CO;Colombia;8497;183;1270991;35860
2020-11-26;CO;Colombia;9496;159;1280487;36019
2020-11-27;CO;Colombia;10023;195;1290510;36214
2020-11-28;CO;Colombia;9103;187;1299613;36401
2020-11-29;CO;Colombia;8763;183;1308376;36584
2020-11-30;CO;Colombia;8430;182;1316806;36766
2020-12-01;CO;Colombia;7986;168;1324792;36934
2020-12-02;CO;Colombia;9297;183;1334089;37117
2020-12-03;CO;Colombia;9233;188;1343322;37305
2020-12-04;CO;Colombia;9285;162;1352607;37467
2020-12-05;CO;Colombia;9642;166;1362249;37633
2020-12-06;CO;Colombia;8854;175;1371103;37808
2020-12-07;CO;Colombia;5997;187;1377100;37995
2020-12-08;CO;Colombia;7510;163;1384610;38158
2020-12-09;CO;Colombia;7523;150;1392133;38308
2020-12-10;CO;Colombia;7778;176;1399911;38484
2020-12-11;CO;Colombia;8998;185;1408909;38669
2020-12-12;CO;Colombia;8163;197;1417072;38866
2020-12-13;CO;Colombia;8702;187;1425774;39053
2020-12-14;CO;Colombia;8742;142;1434516;39195
2020-12-15;CO;Colombia;10130;161;1444646;39356
2020-12-16;CO;Colombia;11953;204;1456599;39560
2020-12-17;CO;Colombia;12196;227;1468795;39787
2020-12-18;CO;Colombia;13277;232;1482072;40019
2020-12-19;CO;Colombia;13990;249;1496062;40268
2020-12-20;CO;Colombia;11160;207;1507222;40475
2020-12-21;CO;Colombia;10845;205;1518067;40680
2020-12-22;CO;Colombia;12526;251;1530593;40931
2020-12-23;CO;Colombia;14233;243;1544826;41174
2020-12-24;CO;Colombia;14940;280;1559766;41454
2020-12-25;CO;Colombia;14941;236;1574707;41690
2020-12-26;CO;Colombia;10196;253;1584903;41943
2020-12-27;CO;Colombia;9594;228;1594497;42171
2020-12-28;CO;Colombia;9310;203;1603807;42374
2020-12-29;CO;Colombia;11015;246;1614822;42620
2020-12-30;CO;Colombia;11639;289;1626461;42909
2020-12-31;CO;Colombia;16314;304;1642775;43213
2021-01-01;CO;Colombia;12105;282;1654880;43495
2021-01-02;CO;Colombia;11528;270;1666408;43765
2021-01-03;CO;Colombia;9412;200;1675820;43965
2021-01-04;CO;Colombia;10311;222;1686131;44187
2021-01-05;CO;Colombia;16835;241;1702966;44428
2021-01-06;CO;Colombia;16805;295;1719771;44723
2021-01-07;CO;Colombia;17576;344;1737347;45067
2021-01-08;CO;Colombia;18221;364;1755568;45431
2021-01-09;CO;Colombia;15795;353;1771363;45784
2021-01-10;CO;Colombia;15537;330;1786900;46114
2021-01-11;CO;Colombia;15003;337;1801903;46451
2021-01-12;CO;Colombia;14179;331;1816082;46782
2021-01-13;CO;Colombia;15898;342;1831980;47124
2021-01-14;CO;Colombia;17121;367;1849101;47491
2021-01-15;CO;Colombia;21078;377;1870179;47868
2021-01-16;CO;Colombia;20855;388;1891034;48256
2021-01-17;CO;Colombia;17379;375;1908413;48631
2021-01-18;CO;Colombia;14719;373;1923132;49004
2021-01-19;CO;Colombia;15939;398;1939071;49402
2021-01-20;CO;Colombia;17908;390;1956979;49792
2021-01-21;CO;Colombia;15366;395;1972345;50187
2021-01-22;CO;Colombia;15073;399;1987418;50586
2021-01-23;CO;Colombia;15551;396;2002969;50982
2021-01-24;CO;Colombia;12516;392;2015485;51374
2021-01-25;CO;Colombia;12261;373;2027746;51747
2021-01-26;CO;Colombia;13606;381;2041352;52128
2021-01-27;CO;Colombia;13953;395;2055305;52523
2021-01-28;CO;Colombia;12270;390;2067575;52913
2021-01-29;CO;Colombia;10058;371;2077633;53284
2021-01-30;CO;Colombia;9173;366;2086806;53650
2021-01-31;CO;Colombia;8078;333;2094884;53983
2021-02-01;CO;Colombia;9622;289;2104506;54272
2021-02-02;CO;Colombia;10091;304;2114597;54576
2021-02-03;CO;Colombia;11025;301;2125622;54877
2021-02-04;CO;Colombia;9790;254;2135412;55131
2021-02-05;CO;Colombia;7248;272;2142660;55403
2021-02-06;CO;Colombia;8547;290;2151207;55693
2021-02-07;CO;Colombia;6009;300;2157216;55993
2021-02-08;CO;Colombia;4246;297;2161462;56290
2021-02-09;CO;Colombia;5442;217;2166904;56507
2021-02-10;CO;Colombia;6443;226;2173347;56733
2021-02-11;CO;Colombia;6294;250;2179641;56983
2021-02-12;CO;Colombia;5528;213;2185169;57196
2021-02-13;CO;Colombia;4947;229;2190116;57425
2021-02-14;CO;Colombia;4923;180;2195039;57605
2021-02-15;CO;Colombia;3510;181;2198549;57786
2021-02-16;CO;Colombia;4049;163;2202598;57949
2021-02-17;CO;Colombia;5103;185;2207701;58134
2021-02-18;CO;Colombia;4824;200;2212525;58334
2021-02-19;CO;Colombia;4476;177;2217001;58511
2021-02-20;CO;Colombia;5017;174;2222018;58685
2021-02-21;CO;Colombia;4244;149;2226262;58834
2021-02-22;CO;Colombia;3401;140;2229663;58974
2021-02-23;CO;Colombia;3926;144;2233589;59118
2021-02-24;CO;Colombia;3953;142;2237542;59260
2021-02-25;CO;Colombia;3683;136;2241225;59396
2021-02-26;CO;Colombia;3567;122;2244792;59518
2021-02-27;CO;Colombia;3343;142;2248135;59660
2021-02-28;CO;Colombia;3555;106;2251690;59766
2021-03-01;CO;Colombia;3570;100;2255260;59866
2021-03-02;CO;Colombia;4339;106;2259599;59972
2021-03-03;CO;Colombia;3047;110;2262646;60082
2021-03-04;CO;Colombia;3565;107;2266211;60189
2021-03-05;CO;Colombia;3371;111;2269582;60300
2021-03-06;CO;Colombia;3663;112;2273245;60412
2021-03-07;CO;Colombia;3411;91;2276656;60503
2021-03-08;CO;Colombia;2205;95;2278861;60598
2021-03-09;CO;Colombia;3511;78;2282372;60676
2021-03-10;CO;Colombia;3588;97;2285960;60773
2021-03-11;CO;Colombia;4579;85;2290539;60858
2021-03-12;CO;Colombia;4078;92;2294617;60950
2021-03-13;CO;Colombia;4465;96;2299082;61046
2021-03-14;CO;Colombia;4062;97;2303144;61143
2021-03-15;CO;Colombia;2740;100;2305884;61243
2021-03-16;CO;Colombia;3716;125;2309600;61368
2021-03-17;CO;Colombia;4554;130;2314154;61498
2021-03-18;CO;Colombia;5139;138;2319293;61636
2021-03-19;CO;Colombia;5133;135;2324426;61771
2021-03-20;CO;Colombia;6761;136;2331187;61907
2021-03-21;CO;Colombia;6043;121;2337230;62028
2021-03-22;CO;Colombia;5048;120;2342278;62148
2021-03-23;CO;Colombia;4946;126;2347224;62274
2021-03-24;CO;Colombia;5986;120;2353210;62394
2021-03-25;CO;Colombia;6732;125;2359942;62519
2021-03-26;CO;Colombia;7395;126;2367337;62645
2021-03-27;CO;Colombia;8254;145;2375591;62790
2021-03-28;CO;Colombia;7139;165;2382730;62955
2021-03-29;CO;Colombia;7049;124;2389779;63079
2021-03-30;CO;Colombia;7952;176;2397731;63255
2021-03-31;CO;Colombia;8646;167;2406377;63422
2021-04-01;CO;Colombia;11449;192;2417826;63614
2021-04-02;CO;Colombia;10222;163;2428048;63777
2021-04-03;CO;Colombia;9149;155;2437197;63932
2021-04-04;CO;Colombia;9022;162;2446219;64094
2021-04-05;CO;Colombia;10190;199;2456409;64293
2021-04-06;CO;Colombia;11827;231;2468236;64524
2021-04-07;CO;Colombia;11381;243;2479617;64767
2021-04-08;CO;Colombia;12464;247;2492081;65014
2021-04-09;CO;Colombia;12125;269;2504206;65283
2021-04-10;CO;Colombia;14509;325;2518715;65608
2021-04-11;CO;Colombia;17483;281;2536198;65889
2021-04-12;CO;Colombia;16739;267;2552937;66156
2021-04-13;CO;Colombia;16377;326;2569314;66482
2021-04-14;CO;Colombia;16487;337;2585801;66819
2021-04-15;CO;Colombia;16918;380;2602719;67199
2021-04-16;CO;Colombia;16703;365;2619422;67564
2021-04-17;CO;Colombia;16654;367;2636076;67931
2021-04-18;CO;Colombia;16871;397;2652947;68328
2021-04-19;CO;Colombia;14189;420;2667136;68748
2021-04-20;CO;Colombia;16965;429;2684101;69177
2021-04-21;CO;Colombia;17212;419;2701313;69596
2021-04-22;CO;Colombia;19306;430;2720619;70026
2021-04-23;CO;Colombia;19925;420;2740544;70446
2021-04-24;CO;Colombia;16730;440;2757274;70886
2021-04-25;CO;Colombia;17190;465;2774464;71351
2021-04-26;CO;Colombia;12839;448;2787303;71799
2021-04-27;CO;Colombia;17578;436;2804881;72235
2021-04-28;CO;Colombia;19745;490;2824626;72725
2021-04-29;CO;Colombia;17308;505;2841934;73230
2021-04-30;CO;Colombia;17790;490;2859724;73720
2021-05-01;CO;Colombia;18022;272;2877746;73992
2021-05-02;CO;Colombia;15909;485;2893655;74477
2021-05-03;CO;Colombia;11599;687;2905254;75164
2021-05-04;CO;Colombia;14551;463;2919805;75627
2021-05-05;CO;Colombia;14806;388;2934611;76015
2021-05-06;CO;Colombia;16490;399;2951101;76414
2021-05-07;CO;Colombia;17525;453;2968626;76867
2021-05-08;CO;Colombia;16910;492;2985536;77359
2021-05-09;CO;Colombia;17222;495;3002758;77854
2021-05-10;CO;Colombia;12543;488;3015301;78342
2021-05-11;CO;Colombia;16425;429;3031726;78771
2021-05-12;CO;Colombia;16993;490;3048719;79261
2021-05-13;CO;Colombia;19160;499;3067879;79760
2021-05-14;CO;Colombia;16581;490;3084460;80250
2021-05-15;CO;Colombia;18873;530;3103333;80780
2021-05-16;CO;Colombia;15093;520;3118426;81300
2021-05-17;CO;Colombia;12984;509;3131410;81809
2021-05-18;CO;Colombia;13137;482;3144547;82291
2021-05-19;CO;Colombia;16579;452;3161126;82743
2021-05-20;CO;Colombia;16086;490;3177212;83233
2021-05-21;CO;Colombia;14838;486;3192050;83719
2021-05-22;CO;Colombia;18737;509;3210787;84228
2021-05-23;CO;Colombia;21669;496;3232456;84724
2021-05-24;CO;Colombia;16977;483;3249433;85207
2021-05-25;CO;Colombia;21181;459;3270614;85666
2021-05-26;CO;Colombia;23487;514;3294101;86180
2021-05-27;CO;Colombia;25092;513;3319193;86693
2021-05-28;CO;Colombia;23374;514;3342567;87207
2021-05-29;CO;Colombia;20494;540;3363061;87747
2021-05-30;CO;Colombia;20218;535;3383279;88282
2021-05-31;CO;Colombia;23177;492;3406456;88774
2021-06-01;CO;Colombia;25966;523;3432422;89297
2021-06-02;CO;Colombia;27000;511;3459422;89808
2021-06-03;CO;Colombia;28624;545;3488046;90353
2021-06-04;CO;Colombia;30000;537;3518046;90890
2021-06-05;CO;Colombia;28971;532;3547017;91422
2021-06-06;CO;Colombia;24050;539;3571067;91961
2021-06-07;CO;Colombia;21949;535;3593016;92496
2021-06-08;CO;Colombia;18586;427;3611602;92923
2021-06-09;CO;Colombia;21879;471;3633481;93394
2021-06-10;CO;Colombia;31656;652;3665137;94046
2021-06-11;CO;Colombia;29570;569;3694707;94615
2021-06-12;CO;Colombia;29998;577;3724705;95192
2021-06-13;CO;Colombia;28519;586;3753224;95778
2021-06-14;CO;Colombia;24376;588;3777600;96366
2021-06-15;CO;Colombia;24452;599;3802052;96965
2021-06-16;CO;Colombia;27827;595;3829879;97560
2021-06-17;CO;Colombia;29945;596;3859824;98156
2021-06-18;CO;Colombia;28790;590;3888614;98746
2021-06-19;CO;Colombia;28734;589;3917348;99335
2021-06-20;CO;Colombia;27818;599;3945166;99934
2021-06-21;CO;Colombia;23239;648;3968405;100582
2021-06-22;CO;Colombia;28616;720;3997021;101302
2021-06-23;CO;Colombia;29995;645;4027016;101947
2021-06-24;CO;Colombia;32997;689;4060013;102636
2021-06-25;CO;Colombia;32733;685;4092746;103321
2021-06-26;CO;Colombia;33594;693;4126340;104014
2021-06-27;CO;Colombia;32376;664;4158716;104678
2021-06-28;CO;Colombia;28478;648;4187194;105326
2021-06-29;CO;Colombia;25880;608;4213074;105934
2021-06-30;CO;Colombia;27908;610;4240982;106544
2021-07-01;CO;Colombia;28315;593;4269297;107137
2020-04-30;KM;Comoros;1;0;1;0
2020-05-01;KM;Comoros;0;0;1;0
2020-05-02;KM;Comoros;2;0;3;0
2020-05-03;KM;Comoros;0;0;3;0
2020-05-04;KM;Comoros;0;0;3;0
2020-05-05;KM;Comoros;0;0;3;0
2020-05-06;KM;Comoros;5;1;8;1
2020-05-07;KM;Comoros;0;0;8;1
2020-05-08;KM;Comoros;0;0;8;1
2020-05-09;KM;Comoros;3;0;11;1
2020-05-10;KM;Comoros;0;0;11;1
2020-05-11;KM;Comoros;0;0;11;1
2020-05-12;KM;Comoros;0;0;11;1
2020-05-13;KM;Comoros;0;0;11;1
2020-05-14;KM;Comoros;0;0;11;1
2020-05-15;KM;Comoros;0;0;11;1
2020-05-16;KM;Comoros;0;0;11;1
2020-05-17;KM;Comoros;0;0;11;1
2020-05-18;KM;Comoros;0;0;11;1
2020-05-19;KM;Comoros;0;0;11;1
2020-05-20;KM;Comoros;23;0;34;1
2020-05-21;KM;Comoros;0;0;34;1
2020-05-22;KM;Comoros;44;0;78;1
2020-05-23;KM;Comoros;0;0;78;1
2020-05-24;KM;Comoros;9;0;87;1
2020-05-25;KM;Comoros;0;0;87;1
2020-05-26;KM;Comoros;0;0;87;1
2020-05-27;KM;Comoros;0;1;87;2
2020-05-28;KM;Comoros;0;0;87;2
2020-05-29;KM;Comoros;0;0;87;2
2020-05-30;KM;Comoros;19;0;106;2
2020-05-31;KM;Comoros;0;0;106;2
2020-06-01;KM;Comoros;0;0;106;2
2020-06-02;KM;Comoros;26;0;132;2
2020-06-03;KM;Comoros;0;0;132;2
2020-06-04;KM;Comoros;0;0;132;2
2020-06-05;KM;Comoros;0;0;132;2
2020-06-06;KM;Comoros;9;0;141;2
2020-06-07;KM;Comoros;0;0;141;2
2020-06-08;KM;Comoros;0;0;141;2
2020-06-09;KM;Comoros;0;0;141;2
2020-06-10;KM;Comoros;21;0;162;2
2020-06-11;KM;Comoros;0;0;162;2
2020-06-12;KM;Comoros;1;0;163;2
2020-06-13;KM;Comoros;13;0;176;2
2020-06-14;KM;Comoros;0;0;176;2
2020-06-15;KM;Comoros;0;0;176;2
2020-06-16;KM;Comoros;21;1;197;3
2020-06-17;KM;Comoros;0;0;197;3
2020-06-18;KM;Comoros;13;2;210;5
2020-06-19;KM;Comoros;0;0;210;5
2020-06-20;KM;Comoros;37;0;247;5
2020-06-21;KM;Comoros;0;0;247;5
2020-06-22;KM;Comoros;0;0;247;5
2020-06-23;KM;Comoros;18;2;265;7
2020-06-24;KM;Comoros;0;0;265;7
2020-06-25;KM;Comoros;7;0;272;7
2020-06-26;KM;Comoros;0;0;272;7
2020-06-27;KM;Comoros;0;0;272;7
2020-06-28;KM;Comoros;0;0;272;7
2020-06-29;KM;Comoros;0;0;272;7
2020-06-30;KM;Comoros;31;0;303;7
2020-07-01;KM;Comoros;0;0;303;7
2020-07-02;KM;Comoros;0;0;303;7
2020-07-03;KM;Comoros;6;0;309;7
2020-07-04;KM;Comoros;0;0;309;7
2020-07-05;KM;Comoros;2;0;311;7
2020-07-06;KM;Comoros;0;0;311;7
2020-07-07;KM;Comoros;0;0;311;7
2020-07-08;KM;Comoros;2;0;313;7
2020-07-09;KM;Comoros;1;0;314;7
2020-07-10;KM;Comoros;0;0;314;7
2020-07-11;KM;Comoros;3;0;317;7
2020-07-12;KM;Comoros;0;0;317;7
2020-07-13;KM;Comoros;0;0;317;7
2020-07-14;KM;Comoros;4;0;321;7
2020-07-15;KM;Comoros;0;0;321;7
2020-07-16;KM;Comoros;7;0;328;7
2020-07-17;KM;Comoros;0;0;328;7
2020-07-18;KM;Comoros;0;0;328;7
2020-07-19;KM;Comoros;6;0;334;7
2020-07-20;KM;Comoros;0;0;334;7
2020-07-21;KM;Comoros;3;0;337;7
2020-07-22;KM;Comoros;0;0;337;7
2020-07-23;KM;Comoros;3;0;340;7
2020-07-24;KM;Comoros;0;0;340;7
2020-07-25;KM;Comoros;0;0;340;7
2020-07-26;KM;Comoros;14;0;354;7
2020-07-27;KM;Comoros;0;0;354;7
2020-07-28;KM;Comoros;0;0;354;7
2020-07-29;KM;Comoros;24;0;378;7
2020-07-30;KM;Comoros;0;0;378;7
2020-07-31;KM;Comoros;0;0;378;7
2020-08-01;KM;Comoros;8;0;386;7
2020-08-02;KM;Comoros;0;0;386;7
2020-08-03;KM;Comoros;0;0;386;7
2020-08-04;KM;Comoros;2;0;388;7
2020-08-05;KM;Comoros;0;0;388;7
2020-08-06;KM;Comoros;8;0;396;7
2020-08-07;KM;Comoros;0;0;396;7
2020-08-08;KM;Comoros;3;0;399;7
2020-08-09;KM;Comoros;0;0;399;7
2020-08-10;KM;Comoros;0;0;399;7
2020-08-11;KM;Comoros;0;0;399;7
2020-08-12;KM;Comoros;0;0;399;7
2020-08-13;KM;Comoros;0;0;399;7
2020-08-14;KM;Comoros;4;0;403;7
2020-08-15;KM;Comoros;0;0;403;7
2020-08-16;KM;Comoros;2;0;405;7
2020-08-17;KM;Comoros;0;0;405;7
2020-08-18;KM;Comoros;1;0;406;7
2020-08-19;KM;Comoros;0;0;406;7
2020-08-20;KM;Comoros;11;0;417;7
2020-08-21;KM;Comoros;0;0;417;7
2020-08-22;KM;Comoros;0;0;417;7
2020-08-23;KM;Comoros;0;0;417;7
2020-08-24;KM;Comoros;0;0;417;7
2020-08-25;KM;Comoros;0;0;417;7
2020-08-26;KM;Comoros;0;0;417;7
2020-08-27;KM;Comoros;5;0;422;7
2020-08-28;KM;Comoros;0;0;422;7
2020-08-29;KM;Comoros;1;0;423;7
2020-08-30;KM;Comoros;0;0;423;7
2020-08-31;KM;Comoros;0;0;423;7
2020-09-01;KM;Comoros;4;0;427;7
2020-09-02;KM;Comoros;0;0;427;7
2020-09-03;KM;Comoros;21;0;448;7
2020-09-04;KM;Comoros;0;0;448;7
2020-09-05;KM;Comoros;4;0;452;7
2020-09-06;KM;Comoros;0;0;452;7
2020-09-07;KM;Comoros;0;0;452;7
2020-09-08;KM;Comoros;4;0;456;7
2020-09-09;KM;Comoros;0;0;456;7
2020-09-10;KM;Comoros;0;0;456;7
2020-09-11;KM;Comoros;0;0;456;7
2020-09-12;KM;Comoros;0;0;456;7
2020-09-13;KM;Comoros;0;0;456;7
2020-09-14;KM;Comoros;1;0;457;7
2020-09-15;KM;Comoros;10;0;467;7
2020-09-16;KM;Comoros;0;0;467;7
2020-09-17;KM;Comoros;3;0;470;7
2020-09-18;KM;Comoros;0;0;470;7
2020-09-19;KM;Comoros;0;0;470;7
2020-09-20;KM;Comoros;0;0;470;7
2020-09-21;KM;Comoros;0;0;470;7
2020-09-22;KM;Comoros;0;0;470;7
2020-09-23;KM;Comoros;0;0;470;7
2020-09-24;KM;Comoros;4;0;474;7
2020-09-25;KM;Comoros;0;0;474;7
2020-09-26;KM;Comoros;4;0;478;7
2020-09-27;KM;Comoros;0;0;478;7
2020-09-28;KM;Comoros;0;0;478;7
2020-09-29;KM;Comoros;1;0;479;7
2020-09-30;KM;Comoros;0;0;479;7
2020-10-01;KM;Comoros;5;0;484;7
2020-10-02;KM;Comoros;0;0;484;7
2020-10-03;KM;Comoros;3;0;487;7
2020-10-04;KM;Comoros;0;0;487;7
2020-10-05;KM;Comoros;0;0;487;7
2020-10-06;KM;Comoros;4;0;491;7
2020-10-07;KM;Comoros;0;0;491;7
2020-10-08;KM;Comoros;4;0;495;7
2020-10-09;KM;Comoros;0;0;495;7
2020-10-10;KM;Comoros;0;0;495;7
2020-10-11;KM;Comoros;0;0;495;7
2020-10-12;KM;Comoros;0;0;495;7
2020-10-13;KM;Comoros;1;0;496;7
2020-10-14;KM;Comoros;0;0;496;7
2020-10-15;KM;Comoros;0;0;496;7
2020-10-16;KM;Comoros;6;0;502;7
2020-10-17;KM;Comoros;0;0;502;7
2020-10-18;KM;Comoros;0;0;502;7
2020-10-19;KM;Comoros;0;0;502;7
2020-10-20;KM;Comoros;2;0;504;7
2020-10-21;KM;Comoros;0;0;504;7
2020-10-22;KM;Comoros;13;0;517;7
2020-10-23;KM;Comoros;0;0;517;7
2020-10-24;KM;Comoros;0;0;517;7
2020-10-25;KM;Comoros;0;0;517;7
2020-10-26;KM;Comoros;0;0;517;7
2020-10-27;KM;Comoros;0;0;517;7
2020-10-28;KM;Comoros;0;0;517;7
2020-10-29;KM;Comoros;0;0;517;7
2020-10-30;KM;Comoros;20;0;537;7
2020-10-31;KM;Comoros;8;0;545;7
2020-11-01;KM;Comoros;0;0;545;7
2020-11-02;KM;Comoros;0;0;545;7
2020-11-03;KM;Comoros;0;0;545;7
2020-11-04;KM;Comoros;9;0;554;7
2020-11-05;KM;Comoros;3;0;557;7
2020-11-06;KM;Comoros;0;0;557;7
2020-11-07;KM;Comoros;6;0;563;7
2020-11-08;KM;Comoros;0;0;563;7
2020-11-09;KM;Comoros;0;0;563;7
2020-11-10;KM;Comoros;6;0;569;7
2020-11-11;KM;Comoros;0;0;569;7
2020-11-12;KM;Comoros;5;0;574;7
2020-11-13;KM;Comoros;0;0;574;7
2020-11-14;KM;Comoros;5;0;579;7
2020-11-15;KM;Comoros;0;0;579;7
2020-11-16;KM;Comoros;0;0;579;7
2020-11-17;KM;Comoros;12;0;591;7
2020-11-18;KM;Comoros;0;0;591;7
2020-11-19;KM;Comoros;1;0;592;7
2020-11-20;KM;Comoros;0;0;592;7
2020-11-21;KM;Comoros;4;0;596;7
2020-11-22;KM;Comoros;0;0;596;7
2020-11-23;KM;Comoros;0;0;596;7
2020-11-24;KM;Comoros;11;0;607;7
2020-11-25;KM;Comoros;0;0;607;7
2020-11-26;KM;Comoros;3;0;610;7
2020-11-27;KM;Comoros;0;0;610;7
2020-11-28;KM;Comoros;1;0;611;7
2020-11-29;KM;Comoros;0;0;611;7
2020-11-30;KM;Comoros;0;0;611;7
2020-12-01;KM;Comoros;2;0;613;7
2020-12-02;KM;Comoros;0;0;613;7
2020-12-03;KM;Comoros;2;0;615;7
2020-12-04;KM;Comoros;0;0;615;7
2020-12-05;KM;Comoros;1;0;616;7
2020-12-06;KM;Comoros;0;0;616;7
2020-12-07;KM;Comoros;0;0;616;7
2020-12-08;KM;Comoros;1;0;617;7
2020-12-09;KM;Comoros;0;0;617;7
2020-12-10;KM;Comoros;0;0;617;7
2020-12-11;KM;Comoros;0;0;617;7
2020-12-12;KM;Comoros;11;0;628;7
2020-12-13;KM;Comoros;0;0;628;7
2020-12-14;KM;Comoros;0;0;628;7
2020-12-15;KM;Comoros;5;0;633;7
2020-12-16;KM;Comoros;0;0;633;7
2020-12-17;KM;Comoros;10;0;643;7
2020-12-18;KM;Comoros;0;0;643;7
2020-12-19;KM;Comoros;0;0;643;7
2020-12-20;KM;Comoros;23;0;666;7
2020-12-21;KM;Comoros;0;0;666;7
2020-12-22;KM;Comoros;27;0;693;7
2020-12-23;KM;Comoros;0;0;693;7
2020-12-24;KM;Comoros;22;0;715;7
2020-12-25;KM;Comoros;0;0;715;7
2020-12-26;KM;Comoros;0;0;715;7
2020-12-27;KM;Comoros;0;0;715;7
2020-12-28;KM;Comoros;0;0;715;7
2020-12-29;KM;Comoros;50;2;765;9
2020-12-30;KM;Comoros;0;0;765;9
2020-12-31;KM;Comoros;58;1;823;10
2021-01-01;KM;Comoros;0;0;823;10
2021-01-02;KM;Comoros;41;3;864;13
2021-01-03;KM;Comoros;0;0;864;13
2021-01-04;KM;Comoros;0;0;864;13
2021-01-05;KM;Comoros;131;0;995;13
2021-01-06;KM;Comoros;0;0;995;13
2021-01-07;KM;Comoros;55;3;1050;16
2021-01-08;KM;Comoros;0;0;1050;16
2021-01-09;KM;Comoros;100;2;1150;18
2021-01-10;KM;Comoros;0;0;1150;18
2021-01-11;KM;Comoros;10;0;1160;18
2021-01-12;KM;Comoros;6;12;1166;30
2021-01-13;KM;Comoros;3;3;1169;33
2021-01-14;KM;Comoros;234;5;1403;38
2021-01-15;KM;Comoros;66;0;1469;38
2021-01-16;KM;Comoros;108;3;1577;41
2021-01-17;KM;Comoros;15;4;1592;45
2021-01-18;KM;Comoros;177;4;1769;49
2021-01-19;KM;Comoros;95;2;1864;51
2021-01-20;KM;Comoros;69;3;1933;54
2021-01-21;KM;Comoros;2;1;1935;55
2021-01-22;KM;Comoros;225;8;2160;63
2021-01-23;KM;Comoros;100;7;2260;70
2021-01-24;KM;Comoros;8;1;2268;71
2021-01-25;KM;Comoros;82;5;2350;76
2021-01-26;KM;Comoros;75;1;2425;77
2021-01-27;KM;Comoros;67;4;2492;81
2021-01-28;KM;Comoros;106;4;2598;85
2021-01-29;KM;Comoros;48;4;2646;89
2021-01-30;KM;Comoros;72;1;2718;90
2021-01-31;KM;Comoros;8;3;2726;93
2021-02-01;KM;Comoros;85;5;2811;98
2021-02-02;KM;Comoros;37;2;2848;100
2021-02-03;KM;Comoros;44;4;2892;104
2021-02-04;KM;Comoros;83;1;2975;105
2021-02-05;KM;Comoros;26;0;3001;105
2021-02-06;KM;Comoros;85;3;3086;108
2021-02-07;KM;Comoros;0;0;3086;108
2021-02-08;KM;Comoros;2;4;3088;112
2021-02-09;KM;Comoros;91;6;3179;118
2021-02-10;KM;Comoros;30;2;3209;120
2021-02-11;KM;Comoros;67;2;3276;122
2021-02-12;KM;Comoros;14;3;3290;125
2021-02-13;KM;Comoros;42;3;3332;128
2021-02-14;KM;Comoros;2;1;3334;129
2021-02-15;KM;Comoros;24;3;3358;132
2021-02-16;KM;Comoros;35;1;3393;133
2021-02-17;KM;Comoros;20;2;3413;135
2021-02-18;KM;Comoros;45;3;3458;138
2021-02-19;KM;Comoros;15;4;3473;142
2021-02-20;KM;Comoros;17;1;3490;143
2021-02-21;KM;Comoros;12;0;3502;143
2021-02-22;KM;Comoros;16;1;3518;144
2021-02-23;KM;Comoros;4;0;3522;144
2021-02-24;KM;Comoros;17;0;3539;144
2021-02-25;KM;Comoros;13;0;3552;144
2021-02-26;KM;Comoros;6;0;3558;144
2021-02-27;KM;Comoros;13;0;3571;144
2021-02-28;KM;Comoros;0;0;3571;144
2021-03-01;KM;Comoros;7;0;3578;144
2021-03-02;KM;Comoros;0;0;3578;144
2021-03-03;KM;Comoros;2;0;3580;144
2021-03-04;KM;Comoros;0;0;3580;144
2021-03-05;KM;Comoros;7;1;3587;145
2021-03-06;KM;Comoros;9;1;3596;146
2021-03-07;KM;Comoros;0;0;3596;146
2021-03-08;KM;Comoros;10;0;3606;146
2021-03-09;KM;Comoros;0;0;3606;146
2021-03-10;KM;Comoros;5;0;3611;146
2021-03-11;KM;Comoros;4;0;3615;146
2021-03-12;KM;Comoros;3;0;3618;146
2021-03-13;KM;Comoros;8;0;3626;146
2021-03-14;KM;Comoros;9;0;3635;146
2021-03-15;KM;Comoros;11;0;3646;146
2021-03-16;KM;Comoros;1;0;3647;146
2021-03-17;KM;Comoros;5;0;3652;146
2021-03-18;KM;Comoros;5;0;3657;146
2021-03-19;KM;Comoros;8;0;3665;146
2021-03-20;KM;Comoros;1;0;3666;146
2021-03-21;KM;Comoros;0;0;3666;146
2021-03-22;KM;Comoros;0;0;3666;146
2021-03-23;KM;Comoros;15;0;3681;146
2021-03-24;KM;Comoros;1;0;3682;146
2021-03-25;KM;Comoros;5;0;3687;146
2021-03-26;KM;Comoros;2;0;3689;146
2021-03-27;KM;Comoros;1;0;3690;146
2021-03-28;KM;Comoros;0;0;3690;146
2021-03-29;KM;Comoros;6;0;3696;146
2021-03-30;KM;Comoros;0;0;3696;146
2021-03-31;KM;Comoros;0;0;3696;146
2021-04-01;KM;Comoros;8;0;3704;146
2021-04-02;KM;Comoros;8;0;3712;146
2021-04-03;KM;Comoros;0;0;3712;146
2021-04-04;KM;Comoros;7;0;3719;146
2021-04-05;KM;Comoros;6;0;3725;146
2021-04-06;KM;Comoros;13;0;3738;146
2021-04-07;KM;Comoros;20;0;3758;146
2021-04-08;KM;Comoros;0;0;3758;146
2021-04-09;KM;Comoros;0;0;3758;146
2021-04-10;KM;Comoros;31;0;3789;146
2021-04-11;KM;Comoros;0;0;3789;146
2021-04-12;KM;Comoros;0;0;3789;146
2021-04-13;KM;Comoros;7;0;3796;146
2021-04-14;KM;Comoros;7;0;3803;146
2021-04-15;KM;Comoros;6;0;3809;146
2021-04-16;KM;Comoros;6;0;3815;146
2021-04-17;KM;Comoros;0;0;3815;146
2021-04-18;KM;Comoros;4;0;3819;146
2021-04-19;KM;Comoros;0;0;3819;146
2021-04-20;KM;Comoros;1;0;3820;146
2021-04-21;KM;Comoros;2;0;3822;146
2021-04-22;KM;Comoros;2;0;3824;146
2021-04-23;KM;Comoros;2;0;3826;146
2021-04-24;KM;Comoros;3;0;3829;146
2021-04-25;KM;Comoros;0;0;3829;146
2021-04-26;KM;Comoros;0;0;3829;146
2021-04-27;KM;Comoros;0;0;3829;146
2021-04-28;KM;Comoros;4;0;3833;146
2021-04-29;KM;Comoros;1;0;3834;146
2021-04-30;KM;Comoros;0;0;3834;146
2021-05-01;KM;Comoros;4;0;3838;146
2021-05-02;KM;Comoros;1;0;3839;146
2021-05-03;KM;Comoros;6;0;3845;146
2021-05-04;KM;Comoros;1;0;3846;146
2021-05-05;KM;Comoros;1;0;3847;146
2021-05-06;KM;Comoros;0;0;3847;146
2021-05-07;KM;Comoros;7;0;3854;146
2021-05-08;KM;Comoros;0;0;3854;146
2021-05-09;KM;Comoros;0;0;3854;146
2021-05-10;KM;Comoros;6;0;3860;146
2021-05-11;KM;Comoros;0;0;3860;146
2021-05-12;KM;Comoros;0;0;3860;146
2021-05-13;KM;Comoros;0;0;3860;146
2021-05-14;KM;Comoros;0;0;3860;146
2021-05-15;KM;Comoros;3;0;3863;146
2021-05-16;KM;Comoros;0;0;3863;146
2021-05-17;KM;Comoros;0;0;3863;146
2021-05-18;KM;Comoros;1;0;3864;146
2021-05-19;KM;Comoros;0;0;3864;146
2021-05-20;KM;Comoros;0;0;3864;146
2021-05-21;KM;Comoros;4;0;3868;146
2021-05-22;KM;Comoros;2;0;3870;146
2021-05-23;KM;Comoros;2;0;3872;146
2021-05-24;KM;Comoros;0;0;3872;146
2021-05-25;KM;Comoros;3;0;3875;146
2021-05-26;KM;Comoros;4;0;3879;146
2021-05-27;KM;Comoros;0;0;3879;146
2021-05-28;KM;Comoros;0;0;3879;146
2021-05-29;KM;Comoros;2;0;3881;146
2021-05-30;KM;Comoros;0;0;3881;146
2021-05-31;KM;Comoros;0;0;3881;146
2021-06-01;KM;Comoros;0;0;3881;146
2021-06-02;KM;Comoros;1;0;3882;146
2021-06-03;KM;Comoros;0;0;3882;146
2021-06-04;KM;Comoros;4;0;3886;146
2021-06-05;KM;Comoros;0;0;3886;146
2021-06-06;KM;Comoros;2;0;3888;146
2021-06-07;KM;Comoros;2;0;3890;146
2021-06-08;KM;Comoros;0;0;3890;146
2021-06-09;KM;Comoros;0;0;3890;146
2021-06-10;KM;Comoros;4;0;3894;146
2021-06-11;KM;Comoros;0;0;3894;146
2021-06-12;KM;Comoros;5;0;3899;146
2021-06-13;KM;Comoros;0;0;3899;146
2021-06-14;KM;Comoros;2;0;3901;146
2021-06-15;KM;Comoros;0;0;3901;146
2021-06-16;KM;Comoros;4;0;3905;146
2021-06-17;KM;Comoros;0;0;3905;146
2021-06-18;KM;Comoros;0;0;3905;146
2021-06-19;KM;Comoros;3;0;3908;146
2021-06-20;KM;Comoros;0;0;3908;146
2021-06-21;KM;Comoros;4;0;3912;146
2021-06-22;KM;Comoros;0;0;3912;146
2021-06-23;KM;Comoros;0;0;3912;146
2021-06-24;KM;Comoros;0;0;3912;146
2021-06-25;KM;Comoros;0;0;3912;146
2021-06-26;KM;Comoros;0;0;3912;146
2021-06-27;KM;Comoros;0;0;3912;146
2021-06-28;KM;Comoros;0;0;3912;146
2021-06-29;KM;Comoros;0;0;3912;146
2021-06-30;KM;Comoros;24;0;3936;146
2021-07-01;KM;Comoros;7;0;3943;146
2020-03-15;CG;Congo;1;0;1;0
2020-03-16;CG;Congo;0;0;1;0
2020-03-17;CG;Congo;0;0;1;0
2020-03-18;CG;Congo;0;0;1;0
2020-03-19;CG;Congo;2;0;3;0
2020-03-20;CG;Congo;0;0;3;0
2020-03-21;CG;Congo;0;0;3;0
2020-03-22;CG;Congo;0;0;3;0
2020-03-23;CG;Congo;1;0;4;0
2020-03-24;CG;Congo;0;0;4;0
2020-03-25;CG;Congo;0;0;4;0
2020-03-26;CG;Congo;0;0;4;0
2020-03-27;CG;Congo;0;0;4;0
2020-03-28;CG;Congo;0;0;4;0
2020-03-29;CG;Congo;15;0;19;0
2020-03-30;CG;Congo;0;0;19;0
2020-03-31;CG;Congo;0;0;19;0
2020-04-01;CG;Congo;0;0;19;0
2020-04-02;CG;Congo;3;2;22;2
2020-04-03;CG;Congo;0;0;22;2
2020-04-04;CG;Congo;0;0;22;2
2020-04-05;CG;Congo;23;3;45;5
2020-04-06;CG;Congo;0;0;45;5
2020-04-07;CG;Congo;0;0;45;5
2020-04-08;CG;Congo;0;0;45;5
2020-04-09;CG;Congo;15;0;60;5
2020-04-10;CG;Congo;0;0;60;5
2020-04-11;CG;Congo;0;0;60;5
2020-04-12;CG;Congo;0;0;60;5
2020-04-13;CG;Congo;0;0;60;5
2020-04-14;CG;Congo;0;0;60;5
2020-04-15;CG;Congo;57;0;117;5
2020-04-16;CG;Congo;0;0;117;5
2020-04-17;CG;Congo;26;1;143;6
2020-04-18;CG;Congo;0;0;143;6
2020-04-19;CG;Congo;0;0;143;6
2020-04-20;CG;Congo;17;0;160;6
2020-04-21;CG;Congo;5;0;165;6
2020-04-22;CG;Congo;21;0;186;6
2020-04-23;CG;Congo;0;0;186;6
2020-04-24;CG;Congo;14;0;200;6
2020-04-25;CG;Congo;0;0;200;6
2020-04-26;CG;Congo;0;0;200;6
2020-04-27;CG;Congo;0;0;200;6
2020-04-28;CG;Congo;7;2;207;8
2020-04-29;CG;Congo;0;0;207;8
2020-04-30;CG;Congo;13;1;220;9
2020-05-01;CG;Congo;9;0;229;9
2020-05-02;CG;Congo;0;0;229;9
2020-05-03;CG;Congo;0;0;229;9
2020-05-04;CG;Congo;7;1;236;10
2020-05-05;CG;Congo;0;0;236;10
2020-05-06;CG;Congo;28;0;264;10
2020-05-07;CG;Congo;0;0;264;10
2020-05-08;CG;Congo;10;0;274;10
2020-05-09;CG;Congo;0;0;274;10
2020-05-10;CG;Congo;0;0;274;10
2020-05-11;CG;Congo;59;1;333;11
2020-05-12;CG;Congo;0;0;333;11
2020-05-13;CG;Congo;0;0;333;11
2020-05-14;CG;Congo;58;4;391;15
2020-05-15;CG;Congo;0;0;391;15
2020-05-16;CG;Congo;0;0;391;15
2020-05-17;CG;Congo;0;0;391;15
2020-05-18;CG;Congo;21;0;412;15
2020-05-19;CG;Congo;8;0;420;15
2020-05-20;CG;Congo;0;0;420;15
2020-05-21;CG;Congo;49;1;469;16
2020-05-22;CG;Congo;0;0;469;16
2020-05-23;CG;Congo;18;0;487;16
2020-05-24;CG;Congo;0;0;487;16
2020-05-25;CG;Congo;0;0;487;16
2020-05-26;CG;Congo;0;0;487;16
2020-05-27;CG;Congo;84;3;571;19
2020-05-28;CG;Congo;0;0;571;19
2020-05-29;CG;Congo;0;0;571;19
2020-05-30;CG;Congo;0;0;571;19
2020-05-31;CG;Congo;40;1;611;20
2020-06-01;CG;Congo;0;0;611;20
2020-06-02;CG;Congo;0;0;611;20
2020-06-03;CG;Congo;0;0;611;20
2020-06-04;CG;Congo;0;0;611;20
2020-06-05;CG;Congo;24;0;635;20
2020-06-06;CG;Congo;48;2;683;22
2020-06-07;CG;Congo;0;0;683;22
2020-06-08;CG;Congo;0;0;683;22
2020-06-09;CG;Congo;45;2;728;24
2020-06-10;CG;Congo;0;0;728;24
2020-06-11;CG;Congo;0;0;728;24
2020-06-12;CG;Congo;0;0;728;24
2020-06-13;CG;Congo;0;0;728;24
2020-06-14;CG;Congo;0;0;728;24
2020-06-15;CG;Congo;155;3;883;27
2020-06-16;CG;Congo;0;0;883;27
2020-06-17;CG;Congo;0;0;883;27
2020-06-18;CG;Congo;0;0;883;27
2020-06-19;CG;Congo;0;0;883;27
2020-06-20;CG;Congo;0;0;883;27
2020-06-21;CG;Congo;0;0;883;27
2020-06-22;CG;Congo;204;10;1087;37
2020-06-23;CG;Congo;0;0;1087;37
2020-06-24;CG;Congo;0;0;1087;37
2020-06-25;CG;Congo;0;0;1087;37
2020-06-26;CG;Congo;0;0;1087;37
2020-06-27;CG;Congo;0;0;1087;37
2020-06-28;CG;Congo;0;0;1087;37
2020-06-29;CG;Congo;0;0;1087;37
2020-06-30;CG;Congo;0;0;1087;37
2020-07-01;CG;Congo;295;4;1382;41
2020-07-02;CG;Congo;0;0;1382;41
2020-07-03;CG;Congo;175;3;1557;44
2020-07-04;CG;Congo;0;0;1557;44
2020-07-05;CG;Congo;0;0;1557;44
2020-07-06;CG;Congo;0;0;1557;44
2020-07-07;CG;Congo;0;0;1557;44
2020-07-08;CG;Congo;264;3;1821;47
2020-07-09;CG;Congo;0;0;1821;47
2020-07-10;CG;Congo;207;0;2028;47
2020-07-11;CG;Congo;0;0;2028;47
2020-07-12;CG;Congo;0;0;2028;47
2020-07-13;CG;Congo;0;0;2028;47
2020-07-14;CG;Congo;0;0;2028;47
2020-07-15;CG;Congo;194;0;2222;47
2020-07-16;CG;Congo;136;1;2358;48
2020-07-17;CG;Congo;275;1;2633;49
2020-07-18;CG;Congo;0;0;2633;49
2020-07-19;CG;Congo;0;0;2633;49
2020-07-20;CG;Congo;218;1;2851;50
2020-07-21;CG;Congo;0;0;2851;50
2020-07-22;CG;Congo;0;0;2851;50
2020-07-23;CG;Congo;0;0;2851;50
2020-07-24;CG;Congo;187;1;3038;51
2020-07-25;CG;Congo;0;0;3038;51
2020-07-26;CG;Congo;0;0;3038;51
2020-07-27;CG;Congo;162;3;3200;54
2020-07-28;CG;Congo;0;0;3200;54
2020-07-29;CG;Congo;0;0;3200;54
2020-07-30;CG;Congo;0;0;3200;54
2020-07-31;CG;Congo;0;0;3200;54
2020-08-01;CG;Congo;0;0;3200;54
2020-08-02;CG;Congo;0;0;3200;54
2020-08-03;CG;Congo;346;4;3546;58
2020-08-04;CG;Congo;0;0;3546;58
2020-08-05;CG;Congo;0;0;3546;58
2020-08-06;CG;Congo;0;0;3546;58
2020-08-07;CG;Congo;91;0;3637;58
2020-08-08;CG;Congo;27;0;3664;58
2020-08-09;CG;Congo;0;0;3664;58
2020-08-10;CG;Congo;0;0;3664;58
2020-08-11;CG;Congo;81;2;3745;60
2020-08-12;CG;Congo;0;0;3745;60
2020-08-13;CG;Congo;0;0;3745;60
2020-08-14;CG;Congo;0;0;3745;60
2020-08-15;CG;Congo;0;0;3745;60
2020-08-16;CG;Congo;86;16;3831;76
2020-08-17;CG;Congo;0;0;3831;76
2020-08-18;CG;Congo;0;0;3831;76
2020-08-19;CG;Congo;19;1;3850;77
2020-08-20;CG;Congo;0;0;3850;77
2020-08-21;CG;Congo;0;0;3850;77
2020-08-22;CG;Congo;0;0;3850;77
2020-08-23;CG;Congo;0;0;3850;77
2020-08-24;CG;Congo;129;1;3979;78
2020-08-25;CG;Congo;0;0;3979;78
2020-08-26;CG;Congo;0;0;3979;78
2020-08-27;CG;Congo;0;0;3979;78
2020-08-28;CG;Congo;0;0;3979;78
2020-08-29;CG;Congo;0;0;3979;78
2020-08-30;CG;Congo;0;0;3979;78
2020-08-31;CG;Congo;0;0;3979;78
2020-09-01;CG;Congo;0;0;3979;78
2020-09-02;CG;Congo;649;24;4628;102
2020-09-03;CG;Congo;0;0;4628;102
2020-09-04;CG;Congo;0;0;4628;102
2020-09-05;CG;Congo;0;0;4628;102
2020-09-06;CG;Congo;0;0;4628;102
2020-09-07;CG;Congo;263;0;4891;102
2020-09-08;CG;Congo;0;12;4891;114
2020-09-09;CG;Congo;0;0;4891;114
2020-09-10;CG;Congo;0;-31;4891;83
2020-09-11;CG;Congo;37;5;4928;88
2020-09-12;CG;Congo;0;0;4928;88
2020-09-13;CG;Congo;0;0;4928;88
2020-09-14;CG;Congo;6;0;4934;88
2020-09-15;CG;Congo;0;0;4934;88
2020-09-16;CG;Congo;0;0;4934;88
2020-09-17;CG;Congo;0;0;4934;88
2020-09-18;CG;Congo;46;1;4980;89
2020-09-19;CG;Congo;6;0;4986;89
2020-09-20;CG;Congo;0;0;4986;89
2020-09-21;CG;Congo;16;0;5002;89
2020-09-22;CG;Congo;0;0;5002;89
2020-09-23;CG;Congo;3;0;5005;89
2020-09-24;CG;Congo;0;0;5005;89
2020-09-25;CG;Congo;0;0;5005;89
2020-09-26;CG;Congo;0;0;5005;89
2020-09-27;CG;Congo;3;0;5008;89
2020-09-28;CG;Congo;0;0;5008;89
2020-09-29;CG;Congo;0;0;5008;89
2020-09-30;CG;Congo;81;0;5089;89
2020-10-01;CG;Congo;0;0;5089;89
2020-10-02;CG;Congo;0;0;5089;89
2020-10-03;CG;Congo;0;0;5089;89
2020-10-04;CG;Congo;0;0;5089;89
2020-10-05;CG;Congo;0;0;5089;89
2020-10-06;CG;Congo;0;0;5089;89
2020-10-07;CG;Congo;0;0;5089;89
2020-10-08;CG;Congo;0;0;5089;89
2020-10-09;CG;Congo;29;1;5118;90
2020-10-10;CG;Congo;0;0;5118;90
2020-10-11;CG;Congo;0;0;5118;90
2020-10-12;CG;Congo;0;0;5118;90
2020-10-13;CG;Congo;0;0;5118;90
2020-10-14;CG;Congo;38;2;5156;92
2020-10-15;CG;Congo;0;0;5156;92
2020-10-16;CG;Congo;0;0;5156;92
2020-10-17;CG;Congo;0;0;5156;92
2020-10-18;CG;Congo;0;0;5156;92
2020-10-19;CG;Congo;0;0;5156;92
2020-10-20;CG;Congo;0;0;5156;92
2020-10-21;CG;Congo;0;0;5156;92
2020-10-22;CG;Congo;0;0;5156;92
2020-10-23;CG;Congo;0;0;5156;92
2020-10-24;CG;Congo;97;0;5253;92
2020-10-25;CG;Congo;0;0;5253;92
2020-10-26;CG;Congo;0;0;5253;92
2020-10-27;CG;Congo;0;0;5253;92
2020-10-28;CG;Congo;0;0;5253;92
2020-10-29;CG;Congo;37;0;5290;92
2020-10-30;CG;Congo;0;0;5290;92
2020-10-31;CG;Congo;0;0;5290;92
2020-11-01;CG;Congo;0;0;5290;92
2020-11-02;CG;Congo;0;0;5290;92
2020-11-03;CG;Congo;58;0;5348;92
2020-11-04;CG;Congo;0;0;5348;92
2020-11-05;CG;Congo;0;0;5348;92
2020-11-06;CG;Congo;31;0;5379;92
2020-11-07;CG;Congo;0;0;5379;92
2020-11-08;CG;Congo;0;0;5379;92
2020-11-09;CG;Congo;0;0;5379;92
2020-11-10;CG;Congo;0;0;5379;92
2020-11-11;CG;Congo;0;0;5379;92
2020-11-12;CG;Congo;0;0;5379;92
2020-11-13;CG;Congo;136;0;5515;92
2020-11-14;CG;Congo;0;0;5515;92
2020-11-15;CG;Congo;0;0;5515;92
2020-11-16;CG;Congo;0;0;5515;92
2020-11-17;CG;Congo;0;0;5515;92
2020-11-18;CG;Congo;0;0;5515;92
2020-11-19;CG;Congo;117;1;5632;93
2020-11-20;CG;Congo;0;0;5632;93
2020-11-21;CG;Congo;0;0;5632;93
2020-11-22;CG;Congo;0;0;5632;93
2020-11-23;CG;Congo;0;0;5632;93
2020-11-24;CG;Congo;0;0;5632;93
2020-11-25;CG;Congo;0;0;5632;93
2020-11-26;CG;Congo;0;0;5632;93
2020-11-27;CG;Congo;142;1;5774;94
2020-11-28;CG;Congo;0;0;5774;94
2020-11-29;CG;Congo;0;0;5774;94
2020-11-30;CG;Congo;0;0;5774;94
2020-12-01;CG;Congo;0;0;5774;94
2020-12-02;CG;Congo;0;0;5774;94
2020-12-03;CG;Congo;0;0;5774;94
2020-12-04;CG;Congo;0;0;5774;94
2020-12-05;CG;Congo;0;0;5774;94
2020-12-06;CG;Congo;0;0;5774;94
2020-12-07;CG;Congo;0;0;5774;94
2020-12-08;CG;Congo;0;0;5774;94
2020-12-09;CG;Congo;275;5;6049;99
2020-12-10;CG;Congo;0;0;6049;99
2020-12-11;CG;Congo;0;0;6049;99
2020-12-12;CG;Congo;0;0;6049;99
2020-12-13;CG;Congo;0;0;6049;99
2020-12-14;CG;Congo;151;1;6200;100
2020-12-15;CG;Congo;0;0;6200;100
2020-12-16;CG;Congo;0;0;6200;100
2020-12-17;CG;Congo;0;0;6200;100
2020-12-18;CG;Congo;0;0;6200;100
2020-12-19;CG;Congo;0;0;6200;100
2020-12-20;CG;Congo;0;0;6200;100
2020-12-21;CG;Congo;0;0;6200;100
2020-12-22;CG;Congo;371;0;6571;100
2020-12-23;CG;Congo;0;0;6571;100
2020-12-24;CG;Congo;0;0;6571;100
2020-12-25;CG;Congo;0;0;6571;100
2020-12-26;CG;Congo;337;7;6908;107
2020-12-27;CG;Congo;0;0;6908;107
2020-12-28;CG;Congo;0;0;6908;107
2020-12-29;CG;Congo;0;0;6908;107
2020-12-30;CG;Congo;0;0;6908;107
2020-12-31;CG;Congo;199;1;7107;108
2021-01-01;CG;Congo;0;0;7107;108
2021-01-02;CG;Congo;0;0;7107;108
2021-01-03;CG;Congo;0;0;7107;108
2021-01-04;CG;Congo;0;0;7107;108
2021-01-05;CG;Congo;0;0;7107;108
2021-01-06;CG;Congo;20;0;7127;108
2021-01-07;CG;Congo;0;0;7127;108
2021-01-08;CG;Congo;0;0;7127;108
2021-01-09;CG;Congo;0;0;7127;108
2021-01-10;CG;Congo;0;0;7127;108
2021-01-11;CG;Congo;0;0;7127;108
2021-01-12;CG;Congo;33;4;7160;112
2021-01-13;CG;Congo;0;0;7160;112
2021-01-14;CG;Congo;0;0;7160;112
2021-01-15;CG;Congo;549;2;7709;114
2021-01-16;CG;Congo;0;0;7709;114
2021-01-17;CG;Congo;0;0;7709;114
2021-01-18;CG;Congo;0;0;7709;114
2021-01-19;CG;Congo;0;0;7709;114
2021-01-20;CG;Congo;0;0;7709;114
2021-01-21;CG;Congo;85;3;7794;117
2021-01-22;CG;Congo;0;0;7794;117
2021-01-23;CG;Congo;0;0;7794;117
2021-01-24;CG;Congo;0;0;7794;117
2021-01-25;CG;Congo;93;0;7887;117
2021-01-26;CG;Congo;0;0;7887;117
2021-01-27;CG;Congo;0;0;7887;117
2021-01-28;CG;Congo;0;0;7887;117
2021-01-29;CG;Congo;0;0;7887;117
2021-01-30;CG;Congo;0;0;7887;117
2021-01-31;CG;Congo;0;0;7887;117
2021-02-01;CG;Congo;0;0;7887;117
2021-02-02;CG;Congo;0;0;7887;117
2021-02-03;CG;Congo;0;0;7887;117
2021-02-04;CG;Congo;173;5;8060;122
2021-02-05;CG;Congo;0;0;8060;122
2021-02-06;CG;Congo;0;0;8060;122
2021-02-07;CG;Congo;0;0;8060;122
2021-02-08;CG;Congo;0;0;8060;122
2021-02-09;CG;Congo;0;0;8060;122
2021-02-10;CG;Congo;294;0;8354;122
2021-02-11;CG;Congo;0;0;8354;122
2021-02-12;CG;Congo;65;1;8419;123
2021-02-13;CG;Congo;0;0;8419;123
2021-02-14;CG;Congo;0;0;8419;123
2021-02-15;CG;Congo;0;0;8419;123
2021-02-16;CG;Congo;0;0;8419;123
2021-02-17;CG;Congo;0;0;8419;123
2021-02-18;CG;Congo;0;0;8419;123
2021-02-19;CG;Congo;0;0;8419;123
2021-02-20;CG;Congo;0;0;8419;123
2021-02-21;CG;Congo;206;4;8625;127
2021-02-22;CG;Congo;0;0;8625;127
2021-02-23;CG;Congo;0;0;8625;127
2021-02-24;CG;Congo;195;1;8820;128
2021-02-25;CG;Congo;0;0;8820;128
2021-02-26;CG;Congo;0;0;8820;128
2021-02-27;CG;Congo;0;0;8820;128
2021-02-28;CG;Congo;0;0;8820;128
2021-03-01;CG;Congo;0;0;8820;128
2021-03-02;CG;Congo;0;0;8820;128
2021-03-03;CG;Congo;0;0;8820;128
2021-03-04;CG;Congo;359;3;9179;131
2021-03-05;CG;Congo;0;0;9179;131
2021-03-06;CG;Congo;0;0;9179;131
2021-03-07;CG;Congo;0;0;9179;131
2021-03-08;CG;Congo;0;0;9179;131
2021-03-09;CG;Congo;0;0;9179;131
2021-03-10;CG;Congo;150;0;9329;131
2021-03-11;CG;Congo;0;0;9329;131
2021-03-12;CG;Congo;0;0;9329;131
2021-03-13;CG;Congo;0;0;9329;131
2021-03-14;CG;Congo;0;0;9329;131
2021-03-15;CG;Congo;0;0;9329;131
2021-03-16;CG;Congo;0;0;9329;131
2021-03-17;CG;Congo;0;0;9329;131
2021-03-18;CG;Congo;235;3;9564;134
2021-03-19;CG;Congo;0;0;9564;134
2021-03-20;CG;Congo;0;0;9564;134
2021-03-21;CG;Congo;0;0;9564;134
2021-03-22;CG;Congo;0;0;9564;134
2021-03-23;CG;Congo;0;0;9564;134
2021-03-24;CG;Congo;117;1;9681;135
2021-03-25;CG;Congo;0;0;9681;135
2021-03-26;CG;Congo;0;0;9681;135
2021-03-27;CG;Congo;0;0;9681;135
2021-03-28;CG;Congo;0;0;9681;135
2021-03-29;CG;Congo;0;0;9681;135
2021-03-30;CG;Congo;0;0;9681;135
2021-03-31;CG;Congo;0;0;9681;135
2021-04-01;CG;Congo;0;0;9681;135
2021-04-02;CG;Congo;0;0;9681;135
2021-04-03;CG;Congo;0;0;9681;135
2021-04-04;CG;Congo;0;0;9681;135
2021-04-05;CG;Congo;0;0;9681;135
2021-04-06;CG;Congo;403;2;10084;137
2021-04-07;CG;Congo;0;0;10084;137
2021-04-08;CG;Congo;0;0;10084;137
2021-04-09;CG;Congo;0;0;10084;137
2021-04-10;CG;Congo;0;0;10084;137
2021-04-11;CG;Congo;0;0;10084;137
2021-04-12;CG;Congo;0;0;10084;137
2021-04-13;CG;Congo;0;0;10084;137
2021-04-14;CG;Congo;0;2;10084;139
2021-04-15;CG;Congo;0;0;10084;139
2021-04-16;CG;Congo;0;0;10084;139
2021-04-17;CG;Congo;0;0;10084;139
2021-04-18;CG;Congo;0;0;10084;139
2021-04-19;CG;Congo;0;0;10084;139
2021-04-20;CG;Congo;0;0;10084;139
2021-04-21;CG;Congo;0;0;10084;139
2021-04-22;CG;Congo;0;0;10084;139
2021-04-23;CG;Congo;0;0;10084;139
2021-04-24;CG;Congo;0;0;10084;139
2021-04-25;CG;Congo;594;5;10678;144
2021-04-26;CG;Congo;0;0;10678;144
2021-04-27;CG;Congo;0;0;10678;144
2021-04-28;CG;Congo;0;0;10678;144
2021-04-29;CG;Congo;0;0;10678;144
2021-04-30;CG;Congo;0;0;10678;144
2021-05-01;CG;Congo;0;0;10678;144
2021-05-02;CG;Congo;0;0;10678;144
2021-05-03;CG;Congo;338;3;11016;147
2021-05-04;CG;Congo;0;0;11016;147
2021-05-05;CG;Congo;0;0;11016;147
2021-05-06;CG;Congo;0;0;11016;147
2021-05-07;CG;Congo;131;1;11147;148
2021-05-08;CG;Congo;0;0;11147;148
2021-05-09;CG;Congo;0;0;11147;148
2021-05-10;CG;Congo;196;0;11343;148
2021-05-11;CG;Congo;0;0;11343;148
2021-05-12;CG;Congo;0;0;11343;148
2021-05-13;CG;Congo;0;0;11343;148
2021-05-14;CG;Congo;0;0;11343;148
2021-05-15;CG;Congo;0;0;11343;148
2021-05-16;CG;Congo;0;0;11343;148
2021-05-17;CG;Congo;0;0;11343;148
2021-05-18;CG;Congo;0;0;11343;148
2021-05-19;CG;Congo;133;2;11476;150
2021-05-20;CG;Congo;0;0;11476;150
2021-05-21;CG;Congo;0;0;11476;150
2021-05-22;CG;Congo;0;0;11476;150
2021-05-23;CG;Congo;0;0;11476;150
2021-05-24;CG;Congo;0;0;11476;150
2021-05-25;CG;Congo;182;3;11658;153
2021-05-26;CG;Congo;0;0;11658;153
2021-05-27;CG;Congo;0;0;11658;153
2021-05-28;CG;Congo;0;0;11658;153
2021-05-29;CG;Congo;0;0;11658;153
2021-05-30;CG;Congo;0;0;11658;153
2021-05-31;CG;Congo;0;0;11658;153
2021-06-01;CG;Congo;0;0;11658;153
2021-06-02;CG;Congo;187;1;11845;154
2021-06-03;CG;Congo;0;0;11845;154
2021-06-04;CG;Congo;75;1;11920;155
2021-06-05;CG;Congo;0;0;11920;155
2021-06-06;CG;Congo;0;0;11920;155
2021-06-07;CG;Congo;106;2;12026;157
2021-06-08;CG;Congo;0;0;12026;157
2021-06-09;CG;Congo;0;0;12026;157
2021-06-10;CG;Congo;0;0;12026;157
2021-06-11;CG;Congo;0;0;12026;157
2021-06-12;CG;Congo;95;3;12121;160
2021-06-13;CG;Congo;0;0;12121;160
2021-06-14;CG;Congo;0;0;12121;160
2021-06-15;CG;Congo;0;0;12121;160
2021-06-16;CG;Congo;0;0;12121;160
2021-06-17;CG;Congo;177;1;12298;161
2021-06-18;CG;Congo;0;0;12298;161
2021-06-19;CG;Congo;0;0;12298;161
2021-06-20;CG;Congo;0;0;12298;161
2021-06-21;CG;Congo;0;0;12298;161
2021-06-22;CG;Congo;106;3;12404;164
2021-06-23;CG;Congo;0;0;12404;164
2021-06-24;CG;Congo;0;0;12404;164
2021-06-25;CG;Congo;81;1;12485;165
2021-06-26;CG;Congo;0;0;12485;165
2021-06-27;CG;Congo;0;0;12485;165
2021-06-28;CG;Congo;0;0;12485;165
2021-06-29;CG;Congo;111;0;12596;165
2021-06-30;CG;Congo;0;0;12596;165
2021-07-01;CG;Congo;99;1;12695;166
2021-05-25;CK;Cook Islands;0;0;0;0
2021-05-26;CK;Cook Islands;0;0;0;0
2021-05-27;CK;Cook Islands;0;0;0;0
2021-05-28;CK;Cook Islands;0;0;0;0
2021-05-29;CK;Cook Islands;0;0;0;0
2021-05-30;CK;Cook Islands;0;0;0;0
2021-05-31;CK;Cook Islands;0;0;0;0
2021-06-01;CK;Cook Islands;0;0;0;0
2021-06-02;CK;Cook Islands;0;0;0;0
2021-06-03;CK;Cook Islands;0;0;0;0
2021-06-04;CK;Cook Islands;0;0;0;0
2021-06-05;CK;Cook Islands;0;0;0;0
2021-06-06;CK;Cook Islands;0;0;0;0
2021-06-07;CK;Cook Islands;0;0;0;0
2021-06-08;CK;Cook Islands;0;0;0;0
2021-06-09;CK;Cook Islands;0;0;0;0
2021-06-10;CK;Cook Islands;0;0;0;0
2021-06-11;CK;Cook Islands;0;0;0;0
2021-06-12;CK;Cook Islands;0;0;0;0
2021-06-13;CK;Cook Islands;0;0;0;0
2021-06-14;CK;Cook Islands;0;0;0;0
2021-06-15;CK;Cook Islands;0;0;0;0
2021-06-16;CK;Cook Islands;0;0;0;0
2021-06-17;CK;Cook Islands;0;0;0;0
2021-06-18;CK;Cook Islands;0;0;0;0
2021-06-19;CK;Cook Islands;0;0;0;0
2021-06-20;CK;Cook Islands;0;0;0;0
2021-06-21;CK;Cook Islands;0;0;0;0
2021-06-22;CK;Cook Islands;0;0;0;0
2021-06-23;CK;Cook Islands;0;0;0;0
2021-06-24;CK;Cook Islands;0;0;0;0
2021-06-25;CK;Cook Islands;0;0;0;0
2021-06-26;CK;Cook Islands;0;0;0;0
2021-06-27;CK;Cook Islands;0;0;0;0
2021-06-28;CK;Cook Islands;0;0;0;0
2021-06-29;CK;Cook Islands;0;0;0;0
2020-03-06;CR;Costa Rica;1;0;1;0
2020-03-07;CR;Costa Rica;0;0;1;0
2020-03-08;CR;Costa Rica;4;0;5;0
2020-03-09;CR;Costa Rica;4;0;9;0
2020-03-10;CR;Costa Rica;0;0;9;0
2020-03-11;CR;Costa Rica;4;0;13;0
2020-03-12;CR;Costa Rica;9;0;22;0
2020-03-13;CR;Costa Rica;1;0;23;0
2020-03-14;CR;Costa Rica;3;0;26;0
2020-03-15;CR;Costa Rica;1;0;27;0
2020-03-16;CR;Costa Rica;8;0;35;0
2020-03-17;CR;Costa Rica;6;0;41;0
2020-03-18;CR;Costa Rica;9;0;50;0
2020-03-19;CR;Costa Rica;19;1;69;1
2020-03-20;CR;Costa Rica;20;0;89;1
2020-03-21;CR;Costa Rica;28;1;117;2
2020-03-22;CR;Costa Rica;17;0;134;2
2020-03-23;CR;Costa Rica;24;0;158;2
2020-03-24;CR;Costa Rica;19;0;177;2
2020-03-25;CR;Costa Rica;24;0;201;2
2020-03-26;CR;Costa Rica;30;0;231;2
2020-03-27;CR;Costa Rica;32;0;263;2
2020-03-28;CR;Costa Rica;32;0;295;2
2020-03-29;CR;Costa Rica;19;0;314;2
2020-03-30;CR;Costa Rica;16;0;330;2
2020-03-31;CR;Costa Rica;17;0;347;2
2020-04-01;CR;Costa Rica;28;0;375;2
2020-04-02;CR;Costa Rica;21;0;396;2
2020-04-03;CR;Costa Rica;20;0;416;2
2020-04-04;CR;Costa Rica;19;0;435;2
2020-04-05;CR;Costa Rica;19;0;454;2
2020-04-06;CR;Costa Rica;13;0;467;2
2020-04-07;CR;Costa Rica;16;0;483;2
2020-04-08;CR;Costa Rica;19;1;502;3
2020-04-09;CR;Costa Rica;37;0;539;3
2020-04-10;CR;Costa Rica;19;0;558;3
2020-04-11;CR;Costa Rica;19;0;577;3
2020-04-12;CR;Costa Rica;18;0;595;3
2020-04-13;CR;Costa Rica;17;0;612;3
2020-04-14;CR;Costa Rica;6;0;618;3
2020-04-15;CR;Costa Rica;8;1;626;4
2020-04-16;CR;Costa Rica;16;0;642;4
2020-04-17;CR;Costa Rica;7;0;649;4
2020-04-18;CR;Costa Rica;6;0;655;4
2020-04-19;CR;Costa Rica;5;1;660;5
2020-04-20;CR;Costa Rica;2;1;662;6
2020-04-21;CR;Costa Rica;7;0;669;6
2020-04-22;CR;Costa Rica;12;0;681;6
2020-04-23;CR;Costa Rica;5;0;686;6
2020-04-24;CR;Costa Rica;1;0;687;6
2020-04-25;CR;Costa Rica;6;0;693;6
2020-04-26;CR;Costa Rica;2;0;695;6
2020-04-27;CR;Costa Rica;2;0;697;6
2020-04-28;CR;Costa Rica;8;0;705;6
2020-04-29;CR;Costa Rica;8;0;713;6
2020-04-30;CR;Costa Rica;6;0;719;6
2020-05-01;CR;Costa Rica;6;0;725;6
2020-05-02;CR;Costa Rica;8;0;733;6
2020-05-03;CR;Costa Rica;6;0;739;6
2020-05-04;CR;Costa Rica;3;0;742;6
2020-05-05;CR;Costa Rica;13;0;755;6
2020-05-06;CR;Costa Rica;6;0;761;6
2020-05-07;CR;Costa Rica;4;0;765;6
2020-05-08;CR;Costa Rica;8;0;773;6
2020-05-09;CR;Costa Rica;7;0;780;6
2020-05-10;CR;Costa Rica;12;1;792;7
2020-05-11;CR;Costa Rica;9;0;801;7
2020-05-12;CR;Costa Rica;3;0;804;7
2020-05-13;CR;Costa Rica;11;1;815;8
2020-05-14;CR;Costa Rica;15;0;830;8
2020-05-15;CR;Costa Rica;13;1;843;9
2020-05-16;CR;Costa Rica;10;1;853;10
2020-05-17;CR;Costa Rica;10;0;863;10
2020-05-18;CR;Costa Rica;3;0;866;10
2020-05-19;CR;Costa Rica;16;0;882;10
2020-05-20;CR;Costa Rica;15;0;897;10
2020-05-21;CR;Costa Rica;6;0;903;10
2020-05-22;CR;Costa Rica;8;0;911;10
2020-05-23;CR;Costa Rica;7;0;918;10
2020-05-24;CR;Costa Rica;12;0;930;10
2020-05-25;CR;Costa Rica;21;0;951;10
2020-05-26;CR;Costa Rica;5;0;956;10
2020-05-27;CR;Costa Rica;28;0;984;10
2020-05-28;CR;Costa Rica;16;0;1000;10
2020-05-29;CR;Costa Rica;22;0;1022;10
2020-05-30;CR;Costa Rica;25;0;1047;10
2020-05-31;CR;Costa Rica;9;0;1056;10
2020-06-01;CR;Costa Rica;28;0;1084;10
2020-06-02;CR;Costa Rica;21;0;1105;10
2020-06-03;CR;Costa Rica;52;0;1157;10
2020-06-04;CR;Costa Rica;37;0;1194;10
2020-06-05;CR;Costa Rica;34;0;1228;10
2020-06-06;CR;Costa Rica;35;0;1263;10
2020-06-07;CR;Costa Rica;55;0;1318;10
2020-06-08;CR;Costa Rica;24;1;1342;11
2020-06-09;CR;Costa Rica;33;0;1375;11
2020-06-10;CR;Costa Rica;86;1;1461;12
2020-06-11;CR;Costa Rica;77;0;1538;12
2020-06-12;CR;Costa Rica;74;0;1612;12
2020-06-13;CR;Costa Rica;50;0;1662;12
2020-06-14;CR;Costa Rica;53;0;1715;12
2020-06-15;CR;Costa Rica;29;0;1744;12
2020-06-16;CR;Costa Rica;52;0;1796;12
2020-06-17;CR;Costa Rica;75;0;1871;12
2020-06-18;CR;Costa Rica;68;0;1939;12
2020-06-19;CR;Costa Rica;119;0;2058;12
2020-06-20;CR;Costa Rica;69;0;2127;12
2020-06-21;CR;Costa Rica;86;0;2213;12
2020-06-22;CR;Costa Rica;64;0;2277;12
2020-06-23;CR;Costa Rica;91;0;2368;12
2020-06-24;CR;Costa Rica;147;0;2515;12
2020-06-25;CR;Costa Rica;169;0;2684;12
2020-06-26;CR;Costa Rica;152;0;2836;12
2020-06-27;CR;Costa Rica;143;2;2979;14
2020-06-28;CR;Costa Rica;151;1;3130;15
2020-06-29;CR;Costa Rica;139;0;3269;15
2020-06-30;CR;Costa Rica;190;1;3459;16
2020-07-01;CR;Costa Rica;294;1;3753;17
2020-07-02;CR;Costa Rica;270;1;4023;18
2020-07-03;CR;Costa Rica;288;0;4311;18
2020-07-04;CR;Costa Rica;310;0;4621;18
2020-07-05;CR;Costa Rica;375;1;4996;19
2020-07-06;CR;Costa Rica;245;4;5241;23
2020-07-07;CR;Costa Rica;245;0;5486;23
2020-07-08;CR;Costa Rica;350;2;5836;25
2020-07-09;CR;Costa Rica;649;0;6485;25
2020-07-10;CR;Costa Rica;360;1;6845;26
2020-07-11;CR;Costa Rica;386;2;7231;28
2020-07-12;CR;Costa Rica;365;2;7596;30
2020-07-13;CR;Costa Rica;440;4;8036;34
2020-07-14;CR;Costa Rica;446;3;8482;37
2020-07-15;CR;Costa Rica;504;3;8986;40
2020-07-16;CR;Costa Rica;560;2;9546;42
2020-07-17;CR;Costa Rica;423;5;9969;47
2020-07-18;CR;Costa Rica;582;7;10551;54
2020-07-19;CR;Costa Rica;563;8;11114;62
2020-07-20;CR;Costa Rica;420;4;11534;66
2020-07-21;CR;Costa Rica;277;2;11811;68
2020-07-22;CR;Costa Rica;550;3;12361;71
2020-07-23;CR;Costa Rica;768;9;13129;80
2020-07-24;CR;Costa Rica;540;7;13669;87
2020-07-25;CR;Costa Rica;931;11;14600;98
2020-07-26;CR;Costa Rica;629;6;15229;104
2020-07-27;CR;Costa Rica;612;11;15841;115
2020-07-28;CR;Costa Rica;503;10;16344;125
2020-07-29;CR;Costa Rica;456;8;16800;133
2020-07-30;CR;Costa Rica;490;7;17290;140
2020-07-31;CR;Costa Rica;530;10;17820;150
2020-08-01;CR;Costa Rica;367;4;18187;154
2020-08-02;CR;Costa Rica;788;8;18975;162
2020-08-03;CR;Costa Rica;427;9;19402;171
2020-08-04;CR;Costa Rica;435;10;19837;181
2020-08-05;CR;Costa Rica;580;10;20417;191
2020-08-06;CR;Costa Rica;653;9;21070;200
2020-08-07;CR;Costa Rica;1011;18;22081;218
2020-08-08;CR;Costa Rica;721;10;22802;228
2020-08-09;CR;Costa Rica;484;7;23286;235
2020-08-10;CR;Costa Rica;586;9;23872;244
2020-08-11;CR;Costa Rica;636;11;24508;255
2020-08-12;CR;Costa Rica;549;8;25057;263
2020-08-13;CR;Costa Rica;1072;9;26129;272
2020-08-14;CR;Costa Rica;802;9;26931;281
2020-08-15;CR;Costa Rica;806;10;27737;291
2020-08-16;CR;Costa Rica;728;3;28465;294
2020-08-17;CR;Costa Rica;619;10;29084;304
2020-08-18;CR;Costa Rica;559;10;29643;314
2020-08-19;CR;Costa Rica;766;7;30409;321
2020-08-20;CR;Costa Rica;666;12;31075;333
2020-08-21;CR;Costa Rica;1059;7;32134;340
2020-08-22;CR;Costa Rica;950;8;33084;348
2020-08-23;CR;Costa Rica;736;7;33820;355
2020-08-24;CR;Costa Rica;643;7;34463;362
2020-08-25;CR;Costa Rica;842;14;35305;376
2020-08-26;CR;Costa Rica;1002;10;36307;386
2020-08-27;CR;Costa Rica;985;11;37292;397
2020-08-28;CR;Costa Rica;1193;10;38485;407
2020-08-29;CR;Costa Rica;1214;11;39699;418
2020-08-30;CR;Costa Rica;0;0;39699;418
2020-08-31;CR;Costa Rica;1588;18;41287;436
2020-09-01;CR;Costa Rica;897;7;42184;443
2020-09-02;CR;Costa Rica;1121;10;43305;453
2020-09-03;CR;Costa Rica;1153;7;44458;460
2020-09-04;CR;Costa Rica;1222;9;45680;469
2020-09-05;CR;Costa Rica;1240;9;46920;478
2020-09-06;CR;Costa Rica;0;0;46920;478
2020-09-07;CR;Costa Rica;1860;32;48780;510
2020-09-08;CR;Costa Rica;1117;21;49897;531
2020-09-09;CR;Costa Rica;1327;12;51224;543
2020-09-10;CR;Costa Rica;1325;24;52549;567
2020-09-11;CR;Costa Rica;1420;16;53969;583
2020-09-12;CR;Costa Rica;1485;7;55454;590
2020-09-13;CR;Costa Rica;0;0;55454;590
2020-09-14;CR;Costa Rica;1907;31;57361;621
2020-09-15;CR;Costa Rica;776;12;58137;633
2020-09-16;CR;Costa Rica;1379;16;59516;649
2020-09-17;CR;Costa Rica;1302;17;60818;666
2020-09-18;CR;Costa Rica;1556;20;62374;686
2020-09-19;CR;Costa Rica;1338;20;63712;706
2020-09-20;CR;Costa Rica;0;0;63712;706
2020-09-21;CR;Costa Rica;1890;39;65602;745
2020-09-22;CR;Costa Rica;1087;15;66689;760
2020-09-23;CR;Costa Rica;1370;21;68059;781
2020-09-24;CR;Costa Rica;1400;14;69459;795
2020-09-25;CR;Costa Rica;1357;17;70816;812
2020-09-26;CR;Costa Rica;1233;16;72049;828
2020-09-27;CR;Costa Rica;0;0;72049;828
2020-09-28;CR;Costa Rica;1665;33;73714;861
2020-09-29;CR;Costa Rica;890;19;74604;880
2020-09-30;CR;Costa Rica;1156;24;75760;904
2020-10-01;CR;Costa Rica;1068;13;76828;917
2020-10-02;CR;Costa Rica;1001;13;77829;930
2020-10-03;CR;Costa Rica;1353;20;79182;950
2020-10-04;CR;Costa Rica;0;0;79182;950
2020-10-05;CR;Costa Rica;1947;37;81129;987
2020-10-06;CR;Costa Rica;1013;17;82142;1004
2020-10-07;CR;Costa Rica;1355;20;83497;1024
2020-10-08;CR;Costa Rica;1331;16;84828;1040
2020-10-09;CR;Costa Rica;1225;15;86053;1055
2020-10-10;CR;Costa Rica;1386;21;87439;1076
2020-10-11;CR;Costa Rica;0;0;87439;1076
2020-10-12;CR;Costa Rica;1784;32;89223;1108
2020-10-13;CR;Costa Rica;1015;16;90238;1124
2020-10-14;CR;Costa Rica;1542;10;91780;1134
2020-10-15;CR;Costa Rica;1372;25;93152;1159
2020-10-16;CR;Costa Rica;1196;9;94348;1168
2020-10-17;CR;Costa Rica;1166;15;95514;1183
2020-10-18;CR;Costa Rica;0;0;95514;1183
2020-10-19;CR;Costa Rica;1561;21;97075;1204
2020-10-20;CR;Costa Rica;847;18;97922;1222
2020-10-21;CR;Costa Rica;1503;14;99425;1236
2020-10-22;CR;Costa Rica;1191;15;100616;1251
2020-10-23;CR;Costa Rica;1210;14;101826;1265
2020-10-24;CR;Costa Rica;1262;17;103088;1282
2020-10-25;CR;Costa Rica;0;0;103088;1282
2020-10-26;CR;Costa Rica;1372;30;104460;1312
2020-10-27;CR;Costa Rica;862;17;105322;1329
2020-10-28;CR;Costa Rica;1231;11;106553;1340
2020-10-29;CR;Costa Rica;1017;17;107570;1357
2020-10-30;CR;Costa Rica;1296;14;108866;1371
2020-10-31;CR;Costa Rica;1105;14;109971;1385
2020-11-01;CR;Costa Rica;0;0;109971;1385
2020-11-02;CR;Costa Rica;1286;19;111257;1404
2020-11-03;CR;Costa Rica;863;15;112120;1419
2020-11-04;CR;Costa Rica;1141;12;113261;1431
2020-11-05;CR;Costa Rica;1106;13;114367;1444
2020-11-06;CR;Costa Rica;1050;9;115417;1453
2020-11-07;CR;Costa Rica;946;11;116363;1464
2020-11-08;CR;Costa Rica;0;0;116363;1464
2020-11-09;CR;Costa Rica;1224;27;117587;1491
2020-11-10;CR;Costa Rica;979;11;118566;1502
2020-11-11;CR;Costa Rica;1202;11;119768;1513
2020-11-12;CR;Costa Rica;1171;14;120939;1527
2020-11-13;CR;Costa Rica;1184;10;122123;1537
2020-11-14;CR;Costa Rica;1100;9;123223;1546
2020-11-15;CR;Costa Rica;0;0;123223;1546
2020-11-16;CR;Costa Rica;1369;20;124592;1566
2020-11-17;CR;Costa Rica;998;12;125590;1578
2020-11-18;CR;Costa Rica;1422;10;127012;1588
2020-11-19;CR;Costa Rica;1219;11;128231;1599
2020-11-20;CR;Costa Rica;1187;9;129418;1608
2020-11-21;CR;Costa Rica;0;0;129418;1608
2020-11-22;CR;Costa Rica;0;0;129418;1608
2020-11-23;CR;Costa Rica;2877;33;132295;1641
2020-11-24;CR;Costa Rica;895;21;133190;1662
2020-11-25;CR;Costa Rica;1330;12;134520;1674
2020-11-26;CR;Costa Rica;1222;5;135742;1679
2020-11-27;CR;Costa Rica;1351;11;137093;1690
2020-11-28;CR;Costa Rica;0;0;137093;1690
2020-11-29;CR;Costa Rica;0;0;137093;1690
2020-11-30;CR;Costa Rica;2545;36;139638;1726
2020-12-01;CR;Costa Rica;534;5;140172;1731
2020-12-02;CR;Costa Rica;1168;8;141340;1739
2020-12-03;CR;Costa Rica;1165;18;142505;1757
2020-12-04;CR;Costa Rica;1180;16;143685;1773
2020-12-05;CR;Costa Rica;0;0;143685;1773
2020-12-06;CR;Costa Rica;0;0;143685;1773
2020-12-07;CR;Costa Rica;2736;52;146421;1825
2020-12-08;CR;Costa Rica;1009;21;147430;1846
2020-12-09;CR;Costa Rica;1258;18;148688;1864
2020-12-10;CR;Costa Rica;1127;18;149815;1882
2020-12-11;CR;Costa Rica;1132;13;150947;1895
2020-12-12;CR;Costa Rica;0;0;150947;1895
2020-12-13;CR;Costa Rica;0;0;150947;1895
2020-12-14;CR;Costa Rica;2222;41;153169;1936
2020-12-15;CR;Costa Rica;927;20;154096;1956
2020-12-16;CR;Costa Rica;1167;11;155263;1967
2020-12-17;CR;Costa Rica;1125;13;156388;1980
2020-12-18;CR;Costa Rica;1084;16;157472;1996
2020-12-19;CR;Costa Rica;0;0;157472;1996
2020-12-20;CR;Costa Rica;0;0;157472;1996
2020-12-21;CR;Costa Rica;2421;41;159893;2037
2020-12-22;CR;Costa Rica;911;14;160804;2051
2020-12-23;CR;Costa Rica;1138;14;161942;2065
2020-12-24;CR;Costa Rica;1048;21;162990;2086
2020-12-25;CR;Costa Rica;0;0;162990;2086
2020-12-26;CR;Costa Rica;0;0;162990;2086
2020-12-27;CR;Costa Rica;0;0;162990;2086
2020-12-28;CR;Costa Rica;2772;58;165762;2144
2020-12-29;CR;Costa Rica;1037;12;166799;2156
2020-12-30;CR;Costa Rica;1315;15;168114;2171
2020-12-31;CR;Costa Rica;1207;14;169321;2185
2021-01-01;CR;Costa Rica;0;0;169321;2185
2021-01-02;CR;Costa Rica;0;0;169321;2185
2021-01-03;CR;Costa Rica;0;0;169321;2185
2021-01-04;CR;Costa Rica;3115;44;172436;2229
2021-01-05;CR;Costa Rica;1155;19;173591;2248
2021-01-06;CR;Costa Rica;1447;19;175038;2267
2021-01-07;CR;Costa Rica;1369;19;176407;2286
2021-01-08;CR;Costa Rica;1207;19;177614;2305
2021-01-09;CR;Costa Rica;0;0;177614;2305
2021-01-10;CR;Costa Rica;0;0;177614;2305
2021-01-11;CR;Costa Rica;2447;48;180061;2353
2021-01-12;CR;Costa Rica;1032;14;181093;2367
2021-01-13;CR;Costa Rica;1063;17;182156;2384
2021-01-14;CR;Costa Rica;1086;17;183242;2401
2021-01-15;CR;Costa Rica;945;15;184187;2416
2021-01-16;CR;Costa Rica;0;0;184187;2416
2021-01-17;CR;Costa Rica;0;0;184187;2416
2021-01-18;CR;Costa Rica;1829;42;186016;2458
2021-01-19;CR;Costa Rica;861;19;186877;2477
2021-01-20;CR;Costa Rica;835;15;187712;2492
2021-01-21;CR;Costa Rica;765;14;188477;2506
2021-01-22;CR;Costa Rica;831;12;189308;2518
2021-01-23;CR;Costa Rica;0;0;189308;2518
2021-01-24;CR;Costa Rica;0;0;189308;2518
2021-01-25;CR;Costa Rica;1437;40;190745;2558
2021-01-26;CR;Costa Rica;600;9;191345;2567
2021-01-27;CR;Costa Rica;721;17;192066;2584
2021-01-28;CR;Costa Rica;571;15;192637;2599
2021-01-29;CR;Costa Rica;639;5;193276;2604
2021-01-30;CR;Costa Rica;0;0;193276;2604
2021-01-31;CR;Costa Rica;0;0;193276;2604
2021-02-01;CR;Costa Rica;1293;30;194569;2634
2021-02-02;CR;Costa Rica;440;7;195009;2641
2021-02-03;CR;Costa Rica;528;9;195537;2650
2021-02-04;CR;Costa Rica;455;12;195992;2662
2021-02-05;CR;Costa Rica;446;10;196438;2672
2021-02-06;CR;Costa Rica;0;0;196438;2672
2021-02-07;CR;Costa Rica;0;0;196438;2672
2021-02-08;CR;Costa Rica;997;20;197435;2692
2021-02-09;CR;Costa Rica;417;6;197852;2698
2021-02-10;CR;Costa Rica;486;3;198338;2701
2021-02-11;CR;Costa Rica;418;9;198756;2710
2021-02-12;CR;Costa Rica;431;4;199187;2714
2021-02-13;CR;Costa Rica;0;0;199187;2714
2021-02-14;CR;Costa Rica;0;0;199187;2714
2021-02-15;CR;Costa Rica;837;16;200024;2730
2021-02-16;CR;Costa Rica;430;7;200454;2737
2021-02-17;CR;Costa Rica;434;8;200888;2745
2021-02-18;CR;Costa Rica;353;11;201241;2756
2021-02-19;CR;Costa Rica;437;7;201678;2763
2021-02-20;CR;Costa Rica;0;0;201678;2763
2021-02-21;CR;Costa Rica;0;0;201678;2763
2021-02-22;CR;Costa Rica;996;19;202674;2782
2021-02-23;CR;Costa Rica;423;3;203097;2785
2021-02-24;CR;Costa Rica;399;8;203496;2793
2021-02-25;CR;Costa Rica;418;3;203914;2796
2021-02-26;CR;Costa Rica;427;4;204341;2800
2021-02-27;CR;Costa Rica;0;0;204341;2800
2021-02-28;CR;Costa Rica;0;0;204341;2800
2021-03-01;CR;Costa Rica;745;12;205086;2812
2021-03-02;CR;Costa Rica;428;8;205514;2820
2021-03-03;CR;Costa Rica;376;4;205890;2824
2021-03-04;CR;Costa Rica;403;5;206293;2829
2021-03-05;CR;Costa Rica;347;4;206640;2833
2021-03-06;CR;Costa Rica;0;0;206640;2833
2021-03-07;CR;Costa Rica;0;0;206640;2833
2021-03-08;CR;Costa Rica;0;0;206640;2833
2021-03-09;CR;Costa Rica;1192;15;207832;2848
2021-03-10;CR;Costa Rica;0;0;207832;2848
2021-03-11;CR;Costa Rica;0;0;207832;2848
2021-03-12;CR;Costa Rica;1261;14;209093;2862
2021-03-13;CR;Costa Rica;0;0;209093;2862
2021-03-14;CR;Costa Rica;0;0;209093;2862
2021-03-15;CR;Costa Rica;0;0;209093;2862
2021-03-16;CR;Costa Rica;1354;24;210447;2886
2021-03-17;CR;Costa Rica;0;0;210447;2886
2021-03-18;CR;Costa Rica;0;0;210447;2886
2021-03-19;CR;Costa Rica;1456;10;211903;2896
2021-03-20;CR;Costa Rica;0;0;211903;2896
2021-03-21;CR;Costa Rica;0;0;211903;2896
2021-03-22;CR;Costa Rica;0;0;211903;2896
2021-03-23;CR;Costa Rica;1535;12;213438;2908
2021-03-24;CR;Costa Rica;0;0;213438;2908
2021-03-25;CR;Costa Rica;0;0;213438;2908
2021-03-26;CR;Costa Rica;1740;23;215178;2931
2021-03-27;CR;Costa Rica;0;0;215178;2931
2021-03-28;CR;Costa Rica;0;0;215178;2931
2021-03-29;CR;Costa Rica;0;0;215178;2931
2021-03-30;CR;Costa Rica;1586;26;216764;2957
2021-03-31;CR;Costa Rica;0;0;216764;2957
2021-04-01;CR;Costa Rica;0;0;216764;2957
2021-04-02;CR;Costa Rica;0;0;216764;2957
2021-04-03;CR;Costa Rica;0;0;216764;2957
2021-04-04;CR;Costa Rica;0;0;216764;2957
2021-04-05;CR;Costa Rica;0;0;216764;2957
2021-04-06;CR;Costa Rica;3082;43;219846;3000
2021-04-07;CR;Costa Rica;0;0;219846;3000
2021-04-08;CR;Costa Rica;0;0;219846;3000
2021-04-09;CR;Costa Rica;2698;18;222544;3018
2021-04-10;CR;Costa Rica;0;0;222544;3018
2021-04-11;CR;Costa Rica;0;0;222544;3018
2021-04-12;CR;Costa Rica;0;0;222544;3018
2021-04-13;CR;Costa Rica;2799;26;225343;3044
2021-04-14;CR;Costa Rica;0;0;225343;3044
2021-04-15;CR;Costa Rica;2190;21;227533;3065
2021-04-16;CR;Costa Rica;1044;6;228577;3071
2021-04-17;CR;Costa Rica;0;0;228577;3071
2021-04-18;CR;Costa Rica;0;0;228577;3071
2021-04-19;CR;Costa Rica;2260;28;230837;3099
2021-04-20;CR;Costa Rica;1130;5;231967;3104
2021-04-21;CR;Costa Rica;1531;11;233498;3115
2021-04-22;CR;Costa Rica;1776;10;235274;3125
2021-04-23;CR;Costa Rica;1656;11;236930;3136
2021-04-24;CR;Costa Rica;1830;7;238760;3143
2021-04-25;CR;Costa Rica;0;0;238760;3143
2021-04-26;CR;Costa Rica;2480;25;241240;3168
2021-04-27;CR;Costa Rica;1927;18;243167;3186
2021-04-28;CR;Costa Rica;2434;16;245601;3202
2021-04-29;CR;Costa Rica;2781;15;248382;3217
2021-04-30;CR;Costa Rica;2609;14;250991;3231
2021-05-01;CR;Costa Rica;0;0;250991;3231
2021-05-02;CR;Costa Rica;0;0;250991;3231
2021-05-03;CR;Costa Rica;5685;59;256676;3290
2021-05-04;CR;Costa Rica;1304;20;257980;3310
2021-05-05;CR;Costa Rica;2555;16;260535;3326
2021-05-06;CR;Costa Rica;2559;15;263094;3341
2021-05-07;CR;Costa Rica;2392;24;265486;3365
2021-05-08;CR;Costa Rica;0;0;265486;3365
2021-05-09;CR;Costa Rica;0;0;265486;3365
2021-05-10;CR;Costa Rica;5992;65;271478;3430
2021-05-11;CR;Costa Rica;2236;26;273714;3456
2021-05-12;CR;Costa Rica;3173;26;276887;3482
2021-05-13;CR;Costa Rica;3039;32;279926;3514
2021-05-14;CR;Costa Rica;2815;33;282741;3547
2021-05-15;CR;Costa Rica;0;0;282741;3547
2021-05-16;CR;Costa Rica;0;0;282741;3547
2021-05-17;CR;Costa Rica;5885;78;288626;3625
2021-05-18;CR;Costa Rica;2294;48;290920;3673
2021-05-19;CR;Costa Rica;2900;23;293820;3696
2021-05-20;CR;Costa Rica;2812;40;296632;3736
2021-05-21;CR;Costa Rica;2587;29;299219;3765
2021-05-22;CR;Costa Rica;0;0;299219;3765
2021-05-23;CR;Costa Rica;0;0;299219;3765
2021-05-24;CR;Costa Rica;5310;84;304529;3849
2021-05-25;CR;Costa Rica;2370;28;306899;3877
2021-05-26;CR;Costa Rica;2587;31;309486;3908
2021-05-27;CR;Costa Rica;2436;21;311922;3929
2021-05-28;CR;Costa Rica;2180;33;314102;3962
2021-05-29;CR;Costa Rica;0;0;314102;3962
2021-05-30;CR;Costa Rica;0;0;314102;3962
2021-05-31;CR;Costa Rica;4884;79;318986;4041
2021-06-01;CR;Costa Rica;2293;33;321279;4074
2021-06-02;CR;Costa Rica;2319;24;323598;4098
2021-06-03;CR;Costa Rica;2181;26;325779;4124
2021-06-04;CR;Costa Rica;2200;29;327979;4153
2021-06-05;CR;Costa Rica;0;0;327979;4153
2021-06-06;CR;Costa Rica;0;0;327979;4153
2021-06-07;CR;Costa Rica;3941;75;331920;4228
2021-06-08;CR;Costa Rica;1900;23;333820;4251
2021-06-09;CR;Costa Rica;2187;27;336007;4278
2021-06-10;CR;Costa Rica;2041;20;338048;4298
2021-06-11;CR;Costa Rica;1852;24;339900;4322
2021-06-12;CR;Costa Rica;0;0;339900;4322
2021-06-13;CR;Costa Rica;0;0;339900;4322
2021-06-14;CR;Costa Rica;3704;66;343604;4388
2021-06-15;CR;Costa Rica;1708;19;345312;4407
2021-06-16;CR;Costa Rica;1845;30;347157;4437
2021-06-17;CR;Costa Rica;1869;22;349026;4459
2021-06-18;CR;Costa Rica;1604;14;350630;4473
2021-06-19;CR;Costa Rica;0;0;350630;4473
2021-06-20;CR;Costa Rica;0;0;350630;4473
2021-06-21;CR;Costa Rica;3465;57;354095;4530
2021-06-22;CR;Costa Rica;1525;16;355620;4546
2021-06-23;CR;Costa Rica;1903;21;357523;4567
2021-06-24;CR;Costa Rica;1743;14;359266;4581
2021-06-25;CR;Costa Rica;1739;21;361005;4602
2021-06-26;CR;Costa Rica;0;0;361005;4602
2021-06-27;CR;Costa Rica;0;0;361005;4602
2021-06-28;CR;Costa Rica;3299;46;364304;4648
2021-06-29;CR;Costa Rica;1857;13;366161;4661
2021-06-30;CR;Costa Rica;1777;6;367938;4667
2021-07-01;CR;Costa Rica;1602;7;369540;4674
2020-03-11;CI;Cote d'Ivoire;1;0;1;0
2020-03-12;CI;Cote d'Ivoire;0;0;1;0
2020-03-13;CI;Cote d'Ivoire;0;0;1;0
2020-03-14;CI;Cote d'Ivoire;0;0;1;0
2020-03-15;CI;Cote d'Ivoire;0;0;1;0
2020-03-16;CI;Cote d'Ivoire;0;0;1;0
2020-03-17;CI;Cote d'Ivoire;4;0;5;0
2020-03-18;CI;Cote d'Ivoire;1;0;6;0
2020-03-19;CI;Cote d'Ivoire;3;0;9;0
2020-03-20;CI;Cote d'Ivoire;0;0;9;0
2020-03-21;CI;Cote d'Ivoire;5;0;14;0
2020-03-22;CI;Cote d'Ivoire;0;0;14;0
2020-03-23;CI;Cote d'Ivoire;11;0;25;0
2020-03-24;CI;Cote d'Ivoire;48;0;73;0
2020-03-25;CI;Cote d'Ivoire;7;0;80;0
2020-03-26;CI;Cote d'Ivoire;16;0;96;0
2020-03-27;CI;Cote d'Ivoire;5;0;101;0
2020-03-28;CI;Cote d'Ivoire;0;0;101;0
2020-03-29;CI;Cote d'Ivoire;64;1;165;1
2020-03-30;CI;Cote d'Ivoire;3;0;168;1
2020-03-31;CI;Cote d'Ivoire;11;0;179;1
2020-04-01;CI;Cote d'Ivoire;11;0;190;1
2020-04-02;CI;Cote d'Ivoire;4;0;194;1
2020-04-03;CI;Cote d'Ivoire;24;0;218;1
2020-04-04;CI;Cote d'Ivoire;27;0;245;1
2020-04-05;CI;Cote d'Ivoire;16;2;261;3
2020-04-06;CI;Cote d'Ivoire;62;0;323;3
2020-04-07;CI;Cote d'Ivoire;26;0;349;3
2020-04-08;CI;Cote d'Ivoire;35;0;384;3
2020-04-09;CI;Cote d'Ivoire;60;0;444;3
2020-04-10;CI;Cote d'Ivoire;0;0;444;3
2020-04-11;CI;Cote d'Ivoire;89;1;533;4
2020-04-12;CI;Cote d'Ivoire;41;1;574;5
2020-04-13;CI;Cote d'Ivoire;52;1;626;6
2020-04-14;CI;Cote d'Ivoire;12;0;638;6
2020-04-15;CI;Cote d'Ivoire;0;0;638;6
2020-04-16;CI;Cote d'Ivoire;16;0;654;6
2020-04-17;CI;Cote d'Ivoire;34;0;688;6
2020-04-18;CI;Cote d'Ivoire;113;2;801;8
2020-04-19;CI;Cote d'Ivoire;46;1;847;9
2020-04-20;CI;Cote d'Ivoire;0;0;847;9
2020-04-21;CI;Cote d'Ivoire;69;4;916;13
2020-04-22;CI;Cote d'Ivoire;36;1;952;14
2020-04-23;CI;Cote d'Ivoire;52;0;1004;14
2020-04-24;CI;Cote d'Ivoire;73;0;1077;14
2020-04-25;CI;Cote d'Ivoire;0;0;1077;14
2020-04-26;CI;Cote d'Ivoire;73;0;1150;14
2020-04-27;CI;Cote d'Ivoire;14;0;1164;14
2020-04-28;CI;Cote d'Ivoire;19;0;1183;14
2020-04-29;CI;Cote d'Ivoire;55;0;1238;14
2020-04-30;CI;Cote d'Ivoire;37;0;1275;14
2020-05-01;CI;Cote d'Ivoire;58;1;1333;15
2020-05-02;CI;Cote d'Ivoire;29;0;1362;15
2020-05-03;CI;Cote d'Ivoire;36;2;1398;17
2020-05-04;CI;Cote d'Ivoire;34;0;1432;17
2020-05-05;CI;Cote d'Ivoire;32;1;1464;18
2020-05-06;CI;Cote d'Ivoire;52;0;1516;18
2020-05-07;CI;Cote d'Ivoire;55;2;1571;20
2020-05-08;CI;Cote d'Ivoire;31;0;1602;20
2020-05-09;CI;Cote d'Ivoire;65;1;1667;21
2020-05-10;CI;Cote d'Ivoire;33;0;1700;21
2020-05-11;CI;Cote d'Ivoire;30;0;1730;21
2020-05-12;CI;Cote d'Ivoire;127;0;1857;21
2020-05-13;CI;Cote d'Ivoire;55;3;1912;24
2020-05-14;CI;Cote d'Ivoire;59;0;1971;24
2020-05-15;CI;Cote d'Ivoire;46;0;2017;24
2020-05-16;CI;Cote d'Ivoire;44;1;2061;25
2020-05-17;CI;Cote d'Ivoire;48;2;2109;27
2020-05-18;CI;Cote d'Ivoire;10;1;2119;28
2020-05-19;CI;Cote d'Ivoire;34;0;2153;28
2020-05-20;CI;Cote d'Ivoire;78;1;2231;29
2020-05-21;CI;Cote d'Ivoire;70;0;2301;29
2020-05-22;CI;Cote d'Ivoire;40;0;2341;29
2020-05-23;CI;Cote d'Ivoire;25;1;2366;30
2020-05-24;CI;Cote d'Ivoire;10;0;2376;30
2020-05-25;CI;Cote d'Ivoire;47;0;2423;30
2020-05-26;CI;Cote d'Ivoire;54;0;2477;30
2020-05-27;CI;Cote d'Ivoire;79;1;2556;31
2020-05-28;CI;Cote d'Ivoire;85;1;2641;32
2020-05-29;CI;Cote d'Ivoire;109;0;2750;32
2020-05-30;CI;Cote d'Ivoire;49;1;2799;33
2020-05-31;CI;Cote d'Ivoire;34;0;2833;33
2020-06-01;CI;Cote d'Ivoire;118;0;2951;33
2020-06-02;CI;Cote d'Ivoire;73;0;3024;33
2020-06-03;CI;Cote d'Ivoire;86;2;3110;35
2020-06-04;CI;Cote d'Ivoire;152;0;3262;35
2020-06-05;CI;Cote d'Ivoire;169;1;3431;36
2020-06-06;CI;Cote d'Ivoire;126;0;3557;36
2020-06-07;CI;Cote d'Ivoire;182;0;3739;36
2020-06-08;CI;Cote d'Ivoire;142;2;3881;38
2020-06-09;CI;Cote d'Ivoire;114;0;3995;38
2020-06-10;CI;Cote d'Ivoire;186;3;4181;41
2020-06-11;CI;Cote d'Ivoire;223;0;4404;41
2020-06-12;CI;Cote d'Ivoire;280;4;4684;45
2020-06-13;CI;Cote d'Ivoire;164;0;4848;45
2020-06-14;CI;Cote d'Ivoire;236;0;5084;45
2020-06-15;CI;Cote d'Ivoire;355;1;5439;46
2020-06-16;CI;Cote d'Ivoire;240;0;5679;46
2020-06-17;CI;Cote d'Ivoire;384;2;6063;48
2020-06-18;CI;Cote d'Ivoire;381;1;6444;49
2020-06-19;CI;Cote d'Ivoire;430;0;6874;49
2020-06-20;CI;Cote d'Ivoire;402;3;7276;52
2020-06-21;CI;Cote d'Ivoire;216;2;7492;54
2020-06-22;CI;Cote d'Ivoire;185;2;7677;56
2020-06-23;CI;Cote d'Ivoire;227;2;7904;58
2020-06-24;CI;Cote d'Ivoire;260;0;8164;58
2020-06-25;CI;Cote d'Ivoire;170;2;8334;60
2020-06-26;CI;Cote d'Ivoire;405;4;8739;64
2020-06-27;CI;Cote d'Ivoire;205;2;8944;66
2020-06-28;CI;Cote d'Ivoire;157;0;9101;66
2020-06-29;CI;Cote d'Ivoire;113;0;9214;66
2020-06-30;CI;Cote d'Ivoire;285;2;9499;68
2020-07-01;CI;Cote d'Ivoire;203;0;9702;68
2020-07-02;CI;Cote d'Ivoire;290;0;9992;68
2020-07-03;CI;Cote d'Ivoire;252;2;10244;70
2020-07-04;CI;Cote d'Ivoire;218;2;10462;72
2020-07-05;CI;Cote d'Ivoire;310;2;10772;74
2020-07-06;CI;Cote d'Ivoire;194;1;10966;75
2020-07-07;CI;Cote d'Ivoire;228;1;11194;76
2020-07-08;CI;Cote d'Ivoire;310;2;11504;78
2020-07-09;CI;Cote d'Ivoire;246;1;11750;79
2020-07-10;CI;Cote d'Ivoire;302;2;12052;81
2020-07-11;CI;Cote d'Ivoire;391;1;12443;82
2020-07-12;CI;Cote d'Ivoire;323;2;12766;84
2020-07-13;CI;Cote d'Ivoire;106;0;12872;84
2020-07-14;CI;Cote d'Ivoire;165;3;13037;87
2020-07-15;CI;Cote d'Ivoire;366;0;13403;87
2020-07-16;CI;Cote d'Ivoire;151;0;13554;87
2020-07-17;CI;Cote d'Ivoire;142;0;13696;87
2020-07-18;CI;Cote d'Ivoire;216;4;13912;91
2020-07-19;CI;Cote d'Ivoire;207;1;14119;92
2020-07-20;CI;Cote d'Ivoire;193;0;14312;92
2020-07-21;CI;Cote d'Ivoire;219;1;14531;93
2020-07-22;CI;Cote d'Ivoire;202;0;14733;93
2020-07-23;CI;Cote d'Ivoire;268;0;15001;93
2020-07-24;CI;Cote d'Ivoire;252;1;15253;94
2020-07-25;CI;Cote d'Ivoire;241;0;15494;94
2020-07-26;CI;Cote d'Ivoire;102;2;15596;96
2020-07-27;CI;Cote d'Ivoire;59;0;15655;96
2020-07-28;CI;Cote d'Ivoire;58;2;15713;98
2020-07-29;CI;Cote d'Ivoire;100;1;15813;99
2020-07-30;CI;Cote d'Ivoire;165;1;15978;100
2020-07-31;CI;Cote d'Ivoire;69;2;16047;102
2020-08-01;CI;Cote d'Ivoire;62;0;16109;102
2020-08-02;CI;Cote d'Ivoire;73;0;16182;102
2020-08-03;CI;Cote d'Ivoire;38;0;16220;102
2020-08-04;CI;Cote d'Ivoire;73;1;16293;103
2020-08-05;CI;Cote d'Ivoire;56;0;16349;103
2020-08-06;CI;Cote d'Ivoire;98;0;16447;103
2020-08-07;CI;Cote d'Ivoire;77;1;16524;104
2020-08-08;CI;Cote d'Ivoire;96;0;16620;104
2020-08-09;CI;Cote d'Ivoire;95;1;16715;105
2020-08-10;CI;Cote d'Ivoire;83;0;16798;105
2020-08-11;CI;Cote d'Ivoire;49;0;16847;105
2020-08-12;CI;Cote d'Ivoire;0;0;16847;105
2020-08-13;CI;Cote d'Ivoire;42;2;16889;107
2020-08-14;CI;Cote d'Ivoire;46;1;16935;108
2020-08-15;CI;Cote d'Ivoire;58;0;16993;108
2020-08-16;CI;Cote d'Ivoire;33;2;17026;110
2020-08-17;CI;Cote d'Ivoire;81;0;17107;110
2020-08-18;CI;Cote d'Ivoire;43;0;17150;110
2020-08-19;CI;Cote d'Ivoire;82;1;17232;111
2020-08-20;CI;Cote d'Ivoire;17;1;17249;112
2020-08-21;CI;Cote d'Ivoire;61;0;17310;112
2020-08-22;CI;Cote d'Ivoire;64;1;17374;113
2020-08-23;CI;Cote d'Ivoire;97;0;17471;113
2020-08-24;CI;Cote d'Ivoire;35;1;17506;114
2020-08-25;CI;Cote d'Ivoire;56;0;17562;114
2020-08-26;CI;Cote d'Ivoire;41;0;17603;114
2020-08-27;CI;Cote d'Ivoire;99;1;17702;115
2020-08-28;CI;Cote d'Ivoire;95;0;17797;115
2020-08-29;CI;Cote d'Ivoire;96;0;17893;115
2020-08-30;CI;Cote d'Ivoire;55;0;17948;115
2020-08-31;CI;Cote d'Ivoire;119;2;18067;117
2020-09-01;CI;Cote d'Ivoire;36;0;18103;117
2020-09-02;CI;Cote d'Ivoire;58;0;18161;117
2020-09-03;CI;Cote d'Ivoire;47;2;18208;119
2020-09-04;CI;Cote d'Ivoire;61;0;18269;119
2020-09-05;CI;Cote d'Ivoire;203;0;18472;119
2020-09-06;CI;Cote d'Ivoire;116;0;18588;119
2020-09-07;CI;Cote d'Ivoire;113;0;18701;119
2020-09-08;CI;Cote d'Ivoire;77;0;18778;119
2020-09-09;CI;Cote d'Ivoire;37;0;18815;119
2020-09-10;CI;Cote d'Ivoire;54;0;18869;119
2020-09-11;CI;Cote d'Ivoire;47;0;18916;119
2020-09-12;CI;Cote d'Ivoire;0;0;18916;119
2020-09-13;CI;Cote d'Ivoire;97;1;19013;120
2020-09-14;CI;Cote d'Ivoire;53;0;19066;120
2020-09-15;CI;Cote d'Ivoire;34;0;19100;120
2020-09-16;CI;Cote d'Ivoire;32;0;19132;120
2020-09-17;CI;Cote d'Ivoire;26;0;19158;120
2020-09-18;CI;Cote d'Ivoire;42;0;19200;120
2020-09-19;CI;Cote d'Ivoire;69;0;19269;120
2020-09-20;CI;Cote d'Ivoire;51;0;19320;120
2020-09-21;CI;Cote d'Ivoire;7;0;19327;120
2020-09-22;CI;Cote d'Ivoire;16;0;19343;120
2020-09-23;CI;Cote d'Ivoire;87;0;19430;120
2020-09-24;CI;Cote d'Ivoire;71;0;19501;120
2020-09-25;CI;Cote d'Ivoire;55;0;19556;120
2020-09-26;CI;Cote d'Ivoire;44;0;19600;120
2020-09-27;CI;Cote d'Ivoire;29;0;19629;120
2020-09-28;CI;Cote d'Ivoire;12;0;19641;120
2020-09-29;CI;Cote d'Ivoire;28;0;19669;120
2020-09-30;CI;Cote d'Ivoire;55;0;19724;120
2020-10-01;CI;Cote d'Ivoire;31;0;19755;120
2020-10-02;CI;Cote d'Ivoire;38;0;19793;120
2020-10-03;CI;Cote d'Ivoire;56;0;19849;120
2020-10-04;CI;Cote d'Ivoire;33;0;19882;120
2020-10-05;CI;Cote d'Ivoire;3;0;19885;120
2020-10-06;CI;Cote d'Ivoire;18;0;19903;120
2020-10-07;CI;Cote d'Ivoire;32;0;19935;120
2020-10-08;CI;Cote d'Ivoire;47;0;19982;120
2020-10-09;CI;Cote d'Ivoire;54;0;20036;120
2020-10-10;CI;Cote d'Ivoire;92;0;20128;120
2020-10-11;CI;Cote d'Ivoire;26;0;20154;120
2020-10-12;CI;Cote d'Ivoire;1;0;20155;120
2020-10-13;CI;Cote d'Ivoire;28;0;20183;120
2020-10-14;CI;Cote d'Ivoire;34;0;20217;120
2020-10-15;CI;Cote d'Ivoire;40;0;20257;120
2020-10-16;CI;Cote d'Ivoire;18;1;20275;121
2020-10-17;CI;Cote d'Ivoire;26;0;20301;121
2020-10-18;CI;Cote d'Ivoire;22;0;20323;121
2020-10-19;CI;Cote d'Ivoire;1;0;20324;121
2020-10-20;CI;Cote d'Ivoire;18;0;20342;121
2020-10-21;CI;Cote d'Ivoire;21;0;20363;121
2020-10-22;CI;Cote d'Ivoire;27;0;20390;121
2020-10-23;CI;Cote d'Ivoire;15;0;20405;121
2020-10-24;CI;Cote d'Ivoire;24;0;20429;121
2020-10-25;CI;Cote d'Ivoire;41;1;20470;122
2020-10-26;CI;Cote d'Ivoire;16;0;20486;122
2020-10-27;CI;Cote d'Ivoire;2;0;20488;122
2020-10-28;CI;Cote d'Ivoire;67;2;20555;124
2020-10-29;CI;Cote d'Ivoire;73;0;20628;124
2020-10-30;CI;Cote d'Ivoire;64;0;20692;124
2020-10-31;CI;Cote d'Ivoire;24;2;20716;126
2020-11-01;CI;Cote d'Ivoire;0;0;20716;126
2020-11-02;CI;Cote d'Ivoire;37;0;20753;126
2020-11-03;CI;Cote d'Ivoire;12;0;20765;126
2020-11-04;CI;Cote d'Ivoire;13;0;20778;126
2020-11-05;CI;Cote d'Ivoire;11;0;20789;126
2020-11-06;CI;Cote d'Ivoire;12;0;20801;126
2020-11-07;CI;Cote d'Ivoire;12;0;20813;126
2020-11-08;CI;Cote d'Ivoire;19;0;20832;126
2020-11-09;CI;Cote d'Ivoire;3;0;20835;126
2020-11-10;CI;Cote d'Ivoire;12;0;20847;126
2020-11-11;CI;Cote d'Ivoire;8;1;20855;127
2020-11-12;CI;Cote d'Ivoire;27;0;20882;127
2020-11-13;CI;Cote d'Ivoire;17;0;20899;127
2020-11-14;CI;Cote d'Ivoire;46;0;20945;127
2020-11-15;CI;Cote d'Ivoire;31;1;20976;128
2020-11-16;CI;Cote d'Ivoire;12;0;20988;128
2020-11-17;CI;Cote d'Ivoire;16;1;21004;129
2020-11-18;CI;Cote d'Ivoire;41;0;21045;129
2020-11-19;CI;Cote d'Ivoire;38;0;21083;129
2020-11-20;CI;Cote d'Ivoire;16;0;21099;129
2020-11-21;CI;Cote d'Ivoire;27;0;21126;129
2020-11-22;CI;Cote d'Ivoire;12;2;21138;131
2020-11-23;CI;Cote d'Ivoire;10;0;21148;131
2020-11-24;CI;Cote d'Ivoire;8;0;21156;131
2020-11-25;CI;Cote d'Ivoire;12;0;21168;131
2020-11-26;CI;Cote d'Ivoire;31;0;21199;131
2020-11-27;CI;Cote d'Ivoire;33;0;21232;131
2020-11-28;CI;Cote d'Ivoire;29;0;21261;131
2020-11-29;CI;Cote d'Ivoire;49;0;21310;131
2020-11-30;CI;Cote d'Ivoire;21;1;21331;132
2020-12-01;CI;Cote d'Ivoire;3;0;21334;132
2020-12-02;CI;Cote d'Ivoire;27;0;21361;132
2020-12-03;CI;Cote d'Ivoire;28;0;21389;132
2020-12-04;CI;Cote d'Ivoire;23;0;21412;132
2020-12-05;CI;Cote d'Ivoire;29;0;21441;132
2020-12-06;CI;Cote d'Ivoire;44;0;21485;132
2020-12-07;CI;Cote d'Ivoire;22;0;21507;132
2020-12-08;CI;Cote d'Ivoire;6;0;21513;132
2020-12-09;CI;Cote d'Ivoire;34;1;21547;133
2020-12-10;CI;Cote d'Ivoire;43;0;21590;133
2020-12-11;CI;Cote d'Ivoire;28;0;21618;133
2020-12-12;CI;Cote d'Ivoire;21;0;21639;133
2020-12-13;CI;Cote d'Ivoire;41;0;21680;133
2020-12-14;CI;Cote d'Ivoire;25;0;21705;133
2020-12-15;CI;Cote d'Ivoire;70;0;21775;133
2020-12-16;CI;Cote d'Ivoire;-34;0;21741;133
2020-12-17;CI;Cote d'Ivoire;31;0;21772;133
2020-12-18;CI;Cote d'Ivoire;73;0;21845;133
2020-12-19;CI;Cote d'Ivoire;45;0;21890;133
2020-12-20;CI;Cote d'Ivoire;28;0;21918;133
2020-12-21;CI;Cote d'Ivoire;14;0;21932;133
2020-12-22;CI;Cote d'Ivoire;10;0;21942;133
2020-12-23;CI;Cote d'Ivoire;42;0;21984;133
2020-12-24;CI;Cote d'Ivoire;87;0;22071;133
2020-12-25;CI;Cote d'Ivoire;10;0;22081;133
2020-12-26;CI;Cote d'Ivoire;0;0;22081;133
2020-12-27;CI;Cote d'Ivoire;71;2;22152;135
2020-12-28;CI;Cote d'Ivoire;24;2;22176;137
2020-12-29;CI;Cote d'Ivoire;74;0;22250;137
2020-12-30;CI;Cote d'Ivoire;116;0;22366;137
2020-12-31;CI;Cote d'Ivoire;124;0;22490;137
2021-01-01;CI;Cote d'Ivoire;73;1;22563;138
2021-01-02;CI;Cote d'Ivoire;0;0;22563;138
2021-01-03;CI;Cote d'Ivoire;85;0;22648;138
2021-01-04;CI;Cote d'Ivoire;152;0;22800;138
2021-01-05;CI;Cote d'Ivoire;55;0;22855;138
2021-01-06;CI;Cote d'Ivoire;108;0;22963;138
2021-01-07;CI;Cote d'Ivoire;210;0;23173;138
2021-01-08;CI;Cote d'Ivoire;81;1;23254;139
2021-01-09;CI;Cote d'Ivoire;228;0;23482;139
2021-01-10;CI;Cote d'Ivoire;268;0;23750;139
2021-01-11;CI;Cote d'Ivoire;144;0;23894;139
2021-01-12;CI;Cote d'Ivoire;292;1;24186;140
2021-01-13;CI;Cote d'Ivoire;183;0;24369;140
2021-01-14;CI;Cote d'Ivoire;209;0;24578;140
2021-01-15;CI;Cote d'Ivoire;278;1;24856;141
2021-01-16;CI;Cote d'Ivoire;0;0;24856;141
2021-01-17;CI;Cote d'Ivoire;385;0;25241;141
2021-01-18;CI;Cote d'Ivoire;63;1;25304;142
2021-01-19;CI;Cote d'Ivoire;79;0;25383;142
2021-01-20;CI;Cote d'Ivoire;214;0;25597;142
2021-01-21;CI;Cote d'Ivoire;154;0;25751;142
2021-01-22;CI;Cote d'Ivoire;564;1;26315;143
2021-01-23;CI;Cote d'Ivoire;297;2;26612;145
2021-01-24;CI;Cote d'Ivoire;238;1;26850;146
2021-01-25;CI;Cote d'Ivoire;246;0;27096;146
2021-01-26;CI;Cote d'Ivoire;141;1;27237;147
2021-01-27;CI;Cote d'Ivoire;218;4;27455;151
2021-01-28;CI;Cote d'Ivoire;239;0;27694;151
2021-01-29;CI;Cote d'Ivoire;240;1;27934;152
2021-01-30;CI;Cote d'Ivoire;244;0;28178;152
2021-01-31;CI;Cote d'Ivoire;221;2;28399;154
2021-02-01;CI;Cote d'Ivoire;76;2;28475;156
2021-02-02;CI;Cote d'Ivoire;132;2;28607;158
2021-02-03;CI;Cote d'Ivoire;132;0;28739;158
2021-02-04;CI;Cote d'Ivoire;363;0;29102;158
2021-02-05;CI;Cote d'Ivoire;193;2;29295;160
2021-02-06;CI;Cote d'Ivoire;272;2;29567;162
2021-02-07;CI;Cote d'Ivoire;258;0;29825;162
2021-02-08;CI;Cote d'Ivoire;142;3;29967;165
2021-02-09;CI;Cote d'Ivoire;0;0;29967;165
2021-02-10;CI;Cote d'Ivoire;273;4;30240;169
2021-02-11;CI;Cote d'Ivoire;286;2;30526;171
2021-02-12;CI;Cote d'Ivoire;191;2;30717;173
2021-02-13;CI;Cote d'Ivoire;167;0;30884;173
2021-02-14;CI;Cote d'Ivoire;256;1;31140;174
2021-02-15;CI;Cote d'Ivoire;95;1;31235;175
2021-02-16;CI;Cote d'Ivoire;130;4;31365;179
2021-02-17;CI;Cote d'Ivoire;132;1;31497;180
2021-02-18;CI;Cote d'Ivoire;115;3;31612;183
2021-02-19;CI;Cote d'Ivoire;213;2;31825;185
2021-02-20;CI;Cote d'Ivoire;89;0;31914;185
2021-02-21;CI;Cote d'Ivoire;112;1;32026;186
2021-02-22;CI;Cote d'Ivoire;13;2;32039;188
2021-02-23;CI;Cote d'Ivoire;85;0;32124;188
2021-02-24;CI;Cote d'Ivoire;171;0;32295;188
2021-02-25;CI;Cote d'Ivoire;0;0;32295;188
2021-02-26;CI;Cote d'Ivoire;183;2;32478;190
2021-02-27;CI;Cote d'Ivoire;153;2;32631;192
2021-02-28;CI;Cote d'Ivoire;123;0;32754;192
2021-03-01;CI;Cote d'Ivoire;37;1;32791;193
2021-03-02;CI;Cote d'Ivoire;138;0;32929;193
2021-03-03;CI;Cote d'Ivoire;356;1;33285;194
2021-03-04;CI;Cote d'Ivoire;691;2;33976;196
2021-03-05;CI;Cote d'Ivoire;436;3;34412;199
2021-03-06;CI;Cote d'Ivoire;523;1;34935;200
2021-03-07;CI;Cote d'Ivoire;252;2;35187;202
2021-03-08;CI;Cote d'Ivoire;144;2;35331;204
2021-03-09;CI;Cote d'Ivoire;146;2;35477;206
2021-03-10;CI;Cote d'Ivoire;551;0;36028;206
2021-03-11;CI;Cote d'Ivoire;483;3;36511;209
2021-03-12;CI;Cote d'Ivoire;313;2;36824;211
2021-03-13;CI;Cote d'Ivoire;480;0;37304;211
2021-03-14;CI;Cote d'Ivoire;349;0;37653;211
2021-03-15;CI;Cote d'Ivoire;255;2;37908;213
2021-03-16;CI;Cote d'Ivoire;212;1;38120;214
2021-03-17;CI;Cote d'Ivoire;162;0;38282;214
2021-03-18;CI;Cote d'Ivoire;641;1;38923;215
2021-03-19;CI;Cote d'Ivoire;511;1;39434;216
2021-03-20;CI;Cote d'Ivoire;479;1;39913;217
2021-03-21;CI;Cote d'Ivoire;397;3;40310;220
2021-03-22;CI;Cote d'Ivoire;291;2;40601;222
2021-03-23;CI;Cote d'Ivoire;267;0;40868;222
2021-03-24;CI;Cote d'Ivoire;439;2;41307;224
2021-03-25;CI;Cote d'Ivoire;767;5;42074;229
2021-03-26;CI;Cote d'Ivoire;394;0;42468;229
2021-03-27;CI;Cote d'Ivoire;393;3;42861;232
2021-03-28;CI;Cote d'Ivoire;319;5;43180;237
2021-03-29;CI;Cote d'Ivoire;242;2;43422;239
2021-03-30;CI;Cote d'Ivoire;120;3;43542;242
2021-03-31;CI;Cote d'Ivoire;347;2;43889;244
2021-04-01;CI;Cote d'Ivoire;0;0;43889;244
2021-04-02;CI;Cote d'Ivoire;556;6;44445;250
2021-04-03;CI;Cote d'Ivoire;173;2;44618;252
2021-04-04;CI;Cote d'Ivoire;131;3;44749;255
2021-04-05;CI;Cote d'Ivoire;92;1;44841;256
2021-04-06;CI;Cote d'Ivoire;13;0;44854;256
2021-04-07;CI;Cote d'Ivoire;26;1;44880;257
2021-04-08;CI;Cote d'Ivoire;95;1;44975;258
2021-04-09;CI;Cote d'Ivoire;114;2;45089;260
2021-04-10;CI;Cote d'Ivoire;0;0;45089;260
2021-04-11;CI;Cote d'Ivoire;117;3;45206;263
2021-04-12;CI;Cote d'Ivoire;21;5;45227;268
2021-04-13;CI;Cote d'Ivoire;38;1;45265;269
2021-04-14;CI;Cote d'Ivoire;123;2;45388;271
2021-04-15;CI;Cote d'Ivoire;56;2;45444;273
2021-04-16;CI;Cote d'Ivoire;30;1;45474;274
2021-04-17;CI;Cote d'Ivoire;45;0;45519;274
2021-04-18;CI;Cote d'Ivoire;41;0;45560;274
2021-04-19;CI;Cote d'Ivoire;10;0;45570;274
2021-04-20;CI;Cote d'Ivoire;44;1;45614;275
2021-04-21;CI;Cote d'Ivoire;83;2;45697;277
2021-04-22;CI;Cote d'Ivoire;18;0;45715;277
2021-04-23;CI;Cote d'Ivoire;50;2;45765;279
2021-04-24;CI;Cote d'Ivoire;55;2;45820;281
2021-04-25;CI;Cote d'Ivoire;32;1;45852;282
2021-04-26;CI;Cote d'Ivoire;11;1;45863;283
2021-04-27;CI;Cote d'Ivoire;22;2;45885;285
2021-04-28;CI;Cote d'Ivoire;58;1;45943;286
2021-04-29;CI;Cote d'Ivoire;55;0;45998;286
2021-04-30;CI;Cote d'Ivoire;38;0;46036;286
2021-05-01;CI;Cote d'Ivoire;78;0;46114;286
2021-05-02;CI;Cote d'Ivoire;0;0;46114;286
2021-05-03;CI;Cote d'Ivoire;40;1;46154;287
2021-05-04;CI;Cote d'Ivoire;19;4;46173;291
2021-05-05;CI;Cote d'Ivoire;58;0;46231;291
2021-05-06;CI;Cote d'Ivoire;84;0;46315;291
2021-05-07;CI;Cote d'Ivoire;29;0;46344;291
2021-05-08;CI;Cote d'Ivoire;41;0;46385;291
2021-05-09;CI;Cote d'Ivoire;57;0;46442;291
2021-05-10;CI;Cote d'Ivoire;1;0;46443;291
2021-05-11;CI;Cote d'Ivoire;41;1;46484;292
2021-05-12;CI;Cote d'Ivoire;32;0;46516;292
2021-05-13;CI;Cote d'Ivoire;4;2;46520;294
2021-05-14;CI;Cote d'Ivoire;15;1;46535;295
2021-05-15;CI;Cote d'Ivoire;0;0;46535;295
2021-05-16;CI;Cote d'Ivoire;121;3;46656;298
2021-05-17;CI;Cote d'Ivoire;5;0;46661;298
2021-05-18;CI;Cote d'Ivoire;47;0;46708;298
2021-05-19;CI;Cote d'Ivoire;69;0;46777;298
2021-05-20;CI;Cote d'Ivoire;57;0;46834;298
2021-05-21;CI;Cote d'Ivoire;40;0;46874;298
2021-05-22;CI;Cote d'Ivoire;68;0;46942;298
2021-05-23;CI;Cote d'Ivoire;0;0;46942;298
2021-05-24;CI;Cote d'Ivoire;91;0;47033;298
2021-05-25;CI;Cote d'Ivoire;3;0;47036;298
2021-05-26;CI;Cote d'Ivoire;49;3;47085;301
2021-05-27;CI;Cote d'Ivoire;61;0;47146;301
2021-05-28;CI;Cote d'Ivoire;49;0;47195;301
2021-05-29;CI;Cote d'Ivoire;38;2;47233;303
2021-05-30;CI;Cote d'Ivoire;0;0;47233;303
2021-05-31;CI;Cote d'Ivoire;59;2;47292;305
2021-06-01;CI;Cote d'Ivoire;27;1;47319;306
2021-06-02;CI;Cote d'Ivoire;37;0;47356;306
2021-06-03;CI;Cote d'Ivoire;33;0;47389;306
2021-06-04;CI;Cote d'Ivoire;46;0;47435;306
2021-06-05;CI;Cote d'Ivoire;41;0;47476;306
2021-06-06;CI;Cote d'Ivoire;14;0;47490;306
2021-06-07;CI;Cote d'Ivoire;3;0;47493;306
2021-06-08;CI;Cote d'Ivoire;18;0;47511;306
2021-06-09;CI;Cote d'Ivoire;36;0;47547;306
2021-06-10;CI;Cote d'Ivoire;58;0;47605;306
2021-06-11;CI;Cote d'Ivoire;33;0;47638;306
2021-06-12;CI;Cote d'Ivoire;24;0;47662;306
2021-06-13;CI;Cote d'Ivoire;0;0;47662;306
2021-06-14;CI;Cote d'Ivoire;98;0;47760;306
2021-06-15;CI;Cote d'Ivoire;149;0;47909;306
2021-06-16;CI;Cote d'Ivoire;24;0;47933;306
2021-06-17;CI;Cote d'Ivoire;40;0;47973;306
2021-06-18;CI;Cote d'Ivoire;0;0;47973;306
2021-06-19;CI;Cote d'Ivoire;58;1;48031;307
2021-06-20;CI;Cote d'Ivoire;13;1;48044;308
2021-06-21;CI;Cote d'Ivoire;3;0;48047;308
2021-06-22;CI;Cote d'Ivoire;11;1;48058;309
2021-06-23;CI;Cote d'Ivoire;0;0;48058;309
2021-06-24;CI;Cote d'Ivoire;0;0;48058;309
2021-06-25;CI;Cote d'Ivoire;0;0;48058;309
2021-06-26;CI;Cote d'Ivoire;118;2;48176;311
2021-06-27;CI;Cote d'Ivoire;16;1;48192;312
2021-06-28;CI;Cote d'Ivoire;11;1;48203;313
2021-06-29;CI;Cote d'Ivoire;39;0;48242;313
2021-06-30;CI;Cote d'Ivoire;63;0;48305;313
2021-07-01;CI;Cote d'Ivoire;73;2;48378;315
2020-02-25;HR;Croatia;1;0;1;0
2020-02-26;HR;Croatia;2;0;3;0
2020-02-27;HR;Croatia;0;0;3;0
2020-02-28;HR;Croatia;2;0;5;0
2020-02-29;HR;Croatia;1;0;6;0
2020-03-01;HR;Croatia;1;0;7;0
2020-03-02;HR;Croatia;0;0;7;0
2020-03-03;HR;Croatia;2;0;9;0
2020-03-04;HR;Croatia;1;0;10;0
2020-03-05;HR;Croatia;0;0;10;0
2020-03-06;HR;Croatia;1;0;11;0
2020-03-07;HR;Croatia;1;0;12;0
2020-03-08;HR;Croatia;0;0;12;0
2020-03-09;HR;Croatia;0;0;12;0
2020-03-10;HR;Croatia;2;0;14;0
2020-03-11;HR;Croatia;5;0;19;0
2020-03-12;HR;Croatia;0;0;19;0
2020-03-13;HR;Croatia;13;0;32;0
2020-03-14;HR;Croatia;6;0;38;0
2020-03-15;HR;Croatia;11;0;49;0
2020-03-16;HR;Croatia;8;0;57;0
2020-03-17;HR;Croatia;8;0;65;0
2020-03-18;HR;Croatia;16;0;81;0
2020-03-19;HR;Croatia;24;1;105;1
2020-03-20;HR;Croatia;23;0;128;1
2020-03-21;HR;Croatia;78;0;206;1
2020-03-22;HR;Croatia;48;0;254;1
2020-03-23;HR;Croatia;61;0;315;1
2020-03-24;HR;Croatia;67;0;382;1
2020-03-25;HR;Croatia;60;0;442;1
2020-03-26;HR;Croatia;53;2;495;3
2020-03-27;HR;Croatia;91;0;586;3
2020-03-28;HR;Croatia;71;2;657;5
2020-03-29;HR;Croatia;56;1;713;6
2020-03-30;HR;Croatia;77;0;790;6
2020-03-31;HR;Croatia;77;0;867;6
2020-04-01;HR;Croatia;96;0;963;6
2020-04-02;HR;Croatia;48;1;1011;7
2020-04-03;HR;Croatia;68;1;1079;8
2020-04-04;HR;Croatia;47;4;1126;12
2020-04-05;HR;Croatia;56;3;1182;15
2020-04-06;HR;Croatia;40;1;1222;16
2020-04-07;HR;Croatia;60;2;1282;18
2020-04-08;HR;Croatia;61;1;1343;19
2020-04-09;HR;Croatia;64;1;1407;20
2020-04-10;HR;Croatia;88;1;1495;21
2020-04-11;HR;Croatia;39;0;1534;21
2020-04-12;HR;Croatia;66;2;1600;23
2020-04-13;HR;Croatia;50;2;1650;25
2020-04-14;HR;Croatia;54;6;1704;31
2020-04-15;HR;Croatia;37;2;1741;33
2020-04-16;HR;Croatia;50;2;1791;35
2020-04-17;HR;Croatia;23;1;1814;36
2020-04-18;HR;Croatia;18;3;1832;39
2020-04-19;HR;Croatia;39;8;1871;47
2020-04-20;HR;Croatia;10;0;1881;47
2020-04-21;HR;Croatia;27;1;1908;48
2020-04-22;HR;Croatia;42;0;1950;48
2020-04-23;HR;Croatia;31;2;1981;50
2020-04-24;HR;Croatia;28;1;2009;51
2020-04-25;HR;Croatia;7;3;2016;54
2020-04-26;HR;Croatia;14;1;2030;55
2020-04-27;HR;Croatia;9;4;2039;59
2020-04-28;HR;Croatia;8;4;2047;63
2020-04-29;HR;Croatia;15;4;2062;67
2020-04-30;HR;Croatia;14;2;2076;69
2020-05-01;HR;Croatia;9;6;2085;75
2020-05-02;HR;Croatia;3;2;2088;77
2020-05-03;HR;Croatia;8;2;2096;79
2020-05-04;HR;Croatia;5;1;2101;80
2020-05-05;HR;Croatia;11;3;2112;83
2020-05-06;HR;Croatia;7;2;2119;85
2020-05-07;HR;Croatia;6;1;2125;86
2020-05-08;HR;Croatia;36;0;2161;86
2020-05-09;HR;Croatia;15;1;2176;87
2020-05-10;HR;Croatia;11;3;2187;90
2020-05-11;HR;Croatia;9;1;2196;91
2020-05-12;HR;Croatia;11;0;2207;91
2020-05-13;HR;Croatia;6;3;2213;94
2020-05-14;HR;Croatia;8;0;2221;94
2020-05-15;HR;Croatia;1;1;2222;95
2020-05-16;HR;Croatia;2;0;2224;95
2020-05-17;HR;Croatia;2;0;2226;95
2020-05-18;HR;Croatia;2;0;2228;95
2020-05-19;HR;Croatia;4;1;2232;96
2020-05-20;HR;Croatia;2;0;2234;96
2020-05-21;HR;Croatia;3;1;2237;97
2020-05-22;HR;Croatia;6;2;2243;99
2020-05-23;HR;Croatia;0;0;2243;99
2020-05-24;HR;Croatia;1;0;2244;99
2020-05-25;HR;Croatia;0;1;2244;100
2020-05-26;HR;Croatia;0;1;2244;101
2020-05-27;HR;Croatia;0;0;2244;101
2020-05-28;HR;Croatia;1;1;2245;102
2020-05-29;HR;Croatia;0;1;2245;103
2020-05-30;HR;Croatia;1;0;2246;103
2020-05-31;HR;Croatia;0;0;2246;103
2020-06-01;HR;Croatia;0;0;2246;103
2020-06-02;HR;Croatia;0;0;2246;103
2020-06-03;HR;Croatia;0;0;2246;103
2020-06-04;HR;Croatia;1;0;2247;103
2020-06-05;HR;Croatia;0;0;2247;103
2020-06-06;HR;Croatia;0;1;2247;104
2020-06-07;HR;Croatia;0;0;2247;104
2020-06-08;HR;Croatia;0;0;2247;104
2020-06-09;HR;Croatia;0;2;2247;106
2020-06-10;HR;Croatia;2;0;2249;106
2020-06-11;HR;Croatia;0;0;2249;106
2020-06-12;HR;Croatia;0;1;2249;107
2020-06-13;HR;Croatia;2;0;2251;107
2020-06-14;HR;Croatia;1;0;2252;107
2020-06-15;HR;Croatia;2;0;2254;107
2020-06-16;HR;Croatia;1;0;2255;107
2020-06-17;HR;Croatia;3;0;2258;107
2020-06-18;HR;Croatia;11;0;2269;107
2020-06-19;HR;Croatia;11;0;2280;107
2020-06-20;HR;Croatia;19;0;2299;107
2020-06-21;HR;Croatia;18;0;2317;107
2020-06-22;HR;Croatia;19;0;2336;107
2020-06-23;HR;Croatia;30;0;2366;107
2020-06-24;HR;Croatia;22;0;2388;107
2020-06-25;HR;Croatia;95;0;2483;107
2020-06-26;HR;Croatia;56;0;2539;107
2020-06-27;HR;Croatia;85;0;2624;107
2020-06-28;HR;Croatia;67;0;2691;107
2020-06-29;HR;Croatia;34;0;2725;107
2020-06-30;HR;Croatia;52;0;2777;107
2020-07-01;HR;Croatia;54;1;2831;108
2020-07-02;HR;Croatia;81;2;2912;110
2020-07-03;HR;Croatia;96;2;3008;112
2020-07-04;HR;Croatia;86;1;3094;113
2020-07-05;HR;Croatia;57;0;3151;113
2020-07-06;HR;Croatia;69;0;3220;113
2020-07-07;HR;Croatia;52;0;3272;113
2020-07-08;HR;Croatia;53;1;3325;114
2020-07-09;HR;Croatia;91;1;3416;115
2020-07-10;HR;Croatia;116;2;3532;117
2020-07-11;HR;Croatia;140;1;3672;118
2020-07-12;HR;Croatia;50;1;3722;119
2020-07-13;HR;Croatia;53;0;3775;119
2020-07-14;HR;Croatia;52;1;3827;120
2020-07-15;HR;Croatia;126;0;3953;120
2020-07-16;HR;Croatia;86;0;4039;120
2020-07-17;HR;Croatia;98;0;4137;120
2020-07-18;HR;Croatia;116;0;4253;120
2020-07-19;HR;Croatia;92;0;4345;120
2020-07-20;HR;Croatia;25;2;4370;122
2020-07-21;HR;Croatia;52;1;4422;123
2020-07-22;HR;Croatia;108;2;4530;125
2020-07-23;HR;Croatia;104;3;4634;128
2020-07-24;HR;Croatia;81;0;4715;128
2020-07-25;HR;Croatia;77;5;4792;133
2020-07-26;HR;Croatia;65;3;4857;136
2020-07-27;HR;Croatia;24;3;4881;139
2020-07-28;HR;Croatia;42;1;4923;140
2020-07-29;HR;Croatia;70;1;4993;141
2020-07-30;HR;Croatia;78;3;5071;144
2020-07-31;HR;Croatia;68;1;5139;145
2020-08-01;HR;Croatia;85;0;5224;145
2020-08-02;HR;Croatia;36;4;5260;149
2020-08-03;HR;Croatia;34;4;5294;153
2020-08-04;HR;Croatia;24;1;5318;154
2020-08-05;HR;Croatia;58;0;5376;154
2020-08-06;HR;Croatia;28;1;5404;155
2020-08-07;HR;Croatia;62;0;5466;155
2020-08-08;HR;Croatia;77;2;5543;157
2020-08-09;HR;Croatia;61;0;5604;157
2020-08-10;HR;Croatia;45;1;5649;158
2020-08-11;HR;Croatia;91;2;5740;160
2020-08-12;HR;Croatia;130;0;5870;160
2020-08-13;HR;Croatia;180;1;6050;161
2020-08-14;HR;Croatia;208;2;6258;163
2020-08-15;HR;Croatia;162;2;6420;165
2020-08-16;HR;Croatia;151;1;6571;166
2020-08-17;HR;Croatia;85;0;6656;166
2020-08-18;HR;Croatia;199;0;6855;166
2020-08-19;HR;Croatia;219;2;7074;168
2020-08-20;HR;Croatia;255;0;7329;168
2020-08-21;HR;Croatia;265;1;7594;169
2020-08-22;HR;Croatia;306;1;7900;170
2020-08-23;HR;Croatia;275;1;8175;171
2020-08-24;HR;Croatia;136;2;8311;173
2020-08-25;HR;Croatia;219;2;8530;175
2020-08-26;HR;Croatia;358;0;8888;175
2020-08-27;HR;Croatia;304;2;9192;177
2020-08-28;HR;Croatia;357;3;9549;180
2020-08-29;HR;Croatia;312;3;9861;183
2020-08-30;HR;Croatia;262;1;10123;184
2020-08-31;HR;Croatia;146;2;10269;186
2020-09-01;HR;Croatia;145;1;10414;187
2020-09-02;HR;Croatia;311;4;10725;191
2020-09-03;HR;Croatia;369;3;11094;194
2020-09-04;HR;Croatia;334;1;11428;195
2020-09-05;HR;Croatia;311;2;11739;197
2020-09-06;HR;Croatia;225;1;11964;198
2020-09-07;HR;Croatia;117;3;12081;201
2020-09-08;HR;Croatia;204;2;12285;203
2020-09-09;HR;Croatia;341;3;12626;206
2020-09-10;HR;Croatia;291;2;12917;208
2020-09-11;HR;Croatia;190;3;13107;211
2020-09-12;HR;Croatia;261;7;13368;218
2020-09-13;HR;Croatia;165;6;13533;224
2020-09-14;HR;Croatia;65;3;13598;227
2020-09-15;HR;Croatia;151;3;13749;230
2020-09-16;HR;Croatia;280;6;14029;236
2020-09-17;HR;Croatia;250;2;14279;238
2020-09-18;HR;Croatia;234;6;14513;244
2020-09-19;HR;Croatia;212;0;14725;244
2020-09-20;HR;Croatia;197;4;14922;248
2020-09-21;HR;Croatia;70;5;14992;253
2020-09-22;HR;Croatia;144;2;15136;255
2020-09-23;HR;Croatia;204;2;15340;257
2020-09-24;HR;Croatia;232;4;15572;261
2020-09-25;HR;Croatia;223;5;15795;266
2020-09-26;HR;Croatia;212;3;16007;269
2020-09-27;HR;Croatia;190;3;16197;272
2020-09-28;HR;Croatia;48;0;16245;272
2020-09-29;HR;Croatia;135;3;16380;275
2020-09-30;HR;Croatia;213;5;16593;280
2020-10-01;HR;Croatia;234;4;16827;284
2020-10-02;HR;Croatia;333;7;17160;291
2020-10-03;HR;Croatia;241;2;17401;293
2020-10-04;HR;Croatia;258;5;17659;298
2020-10-05;HR;Croatia;138;2;17797;300
2020-10-06;HR;Croatia;287;4;18084;304
2020-10-07;HR;Croatia;363;5;18447;309
2020-10-08;HR;Croatia;542;1;18989;310
2020-10-09;HR;Croatia;457;3;19446;313
2020-10-10;HR;Croatia;486;4;19932;317
2020-10-11;HR;Croatia;508;7;20440;324
2020-10-12;HR;Croatia;181;3;20621;327
2020-10-13;HR;Croatia;372;3;20993;330
2020-10-14;HR;Croatia;748;4;21741;334
2020-10-15;HR;Croatia;793;10;22534;344
2020-10-16;HR;Croatia;1131;1;23665;345
2020-10-17;HR;Croatia;1096;10;24761;355
2020-10-18;HR;Croatia;819;8;25580;363
2020-10-19;HR;Croatia;393;11;25973;374
2020-10-20;HR;Croatia;890;8;26863;382
2020-10-21;HR;Croatia;1424;11;28287;393
2020-10-22;HR;Croatia;1563;13;29850;406
2020-10-23;HR;Croatia;1867;7;31717;413
2020-10-24;HR;Croatia;2242;16;33959;429
2020-10-25;HR;Croatia;2421;8;36380;437
2020-10-26;HR;Croatia;828;15;37208;452
2020-10-27;HR;Croatia;1413;18;38621;470
2020-10-28;HR;Croatia;2378;23;40999;493
2020-10-29;HR;Croatia;2776;18;43775;511
2020-10-30;HR;Croatia;2772;20;46547;531
2020-10-31;HR;Croatia;2769;15;49316;546
2020-11-01;HR;Croatia;2179;16;51495;562
2020-11-02;HR;Croatia;1165;32;52660;594
2020-11-03;HR;Croatia;1427;34;54087;628
2020-11-04;HR;Croatia;2480;26;56567;654
2020-11-05;HR;Croatia;2848;29;59415;683
2020-11-06;HR;Croatia;2890;34;62305;717
2020-11-07;HR;Croatia;2399;35;64704;752
2020-11-08;HR;Croatia;2543;42;67247;794
2020-11-09;HR;Croatia;1529;38;68776;832
2020-11-10;HR;Croatia;1467;33;70243;865
2020-11-11;HR;Croatia;2597;28;72840;893
2020-11-12;HR;Croatia;3082;32;75922;925
2020-11-13;HR;Croatia;3056;43;78978;968
2020-11-14;HR;Croatia;2866;38;81844;1006
2020-11-15;HR;Croatia;2362;43;84206;1049
2020-11-16;HR;Croatia;1313;33;85519;1082
2020-11-17;HR;Croatia;1945;31;87464;1113
2020-11-18;HR;Croatia;3251;38;90715;1151
2020-11-19;HR;Croatia;3164;49;93879;1200
2020-11-20;HR;Croatia;2958;57;96837;1257
2020-11-21;HR;Croatia;3573;47;100410;1304
2020-11-22;HR;Croatia;3308;49;103718;1353
2020-11-23;HR;Croatia;1973;45;105691;1398
2020-11-24;HR;Croatia;2323;47;108014;1445
2020-11-25;HR;Croatia;3603;56;111617;1501
2020-11-26;HR;Croatia;4009;51;115626;1552
2020-11-27;HR;Croatia;4080;48;119706;1600
2020-11-28;HR;Croatia;3987;55;123693;1655
2020-11-29;HR;Croatia;2919;57;126612;1712
2020-11-30;HR;Croatia;1830;74;128442;1786
2020-12-01;HR;Croatia;2900;75;131342;1861
2020-12-02;HR;Croatia;3539;55;134881;1916
2020-12-03;HR;Croatia;4534;48;139415;1964
2020-12-04;HR;Croatia;3955;68;143370;2032
2020-12-05;HR;Croatia;4084;70;147454;2102
2020-12-06;HR;Croatia;2899;72;150353;2174
2020-12-07;HR;Croatia;1886;59;152239;2233
2020-12-08;HR;Croatia;2613;65;154852;2298
2020-12-09;HR;Croatia;4520;69;159372;2367
2020-12-10;HR;Croatia;4620;53;163992;2420
2020-12-11;HR;Croatia;4396;64;168388;2484
2020-12-12;HR;Croatia;4135;78;172523;2562
2020-12-13;HR;Croatia;3363;78;175886;2640
2020-12-14;HR;Croatia;1472;65;177358;2705
2020-12-15;HR;Croatia;2360;73;179718;2778
2020-12-16;HR;Croatia;3327;92;183045;2870
2020-12-17;HR;Croatia;3918;85;186963;2955
2020-12-18;HR;Croatia;3272;68;190235;3023
2020-12-19;HR;Croatia;2752;78;192987;3101
2020-12-20;HR;Croatia;1975;76;194962;3177
2020-12-21;HR;Croatia;766;80;195728;3257
2020-12-22;HR;Croatia;1595;71;197323;3328
2020-12-23;HR;Croatia;2763;66;200086;3394
2020-12-24;HR;Croatia;2233;70;202319;3464
2020-12-25;HR;Croatia;1643;84;203962;3548
2020-12-26;HR;Croatia;350;65;204312;3613
2020-12-27;HR;Croatia;618;58;204930;3671
2020-12-28;HR;Croatia;316;68;205246;3739
2020-12-29;HR;Croatia;1350;56;206596;3795
2020-12-30;HR;Croatia;1850;65;208446;3860
2020-12-31;HR;Croatia;2391;60;210837;3920
2021-01-01;HR;Croatia;1170;41;212007;3961
2021-01-02;HR;Croatia;255;55;212262;4016
2021-01-03;HR;Croatia;696;56;212958;4072
2021-01-04;HR;Croatia;361;54;213319;4126
2021-01-05;HR;Croatia;1071;53;214390;4179
2021-01-06;HR;Croatia;1896;44;216286;4223
2021-01-07;HR;Croatia;562;43;216848;4266
2021-01-08;HR;Croatia;1098;38;217946;4304
2021-01-09;HR;Croatia;1401;38;219347;4342
2021-01-10;HR;Croatia;646;26;219993;4368
2021-01-11;HR;Croatia;230;35;220223;4403
2021-01-12;HR;Croatia;759;43;220982;4446
2021-01-13;HR;Croatia;1135;26;222117;4472
2021-01-14;HR;Croatia;980;45;223097;4517
2021-01-15;HR;Croatia;715;33;223812;4550
2021-01-16;HR;Croatia;763;38;224575;4588
2021-01-17;HR;Croatia;379;28;224954;4616
2021-01-18;HR;Croatia;174;39;225128;4655
2021-01-19;HR;Croatia;520;29;225648;4684
2021-01-20;HR;Croatia;902;27;226550;4711
2021-01-21;HR;Croatia;776;27;227326;4738
2021-01-22;HR;Croatia;643;32;227969;4770
2021-01-23;HR;Croatia;599;29;228568;4799
2021-01-24;HR;Croatia;352;28;228920;4827
2021-01-25;HR;Croatia;134;32;229054;4859
2021-01-26;HR;Croatia;448;23;229502;4882
2021-01-27;HR;Croatia;857;31;230359;4913
2021-01-28;HR;Croatia;619;30;230978;4943
2021-01-29;HR;Croatia;561;29;231539;4972
2021-01-30;HR;Croatia;551;26;232090;4998
2021-01-31;HR;Croatia;336;29;232426;5027
2021-02-01;HR;Croatia;94;27;232520;5054
2021-02-02;HR;Croatia;387;17;232907;5071
2021-02-03;HR;Croatia;730;17;233637;5088
2021-02-04;HR;Croatia;516;18;234153;5106
2021-02-05;HR;Croatia;549;16;234702;5122
2021-02-06;HR;Croatia;424;22;235126;5144
2021-02-07;HR;Croatia;276;25;235402;5169
2021-02-08;HR;Croatia;71;29;235473;5198
2021-02-09;HR;Croatia;283;26;235756;5224
2021-02-10;HR;Croatia;577;14;236333;5238
2021-02-11;HR;Croatia;376;25;236709;5263
2021-02-12;HR;Croatia;371;19;237080;5282
2021-02-13;HR;Croatia;379;17;237459;5299
2021-02-14;HR;Croatia;198;19;237657;5318
2021-02-15;HR;Croatia;68;21;237725;5339
2021-02-16;HR;Croatia;274;18;237999;5357
2021-02-17;HR;Croatia;502;18;238501;5375
2021-02-18;HR;Croatia;365;24;238866;5399
2021-02-19;HR;Croatia;388;8;239254;5407
2021-02-20;HR;Croatia;431;13;239685;5420
2021-02-21;HR;Croatia;260;9;239945;5429
2021-02-22;HR;Croatia;72;20;240017;5449
2021-02-23;HR;Croatia;343;13;240360;5462
2021-02-24;HR;Croatia;688;15;241048;5477
2021-02-25;HR;Croatia;544;12;241592;5489
2021-02-26;HR;Croatia;505;14;242097;5503
2021-02-27;HR;Croatia;520;8;242617;5511
2021-02-28;HR;Croatia;356;15;242973;5526
2021-03-01;HR;Croatia;91;11;243064;5537
2021-03-02;HR;Croatia;394;11;243458;5548
2021-03-03;HR;Croatia;747;7;244205;5555
2021-03-04;HR;Croatia;667;9;244872;5564
2021-03-05;HR;Croatia;590;6;245462;5570
2021-03-06;HR;Croatia;658;15;246120;5585
2021-03-07;HR;Croatia;394;5;246514;5590
2021-03-08;HR;Croatia;94;19;246608;5609
2021-03-09;HR;Croatia;491;12;247099;5621
2021-03-10;HR;Croatia;962;4;248061;5625
2021-03-11;HR;Croatia;777;10;248838;5635
2021-03-12;HR;Croatia;823;12;249661;5647
2021-03-13;HR;Croatia;823;23;250484;5670
2021-03-14;HR;Croatia;561;7;251045;5677
2021-03-15;HR;Croatia;129;8;251174;5685
2021-03-16;HR;Croatia;691;12;251865;5697
2021-03-17;HR;Croatia;1445;12;253310;5709
2021-03-18;HR;Croatia;1197;17;254507;5726
2021-03-19;HR;Croatia;1112;17;255619;5743
2021-03-20;HR;Croatia;1186;10;256805;5753
2021-03-21;HR;Croatia;834;20;257639;5773
2021-03-22;HR;Croatia;150;13;257789;5786
2021-03-23;HR;Croatia;956;22;258745;5808
2021-03-24;HR;Croatia;1891;20;260636;5828
2021-03-25;HR;Croatia;1673;10;262309;5838
2021-03-26;HR;Croatia;1802;16;264111;5854
2021-03-27;HR;Croatia;1790;18;265901;5872
2021-03-28;HR;Croatia;1321;21;267222;5893
2021-03-29;HR;Croatia;300;18;267522;5911
2021-03-30;HR;Croatia;1487;17;269009;5928
2021-03-31;HR;Croatia;2623;19;271632;5947
2021-04-01;HR;Croatia;2422;20;274054;5967
2021-04-02;HR;Croatia;2362;29;276416;5996
2021-04-03;HR;Croatia;2234;29;278650;6025
2021-04-04;HR;Croatia;1376;33;280026;6058
2021-04-05;HR;Croatia;138;25;280164;6083
2021-04-06;HR;Croatia;735;30;280899;6113
2021-04-07;HR;Croatia;1649;36;282548;6149
2021-04-08;HR;Croatia;3217;36;285765;6185
2021-04-09;HR;Croatia;2599;50;288364;6235
2021-04-10;HR;Croatia;2535;34;290899;6269
2021-04-11;HR;Croatia;1617;39;292516;6308
2021-04-12;HR;Croatia;422;25;292938;6333
2021-04-13;HR;Croatia;1936;25;294874;6358
2021-04-14;HR;Croatia;3099;41;297973;6399
2021-04-15;HR;Croatia;2927;43;300900;6442
2021-04-16;HR;Croatia;2698;44;303598;6486
2021-04-17;HR;Croatia;2627;37;306225;6523
2021-04-18;HR;Croatia;1565;39;307790;6562
2021-04-19;HR;Croatia;410;39;308200;6601
2021-04-20;HR;Croatia;2106;42;310306;6643
2021-04-21;HR;Croatia;3117;49;313423;6692
2021-04-22;HR;Croatia;2885;46;316308;6738
2021-04-23;HR;Croatia;2529;46;318837;6784
2021-04-24;HR;Croatia;2535;31;321372;6815
2021-04-25;HR;Croatia;1254;39;322626;6854
2021-04-26;HR;Croatia;410;51;323036;6905
2021-04-27;HR;Croatia;1797;52;324833;6957
2021-04-28;HR;Croatia;2904;44;327737;7001
2021-04-29;HR;Croatia;2439;39;330176;7040
2021-04-30;HR;Croatia;2007;41;332183;7081
2021-05-01;HR;Croatia;2046;49;334229;7130
2021-05-02;HR;Croatia;944;52;335173;7182
2021-05-03;HR;Croatia;349;36;335522;7218
2021-05-04;HR;Croatia;1396;46;336918;7264
2021-05-05;HR;Croatia;2494;51;339412;7315
2021-05-06;HR;Croatia;1640;40;341052;7355
2021-05-07;HR;Croatia;1435;33;342487;7388
2021-05-08;HR;Croatia;1342;36;343829;7424
2021-05-09;HR;Croatia;665;45;344494;7469
2021-05-10;HR;Croatia;253;34;344747;7503
2021-05-11;HR;Croatia;876;46;345623;7549
2021-05-12;HR;Croatia;1471;40;347094;7589
2021-05-13;HR;Croatia;1064;34;348158;7623
2021-05-14;HR;Croatia;926;41;349084;7664
2021-05-15;HR;Croatia;826;23;349910;7687
2021-05-16;HR;Croatia;480;21;350390;7708
2021-05-17;HR;Croatia;116;30;350506;7738
2021-05-18;HR;Croatia;491;27;350997;7765
2021-05-19;HR;Croatia;1000;27;351997;7792
2021-05-20;HR;Croatia;695;36;352692;7828
2021-05-21;HR;Croatia;525;28;353217;7856
2021-05-22;HR;Croatia;518;27;353735;7883
2021-05-23;HR;Croatia;251;20;353986;7903
2021-05-24;HR;Croatia;74;26;354060;7929
2021-05-25;HR;Croatia;323;21;354383;7950
2021-05-26;HR;Croatia;538;21;354921;7971
2021-05-27;HR;Croatia;375;10;355296;7981
2021-05-28;HR;Croatia;321;11;355617;7992
2021-05-29;HR;Croatia;338;10;355955;8002
2021-05-30;HR;Croatia;186;12;356141;8014
2021-05-31;HR;Croatia;40;12;356181;8026
2021-06-01;HR;Croatia;216;8;356397;8034
2021-06-02;HR;Croatia;432;8;356829;8042
2021-06-03;HR;Croatia;280;14;357109;8056
2021-06-04;HR;Croatia;88;11;357197;8067
2021-06-05;HR;Croatia;211;13;357408;8080
2021-06-06;HR;Croatia;157;6;357565;8086
2021-06-07;HR;Croatia;43;5;357608;8091
2021-06-08;HR;Croatia;178;5;357786;8096
2021-06-09;HR;Croatia;275;7;358061;8103
2021-06-10;HR;Croatia;184;7;358245;8110
2021-06-11;HR;Croatia;134;13;358379;8123
2021-06-12;HR;Croatia;125;9;358504;8132
2021-06-13;HR;Croatia;59;0;358563;8132
2021-06-14;HR;Croatia;18;20;358581;8152
2021-06-15;HR;Croatia;96;8;358677;8160
2021-06-16;HR;Croatia;146;2;358823;8162
2021-06-17;HR;Croatia;95;3;358918;8165
2021-06-18;HR;Croatia;113;3;359031;8168
2021-06-19;HR;Croatia;84;1;359115;8169
2021-06-20;HR;Croatia;58;5;359173;8174
2021-06-21;HR;Croatia;11;8;359184;8182
2021-06-22;HR;Croatia;75;6;359259;8188
2021-06-23;HR;Croatia;43;2;359302;8190
2021-06-24;HR;Croatia;101;2;359403;8192
2021-06-25;HR;Croatia;118;4;359521;8196
2021-06-26;HR;Croatia;86;1;359607;8197
2021-06-27;HR;Croatia;45;3;359652;8200
2021-06-28;HR;Croatia;14;2;359666;8202
2021-06-29;HR;Croatia;70;3;359736;8205
2021-06-30;HR;Croatia;136;1;359872;8206
2021-07-01;HR;Croatia;103;3;359975;8209
2020-03-12;CU;Cuba;3;0;3;0
2020-03-13;CU;Cuba;1;0;4;0
2020-03-14;CU;Cuba;0;0;4;0
2020-03-15;CU;Cuba;0;0;4;0
2020-03-16;CU;Cuba;0;0;4;0
2020-03-17;CU;Cuba;1;0;5;0
2020-03-18;CU;Cuba;2;1;7;1
2020-03-19;CU;Cuba;4;0;11;1
2020-03-20;CU;Cuba;5;0;16;1
2020-03-21;CU;Cuba;5;0;21;1
2020-03-22;CU;Cuba;14;0;35;1
2020-03-23;CU;Cuba;5;0;40;1
2020-03-24;CU;Cuba;8;0;48;1
2020-03-25;CU;Cuba;9;0;57;1
2020-03-26;CU;Cuba;10;1;67;2
2020-03-27;CU;Cuba;13;0;80;2
2020-03-28;CU;Cuba;39;1;119;3
2020-03-29;CU;Cuba;20;0;139;3
2020-03-30;CU;Cuba;31;1;170;4
2020-03-31;CU;Cuba;16;2;186;6
2020-04-01;CU;Cuba;26;0;212;6
2020-04-02;CU;Cuba;21;0;233;6
2020-04-03;CU;Cuba;36;0;269;6
2020-04-04;CU;Cuba;19;0;288;6
2020-04-05;CU;Cuba;32;2;320;8
2020-04-06;CU;Cuba;30;1;350;9
2020-04-07;CU;Cuba;46;2;396;11
2020-04-08;CU;Cuba;61;1;457;12
2020-04-09;CU;Cuba;58;3;515;15
2020-04-10;CU;Cuba;49;0;564;15
2020-04-11;CU;Cuba;56;1;620;16
2020-04-12;CU;Cuba;49;2;669;18
2020-04-13;CU;Cuba;57;3;726;21
2020-04-14;CU;Cuba;40;0;766;21
2020-04-15;CU;Cuba;48;3;814;24
2020-04-16;CU;Cuba;48;3;862;27
2020-04-17;CU;Cuba;61;4;923;31
2020-04-18;CU;Cuba;63;1;986;32
2020-04-19;CU;Cuba;49;2;1035;34
2020-04-20;CU;Cuba;52;2;1087;36
2020-04-21;CU;Cuba;50;2;1137;38
2020-04-22;CU;Cuba;52;2;1189;40
2020-04-23;CU;Cuba;46;3;1235;43
2020-04-24;CU;Cuba;50;6;1285;49
2020-04-25;CU;Cuba;52;2;1337;51
2020-04-26;CU;Cuba;32;3;1369;54
2020-04-27;CU;Cuba;20;2;1389;56
2020-04-28;CU;Cuba;48;2;1437;58
2020-04-29;CU;Cuba;30;0;1467;58
2020-04-30;CU;Cuba;34;3;1501;61
2020-05-01;CU;Cuba;36;3;1537;64
2020-05-02;CU;Cuba;74;2;1611;66
2020-05-03;CU;Cuba;38;1;1649;67
2020-05-04;CU;Cuba;19;2;1668;69
2020-05-05;CU;Cuba;17;0;1685;69
2020-05-06;CU;Cuba;18;0;1703;69
2020-05-07;CU;Cuba;26;4;1729;73
2020-05-08;CU;Cuba;12;1;1741;74
2020-05-09;CU;Cuba;13;0;1754;74
2020-05-10;CU;Cuba;12;3;1766;77
2020-05-11;CU;Cuba;17;0;1783;77
2020-05-12;CU;Cuba;21;1;1804;78
2020-05-13;CU;Cuba;6;1;1810;79
2020-05-14;CU;Cuba;20;0;1830;79
2020-05-15;CU;Cuba;10;0;1840;79
2020-05-16;CU;Cuba;22;0;1862;79
2020-05-17;CU;Cuba;10;0;1872;79
2020-05-18;CU;Cuba;9;0;1881;79
2020-05-19;CU;Cuba;6;0;1887;79
2020-05-20;CU;Cuba;13;0;1900;79
2020-05-21;CU;Cuba;8;1;1908;80
2020-05-22;CU;Cuba;8;1;1916;81
2020-05-23;CU;Cuba;15;0;1931;81
2020-05-24;CU;Cuba;10;1;1941;82
2020-05-25;CU;Cuba;6;0;1947;82
2020-05-26;CU;Cuba;16;0;1963;82
2020-05-27;CU;Cuba;11;0;1974;82
2020-05-28;CU;Cuba;9;0;1983;82
2020-05-29;CU;Cuba;22;0;2005;82
2020-05-30;CU;Cuba;20;1;2025;83
2020-05-31;CU;Cuba;20;0;2045;83
2020-06-01;CU;Cuba;38;0;2083;83
2020-06-02;CU;Cuba;9;0;2092;83
2020-06-03;CU;Cuba;15;0;2107;83
2020-06-04;CU;Cuba;12;0;2119;83
2020-06-05;CU;Cuba;14;0;2133;83
2020-06-06;CU;Cuba;40;0;2173;83
2020-06-07;CU;Cuba;18;0;2191;83
2020-06-08;CU;Cuba;9;0;2200;83
2020-06-09;CU;Cuba;5;0;2205;83
2020-06-10;CU;Cuba;6;0;2211;83
2020-06-11;CU;Cuba;8;1;2219;84
2020-06-12;CU;Cuba;14;0;2233;84
2020-06-13;CU;Cuba;5;0;2238;84
2020-06-14;CU;Cuba;10;0;2248;84
2020-06-15;CU;Cuba;14;0;2262;84
2020-06-16;CU;Cuba;11;0;2273;84
2020-06-17;CU;Cuba;7;0;2280;84
2020-06-18;CU;Cuba;15;1;2295;85
2020-06-19;CU;Cuba;10;0;2305;85
2020-06-20;CU;Cuba;4;0;2309;85
2020-06-21;CU;Cuba;3;0;2312;85
2020-06-22;CU;Cuba;3;0;2315;85
2020-06-23;CU;Cuba;3;0;2318;85
2020-06-24;CU;Cuba;1;0;2319;85
2020-06-25;CU;Cuba;2;0;2321;85
2020-06-26;CU;Cuba;4;0;2325;85
2020-06-27;CU;Cuba;5;1;2330;86
2020-06-28;CU;Cuba;2;0;2332;86
2020-06-29;CU;Cuba;8;0;2340;86
2020-06-30;CU;Cuba;1;0;2341;86
2020-07-01;CU;Cuba;7;0;2348;86
2020-07-02;CU;Cuba;5;0;2353;86
2020-07-03;CU;Cuba;8;0;2361;86
2020-07-04;CU;Cuba;8;0;2369;86
2020-07-05;CU;Cuba;3;0;2372;86
2020-07-06;CU;Cuba;8;0;2380;86
2020-07-07;CU;Cuba;15;0;2395;86
2020-07-08;CU;Cuba;4;0;2399;86
2020-07-09;CU;Cuba;4;0;2403;86
2020-07-10;CU;Cuba;10;0;2413;86
2020-07-11;CU;Cuba;7;1;2420;87
2020-07-12;CU;Cuba;6;0;2426;87
2020-07-13;CU;Cuba;2;0;2428;87
2020-07-14;CU;Cuba;4;0;2432;87
2020-07-15;CU;Cuba;6;0;2438;87
2020-07-16;CU;Cuba;2;0;2440;87
2020-07-17;CU;Cuba;4;0;2444;87
2020-07-18;CU;Cuba;1;0;2445;87
2020-07-19;CU;Cuba;1;0;2446;87
2020-07-20;CU;Cuba;0;0;2446;87
2020-07-21;CU;Cuba;3;0;2449;87
2020-07-22;CU;Cuba;13;0;2462;87
2020-07-23;CU;Cuba;4;0;2466;87
2020-07-24;CU;Cuba;3;0;2469;87
2020-07-25;CU;Cuba;9;0;2478;87
2020-07-26;CU;Cuba;17;0;2495;87
2020-07-27;CU;Cuba;37;0;2532;87
2020-07-28;CU;Cuba;23;0;2555;87
2020-07-29;CU;Cuba;33;0;2588;87
2020-07-30;CU;Cuba;9;0;2597;87
2020-07-31;CU;Cuba;11;0;2608;87
2020-08-01;CU;Cuba;25;0;2633;87
2020-08-02;CU;Cuba;13;0;2646;87
2020-08-03;CU;Cuba;24;0;2670;87
2020-08-04;CU;Cuba;31;1;2701;88
2020-08-05;CU;Cuba;25;0;2726;88
2020-08-06;CU;Cuba;49;0;2775;88
2020-08-07;CU;Cuba;54;0;2829;88
2020-08-08;CU;Cuba;59;0;2888;88
2020-08-09;CU;Cuba;65;0;2953;88
2020-08-10;CU;Cuba;93;0;3046;88
2020-08-11;CU;Cuba;47;0;3093;88
2020-08-12;CU;Cuba;35;0;3128;88
2020-08-13;CU;Cuba;46;1;3174;89
2020-08-14;CU;Cuba;55;-1;3229;88
2020-08-15;CU;Cuba;63;0;3292;88
2020-08-16;CU;Cuba;24;0;3316;88
2020-08-17;CU;Cuba;48;0;3364;88
2020-08-18;CU;Cuba;44;0;3408;88
2020-08-19;CU;Cuba;74;0;3482;88
2020-08-20;CU;Cuba;83;0;3565;88
2020-08-21;CU;Cuba;17;1;3582;89
2020-08-22;CU;Cuba;35;0;3617;89
2020-08-23;CU;Cuba;65;2;3682;91
2020-08-24;CU;Cuba;35;0;3717;91
2020-08-25;CU;Cuba;27;0;3744;91
2020-08-26;CU;Cuba;15;1;3759;92
2020-08-27;CU;Cuba;47;0;3806;92
2020-08-28;CU;Cuba;60;0;3866;92
2020-08-29;CU;Cuba;59;2;3925;94
2020-08-30;CU;Cuba;48;0;3973;94
2020-08-31;CU;Cuba;59;0;4032;94
2020-09-01;CU;Cuba;33;1;4065;95
2020-09-02;CU;Cuba;61;3;4126;98
2020-09-03;CU;Cuba;88;2;4214;100
2020-09-04;CU;Cuba;52;0;4266;100
2020-09-05;CU;Cuba;32;0;4298;100
2020-09-06;CU;Cuba;11;1;4309;101
2020-09-07;CU;Cuba;43;1;4352;102
2020-09-08;CU;Cuba;25;2;4377;104
2020-09-09;CU;Cuba;82;0;4459;104
2020-09-10;CU;Cuba;92;2;4551;106
2020-09-11;CU;Cuba;42;0;4593;106
2020-09-12;CU;Cuba;60;2;4653;108
2020-09-13;CU;Cuba;31;0;4684;108
2020-09-14;CU;Cuba;42;0;4726;108
2020-09-15;CU;Cuba;77;0;4803;108
2020-09-16;CU;Cuba;73;1;4876;109
2020-09-17;CU;Cuba;57;0;4933;109
2020-09-18;CU;Cuba;71;2;5004;111
2020-09-19;CU;Cuba;51;2;5055;113
2020-09-20;CU;Cuba;36;2;5091;115
2020-09-21;CU;Cuba;50;1;5141;116
2020-09-22;CU;Cuba;81;1;5222;117
2020-09-23;CU;Cuba;48;1;5270;118
2020-09-24;CU;Cuba;40;0;5310;118
2020-09-25;CU;Cuba;40;0;5350;118
2020-09-26;CU;Cuba;62;2;5412;120
2020-09-27;CU;Cuba;45;2;5457;122
2020-09-28;CU;Cuba;26;0;5483;122
2020-09-29;CU;Cuba;48;0;5531;122
2020-09-30;CU;Cuba;66;0;5597;122
2020-10-01;CU;Cuba;73;0;5670;122
2020-10-02;CU;Cuba;48;0;5718;122
2020-10-03;CU;Cuba;62;0;5780;122
2020-10-04;CU;Cuba;29;0;5809;122
2020-10-05;CU;Cuba;36;1;5845;123
2020-10-06;CU;Cuba;38;0;5883;123
2020-10-07;CU;Cuba;15;0;5898;123
2020-10-08;CU;Cuba;19;0;5917;123
2020-10-09;CU;Cuba;26;0;5943;123
2020-10-10;CU;Cuba;5;0;5948;123
2020-10-11;CU;Cuba;30;0;5978;123
2020-10-12;CU;Cuba;22;0;6000;123
2020-10-13;CU;Cuba;17;0;6017;123
2020-10-14;CU;Cuba;18;0;6035;123
2020-10-15;CU;Cuba;27;0;6062;123
2020-10-16;CU;Cuba;56;1;6118;124
2020-10-17;CU;Cuba;52;1;6170;125
2020-10-18;CU;Cuba;50;0;6220;125
2020-10-19;CU;Cuba;38;2;6258;127
2020-10-20;CU;Cuba;47;0;6305;127
2020-10-21;CU;Cuba;63;0;6368;127
2020-10-22;CU;Cuba;53;1;6421;128
2020-10-23;CU;Cuba;58;0;6479;128
2020-10-24;CU;Cuba;55;0;6534;128
2020-10-25;CU;Cuba;32;0;6566;128
2020-10-26;CU;Cuba;29;0;6595;128
2020-10-27;CU;Cuba;83;0;6678;128
2020-10-28;CU;Cuba;49;0;6727;128
2020-10-29;CU;Cuba;39;0;6766;128
2020-10-30;CU;Cuba;35;0;6801;128
2020-10-31;CU;Cuba;86;0;6887;128
2020-11-01;CU;Cuba;48;0;6935;128
2020-11-02;CU;Cuba;35;1;6970;129
2020-11-03;CU;Cuba;65;0;7035;129
2020-11-04;CU;Cuba;109;0;7144;129
2020-11-05;CU;Cuba;40;0;7184;129
2020-11-06;CU;Cuba;44;1;7228;130
2020-11-07;CU;Cuba;39;0;7267;130
2020-11-08;CU;Cuba;30;0;7297;130
2020-11-09;CU;Cuba;52;0;7349;130
2020-11-10;CU;Cuba;43;0;7392;130
2020-11-11;CU;Cuba;37;0;7429;130
2020-11-12;CU;Cuba;58;1;7487;131
2020-11-13;CU;Cuba;54;0;7541;131
2020-11-14;CU;Cuba;27;0;7568;131
2020-11-15;CU;Cuba;22;0;7590;131
2020-11-16;CU;Cuba;49;0;7639;131
2020-11-17;CU;Cuba;28;0;7667;131
2020-11-18;CU;Cuba;37;0;7704;131
2020-11-19;CU;Cuba;21;0;7725;131
2020-11-20;CU;Cuba;38;0;7763;131
2020-11-21;CU;Cuba;35;1;7798;132
2020-11-22;CU;Cuba;48;0;7846;132
2020-11-23;CU;Cuba;33;0;7879;132
2020-11-24;CU;Cuba;71;1;7950;133
2020-11-25;CU;Cuba;76;0;8026;133
2020-11-26;CU;Cuba;49;0;8075;133
2020-11-27;CU;Cuba;35;0;8110;133
2020-11-28;CU;Cuba;63;0;8173;133
2020-11-29;CU;Cuba;60;1;8233;134
2020-11-30;CU;Cuba;51;1;8284;135
2020-12-01;CU;Cuba;97;1;8381;136
2020-12-02;CU;Cuba;75;0;8456;136
2020-12-03;CU;Cuba;75;0;8531;136
2020-12-04;CU;Cuba;79;0;8610;136
2020-12-05;CU;Cuba;104;0;8714;136
2020-12-06;CU;Cuba;68;0;8782;136
2020-12-07;CU;Cuba;124;0;8906;136
2020-12-08;CU;Cuba;76;0;8982;136
2020-12-09;CU;Cuba;124;0;9106;136
2020-12-10;CU;Cuba;75;0;9181;136
2020-12-11;CU;Cuba;86;0;9267;136
2020-12-12;CU;Cuba;87;1;9354;137
2020-12-13;CU;Cuba;69;0;9423;137
2020-12-14;CU;Cuba;69;0;9492;137
2020-12-15;CU;Cuba;96;0;9588;137
2020-12-16;CU;Cuba;83;0;9671;137
2020-12-17;CU;Cuba;100;0;9771;137
2020-12-18;CU;Cuba;122;0;9893;137
2020-12-19;CU;Cuba;131;0;10024;137
2020-12-20;CU;Cuba;103;0;10127;137
2020-12-21;CU;Cuba;115;0;10242;137
2020-12-22;CU;Cuba;142;2;10384;139
2020-12-23;CU;Cuba;116;0;10500;139
2020-12-24;CU;Cuba;217;0;10717;139
2020-12-25;CU;Cuba;183;1;10900;140
2020-12-26;CU;Cuba;138;1;11038;141
2020-12-27;CU;Cuba;167;1;11205;142
2020-12-28;CU;Cuba;229;1;11434;143
2020-12-29;CU;Cuba;167;0;11601;143
2020-12-30;CU;Cuba;86;2;11687;145
2020-12-31;CU;Cuba;176;1;11863;146
2021-01-01;CU;Cuba;193;0;12056;146
2021-01-02;CU;Cuba;169;0;12225;146
2021-01-03;CU;Cuba;199;1;12424;147
2021-01-04;CU;Cuba;316;0;12740;147
2021-01-05;CU;Cuba;224;0;12964;147
2021-01-06;CU;Cuba;201;1;13165;148
2021-01-07;CU;Cuba;314;0;13479;148
2021-01-08;CU;Cuba;344;0;13823;148
2021-01-09;CU;Cuba;365;0;14188;148
2021-01-10;CU;Cuba;388;3;14576;151
2021-01-11;CU;Cuba;431;2;15007;153
2021-01-12;CU;Cuba;487;2;15494;155
2021-01-13;CU;Cuba;550;3;16044;158
2021-01-14;CU;Cuba;505;2;16549;160
2021-01-15;CU;Cuba;547;2;17096;162
2021-01-16;CU;Cuba;405;4;17501;166
2021-01-17;CU;Cuba;650;4;18151;170
2021-01-18;CU;Cuba;292;3;18443;173
2021-01-19;CU;Cuba;330;2;18773;175
2021-01-20;CU;Cuba;349;5;19122;180
2021-01-21;CU;Cuba;408;4;19530;184
2021-01-22;CU;Cuba;530;4;20060;188
2021-01-23;CU;Cuba;567;3;20627;191
2021-01-24;CU;Cuba;634;3;21261;194
2021-01-25;CU;Cuba;567;3;21828;197
2021-01-26;CU;Cuba;786;3;22614;200
2021-01-27;CU;Cuba;825;4;23439;204
2021-01-28;CU;Cuba;666;4;24105;208
2021-01-29;CU;Cuba;659;2;24764;210
2021-01-30;CU;Cuba;910;3;25674;213
2021-01-31;CU;Cuba;1012;1;26686;214
2021-02-01;CU;Cuba;906;2;27592;216
2021-02-02;CU;Cuba;1044;2;28636;218
2021-02-03;CU;Cuba;893;2;29529;220
2021-02-04;CU;Cuba;816;5;30345;225
2021-02-05;CU;Cuba;845;4;31190;229
2021-02-06;CU;Cuba;821;4;32011;233
2021-02-07;CU;Cuba;820;5;32831;238
2021-02-08;CU;Cuba;653;2;33484;240
2021-02-09;CU;Cuba;580;4;34064;244
2021-02-10;CU;Cuba;858;5;34922;249
2021-02-11;CU;Cuba;850;4;35772;253
2021-02-12;CU;Cuba;823;4;36595;257
2021-02-13;CU;Cuba;888;4;37483;261
2021-02-14;CU;Cuba;806;5;38289;266
2021-02-15;CU;Cuba;715;3;39004;269
2021-02-16;CU;Cuba;937;5;39941;274
2021-02-17;CU;Cuba;824;3;40765;277
2021-02-18;CU;Cuba;923;5;41688;282
2021-02-19;CU;Cuba;859;5;42547;287
2021-02-20;CU;Cuba;937;4;43484;291
2021-02-21;CU;Cuba;1039;5;44523;296
2021-02-22;CU;Cuba;838;4;45361;300
2021-02-23;CU;Cuba;836;4;46197;304
2021-02-24;CU;Cuba;699;4;46896;308
2021-02-25;CU;Cuba;670;4;47566;312
2021-02-26;CU;Cuba;875;2;48441;314
2021-02-27;CU;Cuba;720;4;49161;318
2021-02-28;CU;Cuba;618;4;49779;322
2021-03-01;CU;Cuba;811;2;50590;324
2021-03-02;CU;Cuba;997;4;51587;328
2021-03-03;CU;Cuba;914;5;52501;333
2021-03-04;CU;Cuba;807;3;53308;336
2021-03-05;CU;Cuba;777;5;54085;341
2021-03-06;CU;Cuba;750;3;54835;344
2021-03-07;CU;Cuba;858;4;55693;348
2021-03-08;CU;Cuba;873;2;56566;350
2021-03-09;CU;Cuba;1041;2;57607;352
2021-03-10;CU;Cuba;772;5;58379;357
2021-03-11;CU;Cuba;778;4;59157;361
2021-03-12;CU;Cuba;762;4;59919;365
2021-03-13;CU;Cuba;639;1;60558;366
2021-03-14;CU;Cuba;914;4;61472;370
2021-03-15;CU;Cuba;734;3;62206;373
2021-03-16;CU;Cuba;792;3;62998;376
2021-03-17;CU;Cuba;727;4;63725;380
2021-03-18;CU;Cuba;689;4;64414;384
2021-03-19;CU;Cuba;735;3;65149;387
2021-03-20;CU;Cuba;813;5;65962;392
2021-03-21;CU;Cuba;796;2;66758;394
2021-03-22;CU;Cuba;718;3;67476;397
2021-03-23;CU;Cuba;774;4;68250;401
2021-03-24;CU;Cuba;736;4;68986;405
2021-03-25;CU;Cuba;816;3;69802;408
2021-03-26;CU;Cuba;832;5;70634;413
2021-03-27;CU;Cuba;950;1;71584;414
2021-03-28;CU;Cuba;919;1;72503;415
2021-03-29;CU;Cuba;701;2;73204;417
2021-03-30;CU;Cuba;1008;4;74212;421
2021-03-31;CU;Cuba;1051;3;75263;424
2021-04-01;CU;Cuba;1013;1;76276;425
2021-04-02;CU;Cuba;1077;4;77353;429
2021-04-03;CU;Cuba;1029;2;78382;431
2021-04-04;CU;Cuba;1162;5;79544;436
2021-04-05;CU;Cuba;1066;0;80610;436
2021-04-06;CU;Cuba;1030;4;81640;440
2021-04-07;CU;Cuba;961;2;82601;442
2021-04-08;CU;Cuba;914;1;83515;443
2021-04-09;CU;Cuba;1017;5;84532;448
2021-04-10;CU;Cuba;1040;5;85572;453
2021-04-11;CU;Cuba;959;6;86531;459
2021-04-12;CU;Cuba;854;8;87385;467
2021-04-13;CU;Cuba;1060;9;88445;476
2021-04-14;CU;Cuba;959;11;89404;487
2021-04-15;CU;Cuba;1004;4;90408;491
2021-04-16;CU;Cuba;1040;9;91448;500
2021-04-17;CU;Cuba;1026;12;92474;512
2021-04-18;CU;Cuba;1037;13;93511;525
2021-04-19;CU;Cuba;1060;6;94571;531
2021-04-20;CU;Cuba;1183;7;95754;538
2021-04-21;CU;Cuba;1006;9;96760;547
2021-04-22;CU;Cuba;1207;12;97967;559
2021-04-23;CU;Cuba;1241;10;99208;569
2021-04-24;CU;Cuba;1110;12;100318;581
2021-04-25;CU;Cuba;1185;10;101503;591
2021-04-26;CU;Cuba;938;6;102441;597
2021-04-27;CU;Cuba;1083;7;103524;604
2021-04-28;CU;Cuba;988;10;104512;614
2021-04-29;CU;Cuba;1149;18;105661;632
2021-04-30;CU;Cuba;1046;12;106707;644
2021-05-01;CU;Cuba;915;10;107622;654
2021-05-02;CU;Cuba;1071;10;108693;664
2021-05-03;CU;Cuba;932;11;109625;675
2021-05-04;CU;Cuba;1019;11;110644;686
2021-05-05;CU;Cuba;1010;8;111654;694
2021-05-06;CU;Cuba;1060;7;112714;701
2021-05-07;CU;Cuba;1162;12;113876;713
2021-05-08;CU;Cuba;1036;9;114912;722
2021-05-09;CU;Cuba;1069;10;115981;732
2021-05-10;CU;Cuba;1116;9;117097;741
2021-05-11;CU;Cuba;1071;14;118168;755
2021-05-12;CU;Cuba;1207;13;119375;768
2021-05-13;CU;Cuba;1186;10;120561;778
2021-05-14;CU;Cuba;1277;7;121838;785
2021-05-15;CU;Cuba;1383;11;123221;796
2021-05-16;CU;Cuba;1233;8;124454;804
2021-05-17;CU;Cuba;1057;10;125511;814
2021-05-18;CU;Cuba;1244;12;126755;826
2021-05-19;CU;Cuba;1339;8;128094;834
2021-05-20;CU;Cuba;1252;6;129346;840
2021-05-21;CU;Cuba;1197;9;130543;849
2021-05-22;CU;Cuba;1289;14;131832;863
2021-05-23;CU;Cuba;1221;14;133053;877
2021-05-24;CU;Cuba;1155;13;134208;890
2021-05-25;CU;Cuba;1291;11;135499;901
2021-05-26;CU;Cuba;1129;11;136628;912
2021-05-27;CU;Cuba;1102;9;137730;921
2021-05-28;CU;Cuba;1169;12;138899;933
2021-05-29;CU;Cuba;1188;10;140087;943
2021-05-30;CU;Cuba;1079;7;141166;950
2021-05-31;CU;Cuba;1100;8;142266;958
2021-06-01;CU;Cuba;1057;7;143323;965
2021-06-02;CU;Cuba;1191;12;144514;977
2021-06-03;CU;Cuba;1053;8;145567;985
2021-06-04;CU;Cuba;1129;7;146696;992
2021-06-05;CU;Cuba;1135;11;147831;1003
2021-06-06;CU;Cuba;1087;9;148918;1012
2021-06-07;CU;Cuba;1185;13;150103;1025
2021-06-08;CU;Cuba;1156;8;151259;1033
2021-06-09;CU;Cuba;1161;12;152420;1045
2021-06-10;CU;Cuba;1158;12;153578;1057
2021-06-11;CU;Cuba;1288;8;154866;1065
2021-06-12;CU;Cuba;1372;10;156238;1075
2021-06-13;CU;Cuba;1470;12;157708;1087
2021-06-14;CU;Cuba;1349;11;159057;1098
2021-06-15;CU;Cuba;1537;8;160594;1106
2021-06-16;CU;Cuba;1403;12;161997;1118
2021-06-17;CU;Cuba;1418;5;163415;1123
2021-06-18;CU;Cuba;1481;9;164896;1132
2021-06-19;CU;Cuba;1472;16;166368;1148
2021-06-20;CU;Cuba;1436;11;167804;1159
2021-06-21;CU;Cuba;1561;11;169365;1170
2021-06-22;CU;Cuba;1489;10;170854;1180
2021-06-23;CU;Cuba;2055;13;172909;1193
2021-06-24;CU;Cuba;1880;16;174789;1209
2021-06-25;CU;Cuba;2464;10;177253;1219
2021-06-26;CU;Cuba;2403;12;179656;1231
2021-06-27;CU;Cuba;2698;10;182354;1241
2021-06-28;CU;Cuba;2589;12;184943;1253
2021-06-29;CU;Cuba;3080;17;188023;1270
2021-06-30;CU;Cuba;2970;14;190993;1284
2021-07-01;CU;Cuba;2952;18;193945;1302
2021-03-29;CW;Curacao;0;0;0;0
2021-03-30;CW;Curacao;0;0;0;0
2021-03-31;CW;Curacao;0;0;0;0
2021-04-01;CW;Curacao;0;0;0;0
2021-04-02;CW;Curacao;0;0;0;0
2021-04-03;CW;Curacao;0;0;0;0
2021-04-04;CW;Curacao;0;0;0;0
2021-04-05;CW;Curacao;0;0;0;0
2021-04-06;CW;Curacao;0;0;0;0
2021-04-07;CW;Curacao;0;0;0;0
2021-04-08;CW;Curacao;0;0;0;0
2021-04-09;CW;Curacao;0;0;0;0
2021-04-10;CW;Curacao;0;0;0;0
2021-04-11;CW;Curacao;0;0;0;0
2021-04-12;CW;Curacao;0;0;0;0
2021-04-13;CW;Curacao;0;0;0;0
2021-04-14;CW;Curacao;0;0;0;0
2021-04-15;CW;Curacao;0;0;0;0
2021-04-16;CW;Curacao;0;0;0;0
2021-04-17;CW;Curacao;0;0;0;0
2021-04-18;CW;Curacao;0;0;0;0
2021-04-19;CW;Curacao;0;0;0;0
2021-04-20;CW;Curacao;0;0;0;0
2021-04-21;CW;Curacao;0;0;0;0
2021-04-22;CW;Curacao;0;0;0;0
2021-04-23;CW;Curacao;0;0;0;0
2021-04-24;CW;Curacao;0;0;0;0
2021-04-25;CW;Curacao;0;0;0;0
2021-04-26;CW;Curacao;0;0;0;0
2021-04-27;CW;Curacao;0;0;0;0
2021-04-28;CW;Curacao;0;0;0;0
2021-04-29;CW;Curacao;0;0;0;0
2021-04-30;CW;Curacao;0;0;0;0
2021-05-01;CW;Curacao;0;0;0;0
2021-05-02;CW;Curacao;0;0;0;0
2021-05-03;CW;Curacao;0;0;0;0
2021-05-04;CW;Curacao;0;0;0;0
2021-05-05;CW;Curacao;0;0;0;0
2021-05-06;CW;Curacao;0;0;0;0
2021-05-07;CW;Curacao;0;0;0;0
2021-05-08;CW;Curacao;0;0;0;0
2021-05-09;CW;Curacao;0;0;0;0
2021-05-10;CW;Curacao;0;0;0;0
2021-05-11;CW;Curacao;0;0;0;0
2021-05-12;CW;Curacao;0;0;0;0
2021-05-13;CW;Curacao;0;0;0;0
2021-05-14;CW;Curacao;0;0;0;0
2021-05-15;CW;Curacao;0;0;0;0
2021-05-16;CW;Curacao;0;0;0;0
2021-05-17;CW;Curacao;0;0;0;0
2021-05-18;CW;Curacao;0;0;0;0
2021-05-19;CW;Curacao;0;0;0;0
2021-05-20;CW;Curacao;0;0;0;0
2021-05-21;CW;Curacao;0;0;0;0
2021-05-22;CW;Curacao;0;0;0;0
2021-05-23;CW;Curacao;0;0;0;0
2021-05-24;CW;Curacao;0;0;0;0
2021-05-25;CW;Curacao;0;0;0;0
2021-05-26;CW;Curacao;0;0;0;0
2021-05-27;CW;Curacao;0;0;0;0
2021-05-28;CW;Curacao;0;0;0;0
2021-05-29;CW;Curacao;0;0;0;0
2021-05-30;CW;Curacao;0;0;0;0
2021-05-31;CW;Curacao;0;0;0;0
2021-06-01;CW;Curacao;0;0;0;0
2021-06-02;CW;Curacao;0;0;0;0
2021-06-03;CW;Curacao;0;0;0;0
2021-06-04;CW;Curacao;0;0;0;0
2021-06-05;CW;Curacao;0;0;0;0
2021-06-06;CW;Curacao;0;0;0;0
2021-06-07;CW;Curacao;0;0;0;0
2021-06-08;CW;Curacao;0;0;0;0
2021-06-09;CW;Curacao;0;0;0;0
2021-06-10;CW;Curacao;0;0;0;0
2021-06-11;CW;Curacao;0;0;0;0
2021-06-12;CW;Curacao;0;0;0;0
2021-06-13;CW;Curacao;0;0;0;0
2021-06-14;CW;Curacao;0;0;0;0
2021-06-15;CW;Curacao;0;0;0;0
2021-06-16;CW;Curacao;0;0;0;0
2021-06-17;CW;Curacao;0;0;0;0
2021-06-18;CW;Curacao;0;0;0;0
2021-06-19;CW;Curacao;0;0;0;0
2021-06-20;CW;Curacao;0;0;0;0
2021-06-21;CW;Curacao;0;0;0;0
2021-06-22;CW;Curacao;0;0;0;0
2021-06-23;CW;Curacao;0;0;0;0
2021-06-24;CW;Curacao;0;0;0;0
2021-06-25;CW;Curacao;0;0;0;0
2021-06-26;CW;Curacao;0;0;0;0
2021-06-27;CW;Curacao;0;0;0;0
2021-06-28;CW;Curacao;0;0;0;0
2021-06-29;CW;Curacao;0;0;0;0
2021-06-30;CW;Curacao;0;0;0;0
2021-07-01;CW;Curacao;0;0;0;0
2020-03-09;CY;Cyprus;2;0;2;0
2020-03-10;CY;Cyprus;1;0;3;0
2020-03-11;CY;Cyprus;3;0;6;0
2020-03-12;CY;Cyprus;0;0;6;0
2020-03-13;CY;Cyprus;8;0;14;0
2020-03-14;CY;Cyprus;12;0;26;0
2020-03-15;CY;Cyprus;0;0;26;0
2020-03-16;CY;Cyprus;7;0;33;0
2020-03-17;CY;Cyprus;13;0;46;0
2020-03-18;CY;Cyprus;3;0;49;0
2020-03-19;CY;Cyprus;18;0;67;0
2020-03-20;CY;Cyprus;0;0;67;0
2020-03-21;CY;Cyprus;17;0;84;0
2020-03-22;CY;Cyprus;11;1;95;1
2020-03-23;CY;Cyprus;21;0;116;1
2020-03-24;CY;Cyprus;8;2;124;3
2020-03-25;CY;Cyprus;8;0;132;3
2020-03-26;CY;Cyprus;14;0;146;3
2020-03-27;CY;Cyprus;16;2;162;5
2020-03-28;CY;Cyprus;17;0;179;5
2020-03-29;CY;Cyprus;35;0;214;5
2020-03-30;CY;Cyprus;16;2;230;7
2020-03-31;CY;Cyprus;32;1;262;8
2020-04-01;CY;Cyprus;58;1;320;9
2020-04-02;CY;Cyprus;36;1;356;10
2020-04-03;CY;Cyprus;40;1;396;11
2020-04-04;CY;Cyprus;30;0;426;11
2020-04-05;CY;Cyprus;20;-2;446;9
2020-04-06;CY;Cyprus;19;0;465;9
2020-04-07;CY;Cyprus;29;0;494;9
2020-04-08;CY;Cyprus;32;0;526;9
2020-04-09;CY;Cyprus;38;1;564;10
2020-04-10;CY;Cyprus;31;0;595;10
2020-04-11;CY;Cyprus;21;0;616;10
2020-04-12;CY;Cyprus;17;1;633;11
2020-04-13;CY;Cyprus;29;1;662;12
2020-04-14;CY;Cyprus;33;0;695;12
2020-04-15;CY;Cyprus;20;0;715;12
2020-04-16;CY;Cyprus;20;0;735;12
2020-04-17;CY;Cyprus;15;0;750;12
2020-04-18;CY;Cyprus;11;0;761;12
2020-04-19;CY;Cyprus;6;0;767;12
2020-04-20;CY;Cyprus;5;0;772;12
2020-04-21;CY;Cyprus;12;0;784;12
2020-04-22;CY;Cyprus;6;1;790;13
2020-04-23;CY;Cyprus;5;0;795;13
2020-04-24;CY;Cyprus;9;1;804;14
2020-04-25;CY;Cyprus;6;0;810;14
2020-04-26;CY;Cyprus;7;0;817;14
2020-04-27;CY;Cyprus;5;1;822;15
2020-04-28;CY;Cyprus;15;0;837;15
2020-04-29;CY;Cyprus;6;0;843;15
2020-04-30;CY;Cyprus;7;0;850;15
2020-05-01;CY;Cyprus;7;0;857;15
2020-05-02;CY;Cyprus;7;0;864;15
2020-05-03;CY;Cyprus;8;0;872;15
2020-05-04;CY;Cyprus;2;0;874;15
2020-05-05;CY;Cyprus;4;0;878;15
2020-05-06;CY;Cyprus;5;0;883;15
2020-05-07;CY;Cyprus;6;0;889;15
2020-05-08;CY;Cyprus;2;0;891;15
2020-05-09;CY;Cyprus;1;0;892;15
2020-05-10;CY;Cyprus;6;1;898;16
2020-05-11;CY;Cyprus;3;0;901;16
2020-05-12;CY;Cyprus;2;0;903;16
2020-05-13;CY;Cyprus;2;1;905;17
2020-05-14;CY;Cyprus;2;0;907;17
2020-05-15;CY;Cyprus;3;0;910;17
2020-05-16;CY;Cyprus;4;0;914;17
2020-05-17;CY;Cyprus;2;0;916;17
2020-05-18;CY;Cyprus;1;0;917;17
2020-05-19;CY;Cyprus;1;0;918;17
2020-05-20;CY;Cyprus;4;0;922;17
2020-05-21;CY;Cyprus;1;0;923;17
2020-05-22;CY;Cyprus;4;0;927;17
2020-05-23;CY;Cyprus;0;0;927;17
2020-05-24;CY;Cyprus;8;0;935;17
2020-05-25;CY;Cyprus;2;0;937;17
2020-05-26;CY;Cyprus;2;0;939;17
2020-05-27;CY;Cyprus;0;0;939;17
2020-05-28;CY;Cyprus;2;0;941;17
2020-05-29;CY;Cyprus;1;0;942;17
2020-05-30;CY;Cyprus;2;0;944;17
2020-05-31;CY;Cyprus;0;0;944;17
2020-06-01;CY;Cyprus;5;0;949;17
2020-06-02;CY;Cyprus;3;0;952;17
2020-06-03;CY;Cyprus;6;0;958;17
2020-06-04;CY;Cyprus;0;0;958;17
2020-06-05;CY;Cyprus;2;0;960;17
2020-06-06;CY;Cyprus;0;1;960;18
2020-06-07;CY;Cyprus;4;0;964;18
2020-06-08;CY;Cyprus;6;0;970;18
2020-06-09;CY;Cyprus;2;0;972;18
2020-06-10;CY;Cyprus;2;0;974;18
2020-06-11;CY;Cyprus;1;0;975;18
2020-06-12;CY;Cyprus;5;0;980;18
2020-06-13;CY;Cyprus;0;0;980;18
2020-06-14;CY;Cyprus;3;0;983;18
2020-06-15;CY;Cyprus;2;0;985;18
2020-06-16;CY;Cyprus;0;0;985;18
2020-06-17;CY;Cyprus;0;0;985;18
2020-06-18;CY;Cyprus;0;1;985;19
2020-06-19;CY;Cyprus;0;0;985;19
2020-06-20;CY;Cyprus;0;0;985;19
2020-06-21;CY;Cyprus;1;0;986;19
2020-06-22;CY;Cyprus;2;0;988;19
2020-06-23;CY;Cyprus;2;0;990;19
2020-06-24;CY;Cyprus;1;0;991;19
2020-06-25;CY;Cyprus;1;0;992;19
2020-06-26;CY;Cyprus;0;0;992;19
2020-06-27;CY;Cyprus;2;0;994;19
2020-06-28;CY;Cyprus;0;0;994;19
2020-06-29;CY;Cyprus;2;0;996;19
2020-06-30;CY;Cyprus;2;0;998;19
2020-07-01;CY;Cyprus;1;0;999;19
2020-07-02;CY;Cyprus;0;0;999;19
2020-07-03;CY;Cyprus;0;0;999;19
2020-07-04;CY;Cyprus;3;0;1002;19
2020-07-05;CY;Cyprus;1;0;1003;19
2020-07-06;CY;Cyprus;1;0;1004;19
2020-07-07;CY;Cyprus;1;0;1005;19
2020-07-08;CY;Cyprus;3;0;1008;19
2020-07-09;CY;Cyprus;2;0;1010;19
2020-07-10;CY;Cyprus;3;0;1013;19
2020-07-11;CY;Cyprus;1;0;1014;19
2020-07-12;CY;Cyprus;7;0;1021;19
2020-07-13;CY;Cyprus;1;0;1022;19
2020-07-14;CY;Cyprus;1;0;1023;19
2020-07-15;CY;Cyprus;2;0;1025;19
2020-07-16;CY;Cyprus;6;0;1031;19
2020-07-17;CY;Cyprus;2;0;1033;19
2020-07-18;CY;Cyprus;4;0;1037;19
2020-07-19;CY;Cyprus;1;0;1038;19
2020-07-20;CY;Cyprus;0;0;1038;19
2020-07-21;CY;Cyprus;2;0;1040;19
2020-07-22;CY;Cyprus;0;0;1040;19
2020-07-23;CY;Cyprus;5;0;1045;19
2020-07-24;CY;Cyprus;2;0;1047;19
2020-07-25;CY;Cyprus;6;0;1053;19
2020-07-26;CY;Cyprus;4;0;1057;19
2020-07-27;CY;Cyprus;3;0;1060;19
2020-07-28;CY;Cyprus;7;0;1067;19
2020-07-29;CY;Cyprus;13;0;1080;19
2020-07-30;CY;Cyprus;10;0;1090;19
2020-07-31;CY;Cyprus;24;0;1114;19
2020-08-01;CY;Cyprus;10;0;1124;19
2020-08-02;CY;Cyprus;26;0;1150;19
2020-08-03;CY;Cyprus;5;0;1155;19
2020-08-04;CY;Cyprus;25;0;1180;19
2020-08-05;CY;Cyprus;15;0;1195;19
2020-08-06;CY;Cyprus;13;0;1208;19
2020-08-07;CY;Cyprus;14;0;1222;19
2020-08-08;CY;Cyprus;11;0;1233;19
2020-08-09;CY;Cyprus;9;0;1242;19
2020-08-10;CY;Cyprus;10;0;1252;19
2020-08-11;CY;Cyprus;25;1;1277;20
2020-08-12;CY;Cyprus;14;0;1291;20
2020-08-13;CY;Cyprus;14;0;1305;20
2020-08-14;CY;Cyprus;13;0;1318;20
2020-08-15;CY;Cyprus;14;0;1332;20
2020-08-16;CY;Cyprus;7;0;1339;20
2020-08-17;CY;Cyprus;12;0;1351;20
2020-08-18;CY;Cyprus;8;0;1359;20
2020-08-19;CY;Cyprus;26;0;1385;20
2020-08-20;CY;Cyprus;10;0;1395;20
2020-08-21;CY;Cyprus;11;0;1406;20
2020-08-22;CY;Cyprus;11;0;1417;20
2020-08-23;CY;Cyprus;4;0;1421;20
2020-08-24;CY;Cyprus;30;0;1451;20
2020-08-25;CY;Cyprus;23;0;1474;20
2020-08-26;CY;Cyprus;10;0;1484;20
2020-08-27;CY;Cyprus;-17;0;1467;20
2020-08-28;CY;Cyprus;14;0;1481;20
2020-08-29;CY;Cyprus;2;0;1483;20
2020-08-30;CY;Cyprus;4;0;1487;20
2020-08-31;CY;Cyprus;1;0;1488;20
2020-09-01;CY;Cyprus;2;1;1490;21
2020-09-02;CY;Cyprus;5;0;1495;21
2020-09-03;CY;Cyprus;3;0;1498;21
2020-09-04;CY;Cyprus;4;0;1502;21
2020-09-05;CY;Cyprus;5;0;1507;21
2020-09-06;CY;Cyprus;2;0;1509;21
2020-09-07;CY;Cyprus;1;1;1510;22
2020-09-08;CY;Cyprus;1;0;1511;22
2020-09-09;CY;Cyprus;3;0;1514;22
2020-09-10;CY;Cyprus;3;0;1517;22
2020-09-11;CY;Cyprus;3;0;1520;22
2020-09-12;CY;Cyprus;3;0;1523;22
2020-09-13;CY;Cyprus;3;0;1526;22
2020-09-14;CY;Cyprus;8;0;1534;22
2020-09-15;CY;Cyprus;6;0;1540;22
2020-09-16;CY;Cyprus;8;0;1548;22
2020-09-17;CY;Cyprus;10;0;1558;22
2020-09-18;CY;Cyprus;7;0;1565;22
2020-09-19;CY;Cyprus;25;0;1590;22
2020-09-20;CY;Cyprus;10;0;1600;22
2020-09-21;CY;Cyprus;3;0;1603;22
2020-09-22;CY;Cyprus;15;0;1618;22
2020-09-23;CY;Cyprus;36;0;1654;22
2020-09-24;CY;Cyprus;9;0;1663;22
2020-09-25;CY;Cyprus;8;0;1671;22
2020-09-26;CY;Cyprus;13;0;1684;22
2020-09-27;CY;Cyprus;12;0;1696;22
2020-09-28;CY;Cyprus;17;0;1713;22
2020-09-29;CY;Cyprus;30;0;1743;22
2020-09-30;CY;Cyprus;12;0;1755;22
2020-10-01;CY;Cyprus;17;0;1772;22
2020-10-02;CY;Cyprus;17;0;1789;22
2020-10-03;CY;Cyprus;22;0;1811;22
2020-10-04;CY;Cyprus;13;0;1824;22
2020-10-05;CY;Cyprus;23;0;1847;22
2020-10-06;CY;Cyprus;29;1;1876;23
2020-10-07;CY;Cyprus;21;1;1897;24
2020-10-08;CY;Cyprus;21;0;1918;24
2020-10-09;CY;Cyprus;33;1;1951;25
2020-10-10;CY;Cyprus;35;0;1986;25
2020-10-11;CY;Cyprus;20;0;2006;25
2020-10-12;CY;Cyprus;41;0;2047;25
2020-10-13;CY;Cyprus;83;0;2130;25
2020-10-14;CY;Cyprus;51;0;2181;25
2020-10-15;CY;Cyprus;104;0;2285;25
2020-10-16;CY;Cyprus;94;0;2379;25
2020-10-17;CY;Cyprus;202;0;2581;25
2020-10-18;CY;Cyprus;63;0;2644;25
2020-10-19;CY;Cyprus;43;0;2687;25
2020-10-20;CY;Cyprus;152;0;2839;25
2020-10-21;CY;Cyprus;127;0;2966;25
2020-10-22;CY;Cyprus;188;0;3154;25
2020-10-23;CY;Cyprus;160;0;3314;25
2020-10-24;CY;Cyprus;130;0;3444;25
2020-10-25;CY;Cyprus;101;0;3545;25
2020-10-26;CY;Cyprus;91;0;3636;25
2020-10-27;CY;Cyprus;181;0;3817;25
2020-10-28;CY;Cyprus;113;0;3930;25
2020-10-29;CY;Cyprus;121;0;4051;25
2020-10-30;CY;Cyprus;166;0;4217;25
2020-10-31;CY;Cyprus;149;1;4366;26
2020-11-01;CY;Cyprus;197;0;4563;26
2020-11-02;CY;Cyprus;197;1;4760;27
2020-11-03;CY;Cyprus;174;0;4934;27
2020-11-04;CY;Cyprus;166;0;5100;27
2020-11-05;CY;Cyprus;233;0;5333;27
2020-11-06;CY;Cyprus;224;0;5557;27
2020-11-07;CY;Cyprus;314;8;5871;35
2020-11-08;CY;Cyprus;116;-7;5987;28
2020-11-09;CY;Cyprus;111;0;6098;28
2020-11-10;CY;Cyprus;198;1;6296;29
2020-11-11;CY;Cyprus;165;4;6461;33
2020-11-12;CY;Cyprus;185;1;6646;34
2020-11-13;CY;Cyprus;207;4;6853;38
2020-11-14;CY;Cyprus;198;1;7051;39
2020-11-15;CY;Cyprus;127;0;7178;39
2020-11-16;CY;Cyprus;107;1;7285;40
2020-11-17;CY;Cyprus;228;0;7513;40
2020-11-18;CY;Cyprus;198;1;7711;41
2020-11-19;CY;Cyprus;268;0;7979;41
2020-11-20;CY;Cyprus;232;2;8211;43
2020-11-21;CY;Cyprus;245;0;8456;43
2020-11-22;CY;Cyprus;187;1;8643;44
2020-11-23;CY;Cyprus;304;0;8947;44
2020-11-24;CY;Cyprus;252;2;9199;46
2020-11-25;CY;Cyprus;254;1;9453;47
2020-11-26;CY;Cyprus;220;1;9673;48
2020-11-27;CY;Cyprus;310;0;9983;48
2020-11-28;CY;Cyprus;248;0;10231;48
2020-11-29;CY;Cyprus;152;0;10383;48
2020-11-30;CY;Cyprus;182;1;10565;49
2020-12-01;CY;Cyprus;318;0;10883;49
2020-12-02;CY;Cyprus;292;3;11175;52
2020-12-03;CY;Cyprus;348;2;11523;54
2020-12-04;CY;Cyprus;289;3;11812;57
2020-12-05;CY;Cyprus;369;0;12181;57
2020-12-06;CY;Cyprus;270;4;12451;61
2020-12-07;CY;Cyprus;416;2;12867;63
2020-12-08;CY;Cyprus;419;5;13286;68
2020-12-09;CY;Cyprus;0;0;13286;68
2020-12-10;CY;Cyprus;363;2;13649;70
2020-12-11;CY;Cyprus;0;0;13649;70
2020-12-12;CY;Cyprus;827;5;14476;75
2020-12-13;CY;Cyprus;625;3;15101;78
2020-12-14;CY;Cyprus;349;4;15450;82
2020-12-15;CY;Cyprus;339;2;15789;84
2020-12-16;CY;Cyprus;401;1;16190;85
2020-12-17;CY;Cyprus;0;0;16190;85
2020-12-18;CY;Cyprus;457;0;16647;85
2020-12-19;CY;Cyprus;829;4;17476;89
2020-12-20;CY;Cyprus;212;2;17688;91
2020-12-21;CY;Cyprus;316;5;18004;96
2020-12-22;CY;Cyprus;0;0;18004;96
2020-12-23;CY;Cyprus;879;8;18883;104
2020-12-24;CY;Cyprus;433;3;19316;107
2020-12-25;CY;Cyprus;50;2;19366;109
2020-12-26;CY;Cyprus;25;2;19391;111
2020-12-27;CY;Cyprus;266;1;19657;112
2020-12-28;CY;Cyprus;751;1;20408;113
2020-12-29;CY;Cyprus;907;4;21315;117
2020-12-30;CY;Cyprus;704;2;22019;119
2020-12-31;CY;Cyprus;0;0;22019;119
2021-01-01;CY;Cyprus;799;8;22818;127
2021-01-02;CY;Cyprus;627;2;23445;129
2021-01-03;CY;Cyprus;529;2;23974;131
2021-01-04;CY;Cyprus;665;2;24639;133
2021-01-05;CY;Cyprus;569;1;25208;134
2021-01-06;CY;Cyprus;573;4;25781;138
2021-01-07;CY;Cyprus;427;2;26208;140
2021-01-08;CY;Cyprus;466;1;26674;141
2021-01-09;CY;Cyprus;337;6;27011;147
2021-01-10;CY;Cyprus;339;1;27350;148
2021-01-11;CY;Cyprus;288;5;27638;153
2021-01-12;CY;Cyprus;259;4;27897;157
2021-01-13;CY;Cyprus;227;6;28124;163
2021-01-14;CY;Cyprus;0;0;28124;163
2021-01-15;CY;Cyprus;485;3;28609;166
2021-01-16;CY;Cyprus;202;1;28811;167
2021-01-17;CY;Cyprus;157;3;28968;170
2021-01-18;CY;Cyprus;162;5;29130;175
2021-01-19;CY;Cyprus;164;1;29294;176
2021-01-20;CY;Cyprus;178;0;29472;176
2021-01-21;CY;Cyprus;164;2;29636;178
2021-01-22;CY;Cyprus;122;1;29758;179
2021-01-23;CY;Cyprus;129;4;29887;183
2021-01-24;CY;Cyprus;130;3;30017;186
2021-01-25;CY;Cyprus;126;2;30143;188
2021-01-26;CY;Cyprus;109;2;30252;190
2021-01-27;CY;Cyprus;128;3;30380;193
2021-01-28;CY;Cyprus;158;4;30538;197
2021-01-29;CY;Cyprus;119;0;30657;197
2021-01-30;CY;Cyprus;113;0;30770;197
2021-01-31;CY;Cyprus;106;2;30876;199
2021-02-01;CY;Cyprus;120;3;30996;202
2021-02-02;CY;Cyprus;128;0;31124;202
2021-02-03;CY;Cyprus;139;1;31263;203
2021-02-04;CY;Cyprus;116;5;31379;208
2021-02-05;CY;Cyprus;133;2;31512;210
2021-02-06;CY;Cyprus;132;1;31644;211
2021-02-07;CY;Cyprus;115;1;31759;212
2021-02-08;CY;Cyprus;105;2;31864;214
2021-02-09;CY;Cyprus;95;0;31959;214
2021-02-10;CY;Cyprus;113;3;32072;217
2021-02-11;CY;Cyprus;103;1;32175;218
2021-02-12;CY;Cyprus;113;1;32288;219
2021-02-13;CY;Cyprus;102;1;32390;220
2021-02-14;CY;Cyprus;123;1;32513;221
2021-02-15;CY;Cyprus;113;1;32626;222
2021-02-16;CY;Cyprus;81;3;32707;225
2021-02-17;CY;Cyprus;121;2;32828;227
2021-02-18;CY;Cyprus;107;1;32935;228
2021-02-19;CY;Cyprus;111;1;33046;229
2021-02-20;CY;Cyprus;107;0;33153;229
2021-02-21;CY;Cyprus;107;0;33260;229
2021-02-22;CY;Cyprus;131;1;33391;230
2021-02-23;CY;Cyprus;176;0;33567;230
2021-02-24;CY;Cyprus;143;1;33710;231
2021-02-25;CY;Cyprus;199;0;33909;231
2021-02-26;CY;Cyprus;272;0;34181;231
2021-02-27;CY;Cyprus;243;0;34424;231
2021-02-28;CY;Cyprus;283;0;34707;231
2021-03-01;CY;Cyprus;302;0;35009;231
2021-03-02;CY;Cyprus;288;1;35297;232
2021-03-03;CY;Cyprus;323;0;35620;232
2021-03-04;CY;Cyprus;384;0;36004;232
2021-03-05;CY;Cyprus;273;0;36277;232
2021-03-06;CY;Cyprus;298;0;36575;232
2021-03-07;CY;Cyprus;303;1;36878;233
2021-03-08;CY;Cyprus;352;0;37230;233
2021-03-09;CY;Cyprus;420;0;37650;233
2021-03-10;CY;Cyprus;415;2;38065;235
2021-03-11;CY;Cyprus;431;1;38496;236
2021-03-12;CY;Cyprus;383;2;38879;238
2021-03-13;CY;Cyprus;398;0;39277;238
2021-03-14;CY;Cyprus;374;2;39651;240
2021-03-15;CY;Cyprus;218;0;39869;240
2021-03-16;CY;Cyprus;475;1;40344;241
2021-03-17;CY;Cyprus;382;0;40726;241
2021-03-18;CY;Cyprus;385;0;41111;241
2021-03-19;CY;Cyprus;364;0;41475;241
2021-03-20;CY;Cyprus;407;1;41882;242
2021-03-21;CY;Cyprus;336;1;42218;243
2021-03-22;CY;Cyprus;410;2;42628;245
2021-03-23;CY;Cyprus;365;1;42993;246
2021-03-24;CY;Cyprus;293;2;43286;248
2021-03-25;CY;Cyprus;324;0;43610;248
2021-03-26;CY;Cyprus;361;0;43971;248
2021-03-27;CY;Cyprus;334;2;44305;250
2021-03-28;CY;Cyprus;326;2;44631;252
2021-03-29;CY;Cyprus;360;2;44991;254
2021-03-30;CY;Cyprus;439;2;45430;256
2021-03-31;CY;Cyprus;434;0;45864;256
2021-04-01;CY;Cyprus;309;4;46173;260
2021-04-02;CY;Cyprus;705;1;46878;261
2021-04-03;CY;Cyprus;404;0;47282;261
2021-04-04;CY;Cyprus;431;0;47713;261
2021-04-05;CY;Cyprus;565;1;48278;262
2021-04-06;CY;Cyprus;559;2;48837;264
2021-04-07;CY;Cyprus;529;2;49366;266
2021-04-08;CY;Cyprus;622;2;49988;268
2021-04-09;CY;Cyprus;601;0;50589;268
2021-04-10;CY;Cyprus;446;4;51035;272
2021-04-11;CY;Cyprus;470;0;51505;272
2021-04-12;CY;Cyprus;528;1;52033;273
2021-04-13;CY;Cyprus;619;1;52652;274
2021-04-14;CY;Cyprus;602;3;53254;277
2021-04-15;CY;Cyprus;690;6;53944;283
2021-04-16;CY;Cyprus;677;1;54621;284
2021-04-17;CY;Cyprus;786;4;55407;288
2021-04-18;CY;Cyprus;852;3;56259;291
2021-04-19;CY;Cyprus;822;3;57081;294
2021-04-20;CY;Cyprus;941;1;58022;295
2021-04-21;CY;Cyprus;843;0;58865;295
2021-04-22;CY;Cyprus;927;1;59792;296
2021-04-23;CY;Cyprus;889;1;60681;297
2021-04-24;CY;Cyprus;895;1;61576;298
2021-04-25;CY;Cyprus;773;0;62349;298
2021-04-26;CY;Cyprus;611;3;62960;301
2021-04-27;CY;Cyprus;760;2;63720;303
2021-04-28;CY;Cyprus;845;3;64565;306
2021-04-29;CY;Cyprus;668;2;65233;308
2021-04-30;CY;Cyprus;0;0;65233;308
2021-05-01;CY;Cyprus;676;4;65909;312
2021-05-02;CY;Cyprus;463;1;66372;313
2021-05-03;CY;Cyprus;539;8;66911;321
2021-05-04;CY;Cyprus;509;5;67420;326
2021-05-05;CY;Cyprus;562;1;67982;327
2021-05-06;CY;Cyprus;460;1;68442;328
2021-05-07;CY;Cyprus;324;4;68766;332
2021-05-08;CY;Cyprus;397;2;69163;334
2021-05-09;CY;Cyprus;269;2;69432;336
2021-05-10;CY;Cyprus;276;1;69708;337
2021-05-11;CY;Cyprus;390;2;70098;339
2021-05-12;CY;Cyprus;260;2;70358;341
2021-05-13;CY;Cyprus;213;1;70571;342
2021-05-14;CY;Cyprus;171;4;70742;346
2021-05-15;CY;Cyprus;157;0;70899;346
2021-05-16;CY;Cyprus;165;0;71064;346
2021-05-17;CY;Cyprus;167;1;71231;347
2021-05-18;CY;Cyprus;167;1;71398;348
2021-05-19;CY;Cyprus;135;0;71533;348
2021-05-20;CY;Cyprus;77;2;71610;350
2021-05-21;CY;Cyprus;135;2;71745;352
2021-05-22;CY;Cyprus;91;1;71836;353
2021-05-23;CY;Cyprus;75;1;71911;354
2021-05-24;CY;Cyprus;100;2;72011;356
2021-05-25;CY;Cyprus;79;1;72090;357
2021-05-26;CY;Cyprus;69;0;72159;357
2021-05-27;CY;Cyprus;75;0;72234;357
2021-05-28;CY;Cyprus;73;3;72307;360
2021-05-29;CY;Cyprus;56;0;72363;360
2021-05-30;CY;Cyprus;44;0;72407;360
2021-05-31;CY;Cyprus;50;0;72457;360
2021-06-01;CY;Cyprus;58;0;72515;360
2021-06-02;CY;Cyprus;58;1;72573;361
2021-06-03;CY;Cyprus;53;1;72626;362
2021-06-04;CY;Cyprus;83;1;72709;363
2021-06-05;CY;Cyprus;41;0;72750;363
2021-06-06;CY;Cyprus;29;0;72779;363
2021-06-07;CY;Cyprus;80;1;72859;364
2021-06-08;CY;Cyprus;60;1;72919;365
2021-06-09;CY;Cyprus;77;2;72996;367
2021-06-10;CY;Cyprus;59;4;73055;371
2021-06-11;CY;Cyprus;60;1;73115;372
2021-06-12;CY;Cyprus;0;0;73115;372
2021-06-13;CY;Cyprus;75;1;73190;373
2021-06-14;CY;Cyprus;57;1;73247;374
2021-06-15;CY;Cyprus;64;0;73311;374
2021-06-16;CY;Cyprus;68;0;73379;374
2021-06-17;CY;Cyprus;65;0;73444;374
2021-06-18;CY;Cyprus;76;0;73520;374
2021-06-19;CY;Cyprus;62;0;73582;374
2021-06-20;CY;Cyprus;61;0;73643;374
2021-06-21;CY;Cyprus;67;0;73710;374
2021-06-22;CY;Cyprus;122;0;73832;374
2021-06-23;CY;Cyprus;167;0;73999;374
2021-06-24;CY;Cyprus;175;0;74174;374
2021-06-25;CY;Cyprus;169;0;74343;374
2021-06-26;CY;Cyprus;226;0;74569;374
2021-06-27;CY;Cyprus;216;0;74785;374
2021-06-28;CY;Cyprus;314;0;75099;374
2021-06-29;CY;Cyprus;332;0;75431;374
2021-06-30;CY;Cyprus;429;0;75860;374
2021-07-01;CY;Cyprus;473;0;76333;374
2020-03-01;CZ;Czechia;3;0;3;0
2020-03-02;CZ;Czechia;0;0;3;0
2020-03-03;CZ;Czechia;2;0;5;0
2020-03-04;CZ;Czechia;3;0;8;0
2020-03-05;CZ;Czechia;4;0;12;0
2020-03-06;CZ;Czechia;6;0;18;0
2020-03-07;CZ;Czechia;1;0;19;0
2020-03-08;CZ;Czechia;12;0;31;0
2020-03-09;CZ;Czechia;0;0;31;0
2020-03-10;CZ;Czechia;10;0;41;0
2020-03-11;CZ;Czechia;50;0;91;0
2020-03-12;CZ;Czechia;3;0;94;0
2020-03-13;CZ;Czechia;47;0;141;0
2020-03-14;CZ;Czechia;48;0;189;0
2020-03-15;CZ;Czechia;64;0;253;0
2020-03-16;CZ;Czechia;45;0;298;0
2020-03-17;CZ;Czechia;98;0;396;0
2020-03-18;CZ;Czechia;68;0;464;0
2020-03-19;CZ;Czechia;230;0;694;0
2020-03-20;CZ;Czechia;139;0;833;0
2020-03-21;CZ;Czechia;162;0;995;0
2020-03-22;CZ;Czechia;125;1;1120;1
2020-03-23;CZ;Czechia;116;0;1236;1
2020-03-24;CZ;Czechia;158;2;1394;3
2020-03-25;CZ;Czechia;260;3;1654;6
2020-03-26;CZ;Czechia;271;3;1925;9
2020-03-27;CZ;Czechia;354;0;2279;9
2020-03-28;CZ;Czechia;352;2;2631;11
2020-03-29;CZ;Czechia;186;5;2817;16
2020-03-30;CZ;Czechia;184;7;3001;23
2020-03-31;CZ;Czechia;307;8;3308;31
2020-04-01;CZ;Czechia;200;8;3508;39
2020-04-02;CZ;Czechia;350;5;3858;44
2020-04-03;CZ;Czechia;233;9;4091;53
2020-04-04;CZ;Czechia;381;6;4472;59
2020-04-05;CZ;Czechia;115;8;4587;67
2020-04-06;CZ;Czechia;235;11;4822;78
2020-04-07;CZ;Czechia;195;10;5017;88
2020-04-08;CZ;Czechia;295;11;5312;99
2020-04-09;CZ;Czechia;257;13;5569;112
2020-04-10;CZ;Czechia;163;7;5732;119
2020-04-11;CZ;Czechia;99;10;5831;129
2020-04-12;CZ;Czechia;160;9;5991;138
2020-04-13;CZ;Czechia;68;5;6059;143
2020-04-14;CZ;Czechia;52;18;6111;161
2020-04-15;CZ;Czechia;105;5;6216;166
2020-04-16;CZ;Czechia;217;3;6433;169
2020-04-17;CZ;Czechia;116;4;6549;173
2020-04-18;CZ;Czechia;57;8;6606;181
2020-04-19;CZ;Czechia;140;5;6746;186
2020-04-20;CZ;Czechia;154;8;6900;194
2020-04-21;CZ;Czechia;133;7;7033;201
2020-04-22;CZ;Czechia;99;7;7132;208
2020-04-23;CZ;Czechia;55;2;7187;210
2020-04-24;CZ;Czechia;86;4;7273;214
2020-04-25;CZ;Czechia;79;4;7352;218
2020-04-26;CZ;Czechia;52;2;7404;220
2020-04-27;CZ;Czechia;41;3;7445;223
2020-04-28;CZ;Czechia;59;4;7504;227
2020-04-29;CZ;Czechia;75;0;7579;227
2020-04-30;CZ;Czechia;103;9;7682;236
2020-05-01;CZ;Czechia;55;4;7737;240
2020-05-02;CZ;Czechia;18;5;7755;245
2020-05-03;CZ;Czechia;26;3;7781;248
2020-05-04;CZ;Czechia;38;4;7819;252
2020-05-05;CZ;Czechia;77;5;7896;257
2020-05-06;CZ;Czechia;78;5;7974;262
2020-05-07;CZ;Czechia;57;8;8031;270
2020-05-08;CZ;Czechia;46;3;8077;273
2020-05-09;CZ;Czechia;18;3;8095;276
2020-05-10;CZ;Czechia;28;4;8123;280
2020-05-11;CZ;Czechia;53;2;8176;282
2020-05-12;CZ;Czechia;45;1;8221;283
2020-05-13;CZ;Czechia;48;7;8269;290
2020-05-14;CZ;Czechia;82;3;8351;293
2020-05-15;CZ;Czechia;55;2;8406;295
2020-05-16;CZ;Czechia;49;1;8455;296
2020-05-17;CZ;Czechia;20;2;8475;298
2020-05-18;CZ;Czechia;111;-1;8586;297
2020-05-19;CZ;Czechia;61;5;8647;302
2020-05-20;CZ;Czechia;74;2;8721;304
2020-05-21;CZ;Czechia;33;2;8754;306
2020-05-22;CZ;Czechia;59;6;8813;312
2020-05-23;CZ;Czechia;77;2;8890;314
2020-05-24;CZ;Czechia;65;1;8955;315
2020-05-25;CZ;Czechia;47;2;9002;317
2020-05-26;CZ;Czechia;48;0;9050;317
2020-05-27;CZ;Czechia;36;0;9086;317
2020-05-28;CZ;Czechia;54;2;9140;319
2020-05-29;CZ;Czechia;56;0;9196;319
2020-05-30;CZ;Czechia;34;0;9230;319
2020-05-31;CZ;Czechia;38;1;9268;320
2020-06-01;CZ;Czechia;34;1;9302;321
2020-06-02;CZ;Czechia;62;2;9364;323
2020-06-03;CZ;Czechia;74;2;9438;325
2020-06-04;CZ;Czechia;56;1;9494;326
2020-06-05;CZ;Czechia;35;1;9529;327
2020-06-06;CZ;Czechia;38;0;9567;327
2020-06-07;CZ;Czechia;61;0;9628;327
2020-06-08;CZ;Czechia;69;1;9697;328
2020-06-09;CZ;Czechia;54;0;9751;328
2020-06-10;CZ;Czechia;73;2;9824;330
2020-06-11;CZ;Czechia;31;-2;9855;328
2020-06-12;CZ;Czechia;83;1;9938;329
2020-06-13;CZ;Czechia;53;-1;9991;328
2020-06-14;CZ;Czechia;33;1;10024;329
2020-06-15;CZ;Czechia;40;1;10064;330
2020-06-16;CZ;Czechia;47;1;10111;331
2020-06-17;CZ;Czechia;51;2;10162;333
2020-06-18;CZ;Czechia;118;1;10280;334
2020-06-19;CZ;Czechia;126;1;10406;335
2020-06-20;CZ;Czechia;42;1;10448;336
2020-06-21;CZ;Czechia;50;0;10498;336
2020-06-22;CZ;Czechia;25;0;10523;336
2020-06-23;CZ;Czechia;127;3;10650;339
2020-06-24;CZ;Czechia;127;4;10777;343
2020-06-25;CZ;Czechia;93;2;10870;345
2020-06-26;CZ;Czechia;168;4;11038;349
2020-06-27;CZ;Czechia;260;0;11298;349
2020-06-28;CZ;Czechia;305;-1;11603;348
2020-06-29;CZ;Czechia;202;0;11805;348
2020-06-30;CZ;Czechia;149;1;11954;349
2020-07-01;CZ;Czechia;92;0;12046;349
2020-07-02;CZ;Czechia;132;4;12178;353
2020-07-03;CZ;Czechia;141;0;12319;353
2020-07-04;CZ;Czechia;121;-2;12440;351
2020-07-05;CZ;Czechia;75;-3;12515;348
2020-07-06;CZ;Czechia;51;2;12566;350
2020-07-07;CZ;Czechia;119;1;12685;351
2020-07-08;CZ;Czechia;129;0;12814;351
2020-07-09;CZ;Czechia;105;1;12919;352
2020-07-10;CZ;Czechia;82;0;13001;352
2020-07-11;CZ;Czechia;114;0;13115;352
2020-07-12;CZ;Czechia;59;0;13174;352
2020-07-13;CZ;Czechia;64;1;13238;353
2020-07-14;CZ;Czechia;103;2;13341;355
2020-07-15;CZ;Czechia;134;0;13475;355
2020-07-16;CZ;Czechia;137;0;13612;355
2020-07-17;CZ;Czechia;130;3;13742;358
2020-07-18;CZ;Czechia;113;0;13855;358
2020-07-19;CZ;Czechia;90;1;13945;359
2020-07-20;CZ;Czechia;153;0;14098;359
2020-07-21;CZ;Czechia;226;1;14324;360
2020-07-22;CZ;Czechia;246;4;14570;364
2020-07-23;CZ;Czechia;230;1;14800;365
2020-07-24;CZ;Czechia;281;4;15081;369
2020-07-25;CZ;Czechia;131;0;15212;369
2020-07-26;CZ;Czechia;112;2;15324;371
2020-07-27;CZ;Czechia;192;2;15516;373
2020-07-28;CZ;Czechia;283;1;15799;374
2020-07-29;CZ;Czechia;294;0;16093;374
2020-07-30;CZ;Czechia;278;5;16371;379
2020-07-31;CZ;Czechia;203;3;16574;382
2020-08-01;CZ;Czechia;125;1;16699;383
2020-08-02;CZ;Czechia;101;1;16800;384
2020-08-03;CZ;Czechia;208;2;17008;386
2020-08-04;CZ;Czechia;278;-3;17286;383
2020-08-05;CZ;Czechia;243;5;17529;388
2020-08-06;CZ;Czechia;202;2;17731;390
2020-08-07;CZ;Czechia;329;-1;18060;389
2020-08-08;CZ;Czechia;175;0;18235;389
2020-08-09;CZ;Czechia;118;1;18353;390
2020-08-10;CZ;Czechia;141;0;18494;390
2020-08-11;CZ;Czechia;289;1;18783;391
2020-08-12;CZ;Czechia;292;0;19075;391
2020-08-13;CZ;Czechia;326;0;19401;391
2020-08-14;CZ;Czechia;292;3;19693;394
2020-08-15;CZ;Czechia;198;1;19891;395
2020-08-16;CZ;Czechia;121;2;20012;397
2020-08-17;CZ;Czechia;190;2;20202;399
2020-08-18;CZ;Czechia;281;2;20483;401
2020-08-19;CZ;Czechia;315;3;20798;404
2020-08-20;CZ;Czechia;247;2;21045;406
2020-08-21;CZ;Czechia;506;5;21551;411
2020-08-22;CZ;Czechia;239;0;21790;411
2020-08-23;CZ;Czechia;133;1;21923;412
2020-08-24;CZ;Czechia;258;3;22181;415
2020-08-25;CZ;Czechia;367;1;22548;416
2020-08-26;CZ;Czechia;403;2;22951;418
2020-08-27;CZ;Czechia;218;0;23169;418
2020-08-28;CZ;Czechia;608;1;23777;419
2020-08-29;CZ;Czechia;317;2;24094;421
2020-08-30;CZ;Czechia;273;2;24367;423
2020-08-31;CZ;Czechia;251;1;24618;424
2020-09-01;CZ;Czechia;499;1;25117;425
2020-09-02;CZ;Czechia;656;0;25773;425
2020-09-03;CZ;Czechia;679;1;26452;426
2020-09-04;CZ;Czechia;797;3;27249;429
2020-09-05;CZ;Czechia;503;2;27752;431
2020-09-06;CZ;Czechia;404;5;28156;436
2020-09-07;CZ;Czechia;560;1;28716;437
2020-09-08;CZ;Czechia;1161;4;29877;441
2020-09-09;CZ;Czechia;1159;3;31036;444
2020-09-10;CZ;Czechia;1377;4;32413;448
2020-09-11;CZ;Czechia;1447;2;33860;450
2020-09-12;CZ;Czechia;1541;3;35401;453
2020-09-13;CZ;Czechia;787;3;36188;456
2020-09-14;CZ;Czechia;1034;9;37222;465
2020-09-15;CZ;Czechia;1674;11;38896;476
2020-09-16;CZ;Czechia;2136;6;41032;482
2020-09-17;CZ;Czechia;3123;7;44155;489
2020-09-18;CZ;Czechia;2107;6;46262;495
2020-09-19;CZ;Czechia;2044;4;48306;499
2020-09-20;CZ;Czechia;984;4;49290;503
2020-09-21;CZ;Czechia;1474;19;50764;522
2020-09-22;CZ;Czechia;2394;9;53158;531
2020-09-23;CZ;Czechia;2306;24;55464;555
2020-09-24;CZ;Czechia;2910;12;58374;567
2020-09-25;CZ;Czechia;2944;14;61318;581
2020-09-26;CZ;Czechia;1976;10;63294;591
2020-09-27;CZ;Czechia;1303;15;64597;606
2020-09-28;CZ;Czechia;1286;12;65883;618
2020-09-29;CZ;Czechia;1960;18;67843;636
2020-09-30;CZ;Czechia;2920;19;70763;655
2020-10-01;CZ;Czechia;3492;23;74255;678
2020-10-02;CZ;Czechia;3796;21;78051;699
2020-10-03;CZ;Czechia;2554;12;80605;711
2020-10-04;CZ;Czechia;1841;16;82446;727
2020-10-05;CZ;Czechia;3120;31;85566;758
2020-10-06;CZ;Czechia;4456;36;90022;794
2020-10-07;CZ;Czechia;5338;35;95360;829
2020-10-08;CZ;Czechia;5397;40;100757;869
2020-10-09;CZ;Czechia;8617;36;109374;905
2020-10-10;CZ;Czechia;4631;43;114005;948
2020-10-11;CZ;Czechia;3105;39;117110;987
2020-10-12;CZ;Czechia;4311;64;121421;1051
2020-10-13;CZ;Czechia;8326;55;129747;1106
2020-10-14;CZ;Czechia;9543;66;139290;1172
2020-10-15;CZ;Czechia;9720;58;149010;1230
2020-10-16;CZ;Czechia;11102;53;160112;1283
2020-10-17;CZ;Czechia;8715;69;168827;1352
2020-10-18;CZ;Czechia;5058;70;173885;1422
2020-10-19;CZ;Czechia;8077;91;181962;1513
2020-10-20;CZ;Czechia;11984;106;193946;1619
2020-10-21;CZ;Czechia;14969;120;208915;1739
2020-10-22;CZ;Czechia;14150;106;223065;1845
2020-10-23;CZ;Czechia;15258;126;238323;1971
2020-10-24;CZ;Czechia;12474;106;250797;2077
2020-10-25;CZ;Czechia;7300;124;258097;2201
2020-10-26;CZ;Czechia;10273;164;268370;2365
2020-10-27;CZ;Czechia;15663;182;284033;2547
2020-10-28;CZ;Czechia;12980;128;297013;2675
2020-10-29;CZ;Czechia;13055;187;310068;2862
2020-10-30;CZ;Czechia;13605;216;323673;3078
2020-10-31;CZ;Czechia;11429;173;335102;3251
2020-11-01;CZ;Czechia;6542;178;341644;3429
2020-11-02;CZ;Czechia;9252;225;350896;3654
2020-11-03;CZ;Czechia;12089;259;362985;3913
2020-11-04;CZ;Czechia;15731;220;378716;4133
2020-11-05;CZ;Czechia;13229;197;391945;4330
2020-11-06;CZ;Czechia;11552;154;403497;4484
2020-11-07;CZ;Czechia;7723;197;411220;4681
2020-11-08;CZ;Czechia;3608;177;414828;4858
2020-11-09;CZ;Czechia;2353;170;417181;5028
2020-11-10;CZ;Czechia;12699;295;429880;5323
2020-11-11;CZ;Czechia;8925;247;438805;5570
2020-11-12;CZ;Czechia;7870;185;446675;5755
2020-11-13;CZ;Czechia;7355;171;454030;5926
2020-11-14;CZ;Czechia;4199;132;458229;6058
2020-11-15;CZ;Czechia;1887;150;460116;6208
2020-11-16;CZ;Czechia;5407;208;465523;6416
2020-11-17;CZ;Czechia;4246;142;469769;6558
2020-11-18;CZ;Czechia;5515;182;475284;6740
2020-11-19;CZ;Czechia;6471;134;481755;6874
2020-11-20;CZ;Czechia;5808;147;487563;7021
2020-11-21;CZ;Czechia;3187;74;490750;7095
2020-11-22;CZ;Czechia;1513;101;492263;7196
2020-11-23;CZ;Czechia;4375;164;496638;7360
2020-11-24;CZ;Czechia;5896;139;502534;7499
2020-11-25;CZ;Czechia;2681;112;505215;7611
2020-11-26;CZ;Czechia;6305;168;511520;7779
2020-11-27;CZ;Czechia;4464;188;515984;7967
2020-11-28;CZ;Czechia;2665;87;518649;8054
2020-11-29;CZ;Czechia;1074;84;519723;8138
2020-11-30;CZ;Czechia;3575;157;523298;8295
2020-12-01;CZ;Czechia;5176;112;528474;8407
2020-12-02;CZ;Czechia;4568;108;533042;8515
2020-12-03;CZ;Czechia;4621;126;537663;8641
2020-12-04;CZ;Czechia;4743;97;542406;8738
2020-12-05;CZ;Czechia;1773;77;544179;8815
2020-12-06;CZ;Czechia;2654;87;546833;8902
2020-12-07;CZ;Czechia;0;0;546833;8902
2020-12-08;CZ;Czechia;4237;134;551070;9036
2020-12-09;CZ;Czechia;5857;100;556927;9136
2020-12-10;CZ;Czechia;6406;90;563333;9226
2020-12-11;CZ;Czechia;5872;115;569205;9341
2020-12-12;CZ;Czechia;6217;109;575422;9450
2020-12-13;CZ;Czechia;3657;85;579079;9535
2020-12-14;CZ;Czechia;2000;74;581079;9609
2020-12-15;CZ;Czechia;5172;134;586251;9743
2020-12-16;CZ;Czechia;7897;139;594148;9882
2020-12-17;CZ;Czechia;8256;154;602404;10036
2020-12-18;CZ;Czechia;7602;127;610006;10163
2020-12-19;CZ;Czechia;8830;108;618836;10271
2020-12-20;CZ;Czechia;5304;60;624140;10331
2020-12-21;CZ;Czechia;3383;80;627523;10411
2020-12-22;CZ;Czechia;7891;151;635414;10562
2020-12-23;CZ;Czechia;10898;102;646312;10664
2020-12-24;CZ;Czechia;14149;112;660461;10776
2020-12-25;CZ;Czechia;4402;83;664863;10859
2020-12-26;CZ;Czechia;2706;91;667569;10950
2020-12-27;CZ;Czechia;3030;94;670599;11044
2020-12-28;CZ;Czechia;3741;108;674340;11152
2020-12-29;CZ;Czechia;10862;150;685202;11302
2020-12-30;CZ;Czechia;16420;127;701622;11429
2020-12-31;CZ;Czechia;17039;151;718661;11580
2021-01-01;CZ;Czechia;13361;131;732022;11711
2021-01-02;CZ;Czechia;3447;116;735469;11827
2021-01-03;CZ;Czechia;5012;133;740481;11960
2021-01-04;CZ;Czechia;6233;110;746714;12070
2021-01-05;CZ;Czechia;12921;187;759635;12257
2021-01-06;CZ;Czechia;17332;179;776967;12436
2021-01-07;CZ;Czechia;17773;185;794740;12621
2021-01-08;CZ;Czechia;14861;179;809601;12800
2021-01-09;CZ;Czechia;13115;178;822716;12978
2021-01-10;CZ;Czechia;8449;137;831165;13115
2021-01-11;CZ;Czechia;4289;157;835454;13272
2021-01-12;CZ;Czechia;9345;213;844799;13485
2021-01-13;CZ;Czechia;10801;171;855600;13656
2021-01-14;CZ;Czechia;10922;200;866522;13856
2021-01-15;CZ;Czechia;8083;173;874605;14029
2021-01-16;CZ;Czechia;9301;186;883906;14215
2021-01-17;CZ;Czechia;5253;123;889159;14338
2021-01-18;CZ;Czechia;2693;111;891852;14449
2021-01-19;CZ;Czechia;7651;197;899503;14646
2021-01-20;CZ;Czechia;9628;174;909131;14820
2021-01-21;CZ;Czechia;8228;153;917359;14973
2021-01-22;CZ;Czechia;7488;157;924847;15130
2021-01-23;CZ;Czechia;8514;140;933361;15270
2021-01-24;CZ;Czechia;4256;99;937617;15369
2021-01-25;CZ;Czechia;2387;84;940004;15453
2021-01-26;CZ;Czechia;6942;165;946946;15618
2021-01-27;CZ;Czechia;9209;173;956155;15791
2021-01-28;CZ;Czechia;8505;153;964660;15944
2021-01-29;CZ;Czechia;7982;128;972642;16072
2021-01-30;CZ;Czechia;8072;139;980714;16211
2021-01-31;CZ;Czechia;4060;97;984774;16308
2021-02-01;CZ;Czechia;2555;84;987329;16392
2021-02-02;CZ;Czechia;7185;153;994514;16545
2021-02-03;CZ;Czechia;9143;138;1003657;16683
2021-02-04;CZ;Czechia;9695;143;1013352;16826
2021-02-05;CZ;Czechia;8125;150;1021477;16976
2021-02-06;CZ;Czechia;8635;153;1030112;17129
2021-02-07;CZ;Czechia;4863;106;1034975;17235
2021-02-08;CZ;Czechia;2430;98;1037405;17333
2021-02-09;CZ;Czechia;7727;164;1045132;17497
2021-02-10;CZ;Czechia;10283;145;1055415;17642
2021-02-11;CZ;Czechia;9537;130;1064952;17772
2021-02-12;CZ;Czechia;9014;130;1073966;17902
2021-02-13;CZ;Czechia;8883;156;1082849;18058
2021-02-14;CZ;Czechia;5160;85;1088009;18143
2021-02-15;CZ;Czechia;2851;107;1090860;18250
2021-02-16;CZ;Czechia;8794;180;1099654;18430
2021-02-17;CZ;Czechia;12668;166;1112322;18596
2021-02-18;CZ;Czechia;10930;143;1123252;18739
2021-02-19;CZ;Czechia;11705;174;1134957;18913
2021-02-20;CZ;Czechia;11364;184;1146321;19097
2021-02-21;CZ;Czechia;6838;117;1153159;19214
2021-02-22;CZ;Czechia;4021;116;1157180;19330
2021-02-23;CZ;Czechia;11311;207;1168491;19537
2021-02-24;CZ;Czechia;15861;145;1184352;19682
2021-02-25;CZ;Czechia;13816;153;1198168;19835
2021-02-26;CZ;Czechia;14612;164;1212780;19999
2021-02-27;CZ;Czechia;14815;195;1227595;20194
2021-02-28;CZ;Czechia;7885;145;1235480;20339
2021-03-01;CZ;Czechia;4571;130;1240051;20469
2021-03-02;CZ;Czechia;12191;232;1252242;20701
2021-03-03;CZ;Czechia;16816;240;1269058;20941
2021-03-04;CZ;Czechia;15230;187;1284288;21128
2021-03-05;CZ;Czechia;14714;197;1299002;21325
2021-03-06;CZ;Czechia;13162;233;1312164;21558
2021-03-07;CZ;Czechia;9167;159;1321331;21717
2021-03-08;CZ;Czechia;3960;165;1325291;21882
2021-03-09;CZ;Czechia;10524;265;1335815;22147
2021-03-10;CZ;Czechia;15380;238;1351195;22385
2021-03-11;CZ;Czechia;14529;239;1365724;22624
2021-03-12;CZ;Czechia;11274;241;1376998;22865
2021-03-13;CZ;Czechia;15110;218;1392108;23083
2021-03-14;CZ;Czechia;6970;143;1399078;23226
2021-03-15;CZ;Czechia;3342;153;1402420;23379
2021-03-16;CZ;Czechia;10542;278;1412962;23657
2021-03-17;CZ;Czechia;14029;245;1426991;23902
2021-03-18;CZ;Czechia;12028;215;1439019;24117
2021-03-19;CZ;Czechia;10677;214;1449696;24331
2021-03-20;CZ;Czechia;9710;199;1459406;24530
2021-03-21;CZ;Czechia;10141;137;1469547;24667
2021-03-22;CZ;Czechia;-2214;143;1467333;24810
2021-03-23;CZ;Czechia;8205;245;1475538;25055
2021-03-24;CZ;Czechia;10972;203;1486510;25258
2021-03-25;CZ;Czechia;8851;192;1495361;25450
2021-03-26;CZ;Czechia;7946;189;1503307;25639
2021-03-27;CZ;Czechia;7714;139;1511021;25778
2021-03-28;CZ;Czechia;4008;96;1515029;25874
2021-03-29;CZ;Czechia;1743;162;1516772;26036
2021-03-30;CZ;Czechia;6896;186;1523668;26222
2021-03-31;CZ;Czechia;8664;199;1532332;26421
2021-04-01;CZ;Czechia;7285;165;1539617;26586
2021-04-02;CZ;Czechia;6248;179;1545865;26765
2021-04-03;CZ;Czechia;3869;102;1549734;26867
2021-04-04;CZ;Czechia;2162;78;1551896;26945
2021-04-05;CZ;Czechia;1924;112;1553820;27057
2021-04-06;CZ;Czechia;1425;112;1555245;27169
2021-04-07;CZ;Czechia;5532;160;1560777;27329
2021-04-08;CZ;Czechia;7071;137;1567848;27466
2021-04-09;CZ;Czechia;5305;151;1573153;27617
2021-04-10;CZ;Czechia;4819;117;1577972;27734
2021-04-11;CZ;Czechia;2217;74;1580189;27808
2021-04-12;CZ;Czechia;995;110;1581184;27918
2021-04-13;CZ;Czechia;3853;120;1585037;28038
2021-04-14;CZ;Czechia;5087;86;1590124;28124
2021-04-15;CZ;Czechia;3723;105;1593847;28229
2021-04-16;CZ;Czechia;3256;88;1597103;28317
2021-04-17;CZ;Czechia;3238;79;1600341;28396
2021-04-18;CZ;Czechia;1540;30;1601881;28426
2021-04-19;CZ;Czechia;830;106;1602711;28532
2021-04-20;CZ;Czechia;3319;108;1606030;28640
2021-04-21;CZ;Czechia;3831;71;1609861;28711
2021-04-22;CZ;Czechia;2971;76;1612832;28787
2021-04-23;CZ;Czechia;2629;76;1615461;28863
2021-04-24;CZ;Czechia;2607;57;1618068;28920
2021-04-25;CZ;Czechia;1315;42;1619383;28962
2021-04-26;CZ;Czechia;823;40;1620206;29002
2021-04-27;CZ;Czechia;2571;73;1622777;29075
2021-04-28;CZ;Czechia;3256;66;1626033;29141
2021-04-29;CZ;Czechia;2503;72;1628536;29213
2021-04-30;CZ;Czechia;2222;54;1630758;29267
2021-05-01;CZ;Czechia;2174;49;1632932;29316
2021-05-02;CZ;Czechia;1182;27;1634114;29343
2021-05-03;CZ;Czechia;505;22;1634619;29365
2021-05-04;CZ;Czechia;2217;56;1636836;29421
2021-05-05;CZ;Czechia;2412;58;1639248;29479
2021-05-06;CZ;Czechia;1872;42;1641120;29521
2021-05-07;CZ;Czechia;1576;87;1642696;29608
2021-05-08;CZ;Czechia;1639;39;1644335;29647
2021-05-09;CZ;Czechia;726;20;1645061;29667
2021-05-10;CZ;Czechia;387;44;1645448;29711
2021-05-11;CZ;Czechia;1533;38;1646981;29749
2021-05-12;CZ;Czechia;1686;38;1648667;29787
2021-05-13;CZ;Czechia;1280;38;1649947;29825
2021-05-14;CZ;Czechia;1231;32;1651178;29857
2021-05-15;CZ;Czechia;1060;29;1652238;29886
2021-05-16;CZ;Czechia;602;15;1652840;29901
2021-05-17;CZ;Czechia;259;12;1653099;29913
2021-05-18;CZ;Czechia;1120;20;1654219;29933
2021-05-19;CZ;Czechia;1195;15;1655414;29948
2021-05-20;CZ;Czechia;788;19;1656202;29967
2021-05-21;CZ;Czechia;672;23;1656874;29990
2021-05-22;CZ;Czechia;684;22;1657558;30012
2021-05-23;CZ;Czechia;335;8;1657893;30020
2021-05-24;CZ;Czechia;199;8;1658092;30028
2021-05-25;CZ;Czechia;686;13;1658778;30041
2021-05-26;CZ;Czechia;655;13;1659433;30054
2021-05-27;CZ;Czechia;547;5;1659980;30059
2021-05-28;CZ;Czechia;501;29;1660481;30088
2021-05-29;CZ;Czechia;454;13;1660935;30101
2021-05-30;CZ;Czechia;224;3;1661159;30104
2021-05-31;CZ;Czechia;113;4;1661272;30108
2021-06-01;CZ;Czechia;508;11;1661780;30119
2021-06-02;CZ;Czechia;476;7;1662256;30126
2021-06-03;CZ;Czechia;352;10;1662608;30136
2021-06-04;CZ;Czechia;432;6;1663040;30142
2021-06-05;CZ;Czechia;323;15;1663363;30157
2021-06-06;CZ;Czechia;154;2;1663517;30159
2021-06-07;CZ;Czechia;90;5;1663607;30164
2021-06-08;CZ;Czechia;391;29;1663998;30193
2021-06-09;CZ;Czechia;384;9;1664382;30202
2021-06-10;CZ;Czechia;267;9;1664649;30211
2021-06-11;CZ;Czechia;190;8;1664839;30219
2021-06-12;CZ;Czechia;183;5;1665022;30224
2021-06-13;CZ;Czechia;75;1;1665097;30225
2021-06-14;CZ;Czechia;41;4;1665138;30229
2021-06-15;CZ;Czechia;189;0;1665327;30229
2021-06-16;CZ;Czechia;199;25;1665526;30254
2021-06-17;CZ;Czechia;134;3;1665660;30257
2021-06-18;CZ;Czechia;158;18;1665818;30275
2021-06-19;CZ;Czechia;143;3;1665961;30278
2021-06-20;CZ;Czechia;64;2;1666025;30280
2021-06-21;CZ;Czechia;57;0;1666082;30280
2021-06-22;CZ;Czechia;110;3;1666192;30283
2021-06-23;CZ;Czechia;133;6;1666325;30289
2021-06-24;CZ;Czechia;196;2;1666521;30291
2021-06-25;CZ;Czechia;165;1;1666686;30292
2021-06-26;CZ;Czechia;135;4;1666821;30296
2021-06-27;CZ;Czechia;69;2;1666890;30298
2021-06-28;CZ;Czechia;57;0;1666947;30298
2021-06-29;CZ;Czechia;168;0;1667115;30298
2021-06-30;CZ;Czechia;172;5;1667287;30303
2021-07-01;CZ;Czechia;148;1;1667435;30304
2020-03-11;CD;Democratic Republic of Congo;1;0;1;0
2020-03-12;CD;Democratic Republic of Congo;0;0;1;0
2020-03-13;CD;Democratic Republic of Congo;1;0;2;0
2020-03-14;CD;Democratic Republic of Congo;0;0;2;0
2020-03-15;CD;Democratic Republic of Congo;0;0;2;0
2020-03-16;CD;Democratic Republic of Congo;0;0;2;0
2020-03-17;CD;Democratic Republic of Congo;1;0;3;0
2020-03-18;CD;Democratic Republic of Congo;1;0;4;0
2020-03-19;CD;Democratic Republic of Congo;10;0;14;0
2020-03-20;CD;Democratic Republic of Congo;4;0;18;0
2020-03-21;CD;Democratic Republic of Congo;5;1;23;1
2020-03-22;CD;Democratic Republic of Congo;7;0;30;1
2020-03-23;CD;Democratic Republic of Congo;6;0;36;1
2020-03-24;CD;Democratic Republic of Congo;9;1;45;2
2020-03-25;CD;Democratic Republic of Congo;3;0;48;2
2020-03-26;CD;Democratic Republic of Congo;3;1;51;3
2020-03-27;CD;Democratic Republic of Congo;0;0;51;3
2020-03-28;CD;Democratic Republic of Congo;14;3;65;6
2020-03-29;CD;Democratic Republic of Congo;0;0;65;6
2020-03-30;CD;Democratic Republic of Congo;16;2;81;8
2020-03-31;CD;Democratic Republic of Congo;17;0;98;8
2020-04-01;CD;Democratic Republic of Congo;11;1;109;9
2020-04-02;CD;Democratic Republic of Congo;25;4;134;13
2020-04-03;CD;Democratic Republic of Congo;0;0;134;13
2020-04-04;CD;Democratic Republic of Congo;20;5;154;18
2020-04-05;CD;Democratic Republic of Congo;0;0;154;18
2020-04-06;CD;Democratic Republic of Congo;7;0;161;18
2020-04-07;CD;Democratic Republic of Congo;19;0;180;18
2020-04-08;CD;Democratic Republic of Congo;0;0;180;18
2020-04-09;CD;Democratic Republic of Congo;0;0;180;18
2020-04-10;CD;Democratic Republic of Congo;35;2;215;20
2020-04-11;CD;Democratic Republic of Congo;8;0;223;20
2020-04-12;CD;Democratic Republic of Congo;11;0;234;20
2020-04-13;CD;Democratic Republic of Congo;1;0;235;20
2020-04-14;CD;Democratic Republic of Congo;6;0;241;20
2020-04-15;CD;Democratic Republic of Congo;13;1;254;21
2020-04-16;CD;Democratic Republic of Congo;13;1;267;22
2020-04-17;CD;Democratic Republic of Congo;20;1;287;23
2020-04-18;CD;Democratic Republic of Congo;20;2;307;25
2020-04-19;CD;Democratic Republic of Congo;20;0;327;25
2020-04-20;CD;Democratic Republic of Congo;5;0;332;25
2020-04-21;CD;Democratic Republic of Congo;18;0;350;25
2020-04-22;CD;Democratic Republic of Congo;9;0;359;25
2020-04-23;CD;Democratic Republic of Congo;18;0;377;25
2020-04-24;CD;Democratic Republic of Congo;17;0;394;25
2020-04-25;CD;Democratic Republic of Congo;22;3;416;28
2020-04-26;CD;Democratic Republic of Congo;26;0;442;28
2020-04-27;CD;Democratic Republic of Congo;17;0;459;28
2020-04-28;CD;Democratic Republic of Congo;12;2;471;30
2020-04-29;CD;Democratic Republic of Congo;20;0;491;30
2020-04-30;CD;Democratic Republic of Congo;81;1;572;31
2020-05-01;CD;Democratic Republic of Congo;32;1;604;32
2020-05-02;CD;Democratic Republic of Congo;70;1;674;33
2020-05-03;CD;Democratic Republic of Congo;0;0;674;33
2020-05-04;CD;Democratic Republic of Congo;8;1;682;34
2020-05-05;CD;Democratic Republic of Congo;23;0;705;34
2020-05-06;CD;Democratic Republic of Congo;92;1;797;35
2020-05-07;CD;Democratic Republic of Congo;66;1;863;36
2020-05-08;CD;Democratic Republic of Congo;74;3;937;39
2020-05-09;CD;Democratic Republic of Congo;0;0;937;39
2020-05-10;CD;Democratic Republic of Congo;54;2;991;41
2020-05-11;CD;Democratic Republic of Congo;33;0;1024;41
2020-05-12;CD;Democratic Republic of Congo;78;3;1102;44
2020-05-13;CD;Democratic Republic of Congo;67;6;1169;50
2020-05-14;CD;Democratic Republic of Congo;73;0;1242;50
2020-05-15;CD;Democratic Republic of Congo;56;0;1298;50
2020-05-16;CD;Democratic Republic of Congo;157;11;1455;61
2020-05-17;CD;Democratic Republic of Congo;0;0;1455;61
2020-05-18;CD;Democratic Republic of Congo;83;0;1538;61
2020-05-19;CD;Democratic Republic of Congo;91;0;1629;61
2020-05-20;CD;Democratic Republic of Congo;102;0;1731;61
2020-05-21;CD;Democratic Republic of Congo;104;0;1835;61
2020-05-22;CD;Democratic Republic of Congo;110;2;1945;63
2020-05-23;CD;Democratic Republic of Congo;80;0;2025;63
2020-05-24;CD;Democratic Republic of Congo;116;0;2141;63
2020-05-25;CD;Democratic Republic of Congo;156;4;2297;67
2020-05-26;CD;Democratic Republic of Congo;106;1;2403;68
2020-05-27;CD;Democratic Republic of Congo;143;0;2546;68
2020-05-28;CD;Democratic Republic of Congo;114;1;2660;69
2020-05-29;CD;Democratic Republic of Congo;173;0;2833;69
2020-05-30;CD;Democratic Republic of Congo;133;0;2966;69
2020-05-31;CD;Democratic Republic of Congo;104;3;3070;72
2020-06-01;CD;Democratic Republic of Congo;125;0;3195;72
2020-06-02;CD;Democratic Republic of Congo;131;0;3326;72
2020-06-03;CD;Democratic Republic of Congo;169;3;3495;75
2020-06-04;CD;Democratic Republic of Congo;149;3;3644;78
2020-06-05;CD;Democratic Republic of Congo;120;3;3764;81
2020-06-06;CD;Democratic Republic of Congo;114;1;3878;82
2020-06-07;CD;Democratic Republic of Congo;138;3;4016;85
2020-06-08;CD;Democratic Republic of Congo;90;3;4106;88
2020-06-09;CD;Democratic Republic of Congo;153;2;4259;90
2020-06-10;CD;Democratic Republic of Congo;131;6;4390;96
2020-06-11;CD;Democratic Republic of Congo;125;2;4515;98
2020-06-12;CD;Democratic Republic of Congo;122;3;4637;101
2020-06-13;CD;Democratic Republic of Congo;87;5;4724;106
2020-06-14;CD;Democratic Republic of Congo;54;1;4778;107
2020-06-15;CD;Democratic Republic of Congo;59;5;4837;112
2020-06-16;CD;Democratic Republic of Congo;137;0;4974;112
2020-06-17;CD;Democratic Republic of Congo;126;3;5100;115
2020-06-18;CD;Democratic Republic of Congo;183;2;5283;117
2020-06-19;CD;Democratic Republic of Congo;194;5;5477;122
2020-06-20;CD;Democratic Republic of Congo;195;3;5672;125
2020-06-21;CD;Democratic Republic of Congo;154;5;5826;130
2020-06-22;CD;Democratic Republic of Congo;98;5;5924;135
2020-06-23;CD;Democratic Republic of Congo;103;0;6027;135
2020-06-24;CD;Democratic Republic of Congo;186;7;6213;142
2020-06-25;CD;Democratic Republic of Congo;198;0;6411;142
2020-06-26;CD;Democratic Republic of Congo;141;7;6552;149
2020-06-27;CD;Democratic Republic of Congo;138;4;6690;153
2020-06-28;CD;Democratic Republic of Congo;137;4;6827;157
2020-06-29;CD;Democratic Republic of Congo;112;10;6939;167
2020-06-30;CD;Democratic Republic of Congo;100;3;7039;170
2020-07-01;CD;Democratic Republic of Congo;83;5;7122;175
2020-07-02;CD;Democratic Republic of Congo;67;1;7189;176
2020-07-03;CD;Democratic Republic of Congo;122;3;7311;179
2020-07-04;CD;Democratic Republic of Congo;68;3;7379;182
2020-07-05;CD;Democratic Republic of Congo;32;0;7411;182
2020-07-06;CD;Democratic Republic of Congo;21;0;7432;182
2020-07-07;CD;Democratic Republic of Congo;0;0;7432;182
2020-07-08;CD;Democratic Republic of Congo;0;0;7432;182
2020-07-09;CD;Democratic Republic of Congo;414;7;7846;189
2020-07-10;CD;Democratic Republic of Congo;59;0;7905;189
2020-07-11;CD;Democratic Republic of Congo;66;0;7971;189
2020-07-12;CD;Democratic Republic of Congo;62;0;8033;189
2020-07-13;CD;Democratic Republic of Congo;42;1;8075;190
2020-07-14;CD;Democratic Republic of Congo;60;0;8135;190
2020-07-15;CD;Democratic Republic of Congo;28;2;8163;192
2020-07-16;CD;Democratic Republic of Congo;36;1;8199;193
2020-07-17;CD;Democratic Republic of Congo;50;0;8249;193
2020-07-18;CD;Democratic Republic of Congo;75;0;8324;193
2020-07-19;CD;Democratic Republic of Congo;79;1;8403;194
2020-07-20;CD;Democratic Republic of Congo;40;0;8443;194
2020-07-21;CD;Democratic Republic of Congo;91;2;8534;196
2020-07-22;CD;Democratic Republic of Congo;92;1;8626;197
2020-07-23;CD;Democratic Republic of Congo;94;4;8720;201
2020-07-24;CD;Democratic Republic of Congo;47;0;8767;201
2020-07-25;CD;Democratic Republic of Congo;34;3;8801;204
2020-07-26;CD;Democratic Republic of Congo;30;0;8831;204
2020-07-27;CD;Democratic Republic of Congo;13;4;8844;208
2020-07-28;CD;Democratic Republic of Congo;29;0;8873;208
2020-07-29;CD;Democratic Republic of Congo;58;2;8931;210
2020-07-30;CD;Democratic Republic of Congo;79;5;9010;215
2020-07-31;CD;Democratic Republic of Congo;60;0;9070;215
2020-08-01;CD;Democratic Republic of Congo;14;0;9084;215
2020-08-02;CD;Democratic Republic of Congo;31;0;9115;215
2020-08-03;CD;Democratic Republic of Congo;18;0;9133;215
2020-08-04;CD;Democratic Republic of Congo;45;0;9178;215
2020-08-05;CD;Democratic Republic of Congo;75;0;9253;215
2020-08-06;CD;Democratic Republic of Congo;56;0;9309;215
2020-08-07;CD;Democratic Republic of Congo;46;3;9355;218
2020-08-08;CD;Democratic Republic of Congo;81;0;9436;218
2020-08-09;CD;Democratic Republic of Congo;18;6;9454;224
2020-08-10;CD;Democratic Republic of Congo;35;0;9489;224
2020-08-11;CD;Democratic Republic of Congo;10;1;9499;225
2020-08-12;CD;Democratic Republic of Congo;39;0;9538;225
2020-08-13;CD;Democratic Republic of Congo;51;9;9589;234
2020-08-14;CD;Democratic Republic of Congo;16;4;9605;238
2020-08-15;CD;Democratic Republic of Congo;33;1;9638;239
2020-08-16;CD;Democratic Republic of Congo;38;1;9676;240
2020-08-17;CD;Democratic Republic of Congo;30;3;9706;243
2020-08-18;CD;Democratic Republic of Congo;15;0;9721;243
2020-08-19;CD;Democratic Republic of Congo;20;3;9741;246
2020-08-20;CD;Democratic Republic of Congo;16;1;9757;247
2020-08-21;CD;Democratic Republic of Congo;45;1;9802;248
2020-08-22;CD;Democratic Republic of Congo;9;3;9811;251
2020-08-23;CD;Democratic Republic of Congo;19;0;9830;251
2020-08-24;CD;Democratic Republic of Congo;12;0;9842;251
2020-08-25;CD;Democratic Republic of Congo;49;0;9891;251
2020-08-26;CD;Democratic Republic of Congo;21;3;9912;254
2020-08-27;CD;Democratic Republic of Congo;3;1;9915;255
2020-08-28;CD;Democratic Republic of Congo;79;0;9994;255
2020-08-29;CD;Democratic Republic of Congo;13;3;10007;258
2020-08-30;CD;Democratic Republic of Congo;38;0;10045;258
2020-08-31;CD;Democratic Republic of Congo;52;0;10097;258
2020-09-01;CD;Democratic Republic of Congo;7;1;10104;259
2020-09-02;CD;Democratic Republic of Congo;10;0;10114;259
2020-09-03;CD;Democratic Republic of Congo;11;0;10125;259
2020-09-04;CD;Democratic Republic of Congo;24;0;10149;259
2020-09-05;CD;Democratic Republic of Congo;29;0;10178;259
2020-09-06;CD;Democratic Republic of Congo;32;1;10210;260
2020-09-07;CD;Democratic Republic of Congo;23;0;10233;260
2020-09-08;CD;Democratic Republic of Congo;59;0;10292;260
2020-09-09;CD;Democratic Republic of Congo;32;0;10324;260
2020-09-10;CD;Democratic Republic of Congo;19;2;10343;262
2020-09-11;CD;Democratic Republic of Congo;18;0;10361;262
2020-09-12;CD;Democratic Republic of Congo;24;0;10385;262
2020-09-13;CD;Democratic Republic of Congo;5;2;10390;264
2020-09-14;CD;Democratic Republic of Congo;0;0;10390;264
2020-09-15;CD;Democratic Republic of Congo;11;3;10401;267
2020-09-16;CD;Democratic Republic of Congo;13;0;10414;267
2020-09-17;CD;Democratic Republic of Congo;28;0;10442;267
2020-09-18;CD;Democratic Republic of Congo;14;1;10456;268
2020-09-19;CD;Democratic Republic of Congo;32;0;10488;268
2020-09-20;CD;Democratic Republic of Congo;27;3;10515;271
2020-09-21;CD;Democratic Republic of Congo;4;0;10519;271
2020-09-22;CD;Democratic Republic of Congo;4;0;10523;271
2020-09-23;CD;Democratic Republic of Congo;14;0;10537;271
2020-09-24;CD;Democratic Republic of Congo;18;0;10555;271
2020-09-25;CD;Democratic Republic of Congo;23;0;10578;271
2020-09-26;CD;Democratic Republic of Congo;15;0;10593;271
2020-09-27;CD;Democratic Republic of Congo;19;0;10612;271
2020-09-28;CD;Democratic Republic of Congo;12;0;10624;271
2020-09-29;CD;Democratic Republic of Congo;7;1;10631;272
2020-09-30;CD;Democratic Republic of Congo;28;0;10659;272
2020-10-01;CD;Democratic Republic of Congo;26;0;10685;272
2020-10-02;CD;Democratic Republic of Congo;44;0;10729;272
2020-10-03;CD;Democratic Republic of Congo;23;2;10752;274
2020-10-04;CD;Democratic Republic of Congo;8;0;10760;274
2020-10-05;CD;Democratic Republic of Congo;18;0;10778;274
2020-10-06;CD;Democratic Republic of Congo;11;0;10789;274
2020-10-07;CD;Democratic Republic of Congo;15;2;10804;276
2020-10-08;CD;Democratic Republic of Congo;18;0;10822;276
2020-10-09;CD;Democratic Republic of Congo;13;0;10835;276
2020-10-10;CD;Democratic Republic of Congo;6;0;10841;276
2020-10-11;CD;Democratic Republic of Congo;10;0;10851;276
2020-10-12;CD;Democratic Republic of Congo;17;0;10868;276
2020-10-13;CD;Democratic Republic of Congo;4;0;10872;276
2020-10-14;CD;Democratic Republic of Congo;63;5;10935;281
2020-10-15;CD;Democratic Republic of Congo;0;0;10935;281
2020-10-16;CD;Democratic Republic of Congo;64;20;10999;301
2020-10-17;CD;Democratic Republic of Congo;1;1;11000;302
2020-10-18;CD;Democratic Republic of Congo;6;0;11006;302
2020-10-19;CD;Democratic Republic of Congo;46;1;11052;303
2020-10-20;CD;Democratic Republic of Congo;14;0;11066;303
2020-10-21;CD;Democratic Republic of Congo;0;0;11066;303
2020-10-22;CD;Democratic Republic of Congo;31;1;11097;304
2020-10-23;CD;Democratic Republic of Congo;25;0;11122;304
2020-10-24;CD;Democratic Republic of Congo;21;1;11143;305
2020-10-25;CD;Democratic Republic of Congo;0;0;11143;305
2020-10-26;CD;Democratic Republic of Congo;31;0;11174;305
2020-10-27;CD;Democratic Republic of Congo;17;0;11191;305
2020-10-28;CD;Democratic Republic of Congo;20;0;11211;305
2020-10-29;CD;Democratic Republic of Congo;0;0;11211;305
2020-10-30;CD;Democratic Republic of Congo;95;2;11306;307
2020-10-31;CD;Democratic Republic of Congo;0;0;11306;307
2020-11-01;CD;Democratic Republic of Congo;67;1;11373;308
2020-11-02;CD;Democratic Republic of Congo;22;0;11395;308
2020-11-03;CD;Democratic Republic of Congo;32;7;11427;315
2020-11-04;CD;Democratic Republic of Congo;23;0;11450;315
2020-11-05;CD;Democratic Republic of Congo;0;0;11450;315
2020-11-06;CD;Democratic Republic of Congo;67;0;11517;315
2020-11-07;CD;Democratic Republic of Congo;33;1;11550;316
2020-11-08;CD;Democratic Republic of Congo;41;0;11591;316
2020-11-09;CD;Democratic Republic of Congo;17;0;11608;316
2020-11-10;CD;Democratic Republic of Congo;34;0;11642;316
2020-11-11;CD;Democratic Republic of Congo;14;0;11656;316
2020-11-12;CD;Democratic Republic of Congo;36;2;11692;318
2020-11-13;CD;Democratic Republic of Congo;0;0;11692;318
2020-11-14;CD;Democratic Republic of Congo;68;1;11760;319
2020-11-15;CD;Democratic Republic of Congo;0;0;11760;319
2020-11-16;CD;Democratic Republic of Congo;79;2;11839;321
2020-11-17;CD;Democratic Republic of Congo;27;1;11866;322
2020-11-18;CD;Democratic Republic of Congo;52;1;11918;323
2020-11-19;CD;Democratic Republic of Congo;90;0;12008;323
2020-11-20;CD;Democratic Republic of Congo;121;1;12129;324
2020-11-21;CD;Democratic Republic of Congo;51;3;12180;327
2020-11-22;CD;Democratic Republic of Congo;0;0;12180;327
2020-11-23;CD;Democratic Republic of Congo;98;2;12278;329
2020-11-24;CD;Democratic Republic of Congo;32;2;12310;331
2020-11-25;CD;Democratic Republic of Congo;55;0;12365;331
2020-11-26;CD;Democratic Republic of Congo;105;2;12470;333
2020-11-27;CD;Democratic Republic of Congo;0;0;12470;333
2020-11-28;CD;Democratic Republic of Congo;138;0;12608;333
2020-11-29;CD;Democratic Republic of Congo;94;0;12702;333
2020-11-30;CD;Democratic Republic of Congo;70;0;12772;333
2020-12-01;CD;Democratic Republic of Congo;87;2;12859;335
2020-12-02;CD;Democratic Republic of Congo;128;1;12987;336
2020-12-03;CD;Democratic Republic of Congo;145;1;13132;337
2020-12-04;CD;Democratic Republic of Congo;149;0;13281;337
2020-12-05;CD;Democratic Republic of Congo;132;5;13413;342
2020-12-06;CD;Democratic Republic of Congo;114;2;13527;344
2020-12-07;CD;Democratic Republic of Congo;68;0;13595;344
2020-12-08;CD;Democratic Republic of Congo;155;0;13750;344
2020-12-09;CD;Democratic Republic of Congo;93;6;13843;350
2020-12-10;CD;Democratic Republic of Congo;154;0;13997;350
2020-12-11;CD;Democratic Republic of Congo;172;0;14169;350
2020-12-12;CD;Democratic Republic of Congo;173;2;14342;352
2020-12-13;CD;Democratic Republic of Congo;119;0;14461;352
2020-12-14;CD;Democratic Republic of Congo;52;4;14513;356
2020-12-15;CD;Democratic Republic of Congo;84;2;14597;358
2020-12-16;CD;Democratic Republic of Congo;333;6;14930;364
2020-12-17;CD;Democratic Republic of Congo;159;2;15089;366
2020-12-18;CD;Democratic Republic of Congo;0;0;15089;366
2020-12-19;CD;Democratic Republic of Congo;308;3;15397;369
2020-12-20;CD;Democratic Republic of Congo;98;1;15495;370
2020-12-21;CD;Democratic Republic of Congo;174;0;15669;370
2020-12-22;CD;Democratic Republic of Congo;141;0;15810;370
2020-12-23;CD;Democratic Republic of Congo;229;196;16039;566
2020-12-24;CD;Democratic Republic of Congo;243;7;16282;573
2020-12-25;CD;Democratic Republic of Congo;190;0;16472;573
2020-12-26;CD;Democratic Republic of Congo;291;0;16763;573
2020-12-27;CD;Democratic Republic of Congo;76;6;16839;579
2020-12-28;CD;Democratic Republic of Congo;78;0;16917;579
2020-12-29;CD;Democratic Republic of Congo;265;5;17182;584
2020-12-30;CD;Democratic Republic of Congo;194;0;17376;584
2020-12-31;CD;Democratic Republic of Congo;282;7;17658;591
2021-01-01;CD;Democratic Republic of Congo;191;0;17849;591
2021-01-02;CD;Democratic Republic of Congo;149;4;17998;595
2021-01-03;CD;Democratic Republic of Congo;104;1;18102;596
2021-01-04;CD;Democratic Republic of Congo;51;3;18153;599
2021-01-05;CD;Democratic Republic of Congo;95;0;18248;599
2021-01-06;CD;Democratic Republic of Congo;239;0;18487;599
2021-01-07;CD;Democratic Republic of Congo;251;11;18738;610
2021-01-08;CD;Democratic Republic of Congo;231;1;18969;611
2021-01-09;CD;Democratic Republic of Congo;190;0;19159;611
2021-01-10;CD;Democratic Republic of Congo;277;0;19436;611
2021-01-11;CD;Democratic Republic of Congo;60;8;19496;619
2021-01-12;CD;Democratic Republic of Congo;211;6;19707;625
2021-01-13;CD;Democratic Republic of Congo;296;1;20003;626
2021-01-14;CD;Democratic Republic of Congo;476;0;20479;626
2021-01-15;CD;Democratic Republic of Congo;77;2;20556;628
2021-01-16;CD;Democratic Republic of Congo;137;2;20693;630
2021-01-17;CD;Democratic Republic of Congo;215;1;20908;631
2021-01-18;CD;Democratic Republic of Congo;152;3;21060;634
2021-01-19;CD;Democratic Republic of Congo;80;6;21140;640
2021-01-20;CD;Democratic Republic of Congo;162;0;21302;640
2021-01-21;CD;Democratic Republic of Congo;96;4;21398;644
2021-01-22;CD;Democratic Republic of Congo;199;3;21597;647
2021-01-23;CD;Democratic Republic of Congo;116;7;21713;654
2021-01-24;CD;Democratic Republic of Congo;156;7;21869;661
2021-01-25;CD;Democratic Republic of Congo;85;0;21954;661
2021-01-26;CD;Democratic Republic of Congo;94;0;22048;661
2021-01-27;CD;Democratic Republic of Congo;130;0;22178;661
2021-01-28;CD;Democratic Republic of Congo;144;4;22322;665
2021-01-29;CD;Democratic Republic of Congo;133;0;22455;665
2021-01-30;CD;Democratic Republic of Congo;149;6;22604;671
2021-01-31;CD;Democratic Republic of Congo;167;0;22771;671
2021-02-01;CD;Democratic Republic of Congo;71;2;22842;673
2021-02-02;CD;Democratic Republic of Congo;201;2;23043;675
2021-02-03;CD;Democratic Republic of Congo;139;0;23182;675
2021-02-04;CD;Democratic Republic of Congo;40;3;23222;678
2021-02-05;CD;Democratic Republic of Congo;149;0;23371;678
2021-02-06;CD;Democratic Republic of Congo;114;1;23485;679
2021-02-07;CD;Democratic Republic of Congo;114;2;23599;681
2021-02-08;CD;Democratic Republic of Congo;72;0;23671;681
2021-02-09;CD;Democratic Republic of Congo;100;3;23771;684
2021-02-10;CD;Democratic Republic of Congo;119;2;23890;686
2021-02-11;CD;Democratic Republic of Congo;136;0;24026;686
2021-02-12;CD;Democratic Republic of Congo;126;5;24152;691
2021-02-13;CD;Democratic Republic of Congo;88;2;24240;693
2021-02-14;CD;Democratic Republic of Congo;55;0;24295;693
2021-02-15;CD;Democratic Republic of Congo;91;0;24386;693
2021-02-16;CD;Democratic Republic of Congo;37;2;24423;695
2021-02-17;CD;Democratic Republic of Congo;179;0;24602;695
2021-02-18;CD;Democratic Republic of Congo;192;0;24794;695
2021-02-19;CD;Democratic Republic of Congo;170;0;24964;695
2021-02-20;CD;Democratic Republic of Congo;116;5;25080;700
2021-02-21;CD;Democratic Republic of Congo;0;0;25080;700
2021-02-22;CD;Democratic Republic of Congo;64;0;25144;700
2021-02-23;CD;Democratic Republic of Congo;0;0;25144;700
2021-02-24;CD;Democratic Republic of Congo;0;0;25144;700
2021-02-25;CD;Democratic Republic of Congo;0;0;25144;700
2021-02-26;CD;Democratic Republic of Congo;547;7;25691;707
2021-02-27;CD;Democratic Republic of Congo;101;0;25792;707
2021-02-28;CD;Democratic Republic of Congo;121;0;25913;707
2021-03-01;CD;Democratic Republic of Congo;49;0;25962;707
2021-03-02;CD;Democratic Republic of Congo;88;4;26050;711
2021-03-03;CD;Democratic Republic of Congo;197;0;26247;711
2021-03-04;CD;Democratic Republic of Congo;93;0;26340;711
2021-03-05;CD;Democratic Republic of Congo;0;0;26340;711
2021-03-06;CD;Democratic Republic of Congo;129;1;26469;712
2021-03-07;CD;Democratic Republic of Congo;72;0;26541;712
2021-03-08;CD;Democratic Republic of Congo;86;0;26627;712
2021-03-09;CD;Democratic Republic of Congo;57;0;26684;712
2021-03-10;CD;Democratic Republic of Congo;54;0;26738;712
2021-03-11;CD;Democratic Republic of Congo;21;0;26759;712
2021-03-12;CD;Democratic Republic of Congo;87;0;26846;712
2021-03-13;CD;Democratic Republic of Congo;92;5;26938;717
2021-03-14;CD;Democratic Republic of Congo;76;0;27014;717
2021-03-15;CD;Democratic Republic of Congo;63;0;27077;717
2021-03-16;CD;Democratic Republic of Congo;23;5;27100;722
2021-03-17;CD;Democratic Republic of Congo;152;0;27252;722
2021-03-18;CD;Democratic Republic of Congo;38;4;27290;726
2021-03-19;CD;Democratic Republic of Congo;66;0;27356;726
2021-03-20;CD;Democratic Republic of Congo;112;0;27468;726
2021-03-21;CD;Democratic Republic of Congo;85;0;27553;726
2021-03-22;CD;Democratic Republic of Congo;19;0;27572;726
2021-03-23;CD;Democratic Republic of Congo;8;0;27580;726
2021-03-24;CD;Democratic Republic of Congo;80;0;27660;726
2021-03-25;CD;Democratic Republic of Congo;69;0;27729;726
2021-03-26;CD;Democratic Republic of Congo;65;0;27794;726
2021-03-27;CD;Democratic Republic of Congo;93;8;27887;734
2021-03-28;CD;Democratic Republic of Congo;43;5;27930;739
2021-03-29;CD;Democratic Republic of Congo;82;0;28012;739
2021-03-30;CD;Democratic Republic of Congo;64;4;28076;743
2021-03-31;CD;Democratic Republic of Congo;66;0;28142;743
2021-04-01;CD;Democratic Republic of Congo;57;2;28199;745
2021-04-02;CD;Democratic Republic of Congo;18;0;28217;745
2021-04-03;CD;Democratic Republic of Congo;75;0;28292;745
2021-04-04;CD;Democratic Republic of Congo;33;0;28325;745
2021-04-05;CD;Democratic Republic of Congo;29;0;28354;745
2021-04-06;CD;Democratic Republic of Congo;23;0;28377;745
2021-04-07;CD;Democratic Republic of Congo;33;0;28410;745
2021-04-08;CD;Democratic Republic of Congo;64;0;28474;745
2021-04-09;CD;Democratic Republic of Congo;37;0;28511;745
2021-04-10;CD;Democratic Republic of Congo;31;0;28542;745
2021-04-11;CD;Democratic Republic of Congo;0;0;28542;745
2021-04-12;CD;Democratic Republic of Congo;0;0;28542;745
2021-04-13;CD;Democratic Republic of Congo;123;0;28665;745
2021-04-14;CD;Democratic Republic of Congo;49;0;28714;745
2021-04-15;CD;Democratic Republic of Congo;55;0;28769;745
2021-04-16;CD;Democratic Republic of Congo;90;0;28859;745
2021-04-17;CD;Democratic Republic of Congo;35;0;28894;745
2021-04-18;CD;Democratic Republic of Congo;62;0;28956;745
2021-04-19;CD;Democratic Republic of Congo;0;0;28956;745
2021-04-20;CD;Democratic Republic of Congo;128;3;29084;748
2021-04-21;CD;Democratic Republic of Congo;149;0;29233;748
2021-04-22;CD;Democratic Republic of Congo;117;4;29350;752
2021-04-23;CD;Democratic Republic of Congo;55;0;29405;752
2021-04-24;CD;Democratic Republic of Congo;93;4;29498;756
2021-04-25;CD;Democratic Republic of Congo;78;0;29576;756
2021-04-26;CD;Democratic Republic of Congo;35;0;29611;756
2021-04-27;CD;Democratic Republic of Congo;90;4;29701;760
2021-04-28;CD;Democratic Republic of Congo;67;3;29768;763
2021-04-29;CD;Democratic Republic of Congo;44;0;29812;763
2021-04-30;CD;Democratic Republic of Congo;41;3;29853;766
2021-05-01;CD;Democratic Republic of Congo;51;2;29904;768
2021-05-02;CD;Democratic Republic of Congo;61;0;29965;768
2021-05-03;CD;Democratic Republic of Congo;39;0;30004;768
2021-05-04;CD;Democratic Republic of Congo;67;2;30071;770
2021-05-05;CD;Democratic Republic of Congo;59;0;30130;770
2021-05-06;CD;Democratic Republic of Congo;71;0;30201;770
2021-05-07;CD;Democratic Republic of Congo;39;2;30240;772
2021-05-08;CD;Democratic Republic of Congo;45;0;30285;772
2021-05-09;CD;Democratic Republic of Congo;38;0;30323;772
2021-05-10;CD;Democratic Republic of Congo;27;0;30350;772
2021-05-11;CD;Democratic Republic of Congo;42;3;30392;775
2021-05-12;CD;Democratic Republic of Congo;37;0;30429;775
2021-05-13;CD;Democratic Republic of Congo;49;0;30478;775
2021-05-14;CD;Democratic Republic of Congo;33;0;30511;775
2021-05-15;CD;Democratic Republic of Congo;35;1;30546;776
2021-05-16;CD;Democratic Republic of Congo;16;0;30562;776
2021-05-17;CD;Democratic Republic of Congo;47;0;30609;776
2021-05-18;CD;Democratic Republic of Congo;11;0;30620;776
2021-05-19;CD;Democratic Republic of Congo;88;0;30708;776
2021-05-20;CD;Democratic Republic of Congo;49;3;30757;779
2021-05-21;CD;Democratic Republic of Congo;68;0;30825;779
2021-05-22;CD;Democratic Republic of Congo;38;0;30863;779
2021-05-23;CD;Democratic Republic of Congo;0;0;30863;779
2021-05-24;CD;Democratic Republic of Congo;0;0;30863;779
2021-05-25;CD;Democratic Republic of Congo;309;1;31172;780
2021-05-26;CD;Democratic Republic of Congo;76;0;31248;780
2021-05-27;CD;Democratic Republic of Congo;31;1;31279;781
2021-05-28;CD;Democratic Republic of Congo;107;1;31386;782
2021-05-29;CD;Democratic Republic of Congo;30;0;31416;782
2021-05-30;CD;Democratic Republic of Congo;141;0;31557;782
2021-05-31;CD;Democratic Republic of Congo;94;0;31651;782
2021-06-01;CD;Democratic Republic of Congo;0;0;31651;782
2021-06-02;CD;Democratic Republic of Congo;283;4;31934;786
2021-06-03;CD;Democratic Republic of Congo;243;3;32177;789
2021-06-04;CD;Democratic Republic of Congo;368;0;32545;789
2021-06-05;CD;Democratic Republic of Congo;251;8;32796;797
2021-06-06;CD;Democratic Republic of Congo;406;7;33202;804
2021-06-07;CD;Democratic Republic of Congo;136;1;33338;805
2021-06-08;CD;Democratic Republic of Congo;239;12;33577;817
2021-06-09;CD;Democratic Republic of Congo;379;4;33956;821
2021-06-10;CD;Democratic Republic of Congo;310;4;34266;825
2021-06-11;CD;Democratic Republic of Congo;429;6;34695;831
2021-06-12;CD;Democratic Republic of Congo;254;3;34949;834
2021-06-13;CD;Democratic Republic of Congo;279;0;35228;834
2021-06-14;CD;Democratic Republic of Congo;440;12;35668;846
2021-06-15;CD;Democratic Republic of Congo;250;8;35918;854
2021-06-16;CD;Democratic Republic of Congo;304;3;36222;857
2021-06-17;CD;Democratic Republic of Congo;356;9;36578;866
2021-06-18;CD;Democratic Republic of Congo;379;0;36957;866
2021-06-19;CD;Democratic Republic of Congo;562;7;37519;873
2021-06-20;CD;Democratic Republic of Congo;290;6;37809;879
2021-06-21;CD;Democratic Republic of Congo;117;0;37926;879
2021-06-22;CD;Democratic Republic of Congo;404;9;38330;888
2021-06-23;CD;Democratic Republic of Congo;223;3;38553;891
2021-06-24;CD;Democratic Republic of Congo;383;5;38936;896
2021-06-25;CD;Democratic Republic of Congo;459;2;39395;898
2021-06-26;CD;Democratic Republic of Congo;363;14;39758;912
2021-06-27;CD;Democratic Republic of Congo;496;4;40254;916
2021-06-28;CD;Democratic Republic of Congo;185;0;40439;916
2021-06-29;CD;Democratic Republic of Congo;397;8;40836;924
2021-06-30;CD;Democratic Republic of Congo;0;0;40836;924
2021-07-01;CD;Democratic Republic of Congo;517;9;41353;933
2020-02-02;DK;Denmark;0;0;0;0
2020-02-03;DK;Denmark;0;0;0;0
2020-02-04;DK;Denmark;0;0;0;0
2020-02-05;DK;Denmark;0;0;0;0
2020-02-06;DK;Denmark;0;0;0;0
2020-02-07;DK;Denmark;0;0;0;0
2020-02-08;DK;Denmark;0;0;0;0
2020-02-09;DK;Denmark;0;0;0;0
2020-02-10;DK;Denmark;0;0;0;0
2020-02-11;DK;Denmark;0;0;0;0
2020-02-12;DK;Denmark;0;0;0;0
2020-02-13;DK;Denmark;0;0;0;0
2020-02-14;DK;Denmark;0;0;0;0
2020-02-15;DK;Denmark;0;0;0;0
2020-02-16;DK;Denmark;0;0;0;0
2020-02-17;DK;Denmark;0;0;0;0
2020-02-18;DK;Denmark;0;0;0;0
2020-02-19;DK;Denmark;0;0;0;0
2020-02-20;DK;Denmark;0;0;0;0
2020-02-21;DK;Denmark;0;0;0;0
2020-02-22;DK;Denmark;0;0;0;0
2020-02-23;DK;Denmark;0;0;0;0
2020-02-24;DK;Denmark;0;0;0;0
2020-02-25;DK;Denmark;0;0;0;0
2020-02-26;DK;Denmark;0;0;0;0
2020-02-27;DK;Denmark;1;0;1;0
2020-02-28;DK;Denmark;0;0;1;0
2020-02-29;DK;Denmark;2;0;3;0
2020-03-01;DK;Denmark;1;0;4;0
2020-03-02;DK;Denmark;0;0;4;0
2020-03-03;DK;Denmark;2;0;6;0
2020-03-04;DK;Denmark;5;0;11;0
2020-03-05;DK;Denmark;0;0;11;0
2020-03-06;DK;Denmark;13;0;24;0
2020-03-07;DK;Denmark;0;0;24;0
2020-03-08;DK;Denmark;13;0;37;0
2020-03-09;DK;Denmark;55;0;92;0
2020-03-10;DK;Denmark;172;0;264;0
2020-03-11;DK;Denmark;180;0;444;0
2020-03-12;DK;Denmark;173;0;617;0
2020-03-13;DK;Denmark;187;0;804;0
2020-03-14;DK;Denmark;32;1;836;1
2020-03-15;DK;Denmark;39;1;875;2
2020-03-16;DK;Denmark;58;1;933;3
2020-03-17;DK;Denmark;92;1;1025;4
2020-03-18;DK;Denmark;91;0;1116;4
2020-03-19;DK;Denmark;109;2;1225;6
2020-03-20;DK;Denmark;112;3;1337;9
2020-03-21;DK;Denmark;83;4;1420;13
2020-03-22;DK;Denmark;94;0;1514;13
2020-03-23;DK;Denmark;58;11;1572;24
2020-03-24;DK;Denmark;146;8;1718;32
2020-03-25;DK;Denmark;144;2;1862;34
2020-03-26;DK;Denmark;161;7;2023;41
2020-03-27;DK;Denmark;177;11;2200;52
2020-03-28;DK;Denmark;166;13;2366;65
2020-03-29;DK;Denmark;198;7;2564;72
2020-03-30;DK;Denmark;191;5;2755;77
2020-03-31;DK;Denmark;284;13;3039;90
2020-04-01;DK;Denmark;251;14;3290;104
2020-04-02;DK;Denmark;283;19;3573;123
2020-04-03;DK;Denmark;373;16;3946;139
2020-04-04;DK;Denmark;323;22;4269;161
2020-04-05;DK;Denmark;292;18;4561;179
2020-04-06;DK;Denmark;314;8;4875;187
2020-04-07;DK;Denmark;391;16;5266;203
2020-04-08;DK;Denmark;331;15;5597;218
2020-04-09;DK;Denmark;233;19;5830;237
2020-04-10;DK;Denmark;184;10;6014;247
2020-04-11;DK;Denmark;177;13;6191;260
2020-04-12;DK;Denmark;178;13;6369;273
2020-04-13;DK;Denmark;144;12;6513;285
2020-04-14;DK;Denmark;193;14;6706;299
2020-04-15;DK;Denmark;170;10;6876;309
2020-04-16;DK;Denmark;198;12;7074;321
2020-04-17;DK;Denmark;194;15;7268;336
2020-04-18;DK;Denmark;169;10;7437;346
2020-04-19;DK;Denmark;143;9;7580;355
2020-04-20;DK;Denmark;131;9;7711;364
2020-04-21;DK;Denmark;180;6;7891;370
2020-04-22;DK;Denmark;217;14;8108;384
2020-04-23;DK;Denmark;163;10;8271;394
2020-04-24;DK;Denmark;137;9;8408;403
2020-04-25;DK;Denmark;235;15;8643;418
2020-04-26;DK;Denmark;130;4;8773;422
2020-04-27;DK;Denmark;123;5;8896;427
2020-04-28;DK;Denmark;153;7;9049;434
2020-04-29;DK;Denmark;157;9;9206;443
2020-04-30;DK;Denmark;150;9;9356;452
2020-05-01;DK;Denmark;153;8;9509;460
2020-05-02;DK;Denmark;96;15;9605;475
2020-05-03;DK;Denmark;116;9;9721;484
2020-05-04;DK;Denmark;147;9;9868;493
2020-05-05;DK;Denmark;151;10;10019;503
2020-05-06;DK;Denmark;117;3;10136;506
2020-05-07;DK;Denmark;145;8;10281;514
2020-05-08;DK;Denmark;135;8;10416;522
2020-05-09;DK;Denmark;101;4;10517;526
2020-05-10;DK;Denmark;110;3;10627;529
2020-05-11;DK;Denmark;84;4;10711;533
2020-05-12;DK;Denmark;78;-6;10789;527
2020-05-13;DK;Denmark;76;6;10865;533
2020-05-14;DK;Denmark;46;4;10911;537
2020-05-15;DK;Denmark;78;0;10989;537
2020-05-16;DK;Denmark;67;6;11056;543
2020-05-17;DK;Denmark;69;4;11125;547
2020-05-18;DK;Denmark;41;1;11166;548
2020-05-19;DK;Denmark;76;3;11242;551
2020-05-20;DK;Denmark;73;3;11315;554
2020-05-21;DK;Denmark;65;7;11380;561
2020-05-22;DK;Denmark;48;0;11428;561
2020-05-23;DK;Denmark;59;0;11487;561
2020-05-24;DK;Denmark;72;1;11559;562
2020-05-25;DK;Denmark;27;1;11586;563
2020-05-26;DK;Denmark;41;0;11627;563
2020-05-27;DK;Denmark;53;2;11680;565
2020-05-28;DK;Denmark;32;3;11712;568
2020-05-29;DK;Denmark;81;0;11793;568
2020-05-30;DK;Denmark;40;3;11833;571
2020-05-31;DK;Denmark;36;3;11869;574
2020-06-01;DK;Denmark;30;2;11899;576
2020-06-02;DK;Denmark;35;4;11934;580
2020-06-03;DK;Denmark;37;0;11971;580
2020-06-04;DK;Denmark;40;2;12011;582
2020-06-05;DK;Denmark;64;4;12075;586
2020-06-06;DK;Denmark;49;1;12124;587
2020-06-07;DK;Denmark;24;2;12148;589
2020-06-08;DK;Denmark;14;4;12162;593
2020-06-09;DK;Denmark;39;0;12201;593
2020-06-10;DK;Denmark;15;0;12216;593
2020-06-11;DK;Denmark;19;0;12235;593
2020-06-12;DK;Denmark;64;1;12299;594
2020-06-13;DK;Denmark;40;3;12339;597
2020-06-14;DK;Denmark;54;0;12393;597
2020-06-15;DK;Denmark;24;1;12417;598
2020-06-16;DK;Denmark;33;0;12450;598
2020-06-17;DK;Denmark;44;0;12494;598
2020-06-18;DK;Denmark;50;2;12544;600
2020-06-19;DK;Denmark;47;0;12591;600
2020-06-20;DK;Denmark;0;0;12591;600
2020-06-21;DK;Denmark;0;0;12591;600
2020-06-22;DK;Denmark;136;2;12727;602
2020-06-23;DK;Denmark;34;1;12761;603
2020-06-24;DK;Denmark;54;0;12815;603
2020-06-25;DK;Denmark;21;0;12836;603
2020-06-26;DK;Denmark;39;1;12875;604
2020-06-27;DK;Denmark;0;0;12875;604
2020-06-28;DK;Denmark;0;0;12875;604
2020-06-29;DK;Denmark;76;1;12951;605
2020-06-30;DK;Denmark;17;0;12968;605
2020-07-01;DK;Denmark;26;1;12994;606
2020-07-02;DK;Denmark;21;0;13015;606
2020-07-03;DK;Denmark;17;0;13032;606
2020-07-04;DK;Denmark;0;0;13032;606
2020-07-05;DK;Denmark;1;0;13033;606
2020-07-06;DK;Denmark;46;1;13079;607
2020-07-07;DK;Denmark;10;2;13089;609
2020-07-08;DK;Denmark;12;0;13101;609
2020-07-09;DK;Denmark;16;0;13117;609
2020-07-10;DK;Denmark;30;0;13147;609
2020-07-11;DK;Denmark;0;0;13147;609
2020-07-12;DK;Denmark;0;0;13147;609
2020-07-13;DK;Denmark;91;1;13238;610
2020-07-14;DK;Denmark;24;0;13262;610
2020-07-15;DK;Denmark;31;0;13293;610
2020-07-16;DK;Denmark;32;0;13325;610
2020-07-17;DK;Denmark;49;1;13374;611
2020-07-18;DK;Denmark;0;0;13374;611
2020-07-19;DK;Denmark;3;0;13377;611
2020-07-20;DK;Denmark;89;0;13466;611
2020-07-21;DK;Denmark;40;0;13506;611
2020-07-22;DK;Denmark;48;0;13554;611
2020-07-23;DK;Denmark;40;1;13594;612
2020-07-24;DK;Denmark;48;1;13642;613
2020-07-25;DK;Denmark;1;0;13643;613
2020-07-26;DK;Denmark;22;0;13665;613
2020-07-27;DK;Denmark;110;0;13775;613
2020-07-28;DK;Denmark;36;0;13811;613
2020-07-29;DK;Denmark;57;1;13868;614
2020-07-30;DK;Denmark;96;1;13964;615
2020-07-31;DK;Denmark;64;0;14028;615
2020-08-01;DK;Denmark;0;0;14028;615
2020-08-02;DK;Denmark;0;0;14028;615
2020-08-03;DK;Denmark;207;1;14235;616
2020-08-04;DK;Denmark;79;0;14314;616
2020-08-05;DK;Denmark;126;0;14440;616
2020-08-06;DK;Denmark;146;1;14586;617
2020-08-07;DK;Denmark;161;0;14747;617
2020-08-08;DK;Denmark;4;0;14751;617
2020-08-09;DK;Denmark;8;0;14759;617
2020-08-10;DK;Denmark;376;3;15135;620
2020-08-11;DK;Denmark;156;1;15291;621
2020-08-12;DK;Denmark;132;0;15423;621
2020-08-13;DK;Denmark;167;0;15590;621
2020-08-14;DK;Denmark;168;0;15758;621
2020-08-15;DK;Denmark;109;0;15867;621
2020-08-16;DK;Denmark;136;0;16003;621
2020-08-17;DK;Denmark;124;0;16127;621
2020-08-18;DK;Denmark;119;0;16246;621
2020-08-19;DK;Denmark;90;0;16336;621
2020-08-20;DK;Denmark;117;0;16453;621
2020-08-21;DK;Denmark;72;0;16525;621
2020-08-22;DK;Denmark;112;1;16637;622
2020-08-23;DK;Denmark;78;0;16715;622
2020-08-24;DK;Denmark;106;1;16821;623
2020-08-25;DK;Denmark;84;0;16905;623
2020-08-26;DK;Denmark;57;0;16962;623
2020-08-27;DK;Denmark;90;1;17052;624
2020-08-28;DK;Denmark;73;0;17125;624
2020-08-29;DK;Denmark;79;0;17204;624
2020-08-30;DK;Denmark;112;0;17316;624
2020-08-31;DK;Denmark;94;0;17410;624
2020-09-01;DK;Denmark;99;1;17509;625
2020-09-02;DK;Denmark;111;1;17620;626
2020-09-03;DK;Denmark;180;0;17800;626
2020-09-04;DK;Denmark;174;1;17974;627
2020-09-05;DK;Denmark;189;0;18163;627
2020-09-06;DK;Denmark;147;0;18310;627
2020-09-07;DK;Denmark;230;1;18540;628
2020-09-08;DK;Denmark;244;0;18784;628
2020-09-09;DK;Denmark;252;0;19036;628
2020-09-10;DK;Denmark;317;1;19353;629
2020-09-11;DK;Denmark;293;0;19646;629
2020-09-12;DK;Denmark;343;1;19989;630
2020-09-13;DK;Denmark;338;1;20327;631
2020-09-14;DK;Denmark;347;2;20674;633
2020-09-15;DK;Denmark;339;0;21013;633
2020-09-16;DK;Denmark;0;0;21013;633
2020-09-17;DK;Denmark;823;2;21836;635
2020-09-18;DK;Denmark;455;0;22291;635
2020-09-19;DK;Denmark;590;0;22881;635
2020-09-20;DK;Denmark;472;3;23353;638
2020-09-21;DK;Denmark;421;2;23774;640
2020-09-22;DK;Denmark;487;1;24261;641
2020-09-23;DK;Denmark;561;2;24822;643
2020-09-24;DK;Denmark;563;2;25385;645
2020-09-25;DK;Denmark;681;2;26066;647
2020-09-26;DK;Denmark;621;1;26687;648
2020-09-27;DK;Denmark;424;1;27111;649
2020-09-28;DK;Denmark;435;0;27546;649
2020-09-29;DK;Denmark;395;1;27941;650
2020-09-30;DK;Denmark;538;0;28479;650
2020-10-01;DK;Denmark;403;1;28882;651
2020-10-02;DK;Denmark;536;1;29418;652
2020-10-03;DK;Denmark;371;2;29789;654
2020-10-04;DK;Denmark;379;4;30168;658
2020-10-05;DK;Denmark;378;1;30546;659
2020-10-06;DK;Denmark;322;4;30868;663
2020-10-07;DK;Denmark;333;0;31201;663
2020-10-08;DK;Denmark;447;2;31648;665
2020-10-09;DK;Denmark;483;0;32131;665
2020-10-10;DK;Denmark;444;2;32575;667
2020-10-11;DK;Denmark;340;2;32915;669
2020-10-12;DK;Denmark;389;2;33304;671
2020-10-13;DK;Denmark;290;3;33594;674
2020-10-14;DK;Denmark;493;1;34087;675
2020-10-15;DK;Denmark;432;2;34519;677
2020-10-16;DK;Denmark;420;0;34939;677
2020-10-17;DK;Denmark;501;2;35440;679
2020-10-18;DK;Denmark;453;1;35893;680
2020-10-19;DK;Denmark;452;6;36345;686
2020-10-20;DK;Denmark;532;2;36877;688
2020-10-21;DK;Denmark;630;2;37507;690
2020-10-22;DK;Denmark;763;4;38270;694
2020-10-23;DK;Denmark;859;3;39129;697
2020-10-24;DK;Denmark;789;3;39918;700
2020-10-25;DK;Denmark;945;2;40863;702
2020-10-26;DK;Denmark;1056;6;41919;708
2020-10-27;DK;Denmark;749;1;42668;709
2020-10-28;DK;Denmark;1017;6;43685;715
2020-10-29;DK;Denmark;860;1;44545;716
2020-10-30;DK;Denmark;1191;3;45736;719
2020-10-31;DK;Denmark;1127;2;46863;721
2020-11-01;DK;Denmark;948;2;47811;723
2020-11-02;DK;Denmark;942;1;48753;724
2020-11-03;DK;Denmark;1353;4;50106;728
2020-11-04;DK;Denmark;936;1;51042;729
2020-11-05;DK;Denmark;1223;4;52265;733
2020-11-06;DK;Denmark;1427;5;53692;738
2020-11-07;DK;Denmark;1050;2;54742;740
2020-11-08;DK;Denmark;893;3;55635;743
2020-11-09;DK;Denmark;771;4;56406;747
2020-11-10;DK;Denmark;1066;3;57472;750
2020-11-11;DK;Denmark;994;3;58466;753
2020-11-12;DK;Denmark;1012;2;59478;755
2020-11-13;DK;Denmark;1037;1;60515;756
2020-11-14;DK;Denmark;1078;1;61593;757
2020-11-15;DK;Denmark;1059;3;62652;760
2020-11-16;DK;Denmark;1195;4;63847;764
2020-11-17;DK;Denmark;1220;4;65067;768
2020-11-18;DK;Denmark;1257;2;66324;770
2020-11-19;DK;Denmark;1297;3;67621;773
2020-11-20;DK;Denmark;1257;5;68878;778
2020-11-21;DK;Denmark;1274;3;70152;781
2020-11-22;DK;Denmark;851;3;71003;784
2020-11-23;DK;Denmark;1169;5;72172;789
2020-11-24;DK;Denmark;1367;8;73539;797
2020-11-25;DK;Denmark;1183;5;74722;802
2020-11-26;DK;Denmark;1191;9;75913;811
2020-11-27;DK;Denmark;1323;5;77236;816
2020-11-28;DK;Denmark;1638;7;78874;823
2020-11-29;DK;Denmark;998;6;79872;829
2020-11-30;DK;Denmark;1130;8;81002;837
2020-12-01;DK;Denmark;1468;9;82470;846
2020-12-02;DK;Denmark;1586;6;84056;852
2020-12-03;DK;Denmark;1607;6;85663;858
2020-12-04;DK;Denmark;1603;9;87266;867
2020-12-05;DK;Denmark;2116;11;89382;878
2020-12-06;DK;Denmark;1749;7;91131;885
2020-12-07;DK;Denmark;2046;9;93177;894
2020-12-08;DK;Denmark;2155;7;95332;901
2020-12-09;DK;Denmark;2563;3;97895;904
2020-12-10;DK;Denmark;3132;14;101027;918
2020-12-11;DK;Denmark;3076;9;104103;927
2020-12-12;DK;Denmark;3557;8;107660;935
2020-12-13;DK;Denmark;2645;6;110305;941
2020-12-14;DK;Denmark;3337;9;113642;950
2020-12-15;DK;Denmark;2994;11;116636;961
2020-12-16;DK;Denmark;3694;14;120330;975
2020-12-17;DK;Denmark;4036;17;124366;992
2020-12-18;DK;Denmark;4508;15;128874;1007
2020-12-19;DK;Denmark;3290;12;132164;1019
2020-12-20;DK;Denmark;2835;16;134999;1035
2020-12-21;DK;Denmark;3205;18;138204;1053
2020-12-22;DK;Denmark;2546;17;140750;1070
2020-12-23;DK;Denmark;3303;26;144053;1096
2020-12-24;DK;Denmark;2874;18;146927;1114
2020-12-25;DK;Denmark;2999;20;149926;1134
2020-12-26;DK;Denmark;1838;19;151764;1153
2020-12-27;DK;Denmark;2188;21;153952;1174
2020-12-28;DK;Denmark;2482;30;156434;1204
2020-12-29;DK;Denmark;2640;22;159074;1226
2020-12-30;DK;Denmark;2788;30;161862;1256
2020-12-31;DK;Denmark;2254;42;164116;1298
2021-01-01;DK;Denmark;2451;24;166567;1322
2021-01-02;DK;Denmark;1615;23;168182;1345
2021-01-03;DK;Denmark;1176;29;169358;1374
2021-01-04;DK;Denmark;2078;15;171436;1389
2021-01-05;DK;Denmark;1997;31;173433;1420
2021-01-06;DK;Denmark;2230;31;175663;1451
2021-01-07;DK;Denmark;1844;37;177507;1488
2021-01-08;DK;Denmark;1663;30;179170;1518
2021-01-09;DK;Denmark;1745;25;180915;1543
2021-01-10;DK;Denmark;1246;28;182161;1571
2021-01-11;DK;Denmark;1239;27;183400;1598
2021-01-12;DK;Denmark;1076;26;184476;1624
2021-01-13;DK;Denmark;1359;37;185835;1661
2021-01-14;DK;Denmark;1;0;185836;1661
2021-01-15;DK;Denmark;2162;60;187998;1721
2021-01-16;DK;Denmark;880;27;188878;1748
2021-01-17;DK;Denmark;889;28;189767;1776
2021-01-18;DK;Denmark;807;30;190574;1806
2021-01-19;DK;Denmark;725;32;191299;1838
2021-01-20;DK;Denmark;888;35;192187;1873
2021-01-21;DK;Denmark;760;37;192947;1910
2021-01-22;DK;Denmark;773;32;193720;1942
2021-01-23;DK;Denmark;879;28;194599;1970
2021-01-24;DK;Denmark;754;14;195353;1984
2021-01-25;DK;Denmark;625;27;195978;2011
2021-01-26;DK;Denmark;654;20;196632;2031
2021-01-27;DK;Denmark;592;20;197224;2051
2021-01-28;DK;Denmark;668;21;197892;2072
2021-01-29;DK;Denmark;456;13;198348;2085
2021-01-30;DK;Denmark;431;22;198779;2107
2021-01-31;DK;Denmark;377;19;199156;2126
2021-02-01;DK;Denmark;488;20;199644;2146
2021-02-02;DK;Denmark;397;15;200041;2161
2021-02-03;DK;Denmark;425;10;200466;2171
2021-02-04;DK;Denmark;554;14;201020;2185
2021-02-05;DK;Denmark;438;17;201458;2202
2021-02-06;DK;Denmark;413;14;201871;2216
2021-02-07;DK;Denmark;436;1;202307;2217
2021-02-08;DK;Denmark;430;0;202737;2217
2021-02-09;DK;Denmark;367;28;203104;2245
2021-02-10;DK;Denmark;470;11;203574;2256
2021-02-11;DK;Denmark;478;14;204052;2270
2021-02-12;DK;Denmark;428;11;204480;2281
2021-02-13;DK;Denmark;274;4;204754;2285
2021-02-14;DK;Denmark;295;8;205049;2293
2021-02-15;DK;Denmark;437;9;205486;2302
2021-02-16;DK;Denmark;385;7;205871;2309
2021-02-17;DK;Denmark;414;8;206285;2317
2021-02-18;DK;Denmark;468;3;206753;2320
2021-02-19;DK;Denmark;552;8;207305;2328
2021-02-20;DK;Denmark;464;6;207769;2334
2021-02-21;DK;Denmark;496;5;208265;2339
2021-02-22;DK;Denmark;450;5;208715;2344
2021-02-23;DK;Denmark;529;0;209244;2344
2021-02-24;DK;Denmark;523;2;209767;2346
2021-02-25;DK;Denmark;603;6;210370;2352
2021-02-26;DK;Denmark;530;2;210900;2354
2021-02-27;DK;Denmark;520;5;211420;2359
2021-02-28;DK;Denmark;463;3;211883;2362
2021-03-01;DK;Denmark;497;4;212380;2366
2021-03-02;DK;Denmark;532;2;212912;2368
2021-03-03;DK;Denmark;574;3;213486;2371
2021-03-04;DK;Denmark;521;4;214007;2375
2021-03-05;DK;Denmark;614;3;214621;2378
2021-03-06;DK;Denmark;394;0;215015;2378
2021-03-07;DK;Denmark;513;2;215528;2380
2021-03-08;DK;Denmark;427;2;215955;2382
2021-03-09;DK;Denmark;527;0;216482;2382
2021-03-10;DK;Denmark;2007;1;218489;2383
2021-03-11;DK;Denmark;862;2;219351;2385
2021-03-12;DK;Denmark;645;3;219996;2388
2021-03-13;DK;Denmark;613;3;220609;2391
2021-03-14;DK;Denmark;542;1;221151;2392
2021-03-15;DK;Denmark;612;2;221763;2394
2021-03-16;DK;Denmark;771;2;222534;2396
2021-03-17;DK;Denmark;787;1;223321;2397
2021-03-18;DK;Denmark;786;1;224107;2398
2021-03-19;DK;Denmark;843;0;224950;2398
2021-03-20;DK;Denmark;590;2;225540;2400
2021-03-21;DK;Denmark;657;1;226197;2401
2021-03-22;DK;Denmark;1272;2;227469;2403
2021-03-23;DK;Denmark;254;1;227723;2404
2021-03-24;DK;Denmark;-2001;1;225722;2405
2021-03-25;DK;Denmark;814;5;226536;2410
2021-03-26;DK;Denmark;789;2;227325;2412
2021-03-27;DK;Denmark;416;2;227741;2414
2021-03-28;DK;Denmark;964;1;228705;2415
2021-03-29;DK;Denmark;679;1;229384;2416
2021-03-30;DK;Denmark;1210;2;230594;2418
2021-03-31;DK;Denmark;701;2;231295;2420
2021-04-01;DK;Denmark;662;4;231957;2424
2021-04-02;DK;Denmark;708;1;232665;2425
2021-04-03;DK;Denmark;745;4;233410;2429
2021-04-04;DK;Denmark;600;1;234010;2430
2021-04-05;DK;Denmark;479;1;234489;2431
2021-04-06;DK;Denmark;520;2;235009;2433
2021-04-07;DK;Denmark;614;3;235623;2436
2021-04-08;DK;Denmark;717;1;236340;2437
2021-04-09;DK;Denmark;698;0;237038;2437
2021-04-10;DK;Denmark;755;3;237793;2440
2021-04-11;DK;Denmark;691;2;238484;2442
2021-04-12;DK;Denmark;514;2;238998;2444
2021-04-13;DK;Denmark;563;3;239561;2447
2021-04-14;DK;Denmark;664;1;240225;2448
2021-04-15;DK;Denmark;798;2;241023;2450
2021-04-16;DK;Denmark;677;3;241700;2453
2021-04-17;DK;Denmark;724;0;242424;2453
2021-04-18;DK;Denmark;902;3;243326;2456
2021-04-19;DK;Denmark;741;4;244067;2460
2021-04-20;DK;Denmark;692;4;244759;2464
2021-04-21;DK;Denmark;803;2;245562;2466
2021-04-22;DK;Denmark;893;2;246455;2468
2021-04-23;DK;Denmark;702;5;247157;2473
2021-04-24;DK;Denmark;547;2;247704;2475
2021-04-25;DK;Denmark;612;1;248316;2476
2021-04-26;DK;Denmark;704;2;249020;2478
2021-04-27;DK;Denmark;624;2;249644;2480
2021-04-28;DK;Denmark;835;2;250479;2482
2021-04-29;DK;Denmark;769;2;251248;2484
2021-04-30;DK;Denmark;1;0;251249;2484
2021-05-01;DK;Denmark;1491;6;252740;2490
2021-05-02;DK;Denmark;867;1;253607;2491
2021-05-03;DK;Denmark;761;0;254368;2491
2021-05-04;DK;Denmark;810;1;255178;2492
2021-05-05;DK;Denmark;3;0;255181;2492
2021-05-06;DK;Denmark;2000;2;257181;2494
2021-05-07;DK;Denmark;1023;2;258204;2496
2021-05-08;DK;Denmark;677;2;258881;2498
2021-05-09;DK;Denmark;874;0;259755;2498
2021-05-10;DK;Denmark;932;0;260687;2498
2021-05-11;DK;Denmark;926;2;261613;2500
2021-05-12;DK;Denmark;1246;0;262859;2500
2021-05-13;DK;Denmark;1355;0;264214;2500
2021-05-14;DK;Denmark;951;0;265165;2500
2021-05-15;DK;Denmark;1075;3;266240;2503
2021-05-16;DK;Denmark;964;0;267204;2503
2021-05-17;DK;Denmark;836;1;268040;2504
2021-05-18;DK;Denmark;916;0;268956;2504
2021-05-19;DK;Denmark;1091;2;270047;2506
2021-05-20;DK;Denmark;1214;1;271261;2507
2021-05-21;DK;Denmark;1352;0;272613;2507
2021-05-22;DK;Denmark;753;1;273366;2508
2021-05-23;DK;Denmark;838;1;274204;2509
2021-05-24;DK;Denmark;935;1;275139;2510
2021-05-25;DK;Denmark;796;1;275935;2511
2021-05-26;DK;Denmark;1076;1;277011;2512
2021-05-27;DK;Denmark;1125;0;278136;2512
2021-05-28;DK;Denmark;1003;1;279139;2513
2021-05-29;DK;Denmark;1044;4;280183;2517
2021-05-30;DK;Denmark;958;0;281141;2517
2021-05-31;DK;Denmark;844;0;281985;2517
2021-06-01;DK;Denmark;911;0;282896;2517
2021-06-02;DK;Denmark;956;0;283852;2517
2021-06-03;DK;Denmark;1036;1;284888;2518
2021-06-04;DK;Denmark;935;0;285823;2518
2021-06-05;DK;Denmark;597;1;286420;2519
2021-06-06;DK;Denmark;855;0;287275;2519
2021-06-07;DK;Denmark;460;2;287735;2521
2021-06-08;DK;Denmark;380;0;288115;2521
2021-06-09;DK;Denmark;909;0;289024;2521
2021-06-10;DK;Denmark;477;2;289501;2523
2021-06-11;DK;Denmark;418;1;289919;2524
2021-06-12;DK;Denmark;439;2;290358;2526
2021-06-13;DK;Denmark;316;0;290674;2526
2021-06-14;DK;Denmark;238;1;290912;2527
2021-06-15;DK;Denmark;227;1;291139;2528
2021-06-16;DK;Denmark;353;0;291492;2528
2021-06-17;DK;Denmark;332;1;291824;2529
2021-06-18;DK;Denmark;205;0;292029;2529
2021-06-19;DK;Denmark;244;2;292273;2531
2021-06-20;DK;Denmark;194;0;292467;2531
2021-06-21;DK;Denmark;151;1;292618;2532
2021-06-22;DK;Denmark;157;0;292775;2532
2021-06-23;DK;Denmark;224;0;292999;2532
2021-06-24;DK;Denmark;173;0;293172;2532
2021-06-25;DK;Denmark;222;0;293394;2532
2021-06-26;DK;Denmark;196;0;293590;2532
2021-06-27;DK;Denmark;175;1;293765;2533
2021-06-28;DK;Denmark;151;1;293916;2534
2021-06-29;DK;Denmark;246;1;294162;2535
2021-06-30;DK;Denmark;341;0;294503;2535
2021-07-01;DK;Denmark;477;1;294980;2536
2020-03-18;DJ;Djibouti;1;0;1;0
2020-03-19;DJ;Djibouti;0;0;1;0
2020-03-20;DJ;Djibouti;0;0;1;0
2020-03-21;DJ;Djibouti;0;0;1;0
2020-03-22;DJ;Djibouti;0;0;1;0
2020-03-23;DJ;Djibouti;2;0;3;0
2020-03-24;DJ;Djibouti;0;0;3;0
2020-03-25;DJ;Djibouti;8;0;11;0
2020-03-26;DJ;Djibouti;0;0;11;0
2020-03-27;DJ;Djibouti;1;0;12;0
2020-03-28;DJ;Djibouti;2;0;14;0
2020-03-29;DJ;Djibouti;4;0;18;0
2020-03-30;DJ;Djibouti;0;0;18;0
2020-03-31;DJ;Djibouti;12;0;30;0
2020-04-01;DJ;Djibouti;3;0;33;0
2020-04-02;DJ;Djibouti;7;0;40;0
2020-04-03;DJ;Djibouti;9;0;49;0
2020-04-04;DJ;Djibouti;1;0;50;0
2020-04-05;DJ;Djibouti;9;0;59;0
2020-04-06;DJ;Djibouti;31;0;90;0
2020-04-07;DJ;Djibouti;0;0;90;0
2020-04-08;DJ;Djibouti;45;0;135;0
2020-04-09;DJ;Djibouti;0;0;135;0
2020-04-10;DJ;Djibouti;15;1;150;1
2020-04-11;DJ;Djibouti;37;1;187;2
2020-04-12;DJ;Djibouti;27;0;214;2
2020-04-13;DJ;Djibouti;84;0;298;2
2020-04-14;DJ;Djibouti;65;0;363;2
2020-04-15;DJ;Djibouti;72;0;435;2
2020-04-16;DJ;Djibouti;156;0;591;2
2020-04-17;DJ;Djibouti;141;0;732;2
2020-04-18;DJ;Djibouti;0;0;732;2
2020-04-19;DJ;Djibouti;114;0;846;2
2020-04-20;DJ;Djibouti;0;0;846;2
2020-04-21;DJ;Djibouti;99;0;945;2
2020-04-22;DJ;Djibouti;29;0;974;2
2020-04-23;DJ;Djibouti;12;0;986;2
2020-04-24;DJ;Djibouti;13;0;999;2
2020-04-25;DJ;Djibouti;9;0;1008;2
2020-04-26;DJ;Djibouti;15;0;1023;2
2020-04-27;DJ;Djibouti;12;0;1035;2
2020-04-28;DJ;Djibouti;37;0;1072;2
2020-04-29;DJ;Djibouti;5;0;1077;2
2020-04-30;DJ;Djibouti;12;0;1089;2
2020-05-01;DJ;Djibouti;8;0;1097;2
2020-05-02;DJ;Djibouti;15;0;1112;2
2020-05-03;DJ;Djibouti;0;0;1112;2
2020-05-04;DJ;Djibouti;4;0;1116;2
2020-05-05;DJ;Djibouti;4;0;1120;2
2020-05-06;DJ;Djibouti;4;1;1124;3
2020-05-07;DJ;Djibouti;9;0;1133;3
2020-05-08;DJ;Djibouti;2;0;1135;3
2020-05-09;DJ;Djibouti;54;0;1189;3
2020-05-10;DJ;Djibouti;21;0;1210;3
2020-05-11;DJ;Djibouti;17;0;1227;3
2020-05-12;DJ;Djibouti;29;0;1256;3
2020-05-13;DJ;Djibouti;12;0;1268;3
2020-05-14;DJ;Djibouti;16;0;1284;3
2020-05-15;DJ;Djibouti;25;1;1309;4
2020-05-16;DJ;Djibouti;22;0;1331;4
2020-05-17;DJ;Djibouti;70;0;1401;4
2020-05-18;DJ;Djibouti;117;3;1518;7
2020-05-19;DJ;Djibouti;100;0;1618;7
2020-05-20;DJ;Djibouti;210;2;1828;9
2020-05-21;DJ;Djibouti;219;1;2047;10
2020-05-22;DJ;Djibouti;223;0;2270;10
2020-05-23;DJ;Djibouti;0;0;2270;10
2020-05-24;DJ;Djibouti;0;0;2270;10
2020-05-25;DJ;Djibouti;198;4;2468;14
2020-05-26;DJ;Djibouti;0;0;2468;14
2020-05-27;DJ;Djibouti;229;4;2697;18
2020-05-28;DJ;Djibouti;217;2;2914;20
2020-05-29;DJ;Djibouti;0;0;2914;20
2020-05-30;DJ;Djibouti;280;2;3194;22
2020-05-31;DJ;Djibouti;160;2;3354;24
2020-06-01;DJ;Djibouti;215;0;3569;24
2020-06-02;DJ;Djibouti;210;1;3779;25
2020-06-03;DJ;Djibouti;156;1;3935;26
2020-06-04;DJ;Djibouti;119;0;4054;26
2020-06-05;DJ;Djibouti;69;0;4123;26
2020-06-06;DJ;Djibouti;46;0;4169;26
2020-06-07;DJ;Djibouti;38;2;4207;28
2020-06-08;DJ;Djibouti;71;3;4278;31
2020-06-09;DJ;Djibouti;53;3;4331;34
2020-06-10;DJ;Djibouti;42;0;4373;34
2020-06-11;DJ;Djibouti;25;3;4398;37
2020-06-12;DJ;Djibouti;43;1;4441;38
2020-06-13;DJ;Djibouti;8;3;4449;41
2020-06-14;DJ;Djibouti;16;2;4465;43
2020-06-15;DJ;Djibouti;36;0;4501;43
2020-06-16;DJ;Djibouti;38;0;4539;43
2020-06-17;DJ;Djibouti;6;0;4545;43
2020-06-18;DJ;Djibouti;12;0;4557;43
2020-06-19;DJ;Djibouti;8;2;4565;45
2020-06-20;DJ;Djibouti;0;0;4565;45
2020-06-21;DJ;Djibouti;17;0;4582;45
2020-06-22;DJ;Djibouti;17;3;4599;48
2020-06-23;DJ;Djibouti;18;1;4617;49
2020-06-24;DJ;Djibouti;13;3;4630;52
2020-06-25;DJ;Djibouti;5;0;4635;52
2020-06-26;DJ;Djibouti;8;0;4643;52
2020-06-27;DJ;Djibouti;0;0;4643;52
2020-06-28;DJ;Djibouti;0;0;4643;52
2020-06-29;DJ;Djibouti;13;1;4656;53
2020-06-30;DJ;Djibouti;26;1;4682;54
2020-07-01;DJ;Djibouti;22;1;4704;55
2020-07-02;DJ;Djibouti;11;0;4715;55
2020-07-03;DJ;Djibouti;21;0;4736;55
2020-07-04;DJ;Djibouti;0;0;4736;55
2020-07-05;DJ;Djibouti;56;0;4792;55
2020-07-06;DJ;Djibouti;30;0;4822;55
2020-07-07;DJ;Djibouti;56;0;4878;55
2020-07-08;DJ;Djibouti;11;0;4889;55
2020-07-09;DJ;Djibouti;66;1;4955;56
2020-07-10;DJ;Djibouti;13;0;4968;56
2020-07-11;DJ;Djibouti;0;0;4968;56
2020-07-12;DJ;Djibouti;4;0;4972;56
2020-07-13;DJ;Djibouti;5;0;4977;56
2020-07-14;DJ;Djibouti;2;0;4979;56
2020-07-15;DJ;Djibouti;6;0;4985;56
2020-07-16;DJ;Djibouti;8;0;4993;56
2020-07-17;DJ;Djibouti;10;0;5003;56
2020-07-18;DJ;Djibouti;0;0;5003;56
2020-07-19;DJ;Djibouti;8;0;5011;56
2020-07-20;DJ;Djibouti;9;0;5020;56
2020-07-21;DJ;Djibouti;7;0;5027;56
2020-07-22;DJ;Djibouti;3;2;5030;58
2020-07-23;DJ;Djibouti;1;0;5031;58
2020-07-24;DJ;Djibouti;8;0;5039;58
2020-07-25;DJ;Djibouti;0;0;5039;58
2020-07-26;DJ;Djibouti;11;0;5050;58
2020-07-27;DJ;Djibouti;9;0;5059;58
2020-07-28;DJ;Djibouti;9;0;5068;58
2020-07-29;DJ;Djibouti;13;0;5081;58
2020-07-30;DJ;Djibouti;0;0;5081;58
2020-07-31;DJ;Djibouti;3;0;5084;58
2020-08-01;DJ;Djibouti;0;0;5084;58
2020-08-02;DJ;Djibouti;77;1;5161;59
2020-08-03;DJ;Djibouti;79;0;5240;59
2020-08-04;DJ;Djibouti;8;0;5248;59
2020-08-05;DJ;Djibouti;82;0;5330;59
2020-08-06;DJ;Djibouti;0;0;5330;59
2020-08-07;DJ;Djibouti;8;0;5338;59
2020-08-08;DJ;Djibouti;0;0;5338;59
2020-08-09;DJ;Djibouti;6;0;5344;59
2020-08-10;DJ;Djibouti;3;0;5347;59
2020-08-11;DJ;Djibouti;1;0;5348;59
2020-08-12;DJ;Djibouti;10;0;5358;59
2020-08-13;DJ;Djibouti;0;0;5358;59
2020-08-14;DJ;Djibouti;9;0;5367;59
2020-08-15;DJ;Djibouti;0;0;5367;59
2020-08-16;DJ;Djibouti;2;0;5369;59
2020-08-17;DJ;Djibouti;3;0;5372;59
2020-08-18;DJ;Djibouti;2;0;5374;59
2020-08-19;DJ;Djibouti;0;0;5374;59
2020-08-20;DJ;Djibouti;0;0;5374;59
2020-08-21;DJ;Djibouti;8;1;5382;60
2020-08-22;DJ;Djibouti;0;0;5382;60
2020-08-23;DJ;Djibouti;0;0;5382;60
2020-08-24;DJ;Djibouti;1;0;5383;60
2020-08-25;DJ;Djibouti;0;0;5383;60
2020-08-26;DJ;Djibouti;0;0;5383;60
2020-08-27;DJ;Djibouti;0;0;5383;60
2020-08-28;DJ;Djibouti;0;0;5383;60
2020-08-29;DJ;Djibouti;2;0;5385;60
2020-08-30;DJ;Djibouti;0;0;5385;60
2020-08-31;DJ;Djibouti;2;0;5387;60
2020-09-01;DJ;Djibouti;0;0;5387;60
2020-09-02;DJ;Djibouti;0;0;5387;60
2020-09-03;DJ;Djibouti;0;0;5387;60
2020-09-04;DJ;Djibouti;0;0;5387;60
2020-09-05;DJ;Djibouti;0;0;5387;60
2020-09-06;DJ;Djibouti;1;1;5388;61
2020-09-07;DJ;Djibouti;0;0;5388;61
2020-09-08;DJ;Djibouti;0;0;5388;61
2020-09-09;DJ;Djibouti;3;0;5391;61
2020-09-10;DJ;Djibouti;3;0;5394;61
2020-09-11;DJ;Djibouti;0;0;5394;61
2020-09-12;DJ;Djibouti;0;0;5394;61
2020-09-13;DJ;Djibouti;1;0;5395;61
2020-09-14;DJ;Djibouti;1;0;5396;61
2020-09-15;DJ;Djibouti;0;0;5396;61
2020-09-16;DJ;Djibouti;3;0;5399;61
2020-09-17;DJ;Djibouti;0;0;5399;61
2020-09-18;DJ;Djibouti;4;0;5403;61
2020-09-19;DJ;Djibouti;0;0;5403;61
2020-09-20;DJ;Djibouti;0;0;5403;61
2020-09-21;DJ;Djibouti;1;0;5404;61
2020-09-22;DJ;Djibouti;3;0;5407;61
2020-09-23;DJ;Djibouti;0;0;5407;61
2020-09-24;DJ;Djibouti;0;0;5407;61
2020-09-25;DJ;Djibouti;2;0;5409;61
2020-09-26;DJ;Djibouti;0;0;5409;61
2020-09-27;DJ;Djibouti;0;0;5409;61
2020-09-28;DJ;Djibouti;1;0;5410;61
2020-09-29;DJ;Djibouti;6;0;5416;61
2020-09-30;DJ;Djibouti;0;0;5416;61
2020-10-01;DJ;Djibouti;1;0;5417;61
2020-10-02;DJ;Djibouti;0;0;5417;61
2020-10-03;DJ;Djibouti;1;0;5418;61
2020-10-04;DJ;Djibouti;1;0;5419;61
2020-10-05;DJ;Djibouti;2;0;5421;61
2020-10-06;DJ;Djibouti;2;0;5423;61
2020-10-07;DJ;Djibouti;0;0;5423;61
2020-10-08;DJ;Djibouti;0;0;5423;61
2020-10-09;DJ;Djibouti;0;0;5423;61
2020-10-10;DJ;Djibouti;0;0;5423;61
2020-10-11;DJ;Djibouti;0;0;5423;61
2020-10-12;DJ;Djibouti;3;0;5426;61
2020-10-13;DJ;Djibouti;2;0;5428;61
2020-10-14;DJ;Djibouti;12;0;5440;61
2020-10-15;DJ;Djibouti;3;0;5443;61
2020-10-16;DJ;Djibouti;6;0;5449;61
2020-10-17;DJ;Djibouti;3;0;5452;61
2020-10-18;DJ;Djibouti;7;0;5459;61
2020-10-19;DJ;Djibouti;10;0;5469;61
2020-10-20;DJ;Djibouti;30;0;5499;61
2020-10-21;DJ;Djibouti;13;0;5512;61
2020-10-22;DJ;Djibouti;10;0;5522;61
2020-10-23;DJ;Djibouti;6;0;5528;61
2020-10-24;DJ;Djibouti;2;0;5530;61
2020-10-25;DJ;Djibouti;6;0;5536;61
2020-10-26;DJ;Djibouti;5;0;5541;61
2020-10-27;DJ;Djibouti;3;0;5544;61
2020-10-28;DJ;Djibouti;11;0;5555;61
2020-10-29;DJ;Djibouti;3;0;5558;61
2020-10-30;DJ;Djibouti;1;0;5559;61
2020-10-31;DJ;Djibouti;2;0;5561;61
2020-11-01;DJ;Djibouti;2;0;5563;61
2020-11-02;DJ;Djibouti;10;0;5573;61
2020-11-03;DJ;Djibouti;2;0;5575;61
2020-11-04;DJ;Djibouti;5;0;5580;61
2020-11-05;DJ;Djibouti;19;0;5599;61
2020-11-06;DJ;Djibouti;5;0;5604;61
2020-11-07;DJ;Djibouti;1;0;5605;61
2020-11-08;DJ;Djibouti;3;0;5608;61
2020-11-09;DJ;Djibouti;19;0;5627;61
2020-11-10;DJ;Djibouti;6;0;5633;61
2020-11-11;DJ;Djibouti;2;0;5635;61
2020-11-12;DJ;Djibouti;6;0;5641;61
2020-11-13;DJ;Djibouti;0;0;5641;61
2020-11-14;DJ;Djibouti;4;0;5645;61
2020-11-15;DJ;Djibouti;4;0;5649;61
2020-11-16;DJ;Djibouti;6;0;5655;61
2020-11-17;DJ;Djibouti;1;0;5656;61
2020-11-18;DJ;Djibouti;2;0;5658;61
2020-11-19;DJ;Djibouti;0;0;5658;61
2020-11-20;DJ;Djibouti;2;0;5660;61
2020-11-21;DJ;Djibouti;1;0;5661;61
2020-11-22;DJ;Djibouti;7;0;5668;61
2020-11-23;DJ;Djibouti;0;0;5668;61
2020-11-24;DJ;Djibouti;1;0;5669;61
2020-11-25;DJ;Djibouti;1;0;5670;61
2020-11-26;DJ;Djibouti;6;0;5676;61
2020-11-27;DJ;Djibouti;0;0;5676;61
2020-11-28;DJ;Djibouti;0;0;5676;61
2020-11-29;DJ;Djibouti;1;0;5677;61
2020-11-30;DJ;Djibouti;2;0;5679;61
2020-12-01;DJ;Djibouti;1;0;5680;61
2020-12-02;DJ;Djibouti;2;0;5682;61
2020-12-03;DJ;Djibouti;7;0;5689;61
2020-12-04;DJ;Djibouti;1;0;5690;61
2020-12-05;DJ;Djibouti;2;0;5692;61
2020-12-06;DJ;Djibouti;9;0;5701;61
2020-12-07;DJ;Djibouti;7;0;5708;61
2020-12-08;DJ;Djibouti;6;0;5714;61
2020-12-09;DJ;Djibouti;3;0;5717;61
2020-12-10;DJ;Djibouti;0;0;5717;61
2020-12-11;DJ;Djibouti;4;0;5721;61
2020-12-12;DJ;Djibouti;4;0;5725;61
2020-12-13;DJ;Djibouti;3;0;5728;61
2020-12-14;DJ;Djibouti;5;0;5733;61
2020-12-15;DJ;Djibouti;16;0;5749;61
2020-12-16;DJ;Djibouti;10;0;5759;61
2020-12-17;DJ;Djibouti;11;0;5770;61
2020-12-18;DJ;Djibouti;10;0;5780;61
2020-12-19;DJ;Djibouti;1;0;5781;61
2020-12-20;DJ;Djibouti;0;0;5781;61
2020-12-21;DJ;Djibouti;2;0;5783;61
2020-12-22;DJ;Djibouti;3;0;5786;61
2020-12-23;DJ;Djibouti;3;0;5789;61
2020-12-24;DJ;Djibouti;11;0;5800;61
2020-12-25;DJ;Djibouti;4;0;5804;61
2020-12-26;DJ;Djibouti;1;0;5805;61
2020-12-27;DJ;Djibouti;8;0;5813;61
2020-12-28;DJ;Djibouti;0;0;5813;61
2020-12-29;DJ;Djibouti;0;0;5813;61
2020-12-30;DJ;Djibouti;11;0;5824;61
2020-12-31;DJ;Djibouti;7;0;5831;61
2021-01-01;DJ;Djibouti;9;0;5840;61
2021-01-02;DJ;Djibouti;1;0;5841;61
2021-01-03;DJ;Djibouti;1;0;5842;61
2021-01-04;DJ;Djibouti;4;0;5846;61
2021-01-05;DJ;Djibouti;8;0;5854;61
2021-01-06;DJ;Djibouti;1;0;5855;61
2021-01-07;DJ;Djibouti;2;0;5857;61
2021-01-08;DJ;Djibouti;8;0;5865;61
2021-01-09;DJ;Djibouti;1;0;5866;61
2021-01-10;DJ;Djibouti;5;0;5871;61
2021-01-11;DJ;Djibouti;6;0;5877;61
2021-01-12;DJ;Djibouti;2;0;5879;61
2021-01-13;DJ;Djibouti;12;0;5891;61
2021-01-14;DJ;Djibouti;9;0;5900;61
2021-01-15;DJ;Djibouti;3;0;5903;61
2021-01-16;DJ;Djibouti;0;0;5903;61
2021-01-17;DJ;Djibouti;2;0;5905;61
2021-01-18;DJ;Djibouti;0;0;5905;61
2021-01-19;DJ;Djibouti;5;0;5910;61
2021-01-20;DJ;Djibouti;3;0;5913;61
2021-01-21;DJ;Djibouti;3;0;5916;61
2021-01-22;DJ;Djibouti;1;0;5917;61
2021-01-23;DJ;Djibouti;1;0;5918;61
2021-01-24;DJ;Djibouti;1;0;5919;61
2021-01-25;DJ;Djibouti;1;0;5920;61
2021-01-26;DJ;Djibouti;3;1;5923;62
2021-01-27;DJ;Djibouti;3;0;5926;62
2021-01-28;DJ;Djibouti;3;0;5929;62
2021-01-29;DJ;Djibouti;1;0;5930;62
2021-01-30;DJ;Djibouti;1;0;5931;62
2021-01-31;DJ;Djibouti;1;1;5932;63
2021-02-01;DJ;Djibouti;0;0;5932;63
2021-02-02;DJ;Djibouti;3;0;5935;63
2021-02-03;DJ;Djibouti;1;0;5936;63
2021-02-04;DJ;Djibouti;0;0;5936;63
2021-02-05;DJ;Djibouti;5;0;5941;63
2021-02-06;DJ;Djibouti;0;0;5941;63
2021-02-07;DJ;Djibouti;6;0;5947;63
2021-02-08;DJ;Djibouti;3;0;5950;63
2021-02-09;DJ;Djibouti;9;0;5959;63
2021-02-10;DJ;Djibouti;3;0;5962;63
2021-02-11;DJ;Djibouti;4;0;5966;63
2021-02-12;DJ;Djibouti;1;0;5967;63
2021-02-13;DJ;Djibouti;1;0;5968;63
2021-02-14;DJ;Djibouti;3;0;5971;63
2021-02-15;DJ;Djibouti;9;0;5980;63
2021-02-16;DJ;Djibouti;1;0;5981;63
2021-02-17;DJ;Djibouti;25;0;6006;63
2021-02-18;DJ;Djibouti;2;0;6008;63
2021-02-19;DJ;Djibouti;14;0;6022;63
2021-02-20;DJ;Djibouti;0;0;6022;63
2021-02-21;DJ;Djibouti;2;0;6024;63
2021-02-22;DJ;Djibouti;2;0;6026;63
2021-02-23;DJ;Djibouti;26;0;6052;63
2021-02-24;DJ;Djibouti;0;0;6052;63
2021-02-25;DJ;Djibouti;8;0;6060;63
2021-02-26;DJ;Djibouti;2;0;6062;63
2021-02-27;DJ;Djibouti;3;0;6065;63
2021-02-28;DJ;Djibouti;1;0;6066;63
2021-03-01;DJ;Djibouti;21;0;6087;63
2021-03-02;DJ;Djibouti;2;0;6089;63
2021-03-03;DJ;Djibouti;13;0;6102;63
2021-03-04;DJ;Djibouti;8;0;6110;63
2021-03-05;DJ;Djibouti;20;0;6130;63
2021-03-06;DJ;Djibouti;4;0;6134;63
2021-03-07;DJ;Djibouti;12;0;6146;63
2021-03-08;DJ;Djibouti;11;0;6157;63
2021-03-09;DJ;Djibouti;24;0;6181;63
2021-03-10;DJ;Djibouti;46;0;6227;63
2021-03-11;DJ;Djibouti;7;0;6234;63
2021-03-12;DJ;Djibouti;2;0;6236;63
2021-03-13;DJ;Djibouti;16;0;6252;63
2021-03-14;DJ;Djibouti;16;0;6268;63
2021-03-15;DJ;Djibouti;26;0;6294;63
2021-03-16;DJ;Djibouti;42;0;6336;63
2021-03-17;DJ;Djibouti;49;0;6385;63
2021-03-18;DJ;Djibouti;67;0;6452;63
2021-03-19;DJ;Djibouti;49;0;6501;63
2021-03-20;DJ;Djibouti;17;0;6518;63
2021-03-21;DJ;Djibouti;70;1;6588;64
2021-03-22;DJ;Djibouti;70;0;6658;64
2021-03-23;DJ;Djibouti;113;0;6771;64
2021-03-24;DJ;Djibouti;124;0;6895;64
2021-03-25;DJ;Djibouti;121;0;7016;64
2021-03-26;DJ;Djibouti;153;2;7169;66
2021-03-27;DJ;Djibouti;80;0;7249;66
2021-03-28;DJ;Djibouti;112;1;7361;67
2021-03-29;DJ;Djibouti;249;1;7610;68
2021-03-30;DJ;Djibouti;180;1;7790;69
2021-03-31;DJ;Djibouti;212;1;8002;70
2021-04-01;DJ;Djibouti;178;1;8180;71
2021-04-02;DJ;Djibouti;251;1;8431;72
2021-04-03;DJ;Djibouti;78;0;8509;72
2021-04-04;DJ;Djibouti;0;0;8509;72
2021-04-05;DJ;Djibouti;187;4;8696;76
2021-04-06;DJ;Djibouti;415;9;9111;85
2021-04-07;DJ;Djibouti;195;5;9306;90
2021-04-08;DJ;Djibouti;173;2;9479;92
2021-04-09;DJ;Djibouti;183;2;9662;94
2021-04-10;DJ;Djibouti;60;0;9722;94
2021-04-11;DJ;Djibouti;154;2;9876;96
2021-04-12;DJ;Djibouti;99;4;9975;100
2021-04-13;DJ;Djibouti;102;2;10077;102
2021-04-14;DJ;Djibouti;125;4;10202;106
2021-04-15;DJ;Djibouti;73;4;10275;110
2021-04-16;DJ;Djibouti;110;0;10385;110
2021-04-17;DJ;Djibouti;27;4;10412;114
2021-04-18;DJ;Djibouti;48;2;10460;116
2021-04-19;DJ;Djibouti;50;3;10510;119
2021-04-20;DJ;Djibouti;47;4;10557;123
2021-04-21;DJ;Djibouti;76;6;10633;129
2021-04-22;DJ;Djibouti;64;1;10697;130
2021-04-23;DJ;Djibouti;41;2;10738;132
2021-04-24;DJ;Djibouti;8;0;10746;132
2021-04-25;DJ;Djibouti;56;4;10802;136
2021-04-26;DJ;Djibouti;83;2;10885;138
2021-04-27;DJ;Djibouti;46;4;10931;142
2021-04-28;DJ;Djibouti;55;0;10986;142
2021-04-29;DJ;Djibouti;40;1;11026;143
2021-04-30;DJ;Djibouti;74;0;11100;143
2021-05-01;DJ;Djibouti;21;2;11121;145
2021-05-02;DJ;Djibouti;36;1;11157;146
2021-05-03;DJ;Djibouti;44;0;11201;146
2021-05-04;DJ;Djibouti;46;1;11247;147
2021-05-05;DJ;Djibouti;21;0;11268;147
2021-05-06;DJ;Djibouti;39;1;11307;148
2021-05-07;DJ;Djibouti;12;0;11319;148
2021-05-08;DJ;Djibouti;16;1;11335;149
2021-05-09;DJ;Djibouti;0;0;11335;149
2021-05-10;DJ;Djibouti;20;0;11355;149
2021-05-11;DJ;Djibouti;14;2;11369;151
2021-05-12;DJ;Djibouti;20;0;11389;151
2021-05-13;DJ;Djibouti;0;0;11389;151
2021-05-14;DJ;Djibouti;13;0;11402;151
2021-05-15;DJ;Djibouti;12;0;11414;151
2021-05-16;DJ;Djibouti;20;0;11434;151
2021-05-17;DJ;Djibouti;0;0;11434;151
2021-05-18;DJ;Djibouti;21;0;11455;151
2021-05-19;DJ;Djibouti;13;1;11468;152
2021-05-20;DJ;Djibouti;17;0;11485;152
2021-05-21;DJ;Djibouti;5;0;11490;152
2021-05-22;DJ;Djibouti;1;0;11491;152
2021-05-23;DJ;Djibouti;2;1;11493;153
2021-05-24;DJ;Djibouti;9;0;11502;153
2021-05-25;DJ;Djibouti;5;0;11507;153
2021-05-26;DJ;Djibouti;7;0;11514;153
2021-05-27;DJ;Djibouti;9;0;11523;153
2021-05-28;DJ;Djibouti;0;0;11523;153
2021-05-29;DJ;Djibouti;0;0;11523;153
2021-05-30;DJ;Djibouti;5;1;11528;154
2021-05-31;DJ;Djibouti;5;0;11533;154
2021-06-01;DJ;Djibouti;4;0;11537;154
2021-06-02;DJ;Djibouti;5;0;11542;154
2021-06-03;DJ;Djibouti;2;0;11544;154
2021-06-04;DJ;Djibouti;10;0;11554;154
2021-06-05;DJ;Djibouti;2;0;11556;154
2021-06-06;DJ;Djibouti;6;0;11562;154
2021-06-07;DJ;Djibouti;3;0;11565;154
2021-06-08;DJ;Djibouti;1;0;11566;154
2021-06-09;DJ;Djibouti;1;0;11567;154
2021-06-10;DJ;Djibouti;3;0;11570;154
2021-06-11;DJ;Djibouti;1;0;11571;154
2021-06-12;DJ;Djibouti;1;0;11572;154
2021-06-13;DJ;Djibouti;0;0;11572;154
2021-06-14;DJ;Djibouti;3;0;11575;154
2021-06-15;DJ;Djibouti;0;0;11575;154
2021-06-16;DJ;Djibouti;2;0;11577;154
2021-06-17;DJ;Djibouti;8;0;11585;154
2021-06-18;DJ;Djibouti;1;0;11586;154
2021-06-19;DJ;Djibouti;1;1;11587;155
2021-06-20;DJ;Djibouti;0;0;11587;155
2021-06-21;DJ;Djibouti;4;0;11591;155
2021-06-22;DJ;Djibouti;4;0;11595;155
2021-06-23;DJ;Djibouti;2;0;11597;155
2021-06-24;DJ;Djibouti;0;0;11597;155
2021-06-25;DJ;Djibouti;3;0;11600;155
2021-06-26;DJ;Djibouti;0;0;11600;155
2021-06-27;DJ;Djibouti;1;0;11601;155
2021-06-28;DJ;Djibouti;0;0;11601;155
2021-06-29;DJ;Djibouti;1;0;11602;155
2021-06-30;DJ;Djibouti;0;0;11602;155
2021-07-01;DJ;Djibouti;0;0;11602;155
2020-03-22;DM;Dominica;1;0;1;0
2020-03-23;DM;Dominica;1;0;2;0
2020-03-24;DM;Dominica;0;0;2;0
2020-03-25;DM;Dominica;5;0;7;0
2020-03-26;DM;Dominica;4;0;11;0
2020-03-27;DM;Dominica;0;0;11;0
2020-03-28;DM;Dominica;0;0;11;0
2020-03-29;DM;Dominica;0;0;11;0
2020-03-30;DM;Dominica;0;0;11;0
2020-03-31;DM;Dominica;1;0;12;0
2020-04-01;DM;Dominica;0;0;12;0
2020-04-02;DM;Dominica;0;0;12;0
2020-04-03;DM;Dominica;0;0;12;0
2020-04-04;DM;Dominica;2;0;14;0
2020-04-05;DM;Dominica;0;0;14;0
2020-04-06;DM;Dominica;1;0;15;0
2020-04-07;DM;Dominica;0;0;15;0
2020-04-08;DM;Dominica;0;0;15;0
2020-04-09;DM;Dominica;0;0;15;0
2020-04-10;DM;Dominica;1;0;16;0
2020-04-11;DM;Dominica;0;0;16;0
2020-04-12;DM;Dominica;0;0;16;0
2020-04-13;DM;Dominica;0;0;16;0
2020-04-14;DM;Dominica;0;0;16;0
2020-04-15;DM;Dominica;0;0;16;0
2020-04-16;DM;Dominica;0;0;16;0
2020-04-17;DM;Dominica;0;0;16;0
2020-04-18;DM;Dominica;0;0;16;0
2020-04-19;DM;Dominica;0;0;16;0
2020-04-20;DM;Dominica;0;0;16;0
2020-04-21;DM;Dominica;0;0;16;0
2020-04-22;DM;Dominica;0;0;16;0
2020-04-23;DM;Dominica;0;0;16;0
2020-04-24;DM;Dominica;0;0;16;0
2020-04-25;DM;Dominica;0;0;16;0
2020-04-26;DM;Dominica;0;0;16;0
2020-04-27;DM;Dominica;0;0;16;0
2020-04-28;DM;Dominica;0;0;16;0
2020-04-29;DM;Dominica;0;0;16;0
2020-04-30;DM;Dominica;0;0;16;0
2020-05-01;DM;Dominica;0;0;16;0
2020-05-02;DM;Dominica;0;0;16;0
2020-05-03;DM;Dominica;0;0;16;0
2020-05-04;DM;Dominica;0;0;16;0
2020-05-05;DM;Dominica;0;0;16;0
2020-05-06;DM;Dominica;0;0;16;0
2020-05-07;DM;Dominica;0;0;16;0
2020-05-08;DM;Dominica;0;0;16;0
2020-05-09;DM;Dominica;0;0;16;0
2020-05-10;DM;Dominica;0;0;16;0
2020-05-11;DM;Dominica;0;0;16;0
2020-05-12;DM;Dominica;0;0;16;0
2020-05-13;DM;Dominica;0;0;16;0
2020-05-14;DM;Dominica;0;0;16;0
2020-05-15;DM;Dominica;0;0;16;0
2020-05-16;DM;Dominica;0;0;16;0
2020-05-17;DM;Dominica;0;0;16;0
2020-05-18;DM;Dominica;0;0;16;0
2020-05-19;DM;Dominica;0;0;16;0
2020-05-20;DM;Dominica;0;0;16;0
2020-05-21;DM;Dominica;0;0;16;0
2020-05-22;DM;Dominica;0;0;16;0
2020-05-23;DM;Dominica;0;0;16;0
2020-05-24;DM;Dominica;0;0;16;0
2020-05-25;DM;Dominica;0;0;16;0
2020-05-26;DM;Dominica;0;0;16;0
2020-05-27;DM;Dominica;0;0;16;0
2020-05-28;DM;Dominica;0;0;16;0
2020-05-29;DM;Dominica;0;0;16;0
2020-05-30;DM;Dominica;0;0;16;0
2020-05-31;DM;Dominica;0;0;16;0
2020-06-01;DM;Dominica;0;0;16;0
2020-06-02;DM;Dominica;2;0;18;0
2020-06-03;DM;Dominica;0;0;18;0
2020-06-04;DM;Dominica;0;0;18;0
2020-06-05;DM;Dominica;0;0;18;0
2020-06-06;DM;Dominica;0;0;18;0
2020-06-07;DM;Dominica;0;0;18;0
2020-06-08;DM;Dominica;0;0;18;0
2020-06-09;DM;Dominica;0;0;18;0
2020-06-10;DM;Dominica;0;0;18;0
2020-06-11;DM;Dominica;0;0;18;0
2020-06-12;DM;Dominica;0;0;18;0
2020-06-13;DM;Dominica;0;0;18;0
2020-06-14;DM;Dominica;0;0;18;0
2020-06-15;DM;Dominica;0;0;18;0
2020-06-16;DM;Dominica;0;0;18;0
2020-06-17;DM;Dominica;0;0;18;0
2020-06-18;DM;Dominica;0;0;18;0
2020-06-19;DM;Dominica;0;0;18;0
2020-06-20;DM;Dominica;0;0;18;0
2020-06-21;DM;Dominica;0;0;18;0
2020-06-22;DM;Dominica;0;0;18;0
2020-06-23;DM;Dominica;0;0;18;0
2020-06-24;DM;Dominica;0;0;18;0
2020-06-25;DM;Dominica;0;0;18;0
2020-06-26;DM;Dominica;0;0;18;0
2020-06-27;DM;Dominica;0;0;18;0
2020-06-28;DM;Dominica;0;0;18;0
2020-06-29;DM;Dominica;0;0;18;0
2020-06-30;DM;Dominica;0;0;18;0
2020-07-01;DM;Dominica;0;0;18;0
2020-07-02;DM;Dominica;0;0;18;0
2020-07-03;DM;Dominica;0;0;18;0
2020-07-04;DM;Dominica;0;0;18;0
2020-07-05;DM;Dominica;0;0;18;0
2020-07-06;DM;Dominica;0;0;18;0
2020-07-07;DM;Dominica;0;0;18;0
2020-07-08;DM;Dominica;0;0;18;0
2020-07-09;DM;Dominica;0;0;18;0
2020-07-10;DM;Dominica;0;0;18;0
2020-07-11;DM;Dominica;0;0;18;0
2020-07-12;DM;Dominica;0;0;18;0
2020-07-13;DM;Dominica;0;0;18;0
2020-07-14;DM;Dominica;0;0;18;0
2020-07-15;DM;Dominica;0;0;18;0
2020-07-16;DM;Dominica;0;0;18;0
2020-07-17;DM;Dominica;0;0;18;0
2020-07-18;DM;Dominica;0;0;18;0
2020-07-19;DM;Dominica;0;0;18;0
2020-07-20;DM;Dominica;0;0;18;0
2020-07-21;DM;Dominica;0;0;18;0
2020-07-22;DM;Dominica;0;0;18;0
2020-07-23;DM;Dominica;0;0;18;0
2020-07-24;DM;Dominica;0;0;18;0
2020-07-25;DM;Dominica;0;0;18;0
2020-07-26;DM;Dominica;0;0;18;0
2020-07-27;DM;Dominica;0;0;18;0
2020-07-28;DM;Dominica;0;0;18;0
2020-07-29;DM;Dominica;0;0;18;0
2020-07-30;DM;Dominica;0;0;18;0
2020-07-31;DM;Dominica;0;0;18;0
2020-08-01;DM;Dominica;0;0;18;0
2020-08-02;DM;Dominica;0;0;18;0
2020-08-03;DM;Dominica;0;0;18;0
2020-08-04;DM;Dominica;0;0;18;0
2020-08-05;DM;Dominica;0;0;18;0
2020-08-06;DM;Dominica;0;0;18;0
2020-08-07;DM;Dominica;0;0;18;0
2020-08-08;DM;Dominica;0;0;18;0
2020-08-09;DM;Dominica;0;0;18;0
2020-08-10;DM;Dominica;0;0;18;0
2020-08-11;DM;Dominica;0;0;18;0
2020-08-12;DM;Dominica;0;0;18;0
2020-08-13;DM;Dominica;0;0;18;0
2020-08-14;DM;Dominica;0;0;18;0
2020-08-15;DM;Dominica;0;0;18;0
2020-08-16;DM;Dominica;0;0;18;0
2020-08-17;DM;Dominica;0;0;18;0
2020-08-18;DM;Dominica;0;0;18;0
2020-08-19;DM;Dominica;0;0;18;0
2020-08-20;DM;Dominica;0;0;18;0
2020-08-21;DM;Dominica;0;0;18;0
2020-08-22;DM;Dominica;1;0;19;0
2020-08-23;DM;Dominica;0;0;19;0
2020-08-24;DM;Dominica;1;0;20;0
2020-08-25;DM;Dominica;0;0;20;0
2020-08-26;DM;Dominica;0;0;20;0
2020-08-27;DM;Dominica;0;0;20;0
2020-08-28;DM;Dominica;0;0;20;0
2020-08-29;DM;Dominica;0;0;20;0
2020-08-30;DM;Dominica;0;0;20;0
2020-08-31;DM;Dominica;0;0;20;0
2020-09-01;DM;Dominica;0;0;20;0
2020-09-02;DM;Dominica;0;0;20;0
2020-09-03;DM;Dominica;0;0;20;0
2020-09-04;DM;Dominica;0;0;20;0
2020-09-05;DM;Dominica;2;0;22;0
2020-09-06;DM;Dominica;0;0;22;0
2020-09-07;DM;Dominica;0;0;22;0
2020-09-08;DM;Dominica;0;0;22;0
2020-09-09;DM;Dominica;0;0;22;0
2020-09-10;DM;Dominica;2;0;24;0
2020-09-11;DM;Dominica;0;0;24;0
2020-09-12;DM;Dominica;0;0;24;0
2020-09-13;DM;Dominica;0;0;24;0
2020-09-14;DM;Dominica;0;0;24;0
2020-09-15;DM;Dominica;0;0;24;0
2020-09-16;DM;Dominica;0;0;24;0
2020-09-17;DM;Dominica;0;0;24;0
2020-09-18;DM;Dominica;0;0;24;0
2020-09-19;DM;Dominica;0;0;24;0
2020-09-20;DM;Dominica;0;0;24;0
2020-09-21;DM;Dominica;0;0;24;0
2020-09-22;DM;Dominica;0;0;24;0
2020-09-23;DM;Dominica;0;0;24;0
2020-09-24;DM;Dominica;0;0;24;0
2020-09-25;DM;Dominica;0;0;24;0
2020-09-26;DM;Dominica;0;0;24;0
2020-09-27;DM;Dominica;6;0;30;0
2020-09-28;DM;Dominica;0;0;30;0
2020-09-29;DM;Dominica;0;0;30;0
2020-09-30;DM;Dominica;0;0;30;0
2020-10-01;DM;Dominica;1;0;31;0
2020-10-02;DM;Dominica;0;0;31;0
2020-10-03;DM;Dominica;0;0;31;0
2020-10-04;DM;Dominica;0;0;31;0
2020-10-05;DM;Dominica;0;0;31;0
2020-10-06;DM;Dominica;0;0;31;0
2020-10-07;DM;Dominica;0;0;31;0
2020-10-08;DM;Dominica;0;0;31;0
2020-10-09;DM;Dominica;1;0;32;0
2020-10-10;DM;Dominica;0;0;32;0
2020-10-11;DM;Dominica;0;0;32;0
2020-10-12;DM;Dominica;0;0;32;0
2020-10-13;DM;Dominica;0;0;32;0
2020-10-14;DM;Dominica;0;0;32;0
2020-10-15;DM;Dominica;1;0;33;0
2020-10-16;DM;Dominica;0;0;33;0
2020-10-17;DM;Dominica;0;0;33;0
2020-10-18;DM;Dominica;0;0;33;0
2020-10-19;DM;Dominica;0;0;33;0
2020-10-20;DM;Dominica;0;0;33;0
2020-10-21;DM;Dominica;0;0;33;0
2020-10-22;DM;Dominica;0;0;33;0
2020-10-23;DM;Dominica;4;0;37;0
2020-10-24;DM;Dominica;1;0;38;0
2020-10-25;DM;Dominica;0;0;38;0
2020-10-26;DM;Dominica;0;0;38;0
2020-10-27;DM;Dominica;0;0;38;0
2020-10-28;DM;Dominica;0;0;38;0
2020-10-29;DM;Dominica;0;0;38;0
2020-10-30;DM;Dominica;4;0;42;0
2020-10-31;DM;Dominica;8;0;50;0
2020-11-01;DM;Dominica;0;0;50;0
2020-11-02;DM;Dominica;0;0;50;0
2020-11-03;DM;Dominica;0;0;50;0
2020-11-04;DM;Dominica;0;0;50;0
2020-11-05;DM;Dominica;7;0;57;0
2020-11-06;DM;Dominica;0;0;57;0
2020-11-07;DM;Dominica;6;0;63;0
2020-11-08;DM;Dominica;0;0;63;0
2020-11-09;DM;Dominica;0;0;63;0
2020-11-10;DM;Dominica;0;0;63;0
2020-11-11;DM;Dominica;5;0;68;0
2020-11-12;DM;Dominica;0;0;68;0
2020-11-13;DM;Dominica;0;0;68;0
2020-11-14;DM;Dominica;0;0;68;0
2020-11-15;DM;Dominica;0;0;68;0
2020-11-16;DM;Dominica;0;0;68;0
2020-11-17;DM;Dominica;0;0;68;0
2020-11-18;DM;Dominica;0;0;68;0
2020-11-19;DM;Dominica;0;0;68;0
2020-11-20;DM;Dominica;0;0;68;0
2020-11-21;DM;Dominica;4;0;72;0
2020-11-22;DM;Dominica;0;0;72;0
2020-11-23;DM;Dominica;5;0;77;0
2020-11-24;DM;Dominica;0;0;77;0
2020-11-25;DM;Dominica;0;0;77;0
2020-11-26;DM;Dominica;0;0;77;0
2020-11-27;DM;Dominica;3;0;80;0
2020-11-28;DM;Dominica;5;0;85;0
2020-11-29;DM;Dominica;0;0;85;0
2020-11-30;DM;Dominica;0;0;85;0
2020-12-01;DM;Dominica;0;0;85;0
2020-12-02;DM;Dominica;0;0;85;0
2020-12-03;DM;Dominica;0;0;85;0
2020-12-04;DM;Dominica;0;0;85;0
2020-12-05;DM;Dominica;0;0;85;0
2020-12-06;DM;Dominica;0;0;85;0
2020-12-07;DM;Dominica;0;0;85;0
2020-12-08;DM;Dominica;0;0;85;0
2020-12-09;DM;Dominica;0;0;85;0
2020-12-10;DM;Dominica;0;0;85;0
2020-12-11;DM;Dominica;2;0;87;0
2020-12-12;DM;Dominica;0;0;87;0
2020-12-13;DM;Dominica;1;0;88;0
2020-12-14;DM;Dominica;0;0;88;0
2020-12-15;DM;Dominica;0;0;88;0
2020-12-16;DM;Dominica;0;0;88;0
2020-12-17;DM;Dominica;0;0;88;0
2020-12-18;DM;Dominica;0;0;88;0
2020-12-19;DM;Dominica;0;0;88;0
2020-12-20;DM;Dominica;0;0;88;0
2020-12-21;DM;Dominica;0;0;88;0
2020-12-22;DM;Dominica;0;0;88;0
2020-12-23;DM;Dominica;0;0;88;0
2020-12-24;DM;Dominica;0;0;88;0
2020-12-25;DM;Dominica;0;0;88;0
2020-12-26;DM;Dominica;0;0;88;0
2020-12-27;DM;Dominica;0;0;88;0
2020-12-28;DM;Dominica;0;0;88;0
2020-12-29;DM;Dominica;0;0;88;0
2020-12-30;DM;Dominica;0;0;88;0
2020-12-31;DM;Dominica;0;0;88;0
2021-01-01;DM;Dominica;0;0;88;0
2021-01-02;DM;Dominica;0;0;88;0
2021-01-03;DM;Dominica;0;0;88;0
2021-01-04;DM;Dominica;0;0;88;0
2021-01-05;DM;Dominica;0;0;88;0
2021-01-06;DM;Dominica;17;0;105;0
2021-01-07;DM;Dominica;0;0;105;0
2021-01-08;DM;Dominica;1;0;106;0
2021-01-09;DM;Dominica;0;0;106;0
2021-01-10;DM;Dominica;0;0;106;0
2021-01-11;DM;Dominica;3;0;109;0
2021-01-12;DM;Dominica;0;0;109;0
2021-01-13;DM;Dominica;0;0;109;0
2021-01-14;DM;Dominica;0;0;109;0
2021-01-15;DM;Dominica;0;0;109;0
2021-01-16;DM;Dominica;1;0;110;0
2021-01-17;DM;Dominica;0;0;110;0
2021-01-18;DM;Dominica;0;0;110;0
2021-01-19;DM;Dominica;0;0;110;0
2021-01-20;DM;Dominica;3;0;113;0
2021-01-21;DM;Dominica;0;0;113;0
2021-01-22;DM;Dominica;0;0;113;0
2021-01-23;DM;Dominica;0;0;113;0
2021-01-24;DM;Dominica;0;0;113;0
2021-01-25;DM;Dominica;0;0;113;0
2021-01-26;DM;Dominica;0;0;113;0
2021-01-27;DM;Dominica;0;0;113;0
2021-01-28;DM;Dominica;4;0;117;0
2021-01-29;DM;Dominica;0;0;117;0
2021-01-30;DM;Dominica;0;0;117;0
2021-01-31;DM;Dominica;0;0;117;0
2021-02-01;DM;Dominica;0;0;117;0
2021-02-02;DM;Dominica;4;0;121;0
2021-02-03;DM;Dominica;0;0;121;0
2021-02-04;DM;Dominica;0;0;121;0
2021-02-05;DM;Dominica;0;0;121;0
2021-02-06;DM;Dominica;0;0;121;0
2021-02-07;DM;Dominica;0;0;121;0
2021-02-08;DM;Dominica;0;0;121;0
2021-02-09;DM;Dominica;0;0;121;0
2021-02-10;DM;Dominica;0;0;121;0
2021-02-11;DM;Dominica;0;0;121;0
2021-02-12;DM;Dominica;0;0;121;0
2021-02-13;DM;Dominica;0;0;121;0
2021-02-14;DM;Dominica;0;0;121;0
2021-02-15;DM;Dominica;13;0;134;0
2021-02-16;DM;Dominica;0;0;134;0
2021-02-17;DM;Dominica;0;0;134;0
2021-02-18;DM;Dominica;0;0;134;0
2021-02-19;DM;Dominica;0;0;134;0
2021-02-20;DM;Dominica;0;0;134;0
2021-02-21;DM;Dominica;0;0;134;0
2021-02-22;DM;Dominica;0;0;134;0
2021-02-23;DM;Dominica;7;0;141;0
2021-02-24;DM;Dominica;0;0;141;0
2021-02-25;DM;Dominica;1;0;142;0
2021-02-26;DM;Dominica;0;0;142;0
2021-02-27;DM;Dominica;0;0;142;0
2021-02-28;DM;Dominica;0;0;142;0
2021-03-01;DM;Dominica;0;0;142;0
2021-03-02;DM;Dominica;2;0;144;0
2021-03-03;DM;Dominica;0;0;144;0
2021-03-04;DM;Dominica;0;0;144;0
2021-03-05;DM;Dominica;0;0;144;0
2021-03-06;DM;Dominica;0;0;144;0
2021-03-07;DM;Dominica;0;0;144;0
2021-03-08;DM;Dominica;0;0;144;0
2021-03-09;DM;Dominica;7;0;151;0
2021-03-10;DM;Dominica;0;0;151;0
2021-03-11;DM;Dominica;0;0;151;0
2021-03-12;DM;Dominica;5;0;156;0
2021-03-13;DM;Dominica;0;0;156;0
2021-03-14;DM;Dominica;0;0;156;0
2021-03-15;DM;Dominica;0;0;156;0
2021-03-16;DM;Dominica;0;0;156;0
2021-03-17;DM;Dominica;0;0;156;0
2021-03-18;DM;Dominica;0;0;156;0
2021-03-19;DM;Dominica;0;0;156;0
2021-03-20;DM;Dominica;0;0;156;0
2021-03-21;DM;Dominica;0;0;156;0
2021-03-22;DM;Dominica;0;0;156;0
2021-03-23;DM;Dominica;0;0;156;0
2021-03-24;DM;Dominica;4;0;160;0
2021-03-25;DM;Dominica;0;0;160;0
2021-03-26;DM;Dominica;1;0;161;0
2021-03-27;DM;Dominica;0;0;161;0
2021-03-28;DM;Dominica;0;0;161;0
2021-03-29;DM;Dominica;0;0;161;0
2021-03-30;DM;Dominica;0;0;161;0
2021-03-31;DM;Dominica;0;0;161;0
2021-04-01;DM;Dominica;3;0;164;0
2021-04-02;DM;Dominica;1;0;165;0
2021-04-03;DM;Dominica;0;0;165;0
2021-04-04;DM;Dominica;0;0;165;0
2021-04-05;DM;Dominica;0;0;165;0
2021-04-06;DM;Dominica;0;0;165;0
2021-04-07;DM;Dominica;0;0;165;0
2021-04-08;DM;Dominica;0;0;165;0
2021-04-09;DM;Dominica;0;0;165;0
2021-04-10;DM;Dominica;0;0;165;0
2021-04-11;DM;Dominica;0;0;165;0
2021-04-12;DM;Dominica;0;0;165;0
2021-04-13;DM;Dominica;0;0;165;0
2021-04-14;DM;Dominica;0;0;165;0
2021-04-15;DM;Dominica;0;0;165;0
2021-04-16;DM;Dominica;0;0;165;0
2021-04-17;DM;Dominica;0;0;165;0
2021-04-18;DM;Dominica;0;0;165;0
2021-04-19;DM;Dominica;0;0;165;0
2021-04-20;DM;Dominica;0;0;165;0
2021-04-21;DM;Dominica;7;0;172;0
2021-04-22;DM;Dominica;0;0;172;0
2021-04-23;DM;Dominica;1;0;173;0
2021-04-24;DM;Dominica;0;0;173;0
2021-04-25;DM;Dominica;0;0;173;0
2021-04-26;DM;Dominica;0;0;173;0
2021-04-27;DM;Dominica;0;0;173;0
2021-04-28;DM;Dominica;0;0;173;0
2021-04-29;DM;Dominica;1;0;174;0
2021-04-30;DM;Dominica;0;0;174;0
2021-05-01;DM;Dominica;0;0;174;0
2021-05-02;DM;Dominica;0;0;174;0
2021-05-03;DM;Dominica;0;0;174;0
2021-05-04;DM;Dominica;0;0;174;0
2021-05-05;DM;Dominica;0;0;174;0
2021-05-06;DM;Dominica;0;0;174;0
2021-05-07;DM;Dominica;0;0;174;0
2021-05-08;DM;Dominica;1;0;175;0
2021-05-09;DM;Dominica;0;0;175;0
2021-05-10;DM;Dominica;0;0;175;0
2021-05-11;DM;Dominica;0;0;175;0
2021-05-12;DM;Dominica;0;0;175;0
2021-05-13;DM;Dominica;3;0;178;0
2021-05-14;DM;Dominica;0;0;178;0
2021-05-15;DM;Dominica;0;0;178;0
2021-05-16;DM;Dominica;0;0;178;0
2021-05-17;DM;Dominica;0;0;178;0
2021-05-18;DM;Dominica;6;0;184;0
2021-05-19;DM;Dominica;0;0;184;0
2021-05-20;DM;Dominica;0;0;184;0
2021-05-21;DM;Dominica;0;0;184;0
2021-05-22;DM;Dominica;0;0;184;0
2021-05-23;DM;Dominica;0;0;184;0
2021-05-24;DM;Dominica;0;0;184;0
2021-05-25;DM;Dominica;0;0;184;0
2021-05-26;DM;Dominica;0;0;184;0
2021-05-27;DM;Dominica;0;0;184;0
2021-05-28;DM;Dominica;4;0;188;0
2021-05-29;DM;Dominica;0;0;188;0
2021-05-30;DM;Dominica;0;0;188;0
2021-05-31;DM;Dominica;0;0;188;0
2021-06-01;DM;Dominica;0;0;188;0
2021-06-02;DM;Dominica;0;0;188;0
2021-06-03;DM;Dominica;0;0;188;0
2021-06-04;DM;Dominica;0;0;188;0
2021-06-05;DM;Dominica;0;0;188;0
2021-06-06;DM;Dominica;0;0;188;0
2021-06-07;DM;Dominica;0;0;188;0
2021-06-08;DM;Dominica;0;0;188;0
2021-06-09;DM;Dominica;0;0;188;0
2021-06-10;DM;Dominica;0;0;188;0
2021-06-11;DM;Dominica;1;0;189;0
2021-06-12;DM;Dominica;0;0;189;0
2021-06-13;DM;Dominica;0;0;189;0
2021-06-14;DM;Dominica;0;0;189;0
2021-06-15;DM;Dominica;0;0;189;0
2021-06-16;DM;Dominica;0;0;189;0
2021-06-17;DM;Dominica;2;0;191;0
2021-06-18;DM;Dominica;0;0;191;0
2021-06-19;DM;Dominica;0;0;191;0
2021-06-20;DM;Dominica;0;0;191;0
2021-06-21;DM;Dominica;0;0;191;0
2021-06-22;DM;Dominica;0;0;191;0
2021-06-23;DM;Dominica;0;0;191;0
2021-06-24;DM;Dominica;1;0;192;0
2021-06-25;DM;Dominica;0;0;192;0
2021-06-26;DM;Dominica;0;0;192;0
2021-06-27;DM;Dominica;1;0;193;0
2021-06-28;DM;Dominica;0;0;193;0
2021-06-29;DM;Dominica;0;0;193;0
2021-06-30;DM;Dominica;0;0;193;0
2021-07-01;DM;Dominica;0;0;193;0
2020-03-01;DO;Dominican Republic;1;0;1;0
2020-03-02;DO;Dominican Republic;0;0;1;0
2020-03-03;DO;Dominican Republic;0;0;1;0
2020-03-04;DO;Dominican Republic;0;0;1;0
2020-03-05;DO;Dominican Republic;0;0;1;0
2020-03-06;DO;Dominican Republic;1;0;2;0
2020-03-07;DO;Dominican Republic;0;0;2;0
2020-03-08;DO;Dominican Republic;3;0;5;0
2020-03-09;DO;Dominican Republic;0;0;5;0
2020-03-10;DO;Dominican Republic;0;0;5;0
2020-03-11;DO;Dominican Republic;0;0;5;0
2020-03-12;DO;Dominican Republic;0;0;5;0
2020-03-13;DO;Dominican Republic;0;0;5;0
2020-03-14;DO;Dominican Republic;6;0;11;0
2020-03-15;DO;Dominican Republic;0;0;11;0
2020-03-16;DO;Dominican Republic;0;0;11;0
2020-03-17;DO;Dominican Republic;10;1;21;1
2020-03-18;DO;Dominican Republic;0;0;21;1
2020-03-19;DO;Dominican Republic;13;1;34;2
2020-03-20;DO;Dominican Republic;38;0;72;2
2020-03-21;DO;Dominican Republic;40;0;112;2
2020-03-22;DO;Dominican Republic;90;1;202;3
2020-03-23;DO;Dominican Republic;43;0;245;3
2020-03-24;DO;Dominican Republic;67;3;312;6
2020-03-25;DO;Dominican Republic;80;4;392;10
2020-03-26;DO;Dominican Republic;96;0;488;10
2020-03-27;DO;Dominican Republic;93;10;581;20
2020-03-28;DO;Dominican Republic;138;8;719;28
2020-03-29;DO;Dominican Republic;140;11;859;39
2020-03-30;DO;Dominican Republic;42;3;901;42
2020-03-31;DO;Dominican Republic;208;9;1109;51
2020-04-01;DO;Dominican Republic;175;6;1284;57
2020-04-02;DO;Dominican Republic;96;3;1380;60
2020-04-03;DO;Dominican Republic;108;8;1488;68
2020-04-04;DO;Dominican Republic;0;0;1488;68
2020-04-05;DO;Dominican Republic;257;14;1745;82
2020-04-06;DO;Dominican Republic;83;4;1828;86
2020-04-07;DO;Dominican Republic;128;12;1956;98
2020-04-08;DO;Dominican Republic;155;10;2111;108
2020-04-09;DO;Dominican Republic;238;10;2349;118
2020-04-10;DO;Dominican Republic;271;8;2620;126
2020-04-11;DO;Dominican Republic;139;9;2759;135
2020-04-12;DO;Dominican Republic;208;38;2967;173
2020-04-13;DO;Dominican Republic;200;4;3167;177
2020-04-14;DO;Dominican Republic;119;6;3286;183
2020-04-15;DO;Dominican Republic;328;6;3614;189
2020-04-16;DO;Dominican Republic;141;7;3755;196
2020-04-17;DO;Dominican Republic;371;4;4126;200
2020-04-18;DO;Dominican Republic;209;17;4335;217
2020-04-19;DO;Dominican Republic;345;9;4680;226
2020-04-20;DO;Dominican Republic;284;9;4964;235
2020-04-21;DO;Dominican Republic;80;10;5044;245
2020-04-22;DO;Dominican Republic;256;15;5300;260
2020-04-23;DO;Dominican Republic;243;5;5543;265
2020-04-24;DO;Dominican Republic;206;2;5749;267
2020-04-25;DO;Dominican Republic;177;6;5926;273
2020-04-26;DO;Dominican Republic;209;5;6135;278
2020-04-27;DO;Dominican Republic;158;4;6293;282
2020-04-28;DO;Dominican Republic;123;4;6416;286
2020-04-29;DO;Dominican Republic;236;7;6652;293
2020-04-30;DO;Dominican Republic;320;8;6972;301
2020-05-01;DO;Dominican Republic;316;12;7288;313
2020-05-02;DO;Dominican Republic;290;13;7578;326
2020-05-03;DO;Dominican Republic;376;7;7954;333
2020-05-04;DO;Dominican Republic;281;13;8235;346
2020-05-05;DO;Dominican Republic;245;8;8480;354
2020-05-06;DO;Dominican Republic;327;8;8807;362
2020-05-07;DO;Dominican Republic;288;11;9095;373
2020-05-08;DO;Dominican Republic;281;7;9376;380
2020-05-09;DO;Dominican Republic;506;5;9882;385
2020-05-10;DO;Dominican Republic;465;3;10347;388
2020-05-11;DO;Dominican Republic;287;5;10634;393
2020-05-12;DO;Dominican Republic;266;9;10900;402
2020-05-13;DO;Dominican Republic;296;7;11196;409
2020-05-14;DO;Dominican Republic;124;13;11320;422
2020-05-15;DO;Dominican Republic;419;2;11739;424
2020-05-16;DO;Dominican Republic;371;4;12110;428
2020-05-17;DO;Dominican Republic;204;0;12314;428
2020-05-18;DO;Dominican Republic;411;6;12725;434
2020-05-19;DO;Dominican Republic;498;7;13223;441
2020-05-20;DO;Dominican Republic;254;5;13477;446
2020-05-21;DO;Dominican Republic;180;2;13657;448
2020-05-22;DO;Dominican Republic;332;8;13989;456
2020-05-23;DO;Dominican Republic;433;2;14422;458
2020-05-24;DO;Dominican Republic;379;0;14801;458
2020-05-25;DO;Dominican Republic;272;2;15073;460
2020-05-26;DO;Dominican Republic;191;8;15264;468
2020-05-27;DO;Dominican Republic;459;6;15723;474
2020-05-28;DO;Dominican Republic;345;11;16068;485
2020-05-29;DO;Dominican Republic;463;3;16531;488
2020-05-30;DO;Dominican Republic;377;10;16908;498
2020-05-31;DO;Dominican Republic;377;4;17285;502
2020-06-01;DO;Dominican Republic;287;0;17572;502
2020-06-02;DO;Dominican Republic;180;13;17752;515
2020-06-03;DO;Dominican Republic;288;1;18040;516
2020-06-04;DO;Dominican Republic;279;4;18319;520
2020-06-05;DO;Dominican Republic;389;5;18708;525
2020-06-06;DO;Dominican Republic;487;11;19195;536
2020-06-07;DO;Dominican Republic;405;2;19600;538
2020-06-08;DO;Dominican Republic;526;1;20126;539
2020-06-09;DO;Dominican Republic;289;5;20415;544
2020-06-10;DO;Dominican Republic;393;6;20808;550
2020-06-11;DO;Dominican Republic;629;11;21437;561
2020-06-12;DO;Dominican Republic;571;7;22008;568
2020-06-13;DO;Dominican Republic;564;9;22572;577
2020-06-14;DO;Dominican Republic;390;15;22962;592
2020-06-15;DO;Dominican Republic;309;13;23271;605
2020-06-16;DO;Dominican Republic;415;10;23686;615
2020-06-17;DO;Dominican Republic;419;18;24105;633
2020-06-18;DO;Dominican Republic;540;2;24645;635
2020-06-19;DO;Dominican Republic;423;12;25068;647
2020-06-20;DO;Dominican Republic;710;8;25778;655
2020-06-21;DO;Dominican Republic;899;7;26677;662
2020-06-22;DO;Dominican Republic;693;7;27370;669
2020-06-23;DO;Dominican Republic;566;6;27936;675
2020-06-24;DO;Dominican Republic;695;16;28631;691
2020-06-25;DO;Dominican Republic;510;7;29141;698
2020-06-26;DO;Dominican Republic;623;14;29764;712
2020-06-27;DO;Dominican Republic;855;6;30619;718
2020-06-28;DO;Dominican Republic;754;8;31373;726
2020-06-29;DO;Dominican Republic;443;7;31816;733
2020-06-30;DO;Dominican Republic;752;14;32568;747
2020-07-01;DO;Dominican Republic;819;7;33387;754
2020-07-02;DO;Dominican Republic;810;11;34197;765
2020-07-03;DO;Dominican Republic;951;10;35148;775
2020-07-04;DO;Dominican Republic;1036;11;36184;786
2020-07-05;DO;Dominican Republic;1241;8;37425;794
2020-07-06;DO;Dominican Republic;703;10;38128;804
2020-07-07;DO;Dominican Republic;302;17;38430;821
2020-07-08;DO;Dominican Republic;1158;8;39588;829
2020-07-09;DO;Dominican Republic;1202;13;40790;842
2020-07-10;DO;Dominican Republic;1125;22;41915;864
2020-07-11;DO;Dominican Republic;1199;16;43114;880
2020-07-12;DO;Dominican Republic;1418;17;44532;897
2020-07-13;DO;Dominican Republic;974;6;45506;903
2020-07-14;DO;Dominican Republic;799;7;46305;910
2020-07-15;DO;Dominican Republic;1366;19;47671;929
2020-07-16;DO;Dominican Republic;1072;12;48743;941
2020-07-17;DO;Dominican Republic;1370;1;50113;942
2020-07-18;DO;Dominican Republic;1406;29;51519;971
2020-07-19;DO;Dominican Republic;1336;10;52855;981
2020-07-20;DO;Dominican Republic;1101;12;53956;993
2020-07-21;DO;Dominican Republic;841;6;54797;999
2020-07-22;DO;Dominican Republic;1246;6;56043;1005
2020-07-23;DO;Dominican Republic;1572;1;57615;1006
2020-07-24;DO;Dominican Republic;1462;30;59077;1036
2020-07-25;DO;Dominican Republic;1819;19;60896;1055
2020-07-26;DO;Dominican Republic;2012;8;62908;1063
2020-07-27;DO;Dominican Republic;1248;20;64156;1083
2020-07-28;DO;Dominican Republic;534;18;64690;1101
2020-07-29;DO;Dominican Republic;1492;22;66182;1123
2020-07-30;DO;Dominican Republic;1733;23;67915;1146
2020-07-31;DO;Dominican Republic;1734;14;69649;1160
2020-08-01;DO;Dominican Republic;1766;10;71415;1170
2020-08-02;DO;Dominican Republic;828;8;72243;1178
2020-08-03;DO;Dominican Republic;874;5;73117;1183
2020-08-04;DO;Dominican Republic;1178;30;74295;1213
2020-08-05;DO;Dominican Republic;1365;9;75660;1222
2020-08-06;DO;Dominican Republic;876;24;76536;1246
2020-08-07;DO;Dominican Republic;1173;13;77709;1259
2020-08-08;DO;Dominican Republic;1069;30;78778;1289
2020-08-09;DO;Dominican Republic;954;20;79732;1309
2020-08-10;DO;Dominican Republic;767;19;80499;1328
2020-08-11;DO;Dominican Republic;595;18;81094;1346
2020-08-12;DO;Dominican Republic;1130;25;82224;1371
2020-08-13;DO;Dominican Republic;910;22;83134;1393
2020-08-14;DO;Dominican Republic;1354;16;84488;1409
2020-08-15;DO;Dominican Republic;1057;29;85545;1438
2020-08-16;DO;Dominican Republic;764;15;86309;1453
2020-08-17;DO;Dominican Republic;428;28;86737;1481
2020-08-18;DO;Dominican Republic;386;8;87123;1489
2020-08-19;DO;Dominican Republic;1004;12;88127;1501
2020-08-20;DO;Dominican Republic;883;4;89010;1505
2020-08-21;DO;Dominican Republic;857;28;89867;1533
2020-08-22;DO;Dominican Republic;694;21;90561;1554
2020-08-23;DO;Dominican Republic;600;13;91161;1567
2020-08-24;DO;Dominican Republic;447;6;91608;1573
2020-08-25;DO;Dominican Republic;609;12;92217;1585
2020-08-26;DO;Dominican Republic;340;28;92557;1613
2020-08-27;DO;Dominican Republic;407;17;92964;1630
2020-08-28;DO;Dominican Republic;426;18;93390;1648
2020-08-29;DO;Dominican Republic;342;25;93732;1673
2020-08-30;DO;Dominican Republic;509;8;94241;1681
2020-08-31;DO;Dominican Republic;474;29;94715;1710
2020-09-01;DO;Dominican Republic;264;28;94979;1738
2020-09-02;DO;Dominican Republic;648;27;95627;1765
2020-09-03;DO;Dominican Republic;1002;36;96629;1801
2020-09-04;DO;Dominican Republic;0;0;96629;1801
2020-09-05;DO;Dominican Republic;2147;39;98776;1840
2020-09-06;DO;Dominican Republic;557;5;99333;1845
2020-09-07;DO;Dominican Republic;565;19;99898;1864
2020-09-08;DO;Dominican Republic;233;25;100131;1889
2020-09-09;DO;Dominican Republic;806;25;100937;1914
2020-09-10;DO;Dominican Republic;779;12;101716;1926
2020-09-11;DO;Dominican Republic;516;15;102232;1941
2020-09-12;DO;Dominican Republic;860;12;103092;1953
2020-09-13;DO;Dominican Republic;568;15;103660;1968
2020-09-14;DO;Dominican Republic;450;16;104110;1984
2020-09-15;DO;Dominican Republic;693;14;104803;1998
2020-09-16;DO;Dominican Republic;718;11;105521;2009
2020-09-17;DO;Dominican Republic;615;13;106136;2022
2020-09-18;DO;Dominican Republic;596;12;106732;2034
2020-09-19;DO;Dominican Republic;968;10;107700;2044
2020-09-20;DO;Dominican Republic;589;3;108289;2047
2020-09-21;DO;Dominican Republic;494;7;108783;2054
2020-09-22;DO;Dominican Republic;486;10;109269;2064
2020-09-23;DO;Dominican Republic;468;10;109737;2074
2020-09-24;DO;Dominican Republic;385;2;110122;2076
2020-09-25;DO;Dominican Republic;475;11;110597;2087
2020-09-26;DO;Dominican Republic;360;6;110957;2093
2020-09-27;DO;Dominican Republic;429;2;111386;2095
2020-09-28;DO;Dominican Republic;280;3;111666;2098
2020-09-29;DO;Dominican Republic;234;3;111900;2101
2020-09-30;DO;Dominican Republic;309;4;112209;2105
2020-10-01;DO;Dominican Republic;519;3;112728;2108
2020-10-02;DO;Dominican Republic;622;9;113350;2117
2020-10-03;DO;Dominican Republic;576;11;113926;2128
2020-10-04;DO;Dominican Republic;554;6;114480;2134
2020-10-05;DO;Dominican Republic;574;10;115054;2144
2020-10-06;DO;Dominican Republic;317;5;115371;2149
2020-10-07;DO;Dominican Republic;777;10;116148;2159
2020-10-08;DO;Dominican Republic;724;4;116872;2163
2020-10-09;DO;Dominican Republic;585;2;117457;2165
2020-10-10;DO;Dominican Republic;557;2;118014;2167
2020-10-11;DO;Dominican Republic;463;6;118477;2173
2020-10-12;DO;Dominican Republic;366;6;118843;2179
2020-10-13;DO;Dominican Republic;165;4;119008;2183
2020-10-14;DO;Dominican Republic;654;3;119662;2186
2020-10-15;DO;Dominican Republic;404;3;120066;2189
2020-10-16;DO;Dominican Republic;384;3;120450;2192
2020-10-17;DO;Dominican Republic;475;3;120925;2195
2020-10-18;DO;Dominican Republic;422;4;121347;2199
2020-10-19;DO;Dominican Republic;320;4;121667;2203
2020-10-20;DO;Dominican Republic;306;1;121973;2204
2020-10-21;DO;Dominican Republic;425;2;122398;2206
2020-10-22;DO;Dominican Republic;475;6;122873;2212
2020-10-23;DO;Dominican Republic;0;0;122873;2212
2020-10-24;DO;Dominican Republic;1145;8;124018;2220
2020-10-25;DO;Dominican Republic;509;3;124527;2223
2020-10-26;DO;Dominican Republic;316;2;124843;2225
2020-10-27;DO;Dominican Republic;165;1;125008;2226
2020-10-28;DO;Dominican Republic;562;6;125570;2232
2020-10-29;DO;Dominican Republic;343;2;125913;2234
2020-10-30;DO;Dominican Republic;419;2;126332;2236
2020-10-31;DO;Dominican Republic;686;9;127018;2245
2020-11-01;DO;Dominican Republic;314;4;127332;2249
2020-11-02;DO;Dominican Republic;259;1;127591;2250
2020-11-03;DO;Dominican Republic;257;2;127848;2252
2020-11-04;DO;Dominican Republic;430;5;128278;2257
2020-11-05;DO;Dominican Republic;546;3;128824;2260
2020-11-06;DO;Dominican Republic;476;1;129300;2261
2020-11-07;DO;Dominican Republic;345;2;129645;2263
2020-11-08;DO;Dominican Republic;537;2;130182;2265
2020-11-09;DO;Dominican Republic;421;2;130603;2267
2020-11-10;DO;Dominican Republic;528;2;131131;2269
2020-11-11;DO;Dominican Republic;134;3;131265;2272
2020-11-12;DO;Dominican Republic;371;2;131636;2274
2020-11-13;DO;Dominican Republic;918;6;132554;2280
2020-11-14;DO;Dominican Republic;671;2;133225;2282
2020-11-15;DO;Dominican Republic;499;3;133724;2285
2020-11-16;DO;Dominican Republic;479;1;134203;2286
2020-11-17;DO;Dominican Republic;494;4;134697;2290
2020-11-18;DO;Dominican Republic;460;3;135157;2293
2020-11-19;DO;Dominican Republic;1026;8;136183;2301
2020-11-20;DO;Dominican Republic;601;5;136784;2306
2020-11-21;DO;Dominican Republic;986;2;137770;2308
2020-11-22;DO;Dominican Republic;640;2;138410;2310
2020-11-23;DO;Dominican Republic;419;1;138829;2311
2020-11-24;DO;Dominican Republic;282;2;139111;2313
2020-11-25;DO;Dominican Republic;285;2;139396;2315
2020-11-26;DO;Dominican Republic;1526;2;140922;2317
2020-11-27;DO;Dominican Republic;855;7;141777;2324
2020-11-28;DO;Dominican Republic;876;4;142653;2328
2020-11-29;DO;Dominican Republic;820;2;143473;2330
2020-11-30;DO;Dominican Republic;515;1;143988;2331
2020-12-01;DO;Dominican Republic;314;2;144302;2333
2020-12-02;DO;Dominican Republic;895;1;145197;2334
2020-12-03;DO;Dominican Republic;812;1;146009;2335
2020-12-04;DO;Dominican Republic;671;8;146680;2343
2020-12-05;DO;Dominican Republic;975;2;147655;2345
2020-12-06;DO;Dominican Republic;798;0;148453;2345
2020-12-07;DO;Dominican Republic;685;1;149138;2346
2020-12-08;DO;Dominican Republic;492;1;149630;2347
2020-12-09;DO;Dominican Republic;531;3;150161;2350
2020-12-10;DO;Dominican Republic;1560;8;151721;2358
2020-12-11;DO;Dominican Republic;731;1;152452;2359
2020-12-12;DO;Dominican Republic;1133;1;153585;2360
2020-12-13;DO;Dominican Republic;1107;1;154692;2361
2020-12-14;DO;Dominican Republic;492;3;155184;2364
2020-12-15;DO;Dominican Republic;613;3;155797;2367
2020-12-16;DO;Dominican Republic;788;5;156585;2372
2020-12-17;DO;Dominican Republic;720;3;157305;2375
2020-12-18;DO;Dominican Republic;624;1;157929;2376
2020-12-19;DO;Dominican Republic;1135;6;159064;2382
2020-12-20;DO;Dominican Republic;1322;2;160386;2384
2020-12-21;DO;Dominican Republic;666;1;161052;2385
2020-12-22;DO;Dominican Republic;878;13;161930;2398
2020-12-23;DO;Dominican Republic;566;3;162496;2401
2020-12-24;DO;Dominican Republic;1158;3;163654;2404
2020-12-25;DO;Dominican Republic;1381;0;165035;2404
2020-12-26;DO;Dominican Republic;905;0;165940;2404
2020-12-27;DO;Dominican Republic;824;0;166764;2404
2020-12-28;DO;Dominican Republic;641;0;167405;2404
2020-12-29;DO;Dominican Republic;860;1;168265;2405
2020-12-30;DO;Dominican Republic;1314;4;169579;2409
2020-12-31;DO;Dominican Republic;1206;5;170785;2414
2021-01-01;DO;Dominican Republic;1433;2;172218;2416
2021-01-02;DO;Dominican Republic;747;0;172965;2416
2021-01-03;DO;Dominican Republic;366;2;173331;2418
2021-01-04;DO;Dominican Republic;2043;1;175374;2419
2021-01-05;DO;Dominican Republic;475;0;175849;2419
2021-01-06;DO;Dominican Republic;529;0;176378;2419
2021-01-07;DO;Dominican Republic;1115;4;177493;2423
2021-01-08;DO;Dominican Republic;1045;1;178538;2424
2021-01-09;DO;Dominican Republic;2106;0;180644;2424
2021-01-10;DO;Dominican Republic;1459;3;182103;2427
2021-01-11;DO;Dominican Republic;1179;0;183282;2427
2021-01-12;DO;Dominican Republic;1506;0;184788;2427
2021-01-13;DO;Dominican Republic;1595;1;186383;2428
2021-01-14;DO;Dominican Republic;1104;0;187487;2428
2021-01-15;DO;Dominican Republic;1482;4;188969;2432
2021-01-16;DO;Dominican Republic;2370;0;191339;2432
2021-01-17;DO;Dominican Republic;1779;5;193118;2437
2021-01-18;DO;Dominican Republic;1848;11;194966;2448
2021-01-19;DO;Dominican Republic;1625;13;196591;2461
2021-01-20;DO;Dominican Republic;1532;9;198123;2470
2021-01-21;DO;Dominican Republic;1549;12;199672;2482
2021-01-22;DO;Dominican Republic;1473;14;201145;2496
2021-01-23;DO;Dominican Republic;1362;17;202507;2513
2021-01-24;DO;Dominican Republic;1439;18;203946;2531
2021-01-25;DO;Dominican Republic;1216;14;205162;2545
2021-01-26;DO;Dominican Republic;1143;19;206305;2564
2021-01-27;DO;Dominican Republic;1150;15;207455;2579
2021-01-28;DO;Dominican Republic;1155;24;208610;2603
2021-01-29;DO;Dominican Republic;1802;23;210412;2626
2021-01-30;DO;Dominican Republic;2141;20;212553;2646
2021-01-31;DO;Dominican Republic;1507;20;214060;2666
2021-02-01;DO;Dominican Republic;1026;22;215086;2688
2021-02-02;DO;Dominican Republic;834;16;215920;2704
2021-02-03;DO;Dominican Republic;1357;15;217277;2719
2021-02-04;DO;Dominican Republic;1671;28;218948;2747
2021-02-05;DO;Dominican Republic;1478;26;220426;2773
2021-02-06;DO;Dominican Republic;1722;28;222148;2801
2021-02-07;DO;Dominican Republic;1250;30;223398;2831
2021-02-08;DO;Dominican Republic;721;12;224119;2843
2021-02-09;DO;Dominican Republic;419;21;224538;2864
2021-02-10;DO;Dominican Republic;934;19;225472;2883
2021-02-11;DO;Dominican Republic;1242;21;226714;2904
2021-02-12;DO;Dominican Republic;1050;13;227764;2917
2021-02-13;DO;Dominican Republic;1131;15;228895;2932
2021-02-14;DO;Dominican Republic;873;12;229768;2944
2021-02-15;DO;Dominican Republic;795;15;230563;2959
2021-02-16;DO;Dominican Republic;532;16;231095;2975
2021-02-17;DO;Dominican Republic;642;15;231737;2990
2021-02-18;DO;Dominican Republic;1043;17;232780;3007
2021-02-19;DO;Dominican Republic;818;17;233598;3024
2021-02-20;DO;Dominican Republic;904;4;234502;3028
2021-02-21;DO;Dominican Republic;960;10;235462;3038
2021-02-22;DO;Dominican Republic;420;10;235882;3048
2021-02-23;DO;Dominican Republic;328;9;236210;3057
2021-02-24;DO;Dominican Republic;673;9;236883;3066
2021-02-25;DO;Dominican Republic;746;9;237629;3075
2021-02-26;DO;Dominican Republic;576;7;238205;3082
2021-02-27;DO;Dominican Republic;804;11;239009;3093
2021-02-28;DO;Dominican Republic;608;7;239617;3100
2021-03-01;DO;Dominican Republic;381;6;239998;3106
2021-03-02;DO;Dominican Republic;203;12;240201;3118
2021-03-03;DO;Dominican Republic;572;12;240773;3130
2021-03-04;DO;Dominican Republic;619;9;241392;3139
2021-03-05;DO;Dominican Republic;695;11;242087;3150
2021-03-06;DO;Dominican Republic;573;12;242660;3162
2021-03-07;DO;Dominican Republic;587;10;243247;3172
2021-03-08;DO;Dominican Republic;279;7;243526;3179
2021-03-09;DO;Dominican Republic;252;12;243778;3191
2021-03-10;DO;Dominican Republic;390;7;244168;3198
2021-03-11;DO;Dominican Republic;755;6;244923;3204
2021-03-12;DO;Dominican Republic;529;9;245452;3213
2021-03-13;DO;Dominican Republic;164;0;245616;3213
2021-03-14;DO;Dominican Republic;429;9;246045;3222
2021-03-15;DO;Dominican Republic;254;4;246299;3226
2021-03-16;DO;Dominican Republic;495;11;246794;3237
2021-03-17;DO;Dominican Republic;570;11;247364;3248
2021-03-18;DO;Dominican Republic;615;9;247979;3257
2021-03-19;DO;Dominican Republic;523;5;248502;3262
2021-03-20;DO;Dominican Republic;487;7;248989;3269
2021-03-21;DO;Dominican Republic;474;3;249463;3272
2021-03-22;DO;Dominican Republic;313;3;249776;3275
2021-03-23;DO;Dominican Republic;401;8;250177;3283
2021-03-24;DO;Dominican Republic;402;6;250579;3289
2021-03-25;DO;Dominican Republic;389;6;250968;3295
2021-03-26;DO;Dominican Republic;364;3;251332;3298
2021-03-27;DO;Dominican Republic;250;4;251582;3302
2021-03-28;DO;Dominican Republic;401;2;251983;3304
2021-03-29;DO;Dominican Republic;199;3;252182;3307
2021-03-30;DO;Dominican Republic;202;10;252384;3317
2021-03-31;DO;Dominican Republic;343;8;252727;3325
2021-04-01;DO;Dominican Republic;469;5;253196;3330
2021-04-02;DO;Dominican Republic;585;4;253781;3334
2021-04-03;DO;Dominican Republic;355;7;254136;3341
2021-04-04;DO;Dominican Republic;159;5;254295;3346
2021-04-05;DO;Dominican Republic;140;5;254435;3351
2021-04-06;DO;Dominican Republic;168;4;254603;3355
2021-04-07;DO;Dominican Republic;334;14;254937;3369
2021-04-08;DO;Dominican Republic;1094;9;256031;3378
2021-04-09;DO;Dominican Republic;532;4;256563;3382
2021-04-10;DO;Dominican Republic;623;3;257186;3385
2021-04-11;DO;Dominican Republic;512;3;257698;3388
2021-04-12;DO;Dominican Republic;341;4;258039;3392
2021-04-13;DO;Dominican Republic;598;5;258637;3397
2021-04-14;DO;Dominican Republic;623;5;259260;3402
2021-04-15;DO;Dominican Republic;379;3;259639;3405
2021-04-16;DO;Dominican Republic;494;5;260133;3410
2021-04-17;DO;Dominican Republic;494;4;260627;3414
2021-04-18;DO;Dominican Republic;502;4;261129;3418
2021-04-19;DO;Dominican Republic;402;4;261531;3422
2021-04-20;DO;Dominican Republic;317;4;261848;3426
2021-04-21;DO;Dominican Republic;556;9;262404;3435
2021-04-22;DO;Dominican Republic;531;6;262935;3441
2021-04-23;DO;Dominican Republic;535;7;263470;3448
2021-04-24;DO;Dominican Republic;474;3;263944;3451
2021-04-25;DO;Dominican Republic;919;3;264863;3454
2021-04-26;DO;Dominican Republic;540;5;265403;3459
2021-04-27;DO;Dominican Republic;78;3;265481;3462
2021-04-28;DO;Dominican Republic;338;5;265819;3467
2021-04-29;DO;Dominican Republic;395;4;266214;3471
2021-04-30;DO;Dominican Republic;347;9;266561;3480
2021-05-01;DO;Dominican Republic;300;7;266861;3487
2021-05-02;DO;Dominican Republic;594;6;267455;3493
2021-05-03;DO;Dominican Republic;226;6;267681;3499
2021-05-04;DO;Dominican Republic;389;5;268070;3504
2021-05-05;DO;Dominican Republic;491;5;268561;3509
2021-05-06;DO;Dominican Republic;623;5;269184;3514
2021-05-07;DO;Dominican Republic;774;3;269958;3517
2021-05-08;DO;Dominican Republic;642;6;270600;3523
2021-05-09;DO;Dominican Republic;948;9;271548;3532
2021-05-10;DO;Dominican Republic;560;8;272108;3540
2021-05-11;DO;Dominican Republic;701;10;272809;3550
2021-05-12;DO;Dominican Republic;688;4;273497;3554
2021-05-13;DO;Dominican Republic;822;6;274319;3560
2021-05-14;DO;Dominican Republic;1059;5;275378;3565
2021-05-15;DO;Dominican Republic;894;4;276272;3569
2021-05-16;DO;Dominican Republic;916;13;277188;3582
2021-05-17;DO;Dominican Republic;731;7;277919;3589
2021-05-18;DO;Dominican Republic;630;8;278549;3597
2021-05-19;DO;Dominican Republic;1016;0;279565;3597
2021-05-20;DO;Dominican Republic;1429;3;280994;3600
2021-05-21;DO;Dominican Republic;636;3;281630;3603
2021-05-22;DO;Dominican Republic;1055;3;282685;3606
2021-05-23;DO;Dominican Republic;1044;0;283729;3606
2021-05-24;DO;Dominican Republic;838;4;284567;3610
2021-05-25;DO;Dominican Republic;644;0;285211;3610
2021-05-26;DO;Dominican Republic;1058;3;286269;3613
2021-05-27;DO;Dominican Republic;1765;7;288034;3620
2021-05-28;DO;Dominican Republic;1254;3;289288;3623
2021-05-29;DO;Dominican Republic;1238;5;290526;3628
2021-05-30;DO;Dominican Republic;1384;0;291910;3628
2021-05-31;DO;Dominican Republic;876;0;292786;3628
2021-06-01;DO;Dominican Republic;1235;6;294021;3634
2021-06-02;DO;Dominican Republic;1659;3;295680;3637
2021-06-03;DO;Dominican Republic;1439;5;297119;3642
2021-06-04;DO;Dominican Republic;1295;4;298414;3646
2021-06-05;DO;Dominican Republic;1267;6;299681;3652
2021-06-06;DO;Dominican Republic;1397;2;301078;3654
2021-06-07;DO;Dominican Republic;906;1;301984;3655
2021-06-08;DO;Dominican Republic;1004;17;302988;3672
2021-06-09;DO;Dominican Republic;1440;14;304428;3686
2021-06-10;DO;Dominican Republic;1141;9;305569;3695
2021-06-11;DO;Dominican Republic;1129;5;306698;3700
2021-06-12;DO;Dominican Republic;1149;5;307847;3705
2021-06-13;DO;Dominican Republic;803;2;308650;3707
2021-06-14;DO;Dominican Republic;827;1;309477;3708
2021-06-15;DO;Dominican Republic;914;9;310391;3717
2021-06-16;DO;Dominican Republic;1442;9;311833;3726
2021-06-17;DO;Dominican Republic;982;7;312815;3733
2021-06-18;DO;Dominican Republic;1216;9;314031;3742
2021-06-19;DO;Dominican Republic;1784;12;315815;3754
2021-06-20;DO;Dominican Republic;972;2;316787;3756
2021-06-21;DO;Dominican Republic;858;2;317645;3758
2021-06-22;DO;Dominican Republic;723;11;318368;3769
2021-06-23;DO;Dominican Republic;886;4;319254;3773
2021-06-24;DO;Dominican Republic;882;8;320136;3781
2021-06-25;DO;Dominican Republic;937;8;321073;3789
2021-06-26;DO;Dominican Republic;998;7;322071;3796
2021-06-27;DO;Dominican Republic;707;1;322778;3797
2021-06-28;DO;Dominican Republic;872;4;323650;3801
2021-06-29;DO;Dominican Republic;714;14;324364;3815
2021-06-30;DO;Dominican Republic;857;7;325221;3822
2021-07-01;DO;Dominican Republic;972;18;326193;3840
2020-03-01;EC;Ecuador;6;0;6;0
2020-03-02;EC;Ecuador;0;0;6;0
2020-03-03;EC;Ecuador;1;0;7;0
2020-03-04;EC;Ecuador;3;0;10;0
2020-03-05;EC;Ecuador;3;0;13;0
2020-03-06;EC;Ecuador;0;0;13;0
2020-03-07;EC;Ecuador;0;0;13;0
2020-03-08;EC;Ecuador;1;0;14;0
2020-03-09;EC;Ecuador;1;0;15;0
2020-03-10;EC;Ecuador;0;0;15;0
2020-03-11;EC;Ecuador;2;0;17;0
2020-03-12;EC;Ecuador;0;0;17;0
2020-03-13;EC;Ecuador;0;0;17;0
2020-03-14;EC;Ecuador;11;2;28;2
2020-03-15;EC;Ecuador;0;0;28;2
2020-03-16;EC;Ecuador;9;0;37;2
2020-03-17;EC;Ecuador;21;0;58;2
2020-03-18;EC;Ecuador;53;0;111;2
2020-03-19;EC;Ecuador;88;1;199;3
2020-03-20;EC;Ecuador;168;2;367;5
2020-03-21;EC;Ecuador;139;2;506;7
2020-03-22;EC;Ecuador;283;7;789;14
2020-03-23;EC;Ecuador;192;4;981;18
2020-03-24;EC;Ecuador;101;9;1082;27
2020-03-25;EC;Ecuador;91;1;1173;28
2020-03-26;EC;Ecuador;230;6;1403;34
2020-03-27;EC;Ecuador;192;2;1595;36
2020-03-28;EC;Ecuador;228;12;1823;48
2020-03-29;EC;Ecuador;101;10;1924;58
2020-03-30;EC;Ecuador;38;2;1962;60
2020-03-31;EC;Ecuador;278;15;2240;75
2020-04-01;EC;Ecuador;508;18;2748;93
2020-04-02;EC;Ecuador;415;27;3163;120
2020-04-03;EC;Ecuador;205;25;3368;145
2020-04-04;EC;Ecuador;97;27;3465;172
2020-04-05;EC;Ecuador;181;8;3646;180
2020-04-06;EC;Ecuador;101;11;3747;191
2020-04-07;EC;Ecuador;0;0;3747;191
2020-04-08;EC;Ecuador;703;51;4450;242
2020-04-09;EC;Ecuador;515;30;4965;272
2020-04-10;EC;Ecuador;2196;25;7161;297
2020-04-11;EC;Ecuador;96;18;7257;315
2020-04-12;EC;Ecuador;209;18;7466;333
2020-04-13;EC;Ecuador;63;22;7529;355
2020-04-14;EC;Ecuador;74;14;7603;369
2020-04-15;EC;Ecuador;255;19;7858;388
2020-04-16;EC;Ecuador;367;15;8225;403
2020-04-17;EC;Ecuador;225;18;8450;421
2020-04-18;EC;Ecuador;572;35;9022;456
2020-04-19;EC;Ecuador;446;18;9468;474
2020-04-20;EC;Ecuador;660;33;10128;507
2020-04-21;EC;Ecuador;270;13;10398;520
2020-04-22;EC;Ecuador;452;17;10850;537
2020-04-23;EC;Ecuador;333;23;11183;560
2020-04-24;EC;Ecuador;11536;16;22719;576
2020-04-25;EC;Ecuador;0;0;22719;576
2020-04-26;EC;Ecuador;0;0;22719;576
2020-04-27;EC;Ecuador;521;87;23240;663
2020-04-28;EC;Ecuador;1018;208;24258;871
2020-04-29;EC;Ecuador;417;12;24675;883
2020-04-30;EC;Ecuador;259;17;24934;900
2020-05-01;EC;Ecuador;1402;163;26336;1063
2020-05-02;EC;Ecuador;1128;308;27464;1371
2020-05-03;EC;Ecuador;2074;193;29538;1564
2020-05-04;EC;Ecuador;2343;5;31881;1569
2020-05-05;EC;Ecuador;0;0;31881;1569
2020-05-06;EC;Ecuador;0;49;31881;1618
2020-05-07;EC;Ecuador;-1583;36;30298;1654
2020-05-08;EC;Ecuador;-1480;50;28818;1704
2020-05-09;EC;Ecuador;253;13;29071;1717
2020-05-10;EC;Ecuador;488;410;29559;2127
2020-05-11;EC;Ecuador;-50;18;29509;2145
2020-05-12;EC;Ecuador;910;182;30419;2327
2020-05-13;EC;Ecuador;67;7;30486;2334
2020-05-14;EC;Ecuador;16;4;30502;2338
2020-05-15;EC;Ecuador;965;256;31467;2594
2020-05-16;EC;Ecuador;1296;94;32763;2688
2020-05-17;EC;Ecuador;419;48;33182;2736
2020-05-18;EC;Ecuador;400;63;33582;2799
2020-05-19;EC;Ecuador;569;40;34151;2839
2020-05-20;EC;Ecuador;703;49;34854;2888
2020-05-21;EC;Ecuador;452;51;35306;2939
2020-05-22;EC;Ecuador;522;117;35828;3056
2020-05-23;EC;Ecuador;430;40;36258;3096
2020-05-24;EC;Ecuador;498;12;36756;3108
2020-05-25;EC;Ecuador;599;95;37355;3203
2020-05-26;EC;Ecuador;0;0;37355;3203
2020-05-27;EC;Ecuador;748;72;38103;3275
2020-05-28;EC;Ecuador;368;38;38471;3313
2020-05-29;EC;Ecuador;100;21;38571;3334
2020-05-30;EC;Ecuador;0;0;38571;3334
2020-05-31;EC;Ecuador;527;24;39098;3358
2020-06-01;EC;Ecuador;0;0;39098;3358
2020-06-02;EC;Ecuador;1316;80;40414;3438
2020-06-03;EC;Ecuador;552;48;40966;3486
2020-06-04;EC;Ecuador;0;0;40966;3486
2020-06-05;EC;Ecuador;609;48;41575;3534
2020-06-06;EC;Ecuador;1153;74;42728;3608
2020-06-07;EC;Ecuador;392;13;43120;3621
2020-06-08;EC;Ecuador;258;21;43378;3642
2020-06-09;EC;Ecuador;539;48;43917;3690
2020-06-10;EC;Ecuador;523;30;44440;3720
2020-06-11;EC;Ecuador;0;0;44440;3720
2020-06-12;EC;Ecuador;1338;108;45778;3828
2020-06-13;EC;Ecuador;578;46;46356;3874
2020-06-14;EC;Ecuador;395;22;46751;3896
2020-06-15;EC;Ecuador;571;33;47322;3929
2020-06-16;EC;Ecuador;621;41;47943;3970
2020-06-17;EC;Ecuador;547;37;48490;4007
2020-06-18;EC;Ecuador;607;80;49097;4087
2020-06-19;EC;Ecuador;634;69;49731;4156
2020-06-20;EC;Ecuador;0;0;49731;4156
2020-06-21;EC;Ecuador;909;67;50640;4223
2020-06-22;EC;Ecuador;0;0;50640;4223
2020-06-23;EC;Ecuador;1003;51;51643;4274
2020-06-24;EC;Ecuador;0;0;51643;4274
2020-06-25;EC;Ecuador;1513;69;53156;4343
2020-06-26;EC;Ecuador;700;63;53856;4406
2020-06-27;EC;Ecuador;718;18;54574;4424
2020-06-28;EC;Ecuador;681;5;55255;4429
2020-06-29;EC;Ecuador;410;73;55665;4502
2020-06-30;EC;Ecuador;767;25;56432;4527
2020-07-01;EC;Ecuador;1825;49;58257;4576
2020-07-02;EC;Ecuador;1211;63;59468;4639
2020-07-03;EC;Ecuador;1189;61;60657;4700
2020-07-04;EC;Ecuador;878;69;61535;4769
2020-07-05;EC;Ecuador;423;12;61958;4781
2020-07-06;EC;Ecuador;422;40;62380;4821
2020-07-07;EC;Ecuador;865;52;63245;4873
2020-07-08;EC;Ecuador;0;0;63245;4873
2020-07-09;EC;Ecuador;976;27;64221;4900
2020-07-10;EC;Ecuador;797;39;65018;4939
2020-07-11;EC;Ecuador;2191;92;67209;5031
2020-07-12;EC;Ecuador;661;16;67870;5047
2020-07-13;EC;Ecuador;589;16;68459;5063
2020-07-14;EC;Ecuador;1111;67;69570;5130
2020-07-15;EC;Ecuador;759;28;70329;5158
2020-07-16;EC;Ecuador;1036;49;71365;5207
2020-07-17;EC;Ecuador;1079;43;72444;5250
2020-07-18;EC;Ecuador;938;32;73382;5282
2020-07-19;EC;Ecuador;631;31;74013;5313
2020-07-20;EC;Ecuador;607;5;74620;5318
2020-07-21;EC;Ecuador;1597;48;76217;5366
2020-07-22;EC;Ecuador;1040;52;77257;5418
2020-07-23;EC;Ecuador;891;21;78148;5439
2020-07-24;EC;Ecuador;901;29;79049;5468
2020-07-25;EC;Ecuador;987;39;80036;5507
2020-07-26;EC;Ecuador;658;8;80694;5515
2020-07-27;EC;Ecuador;467;17;81161;5532
2020-07-28;EC;Ecuador;1118;52;82279;5584
2020-07-29;EC;Ecuador;914;39;83193;5623
2020-07-30;EC;Ecuador;1177;34;84370;5657
2020-07-31;EC;Ecuador;985;45;85355;5702
2020-08-01;EC;Ecuador;877;34;86232;5736
2020-08-02;EC;Ecuador;0;0;86232;5736
2020-08-03;EC;Ecuador;809;31;87041;5767
2020-08-04;EC;Ecuador;922;41;87963;5808
2020-08-05;EC;Ecuador;903;39;88866;5847
2020-08-06;EC;Ecuador;1671;30;90537;5877
2020-08-07;EC;Ecuador;1432;20;91969;5897
2020-08-08;EC;Ecuador;1603;19;93572;5916
2020-08-09;EC;Ecuador;887;6;94459;5922
2020-08-10;EC;Ecuador;242;10;94701;5932
2020-08-11;EC;Ecuador;862;19;95563;5951
2020-08-12;EC;Ecuador;1547;33;97110;5984
2020-08-13;EC;Ecuador;1233;26;98343;6010
2020-08-14;EC;Ecuador;1066;20;99409;6030
2020-08-15;EC;Ecuador;1279;35;100688;6065
2020-08-16;EC;Ecuador;854;5;101542;6070
2020-08-17;EC;Ecuador;209;13;101751;6083
2020-08-18;EC;Ecuador;1190;22;102941;6105
2020-08-19;EC;Ecuador;1534;41;104475;6146
2020-08-20;EC;Ecuador;1033;54;105508;6200
2020-08-21;EC;Ecuador;973;48;106481;6248
2020-08-22;EC;Ecuador;608;29;107089;6277
2020-08-23;EC;Ecuador;680;33;107769;6310
2020-08-24;EC;Ecuador;520;12;108289;6322
2020-08-25;EC;Ecuador;741;46;109030;6368
2020-08-26;EC;Ecuador;1519;42;110549;6410
2020-08-27;EC;Ecuador;670;61;111219;6471
2020-08-28;EC;Ecuador;922;33;112141;6504
2020-08-29;EC;Ecuador;765;33;112906;6537
2020-08-30;EC;Ecuador;742;18;113648;6555
2020-08-31;EC;Ecuador;119;1;113767;6556
2020-09-01;EC;Ecuador;542;15;114309;6571
2020-09-02;EC;Ecuador;1148;48;115457;6619
2020-09-03;EC;Ecuador;903;29;116360;6648
2020-09-04;EC;Ecuador;815;26;117175;6674
2020-09-05;EC;Ecuador;870;50;118045;6724
2020-09-06;EC;Ecuador;0;0;118045;6724
2020-09-07;EC;Ecuador;-7953;3852;110092;10576
2020-09-08;EC;Ecuador;665;51;110757;10627
2020-09-09;EC;Ecuador;1409;74;112166;10701
2020-09-10;EC;Ecuador;1040;48;113206;10749
2020-09-11;EC;Ecuador;1526;87;114732;10836
2020-09-12;EC;Ecuador;1719;28;116451;10864
2020-09-13;EC;Ecuador;2143;39;118594;10903
2020-09-14;EC;Ecuador;317;19;118911;10922
2020-09-15;EC;Ecuador;642;41;119553;10963
2020-09-16;EC;Ecuador;1972;33;121525;10996
2020-09-17;EC;Ecuador;732;33;122257;11029
2020-09-18;EC;Ecuador;1872;15;124129;11044
2020-09-19;EC;Ecuador;1491;40;125620;11084
2020-09-20;EC;Ecuador;799;6;126419;11090
2020-09-21;EC;Ecuador;292;5;126711;11095
2020-09-22;EC;Ecuador;932;31;127643;11126
2020-09-23;EC;Ecuador;2249;45;129892;11171
2020-09-24;EC;Ecuador;1254;42;131146;11213
2020-09-25;EC;Ecuador;1329;23;132475;11236
2020-09-26;EC;Ecuador;1506;37;133981;11273
2020-09-27;EC;Ecuador;766;6;134747;11279
2020-09-28;EC;Ecuador;218;1;134965;11280
2020-09-29;EC;Ecuador;784;32;135749;11312
2020-09-30;EC;Ecuador;1298;43;137047;11355
2020-10-01;EC;Ecuador;1537;78;138584;11433
2020-10-02;EC;Ecuador;950;62;139534;11495
2020-10-03;EC;Ecuador;817;102;140351;11597
2020-10-04;EC;Ecuador;683;50;141034;11647
2020-10-05;EC;Ecuador;305;34;141339;11681
2020-10-06;EC;Ecuador;717;21;142056;11702
2020-10-07;EC;Ecuador;1475;41;143531;11743
2020-10-08;EC;Ecuador;1514;398;145045;12141
2020-10-09;EC;Ecuador;803;34;145848;12175
2020-10-10;EC;Ecuador;980;13;146828;12188
2020-10-11;EC;Ecuador;205;3;147033;12191
2020-10-12;EC;Ecuador;282;27;147315;12218
2020-10-13;EC;Ecuador;856;17;148171;12235
2020-10-14;EC;Ecuador;912;29;149083;12264
2020-10-15;EC;Ecuador;1277;42;150360;12306
2020-10-16;EC;Ecuador;1299;51;151659;12357
2020-10-17;EC;Ecuador;763;18;152422;12375
2020-10-18;EC;Ecuador;867;12;153289;12387
2020-10-19;EC;Ecuador;134;8;153423;12395
2020-10-20;EC;Ecuador;692;9;154115;12404
2020-10-21;EC;Ecuador;1510;49;155625;12453
2020-10-22;EC;Ecuador;826;47;156451;12500
2020-10-23;EC;Ecuador;1819;28;158270;12528
2020-10-24;EC;Ecuador;1344;14;159614;12542
2020-10-25;EC;Ecuador;2021;11;161635;12553
2020-10-26;EC;Ecuador;543;20;162178;12573
2020-10-27;EC;Ecuador;1014;15;163192;12588
2020-10-28;EC;Ecuador;1716;20;164908;12608
2020-10-29;EC;Ecuador;1394;14;166302;12622
2020-10-30;EC;Ecuador;845;10;167147;12632
2020-10-31;EC;Ecuador;1045;38;168192;12670
2020-11-01;EC;Ecuador;1002;14;169194;12684
2020-11-02;EC;Ecuador;368;8;169562;12692
2020-11-03;EC;Ecuador;548;6;170110;12698
2020-11-04;EC;Ecuador;1323;6;171433;12704
2020-11-05;EC;Ecuador;350;26;171783;12730
2020-11-06;EC;Ecuador;725;31;172508;12761
2020-11-07;EC;Ecuador;978;54;173486;12815
2020-11-08;EC;Ecuador;1421;15;174907;12830
2020-11-09;EC;Ecuador;362;9;175269;12839
2020-11-10;EC;Ecuador;442;10;175711;12849
2020-11-11;EC;Ecuador;919;71;176630;12920
2020-11-12;EC;Ecuador;883;26;177513;12946
2020-11-13;EC;Ecuador;1161;31;178674;12977
2020-11-14;EC;Ecuador;953;20;179627;12997
2020-11-15;EC;Ecuador;668;11;180295;13008
2020-11-16;EC;Ecuador;381;8;180676;13016
2020-11-17;EC;Ecuador;428;9;181104;13025
2020-11-18;EC;Ecuador;1146;27;182250;13052
2020-11-19;EC;Ecuador;996;21;183246;13073
2020-11-20;EC;Ecuador;594;22;183840;13095
2020-11-21;EC;Ecuador;1036;44;184876;13139
2020-11-22;EC;Ecuador;767;62;185643;13201
2020-11-23;EC;Ecuador;301;24;185944;13225
2020-11-24;EC;Ecuador;492;39;186436;13264
2020-11-25;EC;Ecuador;794;24;187230;13288
2020-11-26;EC;Ecuador;908;28;188138;13316
2020-11-27;EC;Ecuador;1396;42;189534;13358
2020-11-28;EC;Ecuador;1375;13;190909;13371
2020-11-29;EC;Ecuador;1208;52;192117;13423
2020-11-30;EC;Ecuador;568;38;192685;13461
2020-12-01;EC;Ecuador;988;40;193673;13501
2020-12-02;EC;Ecuador;1203;61;194876;13562
2020-12-03;EC;Ecuador;1008;50;195884;13612
2020-12-04;EC;Ecuador;598;84;196482;13696
2020-12-05;EC;Ecuador;909;60;197391;13756
2020-12-06;EC;Ecuador;607;22;197998;13778
2020-12-07;EC;Ecuador;246;2;198244;13780
2020-12-08;EC;Ecuador;508;14;198752;13794
2020-12-09;EC;Ecuador;476;20;199228;13814
2020-12-10;EC;Ecuador;1151;36;200379;13850
2020-12-11;EC;Ecuador;386;8;200765;13858
2020-12-12;EC;Ecuador;759;16;201524;13874
2020-12-13;EC;Ecuador;586;1;202110;13875
2020-12-14;EC;Ecuador;70;0;202180;13875
2020-12-15;EC;Ecuador;176;21;202356;13896
2020-12-16;EC;Ecuador;1105;19;203461;13915
2020-12-17;EC;Ecuador;788;17;204249;13932
2020-12-18;EC;Ecuador;754;10;205003;13942
2020-12-19;EC;Ecuador;917;6;205920;13948
2020-12-20;EC;Ecuador;337;0;206257;13948
2020-12-21;EC;Ecuador;72;1;206329;13949
2020-12-22;EC;Ecuador;35;0;206364;13949
2020-12-23;EC;Ecuador;720;13;207084;13962
2020-12-24;EC;Ecuador;926;15;208010;13977
2020-12-25;EC;Ecuador;818;7;208828;13984
2020-12-26;EC;Ecuador;446;6;209274;13990
2020-12-27;EC;Ecuador;81;2;209355;13992
2020-12-28;EC;Ecuador;403;2;209758;13994
2020-12-29;EC;Ecuador;568;7;210326;14001
2020-12-30;EC;Ecuador;1186;22;211512;14023
2020-12-31;EC;Ecuador;1000;11;212512;14034
2021-01-01;EC;Ecuador;866;17;213378;14051
2021-01-02;EC;Ecuador;1135;8;214513;14059
2021-01-03;EC;Ecuador;101;0;214614;14059
2021-01-04;EC;Ecuador;466;10;215080;14069
2021-01-05;EC;Ecuador;1003;34;216083;14103
2021-01-06;EC;Ecuador;1294;43;217377;14146
2021-01-07;EC;Ecuador;1008;12;218385;14158
2021-01-08;EC;Ecuador;763;7;219148;14165
2021-01-09;EC;Ecuador;1201;12;220349;14177
2021-01-10;EC;Ecuador;721;0;221070;14177
2021-01-11;EC;Ecuador;436;7;221506;14184
2021-01-12;EC;Ecuador;1061;12;222567;14196
2021-01-13;EC;Ecuador;1748;33;224315;14229
2021-01-14;EC;Ecuador;1687;17;226002;14246
2021-01-15;EC;Ecuador;864;27;226866;14273
2021-01-16;EC;Ecuador;3942;43;230808;14316
2021-01-17;EC;Ecuador;674;3;231482;14319
2021-01-18;EC;Ecuador;162;3;231644;14322
2021-01-19;EC;Ecuador;924;60;232568;14382
2021-01-20;EC;Ecuador;1747;55;234315;14437
2021-01-21;EC;Ecuador;1874;89;236189;14526
2021-01-22;EC;Ecuador;969;36;237158;14562
2021-01-23;EC;Ecuador;1074;34;238232;14596
2021-01-24;EC;Ecuador;3060;27;241292;14623
2021-01-25;EC;Ecuador;275;16;241567;14639
2021-01-26;EC;Ecuador;579;29;242146;14668
2021-01-27;EC;Ecuador;1389;36;243535;14704
2021-01-28;EC;Ecuador;2465;62;246000;14766
2021-01-29;EC;Ecuador;687;36;246687;14802
2021-01-30;EC;Ecuador;3092;49;249779;14851
2021-01-31;EC;Ecuador;1049;8;250828;14859
2021-02-01;EC;Ecuador;158;31;250986;14890
2021-02-02;EC;Ecuador;293;25;251279;14915
2021-02-03;EC;Ecuador;1111;34;252390;14949
2021-02-04;EC;Ecuador;949;19;253339;14968
2021-02-05;EC;Ecuador;2073;14;255412;14982
2021-02-06;EC;Ecuador;1703;22;257115;15004
2021-02-07;EC;Ecuador;1167;8;258282;15012
2021-02-08;EC;Ecuador;325;1;258607;15013
2021-02-09;EC;Ecuador;1176;73;259783;15086
2021-02-10;EC;Ecuador;293;30;260076;15116
2021-02-11;EC;Ecuador;2137;58;262213;15174
2021-02-12;EC;Ecuador;1304;46;263517;15220
2021-02-13;EC;Ecuador;2010;49;265527;15269
2021-02-14;EC;Ecuador;1696;52;267223;15321
2021-02-15;EC;Ecuador;478;34;267701;15355
2021-02-16;EC;Ecuador;372;37;268073;15392
2021-02-17;EC;Ecuador;146;2;268219;15394
2021-02-18;EC;Ecuador;1641;50;269860;15444
2021-02-19;EC;Ecuador;1416;30;271276;15474
2021-02-20;EC;Ecuador;1821;39;273097;15513
2021-02-21;EC;Ecuador;1576;23;274673;15536
2021-02-22;EC;Ecuador;295;11;274968;15547
2021-02-23;EC;Ecuador;812;20;275780;15567
2021-02-24;EC;Ecuador;2999;67;278779;15634
2021-02-25;EC;Ecuador;2390;35;281169;15669
2021-02-26;EC;Ecuador;1430;44;282599;15713
2021-02-27;EC;Ecuador;1748;66;284347;15779
2021-02-28;EC;Ecuador;1808;32;286155;15811
2021-03-01;EC;Ecuador;212;21;286367;15832
2021-03-02;EC;Ecuador;358;18;286725;15850
2021-03-03;EC;Ecuador;2747;71;289472;15921
2021-03-04;EC;Ecuador;263;38;289735;15959
2021-03-05;EC;Ecuador;1335;38;291070;15997
2021-03-06;EC;Ecuador;1873;23;292943;16020
2021-03-07;EC;Ecuador;1560;19;294503;16039
2021-03-08;EC;Ecuador;115;4;294618;16043
2021-03-09;EC;Ecuador;496;26;295114;16069
2021-03-10;EC;Ecuador;1727;36;296841;16105
2021-03-11;EC;Ecuador;1116;23;297957;16128
2021-03-12;EC;Ecuador;1259;65;299216;16193
2021-03-13;EC;Ecuador;1450;22;300666;16215
2021-03-14;EC;Ecuador;1555;21;302221;16236
2021-03-15;EC;Ecuador;277;4;302498;16240
2021-03-16;EC;Ecuador;356;19;302854;16259
2021-03-17;EC;Ecuador;2744;41;305598;16300
2021-03-18;EC;Ecuador;1831;33;307429;16333
2021-03-19;EC;Ecuador;2214;79;309643;16412
2021-03-20;EC;Ecuador;1225;23;310868;16435
2021-03-21;EC;Ecuador;1730;16;312598;16451
2021-03-22;EC;Ecuador;253;27;312851;16478
2021-03-23;EC;Ecuador;719;26;313570;16504
2021-03-24;EC;Ecuador;3237;36;316807;16540
2021-03-25;EC;Ecuador;1849;42;318656;16582
2021-03-26;EC;Ecuador;2795;50;321451;16632
2021-03-27;EC;Ecuador;1248;47;322699;16679
2021-03-28;EC;Ecuador;1783;59;324482;16738
2021-03-29;EC;Ecuador;642;8;325124;16746
2021-03-30;EC;Ecuador;2201;34;327325;16780
2021-03-31;EC;Ecuador;1430;67;328755;16847
2021-04-01;EC;Ecuador;1633;30;330388;16877
2021-04-02;EC;Ecuador;1650;33;332038;16910
2021-04-03;EC;Ecuador;1137;19;333175;16929
2021-04-04;EC;Ecuador;2506;27;335681;16956
2021-04-05;EC;Ecuador;1096;31;336777;16987
2021-04-06;EC;Ecuador;925;17;337702;17004
2021-04-07;EC;Ecuador;1902;53;339604;17057
2021-04-08;EC;Ecuador;2015;58;341619;17115
2021-04-09;EC;Ecuador;1059;43;342678;17158
2021-04-10;EC;Ecuador;2199;117;344877;17275
2021-04-11;EC;Ecuador;1940;18;346817;17293
2021-04-12;EC;Ecuador;253;5;347070;17298
2021-04-13;EC;Ecuador;519;53;347589;17351
2021-04-14;EC;Ecuador;2950;49;350539;17400
2021-04-15;EC;Ecuador;4892;89;355431;17489
2021-04-16;EC;Ecuador;533;39;355964;17528
2021-04-17;EC;Ecuador;2193;113;358157;17641
2021-04-18;EC;Ecuador;2389;62;360546;17703
2021-04-19;EC;Ecuador;17;0;360563;17703
2021-04-20;EC;Ecuador;591;41;361154;17744
2021-04-21;EC;Ecuador;1689;60;362843;17804
2021-04-22;EC;Ecuador;2550;161;365393;17965
2021-04-23;EC;Ecuador;5913;97;371306;18062
2021-04-24;EC;Ecuador;1448;96;372754;18158
2021-04-25;EC;Ecuador;608;19;373362;18177
2021-04-26;EC;Ecuador;1413;123;374775;18300
2021-04-27;EC;Ecuador;554;89;375329;18389
2021-04-28;EC;Ecuador;2333;81;377662;18470
2021-04-29;EC;Ecuador;3027;82;380689;18552
2021-04-30;EC;Ecuador;1173;79;381862;18631
2021-05-01;EC;Ecuador;2727;93;384589;18724
2021-05-02;EC;Ecuador;2710;16;387299;18740
2021-05-03;EC;Ecuador;747;25;388046;18765
2021-05-04;EC;Ecuador;3196;98;391242;18863
2021-05-05;EC;Ecuador;1806;44;393048;18907
2021-05-06;EC;Ecuador;2279;111;395327;19018
2021-05-07;EC;Ecuador;1561;43;396888;19061
2021-05-08;EC;Ecuador;2033;76;398921;19137
2021-05-09;EC;Ecuador;1375;85;400296;19222
2021-05-10;EC;Ecuador;1764;20;402060;19242
2021-05-11;EC;Ecuador;535;44;402595;19286
2021-05-12;EC;Ecuador;2037;63;404632;19349
2021-05-13;EC;Ecuador;1151;93;405783;19442
2021-05-14;EC;Ecuador;1219;72;407002;19514
2021-05-15;EC;Ecuador;2518;178;409520;19692
2021-05-16;EC;Ecuador;609;7;410129;19699
2021-05-17;EC;Ecuador;741;87;410870;19786
2021-05-18;EC;Ecuador;596;91;411466;19877
2021-05-19;EC;Ecuador;1441;102;412907;19979
2021-05-20;EC;Ecuador;2348;43;415255;20022
2021-05-21;EC;Ecuador;1366;85;416621;20107
2021-05-22;EC;Ecuador;1219;73;417840;20180
2021-05-23;EC;Ecuador;1011;13;418851;20193
2021-05-24;EC;Ecuador;347;17;419198;20210
2021-05-25;EC;Ecuador;969;17;420167;20227
2021-05-26;EC;Ecuador;1064;85;421231;20312
2021-05-27;EC;Ecuador;1098;45;422329;20357
2021-05-28;EC;Ecuador;836;51;423165;20408
2021-05-29;EC;Ecuador;1576;77;424741;20485
2021-05-30;EC;Ecuador;1100;60;425841;20545
2021-05-31;EC;Ecuador;196;27;426037;20572
2021-06-01;EC;Ecuador;1653;48;427690;20620
2021-06-02;EC;Ecuador;1175;61;428865;20681
2021-06-03;EC;Ecuador;952;25;429817;20706
2021-06-04;EC;Ecuador;922;49;430739;20755
2021-06-05;EC;Ecuador;690;18;431429;20773
2021-06-06;EC;Ecuador;924;36;432353;20809
2021-06-07;EC;Ecuador;386;5;432739;20814
2021-06-08;EC;Ecuador;246;17;432985;20831
2021-06-09;EC;Ecuador;885;72;433870;20903
2021-06-10;EC;Ecuador;2153;46;436023;20949
2021-06-11;EC;Ecuador;1098;48;437121;20997
2021-06-12;EC;Ecuador;987;21;438108;21018
2021-06-13;EC;Ecuador;826;30;438934;21048
2021-06-14;EC;Ecuador;205;3;439139;21051
2021-06-15;EC;Ecuador;235;10;439374;21061
2021-06-16;EC;Ecuador;1806;92;441180;21153
2021-06-17;EC;Ecuador;1161;22;442341;21175
2021-06-18;EC;Ecuador;2054;59;444395;21234
2021-06-19;EC;Ecuador;1191;50;445586;21284
2021-06-20;EC;Ecuador;855;9;446441;21293
2021-06-21;EC;Ecuador;192;11;446633;21304
2021-06-22;EC;Ecuador;543;11;447176;21315
2021-06-23;EC;Ecuador;1931;52;449107;21367
2021-06-24;EC;Ecuador;376;10;449483;21377
2021-06-25;EC;Ecuador;2751;56;452234;21433
2021-06-26;EC;Ecuador;1131;52;453365;21485
2021-06-27;EC;Ecuador;971;38;454336;21523
2021-06-28;EC;Ecuador;1407;0;455743;21523
2021-06-29;EC;Ecuador;1746;22;457489;21545
2021-06-30;EC;Ecuador;1015;15;458504;21560
2021-07-01;EC;Ecuador;1034;45;459538;21605
2020-02-14;EG;Egypt;1;0;1;0
2020-02-15;EG;Egypt;0;0;1;0
2020-02-16;EG;Egypt;0;0;1;0
2020-02-17;EG;Egypt;0;0;1;0
2020-02-18;EG;Egypt;0;0;1;0
2020-02-19;EG;Egypt;0;0;1;0
2020-02-20;EG;Egypt;0;0;1;0
2020-02-21;EG;Egypt;0;0;1;0
2020-02-22;EG;Egypt;0;0;1;0
2020-02-23;EG;Egypt;0;0;1;0
2020-02-24;EG;Egypt;0;0;1;0
2020-02-25;EG;Egypt;0;0;1;0
2020-02-26;EG;Egypt;0;0;1;0
2020-02-27;EG;Egypt;0;0;1;0
2020-02-28;EG;Egypt;0;0;1;0
2020-02-29;EG;Egypt;0;0;1;0
2020-03-01;EG;Egypt;1;0;2;0
2020-03-02;EG;Egypt;0;0;2;0
2020-03-03;EG;Egypt;0;0;2;0
2020-03-04;EG;Egypt;0;0;2;0
2020-03-05;EG;Egypt;1;0;3;0
2020-03-06;EG;Egypt;12;0;15;0
2020-03-07;EG;Egypt;0;0;15;0
2020-03-08;EG;Egypt;34;1;49;1
2020-03-09;EG;Egypt;6;0;55;1
2020-03-10;EG;Egypt;4;0;59;1
2020-03-11;EG;Egypt;1;0;60;1
2020-03-12;EG;Egypt;7;0;67;1
2020-03-13;EG;Egypt;13;1;80;2
2020-03-14;EG;Egypt;29;0;109;2
2020-03-15;EG;Egypt;1;0;110;2
2020-03-16;EG;Egypt;40;0;150;2
2020-03-17;EG;Egypt;46;2;196;4
2020-03-18;EG;Egypt;0;2;196;6
2020-03-19;EG;Egypt;60;0;256;6
2020-03-20;EG;Egypt;29;2;285;8
2020-03-21;EG;Egypt;9;2;294;10
2020-03-22;EG;Egypt;33;4;327;14
2020-03-23;EG;Egypt;39;5;366;19
2020-03-24;EG;Egypt;36;1;402;20
2020-03-25;EG;Egypt;54;1;456;21
2020-03-26;EG;Egypt;39;3;495;24
2020-03-27;EG;Egypt;41;6;536;30
2020-03-28;EG;Egypt;40;6;576;36
2020-03-29;EG;Egypt;33;4;609;40
2020-03-30;EG;Egypt;47;1;656;41
2020-03-31;EG;Egypt;54;5;710;46
2020-04-01;EG;Egypt;69;6;779;52
2020-04-02;EG;Egypt;86;6;865;58
2020-04-03;EG;Egypt;120;8;985;66
2020-04-04;EG;Egypt;85;5;1070;71
2020-04-05;EG;Egypt;103;7;1173;78
2020-04-06;EG;Egypt;149;7;1322;85
2020-04-07;EG;Egypt;128;9;1450;94
2020-04-08;EG;Egypt;110;9;1560;103
2020-04-09;EG;Egypt;139;15;1699;118
2020-04-10;EG;Egypt;95;17;1794;135
2020-04-11;EG;Egypt;145;11;1939;146
2020-04-12;EG;Egypt;126;13;2065;159
2020-04-13;EG;Egypt;125;5;2190;164
2020-04-14;EG;Egypt;160;14;2350;178
2020-04-15;EG;Egypt;155;5;2505;183
2020-04-16;EG;Egypt;168;13;2673;196
2020-04-17;EG;Egypt;171;9;2844;205
2020-04-18;EG;Egypt;188;19;3032;224
2020-04-19;EG;Egypt;112;15;3144;239
2020-04-20;EG;Egypt;189;11;3333;250
2020-04-21;EG;Egypt;157;14;3490;264
2020-04-22;EG;Egypt;169;12;3659;276
2020-04-23;EG;Egypt;232;11;3891;287
2020-04-24;EG;Egypt;201;7;4092;294
2020-04-25;EG;Egypt;227;13;4319;307
2020-04-26;EG;Egypt;215;10;4534;317
2020-04-27;EG;Egypt;248;20;4782;337
2020-04-28;EG;Egypt;260;22;5042;359
2020-04-29;EG;Egypt;226;21;5268;380
2020-04-30;EG;Egypt;269;12;5537;392
2020-05-01;EG;Egypt;358;14;5895;406
2020-05-02;EG;Egypt;298;9;6193;415
2020-05-03;EG;Egypt;272;14;6465;429
2020-05-04;EG;Egypt;348;7;6813;436
2020-05-05;EG;Egypt;388;16;7201;452
2020-05-06;EG;Egypt;387;17;7588;469
2020-05-07;EG;Egypt;393;13;7981;482
2020-05-08;EG;Egypt;495;21;8476;503
2020-05-09;EG;Egypt;488;11;8964;514
2020-05-10;EG;Egypt;436;11;9400;525
2020-05-11;EG;Egypt;346;8;9746;533
2020-05-12;EG;Egypt;347;11;10093;544
2020-05-13;EG;Egypt;338;12;10431;556
2020-05-14;EG;Egypt;398;15;10829;571
2020-05-15;EG;Egypt;399;21;11228;592
2020-05-16;EG;Egypt;491;20;11719;612
2020-05-17;EG;Egypt;510;18;12229;630
2020-05-18;EG;Egypt;535;15;12764;645
2020-05-19;EG;Egypt;720;14;13484;659
2020-05-20;EG;Egypt;745;21;14229;680
2020-05-21;EG;Egypt;774;16;15003;696
2020-05-22;EG;Egypt;783;11;15786;707
2020-05-23;EG;Egypt;727;28;16513;735
2020-05-24;EG;Egypt;752;29;17265;764
2020-05-25;EG;Egypt;702;19;17967;783
2020-05-26;EG;Egypt;789;14;18756;797
2020-05-27;EG;Egypt;910;19;19666;816
2020-05-28;EG;Egypt;1127;29;20793;845
2020-05-29;EG;Egypt;1289;34;22082;879
2020-05-30;EG;Egypt;1367;34;23449;913
2020-05-31;EG;Egypt;1536;46;24985;959
2020-06-01;EG;Egypt;1399;46;26384;1005
2020-06-02;EG;Egypt;1152;47;27536;1052
2020-06-03;EG;Egypt;1079;36;28615;1088
2020-06-04;EG;Egypt;1152;38;29767;1126
2020-06-05;EG;Egypt;1348;40;31115;1166
2020-06-06;EG;Egypt;1497;32;32612;1198
2020-06-07;EG;Egypt;1467;39;34079;1237
2020-06-08;EG;Egypt;1365;34;35444;1271
2020-06-09;EG;Egypt;1385;35;36829;1306
2020-06-10;EG;Egypt;1455;36;38284;1342
2020-06-11;EG;Egypt;1442;35;39726;1377
2020-06-12;EG;Egypt;1577;45;41303;1422
2020-06-13;EG;Egypt;1677;62;42980;1484
2020-06-14;EG;Egypt;1618;91;44598;1575
2020-06-15;EG;Egypt;1691;97;46289;1672
2020-06-16;EG;Egypt;1567;94;47856;1766
2020-06-17;EG;Egypt;1363;84;49219;1850
2020-06-18;EG;Egypt;1218;88;50437;1938
2020-06-19;EG;Egypt;1774;79;52211;2017
2020-06-20;EG;Egypt;1547;89;53758;2106
2020-06-21;EG;Egypt;1475;87;55233;2193
2020-06-22;EG;Egypt;1576;85;56809;2278
2020-06-23;EG;Egypt;1332;87;58141;2365
2020-06-24;EG;Egypt;1420;85;59561;2450
2020-06-25;EG;Egypt;1569;83;61130;2533
2020-06-26;EG;Egypt;1625;87;62755;2620
2020-06-27;EG;Egypt;1168;88;63923;2708
2020-06-28;EG;Egypt;1265;81;65188;2789
2020-06-29;EG;Egypt;1566;83;66754;2872
2020-06-30;EG;Egypt;1557;81;68311;2953
2020-07-01;EG;Egypt;1503;81;69814;3034
2020-07-02;EG;Egypt;1485;86;71299;3120
2020-07-03;EG;Egypt;1412;81;72711;3201
2020-07-04;EG;Egypt;1324;79;74035;3280
2020-07-05;EG;Egypt;1218;63;75253;3343
2020-07-06;EG;Egypt;969;79;76222;3422
2020-07-07;EG;Egypt;1057;67;77279;3489
2020-07-08;EG;Egypt;1025;75;78304;3564
2020-07-09;EG;Egypt;950;53;79254;3617
2020-07-10;EG;Egypt;981;85;80235;3702
2020-07-11;EG;Egypt;923;67;81158;3769
2020-07-12;EG;Egypt;912;89;82070;3858
2020-07-13;EG;Egypt;931;77;83001;3935
2020-07-14;EG;Egypt;929;73;83930;4008
2020-07-15;EG;Egypt;913;59;84843;4067
2020-07-16;EG;Egypt;928;53;85771;4120
2020-07-17;EG;Egypt;703;68;86474;4188
2020-07-18;EG;Egypt;698;63;87172;4251
2020-07-19;EG;Egypt;603;51;87775;4302
2020-07-20;EG;Egypt;627;50;88402;4352
2020-07-21;EG;Egypt;676;47;89078;4399
2020-07-22;EG;Egypt;667;41;89745;4440
2020-07-23;EG;Egypt;668;40;90413;4480
2020-07-24;EG;Egypt;659;38;91072;4518
2020-07-25;EG;Egypt;511;40;91583;4558
2020-07-26;EG;Egypt;479;48;92062;4606
2020-07-27;EG;Egypt;420;46;92482;4652
2020-07-28;EG;Egypt;465;39;92947;4691
2020-07-29;EG;Egypt;409;37;93356;4728
2020-07-30;EG;Egypt;401;46;93757;4774
2020-07-31;EG;Egypt;321;31;94078;4805
2020-08-01;EG;Egypt;238;29;94316;4834
2020-08-02;EG;Egypt;167;31;94483;4865
2020-08-03;EG;Egypt;157;23;94640;4888
2020-08-04;EG;Egypt;112;24;94752;4912
2020-08-05;EG;Egypt;123;18;94875;4930
2020-08-06;EG;Egypt;131;21;95006;4951
2020-08-07;EG;Egypt;141;20;95147;4971
2020-08-08;EG;Egypt;167;21;95314;4992
2020-08-09;EG;Egypt;178;17;95492;5009
2020-08-10;EG;Egypt;174;26;95666;5035
2020-08-11;EG;Egypt;168;24;95834;5059
2020-08-12;EG;Egypt;129;26;95963;5085
2020-08-13;EG;Egypt;145;22;96108;5107
2020-08-14;EG;Egypt;112;17;96220;5124
2020-08-15;EG;Egypt;116;17;96336;5141
2020-08-16;EG;Egypt;139;19;96475;5160
2020-08-17;EG;Egypt;115;13;96590;5173
2020-08-18;EG;Egypt;163;11;96753;5184
2020-08-19;EG;Egypt;161;13;96914;5197
2020-08-20;EG;Egypt;111;15;97025;5212
2020-08-21;EG;Egypt;123;19;97148;5231
2020-08-22;EG;Egypt;89;12;97237;5243
2020-08-23;EG;Egypt;103;19;97340;5262
2020-08-24;EG;Egypt;138;18;97478;5280
2020-08-25;EG;Egypt;141;18;97619;5298
2020-08-26;EG;Egypt;206;19;97825;5317
2020-08-27;EG;Egypt;237;25;98062;5342
2020-08-28;EG;Egypt;223;20;98285;5362
2020-08-29;EG;Egypt;212;14;98497;5376
2020-08-30;EG;Egypt;230;23;98727;5399
2020-08-31;EG;Egypt;212;22;98939;5421
2020-09-01;EG;Egypt;176;19;99115;5440
2020-09-02;EG;Egypt;165;21;99280;5461
2020-09-03;EG;Egypt;145;18;99425;5479
2020-09-04;EG;Egypt;157;16;99582;5495
2020-09-05;EG;Egypt;130;16;99712;5511
2020-09-06;EG;Egypt;151;19;99863;5530
2020-09-07;EG;Egypt;178;11;100041;5541
2020-09-08;EG;Egypt;187;19;100228;5560
2020-09-09;EG;Egypt;175;17;100403;5577
2020-09-10;EG;Egypt;154;13;100557;5590
2020-09-11;EG;Egypt;151;17;100708;5607
2020-09-12;EG;Egypt;148;20;100856;5627
2020-09-13;EG;Egypt;153;21;101009;5648
2020-09-14;EG;Egypt;168;13;101177;5661
2020-09-15;EG;Egypt;163;18;101340;5679
2020-09-16;EG;Egypt;160;17;101500;5696
2020-09-17;EG;Egypt;141;19;101641;5715
2020-09-18;EG;Egypt;131;18;101772;5733
2020-09-19;EG;Egypt;128;17;101900;5750
2020-09-20;EG;Egypt;115;20;102015;5770
2020-09-21;EG;Egypt;126;17;102141;5787
2020-09-22;EG;Egypt;113;19;102254;5806
2020-09-23;EG;Egypt;121;16;102375;5822
2020-09-24;EG;Egypt;138;13;102513;5835
2020-09-25;EG;Egypt;112;18;102625;5853
2020-09-26;EG;Egypt;111;16;102736;5869
2020-09-27;EG;Egypt;104;14;102840;5883
2020-09-28;EG;Egypt;115;18;102955;5901
2020-09-29;EG;Egypt;124;13;103079;5914
2020-09-30;EG;Egypt;119;16;103198;5930
2020-10-01;EG;Egypt;119;16;103317;5946
2020-10-02;EG;Egypt;149;10;103466;5956
2020-10-03;EG;Egypt;109;14;103575;5970
2020-10-04;EG;Egypt;108;11;103683;5981
2020-10-05;EG;Egypt;98;9;103781;5990
2020-10-06;EG;Egypt;121;11;103902;6001
2020-10-07;EG;Egypt;133;9;104035;6010
2020-10-08;EG;Egypt;121;7;104156;6017
2020-10-09;EG;Egypt;106;12;104262;6029
2020-10-10;EG;Egypt;125;11;104387;6040
2020-10-11;EG;Egypt;129;12;104516;6052
2020-10-12;EG;Egypt;132;10;104648;6062
2020-10-13;EG;Egypt;139;9;104787;6071
2020-10-14;EG;Egypt;128;6;104915;6077
2020-10-15;EG;Egypt;118;11;105033;6088
2020-10-16;EG;Egypt;126;11;105159;6099
2020-10-17;EG;Egypt;138;10;105297;6109
2020-10-18;EG;Egypt;127;11;105424;6120
2020-10-19;EG;Egypt;123;10;105547;6130
2020-10-20;EG;Egypt;158;12;105705;6142
2020-10-21;EG;Egypt;178;13;105883;6155
2020-10-22;EG;Egypt;177;11;106060;6166
2020-10-23;EG;Egypt;170;10;106230;6176
2020-10-24;EG;Egypt;167;11;106397;6187
2020-10-25;EG;Egypt;143;12;106540;6199
2020-10-26;EG;Egypt;167;12;106707;6211
2020-10-27;EG;Egypt;170;11;106877;6222
2020-10-28;EG;Egypt;153;12;107030;6234
2020-10-29;EG;Egypt;179;13;107209;6247
2020-10-30;EG;Egypt;167;11;107376;6258
2020-10-31;EG;Egypt;179;8;107555;6266
2020-11-01;EG;Egypt;181;12;107736;6278
2020-11-02;EG;Egypt;189;13;107925;6291
2020-11-03;EG;Egypt;197;14;108122;6305
2020-11-04;EG;Egypt;207;13;108329;6318
2020-11-05;EG;Egypt;201;11;108530;6329
2020-11-06;EG;Egypt;224;14;108754;6343
2020-11-07;EG;Egypt;208;12;108962;6355
2020-11-08;EG;Egypt;239;13;109201;6368
2020-11-09;EG;Egypt;221;12;109422;6380
2020-11-10;EG;Egypt;232;14;109654;6394
2020-11-11;EG;Egypt;227;11;109881;6405
2020-11-12;EG;Egypt;214;12;110095;6417
2020-11-13;EG;Egypt;224;12;110319;6429
2020-11-14;EG;Egypt;228;13;110547;6442
2020-11-15;EG;Egypt;220;11;110767;6453
2020-11-16;EG;Egypt;242;12;111009;6465
2020-11-17;EG;Egypt;275;16;111284;6481
2020-11-18;EG;Egypt;329;14;111613;6495
2020-11-19;EG;Egypt;342;13;111955;6508
2020-11-20;EG;Egypt;363;13;112318;6521
2020-11-21;EG;Egypt;358;14;112676;6535
2020-11-22;EG;Egypt;351;13;113027;6548
2020-11-23;EG;Egypt;354;12;113381;6560
2020-11-24;EG;Egypt;361;13;113742;6573
2020-11-25;EG;Egypt;365;12;114107;6585
2020-11-26;EG;Egypt;368;11;114475;6596
2020-11-27;EG;Egypt;357;12;114832;6608
2020-11-28;EG;Egypt;351;13;115183;6621
2020-11-29;EG;Egypt;358;15;115541;6636
2020-11-30;EG;Egypt;370;14;115911;6650
2020-12-01;EG;Egypt;392;16;116303;6666
2020-12-02;EG;Egypt;421;28;116724;6694
2020-12-03;EG;Egypt;432;19;117156;6713
2020-12-04;EG;Egypt;427;19;117583;6732
2020-12-05;EG;Egypt;431;18;118014;6750
2020-12-06;EG;Egypt;418;21;118432;6771
2020-12-07;EG;Egypt;415;19;118847;6790
2020-12-08;EG;Egypt;434;23;119281;6813
2020-12-09;EG;Egypt;421;19;119702;6832
2020-12-10;EG;Egypt;445;22;120147;6854
2020-12-11;EG;Egypt;464;23;120611;6877
2020-12-12;EG;Egypt;478;21;121089;6898
2020-12-13;EG;Egypt;486;22;121575;6920
2020-12-14;EG;Egypt;511;23;122086;6943
2020-12-15;EG;Egypt;523;23;122609;6966
2020-12-16;EG;Egypt;544;24;123153;6990
2020-12-17;EG;Egypt;548;25;123701;7015
2020-12-18;EG;Egypt;579;26;124280;7041
2020-12-19;EG;Egypt;611;28;124891;7069
2020-12-20;EG;Egypt;664;29;125555;7098
2020-12-21;EG;Egypt;718;32;126273;7130
2020-12-22;EG;Egypt;788;37;127061;7167
2020-12-23;EG;Egypt;911;42;127972;7209
2020-12-24;EG;Egypt;1021;51;128993;7260
2020-12-25;EG;Egypt;1133;49;130126;7309
2020-12-26;EG;Egypt;1189;43;131315;7352
2020-12-27;EG;Egypt;1226;53;132541;7405
2020-12-28;EG;Egypt;1359;61;133900;7466
2020-12-29;EG;Egypt;1333;54;135233;7520
2020-12-30;EG;Egypt;1411;56;136644;7576
2020-12-31;EG;Egypt;1418;55;138062;7631
2021-01-01;EG;Egypt;1409;56;139471;7687
2021-01-02;EG;Egypt;1407;54;140878;7741
2021-01-03;EG;Egypt;1309;64;142187;7805
2021-01-04;EG;Egypt;1277;58;143464;7863
2021-01-05;EG;Egypt;1119;55;144583;7918
2021-01-06;EG;Egypt;1007;57;145590;7975
2021-01-07;EG;Egypt;1219;54;146809;8029
2021-01-08;EG;Egypt;1001;56;147810;8085
2021-01-09;EG;Egypt;989;57;148799;8142
2021-01-10;EG;Egypt;993;55;149792;8197
2021-01-11;EG;Egypt;961;52;150753;8249
2021-01-12;EG;Egypt;970;55;151723;8304
2021-01-13;EG;Egypt;996;58;152719;8362
2021-01-14;EG;Egypt;1022;59;153741;8421
2021-01-15;EG;Egypt;879;52;154620;8473
2021-01-16;EG;Egypt;887;54;155507;8527
2021-01-17;EG;Egypt;890;56;156397;8583
2021-01-18;EG;Egypt;878;55;157275;8638
2021-01-19;EG;Egypt;899;58;158174;8696
2021-01-20;EG;Egypt;789;51;158963;8747
2021-01-21;EG;Egypt;752;54;159715;8801
2021-01-22;EG;Egypt;748;52;160463;8853
2021-01-23;EG;Egypt;680;49;161143;8902
2021-01-24;EG;Egypt;674;57;161817;8959
2021-01-25;EG;Egypt;669;53;162486;9012
2021-01-26;EG;Egypt;643;55;163129;9067
2021-01-27;EG;Egypt;632;48;163761;9115
2021-01-28;EG;Egypt;521;54;164282;9169
2021-01-29;EG;Egypt;589;48;164871;9217
2021-01-30;EG;Egypt;547;46;165418;9263
2021-01-31;EG;Egypt;533;53;165951;9316
2021-02-01;EG;Egypt;541;44;166492;9360
2021-02-02;EG;Egypt;521;47;167013;9407
2021-02-03;EG;Egypt;512;53;167525;9460
2021-02-04;EG;Egypt;532;52;168057;9512
2021-02-05;EG;Egypt;540;48;168597;9560
2021-02-06;EG;Egypt;509;44;169106;9604
2021-02-07;EG;Egypt;534;47;169640;9651
2021-02-08;EG;Egypt;567;48;170207;9699
2021-02-09;EG;Egypt;573;52;170780;9751
2021-02-10;EG;Egypt;610;53;171390;9804
2021-02-11;EG;Egypt;603;53;171993;9857
2021-02-12;EG;Egypt;609;42;172602;9899
2021-02-13;EG;Egypt;600;36;173202;9935
2021-02-14;EG;Egypt;611;59;173813;9994
2021-02-15;EG;Egypt;613;56;174426;10050
2021-02-16;EG;Egypt;633;51;175059;10101
2021-02-17;EG;Egypt;618;49;175677;10150
2021-02-18;EG;Egypt;656;51;176333;10201
2021-02-19;EG;Egypt;610;49;176943;10250
2021-02-20;EG;Egypt;600;48;177543;10298
2021-02-21;EG;Egypt;608;55;178151;10353
2021-02-22;EG;Egypt;623;51;178774;10404
2021-02-23;EG;Egypt;633;39;179407;10443
2021-02-24;EG;Egypt;644;52;180051;10495
2021-02-25;EG;Egypt;589;46;180640;10541
2021-02-26;EG;Egypt;601;49;181241;10590
2021-02-27;EG;Egypt;588;49;181829;10639
2021-02-28;EG;Egypt;595;49;182424;10688
2021-03-01;EG;Egypt;586;48;183010;10736
2021-03-02;EG;Egypt;581;42;183591;10778
2021-03-03;EG;Egypt;577;44;184168;10822
2021-03-04;EG;Egypt;587;49;184755;10871
2021-03-05;EG;Egypt;579;45;185334;10916
2021-03-06;EG;Egypt;588;38;185922;10954
2021-03-07;EG;Egypt;581;41;186503;10995
2021-03-08;EG;Egypt;591;43;187094;11038
2021-03-09;EG;Egypt;622;44;187716;11082
2021-03-10;EG;Egypt;645;46;188361;11128
2021-03-11;EG;Egypt;639;41;189000;11169
2021-03-12;EG;Egypt;639;45;189639;11214
2021-03-13;EG;Egypt;641;42;190280;11256
2021-03-14;EG;Egypt;644;44;190924;11300
2021-03-15;EG;Egypt;631;40;191555;11340
2021-03-16;EG;Egypt;640;44;192195;11384
2021-03-17;EG;Egypt;645;47;192840;11431
2021-03-18;EG;Egypt;642;41;193482;11472
2021-03-19;EG;Egypt;645;40;194127;11512
2021-03-20;EG;Egypt;644;45;194771;11557
2021-03-21;EG;Egypt;647;41;195418;11598
2021-03-22;EG;Egypt;643;39;196061;11637
2021-03-23;EG;Egypt;648;43;196709;11680
2021-03-24;EG;Egypt;641;40;197350;11720
2021-03-25;EG;Egypt;661;48;198011;11768
2021-03-26;EG;Egypt;670;36;198681;11804
2021-03-27;EG;Egypt;683;41;199364;11845
2021-03-28;EG;Egypt;686;37;200050;11882
2021-03-29;EG;Egypt;689;32;200739;11914
2021-03-30;EG;Egypt;693;42;201432;11956
2021-03-31;EG;Egypt;699;39;202131;11995
2021-04-01;EG;Egypt;712;46;202843;12041
2021-04-02;EG;Egypt;703;43;203546;12084
2021-04-03;EG;Egypt;710;39;204256;12123
2021-04-04;EG;Egypt;709;40;204965;12163
2021-04-05;EG;Egypt;767;47;205732;12210
2021-04-06;EG;Egypt;778;43;206510;12253
2021-04-07;EG;Egypt;783;37;207293;12290
2021-04-08;EG;Egypt;789;33;208082;12323
2021-04-09;EG;Egypt;794;39;208876;12362
2021-04-10;EG;Egypt;801;43;209677;12405
2021-04-11;EG;Egypt;812;40;210489;12445
2021-04-12;EG;Egypt;818;42;211307;12487
2021-04-13;EG;Egypt;823;39;212130;12526
2021-04-14;EG;Egypt;831;44;212961;12570
2021-04-15;EG;Egypt;837;41;213798;12611
2021-04-16;EG;Egypt;841;42;214639;12653
2021-04-17;EG;Egypt;845;41;215484;12694
2021-04-18;EG;Egypt;850;44;216334;12738
2021-04-19;EG;Egypt;852;40;217186;12778
2021-04-20;EG;Egypt;855;42;218041;12820
2021-04-21;EG;Egypt;861;46;218902;12866
2021-04-22;EG;Egypt;872;48;219774;12914
2021-04-23;EG;Egypt;884;45;220658;12959
2021-04-24;EG;Egypt;912;39;221570;12998
2021-04-25;EG;Egypt;953;51;222523;13049
2021-04-26;EG;Egypt;991;58;223514;13107
2021-04-27;EG;Egypt;1003;61;224517;13168
2021-04-28;EG;Egypt;1011;51;225528;13219
2021-04-29;EG;Egypt;1003;59;226531;13278
2021-04-30;EG;Egypt;1021;61;227552;13339
2021-05-01;EG;Egypt;1032;63;228584;13402
2021-05-02;EG;Egypt;1051;67;229635;13469
2021-05-03;EG;Egypt;1078;62;230713;13531
2021-05-04;EG;Egypt;1090;60;231803;13591
2021-05-05;EG;Egypt;1102;64;232905;13655
2021-05-06;EG;Egypt;1110;59;234015;13714
2021-05-07;EG;Egypt;1125;65;235140;13779
2021-05-08;EG;Egypt;1132;66;236272;13845
2021-05-09;EG;Egypt;1138;59;237410;13904
2021-05-10;EG;Egypt;1150;68;238560;13972
2021-05-11;EG;Egypt;1180;61;239740;14033
2021-05-12;EG;Egypt;1187;58;240927;14091
2021-05-13;EG;Egypt;1193;59;242120;14150
2021-05-14;EG;Egypt;1197;56;243317;14206
2021-05-15;EG;Egypt;1203;63;244520;14269
2021-05-16;EG;Egypt;1201;58;245721;14327
2021-05-17;EG;Egypt;1188;61;246909;14388
2021-05-18;EG;Egypt;1169;53;248078;14441
2021-05-19;EG;Egypt;1160;57;249238;14498
2021-05-20;EG;Egypt;1153;61;250391;14559
2021-05-21;EG;Egypt;1148;52;251539;14611
2021-05-22;EG;Egypt;1151;59;252690;14670
2021-05-23;EG;Egypt;1145;51;253835;14721
2021-05-24;EG;Egypt;1149;45;254984;14766
2021-05-25;EG;Egypt;1140;41;256124;14807
2021-05-26;EG;Egypt;1151;43;257275;14850
2021-05-27;EG;Egypt;1132;54;258407;14904
2021-05-28;EG;Egypt;1133;46;259540;14950
2021-05-29;EG;Egypt;1119;51;260659;15001
2021-05-30;EG;Egypt;1007;46;261666;15047
2021-05-31;EG;Egypt;984;49;262650;15096
2021-06-01;EG;Egypt;956;40;263606;15136
2021-06-02;EG;Egypt;951;42;264557;15178
2021-06-03;EG;Egypt;932;44;265489;15222
2021-06-04;EG;Egypt;861;46;266350;15268
2021-06-05;EG;Egypt;821;41;267171;15309
2021-06-06;EG;Egypt;801;43;267972;15352
2021-06-07;EG;Egypt;782;47;268754;15399
2021-06-08;EG;Egypt;773;38;269527;15437
2021-06-09;EG;Egypt;765;34;270292;15471
2021-06-10;EG;Egypt;755;39;271047;15510
2021-06-11;EG;Egypt;733;37;271780;15547
2021-06-12;EG;Egypt;711;35;272491;15582
2021-06-13;EG;Egypt;691;41;273182;15623
2021-06-14;EG;Egypt;613;31;273795;15654
2021-06-15;EG;Egypt;609;37;274404;15691
2021-06-16;EG;Egypt;606;32;275010;15723
2021-06-17;EG;Egypt;591;37;275601;15760
2021-06-18;EG;Egypt;589;31;276190;15791
2021-06-19;EG;Egypt;566;38;276756;15829
2021-06-20;EG;Egypt;532;30;277288;15859
2021-06-21;EG;Egypt;509;39;277797;15898
2021-06-22;EG;Egypt;498;37;278295;15935
2021-06-23;EG;Egypt;466;32;278761;15967
2021-06-24;EG;Egypt;423;35;279184;16002
2021-06-25;EG;Egypt;412;29;279596;16031
2021-06-26;EG;Egypt;409;31;280005;16062
2021-06-27;EG;Egypt;389;30;280394;16092
2021-06-28;EG;Egypt;376;33;280770;16125
2021-06-29;EG;Egypt;261;23;281031;16148
2021-06-30;EG;Egypt;251;21;281282;16169
2021-07-01;EG;Egypt;242;25;281524;16194
2020-03-19;SV;El Salvador;1;0;1;0
2020-03-20;SV;El Salvador;0;0;1;0
2020-03-21;SV;El Salvador;2;0;3;0
2020-03-22;SV;El Salvador;0;0;3;0
2020-03-23;SV;El Salvador;0;0;3;0
2020-03-24;SV;El Salvador;2;0;5;0
2020-03-25;SV;El Salvador;4;0;9;0
2020-03-26;SV;El Salvador;4;0;13;0
2020-03-27;SV;El Salvador;0;0;13;0
2020-03-28;SV;El Salvador;6;0;19;0
2020-03-29;SV;El Salvador;5;0;24;0
2020-03-30;SV;El Salvador;6;0;30;0
2020-03-31;SV;El Salvador;2;1;32;1
2020-04-01;SV;El Salvador;0;0;32;1
2020-04-02;SV;El Salvador;9;1;41;2
2020-04-03;SV;El Salvador;5;0;46;2
2020-04-04;SV;El Salvador;10;1;56;3
2020-04-05;SV;El Salvador;6;0;62;3
2020-04-06;SV;El Salvador;7;1;69;4
2020-04-07;SV;El Salvador;9;0;78;4
2020-04-08;SV;El Salvador;15;1;93;5
2020-04-09;SV;El Salvador;10;1;103;6
2020-04-10;SV;El Salvador;14;0;117;6
2020-04-11;SV;El Salvador;1;0;118;6
2020-04-12;SV;El Salvador;7;0;125;6
2020-04-13;SV;El Salvador;12;0;137;6
2020-04-14;SV;El Salvador;12;0;149;6
2020-04-15;SV;El Salvador;10;0;159;6
2020-04-16;SV;El Salvador;5;0;164;6
2020-04-17;SV;El Salvador;13;1;177;7
2020-04-18;SV;El Salvador;13;0;190;7
2020-04-19;SV;El Salvador;11;0;201;7
2020-04-20;SV;El Salvador;17;0;218;7
2020-04-21;SV;El Salvador;7;0;225;7
2020-04-22;SV;El Salvador;12;0;237;7
2020-04-23;SV;El Salvador;13;1;250;8
2020-04-24;SV;El Salvador;24;0;274;8
2020-04-25;SV;El Salvador;0;0;274;8
2020-04-26;SV;El Salvador;24;0;298;8
2020-04-27;SV;El Salvador;25;0;323;8
2020-04-28;SV;El Salvador;22;0;345;8
2020-04-29;SV;El Salvador;32;1;377;9
2020-04-30;SV;El Salvador;18;1;395;10
2020-05-01;SV;El Salvador;29;0;424;10
2020-05-02;SV;El Salvador;22;1;446;11
2020-05-03;SV;El Salvador;44;0;490;11
2020-05-04;SV;El Salvador;65;2;555;13
2020-05-05;SV;El Salvador;32;1;587;14
2020-05-06;SV;El Salvador;46;1;633;15
2020-05-07;SV;El Salvador;62;0;695;15
2020-05-08;SV;El Salvador;47;1;742;16
2020-05-09;SV;El Salvador;42;1;784;17
2020-05-10;SV;El Salvador;105;0;889;17
2020-05-11;SV;El Salvador;69;1;958;18
2020-05-12;SV;El Salvador;40;2;998;20
2020-05-13;SV;El Salvador;39;0;1037;20
2020-05-14;SV;El Salvador;75;3;1112;23
2020-05-15;SV;El Salvador;98;2;1210;25
2020-05-16;SV;El Salvador;55;1;1265;26
2020-05-17;SV;El Salvador;73;4;1338;30
2020-05-18;SV;El Salvador;75;0;1413;30
2020-05-19;SV;El Salvador;85;0;1498;30
2020-05-20;SV;El Salvador;73;1;1571;31
2020-05-21;SV;El Salvador;69;2;1640;33
2020-05-22;SV;El Salvador;85;0;1725;33
2020-05-23;SV;El Salvador;94;0;1819;33
2020-05-24;SV;El Salvador;96;2;1915;35
2020-05-25;SV;El Salvador;68;0;1983;35
2020-05-26;SV;El Salvador;59;1;2042;36
2020-05-27;SV;El Salvador;67;3;2109;39
2020-05-28;SV;El Salvador;85;0;2194;39
2020-05-29;SV;El Salvador;84;3;2278;42
2020-05-30;SV;El Salvador;117;4;2395;46
2020-05-31;SV;El Salvador;122;0;2517;46
2020-06-01;SV;El Salvador;65;0;2582;46
2020-06-02;SV;El Salvador;71;3;2653;49
2020-06-03;SV;El Salvador;52;2;2705;51
2020-06-04;SV;El Salvador;76;1;2781;52
2020-06-05;SV;El Salvador;68;1;2849;53
2020-06-06;SV;El Salvador;85;0;2934;53
2020-06-07;SV;El Salvador;81;0;3015;53
2020-06-08;SV;El Salvador;89;3;3104;56
2020-06-09;SV;El Salvador;87;4;3191;60
2020-06-10;SV;El Salvador;83;4;3274;64
2020-06-11;SV;El Salvador;99;4;3373;68
2020-06-12;SV;El Salvador;108;0;3481;68
2020-06-13;SV;El Salvador;122;4;3603;72
2020-06-14;SV;El Salvador;117;2;3720;74
2020-06-15;SV;El Salvador;106;0;3826;74
2020-06-16;SV;El Salvador;115;2;3941;76
2020-06-17;SV;El Salvador;125;3;4066;79
2020-06-18;SV;El Salvador;134;3;4200;82
2020-06-19;SV;El Salvador;129;4;4329;86
2020-06-20;SV;El Salvador;146;7;4475;93
2020-06-21;SV;El Salvador;151;5;4626;98
2020-06-22;SV;El Salvador;182;9;4808;107
2020-06-23;SV;El Salvador;165;6;4973;113
2020-06-24;SV;El Salvador;177;6;5150;119
2020-06-25;SV;El Salvador;186;7;5336;126
2020-06-26;SV;El Salvador;181;7;5517;133
2020-06-27;SV;El Salvador;210;10;5727;143
2020-06-28;SV;El Salvador;207;9;5934;152
2020-06-29;SV;El Salvador;239;12;6173;164
2020-06-30;SV;El Salvador;265;10;6438;174
2020-07-01;SV;El Salvador;298;8;6736;182
2020-07-02;SV;El Salvador;264;9;7000;191
2020-07-03;SV;El Salvador;267;11;7267;202
2020-07-04;SV;El Salvador;240;8;7507;210
2020-07-05;SV;El Salvador;270;7;7777;217
2020-07-06;SV;El Salvador;250;6;8027;223
2020-07-07;SV;El Salvador;280;6;8307;229
2020-07-08;SV;El Salvador;259;6;8566;235
2020-07-09;SV;El Salvador;278;8;8844;243
2020-07-10;SV;El Salvador;298;6;9142;249
2020-07-11;SV;El Salvador;249;5;9391;254
2020-07-12;SV;El Salvador;283;6;9674;260
2020-07-13;SV;El Salvador;304;7;9978;267
2020-07-14;SV;El Salvador;325;11;10303;278
2020-07-15;SV;El Salvador;342;8;10645;286
2020-07-16;SV;El Salvador;312;12;10957;298
2020-07-17;SV;El Salvador;250;11;11207;309
2020-07-18;SV;El Salvador;301;15;11508;324
2020-07-19;SV;El Salvador;338;11;11846;335
2020-07-20;SV;El Salvador;361;9;12207;344
2020-07-21;SV;El Salvador;375;8;12582;352
2020-07-22;SV;El Salvador;393;11;12975;363
2020-07-23;SV;El Salvador;402;9;13377;372
2020-07-24;SV;El Salvador;415;7;13792;379
2020-07-25;SV;El Salvador;429;11;14221;390
2020-07-26;SV;El Salvador;409;10;14630;400
2020-07-27;SV;El Salvador;405;8;15035;408
2020-07-28;SV;El Salvador;411;9;15446;417
2020-07-29;SV;El Salvador;395;13;15841;430
2020-07-30;SV;El Salvador;389;9;16230;439
2020-07-31;SV;El Salvador;402;9;16632;448
2020-08-01;SV;El Salvador;418;11;17050;459
2020-08-02;SV;El Salvador;398;8;17448;467
2020-08-03;SV;El Salvador;395;10;17843;477
2020-08-04;SV;El Salvador;419;9;18262;486
2020-08-05;SV;El Salvador;439;12;18701;498
2020-08-06;SV;El Salvador;425;15;19126;513
2020-08-07;SV;El Salvador;418;7;19544;520
2020-08-08;SV;El Salvador;434;16;19978;536
2020-08-09;SV;El Salvador;445;13;20423;549
2020-08-10;SV;El Salvador;449;14;20872;563
2020-08-11;SV;El Salvador;397;7;21269;570
2020-08-12;SV;El Salvador;375;7;21644;577
2020-08-13;SV;El Salvador;349;7;21993;584
2020-08-14;SV;El Salvador;321;11;22314;595
2020-08-15;SV;El Salvador;305;8;22619;603
2020-08-16;SV;El Salvador;293;9;22912;612
2020-08-17;SV;El Salvador;281;6;23193;618
2020-08-18;SV;El Salvador;269;7;23462;625
2020-08-19;SV;El Salvador;255;8;23717;633
2020-08-20;SV;El Salvador;247;7;23964;640
2020-08-21;SV;El Salvador;236;6;24200;646
2020-08-22;SV;El Salvador;220;8;24420;654
2020-08-23;SV;El Salvador;202;7;24622;661
2020-08-24;SV;El Salvador;189;8;24811;669
2020-08-25;SV;El Salvador;175;9;24986;678
2020-08-26;SV;El Salvador;154;9;25140;687
2020-08-27;SV;El Salvador;144;7;25284;694
2020-08-28;SV;El Salvador;131;8;25415;702
2020-08-29;SV;El Salvador;122;6;25537;708
2020-08-30;SV;El Salvador;98;5;25635;713
2020-08-31;SV;El Salvador;94;4;25729;717
2020-09-01;SV;El Salvador;91;7;25820;724
2020-09-02;SV;El Salvador;84;7;25904;731
2020-09-03;SV;El Salvador;96;8;26000;739
2020-09-04;SV;El Salvador;99;5;26099;744
2020-09-05;SV;El Salvador;107;8;26206;752
2020-09-06;SV;El Salvador;102;7;26308;759
2020-09-07;SV;El Salvador;105;5;26413;764
2020-09-08;SV;El Salvador;98;1;26511;765
2020-09-09;SV;El Salvador;91;5;26602;770
2020-09-10;SV;El Salvador;86;4;26688;774
2020-09-11;SV;El Salvador;85;3;26773;777
2020-09-12;SV;El Salvador;78;5;26851;782
2020-09-13;SV;El Salvador;77;3;26928;785
2020-09-14;SV;El Salvador;81;3;27009;788
2020-09-15;SV;El Salvador;79;4;27088;792
2020-09-16;SV;El Salvador;75;4;27163;796
2020-09-17;SV;El Salvador;86;5;27249;801
2020-09-18;SV;El Salvador;97;3;27346;804
2020-09-19;SV;El Salvador;82;4;27428;808
2020-09-20;SV;El Salvador;125;3;27553;811
2020-09-21;SV;El Salvador;245;1;27798;812
2020-09-22;SV;El Salvador;156;2;27954;814
2020-09-23;SV;El Salvador;247;5;28201;819
2020-09-24;SV;El Salvador;214;4;28415;823
2020-09-25;SV;El Salvador;215;3;28630;826
2020-09-26;SV;El Salvador;92;0;28722;826
2020-09-27;SV;El Salvador;-92;0;28630;826
2020-09-28;SV;El Salvador;179;5;28809;831
2020-09-29;SV;El Salvador;172;8;28981;839
2020-09-30;SV;El Salvador;96;4;29077;843
2020-10-01;SV;El Salvador;98;5;29175;848
2020-10-02;SV;El Salvador;94;5;29269;853
2020-10-03;SV;El Salvador;89;4;29358;857
2020-10-04;SV;El Salvador;92;6;29450;863
2020-10-05;SV;El Salvador;89;2;29539;865
2020-10-06;SV;El Salvador;95;4;29634;869
2020-10-07;SV;El Salvador;103;4;29737;873
2020-10-08;SV;El Salvador;105;4;29842;877
2020-10-09;SV;El Salvador;109;4;29951;881
2020-10-10;SV;El Salvador;119;6;30070;887
2020-10-11;SV;El Salvador;126;3;30196;890
2020-10-12;SV;El Salvador;139;4;30335;894
2020-10-13;SV;El Salvador;145;5;30480;899
2020-10-14;SV;El Salvador;286;5;30766;904
2020-10-15;SV;El Salvador;295;4;31061;908
2020-10-16;SV;El Salvador;204;4;31265;912
2020-10-17;SV;El Salvador;191;5;31456;917
2020-10-18;SV;El Salvador;210;5;31666;922
2020-10-19;SV;El Salvador;160;4;31826;926
2020-10-20;SV;El Salvador;149;3;31975;929
2020-10-21;SV;El Salvador;145;4;32120;933
2020-10-22;SV;El Salvador;142;3;32262;936
2020-10-23;SV;El Salvador;159;4;32421;940
2020-10-24;SV;El Salvador;164;4;32585;944
2020-10-25;SV;El Salvador;167;5;32752;949
2020-10-26;SV;El Salvador;173;4;32925;953
2020-10-27;SV;El Salvador;165;4;33090;957
2020-10-28;SV;El Salvador;174;5;33264;962
2020-10-29;SV;El Salvador;181;5;33445;967
2020-10-30;SV;El Salvador;186;4;33631;971
2020-10-31;SV;El Salvador;195;4;33826;975
2020-11-01;SV;El Salvador;189;4;34015;979
2020-11-02;SV;El Salvador;199;4;34214;983
2020-11-03;SV;El Salvador;190;4;34404;987
2020-11-04;SV;El Salvador;173;5;34577;992
2020-11-05;SV;El Salvador;205;5;34782;997
2020-11-06;SV;El Salvador;184;5;34966;1002
2020-11-07;SV;El Salvador;179;4;35145;1006
2020-11-08;SV;El Salvador;181;4;35326;1010
2020-11-09;SV;El Salvador;183;4;35509;1014
2020-11-10;SV;El Salvador;175;6;35684;1020
2020-11-11;SV;El Salvador;178;4;35862;1024
2020-11-12;SV;El Salvador;168;4;36030;1028
2020-11-13;SV;El Salvador;165;5;36195;1033
2020-11-14;SV;El Salvador;163;6;36358;1039
2020-11-15;SV;El Salvador;158;5;36516;1044
2020-11-16;SV;El Salvador;153;3;36669;1047
2020-11-17;SV;El Salvador;150;5;36819;1052
2020-11-18;SV;El Salvador;146;4;36965;1056
2020-11-19;SV;El Salvador;144;5;37109;1061
2020-11-20;SV;El Salvador;141;3;37250;1064
2020-11-21;SV;El Salvador;154;6;37404;1070
2020-11-22;SV;El Salvador;158;5;37562;1075
2020-11-23;SV;El Salvador;157;6;37719;1081
2020-11-24;SV;El Salvador;165;5;37884;1086
2020-11-25;SV;El Salvador;174;0;38058;1086
2020-11-26;SV;El Salvador;170;12;38228;1098
2020-11-27;SV;El Salvador;177;4;38405;1102
2020-11-28;SV;El Salvador;181;5;38586;1107
2020-11-29;SV;El Salvador;172;4;38758;1111
2020-11-30;SV;El Salvador;183;3;38941;1114
2020-12-01;SV;El Salvador;189;6;39130;1120
2020-12-02;SV;El Salvador;197;9;39327;1129
2020-12-03;SV;El Salvador;188;5;39515;1134
2020-12-04;SV;El Salvador;203;8;39718;1142
2020-12-05;SV;El Salvador;212;11;39930;1153
2020-12-06;SV;El Salvador;201;6;40131;1159
2020-12-07;SV;El Salvador;214;5;40345;1164
2020-12-08;SV;El Salvador;206;4;40551;1168
2020-12-09;SV;El Salvador;190;6;40741;1174
2020-12-10;SV;El Salvador;205;6;40946;1180
2020-12-11;SV;El Salvador;217;6;41163;1186
2020-12-12;SV;El Salvador;231;7;41394;1193
2020-12-13;SV;El Salvador;237;7;41631;1200
2020-12-14;SV;El Salvador;249;5;41880;1205
2020-12-15;SV;El Salvador;252;7;42132;1212
2020-12-16;SV;El Salvador;265;7;42397;1219
2020-12-17;SV;El Salvador;244;8;42641;1227
2020-12-18;SV;El Salvador;273;7;42914;1234
2020-12-19;SV;El Salvador;281;8;43195;1242
2020-12-20;SV;El Salvador;282;8;43477;1250
2020-12-21;SV;El Salvador;295;7;43772;1257
2020-12-22;SV;El Salvador;286;8;44058;1265
2020-12-23;SV;El Salvador;270;9;44328;1274
2020-12-24;SV;El Salvador;291;9;44619;1283
2020-12-25;SV;El Salvador;273;6;44892;1289
2020-12-26;SV;El Salvador;0;8;44892;1297
2020-12-27;SV;El Salvador;265;8;45157;1305
2020-12-28;SV;El Salvador;258;8;45415;1313
2020-12-29;SV;El Salvador;269;0;45684;1313
2020-12-30;SV;El Salvador;276;14;45960;1327
2020-12-31;SV;El Salvador;282;0;46242;1327
2021-01-01;SV;El Salvador;273;0;46515;1327
2021-01-02;SV;El Salvador;288;0;46803;1327
2021-01-03;SV;El Salvador;0;31;46803;1358
2021-01-04;SV;El Salvador;284;6;47087;1364
2021-01-05;SV;El Salvador;268;9;47355;1373
2021-01-06;SV;El Salvador;290;9;47645;1382
2021-01-07;SV;El Salvador;303;8;47948;1390
2021-01-08;SV;El Salvador;307;8;48255;1398
2021-01-09;SV;El Salvador;319;10;48574;1408
2021-01-10;SV;El Salvador;331;11;48905;1419
2021-01-11;SV;El Salvador;319;9;49224;1428
2021-01-12;SV;El Salvador;315;9;49539;1437
2021-01-13;SV;El Salvador;320;10;49859;1447
2021-01-14;SV;El Salvador;298;12;50157;1459
2021-01-15;SV;El Salvador;310;10;50467;1469
2021-01-16;SV;El Salvador;317;10;50784;1479
2021-01-17;SV;El Salvador;323;8;51107;1487
2021-01-18;SV;El Salvador;330;11;51437;1498
2021-01-19;SV;El Salvador;335;11;51772;1509
2021-01-20;SV;El Salvador;322;12;52094;1521
2021-01-21;SV;El Salvador;294;9;52388;1530
2021-01-22;SV;El Salvador;284;10;52672;1540
2021-01-23;SV;El Salvador;277;11;52949;1551
2021-01-24;SV;El Salvador;269;10;53218;1561
2021-01-25;SV;El Salvador;261;11;53479;1572
2021-01-26;SV;El Salvador;259;11;53738;1583
2021-01-27;SV;El Salvador;251;6;53989;1589
2021-01-28;SV;El Salvador;252;10;54241;1599
2021-01-29;SV;El Salvador;247;5;54488;1604
2021-01-30;SV;El Salvador;235;10;54723;1614
2021-01-31;SV;El Salvador;243;9;54966;1623
2021-02-01;SV;El Salvador;229;9;55195;1632
2021-02-02;SV;El Salvador;221;6;55416;1638
2021-02-03;SV;El Salvador;207;8;55623;1646
2021-02-04;SV;El Salvador;198;7;55821;1653
2021-02-05;SV;El Salvador;204;9;56025;1662
2021-02-06;SV;El Salvador;212;11;56237;1673
2021-02-07;SV;El Salvador;205;8;56442;1681
2021-02-08;SV;El Salvador;211;11;56653;1692
2021-02-09;SV;El Salvador;206;9;56859;1701
2021-02-10;SV;El Salvador;187;8;57046;1709
2021-02-11;SV;El Salvador;183;10;57229;1719
2021-02-12;SV;El Salvador;199;8;57428;1727
2021-02-13;SV;El Salvador;210;7;57638;1734
2021-02-14;SV;El Salvador;201;8;57839;1742
2021-02-15;SV;El Salvador;184;8;58023;1750
2021-02-16;SV;El Salvador;177;8;58200;1758
2021-02-17;SV;El Salvador;174;9;58374;1767
2021-02-18;SV;El Salvador;172;9;58546;1776
2021-02-19;SV;El Salvador;182;9;58728;1785
2021-02-20;SV;El Salvador;175;7;58903;1792
2021-02-21;SV;El Salvador;168;7;59071;1799
2021-02-22;SV;El Salvador;164;8;59235;1807
2021-02-23;SV;El Salvador;161;8;59396;1815
2021-02-24;SV;El Salvador;159;8;59555;1823
2021-02-25;SV;El Salvador;157;9;59712;1832
2021-02-26;SV;El Salvador;154;9;59866;1841
2021-02-27;SV;El Salvador;155;6;60021;1847
2021-02-28;SV;El Salvador;160;7;60181;1854
2021-03-01;SV;El Salvador;156;7;60337;1861
2021-03-02;SV;El Salvador;154;8;60491;1869
2021-03-03;SV;El Salvador;149;9;60640;1878
2021-03-04;SV;El Salvador;160;9;60800;1887
2021-03-05;SV;El Salvador;152;7;60952;1894
2021-03-06;SV;El Salvador;149;0;61101;1894
2021-03-07;SV;El Salvador;150;13;61251;1907
2021-03-08;SV;El Salvador;147;8;61398;1915
2021-03-09;SV;El Salvador;141;8;61539;1923
2021-03-10;SV;El Salvador;138;6;61677;1929
2021-03-11;SV;El Salvador;137;6;61814;1935
2021-03-12;SV;El Salvador;133;5;61947;1940
2021-03-13;SV;El Salvador;139;5;62086;1945
2021-03-14;SV;El Salvador;143;5;62229;1950
2021-03-15;SV;El Salvador;148;4;62377;1954
2021-03-16;SV;El Salvador;154;4;62531;1958
2021-03-17;SV;El Salvador;160;4;62691;1962
2021-03-18;SV;El Salvador;162;0;62853;1962
2021-03-19;SV;El Salvador;164;9;63017;1971
2021-03-20;SV;El Salvador;171;4;63188;1975
2021-03-21;SV;El Salvador;156;4;63344;1979
2021-03-22;SV;El Salvador;146;4;63490;1983
2021-03-23;SV;El Salvador;141;3;63631;1986
2021-03-24;SV;El Salvador;135;4;63766;1990
2021-03-25;SV;El Salvador;134;0;63900;1990
2021-03-26;SV;El Salvador;139;6;64039;1996
2021-03-27;SV;El Salvador;129;2;64168;1998
2021-03-28;SV;El Salvador;130;2;64298;2000
2021-03-29;SV;El Salvador;133;3;64431;2003
2021-03-30;SV;El Salvador;142;3;64573;2006
2021-03-31;SV;El Salvador;153;0;64726;2006
2021-04-01;SV;El Salvador;149;0;64875;2006
2021-04-02;SV;El Salvador;155;11;65030;2017
2021-04-03;SV;El Salvador;150;4;65180;2021
2021-04-04;SV;El Salvador;157;4;65337;2025
2021-04-05;SV;El Salvador;154;5;65491;2030
2021-04-06;SV;El Salvador;0;0;65491;2030
2021-04-07;SV;El Salvador;0;7;65491;2037
2021-04-08;SV;El Salvador;0;3;65491;2040
2021-04-09;SV;El Salvador;0;4;65491;2044
2021-04-10;SV;El Salvador;0;4;65491;2048
2021-04-11;SV;El Salvador;998;3;66489;2051
2021-04-12;SV;El Salvador;0;3;66489;2054
2021-04-13;SV;El Salvador;327;3;66816;2057
2021-04-14;SV;El Salvador;140;3;66956;2060
2021-04-15;SV;El Salvador;143;4;67099;2064
2021-04-16;SV;El Salvador;150;4;67249;2068
2021-04-17;SV;El Salvador;155;4;67404;2072
2021-04-18;SV;El Salvador;153;3;67557;2075
2021-04-19;SV;El Salvador;0;3;67557;2078
2021-04-20;SV;El Salvador;294;4;67851;2082
2021-04-21;SV;El Salvador;156;4;68007;2086
2021-04-22;SV;El Salvador;154;3;68161;2089
2021-04-23;SV;El Salvador;157;4;68318;2093
2021-04-24;SV;El Salvador;150;5;68468;2098
2021-04-25;SV;El Salvador;0;5;68468;2103
2021-04-26;SV;El Salvador;0;3;68468;2106
2021-04-27;SV;El Salvador;454;5;68922;2111
2021-04-28;SV;El Salvador;0;6;68922;2117
2021-04-29;SV;El Salvador;276;3;69198;2120
2021-04-30;SV;El Salvador;0;4;69198;2124
2021-05-01;SV;El Salvador;0;0;69198;2124
2021-05-02;SV;El Salvador;0;8;69198;2132
2021-05-03;SV;El Salvador;529;2;69727;2134
2021-05-04;SV;El Salvador;0;3;69727;2137
2021-05-05;SV;El Salvador;270;4;69997;2141
2021-05-06;SV;El Salvador;0;2;69997;2143
2021-05-07;SV;El Salvador;258;3;70255;2146
2021-05-08;SV;El Salvador;0;4;70255;2150
2021-05-09;SV;El Salvador;125;4;70380;2154
2021-05-10;SV;El Salvador;0;4;70380;2158
2021-05-11;SV;El Salvador;0;6;70380;2164
2021-05-12;SV;El Salvador;535;4;70915;2168
2021-05-13;SV;El Salvador;0;5;70915;2173
2021-05-14;SV;El Salvador;0;5;70915;2178
2021-05-15;SV;El Salvador;415;4;71330;2182
2021-05-16;SV;El Salvador;149;5;71479;2187
2021-05-17;SV;El Salvador;0;4;71479;2191
2021-05-18;SV;El Salvador;0;4;71479;2195
2021-05-19;SV;El Salvador;0;4;71479;2199
2021-05-20;SV;El Salvador;0;3;71479;2202
2021-05-21;SV;El Salvador;741;4;72220;2206
2021-05-22;SV;El Salvador;0;5;72220;2211
2021-05-23;SV;El Salvador;0;5;72220;2216
2021-05-24;SV;El Salvador;0;4;72220;2220
2021-05-25;SV;El Salvador;601;4;72821;2224
2021-05-26;SV;El Salvador;0;5;72821;2229
2021-05-27;SV;El Salvador;0;4;72821;2233
2021-05-28;SV;El Salvador;425;4;73246;2237
2021-05-29;SV;El Salvador;0;4;73246;2241
2021-05-30;SV;El Salvador;0;4;73246;2245
2021-05-31;SV;El Salvador;456;4;73702;2249
2021-06-01;SV;El Salvador;0;3;73702;2252
2021-06-02;SV;El Salvador;0;3;73702;2255
2021-06-03;SV;El Salvador;439;5;74141;2260
2021-06-04;SV;El Salvador;0;0;74141;2260
2021-06-05;SV;El Salvador;0;6;74141;2266
2021-06-06;SV;El Salvador;0;4;74141;2270
2021-06-07;SV;El Salvador;0;4;74141;2274
2021-06-08;SV;El Salvador;842;5;74983;2279
2021-06-09;SV;El Salvador;0;0;74983;2279
2021-06-10;SV;El Salvador;368;5;75351;2284
2021-06-11;SV;El Salvador;0;4;75351;2288
2021-06-12;SV;El Salvador;0;4;75351;2292
2021-06-13;SV;El Salvador;0;3;75351;2295
2021-06-14;SV;El Salvador;0;4;75351;2299
2021-06-15;SV;El Salvador;946;6;76297;2305
2021-06-16;SV;El Salvador;198;5;76495;2310
2021-06-17;SV;El Salvador;0;5;76495;2315
2021-06-18;SV;El Salvador;202;6;76697;2321
2021-06-19;SV;El Salvador;0;6;76697;2327
2021-06-20;SV;El Salvador;403;5;77100;2332
2021-06-21;SV;El Salvador;384;4;77484;2336
2021-06-22;SV;El Salvador;0;5;77484;2341
2021-06-23;SV;El Salvador;0;5;77484;2346
2021-06-24;SV;El Salvador;0;5;77484;2351
2021-06-25;SV;El Salvador;0;5;77484;2356
2021-06-26;SV;El Salvador;0;5;77484;2361
2021-06-27;SV;El Salvador;1088;6;78572;2367
2021-06-28;SV;El Salvador;194;4;78766;2371
2021-06-29;SV;El Salvador;0;5;78766;2376
2021-06-30;SV;El Salvador;0;5;78766;2381
2021-07-01;SV;El Salvador;0;6;78766;2387
2020-03-15;GQ;Equatorial Guinea;1;0;1;0
2020-03-16;GQ;Equatorial Guinea;0;0;1;0
2020-03-17;GQ;Equatorial Guinea;0;0;1;0
2020-03-18;GQ;Equatorial Guinea;3;0;4;0
2020-03-19;GQ;Equatorial Guinea;2;0;6;0
2020-03-20;GQ;Equatorial Guinea;0;0;6;0
2020-03-21;GQ;Equatorial Guinea;0;0;6;0
2020-03-22;GQ;Equatorial Guinea;0;0;6;0
2020-03-23;GQ;Equatorial Guinea;3;0;9;0
2020-03-24;GQ;Equatorial Guinea;0;0;9;0
2020-03-25;GQ;Equatorial Guinea;0;0;9;0
2020-03-26;GQ;Equatorial Guinea;3;0;12;0
2020-03-27;GQ;Equatorial Guinea;0;0;12;0
2020-03-28;GQ;Equatorial Guinea;0;0;12;0
2020-03-29;GQ;Equatorial Guinea;0;0;12;0
2020-03-30;GQ;Equatorial Guinea;0;0;12;0
2020-03-31;GQ;Equatorial Guinea;0;0;12;0
2020-04-01;GQ;Equatorial Guinea;3;0;15;0
2020-04-02;GQ;Equatorial Guinea;0;0;15;0
2020-04-03;GQ;Equatorial Guinea;1;0;16;0
2020-04-04;GQ;Equatorial Guinea;0;0;16;0
2020-04-05;GQ;Equatorial Guinea;0;0;16;0
2020-04-06;GQ;Equatorial Guinea;0;0;16;0
2020-04-07;GQ;Equatorial Guinea;0;0;16;0
2020-04-08;GQ;Equatorial Guinea;2;0;18;0
2020-04-09;GQ;Equatorial Guinea;0;0;18;0
2020-04-10;GQ;Equatorial Guinea;0;0;18;0
2020-04-11;GQ;Equatorial Guinea;0;0;18;0
2020-04-12;GQ;Equatorial Guinea;3;0;21;0
2020-04-13;GQ;Equatorial Guinea;0;0;21;0
2020-04-14;GQ;Equatorial Guinea;20;0;41;0
2020-04-15;GQ;Equatorial Guinea;10;0;51;0
2020-04-16;GQ;Equatorial Guinea;0;0;51;0
2020-04-17;GQ;Equatorial Guinea;28;0;79;0
2020-04-18;GQ;Equatorial Guinea;0;0;79;0
2020-04-19;GQ;Equatorial Guinea;0;0;79;0
2020-04-20;GQ;Equatorial Guinea;0;0;79;0
2020-04-21;GQ;Equatorial Guinea;4;0;83;0
2020-04-22;GQ;Equatorial Guinea;1;1;84;1
2020-04-23;GQ;Equatorial Guinea;0;0;84;1
2020-04-24;GQ;Equatorial Guinea;130;0;214;1
2020-04-25;GQ;Equatorial Guinea;44;0;258;1
2020-04-26;GQ;Equatorial Guinea;0;0;258;1
2020-04-27;GQ;Equatorial Guinea;0;0;258;1
2020-04-28;GQ;Equatorial Guinea;57;0;315;1
2020-04-29;GQ;Equatorial Guinea;0;0;315;1
2020-04-30;GQ;Equatorial Guinea;0;0;315;1
2020-05-01;GQ;Equatorial Guinea;0;0;315;1
2020-05-02;GQ;Equatorial Guinea;0;0;315;1
2020-05-03;GQ;Equatorial Guinea;0;0;315;1
2020-05-04;GQ;Equatorial Guinea;0;2;315;3
2020-05-05;GQ;Equatorial Guinea;0;0;315;3
2020-05-06;GQ;Equatorial Guinea;124;1;439;4
2020-05-07;GQ;Equatorial Guinea;0;0;439;4
2020-05-08;GQ;Equatorial Guinea;0;0;439;4
2020-05-09;GQ;Equatorial Guinea;0;0;439;4
2020-05-10;GQ;Equatorial Guinea;0;0;439;4
2020-05-11;GQ;Equatorial Guinea;0;0;439;4
2020-05-12;GQ;Equatorial Guinea;0;0;439;4
2020-05-13;GQ;Equatorial Guinea;83;2;522;6
2020-05-14;GQ;Equatorial Guinea;61;1;583;7
2020-05-15;GQ;Equatorial Guinea;11;0;594;7
2020-05-16;GQ;Equatorial Guinea;0;0;594;7
2020-05-17;GQ;Equatorial Guinea;0;0;594;7
2020-05-18;GQ;Equatorial Guinea;125;0;719;7
2020-05-19;GQ;Equatorial Guinea;106;0;825;7
2020-05-20;GQ;Equatorial Guinea;65;0;890;7
2020-05-21;GQ;Equatorial Guinea;13;3;903;10
2020-05-22;GQ;Equatorial Guinea;57;1;960;11
2020-05-23;GQ;Equatorial Guinea;0;0;960;11
2020-05-24;GQ;Equatorial Guinea;0;0;960;11
2020-05-25;GQ;Equatorial Guinea;83;1;1043;12
2020-05-26;GQ;Equatorial Guinea;0;0;1043;12
2020-05-27;GQ;Equatorial Guinea;0;0;1043;12
2020-05-28;GQ;Equatorial Guinea;0;0;1043;12
2020-05-29;GQ;Equatorial Guinea;263;0;1306;12
2020-05-30;GQ;Equatorial Guinea;0;0;1306;12
2020-05-31;GQ;Equatorial Guinea;0;0;1306;12
2020-06-01;GQ;Equatorial Guinea;0;0;1306;12
2020-06-02;GQ;Equatorial Guinea;0;0;1306;12
2020-06-03;GQ;Equatorial Guinea;0;0;1306;12
2020-06-04;GQ;Equatorial Guinea;0;0;1306;12
2020-06-05;GQ;Equatorial Guinea;0;0;1306;12
2020-06-06;GQ;Equatorial Guinea;0;0;1306;12
2020-06-07;GQ;Equatorial Guinea;0;0;1306;12
2020-06-08;GQ;Equatorial Guinea;0;0;1306;12
2020-06-09;GQ;Equatorial Guinea;0;0;1306;12
2020-06-10;GQ;Equatorial Guinea;0;0;1306;12
2020-06-11;GQ;Equatorial Guinea;0;0;1306;12
2020-06-12;GQ;Equatorial Guinea;0;0;1306;12
2020-06-13;GQ;Equatorial Guinea;0;0;1306;12
2020-06-14;GQ;Equatorial Guinea;0;0;1306;12
2020-06-15;GQ;Equatorial Guinea;0;0;1306;12
2020-06-16;GQ;Equatorial Guinea;358;20;1664;32
2020-06-17;GQ;Equatorial Guinea;0;0;1664;32
2020-06-18;GQ;Equatorial Guinea;0;0;1664;32
2020-06-19;GQ;Equatorial Guinea;0;0;1664;32
2020-06-20;GQ;Equatorial Guinea;0;0;1664;32
2020-06-21;GQ;Equatorial Guinea;0;0;1664;32
2020-06-22;GQ;Equatorial Guinea;0;0;1664;32
2020-06-23;GQ;Equatorial Guinea;0;0;1664;32
2020-06-24;GQ;Equatorial Guinea;0;0;1664;32
2020-06-25;GQ;Equatorial Guinea;337;0;2001;32
2020-06-26;GQ;Equatorial Guinea;0;0;2001;32
2020-06-27;GQ;Equatorial Guinea;0;0;2001;32
2020-06-28;GQ;Equatorial Guinea;0;0;2001;32
2020-06-29;GQ;Equatorial Guinea;0;0;2001;32
2020-06-30;GQ;Equatorial Guinea;0;0;2001;32
2020-07-01;GQ;Equatorial Guinea;0;0;2001;32
2020-07-02;GQ;Equatorial Guinea;1070;19;3071;51
2020-07-03;GQ;Equatorial Guinea;0;0;3071;51
2020-07-04;GQ;Equatorial Guinea;0;0;3071;51
2020-07-05;GQ;Equatorial Guinea;0;0;3071;51
2020-07-06;GQ;Equatorial Guinea;0;0;3071;51
2020-07-07;GQ;Equatorial Guinea;0;0;3071;51
2020-07-08;GQ;Equatorial Guinea;0;0;3071;51
2020-07-09;GQ;Equatorial Guinea;0;0;3071;51
2020-07-10;GQ;Equatorial Guinea;0;0;3071;51
2020-07-11;GQ;Equatorial Guinea;0;0;3071;51
2020-07-12;GQ;Equatorial Guinea;0;0;3071;51
2020-07-13;GQ;Equatorial Guinea;0;0;3071;51
2020-07-14;GQ;Equatorial Guinea;0;0;3071;51
2020-07-15;GQ;Equatorial Guinea;0;0;3071;51
2020-07-16;GQ;Equatorial Guinea;0;0;3071;51
2020-07-17;GQ;Equatorial Guinea;0;0;3071;51
2020-07-18;GQ;Equatorial Guinea;0;0;3071;51
2020-07-19;GQ;Equatorial Guinea;0;0;3071;51
2020-07-20;GQ;Equatorial Guinea;0;0;3071;51
2020-07-21;GQ;Equatorial Guinea;0;0;3071;51
2020-07-22;GQ;Equatorial Guinea;0;0;3071;51
2020-07-23;GQ;Equatorial Guinea;0;0;3071;51
2020-07-24;GQ;Equatorial Guinea;0;0;3071;51
2020-07-25;GQ;Equatorial Guinea;0;0;3071;51
2020-07-26;GQ;Equatorial Guinea;0;0;3071;51
2020-07-27;GQ;Equatorial Guinea;0;0;3071;51
2020-07-28;GQ;Equatorial Guinea;0;0;3071;51
2020-07-29;GQ;Equatorial Guinea;0;0;3071;51
2020-07-30;GQ;Equatorial Guinea;0;0;3071;51
2020-07-31;GQ;Equatorial Guinea;1750;32;4821;83
2020-08-01;GQ;Equatorial Guinea;0;0;4821;83
2020-08-02;GQ;Equatorial Guinea;0;0;4821;83
2020-08-03;GQ;Equatorial Guinea;0;0;4821;83
2020-08-04;GQ;Equatorial Guinea;0;0;4821;83
2020-08-05;GQ;Equatorial Guinea;0;0;4821;83
2020-08-06;GQ;Equatorial Guinea;0;0;4821;83
2020-08-07;GQ;Equatorial Guinea;0;0;4821;83
2020-08-08;GQ;Equatorial Guinea;0;0;4821;83
2020-08-09;GQ;Equatorial Guinea;0;0;4821;83
2020-08-10;GQ;Equatorial Guinea;0;0;4821;83
2020-08-11;GQ;Equatorial Guinea;0;0;4821;83
2020-08-12;GQ;Equatorial Guinea;0;0;4821;83
2020-08-13;GQ;Equatorial Guinea;0;0;4821;83
2020-08-14;GQ;Equatorial Guinea;0;0;4821;83
2020-08-15;GQ;Equatorial Guinea;0;0;4821;83
2020-08-16;GQ;Equatorial Guinea;0;0;4821;83
2020-08-17;GQ;Equatorial Guinea;0;0;4821;83
2020-08-18;GQ;Equatorial Guinea;0;0;4821;83
2020-08-19;GQ;Equatorial Guinea;71;0;4892;83
2020-08-20;GQ;Equatorial Guinea;0;0;4892;83
2020-08-21;GQ;Equatorial Guinea;34;0;4926;83
2020-08-22;GQ;Equatorial Guinea;0;0;4926;83
2020-08-23;GQ;Equatorial Guinea;0;0;4926;83
2020-08-24;GQ;Equatorial Guinea;0;0;4926;83
2020-08-25;GQ;Equatorial Guinea;0;0;4926;83
2020-08-26;GQ;Equatorial Guinea;2;0;4928;83
2020-08-27;GQ;Equatorial Guinea;0;0;4928;83
2020-08-28;GQ;Equatorial Guinea;13;0;4941;83
2020-08-29;GQ;Equatorial Guinea;0;0;4941;83
2020-08-30;GQ;Equatorial Guinea;0;0;4941;83
2020-08-31;GQ;Equatorial Guinea;0;0;4941;83
2020-09-01;GQ;Equatorial Guinea;24;0;4965;83
2020-09-02;GQ;Equatorial Guinea;0;0;4965;83
2020-09-03;GQ;Equatorial Guinea;0;0;4965;83
2020-09-04;GQ;Equatorial Guinea;7;0;4972;83
2020-09-05;GQ;Equatorial Guinea;0;0;4972;83
2020-09-06;GQ;Equatorial Guinea;0;0;4972;83
2020-09-07;GQ;Equatorial Guinea;13;0;4985;83
2020-09-08;GQ;Equatorial Guinea;0;0;4985;83
2020-09-09;GQ;Equatorial Guinea;5;0;4990;83
2020-09-10;GQ;Equatorial Guinea;0;0;4990;83
2020-09-11;GQ;Equatorial Guinea;6;0;4996;83
2020-09-12;GQ;Equatorial Guinea;0;0;4996;83
2020-09-13;GQ;Equatorial Guinea;0;0;4996;83
2020-09-14;GQ;Equatorial Guinea;4;0;5000;83
2020-09-15;GQ;Equatorial Guinea;0;0;5000;83
2020-09-16;GQ;Equatorial Guinea;0;0;5000;83
2020-09-17;GQ;Equatorial Guinea;2;0;5002;83
2020-09-18;GQ;Equatorial Guinea;0;0;5002;83
2020-09-19;GQ;Equatorial Guinea;0;0;5002;83
2020-09-20;GQ;Equatorial Guinea;0;0;5002;83
2020-09-21;GQ;Equatorial Guinea;0;0;5002;83
2020-09-22;GQ;Equatorial Guinea;16;0;5018;83
2020-09-23;GQ;Equatorial Guinea;0;0;5018;83
2020-09-24;GQ;Equatorial Guinea;0;0;5018;83
2020-09-25;GQ;Equatorial Guinea;0;0;5018;83
2020-09-26;GQ;Equatorial Guinea;10;0;5028;83
2020-09-27;GQ;Equatorial Guinea;0;0;5028;83
2020-09-28;GQ;Equatorial Guinea;0;0;5028;83
2020-09-29;GQ;Equatorial Guinea;2;0;5030;83
2020-09-30;GQ;Equatorial Guinea;0;0;5030;83
2020-10-01;GQ;Equatorial Guinea;15;0;5045;83
2020-10-02;GQ;Equatorial Guinea;0;0;5045;83
2020-10-03;GQ;Equatorial Guinea;0;0;5045;83
2020-10-04;GQ;Equatorial Guinea;0;0;5045;83
2020-10-05;GQ;Equatorial Guinea;0;0;5045;83
2020-10-06;GQ;Equatorial Guinea;7;0;5052;83
2020-10-07;GQ;Equatorial Guinea;0;0;5052;83
2020-10-08;GQ;Equatorial Guinea;10;0;5062;83
2020-10-09;GQ;Equatorial Guinea;1;0;5063;83
2020-10-10;GQ;Equatorial Guinea;0;0;5063;83
2020-10-11;GQ;Equatorial Guinea;0;0;5063;83
2020-10-12;GQ;Equatorial Guinea;3;0;5066;83
2020-10-13;GQ;Equatorial Guinea;0;0;5066;83
2020-10-14;GQ;Equatorial Guinea;2;0;5068;83
2020-10-15;GQ;Equatorial Guinea;0;0;5068;83
2020-10-16;GQ;Equatorial Guinea;0;0;5068;83
2020-10-17;GQ;Equatorial Guinea;2;0;5070;83
2020-10-18;GQ;Equatorial Guinea;0;0;5070;83
2020-10-19;GQ;Equatorial Guinea;0;0;5070;83
2020-10-20;GQ;Equatorial Guinea;4;0;5074;83
2020-10-21;GQ;Equatorial Guinea;0;0;5074;83
2020-10-22;GQ;Equatorial Guinea;0;0;5074;83
2020-10-23;GQ;Equatorial Guinea;0;0;5074;83
2020-10-24;GQ;Equatorial Guinea;5;0;5079;83
2020-10-25;GQ;Equatorial Guinea;0;0;5079;83
2020-10-26;GQ;Equatorial Guinea;0;0;5079;83
2020-10-27;GQ;Equatorial Guinea;4;0;5083;83
2020-10-28;GQ;Equatorial Guinea;0;0;5083;83
2020-10-29;GQ;Equatorial Guinea;0;0;5083;83
2020-10-30;GQ;Equatorial Guinea;0;0;5083;83
2020-10-31;GQ;Equatorial Guinea;5;0;5088;83
2020-11-01;GQ;Equatorial Guinea;0;0;5088;83
2020-11-02;GQ;Equatorial Guinea;1;0;5089;83
2020-11-03;GQ;Equatorial Guinea;0;0;5089;83
2020-11-04;GQ;Equatorial Guinea;0;0;5089;83
2020-11-05;GQ;Equatorial Guinea;3;2;5092;85
2020-11-06;GQ;Equatorial Guinea;0;0;5092;85
2020-11-07;GQ;Equatorial Guinea;0;0;5092;85
2020-11-08;GQ;Equatorial Guinea;0;0;5092;85
2020-11-09;GQ;Equatorial Guinea;0;0;5092;85
2020-11-10;GQ;Equatorial Guinea;10;0;5102;85
2020-11-11;GQ;Equatorial Guinea;0;0;5102;85
2020-11-12;GQ;Equatorial Guinea;2;0;5104;85
2020-11-13;GQ;Equatorial Guinea;0;0;5104;85
2020-11-14;GQ;Equatorial Guinea;0;0;5104;85
2020-11-15;GQ;Equatorial Guinea;0;0;5104;85
2020-11-16;GQ;Equatorial Guinea;0;0;5104;85
2020-11-17;GQ;Equatorial Guinea;17;0;5121;85
2020-11-18;GQ;Equatorial Guinea;0;0;5121;85
2020-11-19;GQ;Equatorial Guinea;0;0;5121;85
2020-11-20;GQ;Equatorial Guinea;0;0;5121;85
2020-11-21;GQ;Equatorial Guinea;9;0;5130;85
2020-11-22;GQ;Equatorial Guinea;0;0;5130;85
2020-11-23;GQ;Equatorial Guinea;7;0;5137;85
2020-11-24;GQ;Equatorial Guinea;0;0;5137;85
2020-11-25;GQ;Equatorial Guinea;0;0;5137;85
2020-11-26;GQ;Equatorial Guinea;9;0;5146;85
2020-11-27;GQ;Equatorial Guinea;0;0;5146;85
2020-11-28;GQ;Equatorial Guinea;7;0;5153;85
2020-11-29;GQ;Equatorial Guinea;0;0;5153;85
2020-11-30;GQ;Equatorial Guinea;0;0;5153;85
2020-12-01;GQ;Equatorial Guinea;3;0;5156;85
2020-12-02;GQ;Equatorial Guinea;0;0;5156;85
2020-12-03;GQ;Equatorial Guinea;3;0;5159;85
2020-12-04;GQ;Equatorial Guinea;0;0;5159;85
2020-12-05;GQ;Equatorial Guinea;0;0;5159;85
2020-12-06;GQ;Equatorial Guinea;0;0;5159;85
2020-12-07;GQ;Equatorial Guinea;7;0;5166;85
2020-12-08;GQ;Equatorial Guinea;0;0;5166;85
2020-12-09;GQ;Equatorial Guinea;17;0;5183;85
2020-12-10;GQ;Equatorial Guinea;0;0;5183;85
2020-12-11;GQ;Equatorial Guinea;0;0;5183;85
2020-12-12;GQ;Equatorial Guinea;2;0;5185;85
2020-12-13;GQ;Equatorial Guinea;0;0;5185;85
2020-12-14;GQ;Equatorial Guinea;0;0;5185;85
2020-12-15;GQ;Equatorial Guinea;10;0;5195;85
2020-12-16;GQ;Equatorial Guinea;0;0;5195;85
2020-12-17;GQ;Equatorial Guinea;19;0;5214;85
2020-12-18;GQ;Equatorial Guinea;0;0;5214;85
2020-12-19;GQ;Equatorial Guinea;0;0;5214;85
2020-12-20;GQ;Equatorial Guinea;0;0;5214;85
2020-12-21;GQ;Equatorial Guinea;17;0;5231;85
2020-12-22;GQ;Equatorial Guinea;0;0;5231;85
2020-12-23;GQ;Equatorial Guinea;5;0;5236;85
2020-12-24;GQ;Equatorial Guinea;0;0;5236;85
2020-12-25;GQ;Equatorial Guinea;0;0;5236;85
2020-12-26;GQ;Equatorial Guinea;0;0;5236;85
2020-12-27;GQ;Equatorial Guinea;12;1;5248;86
2020-12-28;GQ;Equatorial Guinea;0;0;5248;86
2020-12-29;GQ;Equatorial Guinea;0;0;5248;86
2020-12-30;GQ;Equatorial Guinea;16;0;5264;86
2020-12-31;GQ;Equatorial Guinea;13;0;5277;86
2021-01-01;GQ;Equatorial Guinea;0;0;5277;86
2021-01-02;GQ;Equatorial Guinea;0;0;5277;86
2021-01-03;GQ;Equatorial Guinea;0;0;5277;86
2021-01-04;GQ;Equatorial Guinea;2;0;5279;86
2021-01-05;GQ;Equatorial Guinea;0;0;5279;86
2021-01-06;GQ;Equatorial Guinea;7;0;5286;86
2021-01-07;GQ;Equatorial Guinea;0;0;5286;86
2021-01-08;GQ;Equatorial Guinea;3;0;5289;86
2021-01-09;GQ;Equatorial Guinea;0;0;5289;86
2021-01-10;GQ;Equatorial Guinea;0;0;5289;86
2021-01-11;GQ;Equatorial Guinea;7;0;5296;86
2021-01-12;GQ;Equatorial Guinea;0;0;5296;86
2021-01-13;GQ;Equatorial Guinea;20;0;5316;86
2021-01-14;GQ;Equatorial Guinea;0;0;5316;86
2021-01-15;GQ;Equatorial Guinea;0;0;5316;86
2021-01-16;GQ;Equatorial Guinea;40;0;5356;86
2021-01-17;GQ;Equatorial Guinea;0;0;5356;86
2021-01-18;GQ;Equatorial Guinea;9;0;5365;86
2021-01-19;GQ;Equatorial Guinea;0;0;5365;86
2021-01-20;GQ;Equatorial Guinea;0;0;5365;86
2021-01-21;GQ;Equatorial Guinea;0;0;5365;86
2021-01-22;GQ;Equatorial Guinea;36;0;5401;86
2021-01-23;GQ;Equatorial Guinea;0;0;5401;86
2021-01-24;GQ;Equatorial Guinea;0;0;5401;86
2021-01-25;GQ;Equatorial Guinea;53;0;5454;86
2021-01-26;GQ;Equatorial Guinea;0;0;5454;86
2021-01-27;GQ;Equatorial Guinea;38;0;5492;86
2021-01-28;GQ;Equatorial Guinea;0;0;5492;86
2021-01-29;GQ;Equatorial Guinea;24;0;5516;86
2021-01-30;GQ;Equatorial Guinea;0;0;5516;86
2021-01-31;GQ;Equatorial Guinea;0;0;5516;86
2021-02-01;GQ;Equatorial Guinea;18;0;5534;86
2021-02-02;GQ;Equatorial Guinea;0;0;5534;86
2021-02-03;GQ;Equatorial Guinea;0;0;5534;86
2021-02-04;GQ;Equatorial Guinea;0;0;5534;86
2021-02-05;GQ;Equatorial Guinea;44;0;5578;86
2021-02-06;GQ;Equatorial Guinea;0;0;5578;86
2021-02-07;GQ;Equatorial Guinea;0;0;5578;86
2021-02-08;GQ;Equatorial Guinea;36;1;5614;87
2021-02-09;GQ;Equatorial Guinea;0;0;5614;87
2021-02-10;GQ;Equatorial Guinea;44;0;5658;87
2021-02-11;GQ;Equatorial Guinea;5;0;5663;87
2021-02-12;GQ;Equatorial Guinea;0;0;5663;87
2021-02-13;GQ;Equatorial Guinea;31;0;5694;87
2021-02-14;GQ;Equatorial Guinea;0;0;5694;87
2021-02-15;GQ;Equatorial Guinea;0;0;5694;87
2021-02-16;GQ;Equatorial Guinea;0;0;5694;87
2021-02-17;GQ;Equatorial Guinea;0;0;5694;87
2021-02-18;GQ;Equatorial Guinea;53;1;5747;88
2021-02-19;GQ;Equatorial Guinea;0;0;5747;88
2021-02-20;GQ;Equatorial Guinea;51;1;5798;89
2021-02-21;GQ;Equatorial Guinea;0;0;5798;89
2021-02-22;GQ;Equatorial Guinea;0;0;5798;89
2021-02-23;GQ;Equatorial Guinea;54;2;5852;91
2021-02-24;GQ;Equatorial Guinea;0;0;5852;91
2021-02-25;GQ;Equatorial Guinea;0;0;5852;91
2021-02-26;GQ;Equatorial Guinea;105;0;5957;91
2021-02-27;GQ;Equatorial Guinea;48;0;6005;91
2021-02-28;GQ;Equatorial Guinea;0;0;6005;91
2021-03-01;GQ;Equatorial Guinea;90;1;6095;92
2021-03-02;GQ;Equatorial Guinea;0;0;6095;92
2021-03-03;GQ;Equatorial Guinea;115;1;6210;93
2021-03-04;GQ;Equatorial Guinea;0;0;6210;93
2021-03-05;GQ;Equatorial Guinea;0;0;6210;93
2021-03-06;GQ;Equatorial Guinea;119;3;6329;96
2021-03-07;GQ;Equatorial Guinea;0;0;6329;96
2021-03-08;GQ;Equatorial Guinea;42;0;6371;96
2021-03-09;GQ;Equatorial Guinea;0;0;6371;96
2021-03-10;GQ;Equatorial Guinea;0;0;6371;96
2021-03-11;GQ;Equatorial Guinea;85;2;6456;98
2021-03-12;GQ;Equatorial Guinea;0;0;6456;98
2021-03-13;GQ;Equatorial Guinea;106;0;6562;98
2021-03-14;GQ;Equatorial Guinea;0;0;6562;98
2021-03-15;GQ;Equatorial Guinea;0;0;6562;98
2021-03-16;GQ;Equatorial Guinea;41;2;6603;100
2021-03-17;GQ;Equatorial Guinea;0;0;6603;100
2021-03-18;GQ;Equatorial Guinea;63;0;6666;100
2021-03-19;GQ;Equatorial Guinea;0;0;6666;100
2021-03-20;GQ;Equatorial Guinea;70;0;6736;100
2021-03-21;GQ;Equatorial Guinea;0;0;6736;100
2021-03-22;GQ;Equatorial Guinea;44;1;6780;101
2021-03-23;GQ;Equatorial Guinea;0;0;6780;101
2021-03-24;GQ;Equatorial Guinea;71;1;6851;102
2021-03-25;GQ;Equatorial Guinea;0;0;6851;102
2021-03-26;GQ;Equatorial Guinea;0;0;6851;102
2021-03-27;GQ;Equatorial Guinea;51;0;6902;102
2021-03-28;GQ;Equatorial Guinea;0;0;6902;102
2021-03-29;GQ;Equatorial Guinea;12;0;6914;102
2021-03-30;GQ;Equatorial Guinea;0;0;6914;102
2021-03-31;GQ;Equatorial Guinea;0;0;6914;102
2021-04-01;GQ;Equatorial Guinea;94;1;7008;103
2021-04-02;GQ;Equatorial Guinea;0;0;7008;103
2021-04-03;GQ;Equatorial Guinea;0;0;7008;103
2021-04-04;GQ;Equatorial Guinea;0;0;7008;103
2021-04-05;GQ;Equatorial Guinea;51;1;7059;104
2021-04-06;GQ;Equatorial Guinea;0;0;7059;104
2021-04-07;GQ;Equatorial Guinea;0;0;7059;104
2021-04-08;GQ;Equatorial Guinea;0;0;7059;104
2021-04-09;GQ;Equatorial Guinea;0;0;7059;104
2021-04-10;GQ;Equatorial Guinea;160;2;7219;106
2021-04-11;GQ;Equatorial Guinea;0;0;7219;106
2021-04-12;GQ;Equatorial Guinea;0;0;7219;106
2021-04-13;GQ;Equatorial Guinea;0;0;7219;106
2021-04-14;GQ;Equatorial Guinea;40;0;7259;106
2021-04-15;GQ;Equatorial Guinea;0;0;7259;106
2021-04-16;GQ;Equatorial Guinea;0;0;7259;106
2021-04-17;GQ;Equatorial Guinea;0;0;7259;106
2021-04-18;GQ;Equatorial Guinea;0;0;7259;106
2021-04-19;GQ;Equatorial Guinea;0;0;7259;106
2021-04-20;GQ;Equatorial Guinea;246;0;7505;106
2021-04-21;GQ;Equatorial Guinea;0;0;7505;106
2021-04-22;GQ;Equatorial Guinea;0;0;7505;106
2021-04-23;GQ;Equatorial Guinea;54;1;7559;107
2021-04-24;GQ;Equatorial Guinea;0;0;7559;107
2021-04-25;GQ;Equatorial Guinea;0;0;7559;107
2021-04-26;GQ;Equatorial Guinea;0;0;7559;107
2021-04-27;GQ;Equatorial Guinea;0;0;7559;107
2021-04-28;GQ;Equatorial Guinea;0;0;7559;107
2021-04-29;GQ;Equatorial Guinea;135;5;7694;112
2021-04-30;GQ;Equatorial Guinea;0;0;7694;112
2021-05-01;GQ;Equatorial Guinea;0;0;7694;112
2021-05-02;GQ;Equatorial Guinea;0;0;7694;112
2021-05-03;GQ;Equatorial Guinea;0;0;7694;112
2021-05-04;GQ;Equatorial Guinea;0;0;7694;112
2021-05-05;GQ;Equatorial Guinea;0;0;7694;112
2021-05-06;GQ;Equatorial Guinea;0;0;7694;112
2021-05-07;GQ;Equatorial Guinea;0;0;7694;112
2021-05-08;GQ;Equatorial Guinea;0;0;7694;112
2021-05-09;GQ;Equatorial Guinea;0;0;7694;112
2021-05-10;GQ;Equatorial Guinea;0;0;7694;112
2021-05-11;GQ;Equatorial Guinea;0;0;7694;112
2021-05-12;GQ;Equatorial Guinea;0;0;7694;112
2021-05-13;GQ;Equatorial Guinea;0;0;7694;112
2021-05-14;GQ;Equatorial Guinea;0;0;7694;112
2021-05-15;GQ;Equatorial Guinea;0;0;7694;112
2021-05-16;GQ;Equatorial Guinea;0;0;7694;112
2021-05-17;GQ;Equatorial Guinea;0;0;7694;112
2021-05-18;GQ;Equatorial Guinea;0;0;7694;112
2021-05-19;GQ;Equatorial Guinea;0;0;7694;112
2021-05-20;GQ;Equatorial Guinea;742;1;8436;113
2021-05-21;GQ;Equatorial Guinea;0;0;8436;113
2021-05-22;GQ;Equatorial Guinea;0;0;8436;113
2021-05-23;GQ;Equatorial Guinea;0;0;8436;113
2021-05-24;GQ;Equatorial Guinea;40;0;8476;113
2021-05-25;GQ;Equatorial Guinea;0;0;8476;113
2021-05-26;GQ;Equatorial Guinea;0;0;8476;113
2021-05-27;GQ;Equatorial Guinea;0;0;8476;113
2021-05-28;GQ;Equatorial Guinea;0;0;8476;113
2021-05-29;GQ;Equatorial Guinea;53;5;8529;118
2021-05-30;GQ;Equatorial Guinea;0;0;8529;118
2021-05-31;GQ;Equatorial Guinea;0;0;8529;118
2021-06-01;GQ;Equatorial Guinea;43;0;8572;118
2021-06-02;GQ;Equatorial Guinea;0;0;8572;118
2021-06-03;GQ;Equatorial Guinea;0;0;8572;118
2021-06-04;GQ;Equatorial Guinea;0;0;8572;118
2021-06-05;GQ;Equatorial Guinea;54;0;8626;118
2021-06-06;GQ;Equatorial Guinea;0;0;8626;118
2021-06-07;GQ;Equatorial Guinea;0;0;8626;118
2021-06-08;GQ;Equatorial Guinea;14;0;8640;118
2021-06-09;GQ;Equatorial Guinea;0;0;8640;118
2021-06-10;GQ;Equatorial Guinea;0;0;8640;118
2021-06-11;GQ;Equatorial Guinea;0;0;8640;118
2021-06-12;GQ;Equatorial Guinea;10;2;8650;120
2021-06-13;GQ;Equatorial Guinea;0;0;8650;120
2021-06-14;GQ;Equatorial Guinea;12;0;8662;120
2021-06-15;GQ;Equatorial Guinea;0;0;8662;120
2021-06-16;GQ;Equatorial Guinea;0;0;8662;120
2021-06-17;GQ;Equatorial Guinea;18;0;8680;120
2021-06-18;GQ;Equatorial Guinea;18;0;8698;120
2021-06-19;GQ;Equatorial Guinea;0;0;8698;120
2021-06-20;GQ;Equatorial Guinea;0;0;8698;120
2021-06-21;GQ;Equatorial Guinea;10;0;8708;120
2021-06-22;GQ;Equatorial Guinea;0;0;8708;120
2021-06-23;GQ;Equatorial Guinea;0;0;8708;120
2021-06-24;GQ;Equatorial Guinea;4;0;8712;120
2021-06-25;GQ;Equatorial Guinea;0;0;8712;120
2021-06-26;GQ;Equatorial Guinea;11;1;8723;121
2021-06-27;GQ;Equatorial Guinea;0;0;8723;121
2021-06-28;GQ;Equatorial Guinea;0;0;8723;121
2021-06-29;GQ;Equatorial Guinea;11;0;8734;121
2021-06-30;GQ;Equatorial Guinea;0;0;8734;121
2021-07-01;GQ;Equatorial Guinea;8;1;8742;122
2020-03-21;ER;Eritrea;1;0;1;0
2020-03-22;ER;Eritrea;0;0;1;0
2020-03-23;ER;Eritrea;0;0;1;0
2020-03-24;ER;Eritrea;0;0;1;0
2020-03-25;ER;Eritrea;3;0;4;0
2020-03-26;ER;Eritrea;2;0;6;0
2020-03-27;ER;Eritrea;0;0;6;0
2020-03-28;ER;Eritrea;0;0;6;0
2020-03-29;ER;Eritrea;6;0;12;0
2020-03-30;ER;Eritrea;0;0;12;0
2020-03-31;ER;Eritrea;3;0;15;0
2020-04-01;ER;Eritrea;0;0;15;0
2020-04-02;ER;Eritrea;7;0;22;0
2020-04-03;ER;Eritrea;0;0;22;0
2020-04-04;ER;Eritrea;7;0;29;0
2020-04-05;ER;Eritrea;0;0;29;0
2020-04-06;ER;Eritrea;2;0;31;0
2020-04-07;ER;Eritrea;0;0;31;0
2020-04-08;ER;Eritrea;2;0;33;0
2020-04-09;ER;Eritrea;0;0;33;0
2020-04-10;ER;Eritrea;1;0;34;0
2020-04-11;ER;Eritrea;0;0;34;0
2020-04-12;ER;Eritrea;0;0;34;0
2020-04-13;ER;Eritrea;0;0;34;0
2020-04-14;ER;Eritrea;0;0;34;0
2020-04-15;ER;Eritrea;1;0;35;0
2020-04-16;ER;Eritrea;0;0;35;0
2020-04-17;ER;Eritrea;0;0;35;0
2020-04-18;ER;Eritrea;4;0;39;0
2020-04-19;ER;Eritrea;0;0;39;0
2020-04-20;ER;Eritrea;0;0;39;0
2020-04-21;ER;Eritrea;0;0;39;0
2020-04-22;ER;Eritrea;0;0;39;0
2020-04-23;ER;Eritrea;0;0;39;0
2020-04-24;ER;Eritrea;0;0;39;0
2020-04-25;ER;Eritrea;0;0;39;0
2020-04-26;ER;Eritrea;0;0;39;0
2020-04-27;ER;Eritrea;0;0;39;0
2020-04-28;ER;Eritrea;0;0;39;0
2020-04-29;ER;Eritrea;0;0;39;0
2020-04-30;ER;Eritrea;0;0;39;0
2020-05-01;ER;Eritrea;0;0;39;0
2020-05-02;ER;Eritrea;0;0;39;0
2020-05-03;ER;Eritrea;0;0;39;0
2020-05-04;ER;Eritrea;0;0;39;0
2020-05-05;ER;Eritrea;0;0;39;0
2020-05-06;ER;Eritrea;0;0;39;0
2020-05-07;ER;Eritrea;0;0;39;0
2020-05-08;ER;Eritrea;0;0;39;0
2020-05-09;ER;Eritrea;0;0;39;0
2020-05-10;ER;Eritrea;0;0;39;0
2020-05-11;ER;Eritrea;0;0;39;0
2020-05-12;ER;Eritrea;0;0;39;0
2020-05-13;ER;Eritrea;0;0;39;0
2020-05-14;ER;Eritrea;0;0;39;0
2020-05-15;ER;Eritrea;0;0;39;0
2020-05-16;ER;Eritrea;0;0;39;0
2020-05-17;ER;Eritrea;0;0;39;0
2020-05-18;ER;Eritrea;0;0;39;0
2020-05-19;ER;Eritrea;0;0;39;0
2020-05-20;ER;Eritrea;0;0;39;0
2020-05-21;ER;Eritrea;0;0;39;0
2020-05-22;ER;Eritrea;0;0;39;0
2020-05-23;ER;Eritrea;0;0;39;0
2020-05-24;ER;Eritrea;0;0;39;0
2020-05-25;ER;Eritrea;0;0;39;0
2020-05-26;ER;Eritrea;0;0;39;0
2020-05-27;ER;Eritrea;0;0;39;0
2020-05-28;ER;Eritrea;0;0;39;0
2020-05-29;ER;Eritrea;0;0;39;0
2020-05-30;ER;Eritrea;0;0;39;0
2020-05-31;ER;Eritrea;0;0;39;0
2020-06-01;ER;Eritrea;0;0;39;0
2020-06-02;ER;Eritrea;0;0;39;0
2020-06-03;ER;Eritrea;0;0;39;0
2020-06-04;ER;Eritrea;0;0;39;0
2020-06-05;ER;Eritrea;0;0;39;0
2020-06-06;ER;Eritrea;0;0;39;0
2020-06-07;ER;Eritrea;0;0;39;0
2020-06-08;ER;Eritrea;0;0;39;0
2020-06-09;ER;Eritrea;0;0;39;0
2020-06-10;ER;Eritrea;2;0;41;0
2020-06-11;ER;Eritrea;0;0;41;0
2020-06-12;ER;Eritrea;0;0;41;0
2020-06-13;ER;Eritrea;24;0;65;0
2020-06-14;ER;Eritrea;31;0;96;0
2020-06-15;ER;Eritrea;13;0;109;0
2020-06-16;ER;Eritrea;12;0;121;0
2020-06-17;ER;Eritrea;10;0;131;0
2020-06-18;ER;Eritrea;11;0;142;0
2020-06-19;ER;Eritrea;0;0;142;0
2020-06-20;ER;Eritrea;1;0;143;0
2020-06-21;ER;Eritrea;0;0;143;0
2020-06-22;ER;Eritrea;0;0;143;0
2020-06-23;ER;Eritrea;0;0;143;0
2020-06-24;ER;Eritrea;1;0;144;0
2020-06-25;ER;Eritrea;0;0;144;0
2020-06-26;ER;Eritrea;23;0;167;0
2020-06-27;ER;Eritrea;24;0;191;0
2020-06-28;ER;Eritrea;0;0;191;0
2020-06-29;ER;Eritrea;0;0;191;0
2020-06-30;ER;Eritrea;12;0;203;0
2020-07-01;ER;Eritrea;0;0;203;0
2020-07-02;ER;Eritrea;12;0;215;0
2020-07-03;ER;Eritrea;0;0;215;0
2020-07-04;ER;Eritrea;0;0;215;0
2020-07-05;ER;Eritrea;0;0;215;0
2020-07-06;ER;Eritrea;0;0;215;0
2020-07-07;ER;Eritrea;0;0;215;0
2020-07-08;ER;Eritrea;0;0;215;0
2020-07-09;ER;Eritrea;17;0;232;0
2020-07-10;ER;Eritrea;0;0;232;0
2020-07-11;ER;Eritrea;0;0;232;0
2020-07-12;ER;Eritrea;0;0;232;0
2020-07-13;ER;Eritrea;0;0;232;0
2020-07-14;ER;Eritrea;0;0;232;0
2020-07-15;ER;Eritrea;0;0;232;0
2020-07-16;ER;Eritrea;19;0;251;0
2020-07-17;ER;Eritrea;0;0;251;0
2020-07-18;ER;Eritrea;0;0;251;0
2020-07-19;ER;Eritrea;0;0;251;0
2020-07-20;ER;Eritrea;0;0;251;0
2020-07-21;ER;Eritrea;0;0;251;0
2020-07-22;ER;Eritrea;0;0;251;0
2020-07-23;ER;Eritrea;10;0;261;0
2020-07-24;ER;Eritrea;0;0;261;0
2020-07-25;ER;Eritrea;2;0;263;0
2020-07-26;ER;Eritrea;0;0;263;0
2020-07-27;ER;Eritrea;2;0;265;0
2020-07-28;ER;Eritrea;0;0;265;0
2020-07-29;ER;Eritrea;0;0;265;0
2020-07-30;ER;Eritrea;14;0;279;0
2020-07-31;ER;Eritrea;0;0;279;0
2020-08-01;ER;Eritrea;0;0;279;0
2020-08-02;ER;Eritrea;0;0;279;0
2020-08-03;ER;Eritrea;3;0;282;0
2020-08-04;ER;Eritrea;0;0;282;0
2020-08-05;ER;Eritrea;0;0;282;0
2020-08-06;ER;Eritrea;0;0;282;0
2020-08-07;ER;Eritrea;3;0;285;0
2020-08-08;ER;Eritrea;0;0;285;0
2020-08-09;ER;Eritrea;0;0;285;0
2020-08-10;ER;Eritrea;0;0;285;0
2020-08-11;ER;Eritrea;0;0;285;0
2020-08-12;ER;Eritrea;0;0;285;0
2020-08-13;ER;Eritrea;0;0;285;0
2020-08-14;ER;Eritrea;0;0;285;0
2020-08-15;ER;Eritrea;0;0;285;0
2020-08-16;ER;Eritrea;0;0;285;0
2020-08-17;ER;Eritrea;0;0;285;0
2020-08-18;ER;Eritrea;19;0;304;0
2020-08-19;ER;Eritrea;0;0;304;0
2020-08-20;ER;Eritrea;2;0;306;0
2020-08-21;ER;Eritrea;0;0;306;0
2020-08-22;ER;Eritrea;0;0;306;0
2020-08-23;ER;Eritrea;0;0;306;0
2020-08-24;ER;Eritrea;0;0;306;0
2020-08-25;ER;Eritrea;9;0;315;0
2020-08-26;ER;Eritrea;0;0;315;0
2020-08-27;ER;Eritrea;2;0;317;0
2020-08-28;ER;Eritrea;0;0;317;0
2020-08-29;ER;Eritrea;1;0;318;0
2020-08-30;ER;Eritrea;0;0;318;0
2020-08-31;ER;Eritrea;1;0;319;0
2020-09-01;ER;Eritrea;0;0;319;0
2020-09-02;ER;Eritrea;0;0;319;0
2020-09-03;ER;Eritrea;11;0;330;0
2020-09-04;ER;Eritrea;0;0;330;0
2020-09-05;ER;Eritrea;0;0;330;0
2020-09-06;ER;Eritrea;0;0;330;0
2020-09-07;ER;Eritrea;0;0;330;0
2020-09-08;ER;Eritrea;11;0;341;0
2020-09-09;ER;Eritrea;0;0;341;0
2020-09-10;ER;Eritrea;20;0;361;0
2020-09-11;ER;Eritrea;0;0;361;0
2020-09-12;ER;Eritrea;0;0;361;0
2020-09-13;ER;Eritrea;0;0;361;0
2020-09-14;ER;Eritrea;0;0;361;0
2020-09-15;ER;Eritrea;3;0;364;0
2020-09-16;ER;Eritrea;0;0;364;0
2020-09-17;ER;Eritrea;0;0;364;0
2020-09-18;ER;Eritrea;0;0;364;0
2020-09-19;ER;Eritrea;0;0;364;0
2020-09-20;ER;Eritrea;0;0;364;0
2020-09-21;ER;Eritrea;0;0;364;0
2020-09-22;ER;Eritrea;0;0;364;0
2020-09-23;ER;Eritrea;0;0;364;0
2020-09-24;ER;Eritrea;5;0;369;0
2020-09-25;ER;Eritrea;0;0;369;0
2020-09-26;ER;Eritrea;6;0;375;0
2020-09-27;ER;Eritrea;0;0;375;0
2020-09-28;ER;Eritrea;0;0;375;0
2020-09-29;ER;Eritrea;0;0;375;0
2020-09-30;ER;Eritrea;0;0;375;0
2020-10-01;ER;Eritrea;6;0;381;0
2020-10-02;ER;Eritrea;0;0;381;0
2020-10-03;ER;Eritrea;17;0;398;0
2020-10-04;ER;Eritrea;0;0;398;0
2020-10-05;ER;Eritrea;0;0;398;0
2020-10-06;ER;Eritrea;0;0;398;0
2020-10-07;ER;Eritrea;0;0;398;0
2020-10-08;ER;Eritrea;7;0;405;0
2020-10-09;ER;Eritrea;0;0;405;0
2020-10-10;ER;Eritrea;9;0;414;0
2020-10-11;ER;Eritrea;0;0;414;0
2020-10-12;ER;Eritrea;0;0;414;0
2020-10-13;ER;Eritrea;0;0;414;0
2020-10-14;ER;Eritrea;0;0;414;0
2020-10-15;ER;Eritrea;8;0;422;0
2020-10-16;ER;Eritrea;0;0;422;0
2020-10-17;ER;Eritrea;30;0;452;0
2020-10-18;ER;Eritrea;0;0;452;0
2020-10-19;ER;Eritrea;0;0;452;0
2020-10-20;ER;Eritrea;0;0;452;0
2020-10-21;ER;Eritrea;0;0;452;0
2020-10-22;ER;Eritrea;5;0;457;0
2020-10-23;ER;Eritrea;4;0;461;0
2020-10-24;ER;Eritrea;0;0;461;0
2020-10-25;ER;Eritrea;0;0;461;0
2020-10-26;ER;Eritrea;0;0;461;0
2020-10-27;ER;Eritrea;0;0;461;0
2020-10-28;ER;Eritrea;0;0;461;0
2020-10-29;ER;Eritrea;0;0;461;0
2020-10-30;ER;Eritrea;2;0;463;0
2020-10-31;ER;Eritrea;0;0;463;0
2020-11-01;ER;Eritrea;0;0;463;0
2020-11-02;ER;Eritrea;17;0;480;0
2020-11-03;ER;Eritrea;0;0;480;0
2020-11-04;ER;Eritrea;0;0;480;0
2020-11-05;ER;Eritrea;4;0;484;0
2020-11-06;ER;Eritrea;0;0;484;0
2020-11-07;ER;Eritrea;7;0;491;0
2020-11-08;ER;Eritrea;0;0;491;0
2020-11-09;ER;Eritrea;0;0;491;0
2020-11-10;ER;Eritrea;0;0;491;0
2020-11-11;ER;Eritrea;0;0;491;0
2020-11-12;ER;Eritrea;2;0;493;0
2020-11-13;ER;Eritrea;0;0;493;0
2020-11-14;ER;Eritrea;0;0;493;0
2020-11-15;ER;Eritrea;0;0;493;0
2020-11-16;ER;Eritrea;25;0;518;0
2020-11-17;ER;Eritrea;0;0;518;0
2020-11-18;ER;Eritrea;0;0;518;0
2020-11-19;ER;Eritrea;9;0;527;0
2020-11-20;ER;Eritrea;0;0;527;0
2020-11-21;ER;Eritrea;24;0;551;0
2020-11-22;ER;Eritrea;0;0;551;0
2020-11-23;ER;Eritrea;7;0;558;0
2020-11-24;ER;Eritrea;0;0;558;0
2020-11-25;ER;Eritrea;0;0;558;0
2020-11-26;ER;Eritrea;8;0;566;0
2020-11-27;ER;Eritrea;0;0;566;0
2020-11-28;ER;Eritrea;11;0;577;0
2020-11-29;ER;Eritrea;0;0;577;0
2020-11-30;ER;Eritrea;0;0;577;0
2020-12-01;ER;Eritrea;0;0;577;0
2020-12-02;ER;Eritrea;0;0;577;0
2020-12-03;ER;Eritrea;17;0;594;0
2020-12-04;ER;Eritrea;38;0;632;0
2020-12-05;ER;Eritrea;0;0;632;0
2020-12-06;ER;Eritrea;0;0;632;0
2020-12-07;ER;Eritrea;17;0;649;0
2020-12-08;ER;Eritrea;0;0;649;0
2020-12-09;ER;Eritrea;0;0;649;0
2020-12-10;ER;Eritrea;7;0;656;0
2020-12-11;ER;Eritrea;0;0;656;0
2020-12-12;ER;Eritrea;55;0;711;0
2020-12-13;ER;Eritrea;0;0;711;0
2020-12-14;ER;Eritrea;0;0;711;0
2020-12-15;ER;Eritrea;0;0;711;0
2020-12-16;ER;Eritrea;0;0;711;0
2020-12-17;ER;Eritrea;30;0;741;0
2020-12-18;ER;Eritrea;0;0;741;0
2020-12-19;ER;Eritrea;13;0;754;0
2020-12-20;ER;Eritrea;0;0;754;0
2020-12-21;ER;Eritrea;53;0;807;0
2020-12-22;ER;Eritrea;25;1;832;1
2020-12-23;ER;Eritrea;45;0;877;1
2020-12-24;ER;Eritrea;74;0;951;1
2020-12-25;ER;Eritrea;41;0;992;1
2020-12-26;ER;Eritrea;0;0;992;1
2020-12-27;ER;Eritrea;47;0;1039;1
2020-12-28;ER;Eritrea;0;0;1039;1
2020-12-29;ER;Eritrea;181;0;1220;1
2020-12-30;ER;Eritrea;32;0;1252;1
2020-12-31;ER;Eritrea;68;2;1320;3
2021-01-01;ER;Eritrea;0;0;1320;3
2021-01-02;ER;Eritrea;0;0;1320;3
2021-01-03;ER;Eritrea;0;0;1320;3
2021-01-04;ER;Eritrea;43;0;1363;3
2021-01-05;ER;Eritrea;0;0;1363;3
2021-01-06;ER;Eritrea;82;0;1445;3
2021-01-07;ER;Eritrea;0;0;1445;3
2021-01-08;ER;Eritrea;111;3;1556;6
2021-01-09;ER;Eritrea;0;0;1556;6
2021-01-10;ER;Eritrea;0;0;1556;6
2021-01-11;ER;Eritrea;0;0;1556;6
2021-01-12;ER;Eritrea;40;0;1596;6
2021-01-13;ER;Eritrea;0;0;1596;6
2021-01-14;ER;Eritrea;209;0;1805;6
2021-01-15;ER;Eritrea;72;0;1877;6
2021-01-16;ER;Eritrea;0;0;1877;6
2021-01-17;ER;Eritrea;0;0;1877;6
2021-01-18;ER;Eritrea;0;0;1877;6
2021-01-19;ER;Eritrea;0;0;1877;6
2021-01-20;ER;Eritrea;33;0;1910;6
2021-01-21;ER;Eritrea;3;0;1913;6
2021-01-22;ER;Eritrea;27;0;1940;6
2021-01-23;ER;Eritrea;0;0;1940;6
2021-01-24;ER;Eritrea;0;0;1940;6
2021-01-25;ER;Eritrea;10;1;1950;7
2021-01-26;ER;Eritrea;20;0;1970;7
2021-01-27;ER;Eritrea;115;0;2085;7
2021-01-28;ER;Eritrea;0;0;2085;7
2021-01-29;ER;Eritrea;50;0;2135;7
2021-01-30;ER;Eritrea;0;0;2135;7
2021-01-31;ER;Eritrea;0;0;2135;7
2021-02-01;ER;Eritrea;0;0;2135;7
2021-02-02;ER;Eritrea;132;0;2267;7
2021-02-03;ER;Eritrea;42;0;2309;7
2021-02-04;ER;Eritrea;0;0;2309;7
2021-02-05;ER;Eritrea;17;0;2326;7
2021-02-06;ER;Eritrea;0;0;2326;7
2021-02-07;ER;Eritrea;0;0;2326;7
2021-02-08;ER;Eritrea;0;0;2326;7
2021-02-09;ER;Eritrea;75;0;2401;7
2021-02-10;ER;Eritrea;17;0;2418;7
2021-02-11;ER;Eritrea;11;0;2429;7
2021-02-12;ER;Eritrea;0;0;2429;7
2021-02-13;ER;Eritrea;0;0;2429;7
2021-02-14;ER;Eritrea;0;0;2429;7
2021-02-15;ER;Eritrea;137;0;2566;7
2021-02-16;ER;Eritrea;0;0;2566;7
2021-02-17;ER;Eritrea;61;0;2627;7
2021-02-18;ER;Eritrea;48;0;2675;7
2021-02-19;ER;Eritrea;10;0;2685;7
2021-02-20;ER;Eritrea;0;0;2685;7
2021-02-21;ER;Eritrea;0;0;2685;7
2021-02-22;ER;Eritrea;18;0;2703;7
2021-02-23;ER;Eritrea;70;0;2773;7
2021-02-24;ER;Eritrea;16;0;2789;7
2021-02-25;ER;Eritrea;37;0;2826;7
2021-02-26;ER;Eritrea;21;0;2847;7
2021-02-27;ER;Eritrea;0;0;2847;7
2021-02-28;ER;Eritrea;0;0;2847;7
2021-03-01;ER;Eritrea;19;0;2866;7
2021-03-02;ER;Eritrea;18;0;2884;7
2021-03-03;ER;Eritrea;8;0;2892;7
2021-03-04;ER;Eritrea;21;0;2913;7
2021-03-05;ER;Eritrea;9;0;2922;7
2021-03-06;ER;Eritrea;22;0;2944;7
2021-03-07;ER;Eritrea;0;0;2944;7
2021-03-08;ER;Eritrea;0;0;2944;7
2021-03-09;ER;Eritrea;0;0;2944;7
2021-03-10;ER;Eritrea;44;0;2988;7
2021-03-11;ER;Eritrea;21;0;3009;7
2021-03-12;ER;Eritrea;29;0;3038;7
2021-03-13;ER;Eritrea;0;0;3038;7
2021-03-14;ER;Eritrea;0;0;3038;7
2021-03-15;ER;Eritrea;17;0;3055;7
2021-03-16;ER;Eritrea;7;0;3062;7
2021-03-17;ER;Eritrea;16;0;3078;7
2021-03-18;ER;Eritrea;17;0;3095;7
2021-03-19;ER;Eritrea;23;0;3118;7
2021-03-20;ER;Eritrea;0;0;3118;7
2021-03-21;ER;Eritrea;0;0;3118;7
2021-03-22;ER;Eritrea;0;0;3118;7
2021-03-23;ER;Eritrea;0;0;3118;7
2021-03-24;ER;Eritrea;65;1;3183;8
2021-03-25;ER;Eritrea;9;1;3192;9
2021-03-26;ER;Eritrea;16;0;3208;9
2021-03-27;ER;Eritrea;0;0;3208;9
2021-03-28;ER;Eritrea;0;0;3208;9
2021-03-29;ER;Eritrea;43;0;3251;9
2021-03-30;ER;Eritrea;28;0;3279;9
2021-03-31;ER;Eritrea;6;1;3285;10
2021-04-01;ER;Eritrea;23;0;3308;10
2021-04-02;ER;Eritrea;26;0;3334;10
2021-04-03;ER;Eritrea;0;0;3334;10
2021-04-04;ER;Eritrea;0;0;3334;10
2021-04-05;ER;Eritrea;6;0;3340;10
2021-04-06;ER;Eritrea;23;0;3363;10
2021-04-07;ER;Eritrea;11;0;3374;10
2021-04-08;ER;Eritrea;19;0;3393;10
2021-04-09;ER;Eritrea;54;0;3447;10
2021-04-10;ER;Eritrea;0;0;3447;10
2021-04-11;ER;Eritrea;0;0;3447;10
2021-04-12;ER;Eritrea;19;0;3466;10
2021-04-13;ER;Eritrea;3;0;3469;10
2021-04-14;ER;Eritrea;10;0;3479;10
2021-04-15;ER;Eritrea;7;0;3486;10
2021-04-16;ER;Eritrea;5;0;3491;10
2021-04-17;ER;Eritrea;0;0;3491;10
2021-04-18;ER;Eritrea;0;0;3491;10
2021-04-19;ER;Eritrea;46;0;3537;10
2021-04-20;ER;Eritrea;11;0;3548;10
2021-04-21;ER;Eritrea;16;0;3564;10
2021-04-22;ER;Eritrea;33;0;3597;10
2021-04-23;ER;Eritrea;8;0;3605;10
2021-04-24;ER;Eritrea;0;0;3605;10
2021-04-25;ER;Eritrea;0;0;3605;10
2021-04-26;ER;Eritrea;35;0;3640;10
2021-04-27;ER;Eritrea;0;0;3640;10
2021-04-28;ER;Eritrea;19;0;3659;10
2021-04-29;ER;Eritrea;12;0;3671;10
2021-04-30;ER;Eritrea;0;0;3671;10
2021-05-01;ER;Eritrea;0;0;3671;10
2021-05-02;ER;Eritrea;0;0;3671;10
2021-05-03;ER;Eritrea;2;2;3673;12
2021-05-04;ER;Eritrea;8;0;3681;12
2021-05-05;ER;Eritrea;26;0;3707;12
2021-05-06;ER;Eritrea;27;0;3734;12
2021-05-07;ER;Eritrea;8;0;3742;12
2021-05-08;ER;Eritrea;0;0;3742;12
2021-05-09;ER;Eritrea;0;0;3742;12
2021-05-10;ER;Eritrea;12;0;3754;12
2021-05-11;ER;Eritrea;64;0;3818;12
2021-05-12;ER;Eritrea;4;0;3822;12
2021-05-13;ER;Eritrea;0;0;3822;12
2021-05-14;ER;Eritrea;0;0;3822;12
2021-05-15;ER;Eritrea;22;0;3844;12
2021-05-16;ER;Eritrea;0;0;3844;12
2021-05-17;ER;Eritrea;24;2;3868;14
2021-05-18;ER;Eritrea;11;0;3879;14
2021-05-19;ER;Eritrea;8;0;3887;14
2021-05-20;ER;Eritrea;19;0;3906;14
2021-05-21;ER;Eritrea;15;0;3921;14
2021-05-22;ER;Eritrea;11;0;3932;14
2021-05-23;ER;Eritrea;0;0;3932;14
2021-05-24;ER;Eritrea;0;0;3932;14
2021-05-25;ER;Eritrea;16;0;3948;14
2021-05-26;ER;Eritrea;40;0;3988;14
2021-05-27;ER;Eritrea;22;0;4010;14
2021-05-28;ER;Eritrea;12;0;4022;14
2021-05-29;ER;Eritrea;39;0;4061;14
2021-05-30;ER;Eritrea;0;0;4061;14
2021-05-31;ER;Eritrea;33;0;4094;14
2021-06-01;ER;Eritrea;23;0;4117;14
2021-06-02;ER;Eritrea;28;0;4145;14
2021-06-03;ER;Eritrea;0;0;4145;14
2021-06-04;ER;Eritrea;282;0;4427;14
2021-06-05;ER;Eritrea;0;0;4427;14
2021-06-06;ER;Eritrea;0;0;4427;14
2021-06-07;ER;Eritrea;72;0;4499;14
2021-06-08;ER;Eritrea;98;0;4597;14
2021-06-09;ER;Eritrea;93;0;4690;14
2021-06-10;ER;Eritrea;76;2;4766;16
2021-06-11;ER;Eritrea;82;0;4848;16
2021-06-12;ER;Eritrea;0;0;4848;16
2021-06-13;ER;Eritrea;0;0;4848;16
2021-06-14;ER;Eritrea;133;0;4981;16
2021-06-15;ER;Eritrea;31;1;5012;17
2021-06-16;ER;Eritrea;96;0;5108;17
2021-06-17;ER;Eritrea;86;2;5194;19
2021-06-18;ER;Eritrea;91;0;5285;19
2021-06-19;ER;Eritrea;51;0;5336;19
2021-06-20;ER;Eritrea;26;0;5362;19
2021-06-21;ER;Eritrea;59;0;5421;19
2021-06-22;ER;Eritrea;87;2;5508;21
2021-06-23;ER;Eritrea;95;0;5603;21
2021-06-24;ER;Eritrea;61;0;5664;21
2021-06-25;ER;Eritrea;56;0;5720;21
2021-06-26;ER;Eritrea;60;0;5780;21
2021-06-27;ER;Eritrea;0;0;5780;21
2021-06-28;ER;Eritrea;104;1;5884;22
2021-06-29;ER;Eritrea;52;1;5936;23
2021-06-30;ER;Eritrea;73;0;6009;23
2021-07-01;ER;Eritrea;19;2;6028;25
2020-01-06;EE;Estonia;0;0;0;0
2020-01-18;EE;Estonia;0;0;0;0
2020-02-05;EE;Estonia;0;0;0;0
2020-02-06;EE;Estonia;0;0;0;0
2020-02-07;EE;Estonia;0;0;0;0
2020-02-08;EE;Estonia;0;0;0;0
2020-02-09;EE;Estonia;0;0;0;0
2020-02-10;EE;Estonia;0;0;0;0
2020-02-11;EE;Estonia;0;0;0;0
2020-02-12;EE;Estonia;0;0;0;0
2020-02-13;EE;Estonia;0;0;0;0
2020-02-14;EE;Estonia;0;0;0;0
2020-02-15;EE;Estonia;0;0;0;0
2020-02-16;EE;Estonia;0;0;0;0
2020-02-17;EE;Estonia;0;0;0;0
2020-02-18;EE;Estonia;0;0;0;0
2020-02-19;EE;Estonia;0;0;0;0
2020-02-20;EE;Estonia;0;0;0;0
2020-02-21;EE;Estonia;0;0;0;0
2020-02-22;EE;Estonia;0;0;0;0
2020-02-23;EE;Estonia;0;0;0;0
2020-02-24;EE;Estonia;0;0;0;0
2020-02-25;EE;Estonia;0;0;0;0
2020-02-26;EE;Estonia;0;0;0;0
2020-02-27;EE;Estonia;1;0;1;0
2020-02-28;EE;Estonia;0;0;1;0
2020-02-29;EE;Estonia;0;0;1;0
2020-03-01;EE;Estonia;0;0;1;0
2020-03-02;EE;Estonia;0;0;1;0
2020-03-03;EE;Estonia;1;0;2;0
2020-03-04;EE;Estonia;0;0;2;0
2020-03-05;EE;Estonia;1;0;3;0
2020-03-06;EE;Estonia;7;0;10;0
2020-03-07;EE;Estonia;0;0;10;0
2020-03-08;EE;Estonia;0;0;10;0
2020-03-09;EE;Estonia;0;0;10;0
2020-03-10;EE;Estonia;2;0;12;0
2020-03-11;EE;Estonia;4;0;16;0
2020-03-12;EE;Estonia;0;0;16;0
2020-03-13;EE;Estonia;63;0;79;0
2020-03-14;EE;Estonia;36;0;115;0
2020-03-15;EE;Estonia;56;0;171;0
2020-03-16;EE;Estonia;34;0;205;0
2020-03-17;EE;Estonia;20;0;225;0
2020-03-18;EE;Estonia;33;0;258;0
2020-03-19;EE;Estonia;9;0;267;0
2020-03-20;EE;Estonia;16;0;283;0
2020-03-21;EE;Estonia;23;0;306;0
2020-03-22;EE;Estonia;20;0;326;0
2020-03-23;EE;Estonia;26;0;352;0
2020-03-24;EE;Estonia;17;0;369;0
2020-03-25;EE;Estonia;35;1;404;1
2020-03-26;EE;Estonia;134;0;538;1
2020-03-27;EE;Estonia;37;0;575;1
2020-03-28;EE;Estonia;70;0;645;1
2020-03-29;EE;Estonia;34;2;679;3
2020-03-30;EE;Estonia;36;0;715;3
2020-03-31;EE;Estonia;30;1;745;4
2020-04-01;EE;Estonia;34;1;779;5
2020-04-02;EE;Estonia;79;6;858;11
2020-04-03;EE;Estonia;103;1;961;12
2020-04-04;EE;Estonia;78;1;1039;13
2020-04-05;EE;Estonia;58;2;1097;15
2020-04-06;EE;Estonia;11;4;1108;19
2020-04-07;EE;Estonia;41;2;1149;21
2020-04-08;EE;Estonia;36;3;1185;24
2020-04-09;EE;Estonia;22;0;1207;24
2020-04-10;EE;Estonia;51;0;1258;24
2020-04-11;EE;Estonia;46;0;1304;24
2020-04-12;EE;Estonia;5;1;1309;25
2020-04-13;EE;Estonia;23;3;1332;28
2020-04-14;EE;Estonia;41;3;1373;31
2020-04-15;EE;Estonia;27;4;1400;35
2020-04-16;EE;Estonia;34;1;1434;36
2020-04-17;EE;Estonia;25;2;1459;38
2020-04-18;EE;Estonia;53;0;1512;38
2020-04-19;EE;Estonia;16;2;1528;40
2020-04-20;EE;Estonia;7;0;1535;40
2020-04-21;EE;Estonia;17;3;1552;43
2020-04-22;EE;Estonia;7;1;1559;44
2020-04-23;EE;Estonia;33;1;1592;45
2020-04-24;EE;Estonia;13;1;1605;46
2020-04-25;EE;Estonia;30;0;1635;46
2020-04-26;EE;Estonia;8;3;1643;49
2020-04-27;EE;Estonia;4;1;1647;50
2020-04-28;EE;Estonia;13;0;1660;50
2020-04-29;EE;Estonia;6;0;1666;50
2020-04-30;EE;Estonia;23;2;1689;52
2020-05-01;EE;Estonia;5;0;1694;52
2020-05-02;EE;Estonia;5;1;1699;53
2020-05-03;EE;Estonia;1;2;1700;55
2020-05-04;EE;Estonia;3;0;1703;55
2020-05-05;EE;Estonia;8;0;1711;55
2020-05-06;EE;Estonia;2;0;1713;55
2020-05-07;EE;Estonia;7;1;1720;56
2020-05-08;EE;Estonia;5;0;1725;56
2020-05-09;EE;Estonia;8;4;1733;60
2020-05-10;EE;Estonia;6;0;1739;60
2020-05-11;EE;Estonia;2;1;1741;61
2020-05-12;EE;Estonia;5;0;1746;61
2020-05-13;EE;Estonia;5;0;1751;61
2020-05-14;EE;Estonia;7;1;1758;62
2020-05-15;EE;Estonia;8;1;1766;63
2020-05-16;EE;Estonia;4;0;1770;63
2020-05-17;EE;Estonia;4;0;1774;63
2020-05-18;EE;Estonia;10;1;1784;64
2020-05-19;EE;Estonia;7;0;1791;64
2020-05-20;EE;Estonia;3;0;1794;64
2020-05-21;EE;Estonia;6;0;1800;64
2020-05-22;EE;Estonia;7;0;1807;64
2020-05-23;EE;Estonia;14;0;1821;64
2020-05-24;EE;Estonia;2;0;1823;64
2020-05-25;EE;Estonia;1;1;1824;65
2020-05-26;EE;Estonia;10;0;1834;65
2020-05-27;EE;Estonia;6;1;1840;66
2020-05-28;EE;Estonia;11;0;1851;66
2020-05-29;EE;Estonia;8;1;1859;67
2020-05-30;EE;Estonia;6;0;1865;67
2020-05-31;EE;Estonia;4;1;1869;68
2020-06-01;EE;Estonia;1;0;1870;68
2020-06-02;EE;Estonia;0;0;1870;68
2020-06-03;EE;Estonia;10;1;1880;69
2020-06-04;EE;Estonia;10;0;1890;69
2020-06-05;EE;Estonia;20;0;1910;69
2020-06-06;EE;Estonia;21;0;1931;69
2020-06-07;EE;Estonia;8;0;1939;69
2020-06-08;EE;Estonia;1;0;1940;69
2020-06-09;EE;Estonia;7;0;1947;69
2020-06-10;EE;Estonia;11;0;1958;69
2020-06-11;EE;Estonia;7;0;1965;69
2020-06-12;EE;Estonia;5;0;1970;69
2020-06-13;EE;Estonia;3;0;1973;69
2020-06-14;EE;Estonia;0;0;1973;69
2020-06-15;EE;Estonia;1;0;1974;69
2020-06-16;EE;Estonia;1;0;1975;69
2020-06-17;EE;Estonia;2;0;1977;69
2020-06-18;EE;Estonia;0;0;1977;69
2020-06-19;EE;Estonia;2;0;1979;69
2020-06-20;EE;Estonia;2;0;1981;69
2020-06-21;EE;Estonia;0;0;1981;69
2020-06-22;EE;Estonia;0;0;1981;69
2020-06-23;EE;Estonia;1;0;1982;69
2020-06-24;EE;Estonia;1;0;1983;69
2020-06-25;EE;Estonia;1;0;1984;69
2020-06-26;EE;Estonia;2;0;1986;69
2020-06-27;EE;Estonia;0;0;1986;69
2020-06-28;EE;Estonia;1;0;1987;69
2020-06-29;EE;Estonia;0;0;1987;69
2020-06-30;EE;Estonia;2;0;1989;69
2020-07-01;EE;Estonia;0;0;1989;69
2020-07-02;EE;Estonia;1;0;1990;69
2020-07-03;EE;Estonia;1;0;1991;69
2020-07-04;EE;Estonia;2;0;1993;69
2020-07-05;EE;Estonia;0;0;1993;69
2020-07-06;EE;Estonia;1;0;1994;69
2020-07-07;EE;Estonia;1;0;1995;69
2020-07-08;EE;Estonia;8;0;2003;69
2020-07-09;EE;Estonia;8;0;2011;69
2020-07-10;EE;Estonia;2;0;2013;69
2020-07-11;EE;Estonia;1;0;2014;69
2020-07-12;EE;Estonia;0;0;2014;69
2020-07-13;EE;Estonia;0;0;2014;69
2020-07-14;EE;Estonia;1;0;2015;69
2020-07-15;EE;Estonia;1;0;2016;69
2020-07-16;EE;Estonia;0;0;2016;69
2020-07-17;EE;Estonia;4;0;2020;69
2020-07-18;EE;Estonia;1;0;2021;69
2020-07-19;EE;Estonia;0;0;2021;69
2020-07-20;EE;Estonia;0;0;2021;69
2020-07-21;EE;Estonia;1;0;2022;69
2020-07-22;EE;Estonia;3;0;2025;69
2020-07-23;EE;Estonia;2;0;2027;69
2020-07-24;EE;Estonia;1;0;2028;69
2020-07-25;EE;Estonia;5;0;2033;69
2020-07-26;EE;Estonia;1;0;2034;69
2020-07-27;EE;Estonia;0;0;2034;69
2020-07-28;EE;Estonia;4;0;2038;69
2020-07-29;EE;Estonia;4;0;2042;69
2020-07-30;EE;Estonia;9;0;2051;69
2020-07-31;EE;Estonia;13;0;2064;69
2020-08-01;EE;Estonia;8;0;2072;69
2020-08-02;EE;Estonia;7;-6;2079;63
2020-08-03;EE;Estonia;1;0;2080;63
2020-08-04;EE;Estonia;11;0;2091;63
2020-08-05;EE;Estonia;22;0;2113;63
2020-08-06;EE;Estonia;11;0;2124;63
2020-08-07;EE;Estonia;9;0;2133;63
2020-08-08;EE;Estonia;14;0;2147;63
2020-08-09;EE;Estonia;5;0;2152;63
2020-08-10;EE;Estonia;6;0;2158;63
2020-08-11;EE;Estonia;9;0;2167;63
2020-08-12;EE;Estonia;7;0;2174;63
2020-08-13;EE;Estonia;0;0;2174;63
2020-08-14;EE;Estonia;3;0;2177;63
2020-08-15;EE;Estonia;7;0;2184;63
2020-08-16;EE;Estonia;6;0;2190;63
2020-08-17;EE;Estonia;2;0;2192;63
2020-08-18;EE;Estonia;8;0;2200;63
2020-08-19;EE;Estonia;7;0;2207;63
2020-08-20;EE;Estonia;20;0;2227;63
2020-08-21;EE;Estonia;17;0;2244;63
2020-08-22;EE;Estonia;21;0;2265;63
2020-08-23;EE;Estonia;7;0;2272;63
2020-08-24;EE;Estonia;3;1;2275;64
2020-08-25;EE;Estonia;19;0;2294;64
2020-08-26;EE;Estonia;17;0;2311;64
2020-08-27;EE;Estonia;14;0;2325;64
2020-08-28;EE;Estonia;18;0;2343;64
2020-08-29;EE;Estonia;20;0;2363;64
2020-08-30;EE;Estonia;10;0;2373;64
2020-08-31;EE;Estonia;2;0;2375;64
2020-09-01;EE;Estonia;20;0;2395;64
2020-09-02;EE;Estonia;20;0;2415;64
2020-09-03;EE;Estonia;26;0;2441;64
2020-09-04;EE;Estonia;15;0;2456;64
2020-09-05;EE;Estonia;35;0;2491;64
2020-09-06;EE;Estonia;25;0;2516;64
2020-09-07;EE;Estonia;16;0;2532;64
2020-09-08;EE;Estonia;32;0;2564;64
2020-09-09;EE;Estonia;21;0;2585;64
2020-09-10;EE;Estonia;15;0;2600;64
2020-09-11;EE;Estonia;32;0;2632;64
2020-09-12;EE;Estonia;23;0;2655;64
2020-09-13;EE;Estonia;21;0;2676;64
2020-09-14;EE;Estonia;22;0;2698;64
2020-09-15;EE;Estonia;24;0;2722;64
2020-09-16;EE;Estonia;34;0;2756;64
2020-09-17;EE;Estonia;22;0;2778;64
2020-09-18;EE;Estonia;36;0;2814;64
2020-09-19;EE;Estonia;61;0;2875;64
2020-09-20;EE;Estonia;49;0;2924;64
2020-09-21;EE;Estonia;17;0;2941;64
2020-09-22;EE;Estonia;35;0;2976;64
2020-09-23;EE;Estonia;57;0;3033;64
2020-09-24;EE;Estonia;43;0;3076;64
2020-09-25;EE;Estonia;42;0;3118;64
2020-09-26;EE;Estonia;47;0;3165;64
2020-09-27;EE;Estonia;35;0;3200;64
2020-09-28;EE;Estonia;67;0;3267;64
2020-09-29;EE;Estonia;48;0;3315;64
2020-09-30;EE;Estonia;56;0;3371;64
2020-10-01;EE;Estonia;79;1;3450;65
2020-10-02;EE;Estonia;57;1;3507;66
2020-10-03;EE;Estonia;70;1;3577;67
2020-10-04;EE;Estonia;30;0;3607;67
2020-10-05;EE;Estonia;10;0;3617;67
2020-10-06;EE;Estonia;42;0;3659;67
2020-10-07;EE;Estonia;56;0;3715;67
2020-10-08;EE;Estonia;45;0;3760;67
2020-10-09;EE;Estonia;49;1;3809;68
2020-10-10;EE;Estonia;37;0;3846;68
2020-10-11;EE;Estonia;19;0;3865;68
2020-10-12;EE;Estonia;18;0;3883;68
2020-10-13;EE;Estonia;25;0;3908;68
2020-10-14;EE;Estonia;39;0;3947;68
2020-10-15;EE;Estonia;33;0;3980;68
2020-10-16;EE;Estonia;37;0;4017;68
2020-10-17;EE;Estonia;35;0;4052;68
2020-10-18;EE;Estonia;26;0;4078;68
2020-10-19;EE;Estonia;7;0;4085;68
2020-10-20;EE;Estonia;42;3;4127;71
2020-10-21;EE;Estonia;44;0;4171;71
2020-10-22;EE;Estonia;76;0;4247;71
2020-10-23;EE;Estonia;53;2;4300;73
2020-10-24;EE;Estonia;51;0;4351;73
2020-10-25;EE;Estonia;60;0;4411;73
2020-10-26;EE;Estonia;17;0;4428;73
2020-10-27;EE;Estonia;37;0;4465;73
2020-10-28;EE;Estonia;125;0;4590;73
2020-10-29;EE;Estonia;81;0;4671;73
2020-10-30;EE;Estonia;100;0;4771;73
2020-10-31;EE;Estonia;134;0;4905;73
2020-11-01;EE;Estonia;80;0;4985;73
2020-11-02;EE;Estonia;61;0;5046;73
2020-11-03;EE;Estonia;79;0;5125;73
2020-11-04;EE;Estonia;208;0;5333;73
2020-11-05;EE;Estonia;131;0;5464;73
2020-11-06;EE;Estonia;241;0;5705;73
2020-11-07;EE;Estonia;228;0;5933;73
2020-11-08;EE;Estonia;192;2;6125;75
2020-11-09;EE;Estonia;125;1;6250;76
2020-11-10;EE;Estonia;126;0;6376;76
2020-11-11;EE;Estonia;132;0;6508;76
2020-11-12;EE;Estonia;373;0;6881;76
2020-11-13;EE;Estonia;267;4;7148;80
2020-11-14;EE;Estonia;264;0;7412;80
2020-11-15;EE;Estonia;225;1;7637;81
2020-11-16;EE;Estonia;211;0;7848;81
2020-11-17;EE;Estonia;185;3;8033;84
2020-11-18;EE;Estonia;271;1;8304;85
2020-11-19;EE;Estonia;411;1;8715;86
2020-11-20;EE;Estonia;361;1;9076;87
2020-11-21;EE;Estonia;299;0;9375;87
2020-11-22;EE;Estonia;349;1;9724;88
2020-11-23;EE;Estonia;232;4;9956;92
2020-11-24;EE;Estonia;203;2;10159;94
2020-11-25;EE;Estonia;382;3;10541;97
2020-11-26;EE;Estonia;414;2;10955;99
2020-11-27;EE;Estonia;368;5;11323;104
2020-11-28;EE;Estonia;375;5;11698;109
2020-11-29;EE;Estonia;354;3;12052;112
2020-11-30;EE;Estonia;256;6;12308;118
2020-12-01;EE;Estonia;189;3;12497;121
2020-12-02;EE;Estonia;522;1;13019;122
2020-12-03;EE;Estonia;450;1;13469;123
2020-12-04;EE;Estonia;470;2;13939;125
2020-12-05;EE;Estonia;561;1;14500;126
2020-12-06;EE;Estonia;478;5;14978;131
2020-12-07;EE;Estonia;248;3;15226;134
2020-12-08;EE;Estonia;284;3;15510;137
2020-12-09;EE;Estonia;544;2;16054;139
2020-12-10;EE;Estonia;544;2;16598;141
2020-12-11;EE;Estonia;358;1;16956;142
2020-12-12;EE;Estonia;757;6;17713;148
2020-12-13;EE;Estonia;342;1;18055;149
2020-12-14;EE;Estonia;330;5;18385;154
2020-12-15;EE;Estonia;297;3;18682;157
2020-12-16;EE;Estonia;589;3;19271;160
2020-12-17;EE;Estonia;733;4;20004;164
2020-12-18;EE;Estonia;654;4;20658;168
2020-12-19;EE;Estonia;561;2;21219;170
2020-12-20;EE;Estonia;575;4;21794;174
2020-12-21;EE;Estonia;289;7;22083;181
2020-12-22;EE;Estonia;564;6;22647;187
2020-12-23;EE;Estonia;662;5;23309;192
2020-12-24;EE;Estonia;700;3;24009;195
2020-12-25;EE;Estonia;573;7;24582;202
2020-12-26;EE;Estonia;445;2;25027;204
2020-12-27;EE;Estonia;365;0;25392;204
2020-12-28;EE;Estonia;416;9;25808;213
2020-12-29;EE;Estonia;475;8;26283;221
2020-12-30;EE;Estonia;973;5;27256;226
2020-12-31;EE;Estonia;734;3;27990;229
2021-01-01;EE;Estonia;416;5;28406;234
2021-01-02;EE;Estonia;383;7;28789;241
2021-01-03;EE;Estonia;342;3;29131;244
2021-01-04;EE;Estonia;390;7;29521;251
2021-01-05;EE;Estonia;429;7;29950;258
2021-01-06;EE;Estonia;717;3;30667;261
2021-01-07;EE;Estonia;1084;4;31751;265
2021-01-08;EE;Estonia;786;5;32537;270
2021-01-09;EE;Estonia;552;8;33089;278
2021-01-10;EE;Estonia;427;5;33516;283
2021-01-11;EE;Estonia;289;4;33805;287
2021-01-12;EE;Estonia;333;5;34138;292
2021-01-13;EE;Estonia;853;9;34991;301
2021-01-14;EE;Estonia;630;10;35621;311
2021-01-15;EE;Estonia;475;5;36096;316
2021-01-16;EE;Estonia;595;4;36691;320
2021-01-17;EE;Estonia;388;5;37079;325
2021-01-18;EE;Estonia;265;8;37344;333
2021-01-19;EE;Estonia;597;11;37941;344
2021-01-20;EE;Estonia;603;5;38544;349
2021-01-21;EE;Estonia;668;5;39212;354
2021-01-22;EE;Estonia;489;4;39701;358
2021-01-23;EE;Estonia;483;10;40184;368
2021-01-24;EE;Estonia;532;8;40716;376
2021-01-25;EE;Estonia;259;7;40975;383
2021-01-26;EE;Estonia;355;9;41330;392
2021-01-27;EE;Estonia;636;6;41966;398
2021-01-28;EE;Estonia;690;8;42656;406
2021-01-29;EE;Estonia;687;3;43343;409
2021-01-30;EE;Estonia;404;2;43747;411
2021-01-31;EE;Estonia;461;8;44208;419
2021-02-01;EE;Estonia;367;3;44575;422
2021-02-02;EE;Estonia;403;2;44978;424
2021-02-03;EE;Estonia;685;9;45663;433
2021-02-04;EE;Estonia;671;10;46334;443
2021-02-05;EE;Estonia;591;4;46925;447
2021-02-06;EE;Estonia;587;9;47512;456
2021-02-07;EE;Estonia;416;5;47928;461
2021-02-08;EE;Estonia;339;5;48267;466
2021-02-09;EE;Estonia;542;8;48809;474
2021-02-10;EE;Estonia;796;3;49605;477
2021-02-11;EE;Estonia;675;3;50280;480
2021-02-12;EE;Estonia;713;6;50993;486
2021-02-13;EE;Estonia;756;5;51749;491
2021-02-14;EE;Estonia;667;4;52416;495
2021-02-15;EE;Estonia;411;6;52827;501
2021-02-16;EE;Estonia;617;7;53444;508
2021-02-17;EE;Estonia;856;2;54300;510
2021-02-18;EE;Estonia;995;4;55295;514
2021-02-19;EE;Estonia;951;4;56246;518
2021-02-20;EE;Estonia;787;10;57033;528
2021-02-21;EE;Estonia;583;7;57616;535
2021-02-22;EE;Estonia;829;5;58445;540
2021-02-23;EE;Estonia;962;13;59407;553
2021-02-24;EE;Estonia;1068;4;60475;557
2021-02-25;EE;Estonia;1152;10;61627;567
2021-02-26;EE;Estonia;1203;8;62830;575
2021-02-27;EE;Estonia;1569;9;64399;584
2021-02-28;EE;Estonia;1201;5;65600;589
2021-03-01;EE;Estonia;1028;9;66628;598
2021-03-02;EE;Estonia;1111;7;67739;605
2021-03-03;EE;Estonia;1454;10;69193;615
2021-03-04;EE;Estonia;1417;8;70610;623
2021-03-05;EE;Estonia;1534;14;72144;637
2021-03-06;EE;Estonia;1540;7;73684;644
2021-03-07;EE;Estonia;1319;9;75003;653
2021-03-08;EE;Estonia;1180;14;76183;667
2021-03-09;EE;Estonia;1308;2;77491;669
2021-03-10;EE;Estonia;1482;8;78973;677
2021-03-11;EE;Estonia;1956;9;80929;686
2021-03-12;EE;Estonia;1357;9;82286;695
2021-03-13;EE;Estonia;1586;15;83872;710
2021-03-14;EE;Estonia;935;9;84807;719
2021-03-15;EE;Estonia;1279;9;86086;728
2021-03-16;EE;Estonia;1462;11;87548;739
2021-03-17;EE;Estonia;1783;6;89331;745
2021-03-18;EE;Estonia;1700;13;91031;758
2021-03-19;EE;Estonia;1749;11;92780;769
2021-03-20;EE;Estonia;1248;11;94028;780
2021-03-21;EE;Estonia;1373;7;95401;787
2021-03-22;EE;Estonia;993;10;96394;797
2021-03-23;EE;Estonia;1062;12;97456;809
2021-03-24;EE;Estonia;1552;14;99008;823
2021-03-25;EE;Estonia;1429;13;100437;836
2021-03-26;EE;Estonia;1150;11;101587;847
2021-03-27;EE;Estonia;1151;13;102738;860
2021-03-28;EE;Estonia;892;8;103630;868
2021-03-29;EE;Estonia;584;11;104214;879
2021-03-30;EE;Estonia;1202;17;105416;896
2021-03-31;EE;Estonia;1008;6;106424;902
2021-04-01;EE;Estonia;829;6;107253;908
2021-04-02;EE;Estonia;1165;14;108418;922
2021-04-03;EE;Estonia;519;9;108937;931
2021-04-04;EE;Estonia;462;10;109399;941
2021-04-05;EE;Estonia;382;9;109781;950
2021-04-06;EE;Estonia;899;14;110680;964
2021-04-07;EE;Estonia;984;12;111664;976
2021-04-08;EE;Estonia;757;14;112421;990
2021-04-09;EE;Estonia;677;16;113098;1006
2021-04-10;EE;Estonia;638;14;113736;1020
2021-04-11;EE;Estonia;438;8;114174;1028
2021-04-12;EE;Estonia;269;9;114443;1037
2021-04-13;EE;Estonia;637;12;115080;1049
2021-04-14;EE;Estonia;549;8;115629;1057
2021-04-15;EE;Estonia;571;7;116200;1064
2021-04-16;EE;Estonia;478;6;116678;1070
2021-04-17;EE;Estonia;333;12;117011;1082
2021-04-18;EE;Estonia;543;10;117554;1092
2021-04-19;EE;Estonia;228;8;117782;1100
2021-04-20;EE;Estonia;535;4;118317;1104
2021-04-21;EE;Estonia;472;5;118789;1109
2021-04-22;EE;Estonia;429;11;119218;1120
2021-04-23;EE;Estonia;392;6;119610;1126
2021-04-24;EE;Estonia;390;11;120000;1137
2021-04-25;EE;Estonia;215;6;120215;1143
2021-04-26;EE;Estonia;163;2;120378;1145
2021-04-27;EE;Estonia;458;3;120836;1148
2021-04-28;EE;Estonia;396;0;121232;1148
2021-04-29;EE;Estonia;425;10;121657;1158
2021-04-30;EE;Estonia;362;3;122019;1161
2021-05-01;EE;Estonia;431;5;122450;1166
2021-05-02;EE;Estonia;235;2;122685;1168
2021-05-03;EE;Estonia;258;4;122943;1172
2021-05-04;EE;Estonia;401;5;123344;1177
2021-05-05;EE;Estonia;437;6;123781;1183
2021-05-06;EE;Estonia;366;4;124147;1187
2021-05-07;EE;Estonia;382;6;124529;1193
2021-05-08;EE;Estonia;372;2;124901;1195
2021-05-09;EE;Estonia;225;6;125126;1201
2021-05-10;EE;Estonia;211;3;125337;1204
2021-05-11;EE;Estonia;359;2;125696;1206
2021-05-12;EE;Estonia;368;4;126064;1210
2021-05-13;EE;Estonia;300;2;126364;1212
2021-05-14;EE;Estonia;278;5;126642;1217
2021-05-15;EE;Estonia;280;3;126922;1220
2021-05-16;EE;Estonia;131;2;127053;1222
2021-05-17;EE;Estonia;153;1;127206;1223
2021-05-18;EE;Estonia;294;6;127500;1229
2021-05-19;EE;Estonia;257;3;127757;1232
2021-05-20;EE;Estonia;327;3;128084;1235
2021-05-21;EE;Estonia;225;4;128309;1239
2021-05-22;EE;Estonia;180;1;128489;1240
2021-05-23;EE;Estonia;103;0;128592;1240
2021-05-24;EE;Estonia;77;1;128669;1241
2021-05-25;EE;Estonia;160;0;128829;1241
2021-05-26;EE;Estonia;185;1;129014;1242
2021-05-27;EE;Estonia;144;2;129158;1244
2021-05-28;EE;Estonia;139;3;129297;1247
2021-05-29;EE;Estonia;127;3;129424;1250
2021-05-30;EE;Estonia;62;1;129486;1251
2021-05-31;EE;Estonia;58;1;129544;1252
2021-06-01;EE;Estonia;130;6;129674;1258
2021-06-02;EE;Estonia;130;1;129804;1259
2021-06-03;EE;Estonia;105;1;129909;1260
2021-06-04;EE;Estonia;96;0;130005;1260
2021-06-05;EE;Estonia;63;2;130068;1262
2021-06-06;EE;Estonia;51;1;130119;1263
2021-06-07;EE;Estonia;37;1;130156;1264
2021-06-08;EE;Estonia;86;0;130242;1264
2021-06-09;EE;Estonia;68;1;130310;1265
2021-06-10;EE;Estonia;54;1;130364;1266
2021-06-11;EE;Estonia;54;0;130418;1266
2021-06-12;EE;Estonia;55;0;130473;1266
2021-06-13;EE;Estonia;37;0;130510;1266
2021-06-14;EE;Estonia;28;0;130538;1266
2021-06-15;EE;Estonia;61;0;130599;1266
2021-06-16;EE;Estonia;59;0;130658;1266
2021-06-17;EE;Estonia;37;1;130695;1267
2021-06-18;EE;Estonia;56;0;130751;1267
2021-06-19;EE;Estonia;30;0;130781;1267
2021-06-20;EE;Estonia;25;1;130806;1268
2021-06-21;EE;Estonia;12;0;130818;1268
2021-06-22;EE;Estonia;37;1;130855;1269
2021-06-23;EE;Estonia;25;0;130880;1269
2021-06-24;EE;Estonia;18;0;130898;1269
2021-06-25;EE;Estonia;10;0;130908;1269
2021-06-26;EE;Estonia;33;0;130941;1269
2021-06-27;EE;Estonia;27;0;130968;1269
2021-06-28;EE;Estonia;15;0;130983;1269
2021-06-29;EE;Estonia;45;0;131028;1269
2021-06-30;EE;Estonia;36;0;131064;1269
2021-07-01;EE;Estonia;21;0;131085;1269
2020-03-14;SZ;Eswatini;1;0;1;0
2020-03-15;SZ;Eswatini;0;0;1;0
2020-03-16;SZ;Eswatini;0;0;1;0
2020-03-17;SZ;Eswatini;0;0;1;0
2020-03-18;SZ;Eswatini;0;0;1;0
2020-03-19;SZ;Eswatini;0;0;1;0
2020-03-20;SZ;Eswatini;0;0;1;0
2020-03-21;SZ;Eswatini;0;0;1;0
2020-03-22;SZ;Eswatini;3;0;4;0
2020-03-23;SZ;Eswatini;0;0;4;0
2020-03-24;SZ;Eswatini;0;0;4;0
2020-03-25;SZ;Eswatini;0;0;4;0
2020-03-26;SZ;Eswatini;2;0;6;0
2020-03-27;SZ;Eswatini;3;0;9;0
2020-03-28;SZ;Eswatini;0;0;9;0
2020-03-29;SZ;Eswatini;0;0;9;0
2020-03-30;SZ;Eswatini;0;0;9;0
2020-03-31;SZ;Eswatini;0;0;9;0
2020-04-01;SZ;Eswatini;0;0;9;0
2020-04-02;SZ;Eswatini;0;0;9;0
2020-04-03;SZ;Eswatini;0;0;9;0
2020-04-04;SZ;Eswatini;0;0;9;0
2020-04-05;SZ;Eswatini;0;0;9;0
2020-04-06;SZ;Eswatini;1;0;10;0
2020-04-07;SZ;Eswatini;0;0;10;0
2020-04-08;SZ;Eswatini;2;0;12;0
2020-04-09;SZ;Eswatini;0;0;12;0
2020-04-10;SZ;Eswatini;0;0;12;0
2020-04-11;SZ;Eswatini;0;0;12;0
2020-04-12;SZ;Eswatini;2;0;14;0
2020-04-13;SZ;Eswatini;1;0;15;0
2020-04-14;SZ;Eswatini;0;0;15;0
2020-04-15;SZ;Eswatini;0;0;15;0
2020-04-16;SZ;Eswatini;1;1;16;1
2020-04-17;SZ;Eswatini;0;0;16;1
2020-04-18;SZ;Eswatini;6;0;22;1
2020-04-19;SZ;Eswatini;0;0;22;1
2020-04-20;SZ;Eswatini;2;0;24;1
2020-04-21;SZ;Eswatini;7;0;31;1
2020-04-22;SZ;Eswatini;0;0;31;1
2020-04-23;SZ;Eswatini;0;0;31;1
2020-04-24;SZ;Eswatini;5;0;36;1
2020-04-25;SZ;Eswatini;20;0;56;1
2020-04-26;SZ;Eswatini;3;0;59;1
2020-04-27;SZ;Eswatini;6;0;65;1
2020-04-28;SZ;Eswatini;6;0;71;1
2020-04-29;SZ;Eswatini;20;0;91;1
2020-04-30;SZ;Eswatini;9;0;100;1
2020-05-01;SZ;Eswatini;6;0;106;1
2020-05-02;SZ;Eswatini;2;0;108;1
2020-05-03;SZ;Eswatini;4;0;112;1
2020-05-04;SZ;Eswatini;4;0;116;1
2020-05-05;SZ;Eswatini;3;0;119;1
2020-05-06;SZ;Eswatini;4;1;123;2
2020-05-07;SZ;Eswatini;30;0;153;2
2020-05-08;SZ;Eswatini;6;0;159;2
2020-05-09;SZ;Eswatini;4;0;163;2
2020-05-10;SZ;Eswatini;9;0;172;2
2020-05-11;SZ;Eswatini;3;0;175;2
2020-05-12;SZ;Eswatini;9;0;184;2
2020-05-13;SZ;Eswatini;3;0;187;2
2020-05-14;SZ;Eswatini;0;0;187;2
2020-05-15;SZ;Eswatini;3;0;190;2
2020-05-16;SZ;Eswatini;12;0;202;2
2020-05-17;SZ;Eswatini;1;0;203;2
2020-05-18;SZ;Eswatini;2;0;205;2
2020-05-19;SZ;Eswatini;3;0;208;2
2020-05-20;SZ;Eswatini;9;0;217;2
2020-05-21;SZ;Eswatini;3;0;220;2
2020-05-22;SZ;Eswatini;5;0;225;2
2020-05-23;SZ;Eswatini;13;0;238;2
2020-05-24;SZ;Eswatini;12;0;250;2
2020-05-25;SZ;Eswatini;6;0;256;2
2020-05-26;SZ;Eswatini;5;0;261;2
2020-05-27;SZ;Eswatini;11;0;272;2
2020-05-28;SZ;Eswatini;7;0;279;2
2020-05-29;SZ;Eswatini;0;0;279;2
2020-05-30;SZ;Eswatini;4;0;283;2
2020-05-31;SZ;Eswatini;2;0;285;2
2020-06-01;SZ;Eswatini;8;1;293;3
2020-06-02;SZ;Eswatini;1;0;294;3
2020-06-03;SZ;Eswatini;1;0;295;3
2020-06-04;SZ;Eswatini;5;0;300;3
2020-06-05;SZ;Eswatini;5;0;305;3
2020-06-06;SZ;Eswatini;17;0;322;3
2020-06-07;SZ;Eswatini;11;0;333;3
2020-06-08;SZ;Eswatini;7;0;340;3
2020-06-09;SZ;Eswatini;31;0;371;3
2020-06-10;SZ;Eswatini;27;0;398;3
2020-06-11;SZ;Eswatini;51;0;449;3
2020-06-12;SZ;Eswatini;23;0;472;3
2020-06-13;SZ;Eswatini;14;0;486;3
2020-06-14;SZ;Eswatini;4;1;490;4
2020-06-15;SZ;Eswatini;16;0;506;4
2020-06-16;SZ;Eswatini;14;0;520;4
2020-06-17;SZ;Eswatini;43;0;563;4
2020-06-18;SZ;Eswatini;23;0;586;4
2020-06-19;SZ;Eswatini;37;0;623;4
2020-06-20;SZ;Eswatini;4;1;627;5
2020-06-21;SZ;Eswatini;8;0;635;5
2020-06-22;SZ;Eswatini;8;1;643;6
2020-06-23;SZ;Eswatini;31;1;674;7
2020-06-24;SZ;Eswatini;16;0;690;7
2020-06-25;SZ;Eswatini;16;1;706;8
2020-06-26;SZ;Eswatini;22;0;728;8
2020-06-27;SZ;Eswatini;17;0;745;8
2020-06-28;SZ;Eswatini;36;3;781;11
2020-06-29;SZ;Eswatini;14;0;795;11
2020-06-30;SZ;Eswatini;17;0;812;11
2020-07-01;SZ;Eswatini;28;0;840;11
2020-07-02;SZ;Eswatini;33;0;873;11
2020-07-03;SZ;Eswatini;36;2;909;13
2020-07-04;SZ;Eswatini;45;0;954;13
2020-07-05;SZ;Eswatini;34;0;988;13
2020-07-06;SZ;Eswatini;23;0;1011;13
2020-07-07;SZ;Eswatini;45;1;1056;14
2020-07-08;SZ;Eswatini;82;0;1138;14
2020-07-09;SZ;Eswatini;75;3;1213;17
2020-07-10;SZ;Eswatini;44;1;1257;18
2020-07-11;SZ;Eswatini;54;0;1311;18
2020-07-12;SZ;Eswatini;40;2;1351;20
2020-07-13;SZ;Eswatini;38;0;1389;20
2020-07-14;SZ;Eswatini;45;0;1434;20
2020-07-15;SZ;Eswatini;55;0;1489;20
2020-07-16;SZ;Eswatini;63;1;1552;21
2020-07-17;SZ;Eswatini;67;0;1619;21
2020-07-18;SZ;Eswatini;110;0;1729;21
2020-07-19;SZ;Eswatini;64;0;1793;21
2020-07-20;SZ;Eswatini;33;2;1826;23
2020-07-21;SZ;Eswatini;68;1;1894;24
2020-07-22;SZ;Eswatini;44;1;1938;25
2020-07-23;SZ;Eswatini;83;3;2021;28
2020-07-24;SZ;Eswatini;52;0;2073;28
2020-07-25;SZ;Eswatini;69;0;2142;28
2020-07-26;SZ;Eswatini;65;4;2207;32
2020-07-27;SZ;Eswatini;109;2;2316;34
2020-07-28;SZ;Eswatini;88;5;2404;39
2020-07-29;SZ;Eswatini;147;1;2551;40
2020-07-30;SZ;Eswatini;26;0;2577;40
2020-07-31;SZ;Eswatini;71;1;2648;41
2020-08-01;SZ;Eswatini;58;2;2706;43
2020-08-02;SZ;Eswatini;69;0;2775;43
2020-08-03;SZ;Eswatini;63;2;2838;45
2020-08-04;SZ;Eswatini;18;4;2856;49
2020-08-05;SZ;Eswatini;53;4;2909;53
2020-08-06;SZ;Eswatini;59;2;2968;55
2020-08-07;SZ;Eswatini;68;1;3036;56
2020-08-08;SZ;Eswatini;92;0;3128;56
2020-08-09;SZ;Eswatini;108;2;3236;58
2020-08-10;SZ;Eswatini;73;3;3309;61
2020-08-11;SZ;Eswatini;101;2;3410;63
2020-08-12;SZ;Eswatini;115;0;3525;63
2020-08-13;SZ;Eswatini;74;2;3599;65
2020-08-14;SZ;Eswatini;71;3;3670;68
2020-08-15;SZ;Eswatini;75;1;3745;69
2020-08-16;SZ;Eswatini;94;1;3839;70
2020-08-17;SZ;Eswatini;55;3;3894;73
2020-08-18;SZ;Eswatini;95;3;3989;76
2020-08-19;SZ;Eswatini;69;3;4058;79
2020-08-20;SZ;Eswatini;52;2;4110;81
2020-08-21;SZ;Eswatini;18;0;4128;81
2020-08-22;SZ;Eswatini;61;2;4189;83
2020-08-23;SZ;Eswatini;36;2;4225;85
2020-08-24;SZ;Eswatini;79;0;4304;85
2020-08-25;SZ;Eswatini;23;1;4327;86
2020-08-26;SZ;Eswatini;60;2;4387;88
2020-08-27;SZ;Eswatini;46;1;4433;89
2020-08-28;SZ;Eswatini;28;2;4461;91
2020-08-29;SZ;Eswatini;49;0;4510;91
2020-08-30;SZ;Eswatini;51;0;4561;91
2020-08-31;SZ;Eswatini;16;0;4577;91
2020-09-01;SZ;Eswatini;41;3;4618;94
2020-09-02;SZ;Eswatini;50;0;4668;94
2020-09-03;SZ;Eswatini;52;0;4720;94
2020-09-04;SZ;Eswatini;60;0;4780;94
2020-09-05;SZ;Eswatini;39;0;4819;94
2020-09-06;SZ;Eswatini;34;0;4853;94
2020-09-07;SZ;Eswatini;31;0;4884;94
2020-09-08;SZ;Eswatini;20;2;4904;96
2020-09-09;SZ;Eswatini;32;1;4936;97
2020-09-10;SZ;Eswatini;58;1;4994;98
2020-09-11;SZ;Eswatini;31;0;5025;98
2020-09-12;SZ;Eswatini;25;0;5050;98
2020-09-13;SZ;Eswatini;25;0;5075;98
2020-09-14;SZ;Eswatini;29;3;5104;101
2020-09-15;SZ;Eswatini;24;0;5128;101
2020-09-16;SZ;Eswatini;27;0;5155;101
2020-09-17;SZ;Eswatini;36;2;5191;103
2020-09-18;SZ;Eswatini;24;0;5215;103
2020-09-19;SZ;Eswatini;30;1;5245;104
2020-09-20;SZ;Eswatini;24;0;5269;104
2020-09-21;SZ;Eswatini;13;0;5282;104
2020-09-22;SZ;Eswatini;25;2;5307;106
2020-09-23;SZ;Eswatini;36;2;5343;108
2020-09-24;SZ;Eswatini;32;0;5375;108
2020-09-25;SZ;Eswatini;24;0;5399;108
2020-09-26;SZ;Eswatini;20;0;5419;108
2020-09-27;SZ;Eswatini;12;0;5431;108
2020-09-28;SZ;Eswatini;21;0;5452;108
2020-09-29;SZ;Eswatini;10;0;5462;108
2020-09-30;SZ;Eswatini;20;1;5482;109
2020-10-01;SZ;Eswatini;18;2;5500;111
2020-10-02;SZ;Eswatini;21;0;5521;111
2020-10-03;SZ;Eswatini;9;0;5530;111
2020-10-04;SZ;Eswatini;39;0;5569;111
2020-10-05;SZ;Eswatini;10;1;5579;112
2020-10-06;SZ;Eswatini;19;0;5598;112
2020-10-07;SZ;Eswatini;19;1;5617;113
2020-10-08;SZ;Eswatini;15;0;5632;113
2020-10-09;SZ;Eswatini;12;0;5644;113
2020-10-10;SZ;Eswatini;16;0;5660;113
2020-10-11;SZ;Eswatini;9;0;5669;113
2020-10-12;SZ;Eswatini;14;0;5683;113
2020-10-13;SZ;Eswatini;13;1;5696;114
2020-10-14;SZ;Eswatini;19;0;5715;114
2020-10-15;SZ;Eswatini;18;1;5733;115
2020-10-16;SZ;Eswatini;13;0;5746;115
2020-10-17;SZ;Eswatini;19;0;5765;115
2020-10-18;SZ;Eswatini;15;1;5780;116
2020-10-19;SZ;Eswatini;8;0;5788;116
2020-10-20;SZ;Eswatini;12;0;5800;116
2020-10-21;SZ;Eswatini;5;0;5805;116
2020-10-22;SZ;Eswatini;9;0;5814;116
2020-10-23;SZ;Eswatini;17;0;5831;116
2020-10-24;SZ;Eswatini;16;0;5847;116
2020-10-25;SZ;Eswatini;7;0;5854;116
2020-10-26;SZ;Eswatini;9;0;5863;116
2020-10-27;SZ;Eswatini;12;0;5875;116
2020-10-28;SZ;Eswatini;11;0;5886;116
2020-10-29;SZ;Eswatini;13;1;5899;117
2020-10-30;SZ;Eswatini;10;0;5909;117
2020-10-31;SZ;Eswatini;8;0;5917;117
2020-11-01;SZ;Eswatini;8;0;5925;117
2020-11-02;SZ;Eswatini;4;0;5929;117
2020-11-03;SZ;Eswatini;13;0;5942;117
2020-11-04;SZ;Eswatini;13;0;5955;117
2020-11-05;SZ;Eswatini;12;0;5967;117
2020-11-06;SZ;Eswatini;9;0;5976;117
2020-11-07;SZ;Eswatini;13;0;5989;117
2020-11-08;SZ;Eswatini;14;0;6003;117
2020-11-09;SZ;Eswatini;10;0;6013;117
2020-11-10;SZ;Eswatini;11;0;6024;117
2020-11-11;SZ;Eswatini;20;0;6044;117
2020-11-12;SZ;Eswatini;16;0;6060;117
2020-11-13;SZ;Eswatini;16;1;6076;118
2020-11-14;SZ;Eswatini;17;1;6093;119
2020-11-15;SZ;Eswatini;2;0;6095;119
2020-11-16;SZ;Eswatini;10;0;6105;119
2020-11-17;SZ;Eswatini;19;0;6124;119
2020-11-18;SZ;Eswatini;20;0;6144;119
2020-11-19;SZ;Eswatini;12;0;6156;119
2020-11-20;SZ;Eswatini;29;0;6185;119
2020-11-21;SZ;Eswatini;20;0;6205;119
2020-11-22;SZ;Eswatini;14;1;6219;120
2020-11-23;SZ;Eswatini;14;0;6233;120
2020-11-24;SZ;Eswatini;14;0;6247;120
2020-11-25;SZ;Eswatini;25;0;6272;120
2020-11-26;SZ;Eswatini;57;0;6329;120
2020-11-27;SZ;Eswatini;33;0;6362;120
2020-11-28;SZ;Eswatini;44;1;6406;121
2020-11-29;SZ;Eswatini;4;0;6410;121
2020-11-30;SZ;Eswatini;9;1;6419;122
2020-12-01;SZ;Eswatini;23;0;6442;122
2020-12-02;SZ;Eswatini;13;0;6455;122
2020-12-03;SZ;Eswatini;19;0;6474;122
2020-12-04;SZ;Eswatini;6;0;6480;122
2020-12-05;SZ;Eswatini;15;0;6495;122
2020-12-06;SZ;Eswatini;6;0;6501;122
2020-12-07;SZ;Eswatini;28;1;6529;123
2020-12-08;SZ;Eswatini;34;1;6563;124
2020-12-09;SZ;Eswatini;49;1;6612;125
2020-12-10;SZ;Eswatini;21;1;6633;126
2020-12-11;SZ;Eswatini;52;0;6685;126
2020-12-12;SZ;Eswatini;29;1;6714;127
2020-12-13;SZ;Eswatini;54;0;6768;127
2020-12-14;SZ;Eswatini;57;3;6825;130
2020-12-15;SZ;Eswatini;87;2;6912;132
2020-12-16;SZ;Eswatini;114;3;7026;135
2020-12-17;SZ;Eswatini;67;0;7093;135
2020-12-18;SZ;Eswatini;109;1;7202;136
2020-12-19;SZ;Eswatini;103;1;7305;137
2020-12-20;SZ;Eswatini;122;3;7427;140
2020-12-21;SZ;Eswatini;135;1;7562;141
2020-12-22;SZ;Eswatini;153;1;7715;142
2020-12-23;SZ;Eswatini;153;11;7868;153
2020-12-24;SZ;Eswatini;164;1;8032;154
2020-12-25;SZ;Eswatini;138;0;8170;154
2020-12-26;SZ;Eswatini;197;9;8367;163
2020-12-27;SZ;Eswatini;117;2;8484;165
2020-12-28;SZ;Eswatini;203;2;8687;167
2020-12-29;SZ;Eswatini;247;8;8934;175
2020-12-30;SZ;Eswatini;212;9;9146;184
2020-12-31;SZ;Eswatini;212;21;9358;205
2021-01-01;SZ;Eswatini;124;11;9482;216
2021-01-02;SZ;Eswatini;229;11;9711;227
2021-01-03;SZ;Eswatini;232;4;9943;231
2021-01-04;SZ;Eswatini;195;13;10138;244
2021-01-05;SZ;Eswatini;200;8;10338;252
2021-01-06;SZ;Eswatini;201;9;10539;261
2021-01-07;SZ;Eswatini;234;7;10773;268
2021-01-08;SZ;Eswatini;202;11;10975;279
2021-01-09;SZ;Eswatini;205;12;11180;291
2021-01-10;SZ;Eswatini;255;4;11435;295
2021-01-11;SZ;Eswatini;276;3;11711;298
2021-01-12;SZ;Eswatini;208;21;11919;319
2021-01-13;SZ;Eswatini;205;13;12124;332
2021-01-14;SZ;Eswatini;203;3;12327;335
2021-01-15;SZ;Eswatini;205;8;12532;343
2021-01-16;SZ;Eswatini;204;17;12736;360
2021-01-17;SZ;Eswatini;208;16;12944;376
2021-01-18;SZ;Eswatini;243;8;13187;384
2021-01-19;SZ;Eswatini;256;19;13443;403
2021-01-20;SZ;Eswatini;346;24;13789;427
2021-01-21;SZ;Eswatini;228;14;14017;441
2021-01-22;SZ;Eswatini;202;17;14219;458
2021-01-23;SZ;Eswatini;111;0;14330;458
2021-01-24;SZ;Eswatini;154;21;14484;479
2021-01-25;SZ;Eswatini;138;14;14622;493
2021-01-26;SZ;Eswatini;208;24;14830;517
2021-01-27;SZ;Eswatini;221;5;15051;522
2021-01-28;SZ;Eswatini;232;16;15283;538
2021-01-29;SZ;Eswatini;188;13;15471;551
2021-01-30;SZ;Eswatini;195;11;15666;562
2021-01-31;SZ;Eswatini;45;3;15711;565
2021-02-01;SZ;Eswatini;93;9;15804;574
2021-02-02;SZ;Eswatini;74;9;15878;583
2021-02-03;SZ;Eswatini;96;2;15974;585
2021-02-04;SZ;Eswatini;71;6;16045;591
2021-02-05;SZ;Eswatini;92;9;16137;600
2021-02-06;SZ;Eswatini;44;4;16181;604
2021-02-07;SZ;Eswatini;23;0;16204;604
2021-02-08;SZ;Eswatini;30;3;16234;607
2021-02-09;SZ;Eswatini;54;3;16288;610
2021-02-10;SZ;Eswatini;53;6;16341;616
2021-02-11;SZ;Eswatini;55;3;16396;619
2021-02-12;SZ;Eswatini;59;11;16455;630
2021-02-13;SZ;Eswatini;33;0;16488;630
2021-02-14;SZ;Eswatini;47;0;16535;630
2021-02-15;SZ;Eswatini;41;4;16576;634
2021-02-16;SZ;Eswatini;30;0;16606;634
2021-02-17;SZ;Eswatini;67;3;16673;637
2021-02-18;SZ;Eswatini;36;3;16709;640
2021-02-19;SZ;Eswatini;33;4;16742;644
2021-02-20;SZ;Eswatini;22;1;16764;645
2021-02-21;SZ;Eswatini;25;0;16789;645
2021-02-22;SZ;Eswatini;18;0;16807;645
2021-02-23;SZ;Eswatini;32;2;16839;647
2021-02-24;SZ;Eswatini;58;2;16897;649
2021-02-25;SZ;Eswatini;49;1;16946;650
2021-02-26;SZ;Eswatini;26;0;16972;650
2021-02-27;SZ;Eswatini;30;0;17002;650
2021-02-28;SZ;Eswatini;12;2;17014;652
2021-03-01;SZ;Eswatini;11;0;17025;652
2021-03-02;SZ;Eswatini;61;0;17086;652
2021-03-03;SZ;Eswatini;17;0;17103;652
2021-03-04;SZ;Eswatini;26;2;17129;654
2021-03-05;SZ;Eswatini;26;0;17155;654
2021-03-06;SZ;Eswatini;18;4;17173;658
2021-03-07;SZ;Eswatini;11;0;17184;658
2021-03-08;SZ;Eswatini;4;0;17188;658
2021-03-09;SZ;Eswatini;3;0;17191;658
2021-03-10;SZ;Eswatini;12;0;17203;658
2021-03-11;SZ;Eswatini;12;1;17215;659
2021-03-12;SZ;Eswatini;10;0;17225;659
2021-03-13;SZ;Eswatini;9;2;17234;661
2021-03-14;SZ;Eswatini;3;0;17237;661
2021-03-15;SZ;Eswatini;2;2;17239;663
2021-03-16;SZ;Eswatini;4;0;17243;663
2021-03-17;SZ;Eswatini;14;0;17257;663
2021-03-18;SZ;Eswatini;10;1;17267;664
2021-03-19;SZ;Eswatini;7;0;17274;664
2021-03-20;SZ;Eswatini;9;1;17283;665
2021-03-21;SZ;Eswatini;3;0;17286;665
2021-03-22;SZ;Eswatini;4;0;17290;665
2021-03-23;SZ;Eswatini;6;0;17296;665
2021-03-24;SZ;Eswatini;5;1;17301;666
2021-03-25;SZ;Eswatini;5;0;17306;666
2021-03-26;SZ;Eswatini;6;0;17312;666
2021-03-27;SZ;Eswatini;6;0;17318;666
2021-03-28;SZ;Eswatini;3;1;17321;667
2021-03-29;SZ;Eswatini;5;0;17326;667
2021-03-30;SZ;Eswatini;7;0;17333;667
2021-03-31;SZ;Eswatini;4;0;17337;667
2021-04-01;SZ;Eswatini;7;1;17344;668
2021-04-02;SZ;Eswatini;3;0;17347;668
2021-04-03;SZ;Eswatini;2;0;17349;668
2021-04-04;SZ;Eswatini;3;0;17352;668
2021-04-05;SZ;Eswatini;2;1;17354;669
2021-04-06;SZ;Eswatini;4;0;17358;669
2021-04-07;SZ;Eswatini;7;0;17365;669
2021-04-08;SZ;Eswatini;2;0;17367;669
2021-04-09;SZ;Eswatini;3;0;17370;669
2021-04-10;SZ;Eswatini;3;0;17373;669
2021-04-11;SZ;Eswatini;3;0;17376;669
2021-04-12;SZ;Eswatini;1017;0;18393;669
2021-04-13;SZ;Eswatini;9;0;18402;669
2021-04-14;SZ;Eswatini;5;1;18407;670
2021-04-15;SZ;Eswatini;5;0;18412;670
2021-04-16;SZ;Eswatini;2;0;18414;670
2021-04-17;SZ;Eswatini;1;1;18415;671
2021-04-18;SZ;Eswatini;2;0;18417;671
2021-04-19;SZ;Eswatini;0;0;18417;671
2021-04-20;SZ;Eswatini;0;0;18417;671
2021-04-21;SZ;Eswatini;6;0;18423;671
2021-04-22;SZ;Eswatini;3;0;18426;671
2021-04-23;SZ;Eswatini;8;0;18434;671
2021-04-24;SZ;Eswatini;6;0;18440;671
2021-04-25;SZ;Eswatini;2;0;18442;671
2021-04-26;SZ;Eswatini;1;0;18443;671
2021-04-27;SZ;Eswatini;5;0;18448;671
2021-04-28;SZ;Eswatini;4;0;18452;671
2021-04-29;SZ;Eswatini;6;0;18458;671
2021-04-30;SZ;Eswatini;0;0;18458;671
2021-05-01;SZ;Eswatini;0;0;18458;671
2021-05-02;SZ;Eswatini;0;0;18458;671
2021-05-03;SZ;Eswatini;2;0;18460;671
2021-05-04;SZ;Eswatini;1;0;18461;671
2021-05-05;SZ;Eswatini;6;0;18467;671
2021-05-06;SZ;Eswatini;6;0;18473;671
2021-05-07;SZ;Eswatini;1;0;18474;671
2021-05-08;SZ;Eswatini;3;0;18477;671
2021-05-09;SZ;Eswatini;3;0;18480;671
2021-05-10;SZ;Eswatini;2;0;18482;671
2021-05-11;SZ;Eswatini;5;0;18487;671
2021-05-12;SZ;Eswatini;5;0;18492;671
2021-05-13;SZ;Eswatini;5;0;18497;671
2021-05-14;SZ;Eswatini;14;0;18511;671
2021-05-15;SZ;Eswatini;8;0;18519;671
2021-05-16;SZ;Eswatini;1;1;18520;672
2021-05-17;SZ;Eswatini;3;0;18523;672
2021-05-18;SZ;Eswatini;2;0;18525;672
2021-05-19;SZ;Eswatini;5;0;18530;672
2021-05-20;SZ;Eswatini;9;0;18539;672
2021-05-21;SZ;Eswatini;7;0;18546;672
2021-05-22;SZ;Eswatini;4;0;18550;672
2021-05-23;SZ;Eswatini;1;0;18551;672
2021-05-24;SZ;Eswatini;6;0;18557;672
2021-05-25;SZ;Eswatini;13;0;18570;672
2021-05-26;SZ;Eswatini;2;0;18572;672
2021-05-27;SZ;Eswatini;10;0;18582;672
2021-05-28;SZ;Eswatini;5;0;18587;672
2021-05-29;SZ;Eswatini;2;0;18589;672
2021-05-30;SZ;Eswatini;2;1;18591;673
2021-05-31;SZ;Eswatini;4;0;18595;673
2021-06-01;SZ;Eswatini;6;0;18601;673
2021-06-02;SZ;Eswatini;17;0;18618;673
2021-06-03;SZ;Eswatini;5;0;18623;673
2021-06-04;SZ;Eswatini;9;0;18632;673
2021-06-05;SZ;Eswatini;4;0;18636;673
2021-06-06;SZ;Eswatini;17;0;18653;673
2021-06-07;SZ;Eswatini;11;0;18664;673
2021-06-08;SZ;Eswatini;16;1;18680;674
2021-06-09;SZ;Eswatini;14;2;18694;676
2021-06-10;SZ;Eswatini;11;0;18705;676
2021-06-11;SZ;Eswatini;18;0;18723;676
2021-06-12;SZ;Eswatini;9;0;18732;676
2021-06-13;SZ;Eswatini;4;0;18736;676
2021-06-14;SZ;Eswatini;10;0;18746;676
2021-06-15;SZ;Eswatini;8;0;18754;676
2021-06-16;SZ;Eswatini;14;0;18768;676
2021-06-17;SZ;Eswatini;16;0;18784;676
2021-06-18;SZ;Eswatini;16;1;18800;677
2021-06-19;SZ;Eswatini;11;0;18811;677
2021-06-20;SZ;Eswatini;2;0;18813;677
2021-06-21;SZ;Eswatini;18;0;18831;677
2021-06-22;SZ;Eswatini;23;0;18854;677
2021-06-23;SZ;Eswatini;44;0;18898;677
2021-06-24;SZ;Eswatini;49;1;18947;678
2021-06-25;SZ;Eswatini;42;0;18989;678
2021-06-26;SZ;Eswatini;29;0;19018;678
2021-06-27;SZ;Eswatini;17;0;19035;678
2021-06-28;SZ;Eswatini;49;0;19084;678
2021-06-29;SZ;Eswatini;0;0;19084;678
2021-06-30;SZ;Eswatini;0;0;19084;678
2021-07-01;SZ;Eswatini;0;0;19084;678
2020-03-13;ET;Ethiopia;1;0;1;0
2020-03-14;ET;Ethiopia;0;0;1;0
2020-03-15;ET;Ethiopia;0;0;1;0
2020-03-16;ET;Ethiopia;4;0;5;0
2020-03-17;ET;Ethiopia;0;0;5;0
2020-03-18;ET;Ethiopia;1;0;6;0
2020-03-19;ET;Ethiopia;0;0;6;0
2020-03-20;ET;Ethiopia;3;0;9;0
2020-03-21;ET;Ethiopia;0;0;9;0
2020-03-22;ET;Ethiopia;2;0;11;0
2020-03-23;ET;Ethiopia;0;0;11;0
2020-03-24;ET;Ethiopia;1;0;12;0
2020-03-25;ET;Ethiopia;0;0;12;0
2020-03-26;ET;Ethiopia;0;0;12;0
2020-03-27;ET;Ethiopia;4;0;16;0
2020-03-28;ET;Ethiopia;0;0;16;0
2020-03-29;ET;Ethiopia;5;0;21;0
2020-03-30;ET;Ethiopia;2;0;23;0
2020-03-31;ET;Ethiopia;3;0;26;0
2020-04-01;ET;Ethiopia;3;0;29;0
2020-04-02;ET;Ethiopia;0;0;29;0
2020-04-03;ET;Ethiopia;6;0;35;0
2020-04-04;ET;Ethiopia;3;0;38;0
2020-04-05;ET;Ethiopia;5;2;43;2
2020-04-06;ET;Ethiopia;1;0;44;2
2020-04-07;ET;Ethiopia;8;0;52;2
2020-04-08;ET;Ethiopia;3;0;55;2
2020-04-09;ET;Ethiopia;1;0;56;2
2020-04-10;ET;Ethiopia;9;1;65;3
2020-04-11;ET;Ethiopia;4;0;69;3
2020-04-12;ET;Ethiopia;2;0;71;3
2020-04-13;ET;Ethiopia;3;0;74;3
2020-04-14;ET;Ethiopia;8;0;82;3
2020-04-15;ET;Ethiopia;3;0;85;3
2020-04-16;ET;Ethiopia;7;0;92;3
2020-04-17;ET;Ethiopia;4;0;96;3
2020-04-18;ET;Ethiopia;9;0;105;3
2020-04-19;ET;Ethiopia;3;0;108;3
2020-04-20;ET;Ethiopia;3;0;111;3
2020-04-21;ET;Ethiopia;3;0;114;3
2020-04-22;ET;Ethiopia;2;0;116;3
2020-04-23;ET;Ethiopia;0;0;116;3
2020-04-24;ET;Ethiopia;1;0;117;3
2020-04-25;ET;Ethiopia;5;0;122;3
2020-04-26;ET;Ethiopia;1;0;123;3
2020-04-27;ET;Ethiopia;1;0;124;3
2020-04-28;ET;Ethiopia;2;0;126;3
2020-04-29;ET;Ethiopia;4;0;130;3
2020-04-30;ET;Ethiopia;1;0;131;3
2020-05-01;ET;Ethiopia;2;0;133;3
2020-05-02;ET;Ethiopia;0;0;133;3
2020-05-03;ET;Ethiopia;2;0;135;3
2020-05-04;ET;Ethiopia;5;0;140;3
2020-05-05;ET;Ethiopia;5;1;145;4
2020-05-06;ET;Ethiopia;17;0;162;4
2020-05-07;ET;Ethiopia;29;0;191;4
2020-05-08;ET;Ethiopia;3;0;194;4
2020-05-09;ET;Ethiopia;16;1;210;5
2020-05-10;ET;Ethiopia;29;0;239;5
2020-05-11;ET;Ethiopia;11;0;250;5
2020-05-12;ET;Ethiopia;11;0;261;5
2020-05-13;ET;Ethiopia;2;0;263;5
2020-05-14;ET;Ethiopia;9;0;272;5
2020-05-15;ET;Ethiopia;15;0;287;5
2020-05-16;ET;Ethiopia;19;0;306;5
2020-05-17;ET;Ethiopia;11;0;317;5
2020-05-18;ET;Ethiopia;35;0;352;5
2020-05-19;ET;Ethiopia;13;0;365;5
2020-05-20;ET;Ethiopia;24;0;389;5
2020-05-21;ET;Ethiopia;10;0;399;5
2020-05-22;ET;Ethiopia;34;0;433;5
2020-05-23;ET;Ethiopia;61;0;494;5
2020-05-24;ET;Ethiopia;88;0;582;5
2020-05-25;ET;Ethiopia;73;0;655;5
2020-05-26;ET;Ethiopia;46;1;701;6
2020-05-27;ET;Ethiopia;30;0;731;6
2020-05-28;ET;Ethiopia;100;1;831;7
2020-05-29;ET;Ethiopia;137;1;968;8
2020-05-30;ET;Ethiopia;95;0;1063;8
2020-05-31;ET;Ethiopia;109;3;1172;11
2020-06-01;ET;Ethiopia;85;1;1257;12
2020-06-02;ET;Ethiopia;87;2;1344;14
2020-06-03;ET;Ethiopia;142;3;1486;17
2020-06-04;ET;Ethiopia;150;1;1636;18
2020-06-05;ET;Ethiopia;169;1;1805;19
2020-06-06;ET;Ethiopia;129;1;1934;20
2020-06-07;ET;Ethiopia;86;7;2020;27
2020-06-08;ET;Ethiopia;136;0;2156;27
2020-06-09;ET;Ethiopia;180;5;2336;32
2020-06-10;ET;Ethiopia;170;3;2506;35
2020-06-11;ET;Ethiopia;164;5;2670;40
2020-06-12;ET;Ethiopia;245;7;2915;47
2020-06-13;ET;Ethiopia;251;8;3166;55
2020-06-14;ET;Ethiopia;179;2;3345;57
2020-06-15;ET;Ethiopia;176;3;3521;60
2020-06-16;ET;Ethiopia;109;1;3630;61
2020-06-17;ET;Ethiopia;129;2;3759;63
2020-06-18;ET;Ethiopia;195;2;3954;65
2020-06-19;ET;Ethiopia;116;7;4070;72
2020-06-20;ET;Ethiopia;399;0;4469;72
2020-06-21;ET;Ethiopia;63;2;4532;74
2020-06-22;ET;Ethiopia;131;1;4663;75
2020-06-23;ET;Ethiopia;185;0;4848;75
2020-06-24;ET;Ethiopia;186;3;5034;78
2020-06-25;ET;Ethiopia;141;3;5175;81
2020-06-26;ET;Ethiopia;250;8;5425;89
2020-06-27;ET;Ethiopia;145;5;5570;94
2020-06-28;ET;Ethiopia;119;4;5689;98
2020-06-29;ET;Ethiopia;157;5;5846;103
2020-06-30;ET;Ethiopia;0;0;5846;103
2020-07-01;ET;Ethiopia;0;0;5846;103
2020-07-02;ET;Ethiopia;0;0;5846;103
2020-07-03;ET;Ethiopia;0;0;5846;103
2020-07-04;ET;Ethiopia;0;0;5846;103
2020-07-05;ET;Ethiopia;0;0;5846;103
2020-07-06;ET;Ethiopia;0;0;5846;103
2020-07-07;ET;Ethiopia;0;0;5846;103
2020-07-08;ET;Ethiopia;928;17;6774;120
2020-07-09;ET;Ethiopia;199;0;6973;120
2020-07-10;ET;Ethiopia;147;4;7120;124
2020-07-11;ET;Ethiopia;282;0;7402;124
2020-07-12;ET;Ethiopia;158;3;7560;127
2020-07-13;ET;Ethiopia;206;1;7766;128
2020-07-14;ET;Ethiopia;203;11;7969;139
2020-07-15;ET;Ethiopia;212;7;8181;146
2020-07-16;ET;Ethiopia;294;2;8475;148
2020-07-17;ET;Ethiopia;328;2;8803;150
2020-07-18;ET;Ethiopia;344;13;9147;163
2020-07-19;ET;Ethiopia;356;4;9503;167
2020-07-20;ET;Ethiopia;704;3;10207;170
2020-07-21;ET;Ethiopia;865;10;11072;180
2020-07-22;ET;Ethiopia;452;8;11524;188
2020-07-23;ET;Ethiopia;409;9;11933;197
2020-07-24;ET;Ethiopia;760;3;12693;200
2020-07-25;ET;Ethiopia;555;9;13248;209
2020-07-26;ET;Ethiopia;720;14;13968;223
2020-07-27;ET;Ethiopia;579;5;14547;228
2020-07-28;ET;Ethiopia;653;11;15200;239
2020-07-29;ET;Ethiopia;610;14;15810;253
2020-07-30;ET;Ethiopia;805;10;16615;263
2020-07-31;ET;Ethiopia;915;11;17530;274
2020-08-01;ET;Ethiopia;469;10;17999;284
2020-08-02;ET;Ethiopia;707;26;18706;310
2020-08-03;ET;Ethiopia;583;26;19289;336
2020-08-04;ET;Ethiopia;588;7;19877;343
2020-08-05;ET;Ethiopia;459;13;20336;356
2020-08-06;ET;Ethiopia;564;9;20900;365
2020-08-07;ET;Ethiopia;552;15;21452;380
2020-08-08;ET;Ethiopia;801;10;22253;390
2020-08-09;ET;Ethiopia;565;17;22818;407
2020-08-10;ET;Ethiopia;773;13;23591;420
2020-08-11;ET;Ethiopia;584;20;24175;440
2020-08-12;ET;Ethiopia;943;23;25118;463
2020-08-13;ET;Ethiopia;1086;16;26204;479
2020-08-14;ET;Ethiopia;1038;13;27242;492
2020-08-15;ET;Ethiopia;1652;17;28894;509
2020-08-16;ET;Ethiopia;982;19;29876;528
2020-08-17;ET;Ethiopia;1460;16;31336;544
2020-08-18;ET;Ethiopia;1386;28;32722;572
2020-08-19;ET;Ethiopia;1336;28;34058;600
2020-08-20;ET;Ethiopia;1778;20;35836;620
2020-08-21;ET;Ethiopia;1829;17;37665;637
2020-08-22;ET;Ethiopia;1368;25;39033;662
2020-08-23;ET;Ethiopia;1638;16;40671;678
2020-08-24;ET;Ethiopia;1472;14;42143;692
2020-08-25;ET;Ethiopia;1545;17;43688;709
2020-08-26;ET;Ethiopia;1533;16;45221;725
2020-08-27;ET;Ethiopia;1186;20;46407;745
2020-08-28;ET;Ethiopia;1733;13;48140;758
2020-08-29;ET;Ethiopia;1514;12;49654;770
2020-08-30;ET;Ethiopia;1468;23;51122;793
2020-08-31;ET;Ethiopia;1009;16;52131;809
2020-09-01;ET;Ethiopia;1173;19;53304;828
2020-09-02;ET;Ethiopia;1105;18;54409;846
2020-09-03;ET;Ethiopia;804;10;55213;856
2020-09-04;ET;Ethiopia;1303;24;56516;880
2020-09-05;ET;Ethiopia;950;17;57466;897
2020-09-06;ET;Ethiopia;1206;21;58672;918
2020-09-07;ET;Ethiopia;976;15;59648;933
2020-09-08;ET;Ethiopia;1136;16;60784;949
2020-09-09;ET;Ethiopia;916;17;61700;966
2020-09-10;ET;Ethiopia;878;8;62578;974
2020-09-11;ET;Ethiopia;789;12;63367;986
2020-09-12;ET;Ethiopia;521;10;63888;996
2020-09-13;ET;Ethiopia;413;17;64301;1013
2020-09-14;ET;Ethiopia;485;9;64786;1022
2020-09-15;ET;Ethiopia;700;13;65486;1035
2020-09-16;ET;Ethiopia;738;10;66224;1045
2020-09-17;ET;Ethiopia;689;15;66913;1060
2020-09-18;ET;Ethiopia;602;12;67515;1072
2020-09-19;ET;Ethiopia;616;17;68131;1089
2020-09-20;ET;Ethiopia;689;7;68820;1096
2020-09-21;ET;Ethiopia;889;12;69709;1108
2020-09-22;ET;Ethiopia;713;19;70422;1127
2020-09-23;ET;Ethiopia;661;14;71083;1141
2020-09-24;ET;Ethiopia;604;7;71687;1148
2020-09-25;ET;Ethiopia;486;7;72173;1155
2020-09-26;ET;Ethiopia;527;10;72700;1165
2020-09-27;ET;Ethiopia;632;5;73332;1170
2020-09-28;ET;Ethiopia;612;7;73944;1177
2020-09-29;ET;Ethiopia;640;14;74584;1191
2020-09-30;ET;Ethiopia;784;7;75368;1198
2020-10-01;ET;Ethiopia;730;7;76098;1205
2020-10-02;ET;Ethiopia;890;3;76988;1208
2020-10-03;ET;Ethiopia;872;6;77860;1214
2020-10-04;ET;Ethiopia;959;8;78819;1222
2020-10-05;ET;Ethiopia;618;8;79437;1230
2020-10-06;ET;Ethiopia;566;8;80003;1238
2020-10-07;ET;Ethiopia;892;17;80895;1255
2020-10-08;ET;Ethiopia;902;7;81797;1262
2020-10-09;ET;Ethiopia;865;9;82662;1271
2020-10-10;ET;Ethiopia;767;6;83429;1277
2020-10-11;ET;Ethiopia;866;10;84295;1287
2020-10-12;ET;Ethiopia;841;14;85136;1301
2020-10-13;ET;Ethiopia;582;4;85718;1305
2020-10-14;ET;Ethiopia;712;7;86430;1312
2020-10-15;ET;Ethiopia;739;13;87169;1325
2020-10-16;ET;Ethiopia;665;12;87834;1337
2020-10-17;ET;Ethiopia;600;9;88434;1346
2020-10-18;ET;Ethiopia;703;6;89137;1352
2020-10-19;ET;Ethiopia;723;13;89860;1365
2020-10-20;ET;Ethiopia;630;6;90490;1371
2020-10-21;ET;Ethiopia;628;13;91118;1384
2020-10-22;ET;Ethiopia;575;12;91693;1396
2020-10-23;ET;Ethiopia;536;4;92229;1400
2020-10-24;ET;Ethiopia;629;19;92858;1419
2020-10-25;ET;Ethiopia;485;7;93343;1426
2020-10-26;ET;Ethiopia;364;11;93707;1437
2020-10-27;ET;Ethiopia;511;8;94218;1445
2020-10-28;ET;Ethiopia;602;6;94820;1451
2020-10-29;ET;Ethiopia;481;6;95301;1457
2020-10-30;ET;Ethiopia;488;7;95789;1464
2020-10-31;ET;Ethiopia;380;5;96169;1469
2020-11-01;ET;Ethiopia;414;9;96583;1478
2020-11-02;ET;Ethiopia;359;11;96942;1489
2020-11-03;ET;Ethiopia;560;5;97502;1494
2020-11-04;ET;Ethiopia;379;9;97881;1503
2020-11-05;ET;Ethiopia;510;5;98391;1508
2020-11-06;ET;Ethiopia;355;4;98746;1512
2020-11-07;ET;Ethiopia;455;6;99201;1518
2020-11-08;ET;Ethiopia;474;5;99675;1523
2020-11-09;ET;Ethiopia;307;7;99982;1530
2020-11-10;ET;Ethiopia;345;7;100327;1537
2020-11-11;ET;Ethiopia;400;8;100727;1545
2020-11-12;ET;Ethiopia;521;9;101248;1554
2020-11-13;ET;Ethiopia;509;4;101757;1558
2020-11-14;ET;Ethiopia;564;7;102321;1565
2020-11-15;ET;Ethiopia;399;4;102720;1569
2020-11-16;ET;Ethiopia;336;12;103056;1581
2020-11-17;ET;Ethiopia;339;7;103395;1588
2020-11-18;ET;Ethiopia;533;13;103928;1601
2020-11-19;ET;Ethiopia;499;6;104427;1607
2020-11-20;ET;Ethiopia;452;13;104879;1620
2020-11-21;ET;Ethiopia;473;16;105352;1636
2020-11-22;ET;Ethiopia;433;11;105785;1647
2020-11-23;ET;Ethiopia;418;4;106203;1651
2020-11-24;ET;Ethiopia;388;10;106591;1661
2020-11-25;ET;Ethiopia;518;3;107109;1664
2020-11-26;ET;Ethiopia;560;8;107669;1672
2020-11-27;ET;Ethiopia;769;14;108438;1686
2020-11-28;ET;Ethiopia;492;9;108930;1695
2020-11-29;ET;Ethiopia;604;5;109534;1700
2020-11-30;ET;Ethiopia;540;6;110074;1706
2020-12-01;ET;Ethiopia;480;3;110554;1709
2020-12-02;ET;Ethiopia;430;6;110984;1715
2020-12-03;ET;Ethiopia;595;9;111579;1724
2020-12-04;ET;Ethiopia;512;10;112091;1734
2020-12-05;ET;Ethiopia;649;11;112740;1745
2020-12-06;ET;Ethiopia;555;2;113295;1747
2020-12-07;ET;Ethiopia;440;8;113735;1755
2020-12-08;ET;Ethiopia;531;11;114266;1766
2020-12-09;ET;Ethiopia;568;3;114834;1769
2020-12-10;ET;Ethiopia;526;10;115360;1779
2020-12-11;ET;Ethiopia;422;12;115782;1791
2020-12-12;ET;Ethiopia;515;12;116297;1803
2020-12-13;ET;Ethiopia;472;3;116769;1806
2020-12-14;ET;Ethiopia;473;3;117242;1809
2020-12-15;ET;Ethiopia;300;4;117542;1813
2020-12-16;ET;Ethiopia;464;5;118006;1818
2020-12-17;ET;Ethiopia;475;13;118481;1831
2020-12-18;ET;Ethiopia;544;12;119025;1843
2020-12-19;ET;Ethiopia;469;3;119494;1846
2020-12-20;ET;Ethiopia;457;7;119951;1853
2020-12-21;ET;Ethiopia;397;8;120348;1861
2020-12-22;ET;Ethiopia;290;3;120638;1864
2020-12-23;ET;Ethiopia;351;6;120989;1870
2020-12-24;ET;Ethiopia;410;12;121399;1882
2020-12-25;ET;Ethiopia;481;15;121880;1897
2020-12-26;ET;Ethiopia;533;4;122413;1901
2020-12-27;ET;Ethiopia;451;8;122864;1909
2020-12-28;ET;Ethiopia;281;3;123145;1912
2020-12-29;ET;Ethiopia;243;1;123388;1913
2020-12-30;ET;Ethiopia;468;5;123856;1918
2020-12-31;ET;Ethiopia;408;5;124264;1923
2021-01-01;ET;Ethiopia;388;14;124652;1937
2021-01-02;ET;Ethiopia;397;7;125049;1944
2021-01-03;ET;Ethiopia;573;4;125622;1948
2021-01-04;ET;Ethiopia;297;2;125919;1950
2021-01-05;ET;Ethiopia;322;13;126241;1963
2021-01-06;ET;Ethiopia;545;2;126786;1965
2021-01-07;ET;Ethiopia;441;1;127227;1966
2021-01-08;ET;Ethiopia;345;8;127572;1974
2021-01-09;ET;Ethiopia;220;11;127792;1985
2021-01-10;ET;Ethiopia;524;9;128316;1994
2021-01-11;ET;Ethiopia;300;9;128616;2003
2021-01-12;ET;Ethiopia;376;1;128992;2004
2021-01-13;ET;Ethiopia;463;2;129455;2006
2021-01-14;ET;Ethiopia;467;2;129922;2008
2021-01-15;ET;Ethiopia;404;15;130326;2023
2021-01-16;ET;Ethiopia;446;6;130772;2029
2021-01-17;ET;Ethiopia;423;1;131195;2030
2021-01-18;ET;Ethiopia;351;3;131546;2033
2021-01-19;ET;Ethiopia;181;4;131727;2037
2021-01-20;ET;Ethiopia;307;7;132034;2044
2021-01-21;ET;Ethiopia;292;13;132326;2057
2021-01-22;ET;Ethiopia;555;3;132881;2060
2021-01-23;ET;Ethiopia;417;3;133298;2063
2021-01-24;ET;Ethiopia;469;3;133767;2066
2021-01-25;ET;Ethiopia;365;5;134132;2071
2021-01-26;ET;Ethiopia;437;4;134569;2075
2021-01-27;ET;Ethiopia;476;8;135045;2083
2021-01-28;ET;Ethiopia;549;2;135594;2085
2021-01-29;ET;Ethiopia;771;2;136365;2087
2021-01-30;ET;Ethiopia;656;4;137021;2091
2021-01-31;ET;Ethiopia;629;2;137650;2093
2021-02-01;ET;Ethiopia;734;10;138384;2103
2021-02-02;ET;Ethiopia;477;13;138861;2116
2021-02-03;ET;Ethiopia;547;6;139408;2122
2021-02-04;ET;Ethiopia;749;4;140157;2126
2021-02-05;ET;Ethiopia;726;10;140883;2136
2021-02-06;ET;Ethiopia;570;9;141453;2145
2021-02-07;ET;Ethiopia;885;3;142338;2148
2021-02-08;ET;Ethiopia;656;8;142994;2156
2021-02-09;ET;Ethiopia;572;2;143566;2158
2021-02-10;ET;Ethiopia;683;9;144249;2167
2021-02-11;ET;Ethiopia;613;4;144862;2171
2021-02-12;ET;Ethiopia;686;6;145548;2177
2021-02-13;ET;Ethiopia;156;4;145704;2181
2021-02-14;ET;Ethiopia;1388;13;147092;2194
2021-02-15;ET;Ethiopia;733;15;147825;2209
2021-02-16;ET;Ethiopia;665;14;148490;2223
2021-02-17;ET;Ethiopia;818;14;149308;2237
2021-02-18;ET;Ethiopia;871;12;150179;2249
2021-02-19;ET;Ethiopia;837;10;151016;2259
2021-02-20;ET;Ethiopia;841;12;151857;2271
2021-02-21;ET;Ethiopia;949;8;152806;2279
2021-02-22;ET;Ethiopia;735;14;153541;2293
2021-02-23;ET;Ethiopia;716;12;154257;2305
2021-02-24;ET;Ethiopia;977;11;155234;2316
2021-02-25;ET;Ethiopia;878;5;156112;2321
2021-02-26;ET;Ethiopia;935;19;157047;2340
2021-02-27;ET;Ethiopia;1006;14;158053;2354
2021-02-28;ET;Ethiopia;1019;11;159072;2365
2021-03-01;ET;Ethiopia;900;8;159972;2373
2021-03-02;ET;Ethiopia;841;13;160813;2386
2021-03-03;ET;Ethiopia;1161;5;161974;2391
2021-03-04;ET;Ethiopia;980;3;162954;2394
2021-03-05;ET;Ethiopia;1119;10;164073;2404
2021-03-06;ET;Ethiopia;956;16;165029;2420
2021-03-07;ET;Ethiopia;1109;9;166138;2429
2021-03-08;ET;Ethiopia;995;13;167133;2442
2021-03-09;ET;Ethiopia;1202;9;168335;2451
2021-03-10;ET;Ethiopia;1543;15;169878;2466
2021-03-11;ET;Ethiopia;1332;17;171210;2483
2021-03-12;ET;Ethiopia;1361;27;172571;2510
2021-03-13;ET;Ethiopia;1483;30;174054;2540
2021-03-14;ET;Ethiopia;1413;10;175467;2550
2021-03-15;ET;Ethiopia;1151;5;176618;2555
2021-03-16;ET;Ethiopia;1490;18;178108;2573
2021-03-17;ET;Ethiopia;1704;19;179812;2592
2021-03-18;ET;Ethiopia;2057;10;181869;2602
2021-03-19;ET;Ethiopia;1994;16;183863;2618
2021-03-20;ET;Ethiopia;1778;29;185641;2647
2021-03-21;ET;Ethiopia;1724;12;187365;2659
2021-03-22;ET;Ethiopia;1537;15;188902;2674
2021-03-23;ET;Ethiopia;1692;19;190594;2693
2021-03-24;ET;Ethiopia;1981;25;192575;2718
2021-03-25;ET;Ethiopia;1949;23;194524;2741
2021-03-26;ET;Ethiopia;2097;28;196621;2769
2021-03-27;ET;Ethiopia;2173;15;198794;2784
2021-03-28;ET;Ethiopia;1769;17;200563;2801
2021-03-29;ET;Ethiopia;1982;24;202545;2825
2021-03-30;ET;Ethiopia;1976;16;204521;2841
2021-03-31;ET;Ethiopia;2068;24;206589;2865
2021-04-01;ET;Ethiopia;2372;25;208961;2890
2021-04-02;ET;Ethiopia;2353;25;211314;2915
2021-04-03;ET;Ethiopia;1997;21;213311;2936
2021-04-04;ET;Ethiopia;1878;27;215189;2963
2021-04-05;ET;Ethiopia;2138;37;217327;3000
2021-04-06;ET;Ethiopia;2054;25;219381;3025
2021-04-07;ET;Ethiopia;2163;33;221544;3058
2021-04-08;ET;Ethiopia;2121;20;223665;3078
2021-04-09;ET;Ethiopia;1851;33;225516;3111
2021-04-10;ET;Ethiopia;1739;35;227255;3146
2021-04-11;ET;Ethiopia;1741;28;228996;3174
2021-04-12;ET;Ethiopia;1948;34;230944;3208
2021-04-13;ET;Ethiopia;1568;22;232512;3230
2021-04-14;ET;Ethiopia;1893;22;234405;3252
2021-04-15;ET;Ethiopia;2149;33;236554;3285
2021-04-16;ET;Ethiopia;1973;15;238527;3300
2021-04-17;ET;Ethiopia;1709;28;240236;3328
2021-04-18;ET;Ethiopia;1792;42;242028;3370
2021-04-19;ET;Ethiopia;1603;22;243631;3392
2021-04-20;ET;Ethiopia;1524;47;245155;3439
2021-04-21;ET;Ethiopia;1329;35;246484;3474
2021-04-22;ET;Ethiopia;1505;22;247989;3496
2021-04-23;ET;Ethiopia;1303;15;249292;3511
2021-04-24;ET;Ethiopia;1663;20;250955;3531
2021-04-25;ET;Ethiopia;1324;20;252279;3551
2021-04-26;ET;Ethiopia;841;19;253120;3570
2021-04-27;ET;Ethiopia;924;35;254044;3605
2021-04-28;ET;Ethiopia;1244;34;255288;3639
2021-04-29;ET;Ethiopia;1130;19;256418;3658
2021-04-30;ET;Ethiopia;1024;30;257442;3688
2021-05-01;ET;Ethiopia;620;21;258062;3709
2021-05-02;ET;Ethiopia;322;17;258384;3726
2021-05-03;ET;Ethiopia;429;31;258813;3757
2021-05-04;ET;Ethiopia;541;15;259354;3772
2021-05-05;ET;Ethiopia;785;23;260139;3795
2021-05-06;ET;Ethiopia;663;27;260802;3822
2021-05-07;ET;Ethiopia;778;18;261580;3840
2021-05-08;ET;Ethiopia;637;31;262217;3871
2021-05-09;ET;Ethiopia;485;17;262702;3888
2021-05-10;ET;Ethiopia;418;9;263120;3897
2021-05-11;ET;Ethiopia;552;14;263672;3911
2021-05-12;ET;Ethiopia;695;27;264367;3938
2021-05-13;ET;Ethiopia;593;13;264960;3951
2021-05-14;ET;Ethiopia;453;13;265413;3964
2021-05-15;ET;Ethiopia;419;12;265832;3976
2021-05-16;ET;Ethiopia;432;20;266264;3996
2021-05-17;ET;Ethiopia;382;12;266646;4008
2021-05-18;ET;Ethiopia;454;13;267100;4021
2021-05-19;ET;Ethiopia;497;17;267597;4038
2021-05-20;ET;Ethiopia;438;10;268035;4048
2021-05-21;ET;Ethiopia;485;12;268520;4060
2021-05-22;ET;Ethiopia;381;8;268901;4068
2021-05-23;ET;Ethiopia;293;8;269194;4076
2021-05-24;ET;Ethiopia;306;8;269500;4084
2021-05-25;ET;Ethiopia;282;9;269782;4093
2021-05-26;ET;Ethiopia;398;15;270180;4108
2021-05-27;ET;Ethiopia;347;19;270527;4127
2021-05-28;ET;Ethiopia;417;12;270944;4139
2021-05-29;ET;Ethiopia;256;4;271200;4143
2021-05-30;ET;Ethiopia;145;12;271345;4155
2021-05-31;ET;Ethiopia;196;10;271541;4165
2021-06-01;ET;Ethiopia;249;6;271790;4171
2021-06-02;ET;Ethiopia;246;7;272036;4178
2021-06-03;ET;Ethiopia;249;7;272285;4185
2021-06-04;ET;Ethiopia;347;8;272632;4193
2021-06-05;ET;Ethiopia;173;8;272805;4201
2021-06-06;ET;Ethiopia;109;8;272914;4209
2021-06-07;ET;Ethiopia;110;4;273024;4213
2021-06-08;ET;Ethiopia;151;7;273175;4220
2021-06-09;ET;Ethiopia;223;6;273398;4226
2021-06-10;ET;Ethiopia;280;5;273678;4231
2021-06-11;ET;Ethiopia;214;4;273892;4235
2021-06-12;ET;Ethiopia;136;2;274028;4237
2021-06-13;ET;Ethiopia;159;5;274187;4242
2021-06-14;ET;Ethiopia;159;8;274346;4250
2021-06-15;ET;Ethiopia;134;7;274480;4257
2021-06-16;ET;Ethiopia;121;3;274601;4260
2021-06-17;ET;Ethiopia;174;2;274775;4262
2021-06-18;ET;Ethiopia;124;14;274899;4276
2021-06-19;ET;Ethiopia;137;4;275036;4280
2021-06-20;ET;Ethiopia;158;3;275194;4283
2021-06-21;ET;Ethiopia;124;3;275318;4286
2021-06-22;ET;Ethiopia;73;4;275391;4290
2021-06-23;ET;Ethiopia;111;2;275502;4292
2021-06-24;ET;Ethiopia;99;4;275601;4296
2021-06-25;ET;Ethiopia;168;6;275769;4302
2021-06-26;ET;Ethiopia;112;7;275881;4309
2021-06-27;ET;Ethiopia;54;5;275935;4314
2021-06-28;ET;Ethiopia;39;1;275974;4315
2021-06-29;ET;Ethiopia;63;5;276037;4320
2021-06-30;ET;Ethiopia;137;0;276174;4320
2021-07-01;ET;Ethiopia;76;5;276250;4325
2020-01-23;;Europe;0;0;0;0
2020-01-24;;Europe;2;0;2;0
2020-01-25;;Europe;1;0;3;0
2020-01-26;;Europe;0;0;3;0
2020-01-27;;Europe;1;0;4;0
2020-01-28;;Europe;4;0;8;0
2020-01-29;;Europe;2;0;10;0
2020-01-30;;Europe;0;0;10;0
2020-01-31;;Europe;7;0;17;0
2020-02-01;;Europe;6;0;23;0
2020-02-02;;Europe;2;0;25;0
2020-02-03;;Europe;8;0;33;0
2020-02-04;;Europe;1;0;34;0
2020-02-05;;Europe;1;0;35;0
2020-02-06;;Europe;0;0;35;0
2020-02-07;;Europe;2;0;37;0
2020-02-08;;Europe;9;0;46;0
2020-02-09;;Europe;3;0;49;0
2020-02-10;;Europe;0;0;49;0
2020-02-11;;Europe;3;0;52;0
2020-02-12;;Europe;1;0;53;0
2020-02-13;;Europe;1;0;54;0
2020-02-14;;Europe;1;0;55;0
2020-02-15;;Europe;1;1;56;1
2020-02-16;;Europe;0;0;56;1
2020-02-17;;Europe;1;0;57;1
2020-02-18;;Europe;0;0;57;1
2020-02-19;;Europe;1;0;58;1
2020-02-20;;Europe;2;0;60;1
2020-02-21;;Europe;18;1;78;2
2020-02-22;;Europe;42;1;120;3
2020-02-23;;Europe;98;1;218;4
2020-02-24;;Europe;76;4;294;8
2020-02-25;;Europe;108;3;402;11
2020-02-26;;Europe;163;3;565;14
2020-02-27;;Europe;265;5;830;19
2020-02-28;;Europe;303;4;1133;23
2020-02-29;;Europe;373;8;1506;31
2020-03-01;;Europe;755;5;2261;36
2020-03-02;;Europe;567;19;2828;55
2020-03-03;;Europe;688;30;3516;85
2020-03-04;;Europe;1012;29;4528;114
2020-03-05;;Europe;1432;46;5960;160
2020-03-06;;Europe;1772;55;7732;215
2020-03-07;;Europe;2158;49;9890;264
2020-03-08;;Europe;2535;146;12425;410
2020-03-09;;Europe;3142;117;15567;527
2020-03-10;;Europe;3391;191;18958;718
2020-03-11;;Europe;5463;240;24421;958
2020-03-12;;Europe;3928;196;28349;1154
2020-03-13;;Europe;11547;381;39896;1535
2020-03-14;;Europe;8157;288;48053;1823
2020-03-15;;Europe;8841;492;56894;2315
2020-03-16;;Europe;10996;501;67890;2816
2020-03-17;;Europe;11547;608;79437;3424
2020-03-18;;Europe;14047;643;93484;4067
2020-03-19;;Europe;19377;852;112861;4919
2020-03-20;;Europe;20463;1182;133324;6101
2020-03-21;;Europe;21662;1437;154986;7538
2020-03-22;;Europe;20309;1317;175295;8855
2020-03-23;;Europe;26407;1566;201702;10421
2020-03-24;;Europe;24405;1833;226107;12254
2020-03-25;;Europe;31019;2236;257126;14490
2020-03-26;;Europe;35912;2302;293038;16792
2020-03-27;;Europe;36027;2678;329065;19470
2020-03-28;;Europe;36795;2776;365860;22246
2020-03-29;;Europe;29917;2580;395777;24826
2020-03-30;;Europe;32655;3042;428432;27868
2020-03-31;;Europe;36809;3265;465241;31133
2020-04-01;;Europe;37141;4255;502382;35388
2020-04-02;;Europe;36170;3807;538552;39195
2020-04-03;;Europe;37653;4235;576205;43430
2020-04-04;;Europe;12521;3732;588726;47162
2020-04-05;;Europe;26464;3010;615190;50172
2020-04-06;;Europe;27402;3551;642592;53723
2020-04-07;;Europe;23840;5088;666432;58811
2020-04-08;;Europe;34123;3960;700555;62771
2020-04-09;;Europe;33364;4788;733919;67559
2020-04-10;;Europe;31340;4414;765259;71973
2020-04-11;;Europe;27168;3324;792427;75297
2020-04-12;;Europe;75042;3200;867469;78497
2020-04-13;;Europe;25147;3228;892616;81725
2020-04-14;;Europe;37581;3605;930197;85330
2020-04-15;;Europe;31933;5021;962130;90351
2020-04-16;;Europe;44097;4184;1006227;94535
2020-04-17;;Europe;32096;4072;1038323;98607
2020-04-18;;Europe;27394;3189;1065717;101796
2020-04-19;;Europe;30083;2412;1095800;104208
2020-04-20;;Europe;23633;2833;1119433;107041
2020-04-21;;Europe;27441;3757;1146874;110798
2020-04-22;;Europe;29563;3403;1176437;114201
2020-04-23;;Europe;25541;3136;1201978;117337
2020-04-24;;Europe;16152;3332;1218130;120669
2020-04-25;;Europe;24764;2776;1242894;123445
2020-04-26;;Europe;22066;1722;1264960;125167
2020-04-27;;Europe;24155;2076;1289115;127243
2020-04-28;;Europe;24019;2806;1313134;130049
2020-04-29;;Europe;21575;2873;1334709;132922
2020-04-30;;Europe;23091;2248;1357800;135170
2020-05-01;;Europe;22860;1845;1380660;137015
2020-05-02;;Europe;22190;2283;1402850;139298
2020-05-03;;Europe;21213;1131;1424063;140429
2020-05-04;;Europe;21062;1524;1445125;141953
2020-05-05;;Europe;22599;2000;1467724;143953
2020-05-06;;Europe;27077;2523;1494801;146476
2020-05-07;;Europe;25133;1751;1519934;148227
2020-05-08;;Europe;23415;2006;1543349;150233
2020-05-09;;Europe;20717;1184;1564066;151417
2020-05-10;;Europe;19751;923;1583817;152340
2020-05-11;;Europe;23821;1164;1607638;153504
2020-05-12;;Europe;22078;1826;1629716;155330
2020-05-13;;Europe;20474;1564;1650190;156894
2020-05-14;;Europe;20156;1576;1670346;158470
2020-05-15;;Europe;20327;1320;1690673;159790
2020-05-16;;Europe;17653;1150;1708326;160940
2020-05-17;;Europe;16460;979;1724786;161919
2020-05-18;;Europe;16899;817;1741685;162736
2020-05-19;;Europe;18922;917;1760607;163653
2020-05-20;;Europe;18059;1177;1778666;164830
2020-05-21;;Europe;17527;960;1796193;165790
2020-05-22;;Europe;18853;1610;1815046;167400
2020-05-23;;Europe;16629;855;1831675;168255
2020-05-24;;Europe;14197;733;1845872;168988
2020-05-25;;Europe;14306;-1354;1860178;167634
2020-05-26;;Europe;16247;1118;1876425;168752
2020-05-27;;Europe;15144;994;1891569;169746
2020-05-28;;Europe;20445;909;1912014;170655
2020-05-29;;Europe;16602;922;1928616;171577
2020-05-30;;Europe;16621;708;1945237;172285
2020-05-31;;Europe;14575;398;1959812;172683
2020-06-01;;Europe;14689;462;1974501;173145
2020-06-02;;Europe;14061;778;1988562;173923
2020-06-03;;Europe;11751;798;2000313;174721
2020-06-04;;Europe;19768;593;2020081;175314
2020-06-05;;Europe;16456;767;2036537;176081
2020-06-06;;Europe;15928;573;2052465;176654
2020-06-07;;Europe;14767;343;2067232;176997
2020-06-08;;Europe;15149;416;2082381;177413
2020-06-09;;Europe;15345;726;2097726;178139
2020-06-10;;Europe;15528;675;2113254;178814
2020-06-11;;Europe;16178;455;2129432;179269
2020-06-12;;Europe;17074;538;2146506;179807
2020-06-13;;Europe;15731;443;2162237;180250
2020-06-14;;Europe;14765;287;2177002;180537
2020-06-15;;Europe;14044;329;2191046;180866
2020-06-16;;Europe;15884;630;2206930;181496
2020-06-17;;Europe;16022;630;2222952;182126
2020-06-18;;Europe;17005;511;2239957;182637
2020-06-19;;Europe;15816;1611;2255773;184248
2020-06-20;;Europe;14616;405;2270389;184653
2020-06-21;;Europe;13295;226;2283684;184879
2020-06-22;;Europe;13549;232;2297233;185111
2020-06-23;;Europe;15074;563;2312307;185674
2020-06-24;;Europe;15132;393;2327439;186067
2020-06-25;;Europe;14778;372;2342217;186439
2020-06-26;;Europe;15625;504;2357842;186943
2020-06-27;;Europe;13901;324;2371743;187267
2020-06-28;;Europe;11742;252;2383485;187519
2020-06-29;;Europe;12950;264;2396435;187783
2020-06-30;;Europe;12802;456;2409237;188239
2020-07-01;;Europe;13190;495;2422427;188734
2020-07-02;;Europe;13533;407;2435960;189141
2020-07-03;;Europe;13950;425;2449910;189566
2020-07-04;;Europe;12821;330;2462731;189896
2020-07-05;;Europe;11793;253;2474524;190149
2020-07-06;;Europe;13613;282;2488137;190431
2020-07-07;;Europe;11979;469;2500116;190900
2020-07-08;;Europe;14144;437;2514260;191337
2020-07-09;;Europe;13622;387;2527882;191724
2020-07-10;;Europe;14566;388;2542448;192112
2020-07-11;;Europe;13741;340;2556189;192452
2020-07-12;;Europe;11770;221;2567959;192673
2020-07-13;;Europe;14531;242;2582490;192915
2020-07-14;;Europe;12813;377;2595303;193292
2020-07-15;;Europe;14433;418;2609736;193710
2020-07-16;;Europe;15289;373;2625025;194083
2020-07-17;;Europe;16202;370;2641227;194453
2020-07-18;;Europe;13364;247;2654591;194700
2020-07-19;;Europe;11756;187;2666347;194887
2020-07-20;;Europe;18002;231;2684349;195118
2020-07-21;;Europe;14377;341;2698726;195459
2020-07-22;;Europe;15955;349;2714681;195808
2020-07-23;;Europe;17553;325;2732234;196133
2020-07-24;;Europe;17611;359;2749845;196492
2020-07-25;;Europe;13706;263;2763551;196755
2020-07-26;;Europe;13048;197;2776599;196952
2020-07-27;;Europe;21619;210;2798218;197162
2020-07-28;;Europe;15309;328;2813527;197490
2020-07-29;;Europe;18376;401;2831903;197891
2020-07-30;;Europe;19834;324;2851737;198215
2020-07-31;;Europe;19769;363;2871506;198578
2020-08-01;;Europe;14374;235;2885880;198813
2020-08-02;;Europe;12893;203;2898773;199016
2020-08-03;;Europe;24974;263;2923747;199279
2020-08-04;;Europe;20538;360;2944285;199639
2020-08-05;;Europe;20348;381;2964633;200020
2020-08-06;;Europe;21947;327;2986580;200347
2020-08-07;;Europe;23706;314;3010286;200661
2020-08-08;;Europe;15131;292;3025417;200953
2020-08-09;;Europe;13794;203;3039211;201156
2020-08-10;;Europe;27638;336;3066849;201492
2020-08-11;;Europe;19712;332;3086561;201824
2020-08-12;;Europe;23410;348;3109971;202172
2020-08-13;;Europe;27407;365;3137378;202537
2020-08-14;;Europe;27042;331;3164420;202868
2020-08-15;;Europe;19816;448;3184236;203316
2020-08-16;;Europe;17038;199;3201274;203515
2020-08-17;;Europe;30735;256;3232009;203771
2020-08-18;;Europe;22917;356;3254926;204127
2020-08-19;;Europe;28057;463;3282983;204590
2020-08-20;;Europe;30270;345;3313253;204935
2020-08-21;;Europe;32196;320;3345449;205255
2020-08-22;;Europe;21417;306;3366866;205561
2020-08-23;;Europe;19965;207;3386831;205768
2020-08-24;;Europe;36913;277;3423744;206045
2020-08-25;;Europe;27052;404;3450796;206449
2020-08-26;;Europe;26211;260;3477007;206709
2020-08-27;;Europe;39843;380;3516850;207089
2020-08-28;;Europe;35272;331;3552122;207420
2020-08-29;;Europe;23722;285;3575844;207705
2020-08-30;;Europe;21873;205;3597717;207910
2020-08-31;;Europe;43032;357;3640749;208267
2020-09-01;;Europe;29786;431;3670535;208698
2020-09-02;;Europe;35668;404;3706203;209102
2020-09-03;;Europe;36956;392;3743159;209494
2020-09-04;;Europe;41511;477;3784670;209971
2020-09-05;;Europe;29601;335;3814271;210306
2020-09-06;;Europe;26454;207;3840725;210513
2020-09-07;;Europe;50999;327;3891724;210840
2020-09-08;;Europe;37236;472;3928960;211312
2020-09-09;;Europe;41150;416;3970110;211728
2020-09-10;;Europe;45726;410;4015836;212138
2020-09-11;;Europe;49067;417;4064903;212555
2020-09-12;;Europe;37884;331;4102787;212886
2020-09-13;;Europe;29457;255;4132244;213141
2020-09-14;;Europe;55849;370;4188093;213511
2020-09-15;;Europe;43770;633;4231863;214144
2020-09-16;;Europe;50943;706;4282806;214850
2020-09-17;;Europe;55124;607;4337930;215457
2020-09-18;;Europe;60955;661;4398885;216118
2020-09-19;;Europe;44644;399;4443529;216517
2020-09-20;;Europe;38697;288;4482226;216805
2020-09-21;;Europe;65880;471;4548106;217276
2020-09-22;;Europe;53719;777;4601825;218053
2020-09-23;;Europe;61057;685;4662882;218738
2020-09-24;;Europe;65364;592;4728246;219330
2020-09-25;;Europe;70009;688;4798255;220018
2020-09-26;;Europe;51836;567;4850091;220585
2020-09-27;;Europe;44788;345;4894879;220930
2020-09-28;;Europe;68658;551;4963537;221481
2020-09-29;;Europe;48426;626;5011963;222107
2020-09-30;;Europe;79394;1014;5091357;223121
2020-10-01;;Europe;70380;753;5161737;223874
2020-10-02;;Europe;76597;824;5238334;224698
2020-10-03;;Europe;71241;577;5309575;225275
2020-10-04;;Europe;73537;437;5383112;225712
2020-10-05;;Europe;84008;638;5467120;226350
2020-10-06;;Europe;84522;1077;5551642;227427
2020-10-07;;Europe;98691;904;5650333;228331
2020-10-08;;Europe;111313;890;5761646;229221
2020-10-09;;Europe;117936;1050;5879582;230271
2020-10-10;;Europe;109790;766;5989372;231037
2020-10-11;;Europe;87486;623;6076858;231660
2020-10-12;;Europe;114751;885;6191609;232545
2020-10-13;;Europe;112474;1172;6304083;233717
2020-10-14;;Europe;142979;1347;6447062;235064
2020-10-15;;Europe;156681;1285;6603743;236349
2020-10-16;;Europe;157579;1435;6761322;237784
2020-10-17;;Europe;144083;1097;6905405;238881
2020-10-18;;Europe;132439;875;7037844;239756
2020-10-19;;Europe;165195;1232;7203039;240988
2020-10-20;;Europe;160854;1811;7363893;242799
2020-10-21;;Europe;200851;1658;7564744;244457
2020-10-22;;Europe;215582;1789;7780326;246246
2020-10-23;;Europe;235023;1979;8015349;248225
2020-10-24;;Europe;205265;1666;8220614;249891
2020-10-25;;Europe;153619;1179;8374233;251070
2020-10-26;;Europe;284162;1918;8658395;252988
2020-10-27;;Europe;230574;2790;8888969;255778
2020-10-28;;Europe;257346;2517;9146315;258295
2020-10-29;;Europe;284779;2584;9431094;260879
2020-10-30;;Europe;300422;3033;9731516;263912
2020-10-31;;Europe;230761;2513;9962277;266425
2020-11-01;;Europe;218248;1874;10180525;268299
2020-11-02;;Europe;346447;2660;10526972;270959
2020-11-03;;Europe;277004;4344;10803976;275303
2020-11-04;;Europe;228055;4918;11032031;280221
2020-11-05;;Europe;316195;3677;11348226;283898
2020-11-06;;Europe;321684;4353;11669910;288251
2020-11-07;;Europe;300505;3247;11970415;291498
2020-11-08;;Europe;219776;2340;12190191;293838
2020-11-09;;Europe;244016;3435;12434207;297273
2020-11-10;;Europe;250057;5227;12684264;302500
2020-11-11;;Europe;297048;5082;12981312;307582
2020-11-12;;Europe;294647;4407;13275959;311989
2020-11-13;;Europe;286273;4781;13562232;316770
2020-11-14;;Europe;242484;3750;13804716;320520
2020-11-15;;Europe;200180;2883;14004896;323403
2020-11-16;;Europe;235329;4053;14240225;327456
2020-11-17;;Europe;274154;5772;14514379;333228
2020-11-18;;Europe;263038;5297;14777417;338525
2020-11-19;;Europe;269793;4850;15047210;343375
2020-11-20;;Europe;267486;5774;15314696;349149
2020-11-21;;Europe;220331;3910;15535027;353059
2020-11-22;;Europe;172686;3198;15707713;356257
2020-11-23;;Europe;192805;4342;15900518;360599
2020-11-24;;Europe;225676;6229;16126194;366828
2020-11-25;;Europe;237824;5537;16364018;372365
2020-11-26;;Europe;237801;5415;16601819;377780
2020-11-27;;Europe;233413;5887;16835232;383667
2020-11-28;;Europe;193566;4254;17028798;387921
2020-11-29;;Europe;150866;3145;17179664;391066
2020-11-30;;Europe;164564;4316;17344228;395382
2020-12-01;;Europe;200694;6007;17544922;401389
2020-12-02;;Europe;210696;5619;17755618;407008
2020-12-03;;Europe;224458;5489;17980076;412497
2020-12-04;;Europe;214924;5652;18195000;418149
2020-12-05;;Europe;200056;4184;18395056;422333
2020-12-06;;Europe;162418;3165;18557474;425498
2020-12-07;;Europe;151955;3970;18709429;429468
2020-12-08;;Europe;198981;5452;18908410;434920
2020-12-09;;Europe;212636;5270;19121046;440190
2020-12-10;;Europe;238058;5470;19359104;445660
2020-12-11;;Europe;231133;5713;19590237;451373
2020-12-12;;Europe;201934;4370;19792171;455743
2020-12-13;;Europe;169487;3108;19961658;458851
2020-12-14;;Europe;158835;4083;20120493;462934
2020-12-15;;Europe;213495;6307;20333988;469241
2020-12-16;;Europe;241622;5950;20575610;475191
2020-12-17;;Europe;254399;5458;20830009;480649
2020-12-18;;Europe;244541;5713;21074550;486362
2020-12-19;;Europe;202237;4329;21276787;490691
2020-12-20;;Europe;169971;2984;21446758;493675
2020-12-21;;Europe;187077;4161;21633835;497836
2020-12-22;;Europe;236518;6147;21870353;503983
2020-12-23;;Europe;248010;5708;22118363;509691
2020-12-24;;Europe;249867;4540;22368230;514231
2020-12-25;;Europe;180519;3511;22548749;517742
2020-12-26;;Europe;139750;2759;22688499;520501
2020-12-27;;Europe;135410;2833;22823909;523334
2020-12-28;;Europe;172625;4195;22996534;527529
2020-12-29;;Europe;244659;6406;23241193;533935
2020-12-30;;Europe;296006;6392;23537199;540327
2020-12-31;;Europe;269948;5160;23807147;545487
2021-01-01;;Europe;209555;3769;24016702;549256
2021-01-02;;Europe;159491;2796;24176193;552052
2021-01-03;;Europe;168042;2914;24344235;554966
2021-01-04;;Europe;203764;4328;24547999;559294
2021-01-05;;Europe;275691;6599;24823690;565893
2021-01-06;;Europe;269592;5542;25093282;571435
2021-01-07;;Europe;320755;5624;25414037;577059
2021-01-08;;Europe;274846;6125;25688883;583184
2021-01-09;;Europe;227717;4327;25916600;587511
2021-01-10;;Europe;182934;3134;26099534;590645
2021-01-11;;Europe;212771;4278;26312305;594923
2021-01-12;;Europe;237197;6716;26549502;601639
2021-01-13;;Europe;262816;6646;26812318;608285
2021-01-14;;Europe;257236;6057;27069554;614342
2021-01-15;;Europe;245856;5669;27315410;620011
2021-01-16;;Europe;185204;4944;27500614;624955
2021-01-17;;Europe;155921;3221;27656535;628176
2021-01-18;;Europe;209320;3878;27865855;632054
2021-01-19;;Europe;202598;7554;28068453;639608
2021-01-20;;Europe;248228;7161;28316681;646769
2021-01-21;;Europe;225089;6098;28541770;652867
2021-01-22;;Europe;230014;6243;28771784;659110
2021-01-23;;Europe;169427;4464;28941211;663574
2021-01-24;;Europe;139630;3144;29080841;666718
2021-01-25;;Europe;194468;4594;29275309;671312
2021-01-26;;Europe;179078;6549;29454387;677861
2021-01-27;;Europe;216411;6535;29670798;684396
2021-01-28;;Europe;210481;6421;29881279;690817
2021-01-29;;Europe;203998;5704;30085277;696521
2021-01-30;;Europe;155901;4788;30241178;701309
2021-01-31;;Europe;115693;2669;30356871;703978
2021-02-01;;Europe;170705;4497;30527576;708475
2021-02-02;;Europe;159485;6755;30687061;715230
2021-02-03;;Europe;186316;5976;30873377;721206
2021-02-04;;Europe;159317;4959;31032694;726165
2021-02-05;;Europe;196844;5929;31229538;732094
2021-02-06;;Europe;130722;3567;31360260;735661
2021-02-07;;Europe;109040;2383;31469300;738044
2021-02-08;;Europe;125972;3936;31595272;741980
2021-02-09;;Europe;129190;5994;31724462;747974
2021-02-10;;Europe;156265;5234;31880727;753208
2021-02-11;;Europe;154852;4713;32035579;757921
2021-02-12;;Europe;148303;4716;32183882;762637
2021-02-13;;Europe;121070;3145;32304952;765782
2021-02-14;;Europe;93956;2014;32398908;767796
2021-02-15;;Europe;102066;3013;32500974;770809
2021-02-16;;Europe;123071;4708;32624045;775517
2021-02-17;;Europe;148007;4685;32772052;780202
2021-02-18;;Europe;154514;3887;32926566;784089
2021-02-19;;Europe;155066;4128;33081632;788217
2021-02-20;;Europe;128859;2621;33210491;790838
2021-02-21;;Europe;111977;1836;33322468;792674
2021-02-22;;Europe;103446;2857;33425914;795531
2021-02-23;;Europe;134703;4146;33560617;799677
2021-02-24;;Europe;171962;3741;33732579;803418
2021-02-25;;Europe;170099;3149;33902678;806567
2021-02-26;;Europe;165531;3843;34068209;810410
2021-02-27;;Europe;145522;2608;34213731;813018
2021-02-28;;Europe;118228;1792;34331959;814810
2021-03-01;;Europe;101692;2750;34433651;817560
2021-03-02;;Europe;68329;3725;34501980;821285
2021-03-03;;Europe;175427;4021;34677407;825306
2021-03-04;;Europe;175445;3341;34852852;828647
2021-03-05;;Europe;175256;3784;35028108;832431
2021-03-06;;Europe;155384;2454;35183492;834885
2021-03-07;;Europe;128502;1765;35311994;836650
2021-03-08;;Europe;101514;2786;35413508;839436
2021-03-09;;Europe;151742;3476;35565250;842912
2021-03-10;;Europe;194070;3599;35759320;846511
2021-03-11;;Europe;185777;3433;35945097;849944
2021-03-12;;Europe;191773;3370;36136870;853314
2021-03-13;;Europe;183640;2627;36320510;855941
2021-03-14;;Europe;147095;2041;36467605;857982
2021-03-15;;Europe;122172;2910;36589777;860892
2021-03-16;;Europe;186319;3689;36776096;864581
2021-03-17;;Europe;207595;3382;36983691;867963
2021-03-18;;Europe;231578;3603;37215269;871566
2021-03-19;;Europe;215710;3364;37430979;874930
2021-03-20;;Europe;194385;2725;37625364;877655
2021-03-21;;Europe;161266;2039;37786630;879694
2021-03-22;;Europe;152047;3337;37938677;883031
2021-03-23;;Europe;179728;3965;38118405;886996
2021-03-24;;Europe;256192;3699;38374597;890695
2021-03-25;;Europe;252982;4092;38627579;894787
2021-03-26;;Europe;239119;4516;38866698;899303
2021-03-27;;Europe;218498;2896;39085196;902199
2021-03-28;;Europe;163075;2062;39248271;904261
2021-03-29;;Europe;139257;2962;39387528;907223
2021-03-30;;Europe;204845;3971;39592373;911194
2021-03-31;;Europe;255985;4041;39848358;915235
2021-04-01;;Europe;251149;3880;40099507;919115
2021-04-02;;Europe;216832;3620;40316339;922735
2021-04-03;;Europe;153012;3012;40469351;925747
2021-04-04;;Europe;199224;2487;40668575;928234
2021-04-05;;Europe;107614;2628;40776189;930862
2021-04-06;;Europe;131033;3118;40907222;933980
2021-04-07;;Europe;162184;4467;41069406;938447
2021-04-08;;Europe;282881;4868;41352287;943315
2021-04-09;;Europe;175476;4158;41527763;947473
2021-04-10;;Europe;145711;3082;41673474;950555
2021-04-11;;Europe;221257;2851;41894731;953406
2021-04-12;;Europe;127172;3198;42021903;956604
2021-04-13;;Europe;193193;4061;42215096;960665
2021-04-14;;Europe;212385;4327;42427481;964992
2021-04-15;;Europe;201003;3853;42628484;968845
2021-04-16;;Europe;194718;3782;42823202;972627
2021-04-17;;Europe;158080;2975;42981282;975602
2021-04-18;;Europe;112683;2177;43093965;977779
2021-04-19;;Europe;110364;3107;43204329;980886
2021-04-20;;Europe;177235;3771;43381564;984657
2021-04-21;;Europe;186878;3963;43568442;988620
2021-04-22;;Europe;189894;3638;43758336;992258
2021-04-23;;Europe;171796;3641;43930132;995899
2021-04-24;;Europe;133725;2862;44063857;998761
2021-04-25;;Europe;109116;1929;44172973;1000690
2021-04-26;;Europe;90912;2816;44263885;1003506
2021-04-27;;Europe;149875;3517;44413760;1007023
2021-04-28;;Europe;161802;3508;44575562;1010531
2021-04-29;;Europe;155986;3282;44731548;1013813
2021-04-30;;Europe;131930;2937;44863478;1016750
2021-05-01;;Europe;114638;2434;44978116;1019184
2021-05-02;;Europe;69658;1527;45047774;1020711
2021-05-03;;Europe;74865;2180;45122639;1022891
2021-05-04;;Europe;121559;2478;45244198;1025369
2021-05-05;;Europe;125074;2825;45369272;1028194
2021-05-06;;Europe;126528;2937;45495800;1031131
2021-05-07;;Europe;118314;2740;45614114;1033871
2021-05-08;;Europe;96615;2256;45710729;1036127
2021-05-09;;Europe;59796;1480;45770525;1037607
2021-05-10;;Europe;69099;2006;45839624;1039613
2021-05-11;;Europe;108217;2477;45947841;1042090
2021-05-12;;Europe;98176;2334;46046017;1044424
2021-05-13;;Europe;93044;2413;46139061;1046837
2021-05-14;;Europe;89157;2158;46228218;1048995
2021-05-15;;Europe;71100;1730;46299318;1050725
2021-05-16;;Europe;60558;1175;46359876;1051900
2021-05-17;;Europe;53702;1587;46413578;1053487
2021-05-18;;Europe;76862;2185;46490440;1055672
2021-05-19;;Europe;90112;2020;46580552;1057692
2021-05-20;;Europe;67487;1848;46299372;1059540
2021-05-21;;Europe;72861;1695;46372233;1061235
2021-05-22;;Europe;59290;1392;46431523;1062627
2021-05-23;;Europe;46092;960;46477615;1063587
2021-05-24;;Europe;41240;1022;46518855;1064609
2021-05-25;;Europe;50746;1980;46569601;1066589
2021-05-26;;Europe;61391;1807;46630992;1068396
2021-05-27;;Europe;66718;1554;46697710;1069950
2021-05-28;;Europe;61884;1431;46759594;1071381
2021-05-29;;Europe;49789;1143;46809383;1072524
2021-05-30;;Europe;40702;792;46850085;1073316
2021-05-31;;Europe;37598;1109;46887683;1074425
2021-06-01;;Europe;48049;1359;46935732;1075784
2021-06-02;;Europe;44233;1273;46979965;1077057
2021-06-03;;Europe;65430;1294;47045395;1078351
2021-06-04;;Europe;48340;1296;47093735;1079647
2021-06-05;;Europe;38409;1008;47132144;1080655
2021-06-06;;Europe;32749;721;47164893;1081376
2021-06-07;;Europe;36634;928;47201527;1082304
2021-06-08;;Europe;43182;1490;47244709;1083794
2021-06-09;;Europe;46288;1228;47290997;1085022
2021-06-10;;Europe;54820;1259;47345817;1086281
2021-06-11;;Europe;43049;1126;47388866;1087407
2021-06-12;;Europe;36832;842;47425698;1088249
2021-06-13;;Europe;33875;563;47459573;1088812
2021-06-14;;Europe;38020;759;47497593;1089571
2021-06-15;;Europe;39728;1105;47537321;1090676
2021-06-16;;Europe;40673;1081;47577994;1091757
2021-06-17;;Europe;41741;986;47619735;1092743
2021-06-18;;Europe;43979;986;47663714;1093729
2021-06-19;;Europe;39480;806;47703194;1094535
2021-06-20;;Europe;34791;595;47737985;1095130
2021-06-21;;Europe;41270;816;47779255;1095946
2021-06-22;;Europe;44653;1010;47823908;1096956
2021-06-23;;Europe;50674;1086;47874582;1098042
2021-06-24;;Europe;52402;1043;47926984;1099085
2021-06-25;;Europe;51121;1105;47978105;1100190
2021-06-26;;Europe;49299;1066;48027404;1101256
2021-06-27;;Europe;42642;787;48070046;1102043
2021-06-28;;Europe;61480;898;48131526;1102941
2021-06-29;;Europe;60736;1273;48192262;1104214
2021-06-30;;Europe;68084;1153;48260346;1105367
2021-07-01;;Europe;78350;1036;48338696;1106403
2020-01-23;;European Union;0;0;0;0
2020-01-24;;European Union;2;0;2;0
2020-01-25;;European Union;1;0;3;0
2020-01-26;;European Union;0;0;3;0
2020-01-27;;European Union;1;0;4;0
2020-01-28;;European Union;4;0;8;0
2020-01-29;;European Union;2;0;10;0
2020-01-30;;European Union;0;0;10;0
2020-01-31;;European Union;3;0;13;0
2020-02-01;;European Union;6;0;19;0
2020-02-02;;European Union;2;0;21;0
2020-02-03;;European Union;2;0;23;0
2020-02-04;;European Union;1;0;24;0
2020-02-05;;European Union;0;0;24;0
2020-02-06;;European Union;0;0;24;0
2020-02-07;;European Union;2;0;26;0
2020-02-08;;European Union;5;0;31;0
2020-02-09;;European Union;2;0;33;0
2020-02-10;;European Union;0;0;33;0
2020-02-11;;European Union;2;0;35;0
2020-02-12;;European Union;0;0;35;0
2020-02-13;;European Union;0;0;35;0
2020-02-14;;European Union;0;0;35;0
2020-02-15;;European Union;1;1;36;1
2020-02-16;;European Union;0;0;36;1
2020-02-17;;European Union;0;0;36;1
2020-02-18;;European Union;0;0;36;1
2020-02-19;;European Union;0;0;36;1
2020-02-20;;European Union;0;0;36;1
2020-02-21;;European Union;17;1;53;2
2020-02-22;;European Union;42;1;95;3
2020-02-23;;European Union;93;1;188;4
2020-02-24;;European Union;74;4;262;8
2020-02-25;;European Union;103;3;365;11
2020-02-26;;European Union;158;3;523;14
2020-02-27;;European Union;250;5;773;19
2020-02-28;;European Union;284;4;1057;23
2020-02-29;;European Union;348;8;1405;31
2020-03-01;;European Union;707;5;2112;36
2020-03-02;;European Union;494;19;2606;55
2020-03-03;;European Union;604;29;3210;84
2020-03-04;;European Union;870;29;4080;113
2020-03-05;;European Union;1312;45;5392;158
2020-03-06;;European Union;1550;54;6942;212
2020-03-07;;European Union;2000;48;8942;260
2020-03-08;;European Union;2365;145;11307;405
2020-03-09;;European Union;2919;116;14226;521
2020-03-10;;European Union;2768;185;16994;706
2020-03-11;;European Union;4654;238;21648;944
2020-03-12;;European Union;3276;193;24924;1137
2020-03-13;;European Union;10172;370;35096;1507
2020-03-14;;European Union;7411;264;42507;1771
2020-03-15;;European Union;7360;477;49867;2248
2020-03-16;;European Union;10177;476;60044;2724
2020-03-17;;European Union;10001;577;70045;3301
2020-03-18;;European Union;12471;598;82516;3899
2020-03-19;;European Union;16836;791;99352;4690
2020-03-20;;European Union;17491;1132;116843;5822
2020-03-21;;European Union;18717;1350;135560;7172
2020-03-22;;European Union;17350;1256;152910;8428
2020-03-23;;European Union;22263;1459;175173;9887
2020-03-24;;European Union;20345;1676;195518;11563
2020-03-25;;European Union;26529;2006;222047;13569
2020-03-26;;European Union;31125;2082;253172;15651
2020-03-27;;European Union;30603;2340;283775;17991
2020-03-28;;European Union;31861;2429;315636;20420
2020-03-29;;European Union;25311;2314;340947;22734
2020-03-30;;European Union;26354;2584;367301;25318
2020-03-31;;European Union;30412;2750;397713;28068
2020-04-01;;European Union;29750;3494;427463;31562
2020-04-02;;European Union;28375;3071;455838;34633
2020-04-03;;European Union;30245;3411;486083;38044
2020-04-04;;European Union;5976;2857;492059;40901
2020-04-05;;European Union;20557;2327;512616;43228
2020-04-06;;European Union;19676;2890;532292;46118
2020-04-07;;European Union;15528;3877;547820;49995
2020-04-08;;European Union;25857;2814;573677;52809
2020-04-09;;European Union;24882;3581;598559;56390
2020-04-10;;European Union;23224;3188;621783;59578
2020-04-11;;European Union;20117;2411;641900;61989
2020-04-12;;European Union;67687;2414;709587;64403
2020-04-13;;European Union;16719;2421;726306;66824
2020-04-14;;European Union;28757;2426;755063;69250
2020-04-15;;European Union;21417;4002;776480;73252
2020-04-16;;European Union;33026;3035;809506;76287
2020-04-17;;European Union;20913;3029;830419;79316
2020-04-18;;European Union;15883;1976;846302;81292
2020-04-19;;European Union;18387;1876;864689;83168
2020-04-20;;European Union;12984;2135;877673;85303
2020-04-21;;European Union;15549;2404;893222;87707
2020-04-22;;European Union;16915;2423;910137;90130
2020-04-23;;European Union;13550;2336;923687;92466
2020-04-24;;European Union;3349;2176;927036;94642
2020-04-25;;European Union;12813;1857;939849;96499
2020-04-26;;European Union;10185;1253;950034;97752
2020-04-27;;European Union;11444;1615;961478;99367
2020-04-28;;European Union;10929;1684;972407;101051
2020-04-29;;European Union;8150;1945;980557;102996
2020-04-30;;European Union;8896;1451;989453;104447
2020-05-01;;European Union;8524;1005;997977;105452
2020-05-02;;European Union;7227;1608;1005204;107060
2020-05-03;;European Union;5884;796;1011088;107856
2020-05-04;;European Union;5428;1118;1016516;108974
2020-05-05;;European Union;7209;1137;1023725;110111
2020-05-06;;European Union;10884;1744;1034609;111855
2020-05-07;;European Union;8317;1171;1042926;113026
2020-05-08;;European Union;7825;1270;1050751;114296
2020-05-09;;European Union;5903;753;1056654;115049
2020-05-10;;European Union;4795;581;1061449;115630
2020-05-11;;European Union;6885;829;1068334;116459
2020-05-12;;European Union;6100;1040;1074434;117499
2020-05-13;;European Union;5358;985;1079792;118484
2020-05-14;;European Union;5800;1090;1085592;119574
2020-05-15;;European Union;5362;808;1090954;120382
2020-05-16;;European Union;4498;582;1095452;120964
2020-05-17;;European Union;3166;781;1098618;121745
2020-05-18;;European Union;3915;537;1102533;122282
2020-05-19;;European Union;5094;269;1107627;122551
2020-05-20;;European Union;4889;677;1112516;123228
2020-05-21;;European Union;4329;520;1116845;123748
2020-05-22;;European Union;6199;1144;1123044;124892
2020-05-23;;European Union;3993;465;1127037;125357
2020-05-24;;European Union;2637;171;1129674;125528
2020-05-25;;European Union;2392;-1583;1132066;123945
2020-05-26;;European Union;4143;773;1136209;124718
2020-05-27;;European Union;3390;376;1139599;125094
2020-05-28;;European Union;8621;360;1148220;125454
2020-05-29;;European Union;4815;389;1153035;125843
2020-05-30;;European Union;4933;343;1157968;126186
2020-05-31;;European Union;2568;174;1160536;126360
2020-06-01;;European Union;2758;180;1163294;126540
2020-06-02;;European Union;2109;326;1165403;126866
2020-06-03;;European Union;6;345;1165409;127211
2020-06-04;;European Union;7729;266;1173138;127477
2020-06-05;;European Union;4601;333;1177739;127810
2020-06-06;;European Union;4323;202;1182062;128012
2020-06-07;;European Union;3244;125;1185306;128137
2020-06-08;;European Union;3294;220;1188600;128357
2020-06-09;;European Union;3890;315;1192490;128672
2020-06-10;;European Union;3986;249;1196476;128921
2020-06-11;;European Union;4125;164;1200601;129085
2020-06-12;;European Union;4889;187;1205490;129272
2020-06-13;;European Union;3881;185;1209371;129457
2020-06-14;;European Union;3102;108;1212473;129565
2020-06-15;;European Union;2811;126;1215284;129691
2020-06-16;;European Union;4328;259;1219612;129950
2020-06-17;;European Union;4681;264;1224293;130214
2020-06-18;;European Union;5879;212;1230172;130426
2020-06-19;;European Union;4260;1304;1234432;131730
2020-06-20;;European Union;3778;131;1238210;131861
2020-06-21;;European Union;2998;58;1241208;131919
2020-06-22;;European Union;3097;85;1244305;132004
2020-06-23;;European Union;4685;269;1248990;132273
2020-06-24;;European Union;4859;111;1253849;132384
2020-06-25;;European Union;4504;140;1258353;132524
2020-06-26;;European Union;5653;198;1264006;132722
2020-06-27;;European Union;4169;47;1268175;132769
2020-06-28;;European Union;2397;63;1270572;132832
2020-06-29;;European Union;3568;96;1274140;132928
2020-06-30;;European Union;3567;206;1277707;133134
2020-07-01;;European Union;4464;140;1282171;133274
2020-07-02;;European Union;4274;160;1286445;133434
2020-07-03;;European Union;4252;129;1290697;133563
2020-07-04;;European Union;3340;81;1294037;133644
2020-07-05;;European Union;2484;46;1296521;133690
2020-07-06;;European Union;4556;79;1301077;133769
2020-07-07;;European Union;3046;142;1304123;133911
2020-07-08;;European Union;4384;140;1308507;134051
2020-07-09;;European Union;4170;117;1312677;134168
2020-07-10;;European Union;4820;110;1317497;134278
2020-07-11;;European Union;3623;62;1321120;134340
2020-07-12;;European Union;2494;37;1323614;134377
2020-07-13;;European Union;5669;77;1329283;134454
2020-07-14;;European Union;3409;107;1332692;134561
2020-07-15;;European Union;4805;179;1337497;134740
2020-07-16;;European Union;5823;115;1343320;134855
2020-07-17;;European Union;6187;100;1349507;134955
2020-07-18;;European Union;3631;52;1353138;135007
2020-07-19;;European Union;2744;35;1355882;135042
2020-07-20;;European Union;9702;75;1365584;135117
2020-07-21;;European Union;5523;96;1371107;135213
2020-07-22;;European Union;6729;105;1377836;135318
2020-07-23;;European Union;8183;106;1386019;135424
2020-07-24;;European Union;8095;103;1394114;135527
2020-07-25;;European Union;4768;51;1398882;135578
2020-07-26;;European Union;3729;62;1402611;135640
2020-07-27;;European Union;12397;48;1415008;135688
2020-07-28;;European Union;6644;107;1421652;135795
2020-07-29;;European Union;8975;126;1430627;135921
2020-07-30;;European Union;10365;111;1440992;136032
2020-07-31;;European Union;10253;104;1451245;136136
2020-08-01;;European Union;5316;66;1456561;136202
2020-08-02;;European Union;3747;61;1460308;136263
2020-08-03;;European Union;16384;121;1476692;136384
2020-08-04;;European Union;11892;118;1488584;136502
2020-08-05;;European Union;11124;139;1499708;136641
2020-08-06;;European Union;12555;110;1512263;136751
2020-08-07;;European Union;14254;117;1526517;136868
2020-08-08;;European Union;6044;97;1532561;136965
2020-08-09;;European Union;5093;64;1537654;137029
2020-08-10;;European Union;18801;160;1556455;137189
2020-08-11;;European Union;10805;97;1567260;137286
2020-08-12;;European Union;13885;140;1581145;137426
2020-08-13;;European Union;17805;158;1598950;137584
2020-08-14;;European Union;16835;141;1615785;137725
2020-08-15;;European Union;10158;254;1625943;137979
2020-08-16;;European Union;7950;69;1633893;138048
2020-08-17;;European Union;22375;127;1656268;138175
2020-08-18;;European Union;13856;156;1670124;138331
2020-08-19;;European Union;18319;258;1688443;138589
2020-08-20;;European Union;20191;139;1708634;138728
2020-08-21;;European Union;22021;160;1730655;138888
2020-08-22;;European Union;10747;88;1741402;138976
2020-08-23;;European Union;10644;71;1752046;139047
2020-08-24;;European Union;27851;138;1779897;139185
2020-08-25;;European Union;17727;183;1797624;139368
2020-08-26;;European Union;16440;52;1814064;139420
2020-08-27;;European Union;29572;155;1843636;139575
2020-08-28;;European Union;24860;129;1868496;139704
2020-08-29;;European Union;13295;83;1881791;139787
2020-08-30;;European Union;11610;67;1893401;139854
2020-08-31;;European Union;33225;201;1926626;140055
2020-09-01;;European Union;20126;204;1946752;140259
2020-09-02;;European Union;24572;186;1971324;140445
2020-09-03;;European Union;25617;166;1996941;140611
2020-09-04;;European Union;29545;260;2026486;140871
2020-09-05;;European Union;17616;112;2044102;140983
2020-09-06;;European Union;14459;83;2058561;141066
2020-09-07;;European Union;39364;200;2097925;141266
2020-09-08;;European Union;25297;219;2123222;141485
2020-09-09;;European Union;28377;187;2151599;141672
2020-09-10;;European Union;32748;188;2184347;141860
2020-09-11;;European Union;34592;221;2218939;142081
2020-09-12;;European Union;23628;104;2242567;142185
2020-09-13;;European Union;16224;90;2258791;142275
2020-09-14;;European Union;43710;233;2302501;142508
2020-09-15;;European Union;30212;345;2332713;142853
2020-09-16;;European Union;35791;417;2368504;143270
2020-09-17;;European Union;39774;333;2408278;143603
2020-09-18;;European Union;44975;382;2453253;143985
2020-09-19;;European Union;28877;140;2482130;144125
2020-09-20;;European Union;23780;128;2505910;144253
2020-09-21;;European Union;50187;324;2556097;144577
2020-09-22;;European Union;37492;468;2593589;145045
2020-09-23;;European Union;42130;383;2635719;145428
2020-09-24;;European Union;46217;315;2681936;145743
2020-09-25;;European Union;49807;434;2731743;146177
2020-09-26;;European Union;32270;246;2764013;146423
2020-09-27;;European Union;26727;149;2790740;146572
2020-09-28;;European Union;51632;394;2842372;146966
2020-09-29;;European Union;27158;278;2869530;147244
2020-09-30;;European Union;56856;659;2926386;147903
2020-10-01;;European Union;47345;425;2973731;148328
2020-10-02;;European Union;51986;469;3025717;148797
2020-10-03;;European Union;41593;231;3067310;149028
2020-10-04;;European Union;34071;218;3101381;149246
2020-10-05;;European Union;52914;423;3154295;149669
2020-10-06;;European Union;50772;665;3205067;150334
2020-10-07;;European Union;64350;512;3269417;150846
2020-10-08;;European Union;72405;484;3341822;151330
2020-10-09;;European Union;81277;620;3423099;151950
2020-10-10;;European Union;73418;347;3496517;152297
2020-10-11;;European Union;53392;297;3549909;152594
2020-10-12;;European Union;76393;605;3626302;153199
2020-10-13;;European Union;72269;624;3698571;153823
2020-10-14;;European Union;96730;801;3795301;154624
2020-10-15;;European Union;112837;729;3908138;155353
2020-10-16;;European Union;113483;900;4021621;156253
2020-10-17;;European Union;102801;514;4124422;156767
2020-10-18;;European Union;92208;489;4216630;157256
2020-10-19;;European Union;114118;839;4330748;158095
2020-10-20;;European Union;111118;1122;4441866;159217
2020-10-21;;European Union;141443;1063;4583309;160280
2020-10-22;;European Union;161453;1131;4744762;161411
2020-10-23;;European Union;177932;1277;4922694;162688
2020-10-24;;European Union;153647;993;5076341;163681
2020-10-25;;European Union;106554;630;5182895;164311
2020-10-26;;European Union;219318;1433;5402213;165744
2020-10-27;;European Union;172706;1873;5574919;167617
2020-10-28;;European Union;192818;1583;5767737;169200
2020-10-29;;European Union;219879;1704;5987616;170904
2020-10-30;;European Union;232231;2075;6219847;172979
2020-10-31;;European Union;174306;1601;6394153;174580
2020-11-01;;European Union;161993;1257;6556146;175837
2020-11-02;;European Union;274748;2031;6830894;177868
2020-11-03;;European Union;214518;3244;7045412;181112
2020-11-04;;European Union;153455;3652;7198867;184764
2020-11-05;;European Union;242611;2637;7441478;187401
2020-11-06;;European Union;248930;3222;7690408;190623
2020-11-07;;European Union;235004;2163;7925412;192786
2020-11-08;;European Union;161812;1668;8087224;194454
2020-11-09;;European Union;166738;2555;8253962;197009
2020-11-10;;European Union;182755;3891;8436717;200900
2020-11-11;;European Union;223937;3596;8660654;204496
2020-11-12;;European Union;210107;2955;8870761;207451
2020-11-13;;European Union;207110;3562;9077871;211013
2020-11-14;;European Union;169772;2546;9247643;213559
2020-11-15;;European Union;132080;2112;9379723;215671
2020-11-16;;European Union;160516;3081;9540239;218752
2020-11-17;;European Union;202552;4273;9742791;223025
2020-11-18;;European Union;188615;3787;9931406;226812
2020-11-19;;European Union;190680;3333;10122086;230145
2020-11-20;;European Union;188842;4271;10310928;234416
2020-11-21;;European Union;147381;2695;10458309;237111
2020-11-22;;European Union;105584;2095;10563893;239206
2020-11-23;;European Union;120961;3273;10684854;242479
2020-11-24;;European Union;159208;4683;10844062;247162
2020-11-25;;European Union;160903;3849;11004965;251011
2020-11-26;;European Union;159387;3856;11164352;254867
2020-11-27;;European Union;155061;4393;11319413;259260
2020-11-28;;European Union;119298;2831;11438711;262091
2020-11-29;;European Union;86246;2119;11524957;264210
2020-11-30;;European Union;96108;3256;11621065;267466
2020-12-01;;European Union;128668;4309;11749733;271775
2020-12-02;;European Union;135914;3909;11885647;275684
2020-12-03;;European Union;146760;3970;12032407;279654
2020-12-04;;European Union;136310;4024;12168717;283678
2020-12-05;;European Union;125506;2767;12294223;286445
2020-12-06;;European Union;92531;2111;12386754;288556
2020-12-07;;European Union;78332;2818;12465086;291374
2020-12-08;;European Union;129624;3775;12594710;295149
2020-12-09;;European Union;136679;3552;12731389;298701
2020-12-10;;European Union;154819;3795;12886208;302496
2020-12-11;;European Union;147616;4091;13033824;306587
2020-12-12;;European Union;126292;2816;13160116;309403
2020-12-13;;European Union;102500;2127;13262616;311530
2020-12-14;;European Union;84070;2945;13346686;314475
2020-12-15;;European Union;142561;4657;13489247;319132
2020-12-16;;European Union;160985;4164;13650232;323296
2020-12-17;;European Union;161699;3810;13811931;327106
2020-12-18;;European Union;157984;4093;13969915;331199
2020-12-19;;European Union;124829;2782;14094744;333981
2020-12-20;;European Union;88808;1881;14183552;335862
2020-12-21;;European Union;99002;3007;14282554;338869
2020-12-22;;European Union;148162;4302;14430716;343171
2020-12-23;;European Union;155424;3852;14586140;347023
2020-12-24;;European Union;154364;2878;14740504;349901
2020-12-25;;European Union;97840;1964;14838344;351865
2020-12-26;;European Union;59630;1682;14897974;353547
2020-12-27;;European Union;61491;1711;14959465;355258
2020-12-28;;European Union;82169;3013;15041634;358271
2020-12-29;;European Union;144298;4816;15185932;363087
2020-12-30;;European Union;196752;4334;15382684;367421
2020-12-31;;European Union;163706;3229;15546390;370650
2021-01-01;;European Union;112548;2296;15658938;372946
2021-01-02;;European Union;64511;1744;15723449;374690
2021-01-03;;European Union;77689;1682;15801138;376372
2021-01-04;;European Union;101218;3079;15902356;379451
2021-01-05;;European Union;172569;4706;16074925;384157
2021-01-06;;European Union;162499;3629;16237424;387786
2021-01-07;;European Union;224545;3642;16461969;391428
2021-01-08;;European Union;165734;4035;16627703;395463
2021-01-09;;European Union;134617;2652;16762320;398115
2021-01-10;;European Union;91667;1856;16853987;399971
2021-01-11;;European Union;126646;3059;16980633;403030
2021-01-12;;European Union;152866;4517;17133499;407547
2021-01-13;;European Union;174504;4139;17308003;411686
2021-01-14;;European Union;165974;3914;17473977;415600
2021-01-15;;European Union;148030;3527;17622007;419127
2021-01-16;;European Union;106529;2810;17728536;421937
2021-01-17;;European Union;82216;1875;17810752;423812
2021-01-18;;European Union;135234;2483;17945986;426295
2021-01-19;;European Union;135215;5016;18081201;431311
2021-01-20;;European Union;174627;4351;18255828;435662
2021-01-21;;European Union;150257;3802;18406085;439464
2021-01-22;;European Union;154195;3933;18560280;443397
2021-01-23;;European Union;104107;2354;18664387;445751
2021-01-24;;European Union;79394;1889;18743781;447640
2021-01-25;;European Union;140212;3286;18883993;450926
2021-01-26;;European Union;129876;4050;19013869;454976
2021-01-27;;European Union;159909;3904;19173778;458880
2021-01-28;;European Union;148854;4314;19322632;463194
2021-01-29;;European Union;141291;3646;19463923;466840
2021-01-30;;European Union;102815;2848;19566738;469688
2021-01-31;;European Union;67196;1434;19633934;471122
2021-02-01;;European Union;123312;3406;19757246;474528
2021-02-02;;European Union;116130;4492;19873376;479020
2021-02-03;;European Union;137342;3819;20010718;482839
2021-02-04;;European Union;107724;3282;20118442;486121
2021-02-05;;European Union;146769;4095;20265211;490216
2021-02-06;;European Union;84762;2026;20349973;492242
2021-02-07;;European Union;68143;1425;20418116;493667
2021-02-08;;European Union;84065;2992;20502181;496659
2021-02-09;;European Union;91354;4150;20593535;500809
2021-02-10;;European Union;115654;3407;20709189;504216
2021-02-11;;European Union;112302;3251;20821491;507467
2021-02-12;;European Union;103547;3218;20925038;510685
2021-02-13;;European Union;81152;1844;21006190;512529
2021-02-14;;European Union;60393;1201;21066583;513730
2021-02-15;;European Union;67281;2205;21133864;515935
2021-02-16;;European Union;88569;3164;21222433;519099
2021-02-17;;European Union;109104;3196;21331537;522295
2021-02-18;;European Union;113211;2665;21444748;524960
2021-02-19;;European Union;113688;2887;21558436;527847
2021-02-20;;European Union;91618;1540;21650054;529387
2021-02-21;;European Union;77441;1044;21727495;530431
2021-02-22;;European Union;66803;2152;21794298;532583
2021-02-23;;European Union;100320;2897;21894618;535480
2021-02-24;;European Union;132503;2627;22027121;538107
2021-02-25;;European Union;129085;2122;22156206;540229
2021-02-26;;European Union;126799;2813;22283005;543042
2021-02-27;;European Union;109576;1640;22392581;544682
2021-02-28;;European Union;88268;1095;22480849;545777
2021-03-01;;European Union;70140;2132;22550989;547909
2021-03-02;;European Union;31750;2578;22582739;550487
2021-03-03;;European Union;138570;2759;22721309;553246
2021-03-04;;European Union;135594;2310;22856903;555556
2021-03-05;;European Union;135323;2770;22992226;558326
2021-03-06;;European Union;118953;1593;23111179;559919
2021-03-07;;European Union;98601;1122;23209780;561041
2021-03-08;;European Union;67542;2054;23277322;563095
2021-03-09;;European Union;121096;2683;23398418;565778
2021-03-10;;European Union;159082;2548;23557500;568326
2021-03-11;;European Union;147472;2370;23704972;570696
2021-03-12;;European Union;147678;2306;23852650;573002
2021-03-13;;European Union;144558;1677;23997208;574679
2021-03-14;;European Union;114922;1334;24112130;576013
2021-03-15;;European Union;84579;2022;24196709;578035
2021-03-16;;European Union;147293;2651;24344002;580686
2021-03-17;;European Union;165450;2335;24509452;583021
2021-03-18;;European Union;185064;2590;24694516;585611
2021-03-19;;European Union;168491;2355;24863007;587966
2021-03-20;;European Union;152915;1862;25015922;589828
2021-03-21;;European Union;126906;1353;25142828;591181
2021-03-22;;European Union;113307;2490;25256135;593671
2021-03-23;;European Union;139641;2891;25395776;596562
2021-03-24;;European Union;207487;2577;25603263;599139
2021-03-25;;European Union;205211;3055;25808474;602194
2021-03-26;;European Union;194923;3525;26003397;605719
2021-03-27;;European Union;172952;1980;26176349;607699
2021-03-28;;European Union;130020;1369;26306369;609068
2021-03-29;;European Union;100973;2103;26407342;611171
2021-03-30;;European Union;162338;2907;26569680;614078
2021-03-31;;European Union;216452;2935;26786132;617013
2021-04-01;;European Union;203859;2773;26989991;619786
2021-04-02;;European Union;169714;2485;27159705;622271
2021-04-03;;European Union;110635;2068;27270340;624339
2021-04-04;;European Union;167010;1725;27437350;626064
2021-04-05;;European Union;76198;1637;27513548;627701
2021-04-06;;European Union;88862;1943;27602410;629644
2021-04-07;;European Union;122034;3273;27724444;632917
2021-04-08;;European Union;237721;3733;27962165;636650
2021-04-09;;European Union;139355;3050;28101520;639700
2021-04-10;;European Union;109497;2110;28211017;641810
2021-04-11;;European Union;192605;2146;28403622;643956
2021-04-12;;European Union;93378;2298;28497000;646254
2021-04-13;;European Union;159192;3084;28656192;649338
2021-04-14;;European Union;174160;3080;28830352;652418
2021-04-15;;European Union;162410;2802;28992762;655220
2021-04-16;;European Union;153932;2666;29146694;657886
2021-04-17;;European Union;125258;1990;29271952;659876
2021-04-18;;European Union;86165;1408;29358117;661284
2021-04-19;;European Union;80359;2262;29438476;663546
2021-04-20;;European Union;148242;2762;29586718;666308
2021-04-21;;European Union;153423;2890;29740141;669198
2021-04-22;;European Union;151615;2526;29891756;671724
2021-04-23;;European Union;137451;2607;30029207;674331
2021-04-24;;European Union;104949;1917;30134156;676248
2021-04-25;;European Union;85661;1262;30219817;677510
2021-04-26;;European Union;64348;1997;30284165;679507
2021-04-27;;European Union;123682;2507;30407847;682014
2021-04-28;;European Union;134413;2467;30542260;684481
2021-04-29;;European Union;125184;2343;30667444;686824
2021-04-30;;European Union;103770;2072;30771214;688896
2021-05-01;;European Union;91223;1590;30862437;690486
2021-05-02;;European Union;51425;914;30913862;691400
2021-05-03;;European Union;55119;1590;30968981;692990
2021-05-04;;European Union;103840;1702;31072821;694692
2021-05-05;;European Union;106256;2141;31179077;696833
2021-05-06;;European Union;102113;2009;31281190;698842
2021-05-07;;European Union;93243;1849;31374433;700691
2021-05-08;;European Union;75241;1467;31449674;702158
2021-05-09;;European Union;40477;872;31490151;703030
2021-05-10;;European Union;48571;1422;31538722;704452
2021-05-11;;European Union;90565;1871;31629287;706323
2021-05-12;;European Union;78203;1507;31707490;707830
2021-05-13;;European Union;73366;1599;31780856;709429
2021-05-14;;European Union;63877;1357;31844733;710786
2021-05-15;;European Union;50673;980;31895406;711766
2021-05-16;;European Union;43470;582;31938876;712348
2021-05-17;;European Union;34991;994;31973867;713342
2021-05-18;;European Union;63012;1464;32036879;714806
2021-05-19;;European Union;70277;1307;32107156;716113
2021-05-20;;European Union;46146;1173;31804635;717286
2021-05-21;;European Union;52922;1036;31857557;718322
2021-05-22;;European Union;39700;770;31897257;719092
2021-05-23;;European Union;30356;465;31927613;719557
2021-05-24;;European Union;27202;542;31954815;720099
2021-05-25;;European Union;32833;1250;31987648;721349
2021-05-26;;European Union;43162;1125;32030810;722474
2021-05-27;;European Union;47500;899;32078310;723373
2021-05-28;;European Union;41990;795;32120300;724168
2021-05-29;;European Union;32516;537;32152816;724705
2021-05-30;;European Union;24500;310;32177316;725015
2021-05-31;;European Union;21633;627;32198949;725642
2021-06-01;;European Union;30986;755;32229935;726397
2021-06-02;;European Union;26412;641;32256347;727038
2021-06-03;;European Union;46529;719;32302876;727757
2021-06-04;;European Union;28613;732;32331489;728489
2021-06-05;;European Union;20448;483;32351937;728972
2021-06-06;;European Union;16178;296;32368115;729268
2021-06-07;;European Union;18773;493;32386888;729761
2021-06-08;;European Union;24060;901;32410948;730662
2021-06-09;;European Union;25709;698;32436657;731360
2021-06-10;;European Union;31628;744;32468285;732104
2021-06-11;;European Union;19079;609;32487364;732713
2021-06-12;;European Union;13274;339;32500638;733052
2021-06-13;;European Union;9709;144;32510347;733196
2021-06-14;;European Union;14385;335;32524732;733531
2021-06-15;;European Union;15692;578;32540424;734109
2021-06-16;;European Union;15752;502;32556176;734611
2021-06-17;;European Union;14091;461;32570267;735072
2021-06-18;;European Union;14041;446;32584308;735518
2021-06-19;;European Union;9639;265;32593947;735783
2021-06-20;;European Union;6807;100;32600754;735883
2021-06-21;;European Union;11766;317;32612520;736200
2021-06-22;;European Union;15207;391;32627727;736591
2021-06-23;;European Union;14916;425;32642643;737016
2021-06-24;;European Union;13089;364;32655732;737380
2021-06-25;;European Union;13268;408;32669000;737788
2021-06-26;;European Union;7855;372;32676855;738160
2021-06-27;;European Union;6190;147;32683045;738307
2021-06-28;;European Union;15744;247;32698789;738554
2021-06-29;;European Union;18563;567;32717352;739121
2021-06-30;;European Union;18762;401;32736114;739522
2021-07-01;;European Union;24845;275;32760959;739797
2021-01-29;FO;Faeroe Islands;0;0;0;0
2021-01-30;FO;Faeroe Islands;0;0;0;0
2021-01-31;FO;Faeroe Islands;0;0;0;0
2021-02-01;FO;Faeroe Islands;0;0;0;0
2021-02-02;FO;Faeroe Islands;0;0;0;0
2021-02-03;FO;Faeroe Islands;0;0;0;0
2021-02-04;FO;Faeroe Islands;0;0;0;0
2021-02-05;FO;Faeroe Islands;0;0;0;0
2021-02-06;FO;Faeroe Islands;0;0;0;0
2021-02-07;FO;Faeroe Islands;0;0;0;0
2021-02-08;FO;Faeroe Islands;0;0;0;0
2021-02-09;FO;Faeroe Islands;0;0;0;0
2021-02-10;FO;Faeroe Islands;0;0;0;0
2021-02-11;FO;Faeroe Islands;0;0;0;0
2021-02-12;FO;Faeroe Islands;0;0;0;0
2021-02-13;FO;Faeroe Islands;0;0;0;0
2021-02-14;FO;Faeroe Islands;0;0;0;0
2021-02-15;FO;Faeroe Islands;0;0;0;0
2021-02-16;FO;Faeroe Islands;0;0;0;0
2021-02-17;FO;Faeroe Islands;0;0;0;0
2021-02-18;FO;Faeroe Islands;0;0;0;0
2021-02-19;FO;Faeroe Islands;0;0;0;0
2021-02-20;FO;Faeroe Islands;0;0;0;0
2021-02-21;FO;Faeroe Islands;0;0;0;0
2021-02-22;FO;Faeroe Islands;0;0;0;0
2021-02-23;FO;Faeroe Islands;0;0;0;0
2021-02-24;FO;Faeroe Islands;0;0;0;0
2021-02-25;FO;Faeroe Islands;0;0;0;0
2021-02-26;FO;Faeroe Islands;0;0;0;0
2021-02-27;FO;Faeroe Islands;0;0;0;0
2021-02-28;FO;Faeroe Islands;0;0;0;0
2021-03-01;FO;Faeroe Islands;0;0;0;0
2021-03-02;FO;Faeroe Islands;0;0;0;0
2021-03-03;FO;Faeroe Islands;0;0;0;0
2021-03-04;FO;Faeroe Islands;0;0;0;0
2021-03-05;FO;Faeroe Islands;0;0;0;0
2021-03-06;FO;Faeroe Islands;0;0;0;0
2021-03-07;FO;Faeroe Islands;0;0;0;0
2021-03-08;FO;Faeroe Islands;0;0;0;0
2021-03-09;FO;Faeroe Islands;0;0;0;0
2021-03-10;FO;Faeroe Islands;0;0;0;0
2021-03-11;FO;Faeroe Islands;0;0;0;0
2021-03-12;FO;Faeroe Islands;0;0;0;0
2021-03-13;FO;Faeroe Islands;0;0;0;0
2021-03-14;FO;Faeroe Islands;0;0;0;0
2021-03-15;FO;Faeroe Islands;0;0;0;0
2021-03-16;FO;Faeroe Islands;0;0;0;0
2021-03-17;FO;Faeroe Islands;0;0;0;0
2021-03-18;FO;Faeroe Islands;0;0;0;0
2021-03-19;FO;Faeroe Islands;0;0;0;0
2021-03-20;FO;Faeroe Islands;0;0;0;0
2021-03-21;FO;Faeroe Islands;0;0;0;0
2021-03-22;FO;Faeroe Islands;0;0;0;0
2021-03-23;FO;Faeroe Islands;0;0;0;0
2021-03-24;FO;Faeroe Islands;0;0;0;0
2021-03-25;FO;Faeroe Islands;0;0;0;0
2021-03-26;FO;Faeroe Islands;0;0;0;0
2021-03-27;FO;Faeroe Islands;0;0;0;0
2021-03-28;FO;Faeroe Islands;0;0;0;0
2021-03-29;FO;Faeroe Islands;0;0;0;0
2021-03-30;FO;Faeroe Islands;0;0;0;0
2021-03-31;FO;Faeroe Islands;0;0;0;0
2021-04-01;FO;Faeroe Islands;0;0;0;0
2021-04-02;FO;Faeroe Islands;0;0;0;0
2021-04-03;FO;Faeroe Islands;0;0;0;0
2021-04-04;FO;Faeroe Islands;0;0;0;0
2021-04-05;FO;Faeroe Islands;0;0;0;0
2021-04-06;FO;Faeroe Islands;0;0;0;0
2021-04-07;FO;Faeroe Islands;0;0;0;0
2021-04-08;FO;Faeroe Islands;0;0;0;0
2021-04-09;FO;Faeroe Islands;0;0;0;0
2021-04-10;FO;Faeroe Islands;0;0;0;0
2021-04-11;FO;Faeroe Islands;0;0;0;0
2021-04-12;FO;Faeroe Islands;0;0;0;0
2021-04-13;FO;Faeroe Islands;0;0;0;0
2021-04-14;FO;Faeroe Islands;0;0;0;0
2021-04-15;FO;Faeroe Islands;0;0;0;0
2021-04-16;FO;Faeroe Islands;0;0;0;0
2021-04-17;FO;Faeroe Islands;0;0;0;0
2021-04-18;FO;Faeroe Islands;0;0;0;0
2021-04-19;FO;Faeroe Islands;0;0;0;0
2021-04-20;FO;Faeroe Islands;0;0;0;0
2021-04-21;FO;Faeroe Islands;0;0;0;0
2021-04-22;FO;Faeroe Islands;0;0;0;0
2021-04-23;FO;Faeroe Islands;0;0;0;0
2021-04-24;FO;Faeroe Islands;0;0;0;0
2021-04-25;FO;Faeroe Islands;0;0;0;0
2021-04-26;FO;Faeroe Islands;0;0;0;0
2021-04-27;FO;Faeroe Islands;0;0;0;0
2021-04-28;FO;Faeroe Islands;0;0;0;0
2021-04-29;FO;Faeroe Islands;0;0;0;0
2021-04-30;FO;Faeroe Islands;0;0;0;0
2021-05-01;FO;Faeroe Islands;0;0;0;0
2021-05-02;FO;Faeroe Islands;0;0;0;0
2021-05-03;FO;Faeroe Islands;0;0;0;0
2021-05-04;FO;Faeroe Islands;0;0;0;0
2021-05-05;FO;Faeroe Islands;0;0;0;0
2021-05-06;FO;Faeroe Islands;0;0;0;0
2021-05-07;FO;Faeroe Islands;0;0;0;0
2021-05-08;FO;Faeroe Islands;0;0;0;0
2021-05-09;FO;Faeroe Islands;0;0;0;0
2021-05-10;FO;Faeroe Islands;0;0;0;0
2021-05-11;FO;Faeroe Islands;0;0;0;0
2021-05-12;FO;Faeroe Islands;0;0;0;0
2021-05-13;FO;Faeroe Islands;0;0;0;0
2021-05-14;FO;Faeroe Islands;0;0;0;0
2021-05-15;FO;Faeroe Islands;0;0;0;0
2021-05-16;FO;Faeroe Islands;0;0;0;0
2021-05-17;FO;Faeroe Islands;0;0;0;0
2021-05-18;FO;Faeroe Islands;0;0;0;0
2021-05-19;FO;Faeroe Islands;0;0;0;0
2021-05-20;FO;Faeroe Islands;0;0;0;0
2021-05-21;FO;Faeroe Islands;0;0;0;0
2021-05-22;FO;Faeroe Islands;0;0;0;0
2021-05-23;FO;Faeroe Islands;0;0;0;0
2021-05-24;FO;Faeroe Islands;0;0;0;0
2021-05-25;FO;Faeroe Islands;0;0;0;0
2021-05-26;FO;Faeroe Islands;0;0;0;0
2021-05-27;FO;Faeroe Islands;0;0;0;0
2021-05-28;FO;Faeroe Islands;0;0;0;0
2021-05-29;FO;Faeroe Islands;0;0;0;0
2021-05-30;FO;Faeroe Islands;0;0;0;0
2021-05-31;FO;Faeroe Islands;0;0;0;0
2021-06-01;FO;Faeroe Islands;0;0;0;0
2021-06-02;FO;Faeroe Islands;0;0;0;0
2021-06-03;FO;Faeroe Islands;0;0;0;0
2021-06-04;FO;Faeroe Islands;0;0;0;0
2021-06-05;FO;Faeroe Islands;0;0;0;0
2021-06-06;FO;Faeroe Islands;0;0;0;0
2021-06-07;FO;Faeroe Islands;0;0;0;0
2021-06-08;FO;Faeroe Islands;0;0;0;0
2021-06-09;FO;Faeroe Islands;0;0;0;0
2021-06-10;FO;Faeroe Islands;0;0;0;0
2021-06-11;FO;Faeroe Islands;0;0;0;0
2021-06-12;FO;Faeroe Islands;0;0;0;0
2021-06-13;FO;Faeroe Islands;0;0;0;0
2021-06-14;FO;Faeroe Islands;0;0;0;0
2021-06-15;FO;Faeroe Islands;0;0;0;0
2021-06-16;FO;Faeroe Islands;0;0;0;0
2021-06-17;FO;Faeroe Islands;0;0;0;0
2021-06-18;FO;Faeroe Islands;0;0;0;0
2021-06-19;FO;Faeroe Islands;0;0;0;0
2021-06-20;FO;Faeroe Islands;0;0;0;0
2021-06-21;FO;Faeroe Islands;0;0;0;0
2021-06-22;FO;Faeroe Islands;0;0;0;0
2021-06-23;FO;Faeroe Islands;0;0;0;0
2021-06-24;FO;Faeroe Islands;0;0;0;0
2021-06-25;FO;Faeroe Islands;0;0;0;0
2021-06-26;FO;Faeroe Islands;0;0;0;0
2021-06-27;FO;Faeroe Islands;0;0;0;0
2021-06-28;FO;Faeroe Islands;0;0;0;0
2021-06-29;FO;Faeroe Islands;0;0;0;0
2021-06-30;FO;Faeroe Islands;0;0;0;0
2021-07-01;FO;Faeroe Islands;0;0;0;0
2021-02-07;FK;Falkland Islands;0;0;0;0
2021-02-08;FK;Falkland Islands;0;0;0;0
2021-02-09;FK;Falkland Islands;0;0;0;0
2021-02-10;FK;Falkland Islands;0;0;0;0
2021-02-11;FK;Falkland Islands;0;0;0;0
2021-02-12;FK;Falkland Islands;0;0;0;0
2021-02-13;FK;Falkland Islands;0;0;0;0
2021-02-14;FK;Falkland Islands;0;0;0;0
2021-02-15;FK;Falkland Islands;0;0;0;0
2021-02-16;FK;Falkland Islands;0;0;0;0
2021-02-17;FK;Falkland Islands;0;0;0;0
2021-02-18;FK;Falkland Islands;0;0;0;0
2021-02-19;FK;Falkland Islands;0;0;0;0
2021-02-20;FK;Falkland Islands;0;0;0;0
2021-02-21;FK;Falkland Islands;0;0;0;0
2021-02-22;FK;Falkland Islands;0;0;0;0
2021-02-23;FK;Falkland Islands;0;0;0;0
2021-02-24;FK;Falkland Islands;0;0;0;0
2021-02-25;FK;Falkland Islands;0;0;0;0
2021-02-26;FK;Falkland Islands;0;0;0;0
2021-02-27;FK;Falkland Islands;0;0;0;0
2021-02-28;FK;Falkland Islands;0;0;0;0
2021-03-01;FK;Falkland Islands;0;0;0;0
2021-03-02;FK;Falkland Islands;0;0;0;0
2021-03-03;FK;Falkland Islands;0;0;0;0
2021-03-04;FK;Falkland Islands;0;0;0;0
2021-03-05;FK;Falkland Islands;0;0;0;0
2021-03-06;FK;Falkland Islands;0;0;0;0
2021-03-07;FK;Falkland Islands;0;0;0;0
2021-03-08;FK;Falkland Islands;0;0;0;0
2021-03-09;FK;Falkland Islands;0;0;0;0
2021-03-10;FK;Falkland Islands;0;0;0;0
2021-03-11;FK;Falkland Islands;0;0;0;0
2021-03-12;FK;Falkland Islands;0;0;0;0
2021-03-13;FK;Falkland Islands;0;0;0;0
2021-03-14;FK;Falkland Islands;0;0;0;0
2021-03-15;FK;Falkland Islands;0;0;0;0
2021-03-16;FK;Falkland Islands;0;0;0;0
2021-03-17;FK;Falkland Islands;0;0;0;0
2021-03-18;FK;Falkland Islands;0;0;0;0
2021-03-19;FK;Falkland Islands;0;0;0;0
2021-03-20;FK;Falkland Islands;0;0;0;0
2021-03-21;FK;Falkland Islands;0;0;0;0
2021-03-22;FK;Falkland Islands;0;0;0;0
2021-03-23;FK;Falkland Islands;0;0;0;0
2021-03-24;FK;Falkland Islands;0;0;0;0
2021-03-25;FK;Falkland Islands;0;0;0;0
2021-03-26;FK;Falkland Islands;0;0;0;0
2021-03-27;FK;Falkland Islands;0;0;0;0
2021-03-28;FK;Falkland Islands;0;0;0;0
2021-03-29;FK;Falkland Islands;0;0;0;0
2021-03-30;FK;Falkland Islands;0;0;0;0
2021-03-31;FK;Falkland Islands;0;0;0;0
2021-04-01;FK;Falkland Islands;0;0;0;0
2021-04-02;FK;Falkland Islands;0;0;0;0
2021-04-03;FK;Falkland Islands;0;0;0;0
2021-04-04;FK;Falkland Islands;0;0;0;0
2021-04-05;FK;Falkland Islands;0;0;0;0
2021-04-06;FK;Falkland Islands;0;0;0;0
2021-04-07;FK;Falkland Islands;0;0;0;0
2021-04-08;FK;Falkland Islands;0;0;0;0
2021-04-09;FK;Falkland Islands;0;0;0;0
2021-04-10;FK;Falkland Islands;0;0;0;0
2021-04-11;FK;Falkland Islands;0;0;0;0
2021-04-12;FK;Falkland Islands;0;0;0;0
2021-04-13;FK;Falkland Islands;0;0;0;0
2021-04-14;FK;Falkland Islands;0;0;0;0
2020-01-30;FJ;Fiji;0;0;0;0
2020-01-31;FJ;Fiji;0;0;0;0
2020-02-01;FJ;Fiji;0;0;0;0
2020-02-02;FJ;Fiji;0;0;0;0
2020-02-03;FJ;Fiji;0;0;0;0
2020-02-04;FJ;Fiji;0;0;0;0
2020-02-05;FJ;Fiji;0;0;0;0
2020-02-06;FJ;Fiji;0;0;0;0
2020-02-07;FJ;Fiji;0;0;0;0
2020-02-08;FJ;Fiji;0;0;0;0
2020-02-09;FJ;Fiji;0;0;0;0
2020-02-10;FJ;Fiji;0;0;0;0
2020-02-11;FJ;Fiji;0;0;0;0
2020-02-12;FJ;Fiji;0;0;0;0
2020-02-13;FJ;Fiji;0;0;0;0
2020-02-14;FJ;Fiji;0;0;0;0
2020-02-15;FJ;Fiji;0;0;0;0
2020-02-16;FJ;Fiji;0;0;0;0
2020-02-17;FJ;Fiji;0;0;0;0
2020-02-18;FJ;Fiji;0;0;0;0
2020-02-19;FJ;Fiji;0;0;0;0
2020-02-20;FJ;Fiji;0;0;0;0
2020-02-21;FJ;Fiji;0;0;0;0
2020-02-22;FJ;Fiji;0;0;0;0
2020-02-23;FJ;Fiji;0;0;0;0
2020-02-24;FJ;Fiji;0;0;0;0
2020-02-25;FJ;Fiji;0;0;0;0
2020-02-26;FJ;Fiji;0;0;0;0
2020-02-27;FJ;Fiji;0;0;0;0
2020-02-28;FJ;Fiji;0;0;0;0
2020-02-29;FJ;Fiji;0;0;0;0
2020-03-01;FJ;Fiji;0;0;0;0
2020-03-02;FJ;Fiji;0;0;0;0
2020-03-03;FJ;Fiji;0;0;0;0
2020-03-04;FJ;Fiji;0;0;0;0
2020-03-05;FJ;Fiji;0;0;0;0
2020-03-06;FJ;Fiji;0;0;0;0
2020-03-07;FJ;Fiji;0;0;0;0
2020-03-08;FJ;Fiji;0;0;0;0
2020-03-09;FJ;Fiji;0;0;0;0
2020-03-10;FJ;Fiji;0;0;0;0
2020-03-11;FJ;Fiji;0;0;0;0
2020-03-12;FJ;Fiji;0;0;0;0
2020-03-13;FJ;Fiji;0;0;0;0
2020-03-14;FJ;Fiji;0;0;0;0
2020-03-15;FJ;Fiji;0;0;0;0
2020-03-16;FJ;Fiji;0;0;0;0
2020-03-17;FJ;Fiji;0;0;0;0
2020-03-18;FJ;Fiji;0;0;0;0
2020-03-19;FJ;Fiji;1;0;1;0
2020-03-20;FJ;Fiji;0;0;1;0
2020-03-21;FJ;Fiji;0;0;1;0
2020-03-22;FJ;Fiji;1;0;2;0
2020-03-23;FJ;Fiji;1;0;3;0
2020-03-24;FJ;Fiji;1;0;4;0
2020-03-25;FJ;Fiji;1;0;5;0
2020-03-26;FJ;Fiji;0;0;5;0
2020-03-27;FJ;Fiji;0;0;5;0
2020-03-28;FJ;Fiji;0;0;5;0
2020-03-29;FJ;Fiji;0;0;5;0
2020-03-30;FJ;Fiji;0;0;5;0
2020-03-31;FJ;Fiji;0;0;5;0
2020-04-01;FJ;Fiji;0;0;5;0
2020-04-02;FJ;Fiji;2;0;7;0
2020-04-03;FJ;Fiji;0;0;7;0
2020-04-04;FJ;Fiji;5;0;12;0
2020-04-05;FJ;Fiji;0;0;12;0
2020-04-06;FJ;Fiji;2;0;14;0
2020-04-07;FJ;Fiji;1;0;15;0
2020-04-08;FJ;Fiji;0;0;15;0
2020-04-09;FJ;Fiji;0;0;15;0
2020-04-10;FJ;Fiji;1;0;16;0
2020-04-11;FJ;Fiji;0;0;16;0
2020-04-12;FJ;Fiji;0;0;16;0
2020-04-13;FJ;Fiji;0;0;16;0
2020-04-14;FJ;Fiji;0;0;16;0
2020-04-15;FJ;Fiji;0;0;16;0
2020-04-16;FJ;Fiji;1;0;17;0
2020-04-17;FJ;Fiji;0;0;17;0
2020-04-18;FJ;Fiji;0;0;17;0
2020-04-19;FJ;Fiji;0;0;17;0
2020-04-20;FJ;Fiji;1;0;18;0
2020-04-21;FJ;Fiji;0;0;18;0
2020-04-22;FJ;Fiji;0;0;18;0
2020-04-23;FJ;Fiji;0;0;18;0
2020-04-24;FJ;Fiji;0;0;18;0
2020-04-25;FJ;Fiji;0;0;18;0
2020-04-26;FJ;Fiji;0;0;18;0
2020-04-27;FJ;Fiji;0;0;18;0
2020-04-28;FJ;Fiji;0;0;18;0
2020-04-29;FJ;Fiji;0;0;18;0
2020-04-30;FJ;Fiji;0;0;18;0
2020-05-01;FJ;Fiji;0;0;18;0
2020-05-02;FJ;Fiji;0;0;18;0
2020-05-03;FJ;Fiji;0;0;18;0
2020-05-04;FJ;Fiji;0;0;18;0
2020-05-05;FJ;Fiji;0;0;18;0
2020-05-06;FJ;Fiji;0;0;18;0
2020-05-07;FJ;Fiji;0;0;18;0
2020-05-08;FJ;Fiji;0;0;18;0
2020-05-09;FJ;Fiji;0;0;18;0
2020-05-10;FJ;Fiji;0;0;18;0
2020-05-11;FJ;Fiji;0;0;18;0
2020-05-12;FJ;Fiji;0;0;18;0
2020-05-13;FJ;Fiji;0;0;18;0
2020-05-14;FJ;Fiji;0;0;18;0
2020-05-15;FJ;Fiji;0;0;18;0
2020-05-16;FJ;Fiji;0;0;18;0
2020-05-17;FJ;Fiji;0;0;18;0
2020-05-18;FJ;Fiji;0;0;18;0
2020-05-19;FJ;Fiji;0;0;18;0
2020-05-20;FJ;Fiji;0;0;18;0
2020-05-21;FJ;Fiji;0;0;18;0
2020-05-22;FJ;Fiji;0;0;18;0
2020-05-23;FJ;Fiji;0;0;18;0
2020-05-24;FJ;Fiji;0;0;18;0
2020-05-25;FJ;Fiji;0;0;18;0
2020-05-26;FJ;Fiji;0;0;18;0
2020-05-27;FJ;Fiji;0;0;18;0
2020-05-28;FJ;Fiji;0;0;18;0
2020-05-29;FJ;Fiji;0;0;18;0
2020-05-30;FJ;Fiji;0;0;18;0
2020-05-31;FJ;Fiji;0;0;18;0
2020-06-01;FJ;Fiji;0;0;18;0
2020-06-02;FJ;Fiji;0;0;18;0
2020-06-03;FJ;Fiji;0;0;18;0
2020-06-04;FJ;Fiji;0;0;18;0
2020-06-05;FJ;Fiji;0;0;18;0
2020-06-06;FJ;Fiji;0;0;18;0
2020-06-07;FJ;Fiji;0;0;18;0
2020-06-08;FJ;Fiji;0;0;18;0
2020-06-09;FJ;Fiji;0;0;18;0
2020-06-10;FJ;Fiji;0;0;18;0
2020-06-11;FJ;Fiji;0;0;18;0
2020-06-12;FJ;Fiji;0;0;18;0
2020-06-13;FJ;Fiji;0;0;18;0
2020-06-14;FJ;Fiji;0;0;18;0
2020-06-15;FJ;Fiji;0;0;18;0
2020-06-16;FJ;Fiji;0;0;18;0
2020-06-17;FJ;Fiji;0;0;18;0
2020-06-18;FJ;Fiji;0;0;18;0
2020-06-19;FJ;Fiji;0;0;18;0
2020-06-20;FJ;Fiji;0;0;18;0
2020-06-21;FJ;Fiji;0;0;18;0
2020-06-22;FJ;Fiji;0;0;18;0
2020-06-23;FJ;Fiji;0;0;18;0
2020-06-24;FJ;Fiji;0;0;18;0
2020-06-25;FJ;Fiji;0;0;18;0
2020-06-26;FJ;Fiji;0;0;18;0
2020-06-27;FJ;Fiji;0;0;18;0
2020-06-28;FJ;Fiji;0;0;18;0
2020-06-29;FJ;Fiji;0;0;18;0
2020-06-30;FJ;Fiji;0;0;18;0
2020-07-01;FJ;Fiji;0;0;18;0
2020-07-02;FJ;Fiji;0;0;18;0
2020-07-03;FJ;Fiji;0;0;18;0
2020-07-04;FJ;Fiji;0;0;18;0
2020-07-05;FJ;Fiji;1;0;19;0
2020-07-06;FJ;Fiji;2;0;21;0
2020-07-07;FJ;Fiji;0;0;21;0
2020-07-08;FJ;Fiji;0;0;21;0
2020-07-09;FJ;Fiji;5;0;26;0
2020-07-10;FJ;Fiji;0;0;26;0
2020-07-11;FJ;Fiji;0;0;26;0
2020-07-12;FJ;Fiji;0;0;26;0
2020-07-13;FJ;Fiji;0;0;26;0
2020-07-14;FJ;Fiji;0;0;26;0
2020-07-15;FJ;Fiji;0;0;26;0
2020-07-16;FJ;Fiji;0;0;26;0
2020-07-17;FJ;Fiji;0;0;26;0
2020-07-18;FJ;Fiji;0;0;26;0
2020-07-19;FJ;Fiji;1;0;27;0
2020-07-20;FJ;Fiji;0;0;27;0
2020-07-21;FJ;Fiji;0;0;27;0
2020-07-22;FJ;Fiji;0;0;27;0
2020-07-23;FJ;Fiji;0;0;27;0
2020-07-24;FJ;Fiji;0;0;27;0
2020-07-25;FJ;Fiji;0;0;27;0
2020-07-26;FJ;Fiji;0;0;27;0
2020-07-27;FJ;Fiji;0;0;27;0
2020-07-28;FJ;Fiji;0;0;27;0
2020-07-29;FJ;Fiji;0;0;27;0
2020-07-30;FJ;Fiji;0;0;27;0
2020-07-31;FJ;Fiji;0;1;27;1
2020-08-01;FJ;Fiji;0;0;27;1
2020-08-02;FJ;Fiji;0;0;27;1
2020-08-03;FJ;Fiji;0;0;27;1
2020-08-04;FJ;Fiji;0;0;27;1
2020-08-05;FJ;Fiji;0;0;27;1
2020-08-06;FJ;Fiji;0;0;27;1
2020-08-07;FJ;Fiji;0;0;27;1
2020-08-08;FJ;Fiji;0;0;27;1
2020-08-09;FJ;Fiji;0;0;27;1
2020-08-10;FJ;Fiji;0;0;27;1
2020-08-11;FJ;Fiji;0;0;27;1
2020-08-12;FJ;Fiji;0;0;27;1
2020-08-13;FJ;Fiji;1;0;28;1
2020-08-14;FJ;Fiji;0;0;28;1
2020-08-15;FJ;Fiji;0;0;28;1
2020-08-16;FJ;Fiji;0;0;28;1
2020-08-17;FJ;Fiji;0;0;28;1
2020-08-18;FJ;Fiji;0;0;28;1
2020-08-19;FJ;Fiji;0;0;28;1
2020-08-20;FJ;Fiji;0;0;28;1
2020-08-21;FJ;Fiji;0;0;28;1
2020-08-22;FJ;Fiji;0;0;28;1
2020-08-23;FJ;Fiji;0;0;28;1
2020-08-24;FJ;Fiji;0;0;28;1
2020-08-25;FJ;Fiji;0;0;28;1
2020-08-26;FJ;Fiji;0;0;28;1
2020-08-27;FJ;Fiji;0;1;28;2
2020-08-28;FJ;Fiji;0;0;28;2
2020-08-29;FJ;Fiji;0;0;28;2
2020-08-30;FJ;Fiji;0;0;28;2
2020-08-31;FJ;Fiji;0;0;28;2
2020-09-01;FJ;Fiji;1;0;29;2
2020-09-02;FJ;Fiji;0;0;29;2
2020-09-03;FJ;Fiji;0;0;29;2
2020-09-04;FJ;Fiji;0;0;29;2
2020-09-05;FJ;Fiji;2;0;31;2
2020-09-06;FJ;Fiji;0;0;31;2
2020-09-07;FJ;Fiji;0;0;31;2
2020-09-08;FJ;Fiji;0;0;31;2
2020-09-09;FJ;Fiji;1;0;32;2
2020-09-10;FJ;Fiji;0;0;32;2
2020-09-11;FJ;Fiji;0;0;32;2
2020-09-12;FJ;Fiji;0;0;32;2
2020-09-13;FJ;Fiji;0;0;32;2
2020-09-14;FJ;Fiji;0;0;32;2
2020-09-15;FJ;Fiji;0;0;32;2
2020-09-16;FJ;Fiji;0;0;32;2
2020-09-17;FJ;Fiji;0;0;32;2
2020-09-18;FJ;Fiji;0;0;32;2
2020-09-19;FJ;Fiji;0;0;32;2
2020-09-20;FJ;Fiji;0;0;32;2
2020-09-21;FJ;Fiji;0;0;32;2
2020-09-22;FJ;Fiji;0;0;32;2
2020-09-23;FJ;Fiji;0;0;32;2
2020-09-24;FJ;Fiji;0;0;32;2
2020-09-25;FJ;Fiji;0;0;32;2
2020-09-26;FJ;Fiji;0;0;32;2
2020-09-27;FJ;Fiji;0;0;32;2
2020-09-28;FJ;Fiji;0;0;32;2
2020-09-29;FJ;Fiji;0;0;32;2
2020-09-30;FJ;Fiji;0;0;32;2
2020-10-01;FJ;Fiji;0;0;32;2
2020-10-02;FJ;Fiji;0;0;32;2
2020-10-03;FJ;Fiji;0;0;32;2
2020-10-04;FJ;Fiji;0;0;32;2
2020-10-05;FJ;Fiji;0;0;32;2
2020-10-06;FJ;Fiji;0;0;32;2
2020-10-07;FJ;Fiji;0;0;32;2
2020-10-08;FJ;Fiji;0;0;32;2
2020-10-09;FJ;Fiji;0;0;32;2
2020-10-10;FJ;Fiji;0;0;32;2
2020-10-11;FJ;Fiji;0;0;32;2
2020-10-12;FJ;Fiji;0;0;32;2
2020-10-13;FJ;Fiji;0;0;32;2
2020-10-14;FJ;Fiji;0;0;32;2
2020-10-15;FJ;Fiji;0;0;32;2
2020-10-16;FJ;Fiji;0;0;32;2
2020-10-17;FJ;Fiji;0;0;32;2
2020-10-18;FJ;Fiji;0;0;32;2
2020-10-19;FJ;Fiji;0;0;32;2
2020-10-20;FJ;Fiji;0;0;32;2
2020-10-21;FJ;Fiji;1;0;33;2
2020-10-22;FJ;Fiji;0;0;33;2
2020-10-23;FJ;Fiji;0;0;33;2
2020-10-24;FJ;Fiji;0;0;33;2
2020-10-25;FJ;Fiji;0;0;33;2
2020-10-26;FJ;Fiji;0;0;33;2
2020-10-27;FJ;Fiji;0;0;33;2
2020-10-28;FJ;Fiji;0;0;33;2
2020-10-29;FJ;Fiji;1;0;34;2
2020-10-30;FJ;Fiji;0;0;34;2
2020-10-31;FJ;Fiji;0;0;34;2
2020-11-01;FJ;Fiji;0;0;34;2
2020-11-02;FJ;Fiji;0;0;34;2
2020-11-03;FJ;Fiji;0;0;34;2
2020-11-04;FJ;Fiji;0;0;34;2
2020-11-05;FJ;Fiji;0;0;34;2
2020-11-06;FJ;Fiji;0;0;34;2
2020-11-07;FJ;Fiji;0;0;34;2
2020-11-08;FJ;Fiji;0;0;34;2
2020-11-09;FJ;Fiji;0;0;34;2
2020-11-10;FJ;Fiji;0;0;34;2
2020-11-11;FJ;Fiji;1;0;35;2
2020-11-12;FJ;Fiji;0;0;35;2
2020-11-13;FJ;Fiji;0;0;35;2
2020-11-14;FJ;Fiji;0;0;35;2
2020-11-15;FJ;Fiji;0;0;35;2
2020-11-16;FJ;Fiji;0;0;35;2
2020-11-17;FJ;Fiji;0;0;35;2
2020-11-18;FJ;Fiji;0;0;35;2
2020-11-19;FJ;Fiji;0;0;35;2
2020-11-20;FJ;Fiji;0;0;35;2
2020-11-21;FJ;Fiji;0;0;35;2
2020-11-22;FJ;Fiji;0;0;35;2
2020-11-23;FJ;Fiji;0;0;35;2
2020-11-24;FJ;Fiji;3;0;38;2
2020-11-25;FJ;Fiji;0;0;38;2
2020-11-26;FJ;Fiji;0;0;38;2
2020-11-27;FJ;Fiji;0;0;38;2
2020-11-28;FJ;Fiji;0;0;38;2
2020-11-29;FJ;Fiji;0;0;38;2
2020-11-30;FJ;Fiji;4;0;42;2
2020-12-01;FJ;Fiji;0;0;42;2
2020-12-02;FJ;Fiji;0;0;42;2
2020-12-03;FJ;Fiji;0;0;42;2
2020-12-04;FJ;Fiji;2;0;44;2
2020-12-05;FJ;Fiji;0;0;44;2
2020-12-06;FJ;Fiji;0;0;44;2
2020-12-07;FJ;Fiji;0;0;44;2
2020-12-08;FJ;Fiji;0;0;44;2
2020-12-09;FJ;Fiji;0;0;44;2
2020-12-10;FJ;Fiji;0;0;44;2
2020-12-11;FJ;Fiji;0;0;44;2
2020-12-12;FJ;Fiji;0;0;44;2
2020-12-13;FJ;Fiji;2;0;46;2
2020-12-14;FJ;Fiji;0;0;46;2
2020-12-15;FJ;Fiji;0;0;46;2
2020-12-16;FJ;Fiji;0;0;46;2
2020-12-17;FJ;Fiji;0;0;46;2
2020-12-18;FJ;Fiji;0;0;46;2
2020-12-19;FJ;Fiji;0;0;46;2
2020-12-20;FJ;Fiji;0;0;46;2
2020-12-21;FJ;Fiji;0;0;46;2
2020-12-22;FJ;Fiji;0;0;46;2
2020-12-23;FJ;Fiji;0;0;46;2
2020-12-24;FJ;Fiji;0;0;46;2
2020-12-25;FJ;Fiji;0;0;46;2
2020-12-26;FJ;Fiji;0;0;46;2
2020-12-27;FJ;Fiji;0;0;46;2
2020-12-28;FJ;Fiji;0;0;46;2
2020-12-29;FJ;Fiji;3;0;49;2
2020-12-30;FJ;Fiji;0;0;49;2
2020-12-31;FJ;Fiji;0;0;49;2
2021-01-01;FJ;Fiji;0;0;49;2
2021-01-02;FJ;Fiji;0;0;49;2
2021-01-03;FJ;Fiji;0;0;49;2
2021-01-04;FJ;Fiji;0;0;49;2
2021-01-05;FJ;Fiji;4;0;53;2
2021-01-06;FJ;Fiji;0;0;53;2
2021-01-07;FJ;Fiji;0;0;53;2
2021-01-08;FJ;Fiji;0;0;53;2
2021-01-09;FJ;Fiji;0;0;53;2
2021-01-10;FJ;Fiji;0;0;53;2
2021-01-11;FJ;Fiji;0;0;53;2
2021-01-12;FJ;Fiji;0;0;53;2
2021-01-13;FJ;Fiji;0;0;53;2
2021-01-14;FJ;Fiji;0;0;53;2
2021-01-15;FJ;Fiji;0;0;53;2
2021-01-16;FJ;Fiji;2;0;55;2
2021-01-17;FJ;Fiji;0;0;55;2
2021-01-18;FJ;Fiji;0;0;55;2
2021-01-19;FJ;Fiji;0;0;55;2
2021-01-20;FJ;Fiji;0;0;55;2
2021-01-21;FJ;Fiji;0;0;55;2
2021-01-22;FJ;Fiji;0;0;55;2
2021-01-23;FJ;Fiji;0;0;55;2
2021-01-24;FJ;Fiji;0;0;55;2
2021-01-25;FJ;Fiji;0;0;55;2
2021-01-26;FJ;Fiji;0;0;55;2
2021-01-27;FJ;Fiji;0;0;55;2
2021-01-28;FJ;Fiji;0;0;55;2
2021-01-29;FJ;Fiji;0;0;55;2
2021-01-30;FJ;Fiji;0;0;55;2
2021-01-31;FJ;Fiji;0;0;55;2
2021-02-01;FJ;Fiji;0;0;55;2
2021-02-02;FJ;Fiji;0;0;55;2
2021-02-03;FJ;Fiji;1;0;56;2
2021-02-04;FJ;Fiji;0;0;56;2
2021-02-05;FJ;Fiji;0;0;56;2
2021-02-06;FJ;Fiji;0;0;56;2
2021-02-07;FJ;Fiji;0;0;56;2
2021-02-08;FJ;Fiji;0;0;56;2
2021-02-09;FJ;Fiji;0;0;56;2
2021-02-10;FJ;Fiji;0;0;56;2
2021-02-11;FJ;Fiji;0;0;56;2
2021-02-12;FJ;Fiji;0;0;56;2
2021-02-13;FJ;Fiji;0;0;56;2
2021-02-14;FJ;Fiji;0;0;56;2
2021-02-15;FJ;Fiji;0;0;56;2
2021-02-16;FJ;Fiji;0;0;56;2
2021-02-17;FJ;Fiji;0;0;56;2
2021-02-18;FJ;Fiji;0;0;56;2
2021-02-19;FJ;Fiji;0;0;56;2
2021-02-20;FJ;Fiji;0;0;56;2
2021-02-21;FJ;Fiji;0;0;56;2
2021-02-22;FJ;Fiji;0;0;56;2
2021-02-23;FJ;Fiji;0;0;56;2
2021-02-24;FJ;Fiji;1;0;57;2
2021-02-25;FJ;Fiji;0;0;57;2
2021-02-26;FJ;Fiji;2;0;59;2
2021-02-27;FJ;Fiji;0;0;59;2
2021-02-28;FJ;Fiji;0;0;59;2
2021-03-01;FJ;Fiji;0;0;59;2
2021-03-02;FJ;Fiji;0;0;59;2
2021-03-03;FJ;Fiji;4;0;63;2
2021-03-04;FJ;Fiji;0;0;63;2
2021-03-05;FJ;Fiji;0;0;63;2
2021-03-06;FJ;Fiji;0;0;63;2
2021-03-07;FJ;Fiji;0;0;63;2
2021-03-08;FJ;Fiji;3;0;66;2
2021-03-09;FJ;Fiji;0;0;66;2
2021-03-10;FJ;Fiji;0;0;66;2
2021-03-11;FJ;Fiji;0;0;66;2
2021-03-12;FJ;Fiji;0;0;66;2
2021-03-13;FJ;Fiji;0;0;66;2
2021-03-14;FJ;Fiji;0;0;66;2
2021-03-15;FJ;Fiji;0;0;66;2
2021-03-16;FJ;Fiji;0;0;66;2
2021-03-17;FJ;Fiji;0;0;66;2
2021-03-18;FJ;Fiji;1;0;67;2
2021-03-19;FJ;Fiji;0;0;67;2
2021-03-20;FJ;Fiji;0;0;67;2
2021-03-21;FJ;Fiji;0;0;67;2
2021-03-22;FJ;Fiji;0;0;67;2
2021-03-23;FJ;Fiji;0;0;67;2
2021-03-24;FJ;Fiji;0;0;67;2
2021-03-25;FJ;Fiji;0;0;67;2
2021-03-26;FJ;Fiji;0;0;67;2
2021-03-27;FJ;Fiji;0;0;67;2
2021-03-28;FJ;Fiji;0;0;67;2
2021-03-29;FJ;Fiji;0;0;67;2
2021-03-30;FJ;Fiji;0;0;67;2
2021-03-31;FJ;Fiji;0;0;67;2
2021-04-01;FJ;Fiji;0;0;67;2
2021-04-02;FJ;Fiji;0;0;67;2
2021-04-03;FJ;Fiji;0;0;67;2
2021-04-04;FJ;Fiji;0;0;67;2
2021-04-05;FJ;Fiji;0;0;67;2
2021-04-06;FJ;Fiji;0;0;67;2
2021-04-07;FJ;Fiji;0;0;67;2
2021-04-08;FJ;Fiji;0;0;67;2
2021-04-09;FJ;Fiji;1;0;68;2
2021-04-10;FJ;Fiji;0;0;68;2
2021-04-11;FJ;Fiji;0;0;68;2
2021-04-12;FJ;Fiji;0;0;68;2
2021-04-13;FJ;Fiji;0;0;68;2
2021-04-14;FJ;Fiji;0;0;68;2
2021-04-15;FJ;Fiji;0;0;68;2
2021-04-16;FJ;Fiji;0;0;68;2
2021-04-17;FJ;Fiji;4;0;72;2
2021-04-18;FJ;Fiji;0;0;72;2
2021-04-19;FJ;Fiji;0;0;72;2
2021-04-20;FJ;Fiji;5;0;77;2
2021-04-21;FJ;Fiji;1;0;78;2
2021-04-22;FJ;Fiji;8;0;86;2
2021-04-23;FJ;Fiji;0;0;86;2
2021-04-24;FJ;Fiji;1;0;87;2
2021-04-25;FJ;Fiji;4;0;91;2
2021-04-26;FJ;Fiji;12;0;103;2
2021-04-27;FJ;Fiji;6;0;109;2
2021-04-28;FJ;Fiji;2;0;111;2
2021-04-29;FJ;Fiji;5;0;116;2
2021-04-30;FJ;Fiji;1;0;117;2
2021-05-01;FJ;Fiji;2;0;119;2
2021-05-02;FJ;Fiji;0;0;119;2
2021-05-03;FJ;Fiji;2;0;121;2
2021-05-04;FJ;Fiji;0;0;121;2
2021-05-05;FJ;Fiji;4;0;125;2
2021-05-06;FJ;Fiji;4;1;129;3
2021-05-07;FJ;Fiji;0;0;129;3
2021-05-08;FJ;Fiji;7;0;136;3
2021-05-09;FJ;Fiji;3;0;139;3
2021-05-10;FJ;Fiji;1;0;140;3
2021-05-11;FJ;Fiji;12;0;152;3
2021-05-12;FJ;Fiji;9;0;161;3
2021-05-13;FJ;Fiji;4;1;165;4
2021-05-14;FJ;Fiji;1;0;166;4
2021-05-15;FJ;Fiji;0;0;166;4
2021-05-16;FJ;Fiji;6;0;172;4
2021-05-17;FJ;Fiji;2;0;174;4
2021-05-18;FJ;Fiji;4;0;178;4
2021-05-19;FJ;Fiji;0;0;178;4
2021-05-20;FJ;Fiji;12;0;190;4
2021-05-21;FJ;Fiji;5;0;195;4
2021-05-22;FJ;Fiji;29;0;224;4
2021-05-23;FJ;Fiji;6;0;230;4
2021-05-24;FJ;Fiji;8;0;238;4
2021-05-25;FJ;Fiji;21;0;259;4
2021-05-26;FJ;Fiji;27;0;286;4
2021-05-27;FJ;Fiji;28;0;314;4
2021-05-28;FJ;Fiji;46;0;360;4
2021-05-29;FJ;Fiji;0;0;360;4
2021-05-30;FJ;Fiji;41;0;401;4
2021-05-31;FJ;Fiji;37;0;438;4
2021-06-01;FJ;Fiji;26;0;464;4
2021-06-02;FJ;Fiji;44;0;508;4
2021-06-03;FJ;Fiji;28;0;536;4
2021-06-04;FJ;Fiji;35;0;571;4
2021-06-05;FJ;Fiji;33;0;604;4
2021-06-06;FJ;Fiji;83;0;687;4
2021-06-07;FJ;Fiji;64;0;751;4
2021-06-08;FJ;Fiji;94;0;845;4
2021-06-09;FJ;Fiji;35;0;880;4
2021-06-10;FJ;Fiji;39;0;919;4
2021-06-11;FJ;Fiji;51;0;970;4
2021-06-12;FJ;Fiji;44;0;1014;4
2021-06-13;FJ;Fiji;104;0;1118;4
2021-06-14;FJ;Fiji;88;0;1206;4
2021-06-15;FJ;Fiji;116;1;1322;5
2021-06-16;FJ;Fiji;121;0;1443;5
2021-06-17;FJ;Fiji;90;1;1533;6
2021-06-18;FJ;Fiji;115;0;1648;6
2021-06-19;FJ;Fiji;150;0;1798;6
2021-06-20;FJ;Fiji;166;1;1964;7
2021-06-21;FJ;Fiji;126;0;2090;7
2021-06-22;FJ;Fiji;180;2;2270;9
2021-06-23;FJ;Fiji;279;4;2549;13
2021-06-24;FJ;Fiji;299;0;2848;13
2021-06-25;FJ;Fiji;215;1;3063;14
2021-06-26;FJ;Fiji;266;1;3329;15
2021-06-27;FJ;Fiji;262;0;3591;15
2021-06-28;FJ;Fiji;241;2;3832;17
2021-06-29;FJ;Fiji;312;4;4144;21
2021-06-30;FJ;Fiji;274;0;4418;21
2021-07-01;FJ;Fiji;431;3;4849;24
2020-01-29;FI;Finland;1;0;1;0
2020-01-30;FI;Finland;0;0;1;0
2020-01-31;FI;Finland;0;0;1;0
2020-02-01;FI;Finland;0;0;1;0
2020-02-02;FI;Finland;0;0;1;0
2020-02-03;FI;Finland;0;0;1;0
2020-02-04;FI;Finland;0;0;1;0
2020-02-05;FI;Finland;0;0;1;0
2020-02-06;FI;Finland;0;0;1;0
2020-02-07;FI;Finland;0;0;1;0
2020-02-08;FI;Finland;0;0;1;0
2020-02-09;FI;Finland;0;0;1;0
2020-02-10;FI;Finland;0;0;1;0
2020-02-11;FI;Finland;0;0;1;0
2020-02-12;FI;Finland;0;0;1;0
2020-02-13;FI;Finland;0;0;1;0
2020-02-14;FI;Finland;0;0;1;0
2020-02-15;FI;Finland;0;0;1;0
2020-02-16;FI;Finland;0;0;1;0
2020-02-17;FI;Finland;0;0;1;0
2020-02-18;FI;Finland;0;0;1;0
2020-02-19;FI;Finland;0;0;1;0
2020-02-20;FI;Finland;0;0;1;0
2020-02-21;FI;Finland;0;0;1;0
2020-02-22;FI;Finland;0;0;1;0
2020-02-23;FI;Finland;0;0;1;0
2020-02-24;FI;Finland;0;0;1;0
2020-02-25;FI;Finland;0;0;1;0
2020-02-26;FI;Finland;1;0;2;0
2020-02-27;FI;Finland;0;0;2;0
2020-02-28;FI;Finland;0;0;2;0
2020-02-29;FI;Finland;1;0;3;0
2020-03-01;FI;Finland;3;0;6;0
2020-03-02;FI;Finland;0;0;6;0
2020-03-03;FI;Finland;0;0;6;0
2020-03-04;FI;Finland;0;0;6;0
2020-03-05;FI;Finland;6;0;12;0
2020-03-06;FI;Finland;3;0;15;0
2020-03-07;FI;Finland;0;0;15;0
2020-03-08;FI;Finland;8;0;23;0
2020-03-09;FI;Finland;7;0;30;0
2020-03-10;FI;Finland;10;0;40;0
2020-03-11;FI;Finland;19;0;59;0
2020-03-12;FI;Finland;0;0;59;0
2020-03-13;FI;Finland;96;0;155;0
2020-03-14;FI;Finland;70;0;225;0
2020-03-15;FI;Finland;19;0;244;0
2020-03-16;FI;Finland;33;0;277;0
2020-03-17;FI;Finland;44;0;321;0
2020-03-18;FI;Finland;15;0;336;0
2020-03-19;FI;Finland;64;0;400;0
2020-03-20;FI;Finland;50;0;450;0
2020-03-21;FI;Finland;73;1;523;1
2020-03-22;FI;Finland;103;0;626;1
2020-03-23;FI;Finland;74;0;700;1
2020-03-24;FI;Finland;92;0;792;1
2020-03-25;FI;Finland;88;2;880;3
2020-03-26;FI;Finland;78;2;958;5
2020-03-27;FI;Finland;83;2;1041;7
2020-03-28;FI;Finland;126;2;1167;9
2020-03-29;FI;Finland;73;2;1240;11
2020-03-30;FI;Finland;112;2;1352;13
2020-03-31;FI;Finland;66;4;1418;17
2020-04-01;FI;Finland;28;0;1446;17
2020-04-02;FI;Finland;72;2;1518;19
2020-04-03;FI;Finland;97;1;1615;20
2020-04-04;FI;Finland;267;5;1882;25
2020-04-05;FI;Finland;45;3;1927;28
2020-04-06;FI;Finland;249;-1;2176;27
2020-04-07;FI;Finland;132;7;2308;34
2020-04-08;FI;Finland;179;6;2487;40
2020-04-09;FI;Finland;118;2;2605;42
2020-04-10;FI;Finland;164;6;2769;48
2020-04-11;FI;Finland;136;1;2905;49
2020-04-12;FI;Finland;69;7;2974;56
2020-04-13;FI;Finland;90;3;3064;59
2020-04-14;FI;Finland;97;5;3161;64
2020-04-15;FI;Finland;76;8;3237;72
2020-04-16;FI;Finland;132;3;3369;75
2020-04-17;FI;Finland;120;7;3489;82
2020-04-18;FI;Finland;192;8;3681;90
2020-04-19;FI;Finland;102;4;3783;94
2020-04-20;FI;Finland;85;4;3868;98
2020-04-21;FI;Finland;146;43;4014;141
2020-04-22;FI;Finland;115;8;4129;149
2020-04-23;FI;Finland;155;23;4284;172
2020-04-24;FI;Finland;111;5;4395;177
2020-04-25;FI;Finland;80;9;4475;186
2020-04-26;FI;Finland;101;4;4576;190
2020-04-27;FI;Finland;119;3;4695;193
2020-04-28;FI;Finland;45;6;4740;199
2020-04-29;FI;Finland;166;7;4906;206
2020-04-30;FI;Finland;89;5;4995;211
2020-05-01;FI;Finland;56;7;5051;218
2020-05-02;FI;Finland;125;2;5176;220
2020-05-03;FI;Finland;78;10;5254;230
2020-05-04;FI;Finland;73;10;5327;240
2020-05-05;FI;Finland;85;6;5412;246
2020-05-06;FI;Finland;161;6;5573;252
2020-05-07;FI;Finland;100;3;5673;255
2020-05-08;FI;Finland;65;5;5738;260
2020-05-09;FI;Finland;142;5;5880;265
2020-05-10;FI;Finland;82;2;5962;267
2020-05-11;FI;Finland;22;4;5984;271
2020-05-12;FI;Finland;19;4;6003;275
2020-05-13;FI;Finland;51;9;6054;284
2020-05-14;FI;Finland;91;3;6145;287
2020-05-15;FI;Finland;83;6;6228;293
2020-05-16;FI;Finland;58;4;6286;297
2020-05-17;FI;Finland;61;1;6347;298
2020-05-18;FI;Finland;33;2;6380;300
2020-05-19;FI;Finland;19;1;6399;301
2020-05-20;FI;Finland;44;3;6443;304
2020-05-21;FI;Finland;50;2;6493;306
2020-05-22;FI;Finland;44;0;6537;306
2020-05-23;FI;Finland;31;0;6568;306
2020-05-24;FI;Finland;11;1;6579;307
2020-05-25;FI;Finland;20;1;6599;308
2020-05-26;FI;Finland;29;4;6628;312
2020-05-27;FI;Finland;64;1;6692;313
2020-05-28;FI;Finland;51;0;6743;313
2020-05-29;FI;Finland;33;1;6776;314
2020-05-30;FI;Finland;50;2;6826;316
2020-05-31;FI;Finland;33;4;6859;320
2020-06-01;FI;Finland;26;-2;6885;318
2020-06-02;FI;Finland;2;2;6887;320
2020-06-03;FI;Finland;24;1;6911;321
2020-06-04;FI;Finland;0;1;6911;322
2020-06-05;FI;Finland;30;0;6941;322
2020-06-06;FI;Finland;23;0;6964;322
2020-06-07;FI;Finland;17;1;6981;323
2020-06-08;FI;Finland;20;0;7001;323
2020-06-09;FI;Finland;24;1;7025;324
2020-06-10;FI;Finland;15;0;7040;324
2020-06-11;FI;Finland;24;1;7064;325
2020-06-12;FI;Finland;9;0;7073;325
2020-06-13;FI;Finland;14;0;7087;325
2020-06-14;FI;Finland;17;1;7104;326
2020-06-15;FI;Finland;4;0;7108;326
2020-06-16;FI;Finland;4;0;7112;326
2020-06-17;FI;Finland;5;0;7117;326
2020-06-18;FI;Finland;2;0;7119;326
2020-06-19;FI;Finland;14;0;7133;326
2020-06-20;FI;Finland;9;0;7142;326
2020-06-21;FI;Finland;1;0;7143;326
2020-06-22;FI;Finland;1;1;7144;327
2020-06-23;FI;Finland;11;0;7155;327
2020-06-24;FI;Finland;12;0;7167;327
2020-06-25;FI;Finland;5;0;7172;327
2020-06-26;FI;Finland;19;1;7191;328
2020-06-27;FI;Finland;7;0;7198;328
2020-06-28;FI;Finland;0;0;7198;328
2020-06-29;FI;Finland;11;0;7209;328
2020-06-30;FI;Finland;5;0;7214;328
2020-07-01;FI;Finland;22;0;7236;328
2020-07-02;FI;Finland;5;0;7241;328
2020-07-03;FI;Finland;1;1;7242;329
2020-07-04;FI;Finland;6;0;7248;329
2020-07-05;FI;Finland;5;0;7253;329
2020-07-06;FI;Finland;4;0;7257;329
2020-07-07;FI;Finland;5;0;7262;329
2020-07-08;FI;Finland;3;0;7265;329
2020-07-09;FI;Finland;8;0;7273;329
2020-07-10;FI;Finland;6;0;7279;329
2020-07-11;FI;Finland;12;0;7291;329
2020-07-12;FI;Finland;3;0;7294;329
2020-07-13;FI;Finland;1;0;7295;329
2020-07-14;FI;Finland;6;0;7301;329
2020-07-15;FI;Finland;-5;-1;7296;328
2020-07-16;FI;Finland;-3;0;7293;328
2020-07-17;FI;Finland;8;0;7301;328
2020-07-18;FI;Finland;17;0;7318;328
2020-07-19;FI;Finland;17;0;7335;328
2020-07-20;FI;Finland;5;0;7340;328
2020-07-21;FI;Finland;11;0;7351;328
2020-07-22;FI;Finland;11;0;7362;328
2020-07-23;FI;Finland;10;0;7372;328
2020-07-24;FI;Finland;8;1;7380;329
2020-07-25;FI;Finland;8;0;7388;329
2020-07-26;FI;Finland;5;0;7393;329
2020-07-27;FI;Finland;5;0;7398;329
2020-07-28;FI;Finland;6;0;7404;329
2020-07-29;FI;Finland;10;0;7414;329
2020-07-30;FI;Finland;9;0;7423;329
2020-07-31;FI;Finland;9;0;7432;329
2020-08-01;FI;Finland;11;0;7443;329
2020-08-02;FI;Finland;10;0;7453;329
2020-08-03;FI;Finland;13;0;7466;329
2020-08-04;FI;Finland;17;2;7483;331
2020-08-05;FI;Finland;29;0;7512;331
2020-08-06;FI;Finland;20;0;7532;331
2020-08-07;FI;Finland;22;0;7554;331
2020-08-08;FI;Finland;14;0;7568;331
2020-08-09;FI;Finland;16;0;7584;331
2020-08-10;FI;Finland;17;2;7601;333
2020-08-11;FI;Finland;22;0;7623;333
2020-08-12;FI;Finland;19;0;7642;333
2020-08-13;FI;Finland;41;0;7683;333
2020-08-14;FI;Finland;17;0;7700;333
2020-08-15;FI;Finland;20;0;7720;333
2020-08-16;FI;Finland;11;0;7731;333
2020-08-17;FI;Finland;21;1;7752;334
2020-08-18;FI;Finland;24;0;7776;334
2020-08-19;FI;Finland;29;0;7805;334
2020-08-20;FI;Finland;37;0;7842;334
2020-08-21;FI;Finland;29;0;7871;334
2020-08-22;FI;Finland;35;0;7906;334
2020-08-23;FI;Finland;14;0;7920;334
2020-08-24;FI;Finland;18;1;7938;335
2020-08-25;FI;Finland;43;0;7981;335
2020-08-26;FI;Finland;21;0;8002;335
2020-08-27;FI;Finland;17;0;8019;335
2020-08-28;FI;Finland;23;0;8042;335
2020-08-29;FI;Finland;7;0;8049;335
2020-08-30;FI;Finland;28;0;8077;335
2020-08-31;FI;Finland;9;1;8086;336
2020-09-01;FI;Finland;56;0;8142;336
2020-09-02;FI;Finland;19;0;8161;336
2020-09-03;FI;Finland;39;0;8200;336
2020-09-04;FI;Finland;25;0;8225;336
2020-09-05;FI;Finland;36;0;8261;336
2020-09-06;FI;Finland;30;0;8291;336
2020-09-07;FI;Finland;36;0;8327;336
2020-09-08;FI;Finland;10;0;8337;336
2020-09-09;FI;Finland;93;1;8430;337
2020-09-10;FI;Finland;39;0;8469;337
2020-09-11;FI;Finland;43;0;8512;337
2020-09-12;FI;Finland;45;0;8557;337
2020-09-13;FI;Finland;23;0;8580;337
2020-09-14;FI;Finland;47;0;8627;337
2020-09-15;FI;Finland;98;2;8725;339
2020-09-16;FI;Finland;25;0;8750;339
2020-09-17;FI;Finland;49;0;8799;339
2020-09-18;FI;Finland;59;0;8858;339
2020-09-19;FI;Finland;64;0;8922;339
2020-09-20;FI;Finland;58;0;8980;339
2020-09-21;FI;Finland;66;2;9046;341
2020-09-22;FI;Finland;149;0;9195;341
2020-09-23;FI;Finland;93;2;9288;343
2020-09-24;FI;Finland;91;0;9379;343
2020-09-25;FI;Finland;105;0;9484;343
2020-09-26;FI;Finland;93;0;9577;343
2020-09-27;FI;Finland;105;0;9682;343
2020-09-28;FI;Finland;61;2;9743;345
2020-09-29;FI;Finland;149;0;9892;345
2020-09-30;FI;Finland;100;-1;9992;344
2020-10-01;FI;Finland;111;0;10103;344
2020-10-02;FI;Finland;141;1;10244;345
2020-10-03;FI;Finland;147;0;10391;345
2020-10-04;FI;Finland;147;0;10538;345
2020-10-05;FI;Finland;164;1;10702;346
2020-10-06;FI;Finland;227;0;10929;346
2020-10-07;FI;Finland;120;0;11049;346
2020-10-08;FI;Finland;296;0;11345;346
2020-10-09;FI;Finland;235;0;11580;346
2020-10-10;FI;Finland;269;0;11849;346
2020-10-11;FI;Finland;149;0;11998;346
2020-10-12;FI;Finland;214;0;12212;346
2020-10-13;FI;Finland;287;0;12499;346
2020-10-14;FI;Finland;204;4;12703;350
2020-10-15;FI;Finland;241;0;12944;350
2020-10-16;FI;Finland;189;1;13133;351
2020-10-17;FI;Finland;160;0;13293;351
2020-10-18;FI;Finland;131;0;13424;351
2020-10-19;FI;Finland;131;0;13555;351
2020-10-20;FI;Finland;294;0;13849;351
2020-10-21;FI;Finland;222;4;14071;355
2020-10-22;FI;Finland;184;0;14255;355
2020-10-23;FI;Finland;219;-2;14474;353
2020-10-24;FI;Finland;178;0;14652;353
2020-10-25;FI;Finland;196;0;14848;353
2020-10-26;FI;Finland;122;1;14970;354
2020-10-27;FI;Finland;193;0;15163;354
2020-10-28;FI;Finland;215;0;15378;354
2020-10-29;FI;Finland;188;0;15566;354
2020-10-30;FI;Finland;344;4;15910;358
2020-10-31;FI;Finland;203;0;16113;358
2020-11-01;FI;Finland;178;0;16291;358
2020-11-02;FI;Finland;109;1;16400;359
2020-11-03;FI;Finland;237;0;16637;359
2020-11-04;FI;Finland;293;2;16930;361
2020-11-05;FI;Finland;189;0;17119;361
2020-11-06;FI;Finland;266;1;17385;362
2020-11-07;FI;Finland;0;0;17385;362
2020-11-08;FI;Finland;412;0;17797;362
2020-11-09;FI;Finland;90;1;17887;363
2020-11-10;FI;Finland;220;0;18107;363
2020-11-11;FI;Finland;238;2;18345;365
2020-11-12;FI;Finland;197;0;18542;365
2020-11-13;FI;Finland;316;4;18858;369
2020-11-14;FI;Finland;244;0;19102;369
2020-11-15;FI;Finland;213;0;19315;369
2020-11-16;FI;Finland;104;2;19419;371
2020-11-17;FI;Finland;228;0;19647;371
2020-11-18;FI;Finland;288;3;19935;374
2020-11-19;FI;Finland;351;0;20286;374
2020-11-20;FI;Finland;461;1;20747;375
2020-11-21;FI;Finland;469;0;21216;375
2020-11-22;FI;Finland;423;0;21639;375
2020-11-23;FI;Finland;297;9;21936;384
2020-11-24;FI;Finland;353;0;22289;384
2020-11-25;FI;Finland;363;4;22652;388
2020-11-26;FI;Finland;496;0;23148;388
2020-11-27;FI;Finland;618;5;23766;393
2020-11-28;FI;Finland;541;0;24307;393
2020-11-29;FI;Finland;322;0;24629;393
2020-11-30;FI;Finland;283;6;24912;399
2020-12-01;FI;Finland;550;0;25462;399
2020-12-02;FI;Finland;420;9;25882;408
2020-12-03;FI;Finland;540;0;26422;408
2020-12-04;FI;Finland;336;0;26758;408
2020-12-05;FI;Finland;460;7;27218;415
2020-12-06;FI;Finland;413;0;27631;415
2020-12-07;FI;Finland;250;9;27881;424
2020-12-08;FI;Finland;361;0;28242;424
2020-12-09;FI;Finland;490;9;28732;433
2020-12-10;FI;Finland;840;9;29572;442
2020-12-11;FI;Finland;501;11;30073;453
2020-12-12;FI;Finland;377;0;30450;453
2020-12-13;FI;Finland;360;0;30810;453
2020-12-14;FI;Finland;300;8;31110;461
2020-12-15;FI;Finland;349;5;31459;466
2020-12-16;FI;Finland;411;6;31870;472
2020-12-17;FI;Finland;358;12;32228;484
2020-12-18;FI;Finland;354;5;32582;489
2020-12-19;FI;Finland;271;0;32853;489
2020-12-20;FI;Finland;309;0;33162;489
2020-12-21;FI;Finland;252;17;33414;506
2020-12-22;FI;Finland;303;5;33717;511
2020-12-23;FI;Finland;367;13;34084;524
2020-12-24;FI;Finland;363;0;34447;524
2020-12-25;FI;Finland;201;0;34648;524
2020-12-26;FI;Finland;173;0;34821;524
2020-12-27;FI;Finland;156;0;34977;524
2020-12-28;FI;Finland;160;22;35137;546
2020-12-29;FI;Finland;283;4;35420;550
2020-12-30;FI;Finland;438;6;35858;556
2020-12-31;FI;Finland;249;5;36107;561
2021-01-01;FI;Finland;296;0;36403;561
2021-01-02;FI;Finland;201;0;36604;561
2021-01-03;FI;Finland;168;0;36772;561
2021-01-04;FI;Finland;147;4;36919;565
2021-01-05;FI;Finland;299;11;37218;576
2021-01-06;FI;Finland;331;0;37549;576
2021-01-07;FI;Finland;223;8;37772;584
2021-01-08;FI;Finland;296;2;38068;586
2021-01-09;FI;Finland;324;0;38392;586
2021-01-10;FI;Finland;198;0;38590;586
2021-01-11;FI;Finland;200;11;38790;597
2021-01-12;FI;Finland;221;5;39011;602
2021-01-13;FI;Finland;324;0;39335;602
2021-01-14;FI;Finland;258;14;39593;616
2021-01-15;FI;Finland;318;2;39911;618
2021-01-16;FI;Finland;190;0;40101;618
2021-01-17;FI;Finland;236;0;40337;618
2021-01-18;FI;Finland;168;0;40505;618
2021-01-19;FI;Finland;217;3;40722;621
2021-01-20;FI;Finland;444;11;41166;632
2021-01-21;FI;Finland;399;0;41565;632
2021-01-22;FI;Finland;350;12;41915;644
2021-01-23;FI;Finland;419;0;42334;644
2021-01-24;FI;Finland;246;0;42580;644
2021-01-25;FI;Finland;192;11;42772;655
2021-01-26;FI;Finland;348;0;43120;655
2021-01-27;FI;Finland;496;5;43616;660
2021-01-28;FI;Finland;423;4;44039;664
2021-01-29;FI;Finland;363;7;44402;671
2021-01-30;FI;Finland;469;0;44871;671
2021-01-31;FI;Finland;367;0;45238;671
2021-02-01;FI;Finland;244;6;45482;677
2021-02-02;FI;Finland;302;7;45784;684
2021-02-03;FI;Finland;265;1;46049;685
2021-02-04;FI;Finland;444;3;46493;688
2021-02-05;FI;Finland;401;0;46894;688
2021-02-06;FI;Finland;368;0;47262;688
2021-02-07;FI;Finland;354;0;47616;688
2021-02-08;FI;Finland;353;0;47969;688
2021-02-09;FI;Finland;438;15;48407;703
2021-02-10;FI;Finland;400;0;48807;703
2021-02-11;FI;Finland;358;5;49165;708
2021-02-12;FI;Finland;407;2;49572;710
2021-02-13;FI;Finland;435;0;50007;710
2021-02-14;FI;Finland;312;0;50319;710
2021-02-15;FI;Finland;343;6;50662;716
2021-02-16;FI;Finland;385;4;51047;720
2021-02-17;FI;Finland;548;3;51595;723
2021-02-18;FI;Finland;614;2;52209;725
2021-02-19;FI;Finland;444;0;52653;725
2021-02-20;FI;Finland;632;1;53285;726
2021-02-21;FI;Finland;457;0;53742;726
2021-02-22;FI;Finland;390;7;54132;733
2021-02-23;FI;Finland;400;1;54532;734
2021-02-24;FI;Finland;590;3;55122;737
2021-02-25;FI;Finland;565;3;55687;740
2021-02-26;FI;Finland;720;2;56407;742
2021-02-27;FI;Finland;645;0;57052;742
2021-02-28;FI;Finland;620;0;57672;742
2021-03-01;FI;Finland;392;8;58064;750
2021-03-02;FI;Finland;581;5;58645;755
2021-03-03;FI;Finland;797;4;59442;759
2021-03-04;FI;Finland;758;5;60200;764
2021-03-05;FI;Finland;704;3;60904;767
2021-03-06;FI;Finland;648;0;61552;767
2021-03-07;FI;Finland;511;0;62063;767
2021-03-08;FI;Finland;459;7;62522;774
2021-03-09;FI;Finland;588;2;63110;776
2021-03-10;FI;Finland;779;0;63889;776
2021-03-11;FI;Finland;720;0;64609;776
2021-03-12;FI;Finland;706;10;65315;786
2021-03-13;FI;Finland;691;0;66006;786
2021-03-14;FI;Finland;863;0;66869;786
2021-03-15;FI;Finland;465;14;67334;800
2021-03-16;FI;Finland;517;1;67851;801
2021-03-17;FI;Finland;842;3;68693;804
2021-03-18;FI;Finland;804;1;69497;805
2021-03-19;FI;Finland;770;0;70267;805
2021-03-20;FI;Finland;856;0;71123;805
2021-03-21;FI;Finland;520;0;71643;805
2021-03-22;FI;Finland;430;3;72073;808
2021-03-23;FI;Finland;640;0;72713;808
2021-03-24;FI;Finland;803;1;73516;809
2021-03-25;FI;Finland;726;6;74242;815
2021-03-26;FI;Finland;512;2;74754;817
2021-03-27;FI;Finland;791;0;75545;817
2021-03-28;FI;Finland;458;0;76003;817
2021-03-29;FI;Finland;422;5;76425;822
2021-03-30;FI;Finland;420;4;76845;826
2021-03-31;FI;Finland;607;18;77452;844
2021-04-01;FI;Finland;654;2;78106;846
2021-04-02;FI;Finland;566;0;78672;846
2021-04-03;FI;Finland;422;0;79094;846
2021-04-04;FI;Finland;302;0;79396;846
2021-04-05;FI;Finland;341;0;79737;846
2021-04-06;FI;Finland;331;14;80068;860
2021-04-07;FI;Finland;348;2;80416;862
2021-04-08;FI;Finland;426;4;80842;866
2021-04-09;FI;Finland;419;2;81261;868
2021-04-10;FI;Finland;446;0;81707;868
2021-04-11;FI;Finland;346;0;82053;868
2021-04-12;FI;Finland;225;6;82278;874
2021-04-13;FI;Finland;286;3;82564;877
2021-04-14;FI;Finland;400;4;82964;881
2021-04-15;FI;Finland;289;4;83253;885
2021-04-16;FI;Finland;380;2;83633;887
2021-04-17;FI;Finland;0;0;83633;887
2021-04-18;FI;Finland;498;0;84131;887
2021-04-19;FI;Finland;156;4;84287;891
2021-04-20;FI;Finland;214;2;84501;893
2021-04-21;FI;Finland;296;6;84797;899
2021-04-22;FI;Finland;280;3;85077;902
2021-04-23;FI;Finland;267;1;85344;903
2021-04-24;FI;Finland;263;0;85607;903
2021-04-25;FI;Finland;197;0;85804;903
2021-04-26;FI;Finland;133;3;85937;906
2021-04-27;FI;Finland;224;2;86161;908
2021-04-28;FI;Finland;244;3;86405;911
2021-04-29;FI;Finland;208;2;86613;913
2021-04-30;FI;Finland;195;1;86808;914
2021-05-01;FI;Finland;288;0;87096;914
2021-05-02;FI;Finland;132;0;87228;914
2021-05-03;FI;Finland;117;1;87345;915
2021-05-04;FI;Finland;184;1;87529;916
2021-05-05;FI;Finland;269;2;87798;918
2021-05-06;FI;Finland;280;1;88078;919
2021-05-07;FI;Finland;254;3;88332;922
2021-05-08;FI;Finland;229;0;88561;922
2021-05-09;FI;Finland;162;0;88723;922
2021-05-10;FI;Finland;143;0;88866;922
2021-05-11;FI;Finland;124;5;88990;927
2021-05-12;FI;Finland;280;3;89270;930
2021-05-13;FI;Finland;262;0;89532;930
2021-05-14;FI;Finland;154;1;89686;931
2021-05-15;FI;Finland;192;0;89878;931
2021-05-16;FI;Finland;227;0;90105;931
2021-05-17;FI;Finland;144;2;90249;933
2021-05-18;FI;Finland;149;-4;90398;929
2021-05-19;FI;Finland;289;0;90687;929
2021-05-20;FI;Finland;259;0;90946;929
2021-05-21;FI;Finland;211;3;91157;932
2021-05-22;FI;Finland;248;0;91405;932
2021-05-23;FI;Finland;121;0;91526;932
2021-05-24;FI;Finland;93;7;91619;939
2021-05-25;FI;Finland;125;3;91744;942
2021-05-26;FI;Finland;220;4;91964;946
2021-05-27;FI;Finland;98;0;92062;946
2021-05-28;FI;Finland;182;2;92244;948
2021-05-29;FI;Finland;0;0;92244;948
2021-05-30;FI;Finland;188;0;92432;948
2021-05-31;FI;Finland;56;8;92488;956
2021-06-01;FI;Finland;154;0;92642;956
2021-06-02;FI;Finland;128;3;92770;959
2021-06-03;FI;Finland;143;0;92913;959
2021-06-04;FI;Finland;125;0;93038;959
2021-06-05;FI;Finland;120;0;93158;959
2021-06-06;FI;Finland;68;0;93226;959
2021-06-07;FI;Finland;55;0;93281;959
2021-06-08;FI;Finland;113;0;93394;959
2021-06-09;FI;Finland;126;0;93520;959
2021-06-10;FI;Finland;93;5;93613;964
2021-06-11;FI;Finland;47;0;93660;964
2021-06-12;FI;Finland;114;0;93774;964
2021-06-13;FI;Finland;47;0;93821;964
2021-06-14;FI;Finland;29;0;93850;964
2021-06-15;FI;Finland;73;0;93923;964
2021-06-16;FI;Finland;103;3;94026;967
2021-06-17;FI;Finland;55;0;94081;967
2021-06-18;FI;Finland;73;0;94154;967
2021-06-19;FI;Finland;115;0;94269;967
2021-06-20;FI;Finland;65;0;94334;967
2021-06-21;FI;Finland;45;0;94379;967
2021-06-22;FI;Finland;110;0;94489;967
2021-06-23;FI;Finland;107;2;94596;969
2021-06-24;FI;Finland;123;0;94719;969
2021-06-25;FI;Finland;0;0;94719;969
2021-06-26;FI;Finland;270;0;94989;969
2021-06-27;FI;Finland;95;0;95084;969
2021-06-28;FI;Finland;84;0;95168;969
2021-06-29;FI;Finland;219;0;95387;969
2021-06-30;FI;Finland;355;0;95742;969
2021-07-01;FI;Finland;222;4;95964;973
2020-01-24;FR;France;2;0;2;0
2020-01-25;FR;France;1;0;3;0
2020-01-26;FR;France;0;0;3;0
2020-01-27;FR;France;0;0;3;0
2020-01-28;FR;France;1;0;4;0
2020-01-29;FR;France;1;0;5;0
2020-01-30;FR;France;0;0;5;0
2020-01-31;FR;France;0;0;5;0
2020-02-01;FR;France;1;0;6;0
2020-02-02;FR;France;0;0;6;0
2020-02-03;FR;France;0;0;6;0
2020-02-04;FR;France;0;0;6;0
2020-02-05;FR;France;0;0;6;0
2020-02-06;FR;France;0;0;6;0
2020-02-07;FR;France;0;0;6;0
2020-02-08;FR;France;5;0;11;0
2020-02-09;FR;France;0;0;11;0
2020-02-10;FR;France;0;0;11;0
2020-02-11;FR;France;0;0;11;0
2020-02-12;FR;France;0;0;11;0
2020-02-13;FR;France;0;0;11;0
2020-02-14;FR;France;0;0;11;0
2020-02-15;FR;France;1;1;12;1
2020-02-16;FR;France;0;0;12;1
2020-02-17;FR;France;0;0;12;1
2020-02-18;FR;France;0;0;12;1
2020-02-19;FR;France;0;0;12;1
2020-02-20;FR;France;0;0;12;1
2020-02-21;FR;France;0;0;12;1
2020-02-22;FR;France;0;0;12;1
2020-02-23;FR;France;0;0;12;1
2020-02-24;FR;France;0;0;12;1
2020-02-25;FR;France;2;0;14;1
2020-02-26;FR;France;4;1;18;2
2020-02-27;FR;France;20;0;38;2
2020-02-28;FR;France;19;0;57;2
2020-02-29;FR;France;43;0;100;2
2020-03-01;FR;France;30;0;130;2
2020-03-02;FR;France;61;1;191;3
2020-03-03;FR;France;21;1;212;4
2020-03-04;FR;France;76;0;288;4
2020-03-05;FR;France;138;3;426;7
2020-03-06;FR;France;190;2;616;9
2020-03-07;FR;France;332;7;948;16
2020-03-08;FR;France;177;3;1125;19
2020-03-09;FR;France;286;6;1411;25
2020-03-10;FR;France;372;8;1783;33
2020-03-11;FR;France;510;15;2293;48
2020-03-12;FR;France;0;0;2293;48
2020-03-13;FR;France;1388;31;3681;79
2020-03-14;FR;France;815;12;4496;91
2020-03-15;FR;France;36;0;4532;91
2020-03-16;FR;France;2151;58;6683;149
2020-03-17;FR;France;1032;0;7715;149
2020-03-18;FR;France;1409;0;9124;149
2020-03-19;FR;France;1846;95;10970;244
2020-03-20;FR;France;1788;207;12758;451
2020-03-21;FR;France;1705;112;14463;563
2020-03-22;FR;France;2295;113;16758;676
2020-03-23;FR;France;3365;186;20123;862
2020-03-24;FR;France;2249;240;22372;1102
2020-03-25;FR;France;2962;231;25334;1333
2020-03-26;FR;France;3918;364;29252;1697
2020-03-27;FR;France;3795;299;33047;1996
2020-03-28;FR;France;4645;318;37692;2314
2020-03-29;FR;France;2603;294;40295;2608
2020-03-30;FR;France;4354;418;44649;3026
2020-03-31;FR;France;7629;500;52278;3526
2020-04-01;FR;France;4844;1252;57122;4778
2020-04-02;FR;France;2106;609;59228;5387
2020-04-03;FR;France;5224;1122;64452;6509
2020-04-04;FR;France;-17074;1053;47378;7562
2020-04-05;FR;France;855;519;48233;8081
2020-04-06;FR;France;2654;833;50887;8914
2020-04-07;FR;France;-3491;1416;47396;10330
2020-04-08;FR;France;3855;544;51251;10874
2020-04-09;FR;France;3784;1340;55035;12214
2020-04-10;FR;France;1565;985;56600;13199
2020-04-11;FR;France;1445;636;58045;13835
2020-04-12;FR;France;50746;561;108791;14396
2020-04-13;FR;France;3141;573;111932;14969
2020-04-14;FR;France;17448;743;129380;15712
2020-04-15;FR;France;3208;1438;132588;17150
2020-04-16;FR;France;12578;753;145166;17903
2020-04-17;FR;France;1891;761;147057;18664
2020-04-18;FR;France;3806;641;150863;19305
2020-04-19;FR;France;1092;389;151955;19694
2020-04-20;FR;France;2447;547;154402;20241
2020-04-21;FR;France;2666;528;157068;20769
2020-04-22;FR;France;1800;544;158868;21313
2020-04-23;FR;France;-1710;516;157158;21829
2020-04-24;FR;France;2811;390;159969;22219
2020-04-25;FR;France;1678;369;161647;22588
2020-04-26;FR;France;633;242;162280;22830
2020-04-27;FR;France;3686;437;165966;23267
2020-04-28;FR;France;3132;367;169098;23634
2020-04-29;FR;France;-1455;426;167643;24060
2020-04-30;FR;France;1218;289;168861;24349
2020-05-01;FR;France;526;217;169387;24566
2020-05-02;FR;France;792;197;170179;24763
2020-05-03;FR;France;361;135;170540;24898
2020-05-04;FR;France;562;306;171102;25204
2020-05-05;FR;France;1117;333;172219;25537
2020-05-06;FR;France;4136;275;176355;25812
2020-05-07;FR;France;741;179;177096;25991
2020-05-08;FR;France;531;242;177627;26233
2020-05-09;FR;France;529;80;178156;26313
2020-05-10;FR;France;249;70;178405;26383
2020-05-11;FR;France;314;263;178719;26646
2020-05-12;FR;France;753;348;179472;26994
2020-05-13;FR;France;521;85;179993;27079
2020-05-14;FR;France;642;351;180635;27430
2020-05-15;FR;France;513;102;181148;27532
2020-05-16;FR;France;415;98;181563;27630
2020-05-17;FR;France;140;483;181703;28113
2020-05-18;FR;France;444;129;182147;28242
2020-05-19;FR;France;501;-217;182648;28025
2020-05-20;FR;France;482;111;183130;28136
2020-05-21;FR;France;267;82;183397;28218
2020-05-22;FR;France;756;148;184153;28366
2020-05-23;FR;France;546;86;184699;28452
2020-05-24;FR;France;-439;-80;184260;28372
2020-05-25;FR;France;325;89;184585;28461
2020-05-26;FR;France;255;137;184840;28598
2020-05-27;FR;France;172;1;185012;28599
2020-05-28;FR;France;3343;67;188355;28666
2020-05-29;FR;France;594;51;188949;28717
2020-05-30;FR;France;1795;57;190744;28774
2020-05-31;FR;France;231;31;190975;28805
2020-06-01;FR;France;407;32;191382;28837
2020-06-02;FR;France;-647;106;190735;28943
2020-06-03;FR;France;-3226;81;187509;29024
2020-06-04;FR;France;4360;45;191869;29069
2020-06-05;FR;France;581;45;192450;29114
2020-06-06;FR;France;572;31;193022;29145
2020-06-07;FR;France;341;13;193363;29158
2020-06-08;FR;France;274;55;193637;29213
2020-06-09;FR;France;553;88;194190;29301
2020-06-10;FR;France;625;21;194815;29322
2020-06-11;FR;France;364;27;195179;29349
2020-06-12;FR;France;802;28;195981;29377
2020-06-13;FR;France;497;24;196478;29401
2020-06-14;FR;France;390;10;196868;29411
2020-06-15;FR;France;136;28;197004;29439
2020-06-16;FR;France;663;114;197667;29553
2020-06-17;FR;France;488;25;198155;29578
2020-06-18;FR;France;586;28;198741;29606
2020-06-19;FR;France;787;14;199528;29620
2020-06-20;FR;France;619;18;200147;29638
2020-06-21;FR;France;343;6;200490;29644
2020-06-22;FR;France;142;24;200632;29668
2020-06-23;FR;France;698;54;201330;29722
2020-06-24;FR;France;268;13;201598;29735
2020-06-25;FR;France;255;19;201853;29754
2020-06-26;FR;France;1263;26;203116;29780
2020-06-27;FR;France;448;1;203564;29781
2020-06-28;FR;France;-406;0;203158;29781
2020-06-29;FR;France;645;35;203803;29816
2020-06-30;FR;France;441;30;204244;29846
2020-07-01;FR;France;990;19;205234;29865
2020-07-02;FR;France;539;13;205773;29878
2020-07-03;FR;France;539;18;206312;29896
2020-07-04;FR;France;358;0;206670;29896
2020-07-05;FR;France;11;-1;206681;29895
2020-07-06;FR;France;1018;30;207699;29925
2020-07-07;FR;France;454;11;208153;29936
2020-07-08;FR;France;822;31;208975;29967
2020-07-09;FR;France;444;16;209419;29983
2020-07-10;FR;France;715;26;210134;30009
2020-07-11;FR;France;251;3;210385;30012
2020-07-12;FR;France;16;0;210401;30012
2020-07-13;FR;France;1423;23;211824;30035
2020-07-14;FR;France;62;2;211886;30037
2020-07-15;FR;France;727;88;212613;30125
2020-07-16;FR;France;569;17;213182;30142
2020-07-17;FR;France;829;13;214011;30155
2020-07-18;FR;France;163;3;214174;30158
2020-07-19;FR;France;4;0;214178;30158
2020-07-20;FR;France;1911;24;216089;30182
2020-07-21;FR;France;595;-13;216684;30169
2020-07-22;FR;France;921;6;217605;30175
2020-07-23;FR;France;1236;11;218841;30186
2020-07-24;FR;France;1091;10;219932;30196
2020-07-25;FR;France;88;0;220020;30196
2020-07-26;FR;France;0;0;220020;30196
2020-07-27;FR;France;2488;18;222508;30214
2020-07-28;FR;France;564;13;223072;30227
2020-07-29;FR;France;1470;14;224542;30241
2020-07-30;FR;France;1389;16;225931;30257
2020-07-31;FR;France;1308;11;227239;30268
2020-08-01;FR;France;63;0;227302;30268
2020-08-02;FR;France;3;0;227305;30268
2020-08-03;FR;France;3360;30;230665;30298
2020-08-04;FR;France;971;2;231636;30300
2020-08-05;FR;France;1708;11;233344;30311
2020-08-06;FR;France;1601;4;234945;30315
2020-08-07;FR;France;2387;13;237332;30328
2020-08-08;FR;France;70;1;237402;30329
2020-08-09;FR;France;35;0;237437;30329
2020-08-10;FR;France;4731;15;242168;30344
2020-08-11;FR;France;1414;14;243582;30358
2020-08-12;FR;France;2598;18;246180;30376
2020-08-13;FR;France;2678;17;248858;30393
2020-08-14;FR;France;2923;19;251781;30412
2020-08-15;FR;France;3210;1;254991;30413
2020-08-16;FR;France;3003;1;257994;30414
2020-08-17;FR;France;650;20;258644;30434
2020-08-18;FR;France;2119;22;260763;30456
2020-08-19;FR;France;3772;18;264535;30474
2020-08-20;FR;France;4800;11;269335;30485
2020-08-21;FR;France;5009;24;274344;30509
2020-08-22;FR;France;3474;9;277818;30518
2020-08-23;FR;France;4680;0;282498;30518
2020-08-24;FR;France;1976;16;284474;30534
2020-08-25;FR;France;3616;19;288090;30553
2020-08-26;FR;France;287;0;288377;30553
2020-08-27;FR;France;11203;35;299580;30588
2020-08-28;FR;France;7641;18;307221;30606
2020-08-29;FR;France;5460;6;312681;30612
2020-08-30;FR;France;5366;3;318047;30615
2020-08-31;FR;France;3113;31;321160;30646
2020-09-01;FR;France;5104;27;326264;30673
2020-09-02;FR;France;7113;27;333377;30700
2020-09-03;FR;France;7122;17;340499;30717
2020-09-04;FR;France;8834;-21;349333;30696
2020-09-05;FR;France;8594;12;357927;30708
2020-09-06;FR;France;7016;4;364943;30712
2020-09-07;FR;France;4266;23;369209;30735
2020-09-08;FR;France;6738;38;375947;30773
2020-09-09;FR;France;8619;32;384566;30805
2020-09-10;FR;France;9762;19;394328;30824
2020-09-11;FR;France;9509;82;403837;30906
2020-09-12;FR;France;11337;18;415174;30924
2020-09-13;FR;France;6345;5;421519;30929
2020-09-14;FR;France;6396;34;427915;30963
2020-09-15;FR;France;7826;50;435741;31013
2020-09-16;FR;France;10191;48;445932;31061
2020-09-17;FR;France;10239;47;456171;31108
2020-09-18;FR;France;13233;154;469404;31262
2020-09-19;FR;France;13560;25;482964;31287
2020-09-20;FR;France;10536;11;493500;31298
2020-09-21;FR;France;5539;53;499039;31351
2020-09-22;FR;France;10084;79;509123;31430
2020-09-23;FR;France;13291;48;522414;31478
2020-09-24;FR;France;15850;46;538264;31524
2020-09-25;FR;France;16104;151;554368;31675
2020-09-26;FR;France;14220;39;568588;31714
2020-09-27;FR;France;10635;27;579223;31741
2020-09-28;FR;France;4299;84;583522;31825
2020-09-29;FR;France;8005;73;591527;31898
2020-09-30;FR;France;14366;80;605893;31978
2020-10-01;FR;France;13051;57;618944;32035
2020-10-02;FR;France;12436;136;631380;32171
2020-10-03;FR;France;16488;25;647868;32196
2020-10-04;FR;France;12504;32;660372;32228
2020-10-05;FR;France;5639;71;666011;32299
2020-10-06;FR;France;11310;87;677321;32386
2020-10-07;FR;France;18953;80;696274;32466
2020-10-08;FR;France;17402;73;713676;32539
2020-10-09;FR;France;21088;110;734764;32649
2020-10-10;FR;France;26677;35;761441;32684
2020-10-11;FR;France;15937;46;777378;32730
2020-10-12;FR;France;9212;97;786590;32827
2020-10-13;FR;France;13626;128;800216;32955
2020-10-14;FR;France;23002;106;823218;33061
2020-10-15;FR;France;29757;85;852975;33146
2020-10-16;FR;France;25632;179;878607;33325
2020-10-17;FR;France;32104;73;910711;33398
2020-10-18;FR;France;29837;85;940548;33483
2020-10-19;FR;France;14289;148;954837;33631
2020-10-20;FR;France;20376;281;975213;33912
2020-10-21;FR;France;27422;168;1002635;34080
2020-10-22;FR;France;40813;154;1043448;34234
2020-10-23;FR;France;42837;300;1086285;34534
2020-10-24;FR;France;45265;136;1131550;34670
2020-10-25;FR;France;6616;-21;1138166;34649
2020-10-26;FR;France;73010;389;1211176;35038
2020-10-27;FR;France;34482;529;1245658;35567
2020-10-28;FR;France;37550;259;1283208;35826
2020-10-29;FR;France;46612;232;1329820;36058
2020-10-30;FR;France;49474;547;1379294;36605
2020-10-31;FR;France;35070;222;1414364;36827
2020-11-01;FR;France;46179;231;1460543;37058
2020-11-02;FR;France;106091;428;1566634;37486
2020-11-03;FR;France;72601;1279;1639235;38765
2020-11-04;FR;France;-46076;-31;1593159;38734
2020-11-05;FR;France;57806;354;1650965;39088
2020-11-06;FR;France;60952;829;1711917;39917
2020-11-07;FR;France;86655;303;1798572;40220
2020-11-08;FR;France;38562;270;1837134;40490
2020-11-09;FR;France;21424;560;1858558;41050
2020-11-10;FR;France;22613;1231;1881171;42281
2020-11-11;FR;France;36406;328;1917577;42609
2020-11-12;FR;France;32628;415;1950205;43024
2020-11-13;FR;France;24065;933;1974270;43957
2020-11-14;FR;France;31957;353;2006227;44310
2020-11-15;FR;France;27192;303;2033419;44613
2020-11-16;FR;France;10050;511;2043469;45124
2020-11-17;FR;France;45602;1226;2089071;46350
2020-11-18;FR;France;28897;431;2117968;46781
2020-11-19;FR;France;20736;417;2138704;47198
2020-11-20;FR;France;23264;1141;2161968;48339
2020-11-21;FR;France;17670;252;2179638;48591
2020-11-22;FR;France;13130;214;2192768;48805
2020-11-23;FR;France;5062;506;2197830;49311
2020-11-24;FR;France;9921;1011;2207751;50322
2020-11-25;FR;France;16754;388;2224505;50710
2020-11-26;FR;France;13001;331;2237506;51041
2020-11-27;FR;France;12774;959;2250280;52000
2020-11-28;FR;France;12477;212;2262757;52212
2020-11-29;FR;France;9763;198;2272520;52410
2020-11-30;FR;France;4354;409;2276874;52819
2020-12-01;FR;France;8364;777;2285238;53596
2020-12-02;FR;France;14228;311;2299466;53907
2020-12-03;FR;France;12787;324;2312253;54231
2020-12-04;FR;France;11511;630;2323764;54861
2020-12-05;FR;France;12882;212;2336646;55073
2020-12-06;FR;France;10949;174;2347595;55247
2020-12-07;FR;France;3411;366;2351006;55613
2020-12-08;FR;France;14037;838;2365043;56451
2020-12-09;FR;France;14675;297;2379718;56748
2020-12-10;FR;France;13872;296;2393590;57044
2020-12-11;FR;France;13489;628;2407079;57672
2020-12-12;FR;France;13947;193;2421026;57865
2020-12-13;FR;France;11533;150;2432559;58015
2020-12-14;FR;France;3192;376;2435751;58391
2020-12-15;FR;France;11655;791;2447406;59182
2020-12-16;FR;France;17720;290;2465126;59472
2020-12-17;FR;France;18398;261;2483524;59733
2020-12-18;FR;France;16005;612;2499529;60345
2020-12-19;FR;France;17428;189;2516957;60534
2020-12-20;FR;France;12799;131;2529756;60665
2020-12-21;FR;France;5960;354;2535716;61019
2020-12-22;FR;France;11861;802;2547577;61821
2020-12-23;FR;France;15038;277;2562615;62098
2020-12-24;FR;France;21718;291;2584333;62389
2020-12-25;FR;France;20262;159;2604595;62548
2020-12-26;FR;France;3093;146;2607688;62694
2020-12-27;FR;France;8822;173;2616510;62867
2020-12-28;FR;France;3106;368;2619616;63235
2020-12-29;FR;France;11494;969;2631110;64204
2020-12-30;FR;France;26514;304;2657624;64508
2020-12-31;FR;France;20042;251;2677666;64759
2021-01-01;FR;France;19348;133;2697014;64892
2021-01-02;FR;France;3466;156;2700480;65048
2021-01-03;FR;France;12495;116;2712975;65164
2021-01-04;FR;France;4084;385;2717059;65549
2021-01-05;FR;France;20825;868;2737884;66417
2021-01-06;FR;France;25232;282;2763116;66699
2021-01-07;FR;France;21767;276;2784883;66975
2021-01-08;FR;France;19860;591;2804743;67566
2021-01-09;FR;France;20177;168;2824920;67734
2021-01-10;FR;France;15944;151;2840864;67885
2021-01-11;FR;France;3816;312;2844680;68197
2021-01-12;FR;France;19680;742;2864360;68939
2021-01-13;FR;France;23932;229;2888292;69168
2021-01-14;FR;France;21431;284;2909723;69452
2021-01-15;FR;France;21317;636;2931040;70088
2021-01-16;FR;France;21409;193;2952449;70281
2021-01-17;FR;France;16642;141;2969091;70422
2021-01-18;FR;France;3798;404;2972889;70826
2021-01-19;FR;France;23895;656;2996784;71482
2021-01-20;FR;France;26877;310;3023661;71792
2021-01-21;FR;France;22710;347;3046371;72139
2021-01-22;FR;France;23324;649;3069695;72788
2021-01-23;FR;France;23924;230;3093619;73018
2021-01-24;FR;France;18436;172;3112055;73190
2021-01-25;FR;France;4300;446;3116355;73636
2021-01-26;FR;France;22143;614;3138498;74250
2021-01-27;FR;France;26951;350;3165449;74600
2021-01-28;FR;France;23956;344;3189405;74944
2021-01-29;FR;France;23235;821;3212640;75765
2021-01-30;FR;France;24045;241;3236685;76006
2021-01-31;FR;France;19235;195;3255920;76201
2021-02-01;FR;France;4388;456;3260308;76657
2021-02-02;FR;France;23337;726;3283645;77383
2021-02-03;FR;France;26406;358;3310051;77741
2021-02-04;FR;France;20;0;3310071;77741
2021-02-05;FR;France;45607;1008;3355678;78749
2021-02-06;FR;France;20588;191;3376266;78940
2021-02-07;FR;France;19715;171;3395981;79111
2021-02-08;FR;France;4343;460;3400324;79571
2021-02-09;FR;France;18886;724;3419210;80295
2021-02-10;FR;France;25678;296;3444888;80591
2021-02-11;FR;France;21076;360;3465964;80951
2021-02-12;FR;France;20709;645;3486673;81596
2021-02-13;FR;France;21231;199;3507904;81795
2021-02-14;FR;France;16546;167;3524450;81962
2021-02-15;FR;France;4406;412;3528856;82374
2021-02-16;FR;France;19596;587;3548452;82961
2021-02-17;FR;France;25186;310;3573638;83271
2021-02-18;FR;France;22518;271;3596156;83542
2021-02-19;FR;France;24127;572;3620283;84114
2021-02-20;FR;France;22371;157;3642654;84271
2021-02-21;FR;France;22046;159;3664700;84430
2021-02-22;FR;France;4654;334;3669354;84764
2021-02-23;FR;France;20180;431;3689534;85195
2021-02-24;FR;France;31527;278;3721061;85473
2021-02-25;FR;France;25414;261;3746475;85734
2021-02-26;FR;France;25216;539;3771691;86273
2021-02-27;FR;France;23996;185;3795687;86458
2021-02-28;FR;France;19952;122;3815639;86580
2021-03-01;FR;France;4730;375;3820369;86955
2021-03-02;FR;France;22872;418;3843241;87373
2021-03-03;FR;France;26903;322;3870144;87695
2021-03-04;FR;France;25286;293;3895430;87988
2021-03-05;FR;France;23507;439;3918937;88427
2021-03-06;FR;France;23306;170;3942243;88597
2021-03-07;FR;France;21835;130;3964078;88727
2021-03-08;FR;France;5534;363;3969612;89090
2021-03-09;FR;France;23143;365;3992755;89455
2021-03-10;FR;France;29674;252;4022429;89707
2021-03-11;FR;France;28129;277;4050558;89984
2021-03-12;FR;France;25177;223;4075735;90207
2021-03-13;FR;France;29792;169;4105527;90376
2021-03-14;FR;France;26347;207;4131874;90583
2021-03-15;FR;France;6471;341;4138345;90924
2021-03-16;FR;France;30066;400;4168411;91324
2021-03-17;FR;France;38501;87;4206912;91411
2021-03-18;FR;France;35061;422;4241973;91833
2021-03-19;FR;France;35198;285;4277171;92118
2021-03-20;FR;France;35339;177;4312510;92295
2021-03-21;FR;France;30587;138;4343097;92433
2021-03-22;FR;France;15813;343;4358910;92776
2021-03-23;FR;France;14697;288;4373607;93064
2021-03-24;FR;France;65392;246;4438999;93310
2021-03-25;FR;France;45660;225;4484659;93535
2021-03-26;FR;France;41871;897;4526530;94432
2021-03-27;FR;France;42634;191;4569164;94623
2021-03-28;FR;France;37021;131;4606185;94754
2021-03-29;FR;France;9110;360;4615295;95114
2021-03-30;FR;France;30719;381;4646014;95495
2021-03-31;FR;France;59054;303;4705068;95798
2021-04-01;FR;France;50711;308;4755779;96106
2021-04-02;FR;France;46678;332;4802457;96438
2021-04-03;FR;France;88;1;4802545;96439
2021-04-04;FR;France;80629;369;4883174;96808
2021-04-05;FR;France;10797;197;4893971;97005
2021-04-06;FR;France;8054;426;4902025;97431
2021-04-07;FR;France;960;13;4902985;97444
2021-04-08;FR;France;97170;752;5000155;98196
2021-04-09;FR;France;159;6;5000314;98202
2021-04-10;FR;France;1371;11;5001685;98213
2021-04-11;FR;France;117900;696;5119585;98909
2021-04-12;FR;France;8555;385;5128140;99294
2021-04-13;FR;France;39125;345;5167265;99639
2021-04-14;FR;France;43507;297;5210772;99936
2021-04-15;FR;France;38081;296;5248853;100232
2021-04-16;FR;France;36451;331;5285304;100563
2021-04-17;FR;France;35872;189;5321176;100752
2021-04-18;FR;France;29345;140;5350521;100892
2021-04-19;FR;France;6708;447;5357229;101339
2021-04-20;FR;France;44076;374;5401305;101713
2021-04-21;FR;France;34924;333;5436229;102046
2021-04-22;FR;France;33445;277;5469674;102323
2021-04-23;FR;France;32340;332;5502014;102655
2021-04-24;FR;France;32642;217;5534656;102872
2021-04-25;FR;France;24465;145;5559121;103017
2021-04-26;FR;France;5959;398;5565080;103415
2021-04-27;FR;France;30323;347;5595403;103762
2021-04-28;FR;France;31582;315;5626985;104077
2021-04-29;FR;France;26548;308;5653533;104385
2021-04-30;FR;France;24302;290;5677835;104675
2021-05-01;FR;France;25670;192;5703505;104867
2021-05-02;FR;France;9888;113;5713393;104980
2021-05-03;FR;France;3767;311;5717160;105291
2021-05-04;FR;France;24377;257;5741537;105548
2021-05-05;FR;France;26004;244;5767541;105792
2021-05-06;FR;France;21742;219;5789283;106011
2021-05-07;FR;France;19138;251;5808421;106262
2021-05-08;FR;France;20745;176;5829166;106438
2021-05-09;FR;France;9128;115;5838294;106553
2021-05-10;FR;France;3299;292;5841593;106845
2021-05-11;FR;France;19791;251;5861384;107096
2021-05-12;FR;France;21498;184;5882882;107280
2021-05-13;FR;France;19461;131;5902343;107411
2021-05-14;FR;France;7043;173;5909386;107584
2021-05-15;FR;France;15685;112;5925071;107696
2021-05-16;FR;France;13948;81;5939019;107777
2021-05-17;FR;France;3351;196;5942370;107973
2021-05-18;FR;France;17223;228;5959593;108201
2021-05-19;FR;France;19057;141;5978650;108342
2021-05-20;FR;France;0;133;5629983;108475
2021-05-21;FR;France;12803;123;5642786;108598
2021-05-22;FR;France;12611;89;5655397;108687
2021-05-23;FR;France;9704;70;5665101;108757
2021-05-24;FR;France;2230;62;5667331;108819
2021-05-25;FR;France;3155;221;5670486;109040
2021-05-26;FR;France;12657;145;5683143;109185
2021-05-27;FR;France;13933;142;5697076;109327
2021-05-28;FR;France;11274;125;5708350;109452
2021-05-29;FR;France;11527;66;5719877;109518
2021-05-30;FR;France;8541;44;5728418;109562
2021-05-31;FR;France;370;128;5728788;109690
2021-06-01;FR;France;9853;134;5738641;109824
2021-06-02;FR;France;1354;17;5739995;109841
2021-06-03;FR;France;15684;149;5755679;109990
2021-06-04;FR;France;6958;88;5762637;110078
2021-06-05;FR;France;6654;57;5769291;110135
2021-06-06;FR;France;5070;25;5774361;110160
2021-06-07;FR;France;1174;64;5775535;110224
2021-06-08;FR;France;6021;75;5781556;110299
2021-06-09;FR;France;5569;65;5787125;110364
2021-06-10;FR;France;4483;68;5791608;110432
2021-06-11;FR;France;3879;74;5795487;110506
2021-06-12;FR;France;3972;34;5799459;110540
2021-06-13;FR;France;2855;13;5802314;110553
2021-06-14;FR;France;698;63;5803012;110616
2021-06-15;FR;France;3243;76;5806255;110692
2021-06-16;FR;France;3064;48;5809319;110740
2021-06-17;FR;France;2142;56;5811461;110796
2021-06-18;FR;France;3187;68;5814648;110864
2021-06-19;FR;France;2624;22;5817272;110886
2021-06-20;FR;France;1816;14;5819088;110900
2021-06-21;FR;France;496;40;5819584;110940
2021-06-22;FR;France;2213;51;5821797;110991
2021-06-23;FR;France;2330;33;5824127;111024
2021-06-24;FR;France;2151;44;5826278;111068
2021-06-25;FR;France;1988;33;5828266;111101
2021-06-26;FR;France;2128;12;5830394;111113
2021-06-27;FR;France;1578;17;5831972;111130
2021-06-28;FR;France;518;44;5832490;111174
2021-06-29;FR;France;3395;56;5835885;111230
2021-06-30;FR;France;1380;14;5837265;111244
2021-07-01;FR;France;2664;29;5839929;111273
2021-02-02;PF;French Polynesia;0;0;0;0
2021-02-03;PF;French Polynesia;0;0;0;0
2021-02-04;PF;French Polynesia;0;0;0;0
2021-02-05;PF;French Polynesia;0;0;0;0
2021-02-06;PF;French Polynesia;0;0;0;0
2021-02-07;PF;French Polynesia;0;0;0;0
2021-02-08;PF;French Polynesia;0;0;0;0
2021-02-09;PF;French Polynesia;0;0;0;0
2021-02-10;PF;French Polynesia;0;0;0;0
2021-02-11;PF;French Polynesia;0;0;0;0
2021-02-12;PF;French Polynesia;0;0;0;0
2021-02-13;PF;French Polynesia;0;0;0;0
2021-02-14;PF;French Polynesia;0;0;0;0
2021-02-15;PF;French Polynesia;0;0;0;0
2021-02-16;PF;French Polynesia;0;0;0;0
2021-02-17;PF;French Polynesia;0;0;0;0
2021-02-18;PF;French Polynesia;0;0;0;0
2021-02-19;PF;French Polynesia;0;0;0;0
2021-02-20;PF;French Polynesia;0;0;0;0
2021-02-21;PF;French Polynesia;0;0;0;0
2021-02-22;PF;French Polynesia;0;0;0;0
2021-02-23;PF;French Polynesia;0;0;0;0
2021-02-24;PF;French Polynesia;0;0;0;0
2021-02-25;PF;French Polynesia;0;0;0;0
2021-02-26;PF;French Polynesia;0;0;0;0
2021-02-27;PF;French Polynesia;0;0;0;0
2021-02-28;PF;French Polynesia;0;0;0;0
2021-03-01;PF;French Polynesia;0;0;0;0
2021-03-02;PF;French Polynesia;0;0;0;0
2021-03-03;PF;French Polynesia;0;0;0;0
2021-03-04;PF;French Polynesia;0;0;0;0
2021-03-05;PF;French Polynesia;0;0;0;0
2021-03-06;PF;French Polynesia;0;0;0;0
2021-03-07;PF;French Polynesia;0;0;0;0
2021-03-08;PF;French Polynesia;0;0;0;0
2021-03-09;PF;French Polynesia;0;0;0;0
2021-03-10;PF;French Polynesia;0;0;0;0
2021-03-11;PF;French Polynesia;0;0;0;0
2021-03-12;PF;French Polynesia;0;0;0;0
2021-03-13;PF;French Polynesia;0;0;0;0
2021-03-14;PF;French Polynesia;0;0;0;0
2021-03-15;PF;French Polynesia;0;0;0;0
2021-03-16;PF;French Polynesia;0;0;0;0
2021-03-17;PF;French Polynesia;0;0;0;0
2021-03-18;PF;French Polynesia;0;0;0;0
2021-03-19;PF;French Polynesia;0;0;0;0
2021-03-20;PF;French Polynesia;0;0;0;0
2021-03-21;PF;French Polynesia;0;0;0;0
2021-03-22;PF;French Polynesia;0;0;0;0
2021-03-23;PF;French Polynesia;0;0;0;0
2021-03-24;PF;French Polynesia;0;0;0;0
2021-03-25;PF;French Polynesia;0;0;0;0
2021-03-26;PF;French Polynesia;0;0;0;0
2021-03-27;PF;French Polynesia;0;0;0;0
2021-03-28;PF;French Polynesia;0;0;0;0
2021-03-29;PF;French Polynesia;0;0;0;0
2021-03-30;PF;French Polynesia;0;0;0;0
2021-03-31;PF;French Polynesia;0;0;0;0
2021-04-01;PF;French Polynesia;0;0;0;0
2021-04-02;PF;French Polynesia;0;0;0;0
2021-04-03;PF;French Polynesia;0;0;0;0
2021-04-04;PF;French Polynesia;0;0;0;0
2021-04-05;PF;French Polynesia;0;0;0;0
2021-04-06;PF;French Polynesia;0;0;0;0
2021-04-07;PF;French Polynesia;0;0;0;0
2021-04-08;PF;French Polynesia;0;0;0;0
2021-04-09;PF;French Polynesia;0;0;0;0
2021-04-10;PF;French Polynesia;0;0;0;0
2021-04-11;PF;French Polynesia;0;0;0;0
2021-04-12;PF;French Polynesia;0;0;0;0
2021-04-13;PF;French Polynesia;0;0;0;0
2021-04-14;PF;French Polynesia;0;0;0;0
2021-04-15;PF;French Polynesia;0;0;0;0
2021-04-16;PF;French Polynesia;0;0;0;0
2021-04-17;PF;French Polynesia;0;0;0;0
2021-04-18;PF;French Polynesia;0;0;0;0
2021-04-19;PF;French Polynesia;0;0;0;0
2021-04-20;PF;French Polynesia;0;0;0;0
2021-04-21;PF;French Polynesia;0;0;0;0
2021-04-22;PF;French Polynesia;0;0;0;0
2021-04-23;PF;French Polynesia;0;0;0;0
2021-04-24;PF;French Polynesia;0;0;0;0
2021-04-25;PF;French Polynesia;0;0;0;0
2021-04-26;PF;French Polynesia;0;0;0;0
2021-04-27;PF;French Polynesia;0;0;0;0
2021-04-28;PF;French Polynesia;0;0;0;0
2021-04-29;PF;French Polynesia;0;0;0;0
2021-04-30;PF;French Polynesia;0;0;0;0
2021-05-01;PF;French Polynesia;0;0;0;0
2021-05-02;PF;French Polynesia;0;0;0;0
2021-05-03;PF;French Polynesia;0;0;0;0
2021-05-04;PF;French Polynesia;0;0;0;0
2021-05-05;PF;French Polynesia;0;0;0;0
2021-05-06;PF;French Polynesia;0;0;0;0
2021-05-07;PF;French Polynesia;0;0;0;0
2021-05-08;PF;French Polynesia;0;0;0;0
2021-05-09;PF;French Polynesia;0;0;0;0
2021-05-10;PF;French Polynesia;0;0;0;0
2021-05-11;PF;French Polynesia;0;0;0;0
2021-05-12;PF;French Polynesia;0;0;0;0
2021-05-13;PF;French Polynesia;0;0;0;0
2021-05-14;PF;French Polynesia;0;0;0;0
2021-05-15;PF;French Polynesia;0;0;0;0
2021-05-16;PF;French Polynesia;0;0;0;0
2021-05-17;PF;French Polynesia;0;0;0;0
2021-05-18;PF;French Polynesia;0;0;0;0
2021-05-19;PF;French Polynesia;0;0;0;0
2021-05-20;PF;French Polynesia;0;0;0;0
2021-05-21;PF;French Polynesia;0;0;0;0
2021-05-22;PF;French Polynesia;0;0;0;0
2021-05-23;PF;French Polynesia;0;0;0;0
2021-05-24;PF;French Polynesia;0;0;0;0
2021-05-25;PF;French Polynesia;0;0;0;0
2021-05-26;PF;French Polynesia;0;0;0;0
2021-05-27;PF;French Polynesia;0;0;0;0
2021-05-28;PF;French Polynesia;0;0;0;0
2021-05-29;PF;French Polynesia;0;0;0;0
2021-05-30;PF;French Polynesia;0;0;0;0
2021-05-31;PF;French Polynesia;0;0;0;0
2021-06-01;PF;French Polynesia;0;0;0;0
2021-06-02;PF;French Polynesia;0;0;0;0
2021-06-03;PF;French Polynesia;0;0;0;0
2021-06-04;PF;French Polynesia;0;0;0;0
2021-06-05;PF;French Polynesia;0;0;0;0
2021-06-06;PF;French Polynesia;0;0;0;0
2021-06-07;PF;French Polynesia;0;0;0;0
2021-06-08;PF;French Polynesia;0;0;0;0
2021-06-09;PF;French Polynesia;0;0;0;0
2021-06-10;PF;French Polynesia;0;0;0;0
2021-06-11;PF;French Polynesia;0;0;0;0
2021-06-12;PF;French Polynesia;0;0;0;0
2021-06-13;PF;French Polynesia;0;0;0;0
2021-06-14;PF;French Polynesia;0;0;0;0
2021-06-15;PF;French Polynesia;0;0;0;0
2021-06-16;PF;French Polynesia;0;0;0;0
2021-06-17;PF;French Polynesia;0;0;0;0
2021-06-18;PF;French Polynesia;0;0;0;0
2021-06-19;PF;French Polynesia;0;0;0;0
2021-06-20;PF;French Polynesia;0;0;0;0
2021-06-21;PF;French Polynesia;0;0;0;0
2021-06-22;PF;French Polynesia;0;0;0;0
2021-06-23;PF;French Polynesia;0;0;0;0
2021-06-24;PF;French Polynesia;0;0;0;0
2021-06-25;PF;French Polynesia;0;0;0;0
2021-06-26;PF;French Polynesia;0;0;0;0
2021-06-27;PF;French Polynesia;0;0;0;0
2021-06-28;PF;French Polynesia;0;0;0;0
2021-06-29;PF;French Polynesia;0;0;0;0
2020-03-14;GA;Gabon;1;0;1;0
2020-03-15;GA;Gabon;0;0;1;0
2020-03-16;GA;Gabon;0;0;1;0
2020-03-17;GA;Gabon;0;0;1;0
2020-03-18;GA;Gabon;0;0;1;0
2020-03-19;GA;Gabon;0;0;1;0
2020-03-20;GA;Gabon;2;1;3;1
2020-03-21;GA;Gabon;1;0;4;1
2020-03-22;GA;Gabon;1;0;5;1
2020-03-23;GA;Gabon;0;0;5;1
2020-03-24;GA;Gabon;1;0;6;1
2020-03-25;GA;Gabon;0;0;6;1
2020-03-26;GA;Gabon;1;0;7;1
2020-03-27;GA;Gabon;0;0;7;1
2020-03-28;GA;Gabon;0;0;7;1
2020-03-29;GA;Gabon;0;0;7;1
2020-03-30;GA;Gabon;0;0;7;1
2020-03-31;GA;Gabon;9;0;16;1
2020-04-01;GA;Gabon;2;0;18;1
2020-04-02;GA;Gabon;3;0;21;1
2020-04-03;GA;Gabon;0;0;21;1
2020-04-04;GA;Gabon;0;0;21;1
2020-04-05;GA;Gabon;0;0;21;1
2020-04-06;GA;Gabon;3;0;24;1
2020-04-07;GA;Gabon;6;0;30;1
2020-04-08;GA;Gabon;4;0;34;1
2020-04-09;GA;Gabon;10;0;44;1
2020-04-10;GA;Gabon;0;0;44;1
2020-04-11;GA;Gabon;2;0;46;1
2020-04-12;GA;Gabon;3;0;49;1
2020-04-13;GA;Gabon;8;0;57;1
2020-04-14;GA;Gabon;0;0;57;1
2020-04-15;GA;Gabon;23;0;80;1
2020-04-16;GA;Gabon;0;0;80;1
2020-04-17;GA;Gabon;28;0;108;1
2020-04-18;GA;Gabon;0;0;108;1
2020-04-19;GA;Gabon;1;0;109;1
2020-04-20;GA;Gabon;11;0;120;1
2020-04-21;GA;Gabon;36;0;156;1
2020-04-22;GA;Gabon;10;0;166;1
2020-04-23;GA;Gabon;1;1;167;2
2020-04-24;GA;Gabon;5;1;172;3
2020-04-25;GA;Gabon;4;0;176;3
2020-04-26;GA;Gabon;0;0;176;3
2020-04-27;GA;Gabon;35;0;211;3
2020-04-28;GA;Gabon;27;0;238;3
2020-04-29;GA;Gabon;38;0;276;3
2020-04-30;GA;Gabon;0;0;276;3
2020-05-01;GA;Gabon;0;0;276;3
2020-05-02;GA;Gabon;59;2;335;5
2020-05-03;GA;Gabon;0;0;335;5
2020-05-04;GA;Gabon;32;1;367;6
2020-05-05;GA;Gabon;30;0;397;6
2020-05-06;GA;Gabon;0;0;397;6
2020-05-07;GA;Gabon;107;2;504;8
2020-05-08;GA;Gabon;116;0;620;8
2020-05-09;GA;Gabon;41;0;661;8
2020-05-10;GA;Gabon;0;0;661;8
2020-05-11;GA;Gabon;141;1;802;9
2020-05-12;GA;Gabon;61;0;863;9
2020-05-13;GA;Gabon;141;0;1004;9
2020-05-14;GA;Gabon;100;1;1104;10
2020-05-15;GA;Gabon;105;0;1209;10
2020-05-16;GA;Gabon;111;1;1320;11
2020-05-17;GA;Gabon;0;0;1320;11
2020-05-18;GA;Gabon;112;0;1432;11
2020-05-19;GA;Gabon;70;1;1502;12
2020-05-20;GA;Gabon;65;0;1567;12
2020-05-21;GA;Gabon;0;0;1567;12
2020-05-22;GA;Gabon;161;0;1728;12
2020-05-23;GA;Gabon;206;0;1934;12
2020-05-24;GA;Gabon;0;0;1934;12
2020-05-25;GA;Gabon;201;2;2135;14
2020-05-26;GA;Gabon;103;0;2238;14
2020-05-27;GA;Gabon;81;0;2319;14
2020-05-28;GA;Gabon;112;0;2431;14
2020-05-29;GA;Gabon;182;1;2613;15
2020-05-30;GA;Gabon;42;2;2655;17
2020-05-31;GA;Gabon;0;0;2655;17
2020-06-01;GA;Gabon;0;0;2655;17
2020-06-02;GA;Gabon;148;3;2803;20
2020-06-03;GA;Gabon;99;0;2902;20
2020-06-04;GA;Gabon;53;1;2955;21
2020-06-05;GA;Gabon;146;0;3101;21
2020-06-06;GA;Gabon;0;0;3101;21
2020-06-07;GA;Gabon;0;0;3101;21
2020-06-08;GA;Gabon;0;0;3101;21
2020-06-09;GA;Gabon;146;0;3247;21
2020-06-10;GA;Gabon;128;1;3375;22
2020-06-11;GA;Gabon;88;1;3463;23
2020-06-12;GA;Gabon;0;0;3463;23
2020-06-13;GA;Gabon;0;0;3463;23
2020-06-14;GA;Gabon;0;0;3463;23
2020-06-15;GA;Gabon;570;4;4033;27
2020-06-16;GA;Gabon;81;2;4114;29
2020-06-17;GA;Gabon;115;1;4229;30
2020-06-18;GA;Gabon;111;2;4340;32
2020-06-19;GA;Gabon;88;2;4428;34
2020-06-20;GA;Gabon;0;0;4428;34
2020-06-21;GA;Gabon;0;0;4428;34
2020-06-22;GA;Gabon;311;5;4739;39
2020-06-23;GA;Gabon;110;0;4849;39
2020-06-24;GA;Gabon;107;0;4956;39
2020-06-25;GA;Gabon;131;1;5087;40
2020-06-26;GA;Gabon;122;0;5209;40
2020-06-27;GA;Gabon;0;0;5209;40
2020-06-28;GA;Gabon;0;0;5209;40
2020-06-29;GA;Gabon;185;2;5394;42
2020-06-30;GA;Gabon;0;0;5394;42
2020-07-01;GA;Gabon;119;0;5513;42
2020-07-02;GA;Gabon;0;0;5513;42
2020-07-03;GA;Gabon;107;2;5620;44
2020-07-04;GA;Gabon;0;0;5620;44
2020-07-05;GA;Gabon;0;0;5620;44
2020-07-06;GA;Gabon;123;2;5743;46
2020-07-07;GA;Gabon;0;0;5743;46
2020-07-08;GA;Gabon;128;0;5871;46
2020-07-09;GA;Gabon;0;0;5871;46
2020-07-10;GA;Gabon;71;0;5942;46
2020-07-11;GA;Gabon;0;0;5942;46
2020-07-12;GA;Gabon;0;0;5942;46
2020-07-13;GA;Gabon;84;0;6026;46
2020-07-14;GA;Gabon;0;0;6026;46
2020-07-15;GA;Gabon;95;0;6121;46
2020-07-16;GA;Gabon;0;0;6121;46
2020-07-17;GA;Gabon;194;0;6315;46
2020-07-18;GA;Gabon;0;0;6315;46
2020-07-19;GA;Gabon;0;0;6315;46
2020-07-20;GA;Gabon;118;0;6433;46
2020-07-21;GA;Gabon;0;0;6433;46
2020-07-22;GA;Gabon;155;1;6588;47
2020-07-23;GA;Gabon;0;0;6588;47
2020-07-24;GA;Gabon;396;2;6984;49
2020-07-25;GA;Gabon;0;0;6984;49
2020-07-26;GA;Gabon;0;0;6984;49
2020-07-27;GA;Gabon;205;0;7189;49
2020-07-28;GA;Gabon;0;0;7189;49
2020-07-29;GA;Gabon;163;0;7352;49
2020-07-30;GA;Gabon;0;0;7352;49
2020-07-31;GA;Gabon;0;0;7352;49
2020-08-01;GA;Gabon;179;1;7531;50
2020-08-02;GA;Gabon;0;0;7531;50
2020-08-03;GA;Gabon;115;1;7646;51
2020-08-04;GA;Gabon;0;0;7646;51
2020-08-05;GA;Gabon;141;0;7787;51
2020-08-06;GA;Gabon;0;0;7787;51
2020-08-07;GA;Gabon;136;0;7923;51
2020-08-08;GA;Gabon;0;0;7923;51
2020-08-09;GA;Gabon;0;0;7923;51
2020-08-10;GA;Gabon;83;0;8006;51
2020-08-11;GA;Gabon;0;0;8006;51
2020-08-12;GA;Gabon;71;0;8077;51
2020-08-13;GA;Gabon;0;0;8077;51
2020-08-14;GA;Gabon;148;0;8225;51
2020-08-15;GA;Gabon;0;0;8225;51
2020-08-16;GA;Gabon;0;0;8225;51
2020-08-17;GA;Gabon;45;2;8270;53
2020-08-18;GA;Gabon;0;0;8270;53
2020-08-19;GA;Gabon;49;0;8319;53
2020-08-20;GA;Gabon;0;0;8319;53
2020-08-21;GA;Gabon;69;0;8388;53
2020-08-22;GA;Gabon;0;0;8388;53
2020-08-23;GA;Gabon;0;0;8388;53
2020-08-24;GA;Gabon;21;0;8409;53
2020-08-25;GA;Gabon;0;0;8409;53
2020-08-26;GA;Gabon;59;0;8468;53
2020-08-27;GA;Gabon;0;0;8468;53
2020-08-28;GA;Gabon;37;0;8505;53
2020-08-29;GA;Gabon;0;0;8505;53
2020-08-30;GA;Gabon;0;0;8505;53
2020-08-31;GA;Gabon;28;0;8533;53
2020-09-01;GA;Gabon;0;0;8533;53
2020-09-02;GA;Gabon;5;0;8538;53
2020-09-03;GA;Gabon;0;0;8538;53
2020-09-04;GA;Gabon;63;0;8601;53
2020-09-05;GA;Gabon;0;0;8601;53
2020-09-06;GA;Gabon;0;0;8601;53
2020-09-07;GA;Gabon;7;0;8608;53
2020-09-08;GA;Gabon;0;0;8608;53
2020-09-09;GA;Gabon;13;0;8621;53
2020-09-10;GA;Gabon;0;0;8621;53
2020-09-11;GA;Gabon;22;0;8643;53
2020-09-12;GA;Gabon;0;0;8643;53
2020-09-13;GA;Gabon;0;0;8643;53
2020-09-14;GA;Gabon;11;0;8654;53
2020-09-15;GA;Gabon;0;0;8654;53
2020-09-16;GA;Gabon;24;0;8678;53
2020-09-17;GA;Gabon;0;0;8678;53
2020-09-18;GA;Gabon;18;0;8696;53
2020-09-19;GA;Gabon;0;0;8696;53
2020-09-20;GA;Gabon;0;0;8696;53
2020-09-21;GA;Gabon;8;1;8704;54
2020-09-22;GA;Gabon;0;0;8704;54
2020-09-23;GA;Gabon;12;0;8716;54
2020-09-24;GA;Gabon;0;0;8716;54
2020-09-25;GA;Gabon;12;0;8728;54
2020-09-26;GA;Gabon;0;0;8728;54
2020-09-27;GA;Gabon;0;0;8728;54
2020-09-28;GA;Gabon;0;0;8728;54
2020-09-29;GA;Gabon;24;0;8752;54
2020-09-30;GA;Gabon;14;0;8766;54
2020-10-01;GA;Gabon;0;0;8766;54
2020-10-02;GA;Gabon;31;0;8797;54
2020-10-03;GA;Gabon;0;0;8797;54
2020-10-04;GA;Gabon;0;0;8797;54
2020-10-05;GA;Gabon;11;0;8808;54
2020-10-06;GA;Gabon;0;0;8808;54
2020-10-07;GA;Gabon;7;0;8815;54
2020-10-08;GA;Gabon;0;0;8815;54
2020-10-09;GA;Gabon;20;0;8835;54
2020-10-10;GA;Gabon;0;0;8835;54
2020-10-11;GA;Gabon;0;0;8835;54
2020-10-12;GA;Gabon;25;0;8860;54
2020-10-13;GA;Gabon;0;0;8860;54
2020-10-14;GA;Gabon;9;0;8869;54
2020-10-15;GA;Gabon;0;0;8869;54
2020-10-16;GA;Gabon;12;0;8881;54
2020-10-17;GA;Gabon;0;0;8881;54
2020-10-18;GA;Gabon;0;0;8881;54
2020-10-19;GA;Gabon;3;0;8884;54
2020-10-20;GA;Gabon;0;0;8884;54
2020-10-21;GA;Gabon;17;0;8901;54
2020-10-22;GA;Gabon;0;0;8901;54
2020-10-23;GA;Gabon;18;0;8919;54
2020-10-24;GA;Gabon;0;0;8919;54
2020-10-25;GA;Gabon;0;0;8919;54
2020-10-26;GA;Gabon;18;0;8937;54
2020-10-27;GA;Gabon;0;0;8937;54
2020-10-28;GA;Gabon;20;1;8957;55
2020-10-29;GA;Gabon;0;0;8957;55
2020-10-30;GA;Gabon;11;0;8968;55
2020-10-31;GA;Gabon;0;0;8968;55
2020-11-01;GA;Gabon;0;0;8968;55
2020-11-02;GA;Gabon;16;0;8984;55
2020-11-03;GA;Gabon;0;0;8984;55
2020-11-04;GA;Gabon;21;0;9005;55
2020-11-05;GA;Gabon;0;0;9005;55
2020-11-06;GA;Gabon;17;0;9022;55
2020-11-07;GA;Gabon;0;0;9022;55
2020-11-08;GA;Gabon;0;0;9022;55
2020-11-09;GA;Gabon;7;2;9029;57
2020-11-10;GA;Gabon;0;0;9029;57
2020-11-11;GA;Gabon;19;0;9048;57
2020-11-12;GA;Gabon;0;0;9048;57
2020-11-13;GA;Gabon;14;1;9062;58
2020-11-14;GA;Gabon;0;0;9062;58
2020-11-15;GA;Gabon;0;0;9062;58
2020-11-16;GA;Gabon;22;0;9084;58
2020-11-17;GA;Gabon;0;0;9084;58
2020-11-18;GA;Gabon;0;0;9084;58
2020-11-19;GA;Gabon;32;1;9116;59
2020-11-20;GA;Gabon;15;0;9131;59
2020-11-21;GA;Gabon;0;0;9131;59
2020-11-22;GA;Gabon;0;0;9131;59
2020-11-23;GA;Gabon;19;0;9150;59
2020-11-24;GA;Gabon;0;0;9150;59
2020-11-25;GA;Gabon;23;0;9173;59
2020-11-26;GA;Gabon;0;0;9173;59
2020-11-27;GA;Gabon;18;0;9191;59
2020-11-28;GA;Gabon;0;0;9191;59
2020-11-29;GA;Gabon;0;0;9191;59
2020-11-30;GA;Gabon;23;1;9214;60
2020-12-01;GA;Gabon;0;0;9214;60
2020-12-02;GA;Gabon;25;0;9239;60
2020-12-03;GA;Gabon;0;0;9239;60
2020-12-04;GA;Gabon;15;0;9254;60
2020-12-05;GA;Gabon;0;0;9254;60
2020-12-06;GA;Gabon;0;0;9254;60
2020-12-07;GA;Gabon;24;0;9278;60
2020-12-08;GA;Gabon;0;0;9278;60
2020-12-09;GA;Gabon;22;2;9300;62
2020-12-10;GA;Gabon;0;0;9300;62
2020-12-11;GA;Gabon;30;1;9330;63
2020-12-12;GA;Gabon;0;0;9330;63
2020-12-13;GA;Gabon;0;0;9330;63
2020-12-14;GA;Gabon;21;0;9351;63
2020-12-15;GA;Gabon;0;0;9351;63
2020-12-16;GA;Gabon;22;0;9373;63
2020-12-17;GA;Gabon;0;0;9373;63
2020-12-18;GA;Gabon;27;1;9400;64
2020-12-19;GA;Gabon;0;0;9400;64
2020-12-20;GA;Gabon;0;0;9400;64
2020-12-21;GA;Gabon;20;0;9420;64
2020-12-22;GA;Gabon;0;0;9420;64
2020-12-23;GA;Gabon;49;0;9469;64
2020-12-24;GA;Gabon;0;0;9469;64
2020-12-25;GA;Gabon;28;0;9497;64
2020-12-26;GA;Gabon;0;0;9497;64
2020-12-27;GA;Gabon;0;0;9497;64
2020-12-28;GA;Gabon;13;0;9510;64
2020-12-29;GA;Gabon;0;0;9510;64
2020-12-30;GA;Gabon;61;0;9571;64
2020-12-31;GA;Gabon;0;0;9571;64
2021-01-01;GA;Gabon;0;0;9571;64
2021-01-02;GA;Gabon;0;0;9571;64
2021-01-03;GA;Gabon;0;0;9571;64
2021-01-04;GA;Gabon;34;2;9605;66
2021-01-05;GA;Gabon;0;0;9605;66
2021-01-06;GA;Gabon;36;0;9641;66
2021-01-07;GA;Gabon;0;0;9641;66
2021-01-08;GA;Gabon;53;0;9694;66
2021-01-09;GA;Gabon;0;0;9694;66
2021-01-10;GA;Gabon;0;0;9694;66
2021-01-11;GA;Gabon;46;0;9740;66
2021-01-12;GA;Gabon;0;0;9740;66
2021-01-13;GA;Gabon;79;0;9819;66
2021-01-14;GA;Gabon;0;0;9819;66
2021-01-15;GA;Gabon;80;0;9899;66
2021-01-16;GA;Gabon;0;0;9899;66
2021-01-17;GA;Gabon;0;0;9899;66
2021-01-18;GA;Gabon;120;0;10019;66
2021-01-19;GA;Gabon;0;0;10019;66
2021-01-20;GA;Gabon;101;0;10120;66
2021-01-21;GA;Gabon;0;0;10120;66
2021-01-22;GA;Gabon;158;1;10278;67
2021-01-23;GA;Gabon;0;0;10278;67
2021-01-24;GA;Gabon;0;0;10278;67
2021-01-25;GA;Gabon;133;0;10411;67
2021-01-26;GA;Gabon;0;0;10411;67
2021-01-27;GA;Gabon;125;1;10536;68
2021-01-28;GA;Gabon;0;0;10536;68
2021-01-29;GA;Gabon;212;0;10748;68
2021-01-30;GA;Gabon;0;0;10748;68
2021-01-31;GA;Gabon;0;0;10748;68
2021-02-01;GA;Gabon;204;0;10952;68
2021-02-02;GA;Gabon;0;0;10952;68
2021-02-03;GA;Gabon;177;2;11129;70
2021-02-04;GA;Gabon;0;0;11129;70
2021-02-05;GA;Gabon;328;1;11457;71
2021-02-06;GA;Gabon;0;0;11457;71
2021-02-07;GA;Gabon;0;0;11457;71
2021-02-08;GA;Gabon;379;0;11836;71
2021-02-09;GA;Gabon;0;0;11836;71
2021-02-10;GA;Gabon;335;0;12171;71
2021-02-11;GA;Gabon;0;0;12171;71
2021-02-12;GA;Gabon;406;2;12577;73
2021-02-13;GA;Gabon;0;0;12577;73
2021-02-14;GA;Gabon;0;0;12577;73
2021-02-15;GA;Gabon;288;2;12865;75
2021-02-16;GA;Gabon;0;0;12865;75
2021-02-17;GA;Gabon;242;0;13107;75
2021-02-18;GA;Gabon;0;0;13107;75
2021-02-19;GA;Gabon;446;0;13553;75
2021-02-20;GA;Gabon;0;0;13553;75
2021-02-21;GA;Gabon;0;0;13553;75
2021-02-22;GA;Gabon;331;1;13884;76
2021-02-23;GA;Gabon;0;0;13884;76
2021-02-24;GA;Gabon;350;4;14234;80
2021-02-25;GA;Gabon;0;0;14234;80
2021-02-26;GA;Gabon;330;3;14564;83
2021-02-27;GA;Gabon;0;0;14564;83
2021-02-28;GA;Gabon;0;0;14564;83
2021-03-01;GA;Gabon;285;4;14849;87
2021-03-02;GA;Gabon;0;0;14849;87
2021-03-03;GA;Gabon;405;1;15254;88
2021-03-04;GA;Gabon;0;0;15254;88
2021-03-05;GA;Gabon;0;0;15254;88
2021-03-06;GA;Gabon;371;2;15625;90
2021-03-07;GA;Gabon;0;0;15625;90
2021-03-08;GA;Gabon;390;1;16015;91
2021-03-09;GA;Gabon;0;0;16015;91
2021-03-10;GA;Gabon;298;2;16313;93
2021-03-11;GA;Gabon;0;0;16313;93
2021-03-12;GA;Gabon;347;3;16660;96
2021-03-13;GA;Gabon;0;0;16660;96
2021-03-14;GA;Gabon;0;0;16660;96
2021-03-15;GA;Gabon;285;5;16945;101
2021-03-16;GA;Gabon;0;0;16945;101
2021-03-17;GA;Gabon;352;4;17297;105
2021-03-18;GA;Gabon;0;0;17297;105
2021-03-19;GA;Gabon;414;1;17711;106
2021-03-20;GA;Gabon;0;0;17711;106
2021-03-21;GA;Gabon;0;0;17711;106
2021-03-22;GA;Gabon;367;2;18078;108
2021-03-23;GA;Gabon;0;0;18078;108
2021-03-24;GA;Gabon;348;1;18426;109
2021-03-25;GA;Gabon;0;0;18426;109
2021-03-26;GA;Gabon;0;0;18426;109
2021-03-27;GA;Gabon;351;2;18777;111
2021-03-28;GA;Gabon;0;0;18777;111
2021-03-29;GA;Gabon;363;3;19140;114
2021-03-30;GA;Gabon;0;0;19140;114
2021-03-31;GA;Gabon;410;4;19550;118
2021-04-01;GA;Gabon;0;0;19550;118
2021-04-02;GA;Gabon;313;1;19863;119
2021-04-03;GA;Gabon;0;0;19863;119
2021-04-04;GA;Gabon;0;0;19863;119
2021-04-05;GA;Gabon;0;0;19863;119
2021-04-06;GA;Gabon;0;0;19863;119
2021-04-07;GA;Gabon;402;5;20265;124
2021-04-08;GA;Gabon;0;0;20265;124
2021-04-09;GA;Gabon;371;3;20636;127
2021-04-10;GA;Gabon;0;0;20636;127
2021-04-11;GA;Gabon;0;0;20636;127
2021-04-12;GA;Gabon;335;2;20971;129
2021-04-13;GA;Gabon;0;0;20971;129
2021-04-14;GA;Gabon;595;3;21566;132
2021-04-15;GA;Gabon;0;0;21566;132
2021-04-16;GA;Gabon;0;0;21566;132
2021-04-17;GA;Gabon;292;1;21858;133
2021-04-18;GA;Gabon;0;0;21858;133
2021-04-19;GA;Gabon;174;3;22032;136
2021-04-20;GA;Gabon;0;0;22032;136
2021-04-21;GA;Gabon;196;0;22228;136
2021-04-22;GA;Gabon;0;0;22228;136
2021-04-23;GA;Gabon;205;2;22433;138
2021-04-24;GA;Gabon;0;0;22433;138
2021-04-25;GA;Gabon;0;0;22433;138
2021-04-26;GA;Gabon;135;0;22568;138
2021-04-27;GA;Gabon;0;0;22568;138
2021-04-28;GA;Gabon;0;0;22568;138
2021-04-29;GA;Gabon;250;0;22818;138
2021-04-30;GA;Gabon;257;1;23075;139
2021-05-01;GA;Gabon;0;0;23075;139
2021-05-02;GA;Gabon;0;0;23075;139
2021-05-03;GA;Gabon;126;1;23201;140
2021-05-04;GA;Gabon;0;0;23201;140
2021-05-05;GA;Gabon;0;0;23201;140
2021-05-06;GA;Gabon;0;0;23201;140
2021-05-07;GA;Gabon;110;2;23311;142
2021-05-08;GA;Gabon;121;1;23432;143
2021-05-09;GA;Gabon;0;0;23432;143
2021-05-10;GA;Gabon;133;0;23565;143
2021-05-11;GA;Gabon;0;0;23565;143
2021-05-12;GA;Gabon;169;0;23734;143
2021-05-13;GA;Gabon;0;0;23734;143
2021-05-14;GA;Gabon;65;0;23799;143
2021-05-15;GA;Gabon;0;0;23799;143
2021-05-16;GA;Gabon;0;0;23799;143
2021-05-17;GA;Gabon;110;2;23909;145
2021-05-18;GA;Gabon;0;0;23909;145
2021-05-19;GA;Gabon;130;2;24039;147
2021-05-20;GA;Gabon;0;0;24039;147
2021-05-21;GA;Gabon;68;0;24107;147
2021-05-22;GA;Gabon;0;0;24107;147
2021-05-23;GA;Gabon;0;0;24107;147
2021-05-24;GA;Gabon;0;0;24107;147
2021-05-25;GA;Gabon;84;2;24191;149
2021-05-26;GA;Gabon;61;1;24252;150
2021-05-27;GA;Gabon;0;0;24252;150
2021-05-28;GA;Gabon;113;0;24365;150
2021-05-29;GA;Gabon;0;0;24365;150
2021-05-30;GA;Gabon;0;0;24365;150
2021-05-31;GA;Gabon;64;2;24429;152
2021-06-01;GA;Gabon;0;0;24429;152
2021-06-02;GA;Gabon;0;0;24429;152
2021-06-03;GA;Gabon;0;0;24429;152
2021-06-04;GA;Gabon;162;2;24591;154
2021-06-05;GA;Gabon;0;0;24591;154
2021-06-06;GA;Gabon;0;0;24591;154
2021-06-07;GA;Gabon;0;0;24591;154
2021-06-08;GA;Gabon;60;0;24651;154
2021-06-09;GA;Gabon;45;2;24696;156
2021-06-10;GA;Gabon;0;0;24696;156
2021-06-11;GA;Gabon;40;0;24736;156
2021-06-12;GA;Gabon;0;0;24736;156
2021-06-13;GA;Gabon;0;0;24736;156
2021-06-14;GA;Gabon;19;1;24755;157
2021-06-15;GA;Gabon;0;0;24755;157
2021-06-16;GA;Gabon;77;0;24832;157
2021-06-17;GA;Gabon;0;0;24832;157
2021-06-18;GA;Gabon;0;0;24832;157
2021-06-19;GA;Gabon;32;1;24864;158
2021-06-20;GA;Gabon;0;0;24864;158
2021-06-21;GA;Gabon;0;0;24864;158
2021-06-22;GA;Gabon;21;0;24885;158
2021-06-23;GA;Gabon;73;1;24958;159
2021-06-24;GA;Gabon;0;0;24958;159
2021-06-25;GA;Gabon;26;0;24984;159
2021-06-26;GA;Gabon;0;0;24984;159
2021-06-27;GA;Gabon;0;0;24984;159
2021-06-28;GA;Gabon;0;0;24984;159
2021-06-29;GA;Gabon;0;0;24984;159
2021-06-30;GA;Gabon;0;0;24984;159
2021-07-01;GA;Gabon;70;0;25054;159
2020-03-17;GM;Gambia;1;0;1;0
2020-03-18;GM;Gambia;0;0;1;0
2020-03-19;GM;Gambia;0;0;1;0
2020-03-20;GM;Gambia;0;0;1;0
2020-03-21;GM;Gambia;0;0;1;0
2020-03-22;GM;Gambia;0;0;1;0
2020-03-23;GM;Gambia;1;1;2;1
2020-03-24;GM;Gambia;1;0;3;1
2020-03-25;GM;Gambia;0;0;3;1
2020-03-26;GM;Gambia;0;0;3;1
2020-03-27;GM;Gambia;0;0;3;1
2020-03-28;GM;Gambia;0;0;3;1
2020-03-29;GM;Gambia;1;0;4;1
2020-03-30;GM;Gambia;0;0;4;1
2020-03-31;GM;Gambia;0;0;4;1
2020-04-01;GM;Gambia;0;0;4;1
2020-04-02;GM;Gambia;0;0;4;1
2020-04-03;GM;Gambia;0;0;4;1
2020-04-04;GM;Gambia;0;0;4;1
2020-04-05;GM;Gambia;0;0;4;1
2020-04-06;GM;Gambia;0;0;4;1
2020-04-07;GM;Gambia;0;0;4;1
2020-04-08;GM;Gambia;0;0;4;1
2020-04-09;GM;Gambia;0;0;4;1
2020-04-10;GM;Gambia;0;0;4;1
2020-04-11;GM;Gambia;5;0;9;1
2020-04-12;GM;Gambia;0;0;9;1
2020-04-13;GM;Gambia;0;0;9;1
2020-04-14;GM;Gambia;0;0;9;1
2020-04-15;GM;Gambia;0;0;9;1
2020-04-16;GM;Gambia;0;0;9;1
2020-04-17;GM;Gambia;0;0;9;1
2020-04-18;GM;Gambia;0;0;9;1
2020-04-19;GM;Gambia;1;0;10;1
2020-04-20;GM;Gambia;0;0;10;1
2020-04-21;GM;Gambia;0;0;10;1
2020-04-22;GM;Gambia;0;0;10;1
2020-04-23;GM;Gambia;0;0;10;1
2020-04-24;GM;Gambia;0;0;10;1
2020-04-25;GM;Gambia;0;0;10;1
2020-04-26;GM;Gambia;0;0;10;1
2020-04-27;GM;Gambia;0;0;10;1
2020-04-28;GM;Gambia;0;0;10;1
2020-04-29;GM;Gambia;0;0;10;1
2020-04-30;GM;Gambia;1;0;11;1
2020-05-01;GM;Gambia;1;0;12;1
2020-05-02;GM;Gambia;5;0;17;1
2020-05-03;GM;Gambia;0;0;17;1
2020-05-04;GM;Gambia;0;0;17;1
2020-05-05;GM;Gambia;0;0;17;1
2020-05-06;GM;Gambia;0;0;17;1
2020-05-07;GM;Gambia;1;0;18;1
2020-05-08;GM;Gambia;2;0;20;1
2020-05-09;GM;Gambia;0;0;20;1
2020-05-10;GM;Gambia;0;0;20;1
2020-05-11;GM;Gambia;2;0;22;1
2020-05-12;GM;Gambia;0;0;22;1
2020-05-13;GM;Gambia;1;0;23;1
2020-05-14;GM;Gambia;0;0;23;1
2020-05-15;GM;Gambia;0;0;23;1
2020-05-16;GM;Gambia;0;0;23;1
2020-05-17;GM;Gambia;0;0;23;1
2020-05-18;GM;Gambia;1;0;24;1
2020-05-19;GM;Gambia;0;0;24;1
2020-05-20;GM;Gambia;0;0;24;1
2020-05-21;GM;Gambia;0;0;24;1
2020-05-22;GM;Gambia;1;0;25;1
2020-05-23;GM;Gambia;0;0;25;1
2020-05-24;GM;Gambia;0;0;25;1
2020-05-25;GM;Gambia;0;0;25;1
2020-05-26;GM;Gambia;0;0;25;1
2020-05-27;GM;Gambia;0;0;25;1
2020-05-28;GM;Gambia;0;0;25;1
2020-05-29;GM;Gambia;0;0;25;1
2020-05-30;GM;Gambia;0;0;25;1
2020-05-31;GM;Gambia;0;0;25;1
2020-06-01;GM;Gambia;0;0;25;1
2020-06-02;GM;Gambia;0;0;25;1
2020-06-03;GM;Gambia;1;0;26;1
2020-06-04;GM;Gambia;0;0;26;1
2020-06-05;GM;Gambia;0;0;26;1
2020-06-06;GM;Gambia;0;0;26;1
2020-06-07;GM;Gambia;0;0;26;1
2020-06-08;GM;Gambia;2;0;28;1
2020-06-09;GM;Gambia;0;0;28;1
2020-06-10;GM;Gambia;0;0;28;1
2020-06-11;GM;Gambia;0;0;28;1
2020-06-12;GM;Gambia;0;0;28;1
2020-06-13;GM;Gambia;0;0;28;1
2020-06-14;GM;Gambia;0;0;28;1
2020-06-15;GM;Gambia;2;0;30;1
2020-06-16;GM;Gambia;4;0;34;1
2020-06-17;GM;Gambia;0;0;34;1
2020-06-18;GM;Gambia;2;0;36;1
2020-06-19;GM;Gambia;0;0;36;1
2020-06-20;GM;Gambia;1;1;37;2
2020-06-21;GM;Gambia;0;0;37;2
2020-06-22;GM;Gambia;4;0;41;2
2020-06-23;GM;Gambia;1;0;42;2
2020-06-24;GM;Gambia;0;0;42;2
2020-06-25;GM;Gambia;1;0;43;2
2020-06-26;GM;Gambia;0;0;43;2
2020-06-27;GM;Gambia;1;0;44;2
2020-06-28;GM;Gambia;1;0;45;2
2020-06-29;GM;Gambia;2;0;47;2
2020-06-30;GM;Gambia;2;0;49;2
2020-07-01;GM;Gambia;0;0;49;2
2020-07-02;GM;Gambia;6;0;55;2
2020-07-03;GM;Gambia;0;0;55;2
2020-07-04;GM;Gambia;2;0;57;2
2020-07-05;GM;Gambia;0;0;57;2
2020-07-06;GM;Gambia;4;1;61;3
2020-07-07;GM;Gambia;0;0;61;3
2020-07-08;GM;Gambia;0;0;61;3
2020-07-09;GM;Gambia;2;0;63;3
2020-07-10;GM;Gambia;1;0;64;3
2020-07-11;GM;Gambia;0;0;64;3
2020-07-12;GM;Gambia;0;0;64;3
2020-07-13;GM;Gambia;0;0;64;3
2020-07-14;GM;Gambia;0;0;64;3
2020-07-15;GM;Gambia;0;0;64;3
2020-07-16;GM;Gambia;14;0;78;3
2020-07-17;GM;Gambia;0;0;78;3
2020-07-18;GM;Gambia;15;1;93;4
2020-07-19;GM;Gambia;0;0;93;4
2020-07-20;GM;Gambia;19;0;112;4
2020-07-21;GM;Gambia;0;0;112;4
2020-07-22;GM;Gambia;34;1;146;5
2020-07-23;GM;Gambia;24;0;170;5
2020-07-24;GM;Gambia;46;1;216;6
2020-07-25;GM;Gambia;61;0;277;6
2020-07-26;GM;Gambia;0;0;277;6
2020-07-27;GM;Gambia;49;2;326;8
2020-07-28;GM;Gambia;0;0;326;8
2020-07-29;GM;Gambia;0;0;326;8
2020-07-30;GM;Gambia;77;0;403;8
2020-07-31;GM;Gambia;95;1;498;9
2020-08-01;GM;Gambia;0;0;498;9
2020-08-02;GM;Gambia;0;0;498;9
2020-08-03;GM;Gambia;0;0;498;9
2020-08-04;GM;Gambia;173;5;671;14
2020-08-05;GM;Gambia;128;2;799;16
2020-08-06;GM;Gambia;136;0;935;16
2020-08-07;GM;Gambia;155;3;1090;19
2020-08-08;GM;Gambia;0;0;1090;19
2020-08-09;GM;Gambia;145;4;1235;23
2020-08-10;GM;Gambia;0;0;1235;23
2020-08-11;GM;Gambia;111;9;1346;32
2020-08-12;GM;Gambia;131;1;1477;33
2020-08-13;GM;Gambia;79;10;1556;43
2020-08-14;GM;Gambia;67;7;1623;50
2020-08-15;GM;Gambia;66;4;1689;54
2020-08-16;GM;Gambia;183;9;1872;63
2020-08-17;GM;Gambia;0;0;1872;63
2020-08-18;GM;Gambia;244;0;2116;63
2020-08-19;GM;Gambia;172;14;2288;77
2020-08-20;GM;Gambia;113;4;2401;81
2020-08-21;GM;Gambia;36;3;2437;84
2020-08-22;GM;Gambia;0;0;2437;84
2020-08-23;GM;Gambia;248;3;2685;87
2020-08-24;GM;Gambia;-100;0;2585;87
2020-08-25;GM;Gambia;101;3;2686;90
2020-08-26;GM;Gambia;22;3;2708;93
2020-08-27;GM;Gambia;35;0;2743;93
2020-08-28;GM;Gambia;54;3;2797;96
2020-08-29;GM;Gambia;98;0;2895;96
2020-08-30;GM;Gambia;68;0;2963;96
2020-08-31;GM;Gambia;0;0;2963;96
2020-09-01;GM;Gambia;66;0;3029;96
2020-09-02;GM;Gambia;38;1;3067;97
2020-09-03;GM;Gambia;34;2;3101;99
2020-09-04;GM;Gambia;19;0;3120;99
2020-09-05;GM;Gambia;30;0;3150;99
2020-09-06;GM;Gambia;47;0;3197;99
2020-09-07;GM;Gambia;0;0;3197;99
2020-09-08;GM;Gambia;78;0;3275;99
2020-09-09;GM;Gambia;18;0;3293;99
2020-09-10;GM;Gambia;37;1;3330;100
2020-09-11;GM;Gambia;32;0;3362;100
2020-09-12;GM;Gambia;14;2;3376;102
2020-09-13;GM;Gambia;29;1;3405;103
2020-09-14;GM;Gambia;0;0;3405;103
2020-09-15;GM;Gambia;23;2;3428;105
2020-09-16;GM;Gambia;12;2;3440;107
2020-09-17;GM;Gambia;33;0;3473;107
2020-09-18;GM;Gambia;12;1;3485;108
2020-09-19;GM;Gambia;19;0;3504;108
2020-09-20;GM;Gambia;22;0;3526;108
2020-09-21;GM;Gambia;0;0;3526;108
2020-09-22;GM;Gambia;14;2;3540;110
2020-09-23;GM;Gambia;2;0;3542;110
2020-09-24;GM;Gambia;10;0;3552;110
2020-09-25;GM;Gambia;3;0;3555;110
2020-09-26;GM;Gambia;0;0;3555;110
2020-09-27;GM;Gambia;14;1;3569;111
2020-09-28;GM;Gambia;0;0;3569;111
2020-09-29;GM;Gambia;10;1;3579;112
2020-09-30;GM;Gambia;0;0;3579;112
2020-10-01;GM;Gambia;5;1;3584;113
2020-10-02;GM;Gambia;1;2;3585;115
2020-10-03;GM;Gambia;5;0;3590;115
2020-10-04;GM;Gambia;4;0;3594;115
2020-10-05;GM;Gambia;0;0;3594;115
2020-10-06;GM;Gambia;19;2;3613;117
2020-10-07;GM;Gambia;0;0;3613;117
2020-10-08;GM;Gambia;4;0;3617;117
2020-10-09;GM;Gambia;4;0;3621;117
2020-10-10;GM;Gambia;7;0;3628;117
2020-10-11;GM;Gambia;4;0;3632;117
2020-10-12;GM;Gambia;4;1;3636;118
2020-10-13;GM;Gambia;0;0;3636;118
2020-10-14;GM;Gambia;6;0;3642;118
2020-10-15;GM;Gambia;2;0;3644;118
2020-10-16;GM;Gambia;5;0;3649;118
2020-10-17;GM;Gambia;0;0;3649;118
2020-10-18;GM;Gambia;0;0;3649;118
2020-10-19;GM;Gambia;0;0;3649;118
2020-10-20;GM;Gambia;6;0;3655;118
2020-10-21;GM;Gambia;2;0;3657;118
2020-10-22;GM;Gambia;2;1;3659;119
2020-10-23;GM;Gambia;0;0;3659;119
2020-10-24;GM;Gambia;0;0;3659;119
2020-10-25;GM;Gambia;1;0;3660;119
2020-10-26;GM;Gambia;5;0;3665;119
2020-10-27;GM;Gambia;1;0;3666;119
2020-10-28;GM;Gambia;0;0;3666;119
2020-10-29;GM;Gambia;0;0;3666;119
2020-10-30;GM;Gambia;4;0;3670;119
2020-10-31;GM;Gambia;2;0;3672;119
2020-11-01;GM;Gambia;0;0;3672;119
2020-11-02;GM;Gambia;0;0;3672;119
2020-11-03;GM;Gambia;7;1;3679;120
2020-11-04;GM;Gambia;1;0;3680;120
2020-11-05;GM;Gambia;1;0;3681;120
2020-11-06;GM;Gambia;3;1;3684;121
2020-11-07;GM;Gambia;0;0;3684;121
2020-11-08;GM;Gambia;0;0;3684;121
2020-11-09;GM;Gambia;12;1;3696;122
2020-11-10;GM;Gambia;0;0;3696;122
2020-11-11;GM;Gambia;1;0;3697;122
2020-11-12;GM;Gambia;0;0;3697;122
2020-11-13;GM;Gambia;1;0;3698;122
2020-11-14;GM;Gambia;4;0;3702;122
2020-11-15;GM;Gambia;0;0;3702;122
2020-11-16;GM;Gambia;3;0;3705;122
2020-11-17;GM;Gambia;0;0;3705;122
2020-11-18;GM;Gambia;0;0;3705;122
2020-11-19;GM;Gambia;0;0;3705;122
2020-11-20;GM;Gambia;1;0;3706;122
2020-11-21;GM;Gambia;20;1;3726;123
2020-11-22;GM;Gambia;0;0;3726;123
2020-11-23;GM;Gambia;0;0;3726;123
2020-11-24;GM;Gambia;0;0;3726;123
2020-11-25;GM;Gambia;1;0;3727;123
2020-11-26;GM;Gambia;1;0;3728;123
2020-11-27;GM;Gambia;3;0;3731;123
2020-11-28;GM;Gambia;0;0;3731;123
2020-11-29;GM;Gambia;3;0;3734;123
2020-11-30;GM;Gambia;8;0;3742;123
2020-12-01;GM;Gambia;1;0;3743;123
2020-12-02;GM;Gambia;22;0;3765;123
2020-12-03;GM;Gambia;2;0;3767;123
2020-12-04;GM;Gambia;1;0;3768;123
2020-12-05;GM;Gambia;2;0;3770;123
2020-12-06;GM;Gambia;0;0;3770;123
2020-12-07;GM;Gambia;0;0;3770;123
2020-12-08;GM;Gambia;6;0;3776;123
2020-12-09;GM;Gambia;0;0;3776;123
2020-12-10;GM;Gambia;1;0;3777;123
2020-12-11;GM;Gambia;2;0;3779;123
2020-12-12;GM;Gambia;0;0;3779;123
2020-12-13;GM;Gambia;3;0;3782;123
2020-12-14;GM;Gambia;0;0;3782;123
2020-12-15;GM;Gambia;3;0;3785;123
2020-12-16;GM;Gambia;1;0;3786;123
2020-12-17;GM;Gambia;0;0;3786;123
2020-12-18;GM;Gambia;0;0;3786;123
2020-12-19;GM;Gambia;0;0;3786;123
2020-12-20;GM;Gambia;0;0;3786;123
2020-12-21;GM;Gambia;0;0;3786;123
2020-12-22;GM;Gambia;5;0;3791;123
2020-12-23;GM;Gambia;0;0;3791;123
2020-12-24;GM;Gambia;0;0;3791;123
2020-12-25;GM;Gambia;0;0;3791;123
2020-12-26;GM;Gambia;0;0;3791;123
2020-12-27;GM;Gambia;2;0;3793;123
2020-12-28;GM;Gambia;0;0;3793;123
2020-12-29;GM;Gambia;4;1;3797;124
2020-12-30;GM;Gambia;0;0;3797;124
2020-12-31;GM;Gambia;0;0;3797;124
2021-01-01;GM;Gambia;3;0;3800;124
2021-01-02;GM;Gambia;0;0;3800;124
2021-01-03;GM;Gambia;0;0;3800;124
2021-01-04;GM;Gambia;0;0;3800;124
2021-01-05;GM;Gambia;12;1;3812;125
2021-01-06;GM;Gambia;0;0;3812;125
2021-01-07;GM;Gambia;21;0;3833;125
2021-01-08;GM;Gambia;5;0;3838;125
2021-01-09;GM;Gambia;3;0;3841;125
2021-01-10;GM;Gambia;16;0;3857;125
2021-01-11;GM;Gambia;0;0;3857;125
2021-01-12;GM;Gambia;19;0;3876;125
2021-01-13;GM;Gambia;9;0;3885;125
2021-01-14;GM;Gambia;8;1;3893;126
2021-01-15;GM;Gambia;4;1;3897;127
2021-01-16;GM;Gambia;0;0;3897;127
2021-01-17;GM;Gambia;13;0;3910;127
2021-01-18;GM;Gambia;23;1;3933;128
2021-01-19;GM;Gambia;5;0;3938;128
2021-01-20;GM;Gambia;0;0;3938;128
2021-01-21;GM;Gambia;12;0;3950;128
2021-01-22;GM;Gambia;8;0;3958;128
2021-01-23;GM;Gambia;0;0;3958;128
2021-01-24;GM;Gambia;14;0;3972;128
2021-01-25;GM;Gambia;36;0;4008;128
2021-01-26;GM;Gambia;4;0;4012;128
2021-01-27;GM;Gambia;7;0;4019;128
2021-01-28;GM;Gambia;0;0;4019;128
2021-01-29;GM;Gambia;0;0;4019;128
2021-01-30;GM;Gambia;71;0;4090;128
2021-01-31;GM;Gambia;0;0;4090;128
2021-02-01;GM;Gambia;49;3;4139;131
2021-02-02;GM;Gambia;0;0;4139;131
2021-02-03;GM;Gambia;45;1;4184;132
2021-02-04;GM;Gambia;0;0;4184;132
2021-02-05;GM;Gambia;0;0;4184;132
2021-02-06;GM;Gambia;53;2;4237;134
2021-02-07;GM;Gambia;0;0;4237;134
2021-02-08;GM;Gambia;65;1;4302;135
2021-02-09;GM;Gambia;0;0;4302;135
2021-02-10;GM;Gambia;0;0;4302;135
2021-02-11;GM;Gambia;0;0;4302;135
2021-02-12;GM;Gambia;0;0;4302;135
2021-02-13;GM;Gambia;0;0;4302;135
2021-02-14;GM;Gambia;112;3;4414;138
2021-02-15;GM;Gambia;0;0;4414;138
2021-02-16;GM;Gambia;55;0;4469;138
2021-02-17;GM;Gambia;0;0;4469;138
2021-02-18;GM;Gambia;41;1;4510;139
2021-02-19;GM;Gambia;33;4;4543;143
2021-02-20;GM;Gambia;11;1;4554;144
2021-02-21;GM;Gambia;0;0;4554;144
2021-02-22;GM;Gambia;0;0;4554;144
2021-02-23;GM;Gambia;58;2;4612;146
2021-02-24;GM;Gambia;28;1;4640;147
2021-02-25;GM;Gambia;31;0;4671;147
2021-02-26;GM;Gambia;20;1;4691;148
2021-02-27;GM;Gambia;0;0;4691;148
2021-02-28;GM;Gambia;21;2;4712;150
2021-03-01;GM;Gambia;0;0;4712;150
2021-03-02;GM;Gambia;0;0;4712;150
2021-03-03;GM;Gambia;23;1;4735;151
2021-03-04;GM;Gambia;24;1;4759;152
2021-03-05;GM;Gambia;0;0;4759;152
2021-03-06;GM;Gambia;0;0;4759;152
2021-03-07;GM;Gambia;0;0;4759;152
2021-03-08;GM;Gambia;33;1;4792;153
2021-03-09;GM;Gambia;0;0;4792;153
2021-03-10;GM;Gambia;0;0;4792;153
2021-03-11;GM;Gambia;0;0;4792;153
2021-03-12;GM;Gambia;147;0;4939;153
2021-03-13;GM;Gambia;46;0;4985;153
2021-03-14;GM;Gambia;0;0;4985;153
2021-03-15;GM;Gambia;34;0;5019;153
2021-03-16;GM;Gambia;0;0;5019;153
2021-03-17;GM;Gambia;66;5;5085;158
2021-03-18;GM;Gambia;37;2;5122;160
2021-03-19;GM;Gambia;31;0;5153;160
2021-03-20;GM;Gambia;0;0;5153;160
2021-03-21;GM;Gambia;102;1;5255;161
2021-03-22;GM;Gambia;0;0;5255;161
2021-03-23;GM;Gambia;0;0;5255;161
2021-03-24;GM;Gambia;48;0;5303;161
2021-03-25;GM;Gambia;0;0;5303;161
2021-03-26;GM;Gambia;62;2;5365;163
2021-03-27;GM;Gambia;0;0;5365;163
2021-03-28;GM;Gambia;36;0;5401;163
2021-03-29;GM;Gambia;19;1;5420;164
2021-03-30;GM;Gambia;27;1;5447;165
2021-03-31;GM;Gambia;12;0;5459;165
2021-04-01;GM;Gambia;0;0;5459;165
2021-04-02;GM;Gambia;0;0;5459;165
2021-04-03;GM;Gambia;46;1;5505;166
2021-04-04;GM;Gambia;0;0;5505;166
2021-04-05;GM;Gambia;0;0;5505;166
2021-04-06;GM;Gambia;59;0;5564;166
2021-04-07;GM;Gambia;0;0;5564;166
2021-04-08;GM;Gambia;0;0;5564;166
2021-04-09;GM;Gambia;0;0;5564;166
2021-04-10;GM;Gambia;38;2;5602;168
2021-04-11;GM;Gambia;0;0;5602;168
2021-04-12;GM;Gambia;0;0;5602;168
2021-04-13;GM;Gambia;0;0;5602;168
2021-04-14;GM;Gambia;80;2;5682;170
2021-04-15;GM;Gambia;12;0;5694;170
2021-04-16;GM;Gambia;26;0;5720;170
2021-04-17;GM;Gambia;0;0;5720;170
2021-04-18;GM;Gambia;0;0;5720;170
2021-04-19;GM;Gambia;0;0;5720;170
2021-04-20;GM;Gambia;64;0;5784;170
2021-04-21;GM;Gambia;4;1;5788;171
2021-04-22;GM;Gambia;32;2;5820;173
2021-04-23;GM;Gambia;0;0;5820;173
2021-04-24;GM;Gambia;37;0;5857;173
2021-04-25;GM;Gambia;0;0;5857;173
2021-04-26;GM;Gambia;0;0;5857;173
2021-04-27;GM;Gambia;25;1;5882;174
2021-04-28;GM;Gambia;3;0;5885;174
2021-04-29;GM;Gambia;2;0;5887;174
2021-04-30;GM;Gambia;11;0;5898;174
2021-05-01;GM;Gambia;0;0;5898;174
2021-05-02;GM;Gambia;3;1;5901;175
2021-05-03;GM;Gambia;0;0;5901;175
2021-05-04;GM;Gambia;13;0;5914;175
2021-05-05;GM;Gambia;0;0;5914;175
2021-05-06;GM;Gambia;11;0;5925;175
2021-05-07;GM;Gambia;0;0;5925;175
2021-05-08;GM;Gambia;0;0;5925;175
2021-05-09;GM;Gambia;4;0;5929;175
2021-05-10;GM;Gambia;0;0;5929;175
2021-05-11;GM;Gambia;5;0;5934;175
2021-05-12;GM;Gambia;0;0;5934;175
2021-05-13;GM;Gambia;0;0;5934;175
2021-05-14;GM;Gambia;6;0;5940;175
2021-05-15;GM;Gambia;0;0;5940;175
2021-05-16;GM;Gambia;0;0;5940;175
2021-05-17;GM;Gambia;17;0;5957;175
2021-05-18;GM;Gambia;0;0;5957;175
2021-05-19;GM;Gambia;9;0;5966;175
2021-05-20;GM;Gambia;2;0;5968;175
2021-05-21;GM;Gambia;0;0;5968;175
2021-05-22;GM;Gambia;0;0;5968;175
2021-05-23;GM;Gambia;0;0;5968;175
2021-05-24;GM;Gambia;10;3;5978;178
2021-05-25;GM;Gambia;0;0;5978;178
2021-05-26;GM;Gambia;0;0;5978;178
2021-05-27;GM;Gambia;12;0;5990;178
2021-05-28;GM;Gambia;0;0;5990;178
2021-05-29;GM;Gambia;0;0;5990;178
2021-05-30;GM;Gambia;0;0;5990;178
2021-05-31;GM;Gambia;3;1;5993;179
2021-06-01;GM;Gambia;0;0;5993;179
2021-06-02;GM;Gambia;0;0;5993;179
2021-06-03;GM;Gambia;2;0;5995;179
2021-06-04;GM;Gambia;4;0;5999;179
2021-06-05;GM;Gambia;0;0;5999;179
2021-06-06;GM;Gambia;0;0;5999;179
2021-06-07;GM;Gambia;3;0;6002;179
2021-06-08;GM;Gambia;0;0;6002;179
2021-06-09;GM;Gambia;0;0;6002;179
2021-06-10;GM;Gambia;0;0;6002;179
2021-06-11;GM;Gambia;6;1;6008;180
2021-06-12;GM;Gambia;0;0;6008;180
2021-06-13;GM;Gambia;0;0;6008;180
2021-06-14;GM;Gambia;8;0;6016;180
2021-06-15;GM;Gambia;0;0;6016;180
2021-06-16;GM;Gambia;8;1;6024;181
2021-06-17;GM;Gambia;0;0;6024;181
2021-06-18;GM;Gambia;0;0;6024;181
2021-06-19;GM;Gambia;0;0;6024;181
2021-06-20;GM;Gambia;0;0;6024;181
2021-06-21;GM;Gambia;21;0;6045;181
2021-06-22;GM;Gambia;0;0;6045;181
2021-06-23;GM;Gambia;0;0;6045;181
2021-06-24;GM;Gambia;9;0;6054;181
2021-06-25;GM;Gambia;11;0;6065;181
2021-06-26;GM;Gambia;4;0;6069;181
2021-06-27;GM;Gambia;0;0;6069;181
2021-06-28;GM;Gambia;0;0;6069;181
2021-06-29;GM;Gambia;10;0;6079;181
2021-06-30;GM;Gambia;0;0;6079;181
2021-07-01;GM;Gambia;0;0;6079;181
2020-02-26;GE;Georgia;1;0;1;0
2020-02-27;GE;Georgia;0;0;1;0
2020-02-28;GE;Georgia;0;0;1;0
2020-02-29;GE;Georgia;0;0;1;0
2020-03-01;GE;Georgia;2;0;3;0
2020-03-02;GE;Georgia;0;0;3;0
2020-03-03;GE;Georgia;0;0;3;0
2020-03-04;GE;Georgia;0;0;3;0
2020-03-05;GE;Georgia;1;0;4;0
2020-03-06;GE;Georgia;0;0;4;0
2020-03-07;GE;Georgia;0;0;4;0
2020-03-08;GE;Georgia;9;0;13;0
2020-03-09;GE;Georgia;2;0;15;0
2020-03-10;GE;Georgia;0;0;15;0
2020-03-11;GE;Georgia;9;0;24;0
2020-03-12;GE;Georgia;0;0;24;0
2020-03-13;GE;Georgia;1;0;25;0
2020-03-14;GE;Georgia;5;0;30;0
2020-03-15;GE;Georgia;3;0;33;0
2020-03-16;GE;Georgia;0;0;33;0
2020-03-17;GE;Georgia;1;0;34;0
2020-03-18;GE;Georgia;4;0;38;0
2020-03-19;GE;Georgia;2;0;40;0
2020-03-20;GE;Georgia;3;0;43;0
2020-03-21;GE;Georgia;6;0;49;0
2020-03-22;GE;Georgia;5;0;54;0
2020-03-23;GE;Georgia;7;0;61;0
2020-03-24;GE;Georgia;9;0;70;0
2020-03-25;GE;Georgia;5;0;75;0
2020-03-26;GE;Georgia;4;0;79;0
2020-03-27;GE;Georgia;4;0;83;0
2020-03-28;GE;Georgia;7;0;90;0
2020-03-29;GE;Georgia;1;0;91;0
2020-03-30;GE;Georgia;12;0;103;0
2020-03-31;GE;Georgia;7;0;110;0
2020-04-01;GE;Georgia;7;0;117;0
2020-04-02;GE;Georgia;17;0;134;0
2020-04-03;GE;Georgia;21;0;155;0
2020-04-04;GE;Georgia;7;1;162;1
2020-04-05;GE;Georgia;12;1;174;2
2020-04-06;GE;Georgia;14;0;188;2
2020-04-07;GE;Georgia;8;1;196;3
2020-04-08;GE;Georgia;15;0;211;3
2020-04-09;GE;Georgia;7;0;218;3
2020-04-10;GE;Georgia;16;0;234;3
2020-04-11;GE;Georgia;8;0;242;3
2020-04-12;GE;Georgia;15;0;257;3
2020-04-13;GE;Georgia;15;0;272;3
2020-04-14;GE;Georgia;28;0;300;3
2020-04-15;GE;Georgia;6;0;306;3
2020-04-16;GE;Georgia;42;0;348;3
2020-04-17;GE;Georgia;22;0;370;3
2020-04-18;GE;Georgia;18;1;388;4
2020-04-19;GE;Georgia;6;0;394;4
2020-04-20;GE;Georgia;8;0;402;4
2020-04-21;GE;Georgia;6;0;408;4
2020-04-22;GE;Georgia;8;1;416;5
2020-04-23;GE;Georgia;9;0;425;5
2020-04-24;GE;Georgia;19;0;444;5
2020-04-25;GE;Georgia;12;0;456;5
2020-04-26;GE;Georgia;30;1;486;6
2020-04-27;GE;Georgia;11;0;497;6
2020-04-28;GE;Georgia;14;0;511;6
2020-04-29;GE;Georgia;6;0;517;6
2020-04-30;GE;Georgia;22;0;539;6
2020-05-01;GE;Georgia;27;1;566;7
2020-05-02;GE;Georgia;16;1;582;8
2020-05-03;GE;Georgia;7;1;589;9
2020-05-04;GE;Georgia;4;0;593;9
2020-05-05;GE;Georgia;11;0;604;9
2020-05-06;GE;Georgia;6;0;610;9
2020-05-07;GE;Georgia;5;0;615;9
2020-05-08;GE;Georgia;8;1;623;10
2020-05-09;GE;Georgia;3;0;626;10
2020-05-10;GE;Georgia;9;0;635;10
2020-05-11;GE;Georgia;3;1;638;11
2020-05-12;GE;Georgia;4;0;642;11
2020-05-13;GE;Georgia;5;0;647;11
2020-05-14;GE;Georgia;20;1;667;12
2020-05-15;GE;Georgia;4;0;671;12
2020-05-16;GE;Georgia;12;0;683;12
2020-05-17;GE;Georgia;12;0;695;12
2020-05-18;GE;Georgia;6;0;701;12
2020-05-19;GE;Georgia;6;0;707;12
2020-05-20;GE;Georgia;6;0;713;12
2020-05-21;GE;Georgia;8;0;721;12
2020-05-22;GE;Georgia;2;0;723;12
2020-05-23;GE;Georgia;5;0;728;12
2020-05-24;GE;Georgia;2;0;730;12
2020-05-25;GE;Georgia;1;0;731;12
2020-05-26;GE;Georgia;1;0;732;12
2020-05-27;GE;Georgia;3;0;735;12
2020-05-28;GE;Georgia;3;0;738;12
2020-05-29;GE;Georgia;8;0;746;12
2020-05-30;GE;Georgia;11;0;757;12
2020-05-31;GE;Georgia;26;0;783;12
2020-06-01;GE;Georgia;11;0;794;12
2020-06-02;GE;Georgia;2;1;796;13
2020-06-03;GE;Georgia;4;0;800;13
2020-06-04;GE;Georgia;1;0;801;13
2020-06-05;GE;Georgia;4;0;805;13
2020-06-06;GE;Georgia;3;0;808;13
2020-06-07;GE;Georgia;1;0;809;13
2020-06-08;GE;Georgia;3;0;812;13
2020-06-09;GE;Georgia;6;0;818;13
2020-06-10;GE;Georgia;9;0;827;13
2020-06-11;GE;Georgia;4;0;831;13
2020-06-12;GE;Georgia;12;0;843;13
2020-06-13;GE;Georgia;8;1;851;14
2020-06-14;GE;Georgia;13;0;864;14
2020-06-15;GE;Georgia;15;0;879;14
2020-06-16;GE;Georgia;0;0;879;14
2020-06-17;GE;Georgia;9;0;888;14
2020-06-18;GE;Georgia;5;0;893;14
2020-06-19;GE;Georgia;3;0;896;14
2020-06-20;GE;Georgia;2;0;898;14
2020-06-21;GE;Georgia;8;0;906;14
2020-06-22;GE;Georgia;2;0;908;14
2020-06-23;GE;Georgia;3;0;911;14
2020-06-24;GE;Georgia;3;0;914;14
2020-06-25;GE;Georgia;3;0;917;14
2020-06-26;GE;Georgia;2;0;919;14
2020-06-27;GE;Georgia;2;0;921;14
2020-06-28;GE;Georgia;3;1;924;15
2020-06-29;GE;Georgia;2;0;926;15
2020-06-30;GE;Georgia;2;0;928;15
2020-07-01;GE;Georgia;3;0;931;15
2020-07-02;GE;Georgia;8;0;939;15
2020-07-03;GE;Georgia;4;0;943;15
2020-07-04;GE;Georgia;5;0;948;15
2020-07-05;GE;Georgia;3;0;951;15
2020-07-06;GE;Georgia;2;0;953;15
2020-07-07;GE;Georgia;5;0;958;15
2020-07-08;GE;Georgia;5;0;963;15
2020-07-09;GE;Georgia;5;0;968;15
2020-07-10;GE;Georgia;5;0;973;15
2020-07-11;GE;Georgia;8;0;981;15
2020-07-12;GE;Georgia;5;0;986;15
2020-07-13;GE;Georgia;9;0;995;15
2020-07-14;GE;Georgia;4;0;999;15
2020-07-15;GE;Georgia;5;0;1004;15
2020-07-16;GE;Georgia;2;0;1006;15
2020-07-17;GE;Georgia;4;0;1010;15
2020-07-18;GE;Georgia;8;0;1018;15
2020-07-19;GE;Georgia;10;0;1028;15
2020-07-20;GE;Georgia;11;1;1039;16
2020-07-21;GE;Georgia;10;0;1049;16
2020-07-22;GE;Georgia;24;0;1073;16
2020-07-23;GE;Georgia;12;0;1085;16
2020-07-24;GE;Georgia;19;0;1104;16
2020-07-25;GE;Georgia;13;0;1117;16
2020-07-26;GE;Georgia;14;0;1131;16
2020-07-27;GE;Georgia;6;0;1137;16
2020-07-28;GE;Georgia;8;0;1145;16
2020-07-29;GE;Georgia;10;1;1155;17
2020-07-30;GE;Georgia;5;0;1160;17
2020-07-31;GE;Georgia;8;0;1168;17
2020-08-01;GE;Georgia;3;0;1171;17
2020-08-02;GE;Georgia;6;0;1177;17
2020-08-03;GE;Georgia;2;0;1179;17
2020-08-04;GE;Georgia;3;0;1182;17
2020-08-05;GE;Georgia;15;0;1197;17
2020-08-06;GE;Georgia;9;0;1206;17
2020-08-07;GE;Georgia;7;0;1213;17
2020-08-08;GE;Georgia;3;0;1216;17
2020-08-09;GE;Georgia;9;0;1225;17
2020-08-10;GE;Georgia;25;0;1250;17
2020-08-11;GE;Georgia;14;0;1264;17
2020-08-12;GE;Georgia;14;0;1278;17
2020-08-13;GE;Georgia;5;0;1283;17
2020-08-14;GE;Georgia;23;0;1306;17
2020-08-15;GE;Georgia;15;0;1321;17
2020-08-16;GE;Georgia;15;0;1336;17
2020-08-17;GE;Georgia;5;0;1341;17
2020-08-18;GE;Georgia;10;0;1351;17
2020-08-19;GE;Georgia;10;0;1361;17
2020-08-20;GE;Georgia;9;0;1370;17
2020-08-21;GE;Georgia;15;0;1385;17
2020-08-22;GE;Georgia;9;0;1394;17
2020-08-23;GE;Georgia;17;0;1411;17
2020-08-24;GE;Georgia;10;1;1421;18
2020-08-25;GE;Georgia;8;1;1429;19
2020-08-26;GE;Georgia;7;0;1436;19
2020-08-27;GE;Georgia;11;0;1447;19
2020-08-28;GE;Georgia;8;0;1455;19
2020-08-29;GE;Georgia;7;0;1462;19
2020-08-30;GE;Georgia;7;0;1469;19
2020-08-31;GE;Georgia;18;0;1487;19
2020-09-01;GE;Georgia;23;0;1510;19
2020-09-02;GE;Georgia;38;0;1548;19
2020-09-03;GE;Georgia;20;0;1568;19
2020-09-04;GE;Georgia;28;0;1596;19
2020-09-05;GE;Georgia;25;0;1621;19
2020-09-06;GE;Georgia;29;0;1650;19
2020-09-07;GE;Georgia;34;0;1684;19
2020-09-08;GE;Georgia;45;0;1729;19
2020-09-09;GE;Georgia;44;0;1773;19
2020-09-10;GE;Georgia;57;0;1830;19
2020-09-11;GE;Georgia;87;0;1917;19
2020-09-12;GE;Georgia;158;0;2075;19
2020-09-13;GE;Georgia;152;0;2227;19
2020-09-14;GE;Georgia;165;0;2392;19
2020-09-15;GE;Georgia;170;0;2562;19
2020-09-16;GE;Georgia;196;0;2758;19
2020-09-17;GE;Georgia;179;0;2937;19
2020-09-18;GE;Georgia;182;0;3119;19
2020-09-19;GE;Georgia;187;0;3306;19
2020-09-20;GE;Georgia;196;0;3502;19
2020-09-21;GE;Georgia;193;1;3695;20
2020-09-22;GE;Georgia;218;3;3913;23
2020-09-23;GE;Georgia;227;2;4140;25
2020-09-24;GE;Georgia;259;1;4399;26
2020-09-25;GE;Georgia;265;1;4664;27
2020-09-26;GE;Georgia;296;1;4960;28
2020-09-27;GE;Georgia;294;0;5254;28
2020-09-28;GE;Georgia;298;4;5552;32
2020-09-29;GE;Georgia;314;4;5866;36
2020-09-30;GE;Georgia;326;3;6192;39
2020-10-01;GE;Georgia;448;2;6640;41
2020-10-02;GE;Georgia;453;5;7093;46
2020-10-03;GE;Georgia;471;2;7564;48
2020-10-04;GE;Georgia;554;2;8118;50
2020-10-05;GE;Georgia;578;4;8696;54
2020-10-06;GE;Georgia;549;4;9245;58
2020-10-07;GE;Georgia;508;5;9753;63
2020-10-08;GE;Georgia;472;3;10225;66
2020-10-09;GE;Georgia;527;6;10752;72
2020-10-10;GE;Georgia;519;6;11271;78
2020-10-11;GE;Georgia;523;7;11794;85
2020-10-12;GE;Georgia;478;8;12272;93
2020-10-13;GE;Georgia;569;9;12841;102
2020-10-14;GE;Georgia;680;7;13521;109
2020-10-15;GE;Georgia;919;4;14440;113
2020-10-16;GE;Georgia;887;11;15327;124
2020-10-17;GE;Georgia;958;4;16285;128
2020-10-18;GE;Georgia;1192;8;17477;136
2020-10-19;GE;Georgia;1186;7;18663;143
2020-10-20;GE;Georgia;1194;15;19857;158
2020-10-21;GE;Georgia;1351;14;21208;172
2020-10-22;GE;Georgia;1595;6;22803;178
2020-10-23;GE;Georgia;1759;5;24562;183
2020-10-24;GE;Georgia;1941;10;26503;193
2020-10-25;GE;Georgia;1928;8;28431;201
2020-10-26;GE;Georgia;1872;14;30303;215
2020-10-27;GE;Georgia;1824;23;32127;238
2020-10-28;GE;Georgia;1731;15;33858;253
2020-10-29;GE;Georgia;1709;20;35567;273
2020-10-30;GE;Georgia;1696;12;37263;285
2020-10-31;GE;Georgia;1673;22;38936;307
2020-11-01;GE;Georgia;1791;28;40727;335
2020-11-02;GE;Georgia;1852;7;42579;342
2020-11-03;GE;Georgia;1943;20;44522;362
2020-11-04;GE;Georgia;2295;19;46817;381
2020-11-05;GE;Georgia;2401;20;49218;401
2020-11-06;GE;Georgia;2775;22;51993;423
2020-11-07;GE;Georgia;2859;18;54852;441
2020-11-08;GE;Georgia;2901;34;57753;475
2020-11-09;GE;Georgia;2927;24;60680;499
2020-11-10;GE;Georgia;2970;22;63650;521
2020-11-11;GE;Georgia;2911;45;66561;566
2020-11-12;GE;Georgia;3120;33;69681;599
2020-11-13;GE;Georgia;3473;37;73154;636
2020-11-14;GE;Georgia;3504;33;76658;669
2020-11-15;GE;Georgia;3020;34;79678;703
2020-11-16;GE;Georgia;3157;30;82835;733
2020-11-17;GE;Georgia;3117;45;85952;778
2020-11-18;GE;Georgia;3443;37;89395;815
2020-11-19;GE;Georgia;3697;38;93092;853
2020-11-20;GE;Georgia;3768;41;96860;894
2020-11-21;GE;Georgia;3824;33;100684;927
2020-11-22;GE;Georgia;4048;49;104732;976
2020-11-23;GE;Georgia;3958;36;108690;1012
2020-11-24;GE;Georgia;3128;39;111818;1051
2020-11-25;GE;Georgia;3071;34;114889;1085
2020-11-26;GE;Georgia;3801;39;118690;1124
2020-11-27;GE;Georgia;4780;37;123470;1161
2020-11-28;GE;Georgia;4472;34;127942;1195
2020-11-29;GE;Georgia;4426;35;132368;1230
2020-11-30;GE;Georgia;3216;37;135584;1267
2020-12-01;GE;Georgia;3759;36;139343;1303
2020-12-02;GE;Georgia;4033;39;143376;1342
2020-12-03;GE;Georgia;4260;45;147636;1387
2020-12-04;GE;Georgia;5068;38;152704;1425
2020-12-05;GE;Georgia;5450;37;158154;1462
2020-12-06;GE;Georgia;4321;42;162475;1504
2020-12-07;GE;Georgia;2501;36;164976;1540
2020-12-08;GE;Georgia;4673;36;169649;1576
2020-12-09;GE;Georgia;4734;38;174383;1614
2020-12-10;GE;Georgia;4570;43;178953;1657
2020-12-11;GE;Georgia;4146;37;183099;1694
2020-12-12;GE;Georgia;3907;50;187006;1744
2020-12-13;GE;Georgia;2720;46;189726;1790
2020-12-14;GE;Georgia;1337;49;191063;1839
2020-12-15;GE;Georgia;3837;44;194900;1883
2020-12-16;GE;Georgia;3487;39;198387;1922
2020-12-17;GE;Georgia;2981;31;201368;1953
2020-12-18;GE;Georgia;2635;49;204003;2002
2020-12-19;GE;Georgia;2904;53;206907;2055
2020-12-20;GE;Georgia;1731;39;208638;2094
2020-12-21;GE;Georgia;824;46;209462;2140
2020-12-22;GE;Georgia;3064;42;212526;2182
2020-12-23;GE;Georgia;2345;51;214871;2233
2020-12-24;GE;Georgia;1972;43;216843;2276
2020-12-25;GE;Georgia;1881;37;218724;2313
2020-12-26;GE;Georgia;1784;39;220508;2352
2020-12-27;GE;Georgia;1097;25;221605;2377
2020-12-28;GE;Georgia;538;41;222143;2418
2020-12-29;GE;Georgia;2012;25;224155;2443
2020-12-30;GE;Georgia;1738;38;225893;2481
2020-12-31;GE;Georgia;1527;24;227420;2505
2021-01-01;GE;Georgia;990;23;228410;2528
2021-01-02;GE;Georgia;342;44;228752;2572
2021-01-03;GE;Georgia;417;31;229169;2603
2021-01-04;GE;Georgia;594;25;229763;2628
2021-01-05;GE;Georgia;2316;18;232079;2646
2021-01-06;GE;Georgia;1800;20;233879;2666
2021-01-07;GE;Georgia;1612;28;235491;2694
2021-01-08;GE;Georgia;537;34;236028;2728
2021-01-09;GE;Georgia;2058;22;238086;2750
2021-01-10;GE;Georgia;1143;23;239229;2773
2021-01-11;GE;Georgia;551;23;239780;2796
2021-01-12;GE;Georgia;1857;24;241637;2820
2021-01-13;GE;Georgia;1618;26;243255;2846
2021-01-14;GE;Georgia;1357;21;244612;2867
2021-01-15;GE;Georgia;1177;26;245789;2893
2021-01-16;GE;Georgia;1236;23;247025;2916
2021-01-17;GE;Georgia;780;17;247805;2933
2021-01-18;GE;Georgia;110;25;247915;2958
2021-01-19;GE;Georgia;1550;15;249465;2973
2021-01-20;GE;Georgia;469;14;249934;2987
2021-01-21;GE;Georgia;1137;11;251071;2998
2021-01-22;GE;Georgia;903;24;251974;3022
2021-01-23;GE;Georgia;998;16;252972;3038
2021-01-24;GE;Georgia;546;17;253518;3055
2021-01-25;GE;Georgia;298;16;253816;3071
2021-01-26;GE;Georgia;1006;25;254822;3096
2021-01-27;GE;Georgia;742;12;255564;3108
2021-01-28;GE;Georgia;723;19;256287;3127
2021-01-29;GE;Georgia;669;21;256956;3148
2021-01-30;GE;Georgia;676;11;257632;3159
2021-01-31;GE;Georgia;479;19;258111;3178
2021-02-01;GE;Georgia;240;16;258351;3194
2021-02-02;GE;Georgia;858;14;259209;3208
2021-02-03;GE;Georgia;688;13;259897;3221
2021-02-04;GE;Georgia;583;19;260480;3240
2021-02-05;GE;Georgia;538;18;261018;3258
2021-02-06;GE;Georgia;602;11;261620;3269
2021-02-07;GE;Georgia;404;14;262024;3283
2021-02-08;GE;Georgia;204;15;262228;3298
2021-02-09;GE;Georgia;829;8;263057;3306
2021-02-10;GE;Georgia;544;5;263601;3311
2021-02-11;GE;Georgia;557;10;264158;3321
2021-02-12;GE;Georgia;507;15;264665;3336
2021-02-13;GE;Georgia;535;7;265200;3343
2021-02-14;GE;Georgia;357;9;265557;3352
2021-02-15;GE;Georgia;165;11;265722;3363
2021-02-16;GE;Georgia;740;14;266462;3377
2021-02-17;GE;Georgia;486;13;266948;3390
2021-02-18;GE;Georgia;365;9;267313;3399
2021-02-19;GE;Georgia;388;7;267701;3406
2021-02-20;GE;Georgia;396;19;268097;3425
2021-02-21;GE;Georgia;258;10;268355;3435
2021-02-22;GE;Georgia;147;12;268502;3447
2021-02-23;GE;Georgia;493;10;268995;3457
2021-02-24;GE;Georgia;443;6;269438;3463
2021-02-25;GE;Georgia;362;12;269800;3475
2021-02-26;GE;Georgia;337;10;270137;3485
2021-02-27;GE;Georgia;373;14;270510;3499
2021-02-28;GE;Georgia;248;11;270758;3510
2021-03-01;GE;Georgia;160;10;270918;3520
2021-03-02;GE;Georgia;461;12;271379;3532
2021-03-03;GE;Georgia;360;9;271739;3541
2021-03-04;GE;Georgia;133;12;271872;3553
2021-03-05;GE;Georgia;390;10;272262;3563
2021-03-06;GE;Georgia;355;4;272617;3567
2021-03-07;GE;Georgia;234;9;272851;3576
2021-03-08;GE;Georgia;147;15;272998;3591
2021-03-09;GE;Georgia;139;10;273137;3601
2021-03-10;GE;Georgia;513;12;273650;3613
2021-03-11;GE;Georgia;395;9;274045;3622
2021-03-12;GE;Georgia;332;12;274377;3634
2021-03-13;GE;Georgia;344;9;274721;3643
2021-03-14;GE;Georgia;268;5;274989;3648
2021-03-15;GE;Georgia;159;2;275148;3650
2021-03-16;GE;Georgia;537;8;275685;3658
2021-03-17;GE;Georgia;382;7;276067;3665
2021-03-18;GE;Georgia;369;9;276436;3674
2021-03-19;GE;Georgia;360;9;276796;3683
2021-03-20;GE;Georgia;422;8;277218;3691
2021-03-21;GE;Georgia;262;9;277480;3700
2021-03-22;GE;Georgia;170;10;277650;3710
2021-03-23;GE;Georgia;528;4;278178;3714
2021-03-24;GE;Georgia;450;8;278628;3722
2021-03-25;GE;Georgia;399;10;279027;3732
2021-03-26;GE;Georgia;419;6;279446;3738
2021-03-27;GE;Georgia;490;8;279936;3746
2021-03-28;GE;Georgia;365;5;280301;3751
2021-03-29;GE;Georgia;171;14;280472;3765
2021-03-30;GE;Georgia;673;8;281145;3773
2021-03-31;GE;Georgia;616;5;281761;3778
2021-04-01;GE;Georgia;499;7;282260;3785
2021-04-02;GE;Georgia;529;13;282789;3798
2021-04-03;GE;Georgia;580;6;283369;3804
2021-04-04;GE;Georgia;464;7;283833;3811
2021-04-05;GE;Georgia;228;11;284061;3822
2021-04-06;GE;Georgia;897;10;284958;3832
2021-04-07;GE;Georgia;687;8;285645;3840
2021-04-08;GE;Georgia;761;9;286406;3849
2021-04-09;GE;Georgia;777;9;287183;3858
2021-04-10;GE;Georgia;506;11;287689;3869
2021-04-11;GE;Georgia;707;8;288396;3877
2021-04-12;GE;Georgia;359;6;288755;3883
2021-04-13;GE;Georgia;1374;11;290129;3894
2021-04-14;GE;Georgia;1085;7;291214;3901
2021-04-15;GE;Georgia;1030;7;292244;3908
2021-04-16;GE;Georgia;1077;8;293321;3916
2021-04-17;GE;Georgia;1219;9;294540;3925
2021-04-18;GE;Georgia;818;14;295358;3939
2021-04-19;GE;Georgia;578;10;295936;3949
2021-04-20;GE;Georgia;1792;10;297728;3959
2021-04-21;GE;Georgia;1310;12;299038;3971
2021-04-22;GE;Georgia;1226;10;300264;3981
2021-04-23;GE;Georgia;1271;11;301535;3992
2021-04-24;GE;Georgia;1250;15;302785;4007
2021-04-25;GE;Georgia;966;18;303751;4025
2021-04-26;GE;Georgia;521;18;304272;4043
2021-04-27;GE;Georgia;1578;17;305850;4060
2021-04-28;GE;Georgia;1551;17;307401;4077
2021-04-29;GE;Georgia;1433;18;308834;4095
2021-04-30;GE;Georgia;1476;15;310310;4110
2021-05-01;GE;Georgia;1147;20;311457;4130
2021-05-02;GE;Georgia;988;21;312445;4151
2021-05-03;GE;Georgia;509;12;312954;4163
2021-05-04;GE;Georgia;788;20;313742;4183
2021-05-05;GE;Georgia;2171;24;315913;4207
2021-05-06;GE;Georgia;1806;20;317719;4227
2021-05-07;GE;Georgia;1547;18;319266;4245
2021-05-08;GE;Georgia;1564;18;320830;4263
2021-05-09;GE;Georgia;1089;18;321919;4281
2021-05-10;GE;Georgia;549;24;322468;4305
2021-05-11;GE;Georgia;1788;31;324256;4336
2021-05-12;GE;Georgia;1409;27;325665;4363
2021-05-13;GE;Georgia;776;16;326441;4379
2021-05-14;GE;Georgia;1390;18;327831;4397
2021-05-15;GE;Georgia;1576;29;329407;4426
2021-05-16;GE;Georgia;968;16;330375;4442
2021-05-17;GE;Georgia;504;27;330879;4469
2021-05-18;GE;Georgia;1562;30;332441;4499
2021-05-19;GE;Georgia;1160;20;333601;4519
2021-05-20;GE;Georgia;1104;21;334705;4540
2021-05-21;GE;Georgia;1064;29;335769;4569
2021-05-22;GE;Georgia;1071;33;336840;4602
2021-05-23;GE;Georgia;733;20;337573;4622
2021-05-24;GE;Georgia;388;17;337961;4639
2021-05-25;GE;Georgia;1354;15;339315;4654
2021-05-26;GE;Georgia;1015;28;340330;4682
2021-05-27;GE;Georgia;508;17;340838;4699
2021-05-28;GE;Georgia;1056;28;341894;4727
2021-05-29;GE;Georgia;986;12;342880;4739
2021-05-30;GE;Georgia;723;18;343603;4757
2021-05-31;GE;Georgia;360;16;343963;4773
2021-06-01;GE;Georgia;1233;31;345196;4804
2021-06-02;GE;Georgia;954;30;346150;4834
2021-06-03;GE;Georgia;833;19;346983;4853
2021-06-04;GE;Georgia;779;23;347762;4876
2021-06-05;GE;Georgia;832;17;348594;4893
2021-06-06;GE;Georgia;504;17;349098;4910
2021-06-07;GE;Georgia;307;24;349405;4934
2021-06-08;GE;Georgia;1023;17;350428;4951
2021-06-09;GE;Georgia;821;31;351249;4982
2021-06-10;GE;Georgia;705;14;351954;4996
2021-06-11;GE;Georgia;695;16;352649;5012
2021-06-12;GE;Georgia;794;22;353443;5034
2021-06-13;GE;Georgia;522;14;353965;5048
2021-06-14;GE;Georgia;311;12;354276;5060
2021-06-15;GE;Georgia;1092;23;355368;5083
2021-06-16;GE;Georgia;811;13;356179;5096
2021-06-17;GE;Georgia;741;18;356920;5114
2021-06-18;GE;Georgia;671;17;357591;5131
2021-06-19;GE;Georgia;769;17;358360;5148
2021-06-20;GE;Georgia;521;12;358881;5160
2021-06-21;GE;Georgia;260;15;359141;5175
2021-06-22;GE;Georgia;914;24;360055;5199
2021-06-23;GE;Georgia;773;12;360828;5211
2021-06-24;GE;Georgia;656;17;361484;5228
2021-06-25;GE;Georgia;699;9;362183;5237
2021-06-26;GE;Georgia;754;18;362937;5255
2021-06-27;GE;Georgia;585;11;363522;5266
2021-06-28;GE;Georgia;352;9;363874;5275
2021-06-29;GE;Georgia;1194;22;365068;5297
2021-06-30;GE;Georgia;1010;19;366078;5316
2021-07-01;GE;Georgia;980;11;367058;5327
2020-01-06;DE;Germany;0;0;0;0
2020-01-18;DE;Germany;0;0;0;0
2020-01-24;DE;Germany;0;0;0;0
2020-01-27;DE;Germany;1;0;1;0
2020-01-28;DE;Germany;3;0;4;0
2020-01-29;DE;Germany;0;0;4;0
2020-01-30;DE;Germany;0;0;4;0
2020-01-31;DE;Germany;1;0;5;0
2020-02-01;DE;Germany;3;0;8;0
2020-02-02;DE;Germany;2;0;10;0
2020-02-03;DE;Germany;2;0;12;0
2020-02-04;DE;Germany;0;0;12;0
2020-02-05;DE;Germany;0;0;12;0
2020-02-06;DE;Germany;0;0;12;0
2020-02-07;DE;Germany;1;0;13;0
2020-02-08;DE;Germany;0;0;13;0
2020-02-09;DE;Germany;1;0;14;0
2020-02-10;DE;Germany;0;0;14;0
2020-02-11;DE;Germany;2;0;16;0
2020-02-12;DE;Germany;0;0;16;0
2020-02-13;DE;Germany;0;0;16;0
2020-02-14;DE;Germany;0;0;16;0
2020-02-15;DE;Germany;0;0;16;0
2020-02-16;DE;Germany;0;0;16;0
2020-02-17;DE;Germany;0;0;16;0
2020-02-18;DE;Germany;0;0;16;0
2020-02-19;DE;Germany;0;0;16;0
2020-02-20;DE;Germany;0;0;16;0
2020-02-21;DE;Germany;0;0;16;0
2020-02-22;DE;Germany;0;0;16;0
2020-02-23;DE;Germany;0;0;16;0
2020-02-24;DE;Germany;0;0;16;0
2020-02-25;DE;Germany;1;0;17;0
2020-02-26;DE;Germany;10;0;27;0
2020-02-27;DE;Germany;19;0;46;0
2020-02-28;DE;Germany;2;0;48;0
2020-02-29;DE;Germany;31;0;79;0
2020-03-01;DE;Germany;51;0;130;0
2020-03-02;DE;Germany;29;0;159;0
2020-03-03;DE;Germany;37;0;196;0
2020-03-04;DE;Germany;66;0;262;0
2020-03-05;DE;Germany;220;0;482;0
2020-03-06;DE;Germany;188;0;670;0
2020-03-07;DE;Germany;129;0;799;0
2020-03-08;DE;Germany;241;0;1040;0
2020-03-09;DE;Germany;136;2;1176;2
2020-03-10;DE;Germany;281;0;1457;2
2020-03-11;DE;Germany;451;1;1908;3
2020-03-12;DE;Germany;170;0;2078;3
2020-03-13;DE;Germany;1597;4;3675;7
2020-03-14;DE;Germany;910;2;4585;9
2020-03-15;DE;Germany;1210;2;5795;11
2020-03-16;DE;Germany;1477;6;7272;17
2020-03-17;DE;Germany;1985;7;9257;24
2020-03-18;DE;Germany;3070;4;12327;28
2020-03-19;DE;Germany;2993;16;15320;44
2020-03-20;DE;Germany;4528;23;19848;67
2020-03-21;DE;Germany;2365;17;22213;84
2020-03-22;DE;Germany;2660;10;24873;94
2020-03-23;DE;Germany;4183;29;29056;123
2020-03-24;DE;Germany;3930;34;32986;157
2020-03-25;DE;Germany;4337;49;37323;206
2020-03-26;DE;Germany;6615;61;43938;267
2020-03-27;DE;Germany;6933;75;50871;342
2020-03-28;DE;Germany;6824;91;57695;433
2020-03-29;DE;Germany;4400;100;62095;533
2020-03-30;DE;Germany;4790;112;66885;645
2020-03-31;DE;Germany;4923;130;71808;775
2020-04-01;DE;Germany;6064;145;77872;920
2020-04-02;DE;Germany;6922;187;84794;1107
2020-04-03;DE;Germany;6365;168;91159;1275
2020-04-04;DE;Germany;4933;169;96092;1444
2020-04-05;DE;Germany;4031;140;100123;1584
2020-04-06;DE;Germany;3251;226;103374;1810
2020-04-07;DE;Germany;4289;206;107663;2016
2020-04-08;DE;Germany;5633;333;113296;2349
2020-04-09;DE;Germany;4885;258;118181;2607
2020-04-10;DE;Germany;3990;160;122171;2767
2020-04-11;DE;Germany;2737;-31;124908;2736
2020-04-12;DE;Germany;2946;286;127854;3022
2020-04-13;DE;Germany;2218;172;130072;3194
2020-04-14;DE;Germany;1287;100;131359;3294
2020-04-15;DE;Germany;3394;510;134753;3804
2020-04-16;DE;Germany;2945;248;137698;4052
2020-04-17;DE;Germany;3699;300;141397;4352
2020-04-18;DE;Germany;1945;107;143342;4459
2020-04-19;DE;Germany;1842;127;145184;4586
2020-04-20;DE;Germany;1881;276;147065;4862
2020-04-21;DE;Germany;1226;171;148291;5033
2020-04-22;DE;Germany;2357;246;150648;5279
2020-04-23;DE;Germany;2481;296;153129;5575
2020-04-24;DE;Germany;1870;185;154999;5760
2020-04-25;DE;Germany;1514;117;156513;5877
2020-04-26;DE;Germany;1257;99;157770;5976
2020-04-27;DE;Germany;988;150;158758;6126
2020-04-28;DE;Germany;1154;188;159912;6314
2020-04-29;DE;Germany;1627;153;161539;6467
2020-04-30;DE;Germany;1470;156;163009;6623
2020-05-01;DE;Germany;1068;113;164077;6736
2020-05-02;DE;Germany;890;76;164967;6812
2020-05-03;DE;Germany;697;54;165664;6866
2020-05-04;DE;Germany;488;127;166152;6993
2020-05-05;DE;Germany;855;0;167007;6993
2020-05-06;DE;Germany;1155;282;168162;7275
2020-05-07;DE;Germany;1268;117;169430;7392
2020-05-08;DE;Germany;1158;118;170588;7510
2020-05-09;DE;Germany;736;39;171324;7549
2020-05-10;DE;Germany;555;20;171879;7569
2020-05-11;DE;Germany;697;92;172576;7661
2020-05-12;DE;Germany;595;77;173171;7738
2020-05-13;DE;Germany;927;123;174098;7861
2020-05-14;DE;Germany;380;23;174478;7884
2020-05-15;DE;Germany;755;13;175233;7897
2020-05-16;DE;Germany;519;41;175752;7938
2020-05-17;DE;Germany;617;24;176369;7962
2020-05-18;DE;Germany;182;41;176551;8003
2020-05-19;DE;Germany;1227;78;177778;8081
2020-05-20;DE;Germany;695;63;178473;8144
2020-05-21;DE;Germany;548;59;179021;8203
2020-05-22;DE;Germany;689;25;179710;8228
2020-05-23;DE;Germany;276;33;179986;8261
2020-05-24;DE;Germany;342;22;180328;8283
2020-05-25;DE;Germany;272;26;180600;8309
2020-05-26;DE;Germany;600;63;181200;8372
2020-05-27;DE;Germany;324;56;181524;8428
2020-05-28;DE;Germany;672;42;182196;8470
2020-05-29;DE;Germany;726;34;182922;8504
2020-05-30;DE;Germany;267;26;183189;8530
2020-05-31;DE;Germany;221;10;183410;8540
2020-06-01;DE;Germany;184;15;183594;8555
2020-06-02;DE;Germany;285;8;183879;8563
2020-06-03;DE;Germany;242;39;184121;8602
2020-06-04;DE;Germany;351;33;184472;8635
2020-06-05;DE;Germany;452;23;184924;8658
2020-06-06;DE;Germany;526;15;185450;8673
2020-06-07;DE;Germany;300;12;185750;8685
2020-06-08;DE;Germany;359;10;186109;8695
2020-06-09;DE;Germany;397;41;186506;8736
2020-06-10;DE;Germany;16;16;186522;8752
2020-06-11;DE;Germany;169;20;186691;8772
2020-06-12;DE;Germany;535;11;187226;8783
2020-06-13;DE;Germany;41;10;187267;8793
2020-06-14;DE;Germany;251;8;187518;8801
2020-06-15;DE;Germany;164;6;187682;8807
2020-06-16;DE;Germany;570;13;188252;8820
2020-06-17;DE;Germany;352;31;188604;8851
2020-06-18;DE;Germany;1213;24;189817;8875
2020-06-19;DE;Germany;482;12;190299;8887
2020-06-20;DE;Germany;371;8;190670;8895
2020-06-21;DE;Germany;602;0;191272;8895
2020-06-22;DE;Germany;496;4;191768;8899
2020-06-23;DE;Germany;712;15;192480;8914
2020-06-24;DE;Germany;391;14;192871;8928
2020-06-25;DE;Germany;500;12;193371;8940
2020-06-26;DE;Germany;665;25;194036;8965
2020-06-27;DE;Germany;422;3;194458;8968
2020-06-28;DE;Germany;235;0;194693;8968
2020-06-29;DE;Germany;349;8;195042;8976
2020-06-30;DE;Germany;376;14;195418;8990
2020-07-01;DE;Germany;475;5;195893;8995
2020-07-02;DE;Germany;477;11;196370;9006
2020-07-03;DE;Germany;410;4;196780;9010
2020-07-04;DE;Germany;418;10;197198;9020
2020-07-05;DE;Germany;325;3;197523;9023
2020-07-06;DE;Germany;541;-1;198064;9022
2020-07-07;DE;Germany;279;10;198343;9032
2020-07-08;DE;Germany;356;14;198699;9046
2020-07-09;DE;Germany;302;11;199001;9057
2020-07-10;DE;Germany;331;6;199332;9063
2020-07-11;DE;Germany;377;7;199709;9070
2020-07-12;DE;Germany;210;1;199919;9071
2020-07-13;DE;Germany;261;3;200180;9074
2020-07-14;DE;Germany;276;4;200456;9078
2020-07-15;DE;Germany;434;2;200890;9080
2020-07-16;DE;Germany;560;7;201450;9087
2020-07-17;DE;Germany;595;1;202045;9088
2020-07-18;DE;Germany;381;3;202426;9091
2020-07-19;DE;Germany;309;1;202735;9092
2020-07-20;DE;Germany;590;2;203325;9094
2020-07-21;DE;Germany;392;5;203717;9099
2020-07-22;DE;Germany;559;3;204276;9102
2020-07-23;DE;Germany;605;8;204881;9110
2020-07-24;DE;Germany;742;10;205623;9120
2020-07-25;DE;Germany;655;4;206278;9124
2020-07-26;DE;Germany;389;0;206667;9124
2020-07-27;DE;Germany;445;1;207112;9125
2020-07-28;DE;Germany;595;6;207707;9131
2020-07-29;DE;Germany;839;4;208546;9135
2020-07-30;DE;Germany;989;9;209535;9144
2020-07-31;DE;Germany;864;3;210399;9147
2020-08-01;DE;Germany;606;7;211005;9154
2020-08-02;DE;Germany;215;0;211220;9154
2020-08-03;DE;Germany;891;0;212111;9154
2020-08-04;DE;Germany;717;9;212828;9163
2020-08-05;DE;Germany;1285;16;214113;9179
2020-08-06;DE;Germany;926;2;215039;9181
2020-08-07;DE;Germany;1157;14;216196;9195
2020-08-08;DE;Germany;707;6;216903;9201
2020-08-09;DE;Germany;385;1;217288;9202
2020-08-10;DE;Germany;1220;1;218508;9203
2020-08-11;DE;Germany;1032;5;219540;9208
2020-08-12;DE;Germany;1319;5;220859;9213
2020-08-13;DE;Germany;1422;4;222281;9217
2020-08-14;DE;Germany;1510;13;223791;9230
2020-08-15;DE;Germany;697;5;224488;9235
2020-08-16;DE;Germany;519;0;225007;9235
2020-08-17;DE;Germany;1693;1;226700;9236
2020-08-18;DE;Germany;1420;5;228120;9241
2020-08-19;DE;Germany;1586;8;229706;9249
2020-08-20;DE;Germany;1586;14;231292;9263
2020-08-21;DE;Germany;1737;3;233029;9266
2020-08-22;DE;Germany;832;6;233861;9272
2020-08-23;DE;Germany;633;3;234494;9275
2020-08-24;DE;Germany;1628;1;236122;9276
2020-08-25;DE;Germany;1461;5;237583;9281
2020-08-26;DE;Germany;1427;4;239010;9285
2020-08-27;DE;Germany;1561;5;240571;9290
2020-08-28;DE;Germany;1555;0;242126;9290
2020-08-29;DE;Germany;709;9;242835;9299
2020-08-30;DE;Germany;470;1;243305;9300
2020-08-31;DE;Germany;1497;3;244802;9303
2020-09-01;DE;Germany;1213;4;246015;9307
2020-09-02;DE;Germany;1396;15;247411;9322
2020-09-03;DE;Germany;1429;0;248840;9322
2020-09-04;DE;Germany;1443;5;250283;9327
2020-09-05;DE;Germany;775;2;251058;9329
2020-09-06;DE;Germany;670;1;251728;9330
2020-09-07;DE;Germany;1898;1;253626;9331
2020-09-08;DE;Germany;1331;5;254957;9336
2020-09-09;DE;Germany;1476;6;256433;9342
2020-09-10;DE;Germany;1716;3;258149;9345
2020-09-11;DE;Germany;1586;3;259735;9348
2020-09-12;DE;Germany;1082;4;260817;9352
2020-09-13;DE;Germany;920;2;261737;9354
2020-09-14;DE;Germany;1485;2;263222;9356
2020-09-15;DE;Germany;1792;11;265014;9367
2020-09-16;DE;Germany;1855;6;266869;9373
2020-09-17;DE;Germany;2179;3;269048;9376
2020-09-18;DE;Germany;2199;10;271247;9386
2020-09-19;DE;Germany;1685;2;272932;9388
2020-09-20;DE;Germany;1033;2;273965;9390
2020-09-21;DE;Germany;1595;0;275560;9390
2020-09-22;DE;Germany;1852;15;277412;9405
2020-09-23;DE;Germany;1613;18;279025;9423
2020-09-24;DE;Germany;2321;13;281346;9436
2020-09-25;DE;Germany;2366;15;283712;9451
2020-09-26;DE;Germany;1314;8;285026;9459
2020-09-27;DE;Germany;1313;5;286339;9464
2020-09-28;DE;Germany;2292;4;288631;9468
2020-09-29;DE;Germany;1840;15;290471;9483
2020-09-30;DE;Germany;2442;12;292913;9495
2020-10-01;DE;Germany;2626;14;295539;9509
2020-10-02;DE;Germany;2835;9;298374;9518
2020-10-03;DE;Germany;1653;13;300027;9531
2020-10-04;DE;Germany;1546;2;301573;9533
2020-10-05;DE;Germany;3100;21;304673;9554
2020-10-06;DE;Germany;2454;12;307127;9566
2020-10-07;DE;Germany;4010;16;311137;9582
2020-10-08;DE;Germany;4804;12;315941;9594
2020-10-09;DE;Germany;4554;5;320495;9599
2020-10-10;DE;Germany;2968;21;323463;9620
2020-10-11;DE;Germany;2846;6;326309;9626
2020-10-12;DE;Germany;6541;14;332850;9640
2020-10-13;DE;Germany;4464;42;337314;9682
2020-10-14;DE;Germany;7173;34;344487;9716
2020-10-15;DE;Germany;7620;23;352107;9739
2020-10-16;DE;Germany;7695;34;359802;9773
2020-10-17;DE;Germany;4862;12;364664;9785
2020-10-18;DE;Germany;4007;13;368671;9798
2020-10-19;DE;Germany;8397;44;377068;9842
2020-10-20;DE;Germany;8523;40;385591;9882
2020-10-21;DE;Germany;12331;29;397922;9911
2020-10-22;DE;Germany;5952;49;403874;9960
2020-10-23;DE;Germany;13476;18;417350;9978
2020-10-24;DE;Germany;10458;57;427808;10035
2020-10-25;DE;Germany;9890;27;437698;10062
2020-10-26;DE;Germany;12560;29;450258;10091
2020-10-27;DE;Germany;13161;30;463419;10121
2020-10-28;DE;Germany;16202;97;479621;10218
2020-10-29;DE;Germany;18733;87;498354;10305
2020-10-30;DE;Germany;19382;86;517736;10391
2020-10-31;DE;Germany;14054;92;531790;10483
2020-11-01;DE;Germany;12556;30;544346;10513
2020-11-02;DE;Germany;25252;156;569598;10669
2020-11-03;DE;Germany;7533;48;577131;10717
2020-11-04;DE;Germany;31480;232;608611;10949
2020-11-05;DE;Germany;22561;161;631172;11110
2020-11-06;DE;Germany;22820;130;653992;11240
2020-11-07;DE;Germany;14122;66;668114;11306
2020-11-08;DE;Germany;14510;66;682624;11372
2020-11-09;DE;Germany;6522;36;689146;11408
2020-11-10;DE;Germany;26547;373;715693;11781
2020-11-11;DE;Germany;22401;213;738094;11994
2020-11-12;DE;Germany;24738;222;762832;12216
2020-11-13;DE;Germany;22261;188;785093;12404
2020-11-14;DE;Germany;14640;107;799733;12511
2020-11-15;DE;Germany;3213;62;802946;12573
2020-11-16;DE;Germany;14580;260;817526;12833
2020-11-17;DE;Germany;26231;305;843757;13138
2020-11-18;DE;Germany;23727;252;867484;13390
2020-11-19;DE;Germany;24041;272;891525;13662
2020-11-20;DE;Germany;22593;256;914118;13918
2020-11-21;DE;Germany;13872;143;927990;14061
2020-11-22;DE;Germany;4377;98;932367;14159
2020-11-23;DE;Germany;14455;301;946822;14460
2020-11-24;DE;Germany;16370;372;963192;14832
2020-11-25;DE;Germany;32687;378;995879;15210
2020-11-26;DE;Germany;21951;430;1017830;15640
2020-11-27;DE;Germany;20819;371;1038649;16011
2020-11-28;DE;Germany;13845;170;1052494;16181
2020-11-29;DE;Germany;3197;125;1055691;16306
2020-11-30;DE;Germany;14221;388;1069912;16694
2020-12-01;DE;Germany;24766;483;1094678;17177
2020-12-02;DE;Germany;23275;482;1117953;17659
2020-12-03;DE;Germany;23591;438;1141544;18097
2020-12-04;DE;Germany;15970;480;1157514;18577
2020-12-05;DE;Germany;26126;262;1183640;18839
2020-12-06;DE;Germany;10910;150;1194550;18989
2020-12-07;DE;Germany;5456;445;1200006;19434
2020-12-08;DE;Germany;29263;568;1229269;20002
2020-12-09;DE;Germany;25089;458;1254358;20460
2020-12-10;DE;Germany;32734;604;1287092;21064
2020-12-11;DE;Germany;27217;503;1314309;21567
2020-12-12;DE;Germany;21792;333;1336101;21900
2020-12-13;DE;Germany;14709;206;1350810;22106
2020-12-14;DE;Germany;6451;528;1357261;22634
2020-12-15;DE;Germany;33825;910;1391086;23544
2020-12-16;DE;Germany;32744;729;1423830;24273
2020-12-17;DE;Germany;30179;754;1454009;25027
2020-12-18;DE;Germany;32830;727;1486839;25754
2020-12-19;DE;Germany;21679;417;1508518;26171
2020-12-20;DE;Germany;6444;229;1514962;26400
2020-12-21;DE;Germany;19256;710;1534218;27110
2020-12-22;DE;Germany;36153;986;1570371;28096
2020-12-23;DE;Germany;33758;813;1604129;28909
2020-12-24;DE;Germany;26467;421;1630596;29330
2020-12-25;DE;Germany;2140;250;1632736;29580
2020-12-26;DE;Germany;13504;366;1646240;29946
2020-12-27;DE;Germany;12399;351;1658639;30297
2020-12-28;DE;Germany;14004;848;1672643;31145
2020-12-29;DE;Germany;19466;1122;1692109;32267
2020-12-30;DE;Germany;49044;963;1741153;33230
2020-12-31;DE;Germany;19367;561;1760520;33791
2021-01-01;DE;Germany;2117;354;1762637;34145
2021-01-02;DE;Germany;10903;335;1773540;34480
2021-01-03;DE;Germany;10356;311;1783896;34791
2021-01-04;DE;Germany;12320;957;1796216;35748
2021-01-05;DE;Germany;18349;1009;1814565;36757
2021-01-06;DE;Germany;26663;1078;1841228;37835
2021-01-07;DE;Germany;45333;1152;1886561;38987
2021-01-08;DE;Germany;19077;1035;1905638;40022
2021-01-09;DE;Germany;22824;575;1928462;40597
2021-01-10;DE;Germany;948;339;1929410;40936
2021-01-11;DE;Germany;11706;863;1941116;41799
2021-01-12;DE;Germany;27210;1090;1968326;42889
2021-01-13;DE;Germany;25566;1207;1993892;44096
2021-01-14;DE;Germany;21343;1111;2015235;45207
2021-01-15;DE;Germany;8593;498;2023828;45705
2021-01-16;DE;Germany;14817;759;2038645;46464
2021-01-17;DE;Germany;11484;437;2050129;46901
2021-01-18;DE;Germany;9253;362;2059382;47263
2021-01-19;DE;Germany;12233;1734;2071615;48997
2021-01-20;DE;Germany;29003;1013;2100618;50010
2021-01-21;DE;Germany;8277;866;2108895;50876
2021-01-22;DE;Germany;16366;837;2125261;51713
2021-01-23;DE;Germany;12430;160;2137691;51873
2021-01-24;DE;Germany;10078;423;2147769;52296
2021-01-25;DE;Germany;6887;831;2154656;53127
2021-01-26;DE;Germany;9387;492;2164043;53619
2021-01-27;DE;Germany;15636;879;2179679;54498
2021-01-28;DE;Germany;14883;1385;2194562;55883
2021-01-29;DE;Germany;12831;403;2207393;56286
2021-01-30;DE;Germany;17518;819;2224911;57105
2021-01-31;DE;Germany;748;58;2225659;57163
2021-02-01;DE;Germany;6668;896;2232327;58059
2021-02-02;DE;Germany;7690;933;2240017;58992
2021-02-03;DE;Germany;12487;784;2252504;59776
2021-02-04;DE;Germany;13032;858;2265536;60634
2021-02-05;DE;Germany;10835;690;2276371;61324
2021-02-06;DE;Germany;8632;227;2285003;61551
2021-02-07;DE;Germany;6670;157;2291673;61708
2021-02-08;DE;Germany;4650;483;2296323;62191
2021-02-09;DE;Germany;5728;815;2302051;63006
2021-02-10;DE;Germany;9246;666;2311297;63672
2021-02-11;DE;Germany;9928;552;2321225;64224
2021-02-12;DE;Germany;9197;547;2330422;64771
2021-02-13;DE;Germany;6484;219;2336906;64990
2021-02-14;DE;Germany;4838;117;2341744;65107
2021-02-15;DE;Germany;5132;181;2346876;65288
2021-02-16;DE;Germany;5890;541;2352766;65829
2021-02-17;DE;Germany;9598;903;2362364;66732
2021-02-18;DE;Germany;9845;513;2372209;67245
2021-02-19;DE;Germany;9050;496;2381259;67741
2021-02-20;DE;Germany;7162;142;2388421;67883
2021-02-21;DE;Germany;6094;63;2394515;67946
2021-02-22;DE;Germany;4984;417;2399499;68363
2021-02-23;DE;Germany;5764;422;2405263;68785
2021-02-24;DE;Germany;10774;385;2416037;69170
2021-02-25;DE;Germany;11032;173;2427069;69343
2021-02-26;DE;Germany;9437;596;2436506;69939
2021-02-27;DE;Germany;7671;153;2444177;70092
2021-02-28;DE;Germany;6118;60;2450295;70152
2021-03-01;DE;Germany;5274;362;2455569;70514
2021-03-02;DE;Germany;6492;412;2462061;70926
2021-03-03;DE;Germany;10852;359;2472913;71285
2021-03-04;DE;Germany;11393;269;2484306;71554
2021-03-05;DE;Germany;9581;298;2493887;71852
2021-03-06;DE;Germany;8264;99;2502151;71951
2021-03-07;DE;Germany;6504;33;2508655;71984
2021-03-08;DE;Germany;5129;252;2513784;72236
2021-03-09;DE;Germany;6834;298;2520618;72534
2021-03-10;DE;Germany;21163;324;2541781;72858
2021-03-11;DE;Germany;4745;262;2546526;73120
2021-03-12;DE;Germany;12770;228;2559296;73348
2021-03-13;DE;Germany;10568;21;2569864;73369
2021-03-14;DE;Germany;8978;94;2578842;73463
2021-03-15;DE;Germany;6543;238;2585385;73701
2021-03-16;DE;Germany;17679;251;2603064;73952
2021-03-17;DE;Germany;7705;91;2610769;74043
2021-03-18;DE;Germany;28489;359;2639258;74402
2021-03-19;DE;Germany;15476;206;2654734;74608
2021-03-20;DE;Germany;14499;98;2669233;74706
2021-03-21;DE;Germany;768;50;2670001;74756
2021-03-22;DE;Germany;8261;253;2678262;75009
2021-03-23;DE;Germany;20969;246;2699231;75255
2021-03-24;DE;Germany;23757;229;2722988;75484
2021-03-25;DE;Germany;21620;185;2744608;75669
2021-03-26;DE;Germany;20689;159;2765297;75828
2021-03-27;DE;Germany;17628;87;2782925;75915
2021-03-28;DE;Germany;1727;44;2784652;75959
2021-03-29;DE;Germany;10297;180;2794949;76139
2021-03-30;DE;Germany;23681;250;2818630;76389
2021-03-31;DE;Germany;25014;200;2843644;76589
2021-04-01;DE;Germany;22679;234;2866323;76823
2021-04-02;DE;Germany;16033;117;2882356;76940
2021-04-03;DE;Germany;3673;70;2886029;77010
2021-04-04;DE;Germany;10300;50;2896329;77060
2021-04-05;DE;Germany;5980;76;2902309;77136
2021-04-06;DE;Germany;7593;109;2909902;77245
2021-04-07;DE;Germany;30377;510;2940279;77755
2021-04-08;DE;Germany;26510;294;2966789;78049
2021-04-09;DE;Germany;23935;246;2990724;78295
2021-04-10;DE;Germany;18728;107;3009452;78402
2021-04-11;DE;Germany;2706;98;3012158;78500
2021-04-12;DE;Germany;12446;296;3024604;78796
2021-04-13;DE;Germany;29421;341;3054025;79137
2021-04-14;DE;Germany;31117;290;3085142;79427
2021-04-15;DE;Germany;25110;245;3110252;79672
2021-04-16;DE;Germany;23856;222;3134108;79894
2021-04-17;DE;Germany;20197;77;3154305;79971
2021-04-18;DE;Germany;1217;81;3155522;80052
2021-04-19;DE;Germany;11615;301;3167137;80353
2021-04-20;DE;Germany;31397;327;3198534;80680
2021-04-21;DE;Germany;24354;258;3222888;80938
2021-04-22;DE;Germany;31721;265;3254609;81203
2021-04-23;DE;Germany;22262;289;3276871;81492
2021-04-24;DE;Germany;14422;118;3291293;81610
2021-04-25;DE;Germany;15399;61;3306692;81671
2021-04-26;DE;Germany;5961;338;3312653;82009
2021-04-27;DE;Germany;25911;316;3338564;82325
2021-04-28;DE;Germany;28263;263;3366827;82588
2021-04-29;DE;Germany;24212;277;3391039;82865
2021-04-30;DE;Germany;14326;232;3405365;83097
2021-05-01;DE;Germany;18535;110;3423900;83207
2021-05-02;DE;Germany;8776;85;3432676;83292
2021-05-03;DE;Germany;5510;313;3438186;83605
2021-05-04;DE;Germany;24111;285;3462297;83890
2021-05-05;DE;Germany;22458;251;3484755;84141
2021-05-06;DE;Germany;17917;284;3502672;84425
2021-05-07;DE;Germany;15090;234;3517762;84659
2021-05-08;DE;Germany;13125;130;3530887;84789
2021-05-09;DE;Germany;0;55;3530887;84844
2021-05-10;DE;Germany;7321;274;3538208;85118
2021-05-11;DE;Germany;19696;267;3557904;85385
2021-05-12;DE;Germany;6590;66;3564494;85451
2021-05-13;DE;Germany;13631;402;3578125;85853
2021-05-14;DE;Germany;10377;177;3588502;86030
2021-05-15;DE;Germany;7370;70;3595872;86100
2021-05-16;DE;Germany;7067;66;3602939;86166
2021-05-17;DE;Germany;5381;220;3608320;86386
2021-05-18;DE;Germany;7576;285;3615896;86671
2021-05-19;DE;Germany;11881;237;3627777;86908
2021-05-20;DE;Germany;10727;227;3638504;87135
2021-05-21;DE;Germany;8096;168;3646600;87303
2021-05-22;DE;Germany;6419;82;3653019;87385
2021-05-23;DE;Germany;4643;44;3657662;87429
2021-05-24;DE;Germany;2328;32;3659990;87461
2021-05-25;DE;Germany;2578;272;3662568;87733
2021-05-26;DE;Germany;4473;267;3667041;88000
2021-05-27;DE;Germany;6949;192;3673990;88192
2021-05-28;DE;Germany;6169;168;3680159;88360
2021-05-29;DE;Germany;4513;53;3684672;88413
2021-05-30;DE;Germany;3043;18;3687715;88431
2021-05-31;DE;Germany;2206;170;3689921;88601
2021-06-01;DE;Germany;2987;180;3692908;88781
2021-06-02;DE;Germany;5096;164;3698004;88945
2021-06-03;DE;Germany;3688;86;3701692;89031
2021-06-04;DE;Germany;2993;121;3704685;89152
2021-06-05;DE;Germany;2249;76;3706934;89228
2021-06-06;DE;Germany;1964;21;3708898;89249
2021-06-07;DE;Germany;1444;141;3710342;89390
2021-06-08;DE;Germany;2253;107;3712595;89497
2021-06-09;DE;Germany;3275;95;3715870;89592
2021-06-10;DE;Germany;2747;101;3718617;89693
2021-06-11;DE;Germany;2194;128;3720811;89821
2021-06-12;DE;Germany;1484;20;3722295;89841
2021-06-13;DE;Germany;1000;8;3723295;89849
2021-06-14;DE;Germany;873;95;3724168;89944
2021-06-15;DE;Germany;1160;135;3725328;90079
2021-06-16;DE;Germany;1439;106;3726767;90185
2021-06-17;DE;Germany;901;92;3727668;90277
2021-06-18;DE;Germany;933;97;3728601;90374
2021-06-19;DE;Germany;996;16;3729597;90390
2021-06-20;DE;Germany;529;10;3730126;90400
2021-06-21;DE;Germany;493;77;3730619;90477
2021-06-22;DE;Germany;685;76;3731304;90553
2021-06-23;DE;Germany;1135;67;3732439;90620
2021-06-24;DE;Germany;475;65;3732914;90685
2021-06-25;DE;Germany;751;67;3733665;90752
2021-06-26;DE;Germany;488;9;3734153;90761
2021-06-27;DE;Germany;336;7;3734489;90768
2021-06-28;DE;Germany;341;58;3734830;90826
2021-06-29;DE;Germany;569;57;3735399;90883
2021-06-30;DE;Germany;806;62;3736205;90945
2021-07-01;DE;Germany;754;69;3736959;91014
2020-03-14;GH;Ghana;3;0;3;0
2020-03-15;GH;Ghana;3;0;6;0
2020-03-16;GH;Ghana;0;0;6;0
2020-03-17;GH;Ghana;1;0;7;0
2020-03-18;GH;Ghana;0;0;7;0
2020-03-19;GH;Ghana;4;0;11;0
2020-03-20;GH;Ghana;5;0;16;0
2020-03-21;GH;Ghana;3;1;19;1
2020-03-22;GH;Ghana;4;0;23;1
2020-03-23;GH;Ghana;4;1;27;2
2020-03-24;GH;Ghana;26;0;53;2
2020-03-25;GH;Ghana;40;2;93;4
2020-03-26;GH;Ghana;39;0;132;4
2020-03-27;GH;Ghana;5;0;137;4
2020-03-28;GH;Ghana;4;1;141;5
2020-03-29;GH;Ghana;11;0;152;5
2020-03-30;GH;Ghana;0;0;152;5
2020-03-31;GH;Ghana;9;0;161;5
2020-04-01;GH;Ghana;34;0;195;5
2020-04-02;GH;Ghana;9;0;204;5
2020-04-03;GH;Ghana;1;0;205;5
2020-04-04;GH;Ghana;0;0;205;5
2020-04-05;GH;Ghana;9;0;214;5
2020-04-06;GH;Ghana;0;0;214;5
2020-04-07;GH;Ghana;73;0;287;5
2020-04-08;GH;Ghana;26;1;313;6
2020-04-09;GH;Ghana;65;0;378;6
2020-04-10;GH;Ghana;0;0;378;6
2020-04-11;GH;Ghana;30;2;408;8
2020-04-12;GH;Ghana;158;0;566;8
2020-04-13;GH;Ghana;0;0;566;8
2020-04-14;GH;Ghana;70;0;636;8
2020-04-15;GH;Ghana;0;0;636;8
2020-04-16;GH;Ghana;5;0;641;8
2020-04-17;GH;Ghana;0;0;641;8
2020-04-18;GH;Ghana;193;1;834;9
2020-04-19;GH;Ghana;208;0;1042;9
2020-04-20;GH;Ghana;0;0;1042;9
2020-04-21;GH;Ghana;0;0;1042;9
2020-04-22;GH;Ghana;112;0;1154;9
2020-04-23;GH;Ghana;0;0;1154;9
2020-04-24;GH;Ghana;125;1;1279;10
2020-04-25;GH;Ghana;0;0;1279;10
2020-04-26;GH;Ghana;271;1;1550;11
2020-04-27;GH;Ghana;0;0;1550;11
2020-04-28;GH;Ghana;121;5;1671;16
2020-04-29;GH;Ghana;0;0;1671;16
2020-04-30;GH;Ghana;403;1;2074;17
2020-05-01;GH;Ghana;0;0;2074;17
2020-05-02;GH;Ghana;95;1;2169;18
2020-05-03;GH;Ghana;0;0;2169;18
2020-05-04;GH;Ghana;550;0;2719;18
2020-05-05;GH;Ghana;0;0;2719;18
2020-05-06;GH;Ghana;372;0;3091;18
2020-05-07;GH;Ghana;0;0;3091;18
2020-05-08;GH;Ghana;921;0;4012;18
2020-05-09;GH;Ghana;251;4;4263;22
2020-05-10;GH;Ghana;0;0;4263;22
2020-05-11;GH;Ghana;437;0;4700;22
2020-05-12;GH;Ghana;427;0;5127;22
2020-05-13;GH;Ghana;281;2;5408;24
2020-05-14;GH;Ghana;122;0;5530;24
2020-05-15;GH;Ghana;108;4;5638;28
2020-05-16;GH;Ghana;97;1;5735;29
2020-05-17;GH;Ghana;0;0;5735;29
2020-05-18;GH;Ghana;0;0;5735;29
2020-05-19;GH;Ghana;361;2;6096;31
2020-05-20;GH;Ghana;173;0;6269;31
2020-05-21;GH;Ghana;0;0;6269;31
2020-05-22;GH;Ghana;217;0;6486;31
2020-05-23;GH;Ghana;131;0;6617;31
2020-05-24;GH;Ghana;66;1;6683;32
2020-05-25;GH;Ghana;125;0;6808;32
2020-05-26;GH;Ghana;309;2;7117;34
2020-05-27;GH;Ghana;186;0;7303;34
2020-05-28;GH;Ghana;0;0;7303;34
2020-05-29;GH;Ghana;313;0;7616;34
2020-05-30;GH;Ghana;152;1;7768;35
2020-05-31;GH;Ghana;302;1;8070;36
2020-06-01;GH;Ghana;0;0;8070;36
2020-06-02;GH;Ghana;227;2;8297;38
2020-06-03;GH;Ghana;251;0;8548;38
2020-06-04;GH;Ghana;337;0;8885;38
2020-06-05;GH;Ghana;283;4;9168;42
2020-06-06;GH;Ghana;294;2;9462;44
2020-06-07;GH;Ghana;176;0;9638;44
2020-06-08;GH;Ghana;272;4;9910;48
2020-06-09;GH;Ghana;291;0;10201;48
2020-06-10;GH;Ghana;0;0;10201;48
2020-06-11;GH;Ghana;157;0;10358;48
2020-06-12;GH;Ghana;498;0;10856;48
2020-06-13;GH;Ghana;262;0;11118;48
2020-06-14;GH;Ghana;846;6;11964;54
2020-06-15;GH;Ghana;0;0;11964;54
2020-06-16;GH;Ghana;229;4;12193;58
2020-06-17;GH;Ghana;397;8;12590;66
2020-06-18;GH;Ghana;339;0;12929;66
2020-06-19;GH;Ghana;274;4;13203;70
2020-06-20;GH;Ghana;514;15;13717;85
2020-06-21;GH;Ghana;437;0;14154;85
2020-06-22;GH;Ghana;0;0;14154;85
2020-06-23;GH;Ghana;414;10;14568;95
2020-06-24;GH;Ghana;445;0;15013;95
2020-06-25;GH;Ghana;460;0;15473;95
2020-06-26;GH;Ghana;361;8;15834;103
2020-06-27;GH;Ghana;597;0;16431;103
2020-06-28;GH;Ghana;311;9;16742;112
2020-06-29;GH;Ghana;609;0;17351;112
2020-06-30;GH;Ghana;390;0;17741;112
2020-07-01;GH;Ghana;393;5;18134;117
2020-07-02;GH;Ghana;0;0;18134;117
2020-07-03;GH;Ghana;1254;0;19388;117
2020-07-04;GH;Ghana;0;0;19388;117
2020-07-05;GH;Ghana;697;5;20085;122
2020-07-06;GH;Ghana;992;7;21077;129
2020-07-07;GH;Ghana;891;0;21968;129
2020-07-08;GH;Ghana;854;0;22822;129
2020-07-09;GH;Ghana;641;0;23463;129
2020-07-10;GH;Ghana;371;6;23834;135
2020-07-11;GH;Ghana;414;0;24248;135
2020-07-12;GH;Ghana;270;4;24518;139
2020-07-13;GH;Ghana;470;0;24988;139
2020-07-14;GH;Ghana;0;0;24988;139
2020-07-15;GH;Ghana;442;0;25430;139
2020-07-16;GH;Ghana;695;0;26125;139
2020-07-17;GH;Ghana;447;5;26572;144
2020-07-18;GH;Ghana;488;1;27060;145
2020-07-19;GH;Ghana;607;3;27667;148
2020-07-20;GH;Ghana;763;5;28430;153
2020-07-21;GH;Ghana;559;0;28989;153
2020-07-22;GH;Ghana;683;0;29672;153
2020-07-23;GH;Ghana;0;0;29672;153
2020-07-24;GH;Ghana;1385;8;31057;161
2020-07-25;GH;Ghana;794;0;31851;161
2020-07-26;GH;Ghana;1118;7;32969;168
2020-07-27;GH;Ghana;655;0;33624;168
2020-07-28;GH;Ghana;782;0;34406;168
2020-07-29;GH;Ghana;736;7;35142;175
2020-07-30;GH;Ghana;0;0;35142;175
2020-07-31;GH;Ghana;359;7;35501;182
2020-08-01;GH;Ghana;1513;0;37014;182
2020-08-02;GH;Ghana;0;0;37014;182
2020-08-03;GH;Ghana;798;9;37812;191
2020-08-04;GH;Ghana;0;0;37812;191
2020-08-05;GH;Ghana;1263;8;39075;199
2020-08-06;GH;Ghana;567;0;39642;199
2020-08-07;GH;Ghana;455;7;40097;206
2020-08-08;GH;Ghana;436;0;40533;206
2020-08-09;GH;Ghana;470;9;41003;215
2020-08-10;GH;Ghana;209;0;41212;215
2020-08-11;GH;Ghana;192;0;41404;215
2020-08-12;GH;Ghana;168;8;41572;223
2020-08-13;GH;Ghana;153;0;41725;223
2020-08-14;GH;Ghana;122;0;41847;223
2020-08-15;GH;Ghana;363;8;42210;231
2020-08-16;GH;Ghana;322;0;42532;231
2020-08-17;GH;Ghana;121;8;42653;239
2020-08-18;GH;Ghana;340;9;42993;248
2020-08-19;GH;Ghana;101;8;43094;256
2020-08-20;GH;Ghana;166;5;43260;261
2020-08-21;GH;Ghana;65;0;43325;261
2020-08-22;GH;Ghana;0;0;43325;261
2020-08-23;GH;Ghana;180;0;43505;261
2020-08-24;GH;Ghana;117;2;43622;263
2020-08-25;GH;Ghana;95;7;43717;270
2020-08-26;GH;Ghana;52;0;43769;270
2020-08-27;GH;Ghana;72;0;43841;270
2020-08-28;GH;Ghana;108;0;43949;270
2020-08-29;GH;Ghana;169;0;44118;270
2020-08-30;GH;Ghana;87;6;44205;276
2020-08-31;GH;Ghana;93;0;44298;276
2020-09-01;GH;Ghana;162;0;44460;276
2020-09-02;GH;Ghana;198;0;44658;276
2020-09-03;GH;Ghana;55;4;44713;280
2020-09-04;GH;Ghana;64;3;44777;283
2020-09-05;GH;Ghana;0;0;44777;283
2020-09-06;GH;Ghana;0;0;44777;283
2020-09-07;GH;Ghana;92;0;44869;283
2020-09-08;GH;Ghana;143;0;45012;283
2020-09-09;GH;Ghana;301;0;45313;283
2020-09-10;GH;Ghana;0;0;45313;283
2020-09-11;GH;Ghana;75;2;45388;285
2020-09-12;GH;Ghana;46;1;45434;286
2020-09-13;GH;Ghana;0;0;45434;286
2020-09-14;GH;Ghana;167;8;45601;294
2020-09-15;GH;Ghana;54;0;45655;294
2020-09-16;GH;Ghana;0;0;45655;294
2020-09-17;GH;Ghana;59;0;45714;294
2020-09-18;GH;Ghana;46;1;45760;295
2020-09-19;GH;Ghana;117;2;45877;297
2020-09-20;GH;Ghana;127;0;46004;297
2020-09-21;GH;Ghana;58;0;46062;297
2020-09-22;GH;Ghana;0;0;46062;297
2020-09-23;GH;Ghana;91;2;46153;299
2020-09-24;GH;Ghana;69;0;46222;299
2020-09-25;GH;Ghana;0;0;46222;299
2020-09-26;GH;Ghana;0;0;46222;299
2020-09-27;GH;Ghana;165;0;46387;299
2020-09-28;GH;Ghana;57;0;46444;299
2020-09-29;GH;Ghana;38;2;46482;301
2020-09-30;GH;Ghana;144;0;46626;301
2020-10-01;GH;Ghana;30;0;46656;301
2020-10-02;GH;Ghana;38;0;46694;301
2020-10-03;GH;Ghana;109;2;46803;303
2020-10-04;GH;Ghana;26;0;46829;303
2020-10-05;GH;Ghana;0;0;46829;303
2020-10-06;GH;Ghana;0;0;46829;303
2020-10-07;GH;Ghana;0;0;46829;303
2020-10-08;GH;Ghana;118;3;46947;306
2020-10-09;GH;Ghana;40;0;46987;306
2020-10-10;GH;Ghana;18;0;47005;306
2020-10-11;GH;Ghana;0;0;47005;306
2020-10-12;GH;Ghana;25;2;47030;308
2020-10-13;GH;Ghana;96;2;47126;310
2020-10-14;GH;Ghana;0;0;47126;310
2020-10-15;GH;Ghana;47;0;47173;310
2020-10-16;GH;Ghana;0;0;47173;310
2020-10-17;GH;Ghana;59;0;47232;310
2020-10-18;GH;Ghana;78;0;47310;310
2020-10-19;GH;Ghana;62;0;47372;310
2020-10-20;GH;Ghana;89;2;47461;312
2020-10-21;GH;Ghana;0;0;47461;312
2020-10-22;GH;Ghana;77;0;47538;312
2020-10-23;GH;Ghana;63;2;47601;314
2020-10-24;GH;Ghana;89;2;47690;316
2020-10-25;GH;Ghana;0;0;47690;316
2020-10-26;GH;Ghana;85;0;47775;316
2020-10-27;GH;Ghana;0;0;47775;316
2020-10-28;GH;Ghana;0;0;47775;316
2020-10-29;GH;Ghana;280;4;48055;320
2020-10-30;GH;Ghana;0;0;48055;320
2020-10-31;GH;Ghana;0;0;48055;320
2020-11-01;GH;Ghana;69;0;48124;320
2020-11-02;GH;Ghana;76;0;48200;320
2020-11-03;GH;Ghana;0;0;48200;320
2020-11-04;GH;Ghana;443;0;48643;320
2020-11-05;GH;Ghana;145;0;48788;320
2020-11-06;GH;Ghana;0;0;48788;320
2020-11-07;GH;Ghana;116;0;48904;320
2020-11-08;GH;Ghana;198;0;49102;320
2020-11-09;GH;Ghana;100;0;49202;320
2020-11-10;GH;Ghana;100;0;49302;320
2020-11-11;GH;Ghana;0;0;49302;320
2020-11-12;GH;Ghana;655;0;49957;320
2020-11-13;GH;Ghana;61;0;50018;320
2020-11-14;GH;Ghana;0;0;50018;320
2020-11-15;GH;Ghana;105;2;50123;322
2020-11-16;GH;Ghana;253;1;50376;323
2020-11-17;GH;Ghana;0;0;50376;323
2020-11-18;GH;Ghana;81;0;50457;323
2020-11-19;GH;Ghana;174;0;50631;323
2020-11-20;GH;Ghana;0;0;50631;323
2020-11-21;GH;Ghana;86;0;50717;323
2020-11-22;GH;Ghana;157;0;50874;323
2020-11-23;GH;Ghana;67;0;50941;323
2020-11-24;GH;Ghana;243;0;51184;323
2020-11-25;GH;Ghana;41;0;51225;323
2020-11-26;GH;Ghana;0;0;51225;323
2020-11-27;GH;Ghana;0;0;51225;323
2020-11-28;GH;Ghana;154;0;51379;323
2020-11-29;GH;Ghana;190;0;51569;323
2020-11-30;GH;Ghana;98;0;51667;323
2020-12-01;GH;Ghana;0;0;51667;323
2020-12-02;GH;Ghana;0;0;51667;323
2020-12-03;GH;Ghana;0;0;51667;323
2020-12-04;GH;Ghana;429;2;52096;325
2020-12-05;GH;Ghana;0;0;52096;325
2020-12-06;GH;Ghana;178;0;52274;325
2020-12-07;GH;Ghana;0;0;52274;325
2020-12-08;GH;Ghana;226;1;52500;326
2020-12-09;GH;Ghana;122;0;52622;326
2020-12-10;GH;Ghana;116;0;52738;326
2020-12-11;GH;Ghana;0;0;52738;326
2020-12-12;GH;Ghana;195;1;52933;327
2020-12-13;GH;Ghana;0;0;52933;327
2020-12-14;GH;Ghana;81;0;53014;327
2020-12-15;GH;Ghana;256;0;53270;327
2020-12-16;GH;Ghana;116;0;53386;327
2020-12-17;GH;Ghana;167;4;53553;331
2020-12-18;GH;Ghana;100;0;53653;331
2020-12-19;GH;Ghana;0;0;53653;331
2020-12-20;GH;Ghana;0;0;53653;331
2020-12-21;GH;Ghana;301;2;53954;333
2020-12-22;GH;Ghana;0;0;53954;333
2020-12-23;GH;Ghana;89;0;54043;333
2020-12-24;GH;Ghana;0;0;54043;333
2020-12-25;GH;Ghana;0;0;54043;333
2020-12-26;GH;Ghana;243;0;54286;333
2020-12-27;GH;Ghana;115;0;54401;333
2020-12-28;GH;Ghana;102;0;54503;333
2020-12-29;GH;Ghana;178;2;54681;335
2020-12-30;GH;Ghana;90;0;54771;335
2020-12-31;GH;Ghana;0;0;54771;335
2021-01-01;GH;Ghana;159;0;54930;335
2021-01-02;GH;Ghana;134;0;55064;335
2021-01-03;GH;Ghana;104;0;55168;335
2021-01-04;GH;Ghana;0;0;55168;335
2021-01-05;GH;Ghana;0;0;55168;335
2021-01-06;GH;Ghana;0;0;55168;335
2021-01-07;GH;Ghana;293;1;55461;336
2021-01-08;GH;Ghana;0;0;55461;336
2021-01-09;GH;Ghana;311;0;55772;336
2021-01-10;GH;Ghana;0;0;55772;336
2021-01-11;GH;Ghana;458;2;56230;338
2021-01-12;GH;Ghana;191;0;56421;338
2021-01-13;GH;Ghana;560;3;56981;341
2021-01-14;GH;Ghana;0;0;56981;341
2021-01-15;GH;Ghana;0;0;56981;341
2021-01-16;GH;Ghana;0;0;56981;341
2021-01-17;GH;Ghana;733;5;57714;346
2021-01-18;GH;Ghana;351;6;58065;352
2021-01-19;GH;Ghana;366;6;58431;358
2021-01-20;GH;Ghana;0;0;58431;358
2021-01-21;GH;Ghana;1049;3;59480;361
2021-01-22;GH;Ghana;0;0;59480;361
2021-01-23;GH;Ghana;635;0;60115;361
2021-01-24;GH;Ghana;679;6;60794;367
2021-01-25;GH;Ghana;1341;5;62135;372
2021-01-26;GH;Ghana;0;0;62135;372
2021-01-27;GH;Ghana;616;5;62751;377
2021-01-28;GH;Ghana;1132;13;63883;390
2021-01-29;GH;Ghana;0;0;63883;390
2021-01-30;GH;Ghana;1544;15;65427;405
2021-01-31;GH;Ghana;1583;11;67010;416
2021-02-01;GH;Ghana;0;0;67010;416
2021-02-02;GH;Ghana;772;8;67782;424
2021-02-03;GH;Ghana;777;9;68559;433
2021-02-04;GH;Ghana;696;7;69255;440
2021-02-05;GH;Ghana;791;9;70046;449
2021-02-06;GH;Ghana;0;0;70046;449
2021-02-07;GH;Ghana;722;8;70768;457
2021-02-08;GH;Ghana;1560;15;72328;472
2021-02-09;GH;Ghana;675;10;73003;482
2021-02-10;GH;Ghana;0;0;73003;482
2021-02-11;GH;Ghana;554;12;73557;494
2021-02-12;GH;Ghana;790;11;74347;505
2021-02-13;GH;Ghana;1489;28;75836;533
2021-02-14;GH;Ghana;0;0;75836;533
2021-02-15;GH;Ghana;656;9;76492;542
2021-02-16;GH;Ghana;554;13;77046;555
2021-02-17;GH;Ghana;1225;10;78271;565
2021-02-18;GH;Ghana;418;3;78689;568
2021-02-19;GH;Ghana;476;0;79165;568
2021-02-20;GH;Ghana;490;4;79655;572
2021-02-21;GH;Ghana;598;5;80253;577
2021-02-22;GH;Ghana;506;5;80759;582
2021-02-23;GH;Ghana;0;0;80759;582
2021-02-24;GH;Ghana;486;2;81245;584
2021-02-25;GH;Ghana;428;4;81673;588
2021-02-26;GH;Ghana;913;6;82586;594
2021-02-27;GH;Ghana;0;0;82586;594
2021-02-28;GH;Ghana;1437;13;84023;607
2021-03-01;GH;Ghana;0;0;84023;607
2021-03-02;GH;Ghana;0;0;84023;607
2021-03-03;GH;Ghana;326;4;84349;611
2021-03-04;GH;Ghana;890;18;85239;629
2021-03-05;GH;Ghana;0;0;85239;629
2021-03-06;GH;Ghana;853;11;86092;640
2021-03-07;GH;Ghana;373;7;86465;647
2021-03-08;GH;Ghana;0;0;86465;647
2021-03-09;GH;Ghana;272;9;86737;656
2021-03-10;GH;Ghana;0;0;86737;656
2021-03-11;GH;Ghana;0;0;86737;656
2021-03-12;GH;Ghana;0;0;86737;656
2021-03-13;GH;Ghana;743;23;87480;679
2021-03-14;GH;Ghana;282;6;87762;685
2021-03-15;GH;Ghana;223;6;87985;691
2021-03-16;GH;Ghana;243;7;88228;698
2021-03-17;GH;Ghana;193;7;88421;705
2021-03-18;GH;Ghana;0;0;88421;705
2021-03-19;GH;Ghana;587;8;89008;713
2021-03-20;GH;Ghana;268;3;89276;716
2021-03-21;GH;Ghana;406;9;89682;725
2021-03-22;GH;Ghana;0;0;89682;725
2021-03-23;GH;Ghana;211;9;89893;734
2021-03-24;GH;Ghana;0;0;89893;734
2021-03-25;GH;Ghana;106;3;89999;737
2021-03-26;GH;Ghana;288;3;90287;740
2021-03-27;GH;Ghana;0;0;90287;740
2021-03-28;GH;Ghana;0;0;90287;740
2021-03-29;GH;Ghana;0;0;90287;740
2021-03-30;GH;Ghana;0;0;90287;740
2021-03-31;GH;Ghana;296;3;90583;743
2021-04-01;GH;Ghana;0;0;90583;743
2021-04-02;GH;Ghana;91;1;90674;744
2021-04-03;GH;Ghana;0;0;90674;744
2021-04-04;GH;Ghana;108;4;90782;748
2021-04-05;GH;Ghana;118;4;90900;752
2021-04-06;GH;Ghana;46;0;90946;752
2021-04-07;GH;Ghana;63;0;91009;752
2021-04-08;GH;Ghana;100;0;91109;752
2021-04-09;GH;Ghana;0;0;91109;752
2021-04-10;GH;Ghana;151;2;91260;754
2021-04-11;GH;Ghana;0;0;91260;754
2021-04-12;GH;Ghana;0;0;91260;754
2021-04-13;GH;Ghana;150;7;91410;761
2021-04-14;GH;Ghana;67;2;91477;763
2021-04-15;GH;Ghana;68;3;91545;766
2021-04-16;GH;Ghana;0;0;91545;766
2021-04-17;GH;Ghana;118;5;91663;771
2021-04-18;GH;Ghana;46;0;91709;771
2021-04-19;GH;Ghana;0;0;91709;771
2021-04-20;GH;Ghana;0;0;91709;771
2021-04-21;GH;Ghana;74;1;91783;772
2021-04-22;GH;Ghana;145;5;91928;777
2021-04-23;GH;Ghana;0;0;91928;777
2021-04-24;GH;Ghana;0;0;91928;777
2021-04-25;GH;Ghana;238;0;92166;777
2021-04-26;GH;Ghana;87;0;92253;777
2021-04-27;GH;Ghana;211;2;92464;779
2021-04-28;GH;Ghana;49;0;92513;779
2021-04-29;GH;Ghana;49;0;92562;779
2021-04-30;GH;Ghana;0;0;92562;779
2021-05-01;GH;Ghana;39;0;92601;779
2021-05-02;GH;Ghana;0;0;92601;779
2021-05-03;GH;Ghana;82;0;92683;779
2021-05-04;GH;Ghana;57;1;92740;780
2021-05-05;GH;Ghana;88;3;92828;783
2021-05-06;GH;Ghana;0;0;92828;783
2021-05-07;GH;Ghana;28;0;92856;783
2021-05-08;GH;Ghana;0;0;92856;783
2021-05-09;GH;Ghana;95;0;92951;783
2021-05-10;GH;Ghana;60;0;93011;783
2021-05-11;GH;Ghana;0;0;93011;783
2021-05-12;GH;Ghana;114;0;93125;783
2021-05-13;GH;Ghana;34;0;93159;783
2021-05-14;GH;Ghana;84;0;93243;783
2021-05-15;GH;Ghana;0;0;93243;783
2021-05-16;GH;Ghana;0;0;93243;783
2021-05-17;GH;Ghana;90;0;93333;783
2021-05-18;GH;Ghana;57;0;93390;783
2021-05-19;GH;Ghana;66;0;93456;783
2021-05-20;GH;Ghana;0;0;93456;783
2021-05-21;GH;Ghana;65;0;93521;783
2021-05-22;GH;Ghana;62;0;93583;783
2021-05-23;GH;Ghana;37;0;93620;783
2021-05-24;GH;Ghana;24;0;93644;783
2021-05-25;GH;Ghana;67;0;93711;783
2021-05-26;GH;Ghana;0;0;93711;783
2021-05-27;GH;Ghana;12;0;93723;783
2021-05-28;GH;Ghana;52;1;93775;784
2021-05-29;GH;Ghana;0;0;93775;784
2021-05-30;GH;Ghana;123;1;93898;785
2021-05-31;GH;Ghana;0;0;93898;785
2021-06-01;GH;Ghana;113;0;94011;785
2021-06-02;GH;Ghana;0;0;94011;785
2021-06-03;GH;Ghana;0;0;94011;785
2021-06-04;GH;Ghana;177;1;94188;786
2021-06-05;GH;Ghana;0;0;94188;786
2021-06-06;GH;Ghana;40;1;94228;787
2021-06-07;GH;Ghana;0;0;94228;787
2021-06-08;GH;Ghana;0;0;94228;787
2021-06-09;GH;Ghana;141;2;94369;789
2021-06-10;GH;Ghana;0;0;94369;789
2021-06-11;GH;Ghana;75;0;94444;789
2021-06-12;GH;Ghana;49;0;94493;789
2021-06-13;GH;Ghana;0;0;94493;789
2021-06-14;GH;Ghana;0;0;94493;789
2021-06-15;GH;Ghana;206;1;94699;790
2021-06-16;GH;Ghana;125;0;94824;790
2021-06-17;GH;Ghana;0;0;94824;790
2021-06-18;GH;Ghana;89;3;94913;793
2021-06-19;GH;Ghana;0;0;94913;793
2021-06-20;GH;Ghana;0;0;94913;793
2021-06-21;GH;Ghana;146;1;95059;794
2021-06-22;GH;Ghana;177;0;95236;794
2021-06-23;GH;Ghana;0;0;95236;794
2021-06-24;GH;Ghana;23;0;95259;794
2021-06-25;GH;Ghana;0;0;95259;794
2021-06-26;GH;Ghana;0;0;95259;794
2021-06-27;GH;Ghana;110;1;95369;795
2021-06-28;GH;Ghana;107;0;95476;795
2021-06-29;GH;Ghana;166;0;95642;795
2021-06-30;GH;Ghana;272;1;95914;796
2021-07-01;GH;Ghana;0;0;95914;796
2021-01-10;GI;Gibraltar;0;0;0;0
2021-01-11;GI;Gibraltar;0;0;0;0
2021-01-12;GI;Gibraltar;0;0;0;0
2021-01-13;GI;Gibraltar;0;0;0;0
2021-01-14;GI;Gibraltar;0;0;0;0
2021-01-15;GI;Gibraltar;0;0;0;0
2021-01-16;GI;Gibraltar;0;0;0;0
2021-01-17;GI;Gibraltar;0;0;0;0
2021-01-18;GI;Gibraltar;0;0;0;0
2021-01-19;GI;Gibraltar;0;0;0;0
2021-01-20;GI;Gibraltar;0;0;0;0
2021-01-21;GI;Gibraltar;0;0;0;0
2021-01-22;GI;Gibraltar;0;0;0;0
2021-01-23;GI;Gibraltar;0;0;0;0
2021-01-24;GI;Gibraltar;0;0;0;0
2021-01-25;GI;Gibraltar;0;0;0;0
2021-01-26;GI;Gibraltar;0;0;0;0
2021-01-27;GI;Gibraltar;0;0;0;0
2021-01-28;GI;Gibraltar;0;0;0;0
2021-01-29;GI;Gibraltar;0;0;0;0
2021-01-30;GI;Gibraltar;0;0;0;0
2021-01-31;GI;Gibraltar;0;0;0;0
2021-02-01;GI;Gibraltar;0;0;0;0
2021-02-02;GI;Gibraltar;0;0;0;0
2021-02-03;GI;Gibraltar;0;0;0;0
2021-02-04;GI;Gibraltar;0;0;0;0
2021-02-05;GI;Gibraltar;0;0;0;0
2021-02-06;GI;Gibraltar;0;0;0;0
2021-02-07;GI;Gibraltar;0;0;0;0
2021-02-08;GI;Gibraltar;0;0;0;0
2021-02-09;GI;Gibraltar;0;0;0;0
2021-02-10;GI;Gibraltar;0;0;0;0
2021-02-11;GI;Gibraltar;0;0;0;0
2021-02-12;GI;Gibraltar;0;0;0;0
2021-02-13;GI;Gibraltar;0;0;0;0
2021-02-14;GI;Gibraltar;0;0;0;0
2021-02-15;GI;Gibraltar;0;0;0;0
2021-02-16;GI;Gibraltar;0;0;0;0
2021-02-17;GI;Gibraltar;0;0;0;0
2021-02-18;GI;Gibraltar;0;0;0;0
2021-02-19;GI;Gibraltar;0;0;0;0
2021-02-20;GI;Gibraltar;0;0;0;0
2021-02-21;GI;Gibraltar;0;0;0;0
2021-02-22;GI;Gibraltar;0;0;0;0
2021-02-23;GI;Gibraltar;0;0;0;0
2021-02-24;GI;Gibraltar;0;0;0;0
2021-02-25;GI;Gibraltar;0;0;0;0
2021-02-26;GI;Gibraltar;0;0;0;0
2021-02-27;GI;Gibraltar;0;0;0;0
2021-02-28;GI;Gibraltar;0;0;0;0
2021-03-01;GI;Gibraltar;0;0;0;0
2021-03-02;GI;Gibraltar;0;0;0;0
2021-03-03;GI;Gibraltar;0;0;0;0
2021-03-04;GI;Gibraltar;0;0;0;0
2021-03-05;GI;Gibraltar;0;0;0;0
2021-03-06;GI;Gibraltar;0;0;0;0
2021-03-07;GI;Gibraltar;0;0;0;0
2021-03-08;GI;Gibraltar;0;0;0;0
2021-03-09;GI;Gibraltar;0;0;0;0
2021-03-10;GI;Gibraltar;0;0;0;0
2021-03-11;GI;Gibraltar;0;0;0;0
2021-03-12;GI;Gibraltar;0;0;0;0
2021-03-13;GI;Gibraltar;0;0;0;0
2021-03-14;GI;Gibraltar;0;0;0;0
2021-03-15;GI;Gibraltar;0;0;0;0
2021-03-16;GI;Gibraltar;0;0;0;0
2021-03-17;GI;Gibraltar;0;0;0;0
2021-03-18;GI;Gibraltar;0;0;0;0
2021-03-19;GI;Gibraltar;0;0;0;0
2021-03-20;GI;Gibraltar;0;0;0;0
2021-03-21;GI;Gibraltar;0;0;0;0
2021-03-22;GI;Gibraltar;0;0;0;0
2021-03-23;GI;Gibraltar;0;0;0;0
2021-03-24;GI;Gibraltar;0;0;0;0
2021-03-25;GI;Gibraltar;0;0;0;0
2021-03-26;GI;Gibraltar;0;0;0;0
2021-03-27;GI;Gibraltar;0;0;0;0
2021-03-28;GI;Gibraltar;0;0;0;0
2021-03-29;GI;Gibraltar;0;0;0;0
2021-03-30;GI;Gibraltar;0;0;0;0
2021-03-31;GI;Gibraltar;0;0;0;0
2021-04-01;GI;Gibraltar;0;0;0;0
2021-04-02;GI;Gibraltar;0;0;0;0
2021-04-03;GI;Gibraltar;0;0;0;0
2021-04-04;GI;Gibraltar;0;0;0;0
2021-04-05;GI;Gibraltar;0;0;0;0
2021-04-06;GI;Gibraltar;0;0;0;0
2021-04-07;GI;Gibraltar;0;0;0;0
2021-04-08;GI;Gibraltar;0;0;0;0
2021-04-09;GI;Gibraltar;0;0;0;0
2021-04-10;GI;Gibraltar;0;0;0;0
2021-04-11;GI;Gibraltar;0;0;0;0
2021-04-12;GI;Gibraltar;0;0;0;0
2021-04-13;GI;Gibraltar;0;0;0;0
2021-04-14;GI;Gibraltar;0;0;0;0
2021-04-15;GI;Gibraltar;0;0;0;0
2021-04-16;GI;Gibraltar;0;0;0;0
2021-04-17;GI;Gibraltar;0;0;0;0
2021-04-18;GI;Gibraltar;0;0;0;0
2021-04-19;GI;Gibraltar;0;0;0;0
2021-04-20;GI;Gibraltar;0;0;0;0
2021-04-21;GI;Gibraltar;0;0;0;0
2021-04-22;GI;Gibraltar;0;0;0;0
2021-04-23;GI;Gibraltar;0;0;0;0
2021-04-24;GI;Gibraltar;0;0;0;0
2021-04-25;GI;Gibraltar;0;0;0;0
2021-04-26;GI;Gibraltar;0;0;0;0
2021-04-27;GI;Gibraltar;0;0;0;0
2021-04-28;GI;Gibraltar;0;0;0;0
2021-04-29;GI;Gibraltar;0;0;0;0
2021-04-30;GI;Gibraltar;0;0;0;0
2021-05-01;GI;Gibraltar;0;0;0;0
2021-05-02;GI;Gibraltar;0;0;0;0
2021-05-03;GI;Gibraltar;0;0;0;0
2021-05-04;GI;Gibraltar;0;0;0;0
2021-05-05;GI;Gibraltar;0;0;0;0
2021-05-06;GI;Gibraltar;0;0;0;0
2021-05-07;GI;Gibraltar;0;0;0;0
2021-05-08;GI;Gibraltar;0;0;0;0
2021-05-09;GI;Gibraltar;0;0;0;0
2021-05-10;GI;Gibraltar;0;0;0;0
2021-05-11;GI;Gibraltar;0;0;0;0
2021-05-12;GI;Gibraltar;0;0;0;0
2021-05-13;GI;Gibraltar;0;0;0;0
2021-05-14;GI;Gibraltar;0;0;0;0
2021-05-15;GI;Gibraltar;0;0;0;0
2021-05-16;GI;Gibraltar;0;0;0;0
2021-05-17;GI;Gibraltar;0;0;0;0
2021-05-18;GI;Gibraltar;0;0;0;0
2021-05-19;GI;Gibraltar;0;0;0;0
2021-05-20;GI;Gibraltar;0;0;0;0
2021-05-21;GI;Gibraltar;0;0;0;0
2021-05-22;GI;Gibraltar;0;0;0;0
2021-05-23;GI;Gibraltar;0;0;0;0
2021-05-24;GI;Gibraltar;0;0;0;0
2021-05-25;GI;Gibraltar;0;0;0;0
2021-05-26;GI;Gibraltar;0;0;0;0
2021-05-27;GI;Gibraltar;0;0;0;0
2021-05-28;GI;Gibraltar;0;0;0;0
2021-05-29;GI;Gibraltar;0;0;0;0
2021-05-30;GI;Gibraltar;0;0;0;0
2021-05-31;GI;Gibraltar;0;0;0;0
2021-06-01;GI;Gibraltar;0;0;0;0
2021-06-02;GI;Gibraltar;0;0;0;0
2021-06-03;GI;Gibraltar;0;0;0;0
2021-06-04;GI;Gibraltar;0;0;0;0
2021-06-05;GI;Gibraltar;0;0;0;0
2021-06-06;GI;Gibraltar;0;0;0;0
2021-06-07;GI;Gibraltar;0;0;0;0
2021-06-08;GI;Gibraltar;0;0;0;0
2021-06-09;GI;Gibraltar;0;0;0;0
2021-06-10;GI;Gibraltar;0;0;0;0
2021-06-11;GI;Gibraltar;0;0;0;0
2021-06-12;GI;Gibraltar;0;0;0;0
2021-06-13;GI;Gibraltar;0;0;0;0
2021-06-14;GI;Gibraltar;0;0;0;0
2021-06-15;GI;Gibraltar;0;0;0;0
2021-06-16;GI;Gibraltar;0;0;0;0
2021-06-17;GI;Gibraltar;0;0;0;0
2021-06-18;GI;Gibraltar;0;0;0;0
2021-06-19;GI;Gibraltar;0;0;0;0
2021-06-20;GI;Gibraltar;0;0;0;0
2021-06-21;GI;Gibraltar;0;0;0;0
2021-06-22;GI;Gibraltar;0;0;0;0
2021-06-23;GI;Gibraltar;0;0;0;0
2021-06-24;GI;Gibraltar;0;0;0;0
2021-06-25;GI;Gibraltar;0;0;0;0
2021-06-26;GI;Gibraltar;0;0;0;0
2021-06-27;GI;Gibraltar;0;0;0;0
2021-06-28;GI;Gibraltar;0;0;0;0
2021-06-29;GI;Gibraltar;0;0;0;0
2020-01-06;GR;Greece;0;0;0;0
2020-01-18;GR;Greece;0;0;0;0
2020-01-24;GR;Greece;0;0;0;0
2020-02-02;GR;Greece;0;0;0;0
2020-02-09;GR;Greece;0;0;0;0
2020-02-15;GR;Greece;0;0;0;0
2020-02-23;GR;Greece;0;0;0;0
2020-02-26;GR;Greece;1;0;1;0
2020-02-27;GR;Greece;2;0;3;0
2020-02-28;GR;Greece;1;0;4;0
2020-02-29;GR;Greece;0;0;4;0
2020-03-01;GR;Greece;3;0;7;0
2020-03-02;GR;Greece;0;0;7;0
2020-03-03;GR;Greece;0;0;7;0
2020-03-04;GR;Greece;2;0;9;0
2020-03-05;GR;Greece;22;0;31;0
2020-03-06;GR;Greece;14;0;45;0
2020-03-07;GR;Greece;1;0;46;0
2020-03-08;GR;Greece;27;0;73;0
2020-03-09;GR;Greece;0;0;73;0
2020-03-10;GR;Greece;16;0;89;0
2020-03-11;GR;Greece;10;1;99;1
2020-03-12;GR;Greece;0;0;99;1
2020-03-13;GR;Greece;91;0;190;1
2020-03-14;GR;Greece;38;2;228;3
2020-03-15;GR;Greece;103;1;331;4
2020-03-16;GR;Greece;0;0;331;4
2020-03-17;GR;Greece;56;1;387;5
2020-03-18;GR;Greece;31;0;418;5
2020-03-19;GR;Greece;0;1;418;6
2020-03-20;GR;Greece;77;0;495;6
2020-03-21;GR;Greece;35;7;530;13
2020-03-22;GR;Greece;94;2;624;15
2020-03-23;GR;Greece;71;2;695;17
2020-03-24;GR;Greece;48;3;743;20
2020-03-25;GR;Greece;78;2;821;22
2020-03-26;GR;Greece;71;4;892;26
2020-03-27;GR;Greece;74;2;966;28
2020-03-28;GR;Greece;95;4;1061;32
2020-03-29;GR;Greece;95;6;1156;38
2020-03-30;GR;Greece;56;5;1212;43
2020-03-31;GR;Greece;102;6;1314;49
2020-04-01;GR;Greece;101;1;1415;50
2020-04-02;GR;Greece;129;3;1544;53
2020-04-03;GR;Greece;69;10;1613;63
2020-04-04;GR;Greece;60;5;1673;68
2020-04-05;GR;Greece;62;5;1735;73
2020-04-06;GR;Greece;20;6;1755;79
2020-04-07;GR;Greece;77;2;1832;81
2020-04-08;GR;Greece;52;2;1884;83
2020-04-09;GR;Greece;71;4;1955;87
2020-04-10;GR;Greece;56;5;2011;92
2020-04-11;GR;Greece;70;1;2081;93
2020-04-12;GR;Greece;33;5;2114;98
2020-04-13;GR;Greece;31;1;2145;99
2020-04-14;GR;Greece;25;2;2170;101
2020-04-15;GR;Greece;22;1;2192;102
2020-04-16;GR;Greece;15;3;2207;105
2020-04-17;GR;Greece;17;3;2224;108
2020-04-18;GR;Greece;11;2;2235;110
2020-04-19;GR;Greece;0;3;2235;113
2020-04-20;GR;Greece;10;3;2245;116
2020-04-21;GR;Greece;156;5;2401;121
2020-04-22;GR;Greece;7;0;2408;121
2020-04-23;GR;Greece;55;4;2463;125
2020-04-24;GR;Greece;27;5;2490;130
2020-04-25;GR;Greece;16;0;2506;130
2020-04-26;GR;Greece;11;4;2517;134
2020-04-27;GR;Greece;17;2;2534;136
2020-04-28;GR;Greece;32;2;2566;138
2020-04-29;GR;Greece;10;1;2576;139
2020-04-30;GR;Greece;15;1;2591;140
2020-05-01;GR;Greece;21;0;2612;140
2020-05-02;GR;Greece;8;3;2620;143
2020-05-03;GR;Greece;6;1;2626;144
2020-05-04;GR;Greece;6;2;2632;146
2020-05-05;GR;Greece;10;0;2642;146
2020-05-06;GR;Greece;21;1;2663;147
2020-05-07;GR;Greece;15;1;2678;148
2020-05-08;GR;Greece;13;2;2691;150
2020-05-09;GR;Greece;19;1;2710;151
2020-05-10;GR;Greece;6;0;2716;151
2020-05-11;GR;Greece;10;0;2726;151
2020-05-12;GR;Greece;18;1;2744;152
2020-05-13;GR;Greece;16;3;2760;155
2020-05-14;GR;Greece;10;1;2770;156
2020-05-15;GR;Greece;40;4;2810;160
2020-05-16;GR;Greece;9;2;2819;162
2020-05-17;GR;Greece;15;1;2834;163
2020-05-18;GR;Greece;2;2;2836;165
2020-05-19;GR;Greece;4;0;2840;165
2020-05-20;GR;Greece;10;1;2850;166
2020-05-21;GR;Greece;3;2;2853;168
2020-05-22;GR;Greece;21;1;2874;169
2020-05-23;GR;Greece;2;2;2876;171
2020-05-24;GR;Greece;2;0;2878;171
2020-05-25;GR;Greece;4;1;2882;172
2020-05-26;GR;Greece;10;1;2892;173
2020-05-27;GR;Greece;11;0;2903;173
2020-05-28;GR;Greece;3;2;2906;175
2020-05-29;GR;Greece;3;0;2909;175
2020-05-30;GR;Greece;6;0;2915;175
2020-05-31;GR;Greece;2;0;2917;175
2020-06-01;GR;Greece;1;4;2918;179
2020-06-02;GR;Greece;19;0;2937;179
2020-06-03;GR;Greece;0;0;2937;179
2020-06-04;GR;Greece;15;1;2952;180
2020-06-05;GR;Greece;15;0;2967;180
2020-06-06;GR;Greece;13;0;2980;180
2020-06-07;GR;Greece;17;0;2997;180
2020-06-08;GR;Greece;52;2;3049;182
2020-06-09;GR;Greece;9;1;3058;183
2020-06-10;GR;Greece;10;0;3068;183
2020-06-11;GR;Greece;20;0;3088;183
2020-06-12;GR;Greece;20;0;3108;183
2020-06-13;GR;Greece;4;0;3112;183
2020-06-14;GR;Greece;9;0;3121;183
2020-06-15;GR;Greece;13;1;3134;184
2020-06-16;GR;Greece;14;1;3148;185
2020-06-17;GR;Greece;55;2;3203;187
2020-06-18;GR;Greece;24;1;3227;188
2020-06-19;GR;Greece;10;1;3237;189
2020-06-20;GR;Greece;19;1;3256;190
2020-06-21;GR;Greece;10;0;3266;190
2020-06-22;GR;Greece;21;0;3287;190
2020-06-23;GR;Greece;15;0;3302;190
2020-06-24;GR;Greece;8;0;3310;190
2020-06-25;GR;Greece;11;1;3321;191
2020-06-26;GR;Greece;22;0;3343;191
2020-06-27;GR;Greece;23;0;3366;191
2020-06-28;GR;Greece;10;0;3376;191
2020-06-29;GR;Greece;14;0;3390;191
2020-06-30;GR;Greece;19;1;3409;192
2020-07-01;GR;Greece;23;0;3432;192
2020-07-02;GR;Greece;26;0;3458;192
2020-07-03;GR;Greece;28;0;3486;192
2020-07-04;GR;Greece;25;0;3511;192
2020-07-05;GR;Greece;8;0;3519;192
2020-07-06;GR;Greece;43;0;3562;192
2020-07-07;GR;Greece;27;1;3589;193
2020-07-08;GR;Greece;33;0;3622;193
2020-07-09;GR;Greece;50;0;3672;193
2020-07-10;GR;Greece;60;0;3732;193
2020-07-11;GR;Greece;40;0;3772;193
2020-07-12;GR;Greece;31;0;3803;193
2020-07-13;GR;Greece;23;0;3826;193
2020-07-14;GR;Greece;57;0;3883;193
2020-07-15;GR;Greece;27;0;3910;193
2020-07-16;GR;Greece;29;0;3939;193
2020-07-17;GR;Greece;25;1;3964;194
2020-07-18;GR;Greece;19;0;3983;194
2020-07-19;GR;Greece;24;0;4007;194
2020-07-20;GR;Greece;5;1;4012;195
2020-07-21;GR;Greece;36;2;4048;197
2020-07-22;GR;Greece;29;3;4077;200
2020-07-23;GR;Greece;33;1;4110;201
2020-07-24;GR;Greece;25;0;4135;201
2020-07-25;GR;Greece;31;0;4166;201
2020-07-26;GR;Greece;27;1;4193;202
2020-07-27;GR;Greece;34;0;4227;202
2020-07-28;GR;Greece;52;1;4279;203
2020-07-29;GR;Greece;57;0;4336;203
2020-07-30;GR;Greece;65;0;4401;203
2020-07-31;GR;Greece;76;3;4477;206
2020-08-01;GR;Greece;110;0;4587;206
2020-08-02;GR;Greece;75;2;4662;208
2020-08-03;GR;Greece;75;1;4737;209
2020-08-04;GR;Greece;118;0;4855;209
2020-08-05;GR;Greece;119;1;4974;210
2020-08-06;GR;Greece;149;0;5123;210
2020-08-07;GR;Greece;147;0;5270;210
2020-08-08;GR;Greece;151;1;5421;211
2020-08-09;GR;Greece;202;1;5623;212
2020-08-10;GR;Greece;126;1;5749;213
2020-08-11;GR;Greece;193;1;5942;214
2020-08-12;GR;Greece;235;2;6177;216
2020-08-13;GR;Greece;204;5;6381;221
2020-08-14;GR;Greece;251;2;6632;223
2020-08-15;GR;Greece;226;3;6858;226
2020-08-16;GR;Greece;217;2;7075;228
2020-08-17;GR;Greece;147;2;7222;230
2020-08-18;GR;Greece;250;2;7472;232
2020-08-19;GR;Greece;212;3;7684;235
2020-08-20;GR;Greece;250;0;7934;235
2020-08-21;GR;Greece;204;3;8138;238
2020-08-22;GR;Greece;243;2;8381;240
2020-08-23;GR;Greece;283;2;8664;242
2020-08-24;GR;Greece;155;0;8819;242
2020-08-25;GR;Greece;168;1;8987;243
2020-08-26;GR;Greece;293;5;9280;248
2020-08-27;GR;Greece;251;6;9531;254
2020-08-28;GR;Greece;269;5;9800;259
2020-08-29;GR;Greece;177;1;9977;260
2020-08-30;GR;Greece;157;2;10134;262
2020-08-31;GR;Greece;183;4;10317;266
2020-09-01;GR;Greece;207;5;10524;271
2020-09-02;GR;Greece;233;2;10757;273
2020-09-03;GR;Greece;241;5;10998;278
2020-09-04;GR;Greece;202;1;11200;279
2020-09-05;GR;Greece;186;1;11386;280
2020-09-06;GR;Greece;138;4;11524;284
2020-09-07;GR;Greece;139;5;11663;289
2020-09-08;GR;Greece;169;1;11832;290
2020-09-09;GR;Greece;248;3;12080;293
2020-09-10;GR;Greece;372;4;12452;297
2020-09-11;GR;Greece;282;3;12734;300
2020-09-12;GR;Greece;302;2;13036;302
2020-09-13;GR;Greece;204;3;13240;305
2020-09-14;GR;Greece;180;5;13420;310
2020-09-15;GR;Greece;310;3;13730;313
2020-09-16;GR;Greece;311;3;14041;316
2020-09-17;GR;Greece;359;9;14400;325
2020-09-18;GR;Greece;338;2;14738;327
2020-09-19;GR;Greece;240;4;14978;331
2020-09-20;GR;Greece;164;7;15142;338
2020-09-21;GR;Greece;453;6;15595;344
2020-09-22;GR;Greece;333;8;15928;352
2020-09-23;GR;Greece;358;5;16286;357
2020-09-24;GR;Greece;341;9;16627;366
2020-09-25;GR;Greece;286;3;16913;369
2020-09-26;GR;Greece;315;7;17228;376
2020-09-27;GR;Greece;216;3;17444;379
2020-09-28;GR;Greece;263;4;17707;383
2020-09-29;GR;Greece;416;5;18123;388
2020-09-30;GR;Greece;352;3;18475;391
2020-10-01;GR;Greece;411;2;18886;393
2020-10-02;GR;Greece;460;5;19346;398
2020-10-03;GR;Greece;267;7;19613;405
2020-10-04;GR;Greece;229;4;19842;409
2020-10-05;GR;Greece;300;8;20142;417
2020-10-06;GR;Greece;399;3;20541;420
2020-10-07;GR;Greece;406;4;20947;424
2020-10-08;GR;Greece;434;6;21381;430
2020-10-09;GR;Greece;391;1;21772;431
2020-10-10;GR;Greece;306;5;22078;436
2020-10-11;GR;Greece;280;13;22358;449
2020-10-12;GR;Greece;294;7;22652;456
2020-10-13;GR;Greece;408;6;23060;462
2020-10-14;GR;Greece;435;7;23495;469
2020-10-15;GR;Greece;452;13;23947;482
2020-10-16;GR;Greece;503;8;24450;490
2020-10-17;GR;Greece;482;10;24932;500
2020-10-18;GR;Greece;438;9;25370;509
2020-10-19;GR;Greece;432;11;25802;520
2020-10-20;GR;Greece;667;8;26469;528
2020-10-21;GR;Greece;865;6;27334;534
2020-10-22;GR;Greece;882;15;28216;549
2020-10-23;GR;Greece;841;10;29057;559
2020-10-24;GR;Greece;935;5;29992;564
2020-10-25;GR;Greece;790;10;30782;574
2020-10-26;GR;Greece;714;7;31496;581
2020-10-27;GR;Greece;1256;12;32752;593
2020-10-28;GR;Greece;1547;10;34299;603
2020-10-29;GR;Greece;1211;12;35510;615
2020-10-30;GR;Greece;1686;5;37196;620
2020-10-31;GR;Greece;2055;6;39251;626
2020-11-01;GR;Greece;1678;9;40929;635
2020-11-02;GR;Greece;1151;7;42080;642
2020-11-03;GR;Greece;2166;13;44246;655
2020-11-04;GR;Greece;2646;18;46892;673
2020-11-05;GR;Greece;2915;29;49807;702
2020-11-06;GR;Greece;2447;13;52254;715
2020-11-07;GR;Greece;2555;34;54809;749
2020-11-08;GR;Greece;1889;35;56698;784
2020-11-09;GR;Greece;1489;41;58187;825
2020-11-10;GR;Greece;2383;41;60570;866
2020-11-11;GR;Greece;2751;43;63321;909
2020-11-12;GR;Greece;3316;50;66637;959
2020-11-13;GR;Greece;3038;38;69675;997
2020-11-14;GR;Greece;2835;38;72510;1035
2020-11-15;GR;Greece;1695;71;74205;1106
2020-11-16;GR;Greece;2198;59;76403;1165
2020-11-17;GR;Greece;2422;63;78825;1228
2020-11-18;GR;Greece;3209;60;82034;1288
2020-11-19;GR;Greece;3227;59;85261;1347
2020-11-20;GR;Greece;2551;72;87812;1419
2020-11-21;GR;Greece;2309;108;90121;1527
2020-11-22;GR;Greece;1498;103;91619;1630
2020-11-23;GR;Greece;1387;84;93006;1714
2020-11-24;GR;Greece;2131;101;95137;1815
2020-11-25;GR;Greece;2151;87;97288;1902
2020-11-26;GR;Greece;2018;99;99306;2001
2020-11-27;GR;Greece;1981;101;101287;2102
2020-11-28;GR;Greece;1747;121;103034;2223
2020-11-29;GR;Greece;1193;98;104227;2321
2020-11-30;GR;Greece;1044;85;105271;2406
2020-12-01;GR;Greece;2199;111;107470;2517
2020-12-02;GR;Greece;2185;89;109655;2606
2020-12-03;GR;Greece;1882;100;111537;2706
2020-12-04;GR;Greece;1648;98;113185;2804
2020-12-05;GR;Greece;1383;98;114568;2902
2020-12-06;GR;Greece;903;101;115471;3003
2020-12-07;GR;Greece;1250;89;116721;3092
2020-12-08;GR;Greece;1324;102;118045;3194
2020-12-09;GR;Greece;1675;95;119720;3289
2020-12-10;GR;Greece;1533;81;121253;3370
2020-12-11;GR;Greece;1395;102;122648;3472
2020-12-12;GR;Greece;1194;68;123842;3540
2020-12-13;GR;Greece;692;85;124534;3625
2020-12-14;GR;Greece;639;62;125173;3687
2020-12-15;GR;Greece;1199;98;126372;3785
2020-12-16;GR;Greece;1185;85;127557;3870
2020-12-17;GR;Greece;1153;78;128710;3948
2020-12-18;GR;Greece;874;96;129584;4044
2020-12-19;GR;Greece;901;58;130485;4102
2020-12-20;GR;Greece;587;70;131072;4172
2020-12-21;GR;Greece;525;85;131597;4257
2020-12-22;GR;Greece;833;83;132430;4340
2020-12-23;GR;Greece;935;62;133365;4402
2020-12-24;GR;Greece;870;55;134235;4457
2020-12-25;GR;Greece;617;50;134852;4507
2020-12-26;GR;Greece;262;46;135114;4553
2020-12-27;GR;Greece;342;53;135456;4606
2020-12-28;GR;Greece;475;66;135931;4672
2020-12-29;GR;Greece;1045;58;136976;4730
2020-12-30;GR;Greece;942;58;137918;4788
2020-12-31;GR;Greece;932;50;138850;4838
2021-01-01;GR;Greece;597;43;139447;4881
2021-01-02;GR;Greece;262;40;139709;4921
2021-01-03;GR;Greece;390;36;140099;4957
2021-01-04;GR;Greece;427;54;140526;5011
2021-01-05;GR;Greece;927;40;141453;5051
2021-01-06;GR;Greece;814;48;142267;5099
2021-01-07;GR;Greece;510;47;142777;5146
2021-01-08;GR;Greece;717;49;143494;5195
2021-01-09;GR;Greece;799;32;144293;5227
2021-01-10;GR;Greece;445;36;144738;5263
2021-01-11;GR;Greece;441;39;145179;5302
2021-01-12;GR;Greece;841;27;146020;5329
2021-01-13;GR;Greece;668;25;146688;5354
2021-01-14;GR;Greece;595;33;147283;5387
2021-01-15;GR;Greece;577;34;147860;5421
2021-01-16;GR;Greece;510;20;148370;5441
2021-01-17;GR;Greece;237;28;148607;5469
2021-01-18;GR;Greece;318;19;148925;5488
2021-01-19;GR;Greece;537;30;149462;5518
2021-01-20;GR;Greece;511;27;149973;5545
2021-01-21;GR;Greece;506;25;150479;5570
2021-01-22;GR;Greece;562;28;151041;5598
2021-01-23;GR;Greece;605;24;151646;5622
2021-01-24;GR;Greece;334;24;151980;5646
2021-01-25;GR;Greece;432;25;152412;5671
2021-01-26;GR;Greece;814;21;153226;5692
2021-01-27;GR;Greece;857;32;154083;5724
2021-01-28;GR;Greece;713;18;154796;5742
2021-01-29;GR;Greece;882;22;155678;5764
2021-01-30;GR;Greece;795;15;156473;5779
2021-01-31;GR;Greece;484;17;156957;5796
2021-02-01;GR;Greece;538;33;157495;5829
2021-02-02;GR;Greece;1221;22;158716;5851
2021-02-03;GR;Greece;1150;27;159866;5878
2021-02-04;GR;Greece;1069;25;160935;5903
2021-02-05;GR;Greece;1172;19;162107;5922
2021-02-06;GR;Greece;1106;29;163213;5951
2021-02-07;GR;Greece;733;21;163946;5972
2021-02-08;GR;Greece;629;25;164575;5997
2021-02-09;GR;Greece;1492;20;166067;6017
2021-02-10;GR;Greece;1482;17;167549;6034
2021-02-11;GR;Greece;1323;22;168872;6056
2021-02-12;GR;Greece;1372;21;170244;6077
2021-02-13;GR;Greece;1222;26;171466;6103
2021-02-14;GR;Greece;662;23;172128;6126
2021-02-15;GR;Greece;696;26;172824;6152
2021-02-16;GR;Greece;1081;29;173905;6181
2021-02-17;GR;Greece;754;13;174659;6194
2021-02-18;GR;Greece;1400;27;176059;6221
2021-02-19;GR;Greece;1435;28;177494;6249
2021-02-20;GR;Greece;1424;23;178918;6272
2021-02-21;GR;Greece;884;25;179802;6297
2021-02-22;GR;Greece;870;24;180672;6321
2021-02-23;GR;Greece;2111;22;182783;6343
2021-02-24;GR;Greece;1903;28;184686;6371
2021-02-25;GR;Greece;1783;39;186469;6410
2021-02-26;GR;Greece;1732;29;188201;6439
2021-02-27;GR;Greece;1630;29;189831;6468
2021-02-28;GR;Greece;1269;36;191100;6504
2021-03-01;GR;Greece;1170;30;192270;6534
2021-03-02;GR;Greece;2312;23;194582;6557
2021-03-03;GR;Greece;2697;40;197279;6597
2021-03-04;GR;Greece;2217;35;199496;6632
2021-03-05;GR;Greece;2181;32;201677;6664
2021-03-06;GR;Greece;2301;41;203978;6705
2021-03-07;GR;Greece;1142;53;205120;6758
2021-03-08;GR;Greece;1161;39;206281;6797
2021-03-09;GR;Greece;3181;46;209462;6843
2021-03-10;GR;Greece;2629;43;212091;6886
2021-03-11;GR;Greece;2570;51;214661;6937
2021-03-12;GR;Greece;2357;49;217018;6986
2021-03-13;GR;Greece;2503;52;219521;7038
2021-03-14;GR;Greece;1626;53;221147;7091
2021-03-15;GR;Greece;1134;46;222281;7137
2021-03-16;GR;Greece;1508;59;223789;7196
2021-03-17;GR;Greece;3458;56;227247;7252
2021-03-18;GR;Greece;3070;45;230317;7297
2021-03-19;GR;Greece;2762;64;233079;7361
2021-03-20;GR;Greece;2532;60;235611;7421
2021-03-21;GR;Greece;1514;41;237125;7462
2021-03-22;GR;Greece;1705;69;238830;7531
2021-03-23;GR;Greece;3517;51;242347;7582
2021-03-24;GR;Greece;3058;67;245405;7649
2021-03-25;GR;Greece;2587;52;247992;7701
2021-03-26;GR;Greece;1466;53;249458;7754
2021-03-27;GR;Greece;3132;72;252590;7826
2021-03-28;GR;Greece;1441;54;254031;7880
2021-03-29;GR;Greece;1724;65;255755;7945
2021-03-30;GR;Greece;4322;72;260077;8017
2021-03-31;GR;Greece;3612;76;263689;8093
2021-04-01;GR;Greece;3483;67;267172;8160
2021-04-02;GR;Greece;3058;72;270230;8232
2021-04-03;GR;Greece;3229;70;273459;8302
2021-04-04;GR;Greece;1955;78;275414;8380
2021-04-05;GR;Greece;1863;73;277277;8453
2021-04-06;GR;Greece;4293;79;281570;8532
2021-04-07;GR;Greece;3445;75;285015;8607
2021-04-08;GR;Greece;3215;73;288230;8680
2021-04-09;GR;Greece;2734;78;290964;8758
2021-04-10;GR;Greece;2799;75;293763;8833
2021-04-11;GR;Greece;1717;52;295480;8885
2021-04-12;GR;Greece;1606;76;297086;8961
2021-04-13;GR;Greece;4017;93;301103;9054
2021-04-14;GR;Greece;3081;81;304184;9135
2021-04-15;GR;Greece;3822;104;308006;9239
2021-04-16;GR;Greece;3027;91;311033;9330
2021-04-17;GR;Greece;2411;67;313444;9397
2021-04-18;GR;Greece;1829;65;315273;9462
2021-04-19;GR;Greece;1606;78;316879;9540
2021-04-20;GR;Greece;3750;87;320629;9627
2021-04-21;GR;Greece;3010;86;323639;9713
2021-04-22;GR;Greece;2756;75;326395;9788
2021-04-23;GR;Greece;2739;76;329134;9864
2021-04-24;GR;Greece;2596;86;331730;9950
2021-04-25;GR;Greece;1399;57;333129;10007
2021-04-26;GR;Greece;1307;80;334436;10087
2021-04-27;GR;Greece;3287;92;337723;10179
2021-04-28;GR;Greece;2770;63;340493;10242
2021-04-29;GR;Greece;2415;73;342908;10315
2021-04-30;GR;Greece;2125;66;345033;10381
2021-05-01;GR;Greece;1389;72;346422;10453
2021-05-02;GR;Greece;0;0;346422;10453
2021-05-03;GR;Greece;2146;134;348568;10587
2021-05-04;GR;Greece;1368;81;349936;10668
2021-05-05;GR;Greece;2091;96;352027;10764
2021-05-06;GR;Greece;3418;83;355445;10847
2021-05-07;GR;Greece;2671;63;358116;10910
2021-05-08;GR;Greece;2461;68;360577;10978
2021-05-09;GR;Greece;1427;51;362004;11029
2021-05-10;GR;Greece;1900;60;363904;11089
2021-05-11;GR;Greece;3172;52;367076;11141
2021-05-12;GR;Greece;2478;70;369554;11211
2021-05-13;GR;Greece;2158;55;371712;11266
2021-05-14;GR;Greece;2169;56;373881;11322
2021-05-15;GR;Greece;1950;43;375831;11365
2021-05-16;GR;Greece;1259;50;377090;11415
2021-05-17;GR;Greece;1395;56;378485;11471
2021-05-18;GR;Greece;2781;63;381266;11534
2021-05-19;GR;Greece;2292;53;383558;11587
2021-05-20;GR;Greece;1886;54;385444;11641
2021-05-21;GR;Greece;1982;56;387426;11697
2021-05-22;GR;Greece;1503;37;388929;11734
2021-05-23;GR;Greece;875;38;389804;11772
2021-05-24;GR;Greece;1377;50;391181;11822
2021-05-25;GR;Greece;2402;50;393583;11872
2021-05-26;GR;Greece;1511;44;395094;11916
2021-05-27;GR;Greece;1876;39;396970;11955
2021-05-28;GR;Greece;1928;40;398898;11995
2021-05-29;GR;Greece;1497;29;400395;12024
2021-05-30;GR;Greece;906;30;401301;12054
2021-05-31;GR;Greece;1005;41;402306;12095
2021-06-01;GR;Greece;1857;27;404163;12122
2021-06-02;GR;Greece;1379;23;405542;12145
2021-06-03;GR;Greece;1209;39;406751;12184
2021-06-04;GR;Greece;1106;34;407857;12218
2021-06-05;GR;Greece;932;35;408789;12253
2021-06-06;GR;Greece;579;24;409368;12277
2021-06-07;GR;Greece;798;24;410166;12301
2021-06-08;GR;Greece;1368;30;411534;12331
2021-06-09;GR;Greece;886;15;412420;12346
2021-06-10;GR;Greece;750;24;413170;12370
2021-06-11;GR;Greece;784;11;413954;12381
2021-06-12;GR;Greece;682;21;414636;12402
2021-06-13;GR;Greece;297;17;414933;12419
2021-06-14;GR;Greece;468;18;415401;12437
2021-06-15;GR;Greece;794;22;416195;12459
2021-06-16;GR;Greece;546;13;416741;12472
2021-06-17;GR;Greece;512;16;417253;12488
2021-06-18;GR;Greece;453;20;417706;12508
2021-06-19;GR;Greece;389;20;418095;12528
2021-06-20;GR;Greece;247;14;418342;12542
2021-06-21;GR;Greece;206;17;418548;12559
2021-06-22;GR;Greece;395;16;418943;12575
2021-06-23;GR;Greece;512;14;419455;12589
2021-06-24;GR;Greece;454;15;419909;12604
2021-06-25;GR;Greece;386;21;420295;12625
2021-06-26;GR;Greece;375;12;420670;12637
2021-06-27;GR;Greece;235;18;420905;12655
2021-06-28;GR;Greece;361;8;421266;12663
2021-06-29;GR;Greece;563;13;421829;12676
2021-06-30;GR;Greece;627;11;422456;12687
2021-07-01;GR;Greece;729;4;423185;12691
2021-01-27;GL;Greenland;0;0;0;0
2021-01-28;GL;Greenland;0;0;0;0
2021-01-29;GL;Greenland;0;0;0;0
2021-01-30;GL;Greenland;0;0;0;0
2021-01-31;GL;Greenland;0;0;0;0
2021-02-01;GL;Greenland;0;0;0;0
2021-02-02;GL;Greenland;0;0;0;0
2021-02-03;GL;Greenland;0;0;0;0
2021-02-04;GL;Greenland;0;0;0;0
2021-02-05;GL;Greenland;0;0;0;0
2021-02-06;GL;Greenland;0;0;0;0
2021-02-07;GL;Greenland;0;0;0;0
2021-02-08;GL;Greenland;0;0;0;0
2021-02-09;GL;Greenland;0;0;0;0
2021-02-10;GL;Greenland;0;0;0;0
2021-02-11;GL;Greenland;0;0;0;0
2021-02-12;GL;Greenland;0;0;0;0
2021-02-13;GL;Greenland;0;0;0;0
2021-02-14;GL;Greenland;0;0;0;0
2021-02-15;GL;Greenland;0;0;0;0
2021-02-16;GL;Greenland;0;0;0;0
2021-02-17;GL;Greenland;0;0;0;0
2021-02-18;GL;Greenland;0;0;0;0
2021-02-19;GL;Greenland;0;0;0;0
2021-02-20;GL;Greenland;0;0;0;0
2021-02-21;GL;Greenland;0;0;0;0
2021-02-22;GL;Greenland;0;0;0;0
2021-02-23;GL;Greenland;0;0;0;0
2021-02-24;GL;Greenland;0;0;0;0
2021-02-25;GL;Greenland;0;0;0;0
2021-02-26;GL;Greenland;0;0;0;0
2021-02-27;GL;Greenland;0;0;0;0
2021-02-28;GL;Greenland;0;0;0;0
2021-03-01;GL;Greenland;0;0;0;0
2021-03-02;GL;Greenland;0;0;0;0
2021-03-03;GL;Greenland;0;0;0;0
2021-03-04;GL;Greenland;0;0;0;0
2021-03-05;GL;Greenland;0;0;0;0
2021-03-06;GL;Greenland;0;0;0;0
2021-03-07;GL;Greenland;0;0;0;0
2021-03-08;GL;Greenland;0;0;0;0
2021-03-09;GL;Greenland;0;0;0;0
2021-03-10;GL;Greenland;0;0;0;0
2021-03-11;GL;Greenland;0;0;0;0
2021-03-12;GL;Greenland;0;0;0;0
2021-03-13;GL;Greenland;0;0;0;0
2021-03-14;GL;Greenland;0;0;0;0
2021-03-15;GL;Greenland;0;0;0;0
2021-03-16;GL;Greenland;0;0;0;0
2021-03-17;GL;Greenland;0;0;0;0
2021-03-18;GL;Greenland;0;0;0;0
2021-03-19;GL;Greenland;0;0;0;0
2021-03-20;GL;Greenland;0;0;0;0
2021-03-21;GL;Greenland;0;0;0;0
2021-03-22;GL;Greenland;0;0;0;0
2021-03-23;GL;Greenland;0;0;0;0
2021-03-24;GL;Greenland;0;0;0;0
2021-03-25;GL;Greenland;0;0;0;0
2021-03-26;GL;Greenland;0;0;0;0
2021-03-27;GL;Greenland;0;0;0;0
2021-03-28;GL;Greenland;0;0;0;0
2021-03-29;GL;Greenland;0;0;0;0
2021-03-30;GL;Greenland;0;0;0;0
2021-03-31;GL;Greenland;0;0;0;0
2021-04-01;GL;Greenland;0;0;0;0
2021-04-02;GL;Greenland;0;0;0;0
2021-04-03;GL;Greenland;0;0;0;0
2021-04-04;GL;Greenland;0;0;0;0
2021-04-05;GL;Greenland;0;0;0;0
2021-04-06;GL;Greenland;0;0;0;0
2021-04-07;GL;Greenland;0;0;0;0
2021-04-08;GL;Greenland;0;0;0;0
2021-04-09;GL;Greenland;0;0;0;0
2021-04-10;GL;Greenland;0;0;0;0
2021-04-11;GL;Greenland;0;0;0;0
2021-04-12;GL;Greenland;0;0;0;0
2021-04-13;GL;Greenland;0;0;0;0
2021-04-14;GL;Greenland;0;0;0;0
2021-04-15;GL;Greenland;0;0;0;0
2021-04-16;GL;Greenland;0;0;0;0
2021-04-17;GL;Greenland;0;0;0;0
2021-04-18;GL;Greenland;0;0;0;0
2021-04-19;GL;Greenland;0;0;0;0
2021-04-20;GL;Greenland;0;0;0;0
2021-04-21;GL;Greenland;0;0;0;0
2021-04-22;GL;Greenland;0;0;0;0
2021-04-23;GL;Greenland;0;0;0;0
2021-04-24;GL;Greenland;0;0;0;0
2021-04-25;GL;Greenland;0;0;0;0
2021-04-26;GL;Greenland;0;0;0;0
2021-04-27;GL;Greenland;0;0;0;0
2021-04-28;GL;Greenland;0;0;0;0
2021-04-29;GL;Greenland;0;0;0;0
2021-04-30;GL;Greenland;0;0;0;0
2021-05-01;GL;Greenland;0;0;0;0
2021-05-02;GL;Greenland;0;0;0;0
2021-05-03;GL;Greenland;0;0;0;0
2021-05-04;GL;Greenland;0;0;0;0
2021-05-05;GL;Greenland;0;0;0;0
2021-05-06;GL;Greenland;0;0;0;0
2021-05-07;GL;Greenland;0;0;0;0
2021-05-08;GL;Greenland;0;0;0;0
2021-05-09;GL;Greenland;0;0;0;0
2021-05-10;GL;Greenland;0;0;0;0
2021-05-11;GL;Greenland;0;0;0;0
2021-05-12;GL;Greenland;0;0;0;0
2021-05-13;GL;Greenland;0;0;0;0
2021-05-14;GL;Greenland;0;0;0;0
2021-05-15;GL;Greenland;0;0;0;0
2021-05-16;GL;Greenland;0;0;0;0
2021-05-17;GL;Greenland;0;0;0;0
2021-05-18;GL;Greenland;0;0;0;0
2021-05-19;GL;Greenland;0;0;0;0
2021-05-20;GL;Greenland;0;0;0;0
2021-05-21;GL;Greenland;0;0;0;0
2021-05-22;GL;Greenland;0;0;0;0
2021-05-23;GL;Greenland;0;0;0;0
2021-05-24;GL;Greenland;0;0;0;0
2021-05-25;GL;Greenland;0;0;0;0
2021-05-26;GL;Greenland;0;0;0;0
2021-05-27;GL;Greenland;0;0;0;0
2021-05-28;GL;Greenland;0;0;0;0
2021-05-29;GL;Greenland;0;0;0;0
2021-05-30;GL;Greenland;0;0;0;0
2021-05-31;GL;Greenland;0;0;0;0
2021-06-01;GL;Greenland;0;0;0;0
2021-06-02;GL;Greenland;0;0;0;0
2021-06-03;GL;Greenland;0;0;0;0
2021-06-04;GL;Greenland;0;0;0;0
2021-06-05;GL;Greenland;0;0;0;0
2021-06-06;GL;Greenland;0;0;0;0
2021-06-07;GL;Greenland;0;0;0;0
2021-06-08;GL;Greenland;0;0;0;0
2021-06-09;GL;Greenland;0;0;0;0
2021-06-10;GL;Greenland;0;0;0;0
2021-06-11;GL;Greenland;0;0;0;0
2021-06-12;GL;Greenland;0;0;0;0
2021-06-13;GL;Greenland;0;0;0;0
2021-06-14;GL;Greenland;0;0;0;0
2021-06-15;GL;Greenland;0;0;0;0
2021-06-16;GL;Greenland;0;0;0;0
2021-06-17;GL;Greenland;0;0;0;0
2021-06-18;GL;Greenland;0;0;0;0
2021-06-19;GL;Greenland;0;0;0;0
2021-06-20;GL;Greenland;0;0;0;0
2021-06-21;GL;Greenland;0;0;0;0
2021-06-22;GL;Greenland;0;0;0;0
2021-06-23;GL;Greenland;0;0;0;0
2021-06-24;GL;Greenland;0;0;0;0
2021-06-25;GL;Greenland;0;0;0;0
2021-06-26;GL;Greenland;0;0;0;0
2021-06-27;GL;Greenland;0;0;0;0
2021-06-28;GL;Greenland;0;0;0;0
2021-06-29;GL;Greenland;0;0;0;0
2021-06-30;GL;Greenland;0;0;0;0
2021-07-01;GL;Greenland;0;0;0;0
2020-03-22;GD;Grenada;1;0;1;0
2020-03-23;GD;Grenada;0;0;1;0
2020-03-24;GD;Grenada;0;0;1;0
2020-03-25;GD;Grenada;0;0;1;0
2020-03-26;GD;Grenada;6;0;7;0
2020-03-27;GD;Grenada;0;0;7;0
2020-03-28;GD;Grenada;0;0;7;0
2020-03-29;GD;Grenada;2;0;9;0
2020-03-30;GD;Grenada;0;0;9;0
2020-03-31;GD;Grenada;0;0;9;0
2020-04-01;GD;Grenada;0;0;9;0
2020-04-02;GD;Grenada;1;0;10;0
2020-04-03;GD;Grenada;2;0;12;0
2020-04-04;GD;Grenada;0;0;12;0
2020-04-05;GD;Grenada;0;0;12;0
2020-04-06;GD;Grenada;0;0;12;0
2020-04-07;GD;Grenada;0;0;12;0
2020-04-08;GD;Grenada;0;0;12;0
2020-04-09;GD;Grenada;0;0;12;0
2020-04-10;GD;Grenada;2;0;14;0
2020-04-11;GD;Grenada;0;0;14;0
2020-04-12;GD;Grenada;0;0;14;0
2020-04-13;GD;Grenada;0;0;14;0
2020-04-14;GD;Grenada;0;0;14;0
2020-04-15;GD;Grenada;0;0;14;0
2020-04-16;GD;Grenada;0;0;14;0
2020-04-17;GD;Grenada;0;0;14;0
2020-04-18;GD;Grenada;0;0;14;0
2020-04-19;GD;Grenada;0;0;14;0
2020-04-20;GD;Grenada;0;0;14;0
2020-04-21;GD;Grenada;0;0;14;0
2020-04-22;GD;Grenada;1;0;15;0
2020-04-23;GD;Grenada;0;0;15;0
2020-04-24;GD;Grenada;0;0;15;0
2020-04-25;GD;Grenada;3;0;18;0
2020-04-26;GD;Grenada;0;0;18;0
2020-04-27;GD;Grenada;0;0;18;0
2020-04-28;GD;Grenada;1;0;19;0
2020-04-29;GD;Grenada;1;0;20;0
2020-04-30;GD;Grenada;0;0;20;0
2020-05-01;GD;Grenada;0;0;20;0
2020-05-02;GD;Grenada;1;0;21;0
2020-05-03;GD;Grenada;0;0;21;0
2020-05-04;GD;Grenada;0;0;21;0
2020-05-05;GD;Grenada;0;0;21;0
2020-05-06;GD;Grenada;0;0;21;0
2020-05-07;GD;Grenada;0;0;21;0
2020-05-08;GD;Grenada;0;0;21;0
2020-05-09;GD;Grenada;0;0;21;0
2020-05-10;GD;Grenada;0;0;21;0
2020-05-11;GD;Grenada;0;0;21;0
2020-05-12;GD;Grenada;0;0;21;0
2020-05-13;GD;Grenada;0;0;21;0
2020-05-14;GD;Grenada;0;0;21;0
2020-05-15;GD;Grenada;1;0;22;0
2020-05-16;GD;Grenada;0;0;22;0
2020-05-17;GD;Grenada;0;0;22;0
2020-05-18;GD;Grenada;0;0;22;0
2020-05-19;GD;Grenada;0;0;22;0
2020-05-20;GD;Grenada;0;0;22;0
2020-05-21;GD;Grenada;0;0;22;0
2020-05-22;GD;Grenada;0;0;22;0
2020-05-23;GD;Grenada;0;0;22;0
2020-05-24;GD;Grenada;0;0;22;0
2020-05-25;GD;Grenada;1;0;23;0
2020-05-26;GD;Grenada;0;0;23;0
2020-05-27;GD;Grenada;0;0;23;0
2020-05-28;GD;Grenada;0;0;23;0
2020-05-29;GD;Grenada;0;0;23;0
2020-05-30;GD;Grenada;0;0;23;0
2020-05-31;GD;Grenada;0;0;23;0
2020-06-01;GD;Grenada;0;0;23;0
2020-06-02;GD;Grenada;0;0;23;0
2020-06-03;GD;Grenada;0;0;23;0
2020-06-04;GD;Grenada;0;0;23;0
2020-06-05;GD;Grenada;0;0;23;0
2020-06-06;GD;Grenada;0;0;23;0
2020-06-07;GD;Grenada;0;0;23;0
2020-06-08;GD;Grenada;0;0;23;0
2020-06-09;GD;Grenada;0;0;23;0
2020-06-10;GD;Grenada;0;0;23;0
2020-06-11;GD;Grenada;0;0;23;0
2020-06-12;GD;Grenada;0;0;23;0
2020-06-13;GD;Grenada;0;0;23;0
2020-06-14;GD;Grenada;0;0;23;0
2020-06-15;GD;Grenada;0;0;23;0
2020-06-16;GD;Grenada;0;0;23;0
2020-06-17;GD;Grenada;0;0;23;0
2020-06-18;GD;Grenada;0;0;23;0
2020-06-19;GD;Grenada;0;0;23;0
2020-06-20;GD;Grenada;0;0;23;0
2020-06-21;GD;Grenada;0;0;23;0
2020-06-22;GD;Grenada;0;0;23;0
2020-06-23;GD;Grenada;0;0;23;0
2020-06-24;GD;Grenada;0;0;23;0
2020-06-25;GD;Grenada;0;0;23;0
2020-06-26;GD;Grenada;0;0;23;0
2020-06-27;GD;Grenada;0;0;23;0
2020-06-28;GD;Grenada;0;0;23;0
2020-06-29;GD;Grenada;0;0;23;0
2020-06-30;GD;Grenada;0;0;23;0
2020-07-01;GD;Grenada;0;0;23;0
2020-07-02;GD;Grenada;0;0;23;0
2020-07-03;GD;Grenada;0;0;23;0
2020-07-04;GD;Grenada;0;0;23;0
2020-07-05;GD;Grenada;0;0;23;0
2020-07-06;GD;Grenada;0;0;23;0
2020-07-07;GD;Grenada;0;0;23;0
2020-07-08;GD;Grenada;0;0;23;0
2020-07-09;GD;Grenada;0;0;23;0
2020-07-10;GD;Grenada;0;0;23;0
2020-07-11;GD;Grenada;0;0;23;0
2020-07-12;GD;Grenada;0;0;23;0
2020-07-13;GD;Grenada;0;0;23;0
2020-07-14;GD;Grenada;0;0;23;0
2020-07-15;GD;Grenada;0;0;23;0
2020-07-16;GD;Grenada;0;0;23;0
2020-07-17;GD;Grenada;0;0;23;0
2020-07-18;GD;Grenada;0;0;23;0
2020-07-19;GD;Grenada;0;0;23;0
2020-07-20;GD;Grenada;0;0;23;0
2020-07-21;GD;Grenada;0;0;23;0
2020-07-22;GD;Grenada;0;0;23;0
2020-07-23;GD;Grenada;0;0;23;0
2020-07-24;GD;Grenada;0;0;23;0
2020-07-25;GD;Grenada;0;0;23;0
2020-07-26;GD;Grenada;0;0;23;0
2020-07-27;GD;Grenada;0;0;23;0
2020-07-28;GD;Grenada;0;0;23;0
2020-07-29;GD;Grenada;0;0;23;0
2020-07-30;GD;Grenada;1;0;24;0
2020-07-31;GD;Grenada;0;0;24;0
2020-08-01;GD;Grenada;0;0;24;0
2020-08-02;GD;Grenada;0;0;24;0
2020-08-03;GD;Grenada;0;0;24;0
2020-08-04;GD;Grenada;0;0;24;0
2020-08-05;GD;Grenada;0;0;24;0
2020-08-06;GD;Grenada;0;0;24;0
2020-08-07;GD;Grenada;0;0;24;0
2020-08-08;GD;Grenada;0;0;24;0
2020-08-09;GD;Grenada;0;0;24;0
2020-08-10;GD;Grenada;0;0;24;0
2020-08-11;GD;Grenada;0;0;24;0
2020-08-12;GD;Grenada;0;0;24;0
2020-08-13;GD;Grenada;0;0;24;0
2020-08-14;GD;Grenada;0;0;24;0
2020-08-15;GD;Grenada;0;0;24;0
2020-08-16;GD;Grenada;0;0;24;0
2020-08-17;GD;Grenada;0;0;24;0
2020-08-18;GD;Grenada;0;0;24;0
2020-08-19;GD;Grenada;0;0;24;0
2020-08-20;GD;Grenada;0;0;24;0
2020-08-21;GD;Grenada;0;0;24;0
2020-08-22;GD;Grenada;0;0;24;0
2020-08-23;GD;Grenada;0;0;24;0
2020-08-24;GD;Grenada;0;0;24;0
2020-08-25;GD;Grenada;0;0;24;0
2020-08-26;GD;Grenada;0;0;24;0
2020-08-27;GD;Grenada;0;0;24;0
2020-08-28;GD;Grenada;0;0;24;0
2020-08-29;GD;Grenada;0;0;24;0
2020-08-30;GD;Grenada;0;0;24;0
2020-08-31;GD;Grenada;0;0;24;0
2020-09-01;GD;Grenada;0;0;24;0
2020-09-02;GD;Grenada;0;0;24;0
2020-09-03;GD;Grenada;0;0;24;0
2020-09-04;GD;Grenada;0;0;24;0
2020-09-05;GD;Grenada;0;0;24;0
2020-09-06;GD;Grenada;0;0;24;0
2020-09-07;GD;Grenada;0;0;24;0
2020-09-08;GD;Grenada;0;0;24;0
2020-09-09;GD;Grenada;0;0;24;0
2020-09-10;GD;Grenada;0;0;24;0
2020-09-11;GD;Grenada;0;0;24;0
2020-09-12;GD;Grenada;0;0;24;0
2020-09-13;GD;Grenada;0;0;24;0
2020-09-14;GD;Grenada;0;0;24;0
2020-09-15;GD;Grenada;0;0;24;0
2020-09-16;GD;Grenada;0;0;24;0
2020-09-17;GD;Grenada;0;0;24;0
2020-09-18;GD;Grenada;0;0;24;0
2020-09-19;GD;Grenada;0;0;24;0
2020-09-20;GD;Grenada;0;0;24;0
2020-09-21;GD;Grenada;0;0;24;0
2020-09-22;GD;Grenada;0;0;24;0
2020-09-23;GD;Grenada;0;0;24;0
2020-09-24;GD;Grenada;0;0;24;0
2020-09-25;GD;Grenada;0;0;24;0
2020-09-26;GD;Grenada;0;0;24;0
2020-09-27;GD;Grenada;0;0;24;0
2020-09-28;GD;Grenada;0;0;24;0
2020-09-29;GD;Grenada;0;0;24;0
2020-09-30;GD;Grenada;0;0;24;0
2020-10-01;GD;Grenada;0;0;24;0
2020-10-02;GD;Grenada;0;0;24;0
2020-10-03;GD;Grenada;0;0;24;0
2020-10-04;GD;Grenada;0;0;24;0
2020-10-05;GD;Grenada;0;0;24;0
2020-10-06;GD;Grenada;0;0;24;0
2020-10-07;GD;Grenada;0;0;24;0
2020-10-08;GD;Grenada;0;0;24;0
2020-10-09;GD;Grenada;0;0;24;0
2020-10-10;GD;Grenada;0;0;24;0
2020-10-11;GD;Grenada;0;0;24;0
2020-10-12;GD;Grenada;1;0;25;0
2020-10-13;GD;Grenada;0;0;25;0
2020-10-14;GD;Grenada;0;0;25;0
2020-10-15;GD;Grenada;0;0;25;0
2020-10-16;GD;Grenada;0;0;25;0
2020-10-17;GD;Grenada;2;0;27;0
2020-10-18;GD;Grenada;0;0;27;0
2020-10-19;GD;Grenada;0;0;27;0
2020-10-20;GD;Grenada;0;0;27;0
2020-10-21;GD;Grenada;0;0;27;0
2020-10-22;GD;Grenada;0;0;27;0
2020-10-23;GD;Grenada;0;0;27;0
2020-10-24;GD;Grenada;1;0;28;0
2020-10-25;GD;Grenada;0;0;28;0
2020-10-26;GD;Grenada;0;0;28;0
2020-10-27;GD;Grenada;0;0;28;0
2020-10-28;GD;Grenada;0;0;28;0
2020-10-29;GD;Grenada;0;0;28;0
2020-10-30;GD;Grenada;0;0;28;0
2020-10-31;GD;Grenada;0;0;28;0
2020-11-01;GD;Grenada;0;0;28;0
2020-11-02;GD;Grenada;1;0;29;0
2020-11-03;GD;Grenada;0;0;29;0
2020-11-04;GD;Grenada;1;0;30;0
2020-11-05;GD;Grenada;0;0;30;0
2020-11-06;GD;Grenada;0;0;30;0
2020-11-07;GD;Grenada;0;0;30;0
2020-11-08;GD;Grenada;2;0;32;0
2020-11-09;GD;Grenada;0;0;32;0
2020-11-10;GD;Grenada;0;0;32;0
2020-11-11;GD;Grenada;0;0;32;0
2020-11-12;GD;Grenada;0;0;32;0
2020-11-13;GD;Grenada;0;0;32;0
2020-11-14;GD;Grenada;0;0;32;0
2020-11-15;GD;Grenada;0;0;32;0
2020-11-16;GD;Grenada;1;0;33;0
2020-11-17;GD;Grenada;0;0;33;0
2020-11-18;GD;Grenada;3;0;36;0
2020-11-19;GD;Grenada;0;0;36;0
2020-11-20;GD;Grenada;5;0;41;0
2020-11-21;GD;Grenada;0;0;41;0
2020-11-22;GD;Grenada;0;0;41;0
2020-11-23;GD;Grenada;0;0;41;0
2020-11-24;GD;Grenada;0;0;41;0
2020-11-25;GD;Grenada;0;0;41;0
2020-11-26;GD;Grenada;0;0;41;0
2020-11-27;GD;Grenada;0;0;41;0
2020-11-28;GD;Grenada;0;0;41;0
2020-11-29;GD;Grenada;0;0;41;0
2020-11-30;GD;Grenada;0;0;41;0
2020-12-01;GD;Grenada;0;0;41;0
2020-12-02;GD;Grenada;0;0;41;0
2020-12-03;GD;Grenada;0;0;41;0
2020-12-04;GD;Grenada;0;0;41;0
2020-12-05;GD;Grenada;0;0;41;0
2020-12-06;GD;Grenada;0;0;41;0
2020-12-07;GD;Grenada;2;0;43;0
2020-12-08;GD;Grenada;0;0;43;0
2020-12-09;GD;Grenada;0;0;43;0
2020-12-10;GD;Grenada;0;0;43;0
2020-12-11;GD;Grenada;0;0;43;0
2020-12-12;GD;Grenada;0;0;43;0
2020-12-13;GD;Grenada;26;0;69;0
2020-12-14;GD;Grenada;0;0;69;0
2020-12-15;GD;Grenada;0;0;69;0
2020-12-16;GD;Grenada;16;0;85;0
2020-12-17;GD;Grenada;0;0;85;0
2020-12-18;GD;Grenada;9;0;94;0
2020-12-19;GD;Grenada;0;0;94;0
2020-12-20;GD;Grenada;9;0;103;0
2020-12-21;GD;Grenada;0;0;103;0
2020-12-22;GD;Grenada;0;0;103;0
2020-12-23;GD;Grenada;2;0;105;0
2020-12-24;GD;Grenada;0;0;105;0
2020-12-25;GD;Grenada;7;0;112;0
2020-12-26;GD;Grenada;0;0;112;0
2020-12-27;GD;Grenada;0;0;112;0
2020-12-28;GD;Grenada;12;0;124;0
2020-12-29;GD;Grenada;3;0;127;0
2020-12-30;GD;Grenada;0;0;127;0
2020-12-31;GD;Grenada;0;0;127;0
2021-01-01;GD;Grenada;0;0;127;0
2021-01-02;GD;Grenada;0;0;127;0
2021-01-03;GD;Grenada;0;1;127;1
2021-01-04;GD;Grenada;0;0;127;1
2021-01-05;GD;Grenada;0;0;127;1
2021-01-06;GD;Grenada;0;0;127;1
2021-01-07;GD;Grenada;0;0;127;1
2021-01-08;GD;Grenada;0;0;127;1
2021-01-09;GD;Grenada;0;0;127;1
2021-01-10;GD;Grenada;0;0;127;1
2021-01-11;GD;Grenada;5;0;132;1
2021-01-12;GD;Grenada;0;0;132;1
2021-01-13;GD;Grenada;0;0;132;1
2021-01-14;GD;Grenada;0;0;132;1
2021-01-15;GD;Grenada;7;0;139;1
2021-01-16;GD;Grenada;0;0;139;1
2021-01-17;GD;Grenada;0;0;139;1
2021-01-18;GD;Grenada;0;0;139;1
2021-01-19;GD;Grenada;0;0;139;1
2021-01-20;GD;Grenada;0;0;139;1
2021-01-21;GD;Grenada;0;0;139;1
2021-01-22;GD;Grenada;0;0;139;1
2021-01-23;GD;Grenada;8;0;147;1
2021-01-24;GD;Grenada;0;0;147;1
2021-01-25;GD;Grenada;1;0;148;1
2021-01-26;GD;Grenada;0;0;148;1
2021-01-27;GD;Grenada;0;0;148;1
2021-01-28;GD;Grenada;0;0;148;1
2021-01-29;GD;Grenada;0;0;148;1
2021-01-30;GD;Grenada;0;0;148;1
2021-01-31;GD;Grenada;0;0;148;1
2021-02-01;GD;Grenada;0;0;148;1
2021-02-02;GD;Grenada;0;0;148;1
2021-02-03;GD;Grenada;0;0;148;1
2021-02-04;GD;Grenada;0;0;148;1
2021-02-05;GD;Grenada;0;0;148;1
2021-02-06;GD;Grenada;0;0;148;1
2021-02-07;GD;Grenada;0;0;148;1
2021-02-08;GD;Grenada;0;0;148;1
2021-02-09;GD;Grenada;0;0;148;1
2021-02-10;GD;Grenada;0;0;148;1
2021-02-11;GD;Grenada;0;0;148;1
2021-02-12;GD;Grenada;0;0;148;1
2021-02-13;GD;Grenada;0;0;148;1
2021-02-14;GD;Grenada;0;0;148;1
2021-02-15;GD;Grenada;0;0;148;1
2021-02-16;GD;Grenada;0;0;148;1
2021-02-17;GD;Grenada;0;0;148;1
2021-02-18;GD;Grenada;0;0;148;1
2021-02-19;GD;Grenada;0;0;148;1
2021-02-20;GD;Grenada;0;0;148;1
2021-02-21;GD;Grenada;0;0;148;1
2021-02-22;GD;Grenada;0;0;148;1
2021-02-23;GD;Grenada;0;0;148;1
2021-02-24;GD;Grenada;0;0;148;1
2021-02-25;GD;Grenada;0;0;148;1
2021-02-26;GD;Grenada;0;0;148;1
2021-02-27;GD;Grenada;0;0;148;1
2021-02-28;GD;Grenada;0;0;148;1
2021-03-01;GD;Grenada;0;0;148;1
2021-03-02;GD;Grenada;0;0;148;1
2021-03-03;GD;Grenada;0;0;148;1
2021-03-04;GD;Grenada;0;0;148;1
2021-03-05;GD;Grenada;0;0;148;1
2021-03-06;GD;Grenada;0;0;148;1
2021-03-07;GD;Grenada;0;0;148;1
2021-03-08;GD;Grenada;0;0;148;1
2021-03-09;GD;Grenada;0;0;148;1
2021-03-10;GD;Grenada;0;0;148;1
2021-03-11;GD;Grenada;0;0;148;1
2021-03-12;GD;Grenada;0;0;148;1
2021-03-13;GD;Grenada;0;0;148;1
2021-03-14;GD;Grenada;0;0;148;1
2021-03-15;GD;Grenada;6;0;154;1
2021-03-16;GD;Grenada;0;0;154;1
2021-03-17;GD;Grenada;0;0;154;1
2021-03-18;GD;Grenada;0;0;154;1
2021-03-19;GD;Grenada;0;0;154;1
2021-03-20;GD;Grenada;0;0;154;1
2021-03-21;GD;Grenada;0;0;154;1
2021-03-22;GD;Grenada;0;0;154;1
2021-03-23;GD;Grenada;0;0;154;1
2021-03-24;GD;Grenada;0;0;154;1
2021-03-25;GD;Grenada;0;0;154;1
2021-03-26;GD;Grenada;1;0;155;1
2021-03-27;GD;Grenada;0;0;155;1
2021-03-28;GD;Grenada;0;0;155;1
2021-03-29;GD;Grenada;0;0;155;1
2021-03-30;GD;Grenada;0;0;155;1
2021-03-31;GD;Grenada;0;0;155;1
2021-04-01;GD;Grenada;0;0;155;1
2021-04-02;GD;Grenada;0;0;155;1
2021-04-03;GD;Grenada;0;0;155;1
2021-04-04;GD;Grenada;0;0;155;1
2021-04-05;GD;Grenada;0;0;155;1
2021-04-06;GD;Grenada;0;0;155;1
2021-04-07;GD;Grenada;0;0;155;1
2021-04-08;GD;Grenada;0;0;155;1
2021-04-09;GD;Grenada;0;0;155;1
2021-04-10;GD;Grenada;0;0;155;1
2021-04-11;GD;Grenada;0;0;155;1
2021-04-12;GD;Grenada;0;0;155;1
2021-04-13;GD;Grenada;0;0;155;1
2021-04-14;GD;Grenada;0;0;155;1
2021-04-15;GD;Grenada;0;0;155;1
2021-04-16;GD;Grenada;0;0;155;1
2021-04-17;GD;Grenada;0;0;155;1
2021-04-18;GD;Grenada;0;0;155;1
2021-04-19;GD;Grenada;2;0;157;1
2021-04-20;GD;Grenada;0;0;157;1
2021-04-21;GD;Grenada;0;0;157;1
2021-04-22;GD;Grenada;2;0;159;1
2021-04-23;GD;Grenada;0;0;159;1
2021-04-24;GD;Grenada;0;0;159;1
2021-04-25;GD;Grenada;0;0;159;1
2021-04-26;GD;Grenada;0;0;159;1
2021-04-27;GD;Grenada;0;0;159;1
2021-04-28;GD;Grenada;0;0;159;1
2021-04-29;GD;Grenada;1;0;160;1
2021-04-30;GD;Grenada;0;0;160;1
2021-05-01;GD;Grenada;0;0;160;1
2021-05-02;GD;Grenada;0;0;160;1
2021-05-03;GD;Grenada;0;0;160;1
2021-05-04;GD;Grenada;0;0;160;1
2021-05-05;GD;Grenada;0;0;160;1
2021-05-06;GD;Grenada;0;0;160;1
2021-05-07;GD;Grenada;0;0;160;1
2021-05-08;GD;Grenada;0;0;160;1
2021-05-09;GD;Grenada;0;0;160;1
2021-05-10;GD;Grenada;0;0;160;1
2021-05-11;GD;Grenada;0;0;160;1
2021-05-12;GD;Grenada;1;0;161;1
2021-05-13;GD;Grenada;0;0;161;1
2021-05-14;GD;Grenada;0;0;161;1
2021-05-15;GD;Grenada;0;0;161;1
2021-05-16;GD;Grenada;0;0;161;1
2021-05-17;GD;Grenada;0;0;161;1
2021-05-18;GD;Grenada;0;0;161;1
2021-05-19;GD;Grenada;0;0;161;1
2021-05-20;GD;Grenada;0;0;161;1
2021-05-21;GD;Grenada;0;0;161;1
2021-05-22;GD;Grenada;0;0;161;1
2021-05-23;GD;Grenada;0;0;161;1
2021-05-24;GD;Grenada;0;0;161;1
2021-05-25;GD;Grenada;0;0;161;1
2021-05-26;GD;Grenada;0;0;161;1
2021-05-27;GD;Grenada;0;0;161;1
2021-05-28;GD;Grenada;0;0;161;1
2021-05-29;GD;Grenada;0;0;161;1
2021-05-30;GD;Grenada;0;0;161;1
2021-05-31;GD;Grenada;0;0;161;1
2021-06-01;GD;Grenada;0;0;161;1
2021-06-02;GD;Grenada;0;0;161;1
2021-06-03;GD;Grenada;0;0;161;1
2021-06-04;GD;Grenada;0;0;161;1
2021-06-05;GD;Grenada;0;0;161;1
2021-06-06;GD;Grenada;0;0;161;1
2021-06-07;GD;Grenada;0;0;161;1
2021-06-08;GD;Grenada;0;0;161;1
2021-06-09;GD;Grenada;0;0;161;1
2021-06-10;GD;Grenada;0;0;161;1
2021-06-11;GD;Grenada;0;0;161;1
2021-06-12;GD;Grenada;0;0;161;1
2021-06-13;GD;Grenada;0;0;161;1
2021-06-14;GD;Grenada;0;0;161;1
2021-06-15;GD;Grenada;0;0;161;1
2021-06-16;GD;Grenada;0;0;161;1
2021-06-17;GD;Grenada;0;0;161;1
2021-06-18;GD;Grenada;0;0;161;1
2021-06-19;GD;Grenada;0;0;161;1
2021-06-20;GD;Grenada;0;0;161;1
2021-06-21;GD;Grenada;0;0;161;1
2021-06-22;GD;Grenada;0;0;161;1
2021-06-23;GD;Grenada;0;0;161;1
2021-06-24;GD;Grenada;0;0;161;1
2021-06-25;GD;Grenada;0;0;161;1
2021-06-26;GD;Grenada;0;0;161;1
2021-06-27;GD;Grenada;0;0;161;1
2021-06-28;GD;Grenada;0;0;161;1
2021-06-29;GD;Grenada;0;0;161;1
2021-06-30;GD;Grenada;0;0;161;1
2021-07-01;GD;Grenada;0;0;161;1
2020-02-17;GT;Guatemala;0;0;0;0
2020-02-18;GT;Guatemala;0;0;0;0
2020-02-19;GT;Guatemala;0;0;0;0
2020-02-20;GT;Guatemala;0;0;0;0
2020-02-21;GT;Guatemala;0;0;0;0
2020-02-22;GT;Guatemala;0;0;0;0
2020-02-23;GT;Guatemala;0;0;0;0
2020-02-24;GT;Guatemala;0;0;0;0
2020-02-25;GT;Guatemala;0;0;0;0
2020-02-26;GT;Guatemala;0;0;0;0
2020-02-27;GT;Guatemala;0;0;0;0
2020-02-28;GT;Guatemala;0;0;0;0
2020-02-29;GT;Guatemala;0;0;0;0
2020-03-01;GT;Guatemala;0;0;0;0
2020-03-02;GT;Guatemala;0;0;0;0
2020-03-03;GT;Guatemala;0;0;0;0
2020-03-04;GT;Guatemala;0;0;0;0
2020-03-05;GT;Guatemala;0;0;0;0
2020-03-06;GT;Guatemala;0;0;0;0
2020-03-07;GT;Guatemala;0;0;0;0
2020-03-08;GT;Guatemala;0;0;0;0
2020-03-09;GT;Guatemala;0;0;0;0
2020-03-10;GT;Guatemala;0;0;0;0
2020-03-11;GT;Guatemala;0;0;0;0
2020-03-12;GT;Guatemala;0;0;0;0
2020-03-13;GT;Guatemala;0;0;0;0
2020-03-14;GT;Guatemala;1;0;1;0
2020-03-15;GT;Guatemala;0;0;1;0
2020-03-16;GT;Guatemala;1;1;2;1
2020-03-17;GT;Guatemala;4;0;6;1
2020-03-18;GT;Guatemala;0;0;6;1
2020-03-19;GT;Guatemala;3;0;9;1
2020-03-20;GT;Guatemala;3;0;12;1
2020-03-21;GT;Guatemala;5;0;17;1
2020-03-22;GT;Guatemala;2;0;19;1
2020-03-23;GT;Guatemala;1;0;20;1
2020-03-24;GT;Guatemala;1;0;21;1
2020-03-25;GT;Guatemala;3;0;24;1
2020-03-26;GT;Guatemala;1;0;25;1
2020-03-27;GT;Guatemala;3;0;28;1
2020-03-28;GT;Guatemala;6;0;34;1
2020-03-29;GT;Guatemala;0;0;34;1
2020-03-30;GT;Guatemala;2;0;36;1
2020-03-31;GT;Guatemala;2;0;38;1
2020-04-01;GT;Guatemala;1;0;39;1
2020-04-02;GT;Guatemala;8;0;47;1
2020-04-03;GT;Guatemala;3;0;50;1
2020-04-04;GT;Guatemala;11;1;61;2
2020-04-05;GT;Guatemala;0;0;61;2
2020-04-06;GT;Guatemala;9;1;70;3
2020-04-07;GT;Guatemala;7;0;77;3
2020-04-08;GT;Guatemala;10;0;87;3
2020-04-09;GT;Guatemala;8;0;95;3
2020-04-10;GT;Guatemala;31;0;126;3
2020-04-11;GT;Guatemala;11;0;137;3
2020-04-12;GT;Guatemala;18;2;155;5
2020-04-13;GT;Guatemala;1;0;156;5
2020-04-14;GT;Guatemala;11;0;167;5
2020-04-15;GT;Guatemala;13;0;180;5
2020-04-16;GT;Guatemala;16;0;196;5
2020-04-17;GT;Guatemala;18;2;214;7
2020-04-18;GT;Guatemala;21;0;235;7
2020-04-19;GT;Guatemala;22;0;257;7
2020-04-20;GT;Guatemala;32;0;289;7
2020-04-21;GT;Guatemala;5;0;294;7
2020-04-22;GT;Guatemala;22;1;316;8
2020-04-23;GT;Guatemala;68;3;384;11
2020-04-24;GT;Guatemala;46;0;430;11
2020-04-25;GT;Guatemala;43;2;473;13
2020-04-26;GT;Guatemala;27;2;500;15
2020-04-27;GT;Guatemala;30;0;530;15
2020-04-28;GT;Guatemala;0;0;530;15
2020-04-29;GT;Guatemala;27;1;557;16
2020-04-30;GT;Guatemala;42;0;599;16
2020-05-01;GT;Guatemala;45;0;644;16
2020-05-02;GT;Guatemala;44;1;688;17
2020-05-03;GT;Guatemala;15;0;703;17
2020-05-04;GT;Guatemala;27;2;730;19
2020-05-05;GT;Guatemala;33;0;763;19
2020-05-06;GT;Guatemala;35;2;798;21
2020-05-07;GT;Guatemala;34;2;832;23
2020-05-08;GT;Guatemala;68;1;900;24
2020-05-09;GT;Guatemala;67;0;967;24
2020-05-10;GT;Guatemala;85;2;1052;26
2020-05-11;GT;Guatemala;62;0;1114;26
2020-05-12;GT;Guatemala;85;1;1199;27
2020-05-13;GT;Guatemala;143;2;1342;29
2020-05-14;GT;Guatemala;176;0;1518;29
2020-05-15;GT;Guatemala;125;1;1643;30
2020-05-16;GT;Guatemala;120;3;1763;33
2020-05-17;GT;Guatemala;0;0;1763;33
2020-05-18;GT;Guatemala;149;2;1912;35
2020-05-19;GT;Guatemala;221;8;2133;43
2020-05-20;GT;Guatemala;132;2;2265;45
2020-05-21;GT;Guatemala;247;3;2512;48
2020-05-22;GT;Guatemala;231;3;2743;51
2020-05-23;GT;Guatemala;311;4;3054;55
2020-05-24;GT;Guatemala;370;3;3424;58
2020-05-25;GT;Guatemala;336;1;3760;59
2020-05-26;GT;Guatemala;194;4;3954;63
2020-05-27;GT;Guatemala;191;5;4145;68
2020-05-28;GT;Guatemala;203;12;4348;80
2020-05-29;GT;Guatemala;259;10;4607;90
2020-05-30;GT;Guatemala;132;12;4739;102
2020-05-31;GT;Guatemala;348;6;5087;108
2020-06-01;GT;Guatemala;249;8;5336;116
2020-06-02;GT;Guatemala;250;7;5586;123
2020-06-03;GT;Guatemala;174;20;5760;143
2020-06-04;GT;Guatemala;394;15;6154;158
2020-06-05;GT;Guatemala;331;58;6485;216
2020-06-06;GT;Guatemala;307;14;6792;230
2020-06-07;GT;Guatemala;263;22;7055;252
2020-06-08;GT;Guatemala;447;15;7502;267
2020-06-09;GT;Guatemala;364;22;7866;289
2020-06-10;GT;Guatemala;355;27;8221;316
2020-06-11;GT;Guatemala;340;18;8561;334
2020-06-12;GT;Guatemala;421;17;8982;351
2020-06-13;GT;Guatemala;509;16;9491;367
2020-06-14;GT;Guatemala;354;17;9845;384
2020-06-15;GT;Guatemala;427;15;10272;399
2020-06-16;GT;Guatemala;434;19;10706;418
2020-06-17;GT;Guatemala;545;14;11251;432
2020-06-18;GT;Guatemala;617;17;11868;449
2020-06-19;GT;Guatemala;641;34;12509;483
2020-06-20;GT;Guatemala;246;31;12755;514
2020-06-21;GT;Guatemala;390;17;13145;531
2020-06-22;GT;Guatemala;624;16;13769;547
2020-06-23;GT;Guatemala;771;35;14540;582
2020-06-24;GT;Guatemala;279;19;14819;601
2020-06-25;GT;Guatemala;800;22;15619;623
2020-06-26;GT;Guatemala;209;49;15828;672
2020-06-27;GT;Guatemala;569;34;16397;706
2020-06-28;GT;Guatemala;533;21;16930;727
2020-06-29;GT;Guatemala;479;19;17409;746
2020-06-30;GT;Guatemala;687;27;18096;773
2020-07-01;GT;Guatemala;915;44;19011;817
2020-07-02;GT;Guatemala;1061;26;20072;843
2020-07-03;GT;Guatemala;1221;37;21293;880
2020-07-04;GT;Guatemala;1208;40;22501;920
2020-07-05;GT;Guatemala;747;27;23248;947
2020-07-06;GT;Guatemala;724;34;23972;981
2020-07-07;GT;Guatemala;815;23;24787;1004
2020-07-08;GT;Guatemala;624;49;25411;1053
2020-07-09;GT;Guatemala;1247;39;26658;1092
2020-07-10;GT;Guatemala;961;47;27619;1139
2020-07-11;GT;Guatemala;979;33;28598;1172
2020-07-12;GT;Guatemala;757;47;29355;1219
2020-07-13;GT;Guatemala;387;25;29742;1244
2020-07-14;GT;Guatemala;1130;58;30872;1302
2020-07-15;GT;Guatemala;1202;48;32074;1350
2020-07-16;GT;Guatemala;865;54;32939;1404
2020-07-17;GT;Guatemala;870;39;33809;1443
2020-07-18;GT;Guatemala;4233;6;38042;1449
2020-07-19;GT;Guatemala;635;36;38677;1485
2020-07-20;GT;Guatemala;362;17;39039;1502
2020-07-21;GT;Guatemala;1190;29;40229;1531
2020-07-22;GT;Guatemala;906;42;41135;1573
2020-07-23;GT;Guatemala;1057;59;42192;1632
2020-07-24;GT;Guatemala;1091;37;43283;1669
2020-07-25;GT;Guatemala;1209;30;44492;1699
2020-07-26;GT;Guatemala;561;35;45053;1734
2020-07-27;GT;Guatemala;256;27;45309;1761
2020-07-28;GT;Guatemala;1142;21;46451;1782
2020-07-29;GT;Guatemala;1154;53;47605;1835
2020-07-30;GT;Guatemala;1221;32;48826;1867
2020-07-31;GT;Guatemala;963;57;49789;1924
2020-08-01;GT;Guatemala;1190;35;50979;1959
2020-08-02;GT;Guatemala;327;36;51306;1995
2020-08-03;GT;Guatemala;236;18;51542;2013
2020-08-04;GT;Guatemala;823;24;52365;2037
2020-08-05;GT;Guatemala;1144;35;53509;2072
2020-08-06;GT;Guatemala;830;47;54339;2119
2020-08-07;GT;Guatemala;931;49;55270;2168
2020-08-08;GT;Guatemala;919;29;56189;2197
2020-08-09;GT;Guatemala;416;14;56605;2211
2020-08-10;GT;Guatemala;382;11;56987;2222
2020-08-11;GT;Guatemala;979;11;57966;2233
2020-08-12;GT;Guatemala;1123;34;59089;2267
2020-08-13;GT;Guatemala;1195;29;60284;2296
2020-08-14;GT;Guatemala;1144;45;61428;2341
2020-08-15;GT;Guatemala;885;14;62313;2355
2020-08-16;GT;Guatemala;249;24;62562;2379
2020-08-17;GT;Guatemala;382;10;62944;2389
2020-08-18;GT;Guatemala;903;30;63847;2419
2020-08-19;GT;Guatemala;1034;48;64881;2467
2020-08-20;GT;Guatemala;1102;39;65983;2506
2020-08-21;GT;Guatemala;958;26;66941;2532
2020-08-22;GT;Guatemala;915;48;67856;2580
2020-08-23;GT;Guatemala;332;14;68188;2594
2020-08-24;GT;Guatemala;345;17;68533;2611
2020-08-25;GT;Guatemala;1118;19;69651;2630
2020-08-26;GT;Guatemala;1063;32;70714;2662
2020-08-27;GT;Guatemala;1142;23;71856;2685
2020-08-28;GT;Guatemala;1065;24;72921;2709
2020-08-29;GT;Guatemala;758;19;73679;2728
2020-08-30;GT;Guatemala;233;12;73912;2740
2020-08-31;GT;Guatemala;162;20;74074;2760
2020-09-01;GT;Guatemala;819;18;74893;2778
2020-09-02;GT;Guatemala;751;12;75644;2790
2020-09-03;GT;Guatemala;714;14;76358;2804
2020-09-04;GT;Guatemala;682;21;77040;2825
2020-09-05;GT;Guatemala;441;20;77481;2845
2020-09-06;GT;Guatemala;202;7;77683;2852
2020-09-07;GT;Guatemala;145;10;77828;2862
2020-09-08;GT;Guatemala;893;28;78721;2890
2020-09-09;GT;Guatemala;901;7;79622;2897
2020-09-10;GT;Guatemala;684;21;80306;2918
2020-09-11;GT;Guatemala;703;11;81009;2929
2020-09-12;GT;Guatemala;649;20;81658;2949
2020-09-13;GT;Guatemala;251;8;81909;2957
2020-09-14;GT;Guatemala;263;15;82172;2972
2020-09-15;GT;Guatemala;512;12;82684;2984
2020-09-16;GT;Guatemala;240;25;82924;3009
2020-09-17;GT;Guatemala;740;27;83664;3036
2020-09-18;GT;Guatemala;680;40;84344;3076
2020-09-19;GT;Guatemala;808;29;85152;3105
2020-09-20;GT;Guatemala;292;14;85444;3119
2020-09-21;GT;Guatemala;237;5;85681;3124
2020-09-22;GT;Guatemala;942;13;86623;3137
2020-09-23;GT;Guatemala;819;17;87442;3154
2020-09-24;GT;Guatemala;491;16;87933;3170
2020-09-25;GT;Guatemala;945;16;88878;3186
2020-09-26;GT;Guatemala;824;27;89702;3213
2020-09-27;GT;Guatemala;390;16;90092;3229
2020-09-28;GT;Guatemala;171;5;90263;3234
2020-09-29;GT;Guatemala;705;4;90968;3238
2020-09-30;GT;Guatemala;778;8;91746;3246
2020-10-01;GT;Guatemala;663;15;92409;3261
2020-10-02;GT;Guatemala;681;6;93090;3267
2020-10-03;GT;Guatemala;658;18;93748;3285
2020-10-04;GT;Guatemala;215;8;93963;3293
2020-10-05;GT;Guatemala;219;9;94182;3302
2020-10-06;GT;Guatemala;688;8;94870;3310
2020-10-07;GT;Guatemala;834;25;95704;3335
2020-10-08;GT;Guatemala;776;12;96480;3347
2020-10-09;GT;Guatemala;455;9;96935;3356
2020-10-10;GT;Guatemala;609;9;97544;3365
2020-10-11;GT;Guatemala;171;19;97715;3384
2020-10-12;GT;Guatemala;111;3;97826;3387
2020-10-13;GT;Guatemala;554;23;98380;3410
2020-10-14;GT;Guatemala;714;20;99094;3430
2020-10-15;GT;Guatemala;671;23;99765;3453
2020-10-16;GT;Guatemala;666;25;100431;3478
2020-10-17;GT;Guatemala;597;37;101028;3515
2020-10-18;GT;Guatemala;332;15;101360;3530
2020-10-19;GT;Guatemala;239;11;101599;3541
2020-10-20;GT;Guatemala;620;5;102219;3546
2020-10-21;GT;Guatemala;196;21;102415;3567
2020-10-22;GT;Guatemala;757;13;103172;3580
2020-10-23;GT;Guatemala;730;14;103902;3594
2020-10-24;GT;Guatemala;730;15;104632;3609
2020-10-25;GT;Guatemala;155;35;104787;3644
2020-10-26;GT;Guatemala;107;7;104894;3651
2020-10-27;GT;Guatemala;677;14;105571;3665
2020-10-28;GT;Guatemala;749;17;106320;3682
2020-10-29;GT;Guatemala;470;22;106790;3704
2020-10-30;GT;Guatemala;549;10;107339;3714
2020-10-31;GT;Guatemala;600;15;107939;3729
2020-11-01;GT;Guatemala;165;9;108104;3738
2020-11-02;GT;Guatemala;0;0;108104;3738
2020-11-03;GT;Guatemala;379;10;108483;3748
2020-11-04;GT;Guatemala;664;4;109147;3752
2020-11-05;GT;Guatemala;702;14;109849;3766
2020-11-06;GT;Guatemala;653;28;110502;3794
2020-11-07;GT;Guatemala;548;17;111050;3811
2020-11-08;GT;Guatemala;212;10;111262;3821
2020-11-09;GT;Guatemala;98;2;111360;3823
2020-11-10;GT;Guatemala;769;9;112129;3832
2020-11-11;GT;Guatemala;682;13;112811;3845
2020-11-12;GT;Guatemala;732;13;113543;3858
2020-11-13;GT;Guatemala;580;22;114123;3880
2020-11-14;GT;Guatemala;596;40;114719;3920
2020-11-15;GT;Guatemala;166;12;114885;3932
2020-11-16;GT;Guatemala;147;6;115032;3938
2020-11-17;GT;Guatemala;698;9;115730;3947
2020-11-18;GT;Guatemala;651;61;116381;4008
2020-11-19;GT;Guatemala;685;42;117066;4050
2020-11-20;GT;Guatemala;691;17;117757;4067
2020-11-21;GT;Guatemala;660;7;118417;4074
2020-11-22;GT;Guatemala;212;2;118629;4076
2020-11-23;GT;Guatemala;93;16;118722;4092
2020-11-24;GT;Guatemala;627;7;119349;4099
2020-11-25;GT;Guatemala;640;8;119989;4107
2020-11-26;GT;Guatemala;696;26;120685;4133
2020-11-27;GT;Guatemala;447;8;121132;4141
2020-11-28;GT;Guatemala;666;20;121798;4161
2020-11-29;GT;Guatemala;173;5;121971;4166
2020-11-30;GT;Guatemala;91;5;122062;4171
2020-12-01;GT;Guatemala;712;7;122774;4178
2020-12-02;GT;Guatemala;686;13;123460;4191
2020-12-03;GT;Guatemala;593;18;124053;4209
2020-12-04;GT;Guatemala;752;15;124805;4224
2020-12-05;GT;Guatemala;547;15;125352;4239
2020-12-06;GT;Guatemala;198;11;125550;4250
2020-12-07;GT;Guatemala;124;24;125674;4274
2020-12-08;GT;Guatemala;799;12;126473;4286
2020-12-09;GT;Guatemala;654;25;127127;4311
2020-12-10;GT;Guatemala;659;34;127786;4345
2020-12-11;GT;Guatemala;755;31;128541;4376
2020-12-12;GT;Guatemala;558;29;129099;4405
2020-12-13;GT;Guatemala;183;18;129282;4423
2020-12-14;GT;Guatemala;123;22;129405;4445
2020-12-15;GT;Guatemala;677;31;130082;4476
2020-12-16;GT;Guatemala;746;34;130828;4510
2020-12-17;GT;Guatemala;607;41;131435;4551
2020-12-18;GT;Guatemala;627;38;132062;4589
2020-12-19;GT;Guatemala;533;35;132595;4624
2020-12-20;GT;Guatemala;170;32;132765;4656
2020-12-21;GT;Guatemala;102;32;132867;4688
2020-12-22;GT;Guatemala;734;30;133601;4718
2020-12-23;GT;Guatemala;655;21;134256;4739
2020-12-24;GT;Guatemala;638;10;134894;4749
2020-12-25;GT;Guatemala;186;8;135080;4757
2020-12-26;GT;Guatemala;91;6;135171;4763
2020-12-27;GT;Guatemala;138;5;135309;4768
2020-12-28;GT;Guatemala;132;5;135441;4773
2020-12-29;GT;Guatemala;846;8;136287;4781
2020-12-30;GT;Guatemala;879;22;137166;4803
2020-12-31;GT;Guatemala;846;10;138012;4813
2021-01-01;GT;Guatemala;224;7;138236;4820
2021-01-02;GT;Guatemala;80;7;138316;4827
2021-01-03;GT;Guatemala;159;6;138475;4833
2021-01-04;GT;Guatemala;181;2;138656;4835
2021-01-05;GT;Guatemala;763;24;139419;4859
2021-01-06;GT;Guatemala;783;40;140202;4899
2021-01-07;GT;Guatemala;872;29;141074;4928
2021-01-08;GT;Guatemala;990;44;142064;4972
2021-01-09;GT;Guatemala;1063;27;143127;4999
2021-01-10;GT;Guatemala;116;26;143243;5025
2021-01-11;GT;Guatemala;0;0;143243;5025
2021-01-12;GT;Guatemala;1739;55;144982;5080
2021-01-13;GT;Guatemala;1004;37;145986;5117
2021-01-14;GT;Guatemala;951;34;146937;5151
2021-01-15;GT;Guatemala;623;26;147560;5177
2021-01-16;GT;Guatemala;1038;43;148598;5220
2021-01-17;GT;Guatemala;290;34;148888;5254
2021-01-18;GT;Guatemala;258;24;149146;5278
2021-01-19;GT;Guatemala;1131;35;150277;5313
2021-01-20;GT;Guatemala;1047;30;151324;5343
2021-01-21;GT;Guatemala;1071;46;152395;5389
2021-01-22;GT;Guatemala;561;31;152956;5420
2021-01-23;GT;Guatemala;934;36;153890;5456
2021-01-24;GT;Guatemala;322;9;154212;5465
2021-01-25;GT;Guatemala;218;4;154430;5469
2021-01-26;GT;Guatemala;1029;17;155459;5486
2021-01-27;GT;Guatemala;1038;27;156497;5513
2021-01-28;GT;Guatemala;1098;30;157595;5543
2021-01-29;GT;Guatemala;741;39;158336;5582
2021-01-30;GT;Guatemala;782;36;159118;5618
2021-01-31;GT;Guatemala;386;25;159504;5643
2021-02-01;GT;Guatemala;128;30;159632;5673
2021-02-02;GT;Guatemala;667;36;160299;5709
2021-02-03;GT;Guatemala;667;27;160966;5736
2021-02-04;GT;Guatemala;699;49;161665;5785
2021-02-05;GT;Guatemala;630;31;162295;5816
2021-02-06;GT;Guatemala;642;38;162937;5854
2021-02-07;GT;Guatemala;200;30;163137;5884
2021-02-08;GT;Guatemala;110;38;163247;5922
2021-02-09;GT;Guatemala;746;33;163993;5955
2021-02-10;GT;Guatemala;753;34;164746;5989
2021-02-11;GT;Guatemala;786;34;165532;6023
2021-02-12;GT;Guatemala;751;34;166283;6057
2021-02-13;GT;Guatemala;788;37;167071;6094
2021-02-14;GT;Guatemala;208;30;167279;6124
2021-02-15;GT;Guatemala;104;26;167383;6150
2021-02-16;GT;Guatemala;720;8;168103;6158
2021-02-17;GT;Guatemala;777;6;168880;6164
2021-02-18;GT;Guatemala;730;22;169610;6186
2021-02-19;GT;Guatemala;665;34;170275;6220
2021-02-20;GT;Guatemala;656;29;170931;6249
2021-02-21;GT;Guatemala;239;33;171170;6282
2021-02-22;GT;Guatemala;119;24;171289;6306
2021-02-23;GT;Guatemala;783;9;172072;6315
2021-02-24;GT;Guatemala;692;12;172764;6327
2021-02-25;GT;Guatemala;378;7;173142;6334
2021-02-26;GT;Guatemala;672;14;173814;6348
2021-02-27;GT;Guatemala;521;26;174335;6374
2021-02-28;GT;Guatemala;207;19;174542;6393
2021-03-01;GT;Guatemala;111;9;174653;6402
2021-03-02;GT;Guatemala;758;10;175411;6412
2021-03-03;GT;Guatemala;839;15;176250;6427
2021-03-04;GT;Guatemala;626;8;176876;6435
2021-03-05;GT;Guatemala;840;20;177716;6455
2021-03-06;GT;Guatemala;621;12;178337;6467
2021-03-07;GT;Guatemala;223;6;178560;6473
2021-03-08;GT;Guatemala;210;6;178770;6479
2021-03-09;GT;Guatemala;793;14;179563;6493
2021-03-10;GT;Guatemala;830;29;180393;6522
2021-03-11;GT;Guatemala;750;9;181143;6531
2021-03-12;GT;Guatemala;831;15;181974;6546
2021-03-13;GT;Guatemala;705;25;182679;6571
2021-03-14;GT;Guatemala;202;-3;182881;6568
2021-03-15;GT;Guatemala;133;10;183014;6578
2021-03-16;GT;Guatemala;971;21;183985;6599
2021-03-17;GT;Guatemala;949;20;184934;6619
2021-03-18;GT;Guatemala;898;20;185832;6639
2021-03-19;GT;Guatemala;908;24;186740;6663
2021-03-20;GT;Guatemala;919;22;187659;6685
2021-03-21;GT;Guatemala;252;15;187911;6700
2021-03-22;GT;Guatemala;208;10;188119;6710
2021-03-23;GT;Guatemala;948;20;189067;6730
2021-03-24;GT;Guatemala;1141;19;190208;6749
2021-03-25;GT;Guatemala;999;16;191207;6765
2021-03-26;GT;Guatemala;926;10;192133;6775
2021-03-27;GT;Guatemala;917;19;193050;6794
2021-03-28;GT;Guatemala;327;8;193377;6802
2021-03-29;GT;Guatemala;179;7;193556;6809
2021-03-30;GT;Guatemala;278;14;193834;6823
2021-03-31;GT;Guatemala;0;17;193834;6840
2021-04-01;GT;Guatemala;922;20;194756;6860
2021-04-02;GT;Guatemala;280;15;195036;6875
2021-04-03;GT;Guatemala;203;9;195239;6884
2021-04-04;GT;Guatemala;232;7;195471;6891
2021-04-05;GT;Guatemala;209;3;195680;6894
2021-04-06;GT;Guatemala;1340;9;197020;6903
2021-04-07;GT;Guatemala;1354;25;198374;6928
2021-04-08;GT;Guatemala;1590;27;199964;6955
2021-04-09;GT;Guatemala;1331;22;201295;6977
2021-04-10;GT;Guatemala;1345;24;202640;7001
2021-04-11;GT;Guatemala;431;15;203071;7016
2021-04-12;GT;Guatemala;238;4;203309;7020
2021-04-13;GT;Guatemala;2013;37;205322;7057
2021-04-14;GT;Guatemala;1805;32;207127;7089
2021-04-15;GT;Guatemala;1567;31;208694;7120
2021-04-16;GT;Guatemala;1973;40;210667;7160
2021-04-17;GT;Guatemala;1640;30;212307;7190
2021-04-18;GT;Guatemala;427;31;212734;7221
2021-04-19;GT;Guatemala;315;20;213049;7241
2021-04-20;GT;Guatemala;1651;38;214700;7279
2021-04-21;GT;Guatemala;1629;30;216329;7309
2021-04-22;GT;Guatemala;1816;36;218145;7345
2021-04-23;GT;Guatemala;1644;29;219789;7374
2021-04-24;GT;Guatemala;1518;21;221307;7395
2021-04-25;GT;Guatemala;391;15;221698;7410
2021-04-26;GT;Guatemala;241;18;221939;7428
2021-04-27;GT;Guatemala;1086;25;223025;7453
2021-04-28;GT;Guatemala;1596;25;224621;7478
2021-04-29;GT;Guatemala;1626;22;226247;7500
2021-04-30;GT;Guatemala;1424;24;227671;7524
2021-05-01;GT;Guatemala;806;19;228477;7543
2021-05-02;GT;Guatemala;207;15;228684;7558
2021-05-03;GT;Guatemala;187;20;228871;7578
2021-05-04;GT;Guatemala;1224;28;230095;7606
2021-05-05;GT;Guatemala;1194;36;231289;7642
2021-05-06;GT;Guatemala;1150;35;232439;7677
2021-05-07;GT;Guatemala;1257;18;233696;7695
2021-05-08;GT;Guatemala;1187;22;234883;7717
2021-05-09;GT;Guatemala;215;16;235098;7733
2021-05-10;GT;Guatemala;206;3;235304;7736
2021-05-11;GT;Guatemala;962;40;236266;7776
2021-05-12;GT;Guatemala;1416;39;237682;7815
2021-05-13;GT;Guatemala;1105;17;238787;7832
2021-05-14;GT;Guatemala;1383;13;240170;7845
2021-05-15;GT;Guatemala;947;27;241117;7872
2021-05-16;GT;Guatemala;252;15;241369;7887
2021-05-17;GT;Guatemala;159;6;241528;7893
2021-05-18;GT;Guatemala;1256;20;242784;7913
2021-05-19;GT;Guatemala;1049;15;243833;7928
2021-05-20;GT;Guatemala;1414;24;245247;7952
2021-05-21;GT;Guatemala;909;25;246156;7977
2021-05-22;GT;Guatemala;950;19;247106;7996
2021-05-23;GT;Guatemala;348;4;247454;8000
2021-05-24;GT;Guatemala;190;9;247644;8009
2021-05-25;GT;Guatemala;1180;13;248824;8022
2021-05-26;GT;Guatemala;1472;36;250296;8058
2021-05-27;GT;Guatemala;1040;12;251336;8070
2021-05-28;GT;Guatemala;1593;24;252929;8094
2021-05-29;GT;Guatemala;908;27;253837;8121
2021-05-30;GT;Guatemala;388;16;254225;8137
2021-05-31;GT;Guatemala;192;28;254417;8165
2021-06-01;GT;Guatemala;1416;18;255833;8183
2021-06-02;GT;Guatemala;1334;31;257167;8214
2021-06-03;GT;Guatemala;1466;24;258633;8238
2021-06-04;GT;Guatemala;1321;20;259954;8258
2021-06-05;GT;Guatemala;1438;22;261392;8280
2021-06-06;GT;Guatemala;566;14;261958;8294
2021-06-07;GT;Guatemala;297;11;262255;8305
2021-06-08;GT;Guatemala;1581;26;263836;8331
2021-06-09;GT;Guatemala;1826;30;265662;8361
2021-06-10;GT;Guatemala;1785;27;267447;8388
2021-06-11;GT;Guatemala;1861;28;269308;8416
2021-06-12;GT;Guatemala;1823;23;271131;8439
2021-06-13;GT;Guatemala;572;16;271703;8455
2021-06-14;GT;Guatemala;287;10;271990;8465
2021-06-15;GT;Guatemala;1740;35;273730;8500
2021-06-16;GT;Guatemala;1472;27;275202;8527
2021-06-17;GT;Guatemala;1725;22;276927;8549
2021-06-18;GT;Guatemala;1482;46;278409;8595
2021-06-19;GT;Guatemala;1538;50;279947;8645
2021-06-20;GT;Guatemala;560;49;280507;8694
2021-06-21;GT;Guatemala;347;41;280854;8735
2021-06-22;GT;Guatemala;1859;50;282713;8785
2021-06-23;GT;Guatemala;2028;60;284741;8845
2021-06-24;GT;Guatemala;1967;49;286708;8894
2021-06-25;GT;Guatemala;2279;66;288987;8960
2021-06-26;GT;Guatemala;1865;48;290852;9008
2021-06-27;GT;Guatemala;743;42;291595;9050
2021-06-28;GT;Guatemala;382;39;291977;9089
2021-06-29;GT;Guatemala;697;58;292674;9147
2021-06-30;GT;Guatemala;909;68;293583;9215
2021-07-01;GT;Guatemala;2855;67;296438;9282
2021-01-24;GG;Guernsey;0;0;0;0
2021-01-25;GG;Guernsey;0;0;0;0
2021-01-26;GG;Guernsey;0;0;0;0
2021-01-27;GG;Guernsey;0;0;0;0
2021-01-28;GG;Guernsey;0;0;0;0
2021-01-29;GG;Guernsey;0;0;0;0
2021-01-30;GG;Guernsey;0;0;0;0
2021-01-31;GG;Guernsey;0;0;0;0
2021-02-01;GG;Guernsey;0;0;0;0
2021-02-02;GG;Guernsey;0;0;0;0
2021-02-03;GG;Guernsey;0;0;0;0
2021-02-04;GG;Guernsey;0;0;0;0
2021-02-05;GG;Guernsey;0;0;0;0
2021-02-06;GG;Guernsey;0;0;0;0
2021-02-07;GG;Guernsey;0;0;0;0
2021-02-08;GG;Guernsey;0;0;0;0
2021-02-09;GG;Guernsey;0;0;0;0
2021-02-10;GG;Guernsey;0;0;0;0
2021-02-11;GG;Guernsey;0;0;0;0
2021-02-12;GG;Guernsey;0;0;0;0
2021-02-13;GG;Guernsey;0;0;0;0
2021-02-14;GG;Guernsey;0;0;0;0
2021-02-15;GG;Guernsey;0;0;0;0
2021-02-16;GG;Guernsey;0;0;0;0
2021-02-17;GG;Guernsey;0;0;0;0
2021-02-18;GG;Guernsey;0;0;0;0
2021-02-19;GG;Guernsey;0;0;0;0
2021-02-20;GG;Guernsey;0;0;0;0
2021-02-21;GG;Guernsey;0;0;0;0
2021-02-22;GG;Guernsey;0;0;0;0
2021-02-23;GG;Guernsey;0;0;0;0
2021-02-24;GG;Guernsey;0;0;0;0
2021-02-25;GG;Guernsey;0;0;0;0
2021-02-26;GG;Guernsey;0;0;0;0
2021-02-27;GG;Guernsey;0;0;0;0
2021-02-28;GG;Guernsey;0;0;0;0
2021-03-01;GG;Guernsey;0;0;0;0
2021-03-02;GG;Guernsey;0;0;0;0
2021-03-03;GG;Guernsey;0;0;0;0
2021-03-04;GG;Guernsey;0;0;0;0
2021-03-05;GG;Guernsey;0;0;0;0
2021-03-06;GG;Guernsey;0;0;0;0
2021-03-07;GG;Guernsey;0;0;0;0
2021-03-08;GG;Guernsey;0;0;0;0
2021-03-09;GG;Guernsey;0;0;0;0
2021-03-10;GG;Guernsey;0;0;0;0
2021-03-11;GG;Guernsey;0;0;0;0
2021-03-12;GG;Guernsey;0;0;0;0
2021-03-13;GG;Guernsey;0;0;0;0
2021-03-14;GG;Guernsey;0;0;0;0
2021-03-15;GG;Guernsey;0;0;0;0
2021-03-16;GG;Guernsey;0;0;0;0
2021-03-17;GG;Guernsey;0;0;0;0
2021-03-18;GG;Guernsey;0;0;0;0
2021-03-19;GG;Guernsey;0;0;0;0
2021-03-20;GG;Guernsey;0;0;0;0
2021-03-21;GG;Guernsey;0;0;0;0
2021-03-22;GG;Guernsey;0;0;0;0
2021-03-23;GG;Guernsey;0;0;0;0
2021-03-24;GG;Guernsey;0;0;0;0
2021-03-25;GG;Guernsey;0;0;0;0
2021-03-26;GG;Guernsey;0;0;0;0
2021-03-27;GG;Guernsey;0;0;0;0
2021-03-28;GG;Guernsey;0;0;0;0
2021-03-29;GG;Guernsey;0;0;0;0
2021-03-30;GG;Guernsey;0;0;0;0
2021-03-31;GG;Guernsey;0;0;0;0
2021-04-01;GG;Guernsey;0;0;0;0
2021-04-02;GG;Guernsey;0;0;0;0
2021-04-03;GG;Guernsey;0;0;0;0
2021-04-04;GG;Guernsey;0;0;0;0
2021-04-05;GG;Guernsey;0;0;0;0
2021-04-06;GG;Guernsey;0;0;0;0
2021-04-07;GG;Guernsey;0;0;0;0
2021-04-08;GG;Guernsey;0;0;0;0
2021-04-09;GG;Guernsey;0;0;0;0
2021-04-10;GG;Guernsey;0;0;0;0
2021-04-11;GG;Guernsey;0;0;0;0
2021-04-12;GG;Guernsey;0;0;0;0
2021-04-13;GG;Guernsey;0;0;0;0
2021-04-14;GG;Guernsey;0;0;0;0
2021-04-15;GG;Guernsey;0;0;0;0
2021-04-16;GG;Guernsey;0;0;0;0
2021-04-17;GG;Guernsey;0;0;0;0
2021-04-18;GG;Guernsey;0;0;0;0
2021-04-19;GG;Guernsey;0;0;0;0
2021-04-20;GG;Guernsey;0;0;0;0
2021-04-21;GG;Guernsey;0;0;0;0
2021-04-22;GG;Guernsey;0;0;0;0
2021-04-23;GG;Guernsey;0;0;0;0
2021-04-24;GG;Guernsey;0;0;0;0
2021-04-25;GG;Guernsey;0;0;0;0
2021-04-26;GG;Guernsey;0;0;0;0
2021-04-27;GG;Guernsey;0;0;0;0
2021-04-28;GG;Guernsey;0;0;0;0
2021-04-29;GG;Guernsey;0;0;0;0
2021-04-30;GG;Guernsey;0;0;0;0
2021-05-01;GG;Guernsey;0;0;0;0
2021-05-02;GG;Guernsey;0;0;0;0
2021-05-03;GG;Guernsey;0;0;0;0
2021-05-04;GG;Guernsey;0;0;0;0
2021-05-05;GG;Guernsey;0;0;0;0
2021-05-06;GG;Guernsey;0;0;0;0
2021-05-07;GG;Guernsey;0;0;0;0
2021-05-08;GG;Guernsey;0;0;0;0
2021-05-09;GG;Guernsey;0;0;0;0
2021-05-10;GG;Guernsey;0;0;0;0
2021-05-11;GG;Guernsey;0;0;0;0
2021-05-12;GG;Guernsey;0;0;0;0
2021-05-13;GG;Guernsey;0;0;0;0
2021-05-14;GG;Guernsey;0;0;0;0
2021-05-15;GG;Guernsey;0;0;0;0
2021-05-16;GG;Guernsey;0;0;0;0
2021-05-17;GG;Guernsey;0;0;0;0
2021-05-18;GG;Guernsey;0;0;0;0
2021-05-19;GG;Guernsey;0;0;0;0
2021-05-20;GG;Guernsey;0;0;0;0
2021-05-21;GG;Guernsey;0;0;0;0
2021-05-22;GG;Guernsey;0;0;0;0
2021-05-23;GG;Guernsey;0;0;0;0
2021-05-24;GG;Guernsey;0;0;0;0
2021-05-25;GG;Guernsey;0;0;0;0
2021-05-26;GG;Guernsey;0;0;0;0
2021-05-27;GG;Guernsey;0;0;0;0
2021-05-28;GG;Guernsey;0;0;0;0
2021-05-29;GG;Guernsey;0;0;0;0
2021-05-30;GG;Guernsey;0;0;0;0
2021-05-31;GG;Guernsey;0;0;0;0
2021-06-01;GG;Guernsey;0;0;0;0
2021-06-02;GG;Guernsey;0;0;0;0
2021-06-03;GG;Guernsey;0;0;0;0
2021-06-04;GG;Guernsey;0;0;0;0
2021-06-05;GG;Guernsey;0;0;0;0
2021-06-06;GG;Guernsey;0;0;0;0
2021-06-07;GG;Guernsey;0;0;0;0
2021-06-08;GG;Guernsey;0;0;0;0
2021-06-09;GG;Guernsey;0;0;0;0
2021-06-10;GG;Guernsey;0;0;0;0
2021-06-11;GG;Guernsey;0;0;0;0
2021-06-12;GG;Guernsey;0;0;0;0
2021-06-13;GG;Guernsey;0;0;0;0
2021-06-14;GG;Guernsey;0;0;0;0
2021-06-15;GG;Guernsey;0;0;0;0
2021-06-16;GG;Guernsey;0;0;0;0
2021-06-17;GG;Guernsey;0;0;0;0
2021-06-18;GG;Guernsey;0;0;0;0
2021-06-19;GG;Guernsey;0;0;0;0
2021-06-20;GG;Guernsey;0;0;0;0
2021-06-21;GG;Guernsey;0;0;0;0
2021-06-22;GG;Guernsey;0;0;0;0
2021-06-23;GG;Guernsey;0;0;0;0
2021-06-24;GG;Guernsey;0;0;0;0
2021-06-25;GG;Guernsey;0;0;0;0
2021-06-26;GG;Guernsey;0;0;0;0
2021-06-27;GG;Guernsey;0;0;0;0
2021-06-28;GG;Guernsey;0;0;0;0
2021-06-29;GG;Guernsey;0;0;0;0
2021-06-30;GG;Guernsey;0;0;0;0
2021-07-01;GG;Guernsey;0;0;0;0
2020-03-13;GN;Guinea;1;0;1;0
2020-03-14;GN;Guinea;0;0;1;0
2020-03-15;GN;Guinea;0;0;1;0
2020-03-16;GN;Guinea;0;0;1;0
2020-03-17;GN;Guinea;0;0;1;0
2020-03-18;GN;Guinea;0;0;1;0
2020-03-19;GN;Guinea;0;0;1;0
2020-03-20;GN;Guinea;0;0;1;0
2020-03-21;GN;Guinea;1;0;2;0
2020-03-22;GN;Guinea;0;0;2;0
2020-03-23;GN;Guinea;2;0;4;0
2020-03-24;GN;Guinea;0;0;4;0
2020-03-25;GN;Guinea;0;0;4;0
2020-03-26;GN;Guinea;0;0;4;0
2020-03-27;GN;Guinea;4;0;8;0
2020-03-28;GN;Guinea;0;0;8;0
2020-03-29;GN;Guinea;8;0;16;0
2020-03-30;GN;Guinea;6;0;22;0
2020-03-31;GN;Guinea;0;0;22;0
2020-04-01;GN;Guinea;8;0;30;0
2020-04-02;GN;Guinea;22;0;52;0
2020-04-03;GN;Guinea;21;0;73;0
2020-04-04;GN;Guinea;38;0;111;0
2020-04-05;GN;Guinea;10;0;121;0
2020-04-06;GN;Guinea;7;0;128;0
2020-04-07;GN;Guinea;16;0;144;0
2020-04-08;GN;Guinea;20;0;164;0
2020-04-09;GN;Guinea;30;0;194;0
2020-04-10;GN;Guinea;18;0;212;0
2020-04-11;GN;Guinea;38;0;250;0
2020-04-12;GN;Guinea;0;0;250;0
2020-04-13;GN;Guinea;69;0;319;0
2020-04-14;GN;Guinea;44;0;363;0
2020-04-15;GN;Guinea;41;1;404;1
2020-04-16;GN;Guinea;34;0;438;1
2020-04-17;GN;Guinea;39;2;477;3
2020-04-18;GN;Guinea;41;0;518;3
2020-04-19;GN;Guinea;61;2;579;5
2020-04-20;GN;Guinea;43;0;622;5
2020-04-21;GN;Guinea;66;1;688;6
2020-04-22;GN;Guinea;73;0;761;6
2020-04-23;GN;Guinea;101;0;862;6
2020-04-24;GN;Guinea;92;0;954;6
2020-04-25;GN;Guinea;42;1;996;7
2020-04-26;GN;Guinea;0;0;996;7
2020-04-27;GN;Guinea;167;0;1163;7
2020-04-28;GN;Guinea;77;0;1240;7
2020-04-29;GN;Guinea;111;0;1351;7
2020-04-30;GN;Guinea;144;0;1495;7
2020-05-01;GN;Guinea;42;0;1537;7
2020-05-02;GN;Guinea;49;0;1586;7
2020-05-03;GN;Guinea;0;0;1586;7
2020-05-04;GN;Guinea;124;2;1710;9
2020-05-05;GN;Guinea;101;1;1811;10
2020-05-06;GN;Guinea;45;1;1856;11
2020-05-07;GN;Guinea;71;0;1927;11
2020-05-08;GN;Guinea;82;0;2009;11
2020-05-09;GN;Guinea;33;0;2042;11
2020-05-10;GN;Guinea;104;0;2146;11
2020-05-11;GN;Guinea;0;0;2146;11
2020-05-12;GN;Guinea;152;0;2298;11
2020-05-13;GN;Guinea;76;3;2374;14
2020-05-14;GN;Guinea;99;1;2473;15
2020-05-15;GN;Guinea;0;0;2473;15
2020-05-16;GN;Guinea;185;1;2658;16
2020-05-17;GN;Guinea;0;0;2658;16
2020-05-18;GN;Guinea;138;0;2796;16
2020-05-19;GN;Guinea;67;2;2863;18
2020-05-20;GN;Guinea;0;0;2863;18
2020-05-21;GN;Guinea;204;0;3067;18
2020-05-22;GN;Guinea;0;1;3067;19
2020-05-23;GN;Guinea;109;1;3176;20
2020-05-24;GN;Guinea;99;0;3275;20
2020-05-25;GN;Guinea;0;0;3275;20
2020-05-26;GN;Guinea;0;0;3275;20
2020-05-27;GN;Guinea;0;0;3275;20
2020-05-28;GN;Guinea;278;2;3553;22
2020-05-29;GN;Guinea;103;0;3656;22
2020-05-30;GN;Guinea;50;1;3706;23
2020-05-31;GN;Guinea;0;0;3706;23
2020-06-01;GN;Guinea;138;0;3844;23
2020-06-02;GN;Guinea;42;0;3886;23
2020-06-03;GN;Guinea;47;0;3933;23
2020-06-04;GN;Guinea;58;0;3991;23
2020-06-05;GN;Guinea;69;0;4060;23
2020-06-06;GN;Guinea;57;0;4117;23
2020-06-07;GN;Guinea;0;0;4117;23
2020-06-08;GN;Guinea;99;0;4216;23
2020-06-09;GN;Guinea;42;0;4258;23
2020-06-10;GN;Guinea;0;0;4258;23
2020-06-11;GN;Guinea;114;0;4372;23
2020-06-12;GN;Guinea;54;1;4426;24
2020-06-13;GN;Guinea;58;1;4484;25
2020-06-14;GN;Guinea;48;0;4532;25
2020-06-15;GN;Guinea;40;1;4572;26
2020-06-16;GN;Guinea;67;0;4639;26
2020-06-17;GN;Guinea;29;0;4668;26
2020-06-18;GN;Guinea;173;0;4841;26
2020-06-19;GN;Guinea;63;1;4904;27
2020-06-20;GN;Guinea;56;0;4960;27
2020-06-21;GN;Guinea;28;0;4988;27
2020-06-22;GN;Guinea;0;0;4988;27
2020-06-23;GN;Guinea;52;1;5040;28
2020-06-24;GN;Guinea;134;1;5174;29
2020-06-25;GN;Guinea;0;0;5174;29
2020-06-26;GN;Guinea;86;0;5260;29
2020-06-27;GN;Guinea;31;1;5291;30
2020-06-28;GN;Guinea;51;1;5342;31
2020-06-29;GN;Guinea;9;0;5351;31
2020-06-30;GN;Guinea;40;2;5391;33
2020-07-01;GN;Guinea;13;0;5404;33
2020-07-02;GN;Guinea;46;0;5450;33
2020-07-03;GN;Guinea;71;0;5521;33
2020-07-04;GN;Guinea;49;1;5570;34
2020-07-05;GN;Guinea;40;0;5610;34
2020-07-06;GN;Guinea;0;0;5610;34
2020-07-07;GN;Guinea;26;0;5636;34
2020-07-08;GN;Guinea;61;0;5697;34
2020-07-09;GN;Guinea;184;2;5881;36
2020-07-10;GN;Guinea;88;1;5969;37
2020-07-11;GN;Guinea;75;0;6044;37
2020-07-12;GN;Guinea;97;0;6141;37
2020-07-13;GN;Guinea;0;0;6141;37
2020-07-14;GN;Guinea;59;1;6200;38
2020-07-15;GN;Guinea;76;0;6276;38
2020-07-16;GN;Guinea;83;1;6359;39
2020-07-17;GN;Guinea;71;0;6430;39
2020-07-18;GN;Guinea;61;0;6491;39
2020-07-19;GN;Guinea;53;0;6544;39
2020-07-20;GN;Guinea;46;1;6590;40
2020-07-21;GN;Guinea;62;1;6652;41
2020-07-22;GN;Guinea;95;0;6747;41
2020-07-23;GN;Guinea;59;1;6806;42
2020-07-24;GN;Guinea;61;0;6867;42
2020-07-25;GN;Guinea;60;0;6927;42
2020-07-26;GN;Guinea;81;1;7008;43
2020-07-27;GN;Guinea;47;2;7055;45
2020-07-28;GN;Guinea;71;1;7126;46
2020-07-29;GN;Guinea;57;0;7183;46
2020-07-30;GN;Guinea;59;0;7242;46
2020-07-31;GN;Guinea;66;0;7308;46
2020-08-01;GN;Guinea;0;0;7308;46
2020-08-02;GN;Guinea;9;0;7317;46
2020-08-03;GN;Guinea;47;0;7364;46
2020-08-04;GN;Guinea;125;2;7489;48
2020-08-05;GN;Guinea;86;1;7575;49
2020-08-06;GN;Guinea;89;0;7664;49
2020-08-07;GN;Guinea;113;1;7777;50
2020-08-08;GN;Guinea;98;0;7875;50
2020-08-09;GN;Guinea;55;0;7930;50
2020-08-10;GN;Guinea;0;0;7930;50
2020-08-11;GN;Guinea;88;0;8018;50
2020-08-12;GN;Guinea;98;0;8116;50
2020-08-13;GN;Guinea;82;0;8198;50
2020-08-14;GN;Guinea;62;0;8260;50
2020-08-15;GN;Guinea;83;0;8343;50
2020-08-16;GN;Guinea;139;1;8482;51
2020-08-17;GN;Guinea;138;0;8620;51
2020-08-18;GN;Guinea;95;1;8715;52
2020-08-19;GN;Guinea;77;1;8792;53
2020-08-20;GN;Guinea;84;0;8876;53
2020-08-21;GN;Guinea;56;0;8932;53
2020-08-22;GN;Guinea;0;0;8932;53
2020-08-23;GN;Guinea;35;0;8967;53
2020-08-24;GN;Guinea;109;2;9076;55
2020-08-25;GN;Guinea;52;2;9128;57
2020-08-26;GN;Guinea;39;0;9167;57
2020-08-27;GN;Guinea;46;1;9213;58
2020-08-28;GN;Guinea;38;1;9251;59
2020-08-29;GN;Guinea;0;0;9251;59
2020-08-30;GN;Guinea;120;0;9371;59
2020-08-31;GN;Guinea;38;0;9409;59
2020-09-01;GN;Guinea;70;0;9479;59
2020-09-02;GN;Guinea;0;0;9479;59
2020-09-03;GN;Guinea;100;2;9579;61
2020-09-04;GN;Guinea;70;0;9649;61
2020-09-05;GN;Guinea;0;0;9649;61
2020-09-06;GN;Guinea;149;0;9798;61
2020-09-07;GN;Guinea;18;1;9816;62
2020-09-08;GN;Guinea;32;1;9848;63
2020-09-09;GN;Guinea;37;0;9885;63
2020-09-10;GN;Guinea;61;0;9946;63
2020-09-11;GN;Guinea;33;0;9979;63
2020-09-12;GN;Guinea;41;0;10020;63
2020-09-13;GN;Guinea;25;0;10045;63
2020-09-14;GN;Guinea;16;0;10061;63
2020-09-15;GN;Guinea;50;0;10111;63
2020-09-16;GN;Guinea;43;0;10154;63
2020-09-17;GN;Guinea;0;0;10154;63
2020-09-18;GN;Guinea;77;0;10231;63
2020-09-19;GN;Guinea;55;0;10286;63
2020-09-20;GN;Guinea;39;1;10325;64
2020-09-21;GN;Guinea;19;1;10344;65
2020-09-22;GN;Guinea;43;0;10387;65
2020-09-23;GN;Guinea;47;0;10434;65
2020-09-24;GN;Guinea;0;0;10434;65
2020-09-25;GN;Guinea;44;0;10478;65
2020-09-26;GN;Guinea;34;0;10512;65
2020-09-27;GN;Guinea;68;1;10580;66
2020-09-28;GN;Guinea;18;0;10598;66
2020-09-29;GN;Guinea;36;0;10634;66
2020-09-30;GN;Guinea;18;0;10652;66
2020-10-01;GN;Guinea;0;0;10652;66
2020-10-02;GN;Guinea;83;0;10735;66
2020-10-03;GN;Guinea;0;0;10735;66
2020-10-04;GN;Guinea;19;0;10754;66
2020-10-05;GN;Guinea;46;1;10800;67
2020-10-06;GN;Guinea;63;1;10863;68
2020-10-07;GN;Guinea;0;0;10863;68
2020-10-08;GN;Guinea;38;0;10901;68
2020-10-09;GN;Guinea;53;0;10954;68
2020-10-10;GN;Guinea;42;1;10996;69
2020-10-11;GN;Guinea;26;0;11022;69
2020-10-12;GN;Guinea;40;1;11062;70
2020-10-13;GN;Guinea;72;0;11134;70
2020-10-14;GN;Guinea;54;0;11188;70
2020-10-15;GN;Guinea;67;0;11255;70
2020-10-16;GN;Guinea;107;0;11362;70
2020-10-17;GN;Guinea;116;0;11478;70
2020-10-18;GN;Guinea;40;0;11518;70
2020-10-19;GN;Guinea;0;0;11518;70
2020-10-20;GN;Guinea;20;0;11538;70
2020-10-21;GN;Guinea;61;0;11599;70
2020-10-22;GN;Guinea;36;1;11635;71
2020-10-23;GN;Guinea;0;0;11635;71
2020-10-24;GN;Guinea;0;0;11635;71
2020-10-25;GN;Guinea;0;0;11635;71
2020-10-26;GN;Guinea;0;0;11635;71
2020-10-27;GN;Guinea;184;0;11819;71
2020-10-28;GN;Guinea;0;0;11819;71
2020-10-29;GN;Guinea;201;0;12020;71
2020-10-30;GN;Guinea;52;1;12072;72
2020-10-31;GN;Guinea;0;0;12072;72
2020-11-01;GN;Guinea;123;1;12195;73
2020-11-02;GN;Guinea;18;0;12213;73
2020-11-03;GN;Guinea;0;0;12213;73
2020-11-04;GN;Guinea;118;0;12331;73
2020-11-05;GN;Guinea;32;0;12363;73
2020-11-06;GN;Guinea;0;0;12363;73
2020-11-07;GN;Guinea;37;0;12400;73
2020-11-08;GN;Guinea;14;1;12414;74
2020-11-09;GN;Guinea;45;0;12459;74
2020-11-10;GN;Guinea;25;0;12484;74
2020-11-11;GN;Guinea;32;0;12516;74
2020-11-12;GN;Guinea;21;0;12537;74
2020-11-13;GN;Guinea;0;0;12537;74
2020-11-14;GN;Guinea;48;0;12585;74
2020-11-15;GN;Guinea;26;1;12611;75
2020-11-16;GN;Guinea;13;0;12624;75
2020-11-17;GN;Guinea;30;0;12654;75
2020-11-18;GN;Guinea;59;0;12713;75
2020-11-19;GN;Guinea;0;0;12713;75
2020-11-20;GN;Guinea;30;0;12743;75
2020-11-21;GN;Guinea;55;0;12798;75
2020-11-22;GN;Guinea;28;0;12826;75
2020-11-23;GN;Guinea;15;0;12841;75
2020-11-24;GN;Guinea;22;0;12863;75
2020-11-25;GN;Guinea;66;1;12929;76
2020-11-26;GN;Guinea;20;0;12949;76
2020-11-27;GN;Guinea;90;0;13039;76
2020-11-28;GN;Guinea;0;0;13039;76
2020-11-29;GN;Guinea;0;0;13039;76
2020-11-30;GN;Guinea;80;0;13119;76
2020-12-01;GN;Guinea;0;0;13119;76
2020-12-02;GN;Guinea;24;0;13143;76
2020-12-03;GN;Guinea;24;0;13167;76
2020-12-04;GN;Guinea;19;0;13186;76
2020-12-05;GN;Guinea;47;0;13233;76
2020-12-06;GN;Guinea;0;0;13233;76
2020-12-07;GN;Guinea;31;3;13264;79
2020-12-08;GN;Guinea;0;0;13264;79
2020-12-09;GN;Guinea;61;0;13325;79
2020-12-10;GN;Guinea;43;0;13368;79
2020-12-11;GN;Guinea;30;0;13398;79
2020-12-12;GN;Guinea;22;0;13420;79
2020-12-13;GN;Guinea;0;0;13420;79
2020-12-14;GN;Guinea;37;1;13457;80
2020-12-15;GN;Guinea;0;0;13457;80
2020-12-16;GN;Guinea;17;0;13474;80
2020-12-17;GN;Guinea;11;0;13485;80
2020-12-18;GN;Guinea;26;0;13511;80
2020-12-19;GN;Guinea;21;0;13532;80
2020-12-20;GN;Guinea;13;0;13545;80
2020-12-21;GN;Guinea;33;0;13578;80
2020-12-22;GN;Guinea;0;0;13578;80
2020-12-23;GN;Guinea;20;0;13598;80
2020-12-24;GN;Guinea;32;0;13630;80
2020-12-25;GN;Guinea;16;0;13646;80
2020-12-26;GN;Guinea;0;0;13646;80
2020-12-27;GN;Guinea;28;0;13674;80
2020-12-28;GN;Guinea;14;0;13688;80
2020-12-29;GN;Guinea;0;0;13688;80
2020-12-30;GN;Guinea;19;0;13707;80
2020-12-31;GN;Guinea;15;1;13722;81
2021-01-01;GN;Guinea;16;0;13738;81
2021-01-02;GN;Guinea;46;0;13784;81
2021-01-03;GN;Guinea;0;0;13784;81
2021-01-04;GN;Guinea;15;0;13799;81
2021-01-05;GN;Guinea;46;0;13845;81
2021-01-06;GN;Guinea;0;0;13845;81
2021-01-07;GN;Guinea;59;0;13904;81
2021-01-08;GN;Guinea;0;0;13904;81
2021-01-09;GN;Guinea;38;0;13942;81
2021-01-10;GN;Guinea;0;0;13942;81
2021-01-11;GN;Guinea;38;0;13980;81
2021-01-12;GN;Guinea;45;0;14025;81
2021-01-13;GN;Guinea;26;0;14051;81
2021-01-14;GN;Guinea;0;0;14051;81
2021-01-15;GN;Guinea;14;0;14065;81
2021-01-16;GN;Guinea;33;0;14098;81
2021-01-17;GN;Guinea;16;0;14114;81
2021-01-18;GN;Guinea;51;0;14165;81
2021-01-19;GN;Guinea;42;0;14207;81
2021-01-20;GN;Guinea;0;0;14207;81
2021-01-21;GN;Guinea;29;0;14236;81
2021-01-22;GN;Guinea;26;0;14262;81
2021-01-23;GN;Guinea;38;0;14300;81
2021-01-24;GN;Guinea;19;0;14319;81
2021-01-25;GN;Guinea;56;0;14375;81
2021-01-26;GN;Guinea;4;1;14379;82
2021-01-27;GN;Guinea;56;0;14435;82
2021-01-28;GN;Guinea;0;0;14435;82
2021-01-29;GN;Guinea;16;0;14451;82
2021-01-30;GN;Guinea;24;0;14475;82
2021-01-31;GN;Guinea;71;0;14546;82
2021-02-01;GN;Guinea;9;1;14555;83
2021-02-02;GN;Guinea;0;0;14555;83
2021-02-03;GN;Guinea;0;0;14555;83
2021-02-04;GN;Guinea;74;1;14629;84
2021-02-05;GN;Guinea;0;0;14629;84
2021-02-06;GN;Guinea;36;0;14665;84
2021-02-07;GN;Guinea;22;0;14687;84
2021-02-08;GN;Guinea;77;0;14764;84
2021-02-09;GN;Guinea;27;0;14791;84
2021-02-10;GN;Guinea;0;0;14791;84
2021-02-11;GN;Guinea;69;0;14860;84
2021-02-12;GN;Guinea;0;0;14860;84
2021-02-13;GN;Guinea;35;0;14895;84
2021-02-14;GN;Guinea;72;1;14967;85
2021-02-15;GN;Guinea;0;0;14967;85
2021-02-16;GN;Guinea;53;0;15020;85
2021-02-17;GN;Guinea;68;0;15088;85
2021-02-18;GN;Guinea;66;0;15154;85
2021-02-19;GN;Guinea;62;1;15216;86
2021-02-20;GN;Guinea;179;0;15395;86
2021-02-21;GN;Guinea;0;0;15395;86
2021-02-22;GN;Guinea;32;0;15427;86
2021-02-23;GN;Guinea;60;1;15487;87
2021-02-24;GN;Guinea;193;1;15680;88
2021-02-25;GN;Guinea;109;0;15789;88
2021-02-26;GN;Guinea;105;1;15894;89
2021-02-27;GN;Guinea;0;0;15894;89
2021-02-28;GN;Guinea;98;0;15992;89
2021-03-01;GN;Guinea;13;0;16005;89
2021-03-02;GN;Guinea;76;2;16081;91
2021-03-03;GN;Guinea;210;1;16291;92
2021-03-04;GN;Guinea;129;1;16420;93
2021-03-05;GN;Guinea;0;0;16420;93
2021-03-06;GN;Guinea;120;0;16540;93
2021-03-07;GN;Guinea;130;2;16670;95
2021-03-08;GN;Guinea;242;2;16912;97
2021-03-09;GN;Guinea;0;0;16912;97
2021-03-10;GN;Guinea;296;4;17208;101
2021-03-11;GN;Guinea;164;0;17372;101
2021-03-12;GN;Guinea;220;1;17592;102
2021-03-13;GN;Guinea;0;0;17592;102
2021-03-14;GN;Guinea;150;0;17742;102
2021-03-15;GN;Guinea;109;1;17851;103
2021-03-16;GN;Guinea;131;1;17982;104
2021-03-17;GN;Guinea;303;2;18285;106
2021-03-18;GN;Guinea;0;0;18285;106
2021-03-19;GN;Guinea;277;2;18562;108
2021-03-20;GN;Guinea;0;0;18562;108
2021-03-21;GN;Guinea;315;3;18877;111
2021-03-22;GN;Guinea;68;2;18945;113
2021-03-23;GN;Guinea;0;0;18945;113
2021-03-24;GN;Guinea;139;0;19084;113
2021-03-25;GN;Guinea;148;0;19232;113
2021-03-26;GN;Guinea;171;3;19403;116
2021-03-27;GN;Guinea;98;0;19501;116
2021-03-28;GN;Guinea;169;4;19670;120
2021-03-29;GN;Guinea;103;3;19773;123
2021-03-30;GN;Guinea;20;2;19793;125
2021-03-31;GN;Guinea;115;0;19908;125
2021-04-01;GN;Guinea;175;2;20083;127
2021-04-02;GN;Guinea;145;1;20228;128
2021-04-03;GN;Guinea;91;1;20319;129
2021-04-04;GN;Guinea;86;1;20405;130
2021-04-05;GN;Guinea;101;0;20506;130
2021-04-06;GN;Guinea;4;0;20510;130
2021-04-07;GN;Guinea;44;1;20554;131
2021-04-08;GN;Guinea;0;0;20554;131
2021-04-09;GN;Guinea;192;1;20746;132
2021-04-10;GN;Guinea;61;1;20807;133
2021-04-11;GN;Guinea;142;1;20949;134
2021-04-12;GN;Guinea;83;2;21032;136
2021-04-13;GN;Guinea;74;0;21106;136
2021-04-14;GN;Guinea;193;0;21299;136
2021-04-15;GN;Guinea;0;0;21299;136
2021-04-16;GN;Guinea;93;2;21392;138
2021-04-17;GN;Guinea;68;0;21460;138
2021-04-18;GN;Guinea;0;0;21460;138
2021-04-19;GN;Guinea;152;0;21612;138
2021-04-20;GN;Guinea;21;1;21633;139
2021-04-21;GN;Guinea;33;0;21666;139
2021-04-22;GN;Guinea;79;0;21745;139
2021-04-23;GN;Guinea;58;0;21803;139
2021-04-24;GN;Guinea;82;1;21885;140
2021-04-25;GN;Guinea;68;0;21953;140
2021-04-26;GN;Guinea;32;1;21985;141
2021-04-27;GN;Guinea;61;0;22046;141
2021-04-28;GN;Guinea;41;0;22087;141
2021-04-29;GN;Guinea;128;3;22215;144
2021-04-30;GN;Guinea;0;0;22215;144
2021-05-01;GN;Guinea;32;0;22247;144
2021-05-02;GN;Guinea;57;1;22304;145
2021-05-03;GN;Guinea;29;1;22333;146
2021-05-04;GN;Guinea;35;0;22368;146
2021-05-05;GN;Guinea;100;2;22468;148
2021-05-06;GN;Guinea;37;0;22505;148
2021-05-07;GN;Guinea;48;1;22553;149
2021-05-08;GN;Guinea;49;1;22602;150
2021-05-09;GN;Guinea;31;0;22633;150
2021-05-10;GN;Guinea;0;0;22633;150
2021-05-11;GN;Guinea;86;1;22719;151
2021-05-12;GN;Guinea;0;0;22719;151
2021-05-13;GN;Guinea;0;0;22719;151
2021-05-14;GN;Guinea;27;0;22746;151
2021-05-15;GN;Guinea;0;0;22746;151
2021-05-16;GN;Guinea;0;0;22746;151
2021-05-17;GN;Guinea;84;1;22830;152
2021-05-18;GN;Guinea;23;1;22853;153
2021-05-19;GN;Guinea;26;0;22879;153
2021-05-20;GN;Guinea;84;2;22963;155
2021-05-21;GN;Guinea;0;0;22963;155
2021-05-22;GN;Guinea;25;3;22988;158
2021-05-23;GN;Guinea;0;0;22988;158
2021-05-24;GN;Guinea;64;1;23052;159
2021-05-25;GN;Guinea;8;1;23060;160
2021-05-26;GN;Guinea;20;0;23080;160
2021-05-27;GN;Guinea;30;1;23110;161
2021-05-28;GN;Guinea;0;0;23110;161
2021-05-29;GN;Guinea;62;0;23172;161
2021-05-30;GN;Guinea;0;0;23172;161
2021-05-31;GN;Guinea;5;0;23177;161
2021-06-01;GN;Guinea;17;1;23194;162
2021-06-02;GN;Guinea;0;0;23194;162
2021-06-03;GN;Guinea;51;0;23245;162
2021-06-04;GN;Guinea;10;0;23255;162
2021-06-05;GN;Guinea;0;0;23255;162
2021-06-06;GN;Guinea;0;0;23255;162
2021-06-07;GN;Guinea;52;0;23307;162
2021-06-08;GN;Guinea;5;2;23312;164
2021-06-09;GN;Guinea;22;1;23334;165
2021-06-10;GN;Guinea;18;2;23352;167
2021-06-11;GN;Guinea;14;0;23366;167
2021-06-12;GN;Guinea;23;0;23389;167
2021-06-13;GN;Guinea;9;0;23398;167
2021-06-14;GN;Guinea;0;0;23398;167
2021-06-15;GN;Guinea;0;0;23398;167
2021-06-16;GN;Guinea;0;0;23398;167
2021-06-17;GN;Guinea;33;0;23431;167
2021-06-18;GN;Guinea;19;0;23450;167
2021-06-19;GN;Guinea;0;1;23450;168
2021-06-20;GN;Guinea;0;0;23450;168
2021-06-21;GN;Guinea;85;0;23535;168
2021-06-22;GN;Guinea;8;0;23543;168
2021-06-23;GN;Guinea;36;0;23579;168
2021-06-24;GN;Guinea;36;0;23615;168
2021-06-25;GN;Guinea;38;0;23653;168
2021-06-26;GN;Guinea;39;0;23692;168
2021-06-27;GN;Guinea;0;0;23692;168
2021-06-28;GN;Guinea;52;0;23744;168
2021-06-29;GN;Guinea;9;1;23753;169
2021-06-30;GN;Guinea;17;2;23770;171
2021-07-01;GN;Guinea;17;1;23787;172
2020-03-25;GW;Guinea-Bissau;2;0;2;0
2020-03-26;GW;Guinea-Bissau;0;0;2;0
2020-03-27;GW;Guinea-Bissau;0;0;2;0
2020-03-28;GW;Guinea-Bissau;0;0;2;0
2020-03-29;GW;Guinea-Bissau;0;0;2;0
2020-03-30;GW;Guinea-Bissau;6;0;8;0
2020-03-31;GW;Guinea-Bissau;0;0;8;0
2020-04-01;GW;Guinea-Bissau;1;0;9;0
2020-04-02;GW;Guinea-Bissau;0;0;9;0
2020-04-03;GW;Guinea-Bissau;6;0;15;0
2020-04-04;GW;Guinea-Bissau;3;0;18;0
2020-04-05;GW;Guinea-Bissau;0;0;18;0
2020-04-06;GW;Guinea-Bissau;0;0;18;0
2020-04-07;GW;Guinea-Bissau;15;0;33;0
2020-04-08;GW;Guinea-Bissau;0;0;33;0
2020-04-09;GW;Guinea-Bissau;3;0;36;0
2020-04-10;GW;Guinea-Bissau;0;0;36;0
2020-04-11;GW;Guinea-Bissau;2;0;38;0
2020-04-12;GW;Guinea-Bissau;0;0;38;0
2020-04-13;GW;Guinea-Bissau;0;0;38;0
2020-04-14;GW;Guinea-Bissau;0;0;38;0
2020-04-15;GW;Guinea-Bissau;5;0;43;0
2020-04-16;GW;Guinea-Bissau;0;0;43;0
2020-04-17;GW;Guinea-Bissau;0;0;43;0
2020-04-18;GW;Guinea-Bissau;3;0;46;0
2020-04-19;GW;Guinea-Bissau;4;0;50;0
2020-04-20;GW;Guinea-Bissau;0;0;50;0
2020-04-21;GW;Guinea-Bissau;0;0;50;0
2020-04-22;GW;Guinea-Bissau;0;0;50;0
2020-04-23;GW;Guinea-Bissau;0;0;50;0
2020-04-24;GW;Guinea-Bissau;2;0;52;0
2020-04-25;GW;Guinea-Bissau;0;0;52;0
2020-04-26;GW;Guinea-Bissau;1;1;53;1
2020-04-27;GW;Guinea-Bissau;20;0;73;1
2020-04-28;GW;Guinea-Bissau;0;0;73;1
2020-04-29;GW;Guinea-Bissau;132;0;205;1
2020-04-30;GW;Guinea-Bissau;0;0;205;1
2020-05-01;GW;Guinea-Bissau;52;0;257;1
2020-05-02;GW;Guinea-Bissau;0;0;257;1
2020-05-03;GW;Guinea-Bissau;0;0;257;1
2020-05-04;GW;Guinea-Bissau;156;0;413;1
2020-05-05;GW;Guinea-Bissau;0;0;413;1
2020-05-06;GW;Guinea-Bissau;62;1;475;2
2020-05-07;GW;Guinea-Bissau;89;0;564;2
2020-05-08;GW;Guinea-Bissau;30;0;594;2
2020-05-09;GW;Guinea-Bissau;47;1;641;3
2020-05-10;GW;Guinea-Bissau;85;0;726;3
2020-05-11;GW;Guinea-Bissau;35;0;761;3
2020-05-12;GW;Guinea-Bissau;59;0;820;3
2020-05-13;GW;Guinea-Bissau;16;0;836;3
2020-05-14;GW;Guinea-Bissau;77;0;913;3
2020-05-15;GW;Guinea-Bissau;0;0;913;3
2020-05-16;GW;Guinea-Bissau;56;1;969;4
2020-05-17;GW;Guinea-Bissau;21;0;990;4
2020-05-18;GW;Guinea-Bissau;42;0;1032;4
2020-05-19;GW;Guinea-Bissau;6;2;1038;6
2020-05-20;GW;Guinea-Bissau;51;0;1089;6
2020-05-21;GW;Guinea-Bissau;20;0;1109;6
2020-05-22;GW;Guinea-Bissau;5;0;1114;6
2020-05-23;GW;Guinea-Bissau;0;0;1114;6
2020-05-24;GW;Guinea-Bissau;0;0;1114;6
2020-05-25;GW;Guinea-Bissau;64;1;1178;7
2020-05-26;GW;Guinea-Bissau;0;0;1178;7
2020-05-27;GW;Guinea-Bissau;17;0;1195;7
2020-05-28;GW;Guinea-Bissau;0;1;1195;8
2020-05-29;GW;Guinea-Bissau;61;0;1256;8
2020-05-30;GW;Guinea-Bissau;0;0;1256;8
2020-05-31;GW;Guinea-Bissau;0;0;1256;8
2020-06-01;GW;Guinea-Bissau;83;0;1339;8
2020-06-02;GW;Guinea-Bissau;0;0;1339;8
2020-06-03;GW;Guinea-Bissau;0;0;1339;8
2020-06-04;GW;Guinea-Bissau;0;0;1339;8
2020-06-05;GW;Guinea-Bissau;29;4;1368;12
2020-06-06;GW;Guinea-Bissau;0;0;1368;12
2020-06-07;GW;Guinea-Bissau;0;0;1368;12
2020-06-08;GW;Guinea-Bissau;21;0;1389;12
2020-06-09;GW;Guinea-Bissau;0;0;1389;12
2020-06-10;GW;Guinea-Bissau;0;0;1389;12
2020-06-11;GW;Guinea-Bissau;0;0;1389;12
2020-06-12;GW;Guinea-Bissau;71;3;1460;15
2020-06-13;GW;Guinea-Bissau;0;0;1460;15
2020-06-14;GW;Guinea-Bissau;0;0;1460;15
2020-06-15;GW;Guinea-Bissau;32;0;1492;15
2020-06-16;GW;Guinea-Bissau;0;0;1492;15
2020-06-17;GW;Guinea-Bissau;0;0;1492;15
2020-06-18;GW;Guinea-Bissau;0;0;1492;15
2020-06-19;GW;Guinea-Bissau;49;2;1541;17
2020-06-20;GW;Guinea-Bissau;0;0;1541;17
2020-06-21;GW;Guinea-Bissau;0;0;1541;17
2020-06-22;GW;Guinea-Bissau;15;2;1556;19
2020-06-23;GW;Guinea-Bissau;0;0;1556;19
2020-06-24;GW;Guinea-Bissau;0;0;1556;19
2020-06-25;GW;Guinea-Bissau;0;0;1556;19
2020-06-26;GW;Guinea-Bissau;58;3;1614;22
2020-06-27;GW;Guinea-Bissau;0;0;1614;22
2020-06-28;GW;Guinea-Bissau;0;0;1614;22
2020-06-29;GW;Guinea-Bissau;40;2;1654;24
2020-06-30;GW;Guinea-Bissau;0;0;1654;24
2020-07-01;GW;Guinea-Bissau;0;0;1654;24
2020-07-02;GW;Guinea-Bissau;0;0;1654;24
2020-07-03;GW;Guinea-Bissau;111;1;1765;25
2020-07-04;GW;Guinea-Bissau;0;0;1765;25
2020-07-05;GW;Guinea-Bissau;0;0;1765;25
2020-07-06;GW;Guinea-Bissau;25;0;1790;25
2020-07-07;GW;Guinea-Bissau;0;0;1790;25
2020-07-08;GW;Guinea-Bissau;0;0;1790;25
2020-07-09;GW;Guinea-Bissau;0;0;1790;25
2020-07-10;GW;Guinea-Bissau;52;1;1842;26
2020-07-11;GW;Guinea-Bissau;0;0;1842;26
2020-07-12;GW;Guinea-Bissau;0;0;1842;26
2020-07-13;GW;Guinea-Bissau;0;0;1842;26
2020-07-14;GW;Guinea-Bissau;0;0;1842;26
2020-07-15;GW;Guinea-Bissau;0;0;1842;26
2020-07-16;GW;Guinea-Bissau;60;0;1902;26
2020-07-17;GW;Guinea-Bissau;25;0;1927;26
2020-07-18;GW;Guinea-Bissau;22;0;1949;26
2020-07-19;GW;Guinea-Bissau;0;0;1949;26
2020-07-20;GW;Guinea-Bissau;0;0;1949;26
2020-07-21;GW;Guinea-Bissau;5;0;1954;26
2020-07-22;GW;Guinea-Bissau;0;0;1954;26
2020-07-23;GW;Guinea-Bissau;0;0;1954;26
2020-07-24;GW;Guinea-Bissau;0;0;1954;26
2020-07-25;GW;Guinea-Bissau;0;0;1954;26
2020-07-26;GW;Guinea-Bissau;0;0;1954;26
2020-07-27;GW;Guinea-Bissau;0;0;1954;26
2020-07-28;GW;Guinea-Bissau;0;0;1954;26
2020-07-29;GW;Guinea-Bissau;0;0;1954;26
2020-07-30;GW;Guinea-Bissau;27;0;1981;26
2020-07-31;GW;Guinea-Bissau;0;0;1981;26
2020-08-01;GW;Guinea-Bissau;0;1;1981;27
2020-08-02;GW;Guinea-Bissau;0;0;1981;27
2020-08-03;GW;Guinea-Bissau;0;0;1981;27
2020-08-04;GW;Guinea-Bissau;0;0;1981;27
2020-08-05;GW;Guinea-Bissau;51;0;2032;27
2020-08-06;GW;Guinea-Bissau;0;0;2032;27
2020-08-07;GW;Guinea-Bissau;0;0;2032;27
2020-08-08;GW;Guinea-Bissau;20;2;2052;29
2020-08-09;GW;Guinea-Bissau;0;0;2052;29
2020-08-10;GW;Guinea-Bissau;0;0;2052;29
2020-08-11;GW;Guinea-Bissau;36;0;2088;29
2020-08-12;GW;Guinea-Bissau;0;0;2088;29
2020-08-13;GW;Guinea-Bissau;0;0;2088;29
2020-08-14;GW;Guinea-Bissau;0;0;2088;29
2020-08-15;GW;Guinea-Bissau;29;4;2117;33
2020-08-16;GW;Guinea-Bissau;0;0;2117;33
2020-08-17;GW;Guinea-Bissau;0;0;2117;33
2020-08-18;GW;Guinea-Bissau;0;0;2117;33
2020-08-19;GW;Guinea-Bissau;0;0;2117;33
2020-08-20;GW;Guinea-Bissau;32;0;2149;33
2020-08-21;GW;Guinea-Bissau;0;0;2149;33
2020-08-22;GW;Guinea-Bissau;0;0;2149;33
2020-08-23;GW;Guinea-Bissau;0;0;2149;33
2020-08-24;GW;Guinea-Bissau;0;0;2149;33
2020-08-25;GW;Guinea-Bissau;0;0;2149;33
2020-08-26;GW;Guinea-Bissau;56;1;2205;34
2020-08-27;GW;Guinea-Bissau;0;0;2205;34
2020-08-28;GW;Guinea-Bissau;0;0;2205;34
2020-08-29;GW;Guinea-Bissau;0;0;2205;34
2020-08-30;GW;Guinea-Bissau;0;0;2205;34
2020-08-31;GW;Guinea-Bissau;0;0;2205;34
2020-09-01;GW;Guinea-Bissau;0;0;2205;34
2020-09-02;GW;Guinea-Bissau;0;0;2205;34
2020-09-03;GW;Guinea-Bissau;0;0;2205;34
2020-09-04;GW;Guinea-Bissau;40;4;2245;38
2020-09-05;GW;Guinea-Bissau;0;0;2245;38
2020-09-06;GW;Guinea-Bissau;0;0;2245;38
2020-09-07;GW;Guinea-Bissau;0;0;2245;38
2020-09-08;GW;Guinea-Bissau;0;0;2245;38
2020-09-09;GW;Guinea-Bissau;0;0;2245;38
2020-09-10;GW;Guinea-Bissau;30;1;2275;39
2020-09-11;GW;Guinea-Bissau;0;0;2275;39
2020-09-12;GW;Guinea-Bissau;0;0;2275;39
2020-09-13;GW;Guinea-Bissau;0;0;2275;39
2020-09-14;GW;Guinea-Bissau;0;0;2275;39
2020-09-15;GW;Guinea-Bissau;0;0;2275;39
2020-09-16;GW;Guinea-Bissau;0;0;2275;39
2020-09-17;GW;Guinea-Bissau;0;0;2275;39
2020-09-18;GW;Guinea-Bissau;28;0;2303;39
2020-09-19;GW;Guinea-Bissau;0;0;2303;39
2020-09-20;GW;Guinea-Bissau;0;0;2303;39
2020-09-21;GW;Guinea-Bissau;0;0;2303;39
2020-09-22;GW;Guinea-Bissau;21;0;2324;39
2020-09-23;GW;Guinea-Bissau;0;0;2324;39
2020-09-24;GW;Guinea-Bissau;0;0;2324;39
2020-09-25;GW;Guinea-Bissau;0;0;2324;39
2020-09-26;GW;Guinea-Bissau;0;0;2324;39
2020-09-27;GW;Guinea-Bissau;0;0;2324;39
2020-09-28;GW;Guinea-Bissau;0;0;2324;39
2020-09-29;GW;Guinea-Bissau;0;0;2324;39
2020-09-30;GW;Guinea-Bissau;0;0;2324;39
2020-10-01;GW;Guinea-Bissau;0;0;2324;39
2020-10-02;GW;Guinea-Bissau;38;0;2362;39
2020-10-03;GW;Guinea-Bissau;0;0;2362;39
2020-10-04;GW;Guinea-Bissau;0;0;2362;39
2020-10-05;GW;Guinea-Bissau;23;1;2385;40
2020-10-06;GW;Guinea-Bissau;0;0;2385;40
2020-10-07;GW;Guinea-Bissau;0;0;2385;40
2020-10-08;GW;Guinea-Bissau;0;0;2385;40
2020-10-09;GW;Guinea-Bissau;0;0;2385;40
2020-10-10;GW;Guinea-Bissau;0;0;2385;40
2020-10-11;GW;Guinea-Bissau;0;0;2385;40
2020-10-12;GW;Guinea-Bissau;4;1;2389;41
2020-10-13;GW;Guinea-Bissau;0;0;2389;41
2020-10-14;GW;Guinea-Bissau;0;0;2389;41
2020-10-15;GW;Guinea-Bissau;0;0;2389;41
2020-10-16;GW;Guinea-Bissau;0;0;2389;41
2020-10-17;GW;Guinea-Bissau;0;0;2389;41
2020-10-18;GW;Guinea-Bissau;0;0;2389;41
2020-10-19;GW;Guinea-Bissau;14;0;2403;41
2020-10-20;GW;Guinea-Bissau;0;0;2403;41
2020-10-21;GW;Guinea-Bissau;0;0;2403;41
2020-10-22;GW;Guinea-Bissau;0;0;2403;41
2020-10-23;GW;Guinea-Bissau;0;0;2403;41
2020-10-24;GW;Guinea-Bissau;0;0;2403;41
2020-10-25;GW;Guinea-Bissau;0;0;2403;41
2020-10-26;GW;Guinea-Bissau;0;0;2403;41
2020-10-27;GW;Guinea-Bissau;0;0;2403;41
2020-10-28;GW;Guinea-Bissau;0;0;2403;41
2020-10-29;GW;Guinea-Bissau;0;0;2403;41
2020-10-30;GW;Guinea-Bissau;0;0;2403;41
2020-10-31;GW;Guinea-Bissau;10;0;2413;41
2020-11-01;GW;Guinea-Bissau;0;0;2413;41
2020-11-02;GW;Guinea-Bissau;0;0;2413;41
2020-11-03;GW;Guinea-Bissau;0;0;2413;41
2020-11-04;GW;Guinea-Bissau;1;1;2414;42
2020-11-05;GW;Guinea-Bissau;0;0;2414;42
2020-11-06;GW;Guinea-Bissau;0;0;2414;42
2020-11-07;GW;Guinea-Bissau;0;0;2414;42
2020-11-08;GW;Guinea-Bissau;0;0;2414;42
2020-11-09;GW;Guinea-Bissau;5;1;2419;43
2020-11-10;GW;Guinea-Bissau;0;0;2419;43
2020-11-11;GW;Guinea-Bissau;0;0;2419;43
2020-11-12;GW;Guinea-Bissau;0;0;2419;43
2020-11-13;GW;Guinea-Bissau;0;0;2419;43
2020-11-14;GW;Guinea-Bissau;0;0;2419;43
2020-11-15;GW;Guinea-Bissau;0;0;2419;43
2020-11-16;GW;Guinea-Bissau;0;0;2419;43
2020-11-17;GW;Guinea-Bissau;0;0;2419;43
2020-11-18;GW;Guinea-Bissau;2;0;2421;43
2020-11-19;GW;Guinea-Bissau;0;0;2421;43
2020-11-20;GW;Guinea-Bissau;0;0;2421;43
2020-11-21;GW;Guinea-Bissau;0;0;2421;43
2020-11-22;GW;Guinea-Bissau;0;0;2421;43
2020-11-23;GW;Guinea-Bissau;1;0;2422;43
2020-11-24;GW;Guinea-Bissau;0;0;2422;43
2020-11-25;GW;Guinea-Bissau;0;0;2422;43
2020-11-26;GW;Guinea-Bissau;0;0;2422;43
2020-11-27;GW;Guinea-Bissau;0;0;2422;43
2020-11-28;GW;Guinea-Bissau;0;0;2422;43
2020-11-29;GW;Guinea-Bissau;0;0;2422;43
2020-11-30;GW;Guinea-Bissau;19;1;2441;44
2020-12-01;GW;Guinea-Bissau;0;0;2441;44
2020-12-02;GW;Guinea-Bissau;0;0;2441;44
2020-12-03;GW;Guinea-Bissau;0;0;2441;44
2020-12-04;GW;Guinea-Bissau;0;0;2441;44
2020-12-05;GW;Guinea-Bissau;0;0;2441;44
2020-12-06;GW;Guinea-Bissau;0;0;2441;44
2020-12-07;GW;Guinea-Bissau;3;0;2444;44
2020-12-08;GW;Guinea-Bissau;0;0;2444;44
2020-12-09;GW;Guinea-Bissau;0;0;2444;44
2020-12-10;GW;Guinea-Bissau;0;0;2444;44
2020-12-11;GW;Guinea-Bissau;0;0;2444;44
2020-12-12;GW;Guinea-Bissau;0;0;2444;44
2020-12-13;GW;Guinea-Bissau;0;0;2444;44
2020-12-14;GW;Guinea-Bissau;0;0;2444;44
2020-12-15;GW;Guinea-Bissau;3;0;2447;44
2020-12-16;GW;Guinea-Bissau;0;0;2447;44
2020-12-17;GW;Guinea-Bissau;0;0;2447;44
2020-12-18;GW;Guinea-Bissau;0;0;2447;44
2020-12-19;GW;Guinea-Bissau;0;0;2447;44
2020-12-20;GW;Guinea-Bissau;0;0;2447;44
2020-12-21;GW;Guinea-Bissau;0;0;2447;44
2020-12-22;GW;Guinea-Bissau;0;1;2447;45
2020-12-23;GW;Guinea-Bissau;0;0;2447;45
2020-12-24;GW;Guinea-Bissau;0;0;2447;45
2020-12-25;GW;Guinea-Bissau;0;0;2447;45
2020-12-26;GW;Guinea-Bissau;0;0;2447;45
2020-12-27;GW;Guinea-Bissau;0;0;2447;45
2020-12-28;GW;Guinea-Bissau;0;0;2447;45
2020-12-29;GW;Guinea-Bissau;5;0;2452;45
2020-12-30;GW;Guinea-Bissau;0;0;2452;45
2020-12-31;GW;Guinea-Bissau;0;0;2452;45
2021-01-01;GW;Guinea-Bissau;0;0;2452;45
2021-01-02;GW;Guinea-Bissau;0;0;2452;45
2021-01-03;GW;Guinea-Bissau;3;0;2455;45
2021-01-04;GW;Guinea-Bissau;0;0;2455;45
2021-01-05;GW;Guinea-Bissau;0;0;2455;45
2021-01-06;GW;Guinea-Bissau;0;0;2455;45
2021-01-07;GW;Guinea-Bissau;0;0;2455;45
2021-01-08;GW;Guinea-Bissau;0;0;2455;45
2021-01-09;GW;Guinea-Bissau;0;0;2455;45
2021-01-10;GW;Guinea-Bissau;23;0;2478;45
2021-01-11;GW;Guinea-Bissau;0;0;2478;45
2021-01-12;GW;Guinea-Bissau;0;0;2478;45
2021-01-13;GW;Guinea-Bissau;0;0;2478;45
2021-01-14;GW;Guinea-Bissau;0;0;2478;45
2021-01-15;GW;Guinea-Bissau;0;0;2478;45
2021-01-16;GW;Guinea-Bissau;0;0;2478;45
2021-01-17;GW;Guinea-Bissau;31;0;2509;45
2021-01-18;GW;Guinea-Bissau;0;0;2509;45
2021-01-19;GW;Guinea-Bissau;1;0;2510;45
2021-01-20;GW;Guinea-Bissau;0;0;2510;45
2021-01-21;GW;Guinea-Bissau;0;0;2510;45
2021-01-22;GW;Guinea-Bissau;0;0;2510;45
2021-01-23;GW;Guinea-Bissau;0;0;2510;45
2021-01-24;GW;Guinea-Bissau;22;0;2532;45
2021-01-25;GW;Guinea-Bissau;0;0;2532;45
2021-01-26;GW;Guinea-Bissau;0;0;2532;45
2021-01-27;GW;Guinea-Bissau;0;0;2532;45
2021-01-28;GW;Guinea-Bissau;0;0;2532;45
2021-01-29;GW;Guinea-Bissau;0;0;2532;45
2021-01-30;GW;Guinea-Bissau;0;0;2532;45
2021-01-31;GW;Guinea-Bissau;102;0;2634;45
2021-02-01;GW;Guinea-Bissau;0;0;2634;45
2021-02-02;GW;Guinea-Bissau;0;0;2634;45
2021-02-03;GW;Guinea-Bissau;28;0;2662;45
2021-02-04;GW;Guinea-Bissau;0;1;2662;46
2021-02-05;GW;Guinea-Bissau;90;0;2752;46
2021-02-06;GW;Guinea-Bissau;20;0;2772;46
2021-02-07;GW;Guinea-Bissau;8;0;2780;46
2021-02-08;GW;Guinea-Bissau;0;0;2780;46
2021-02-09;GW;Guinea-Bissau;30;0;2810;46
2021-02-10;GW;Guinea-Bissau;16;0;2826;46
2021-02-11;GW;Guinea-Bissau;22;0;2848;46
2021-02-12;GW;Guinea-Bissau;21;0;2869;46
2021-02-13;GW;Guinea-Bissau;16;0;2885;46
2021-02-14;GW;Guinea-Bissau;39;0;2924;46
2021-02-15;GW;Guinea-Bissau;0;0;2924;46
2021-02-16;GW;Guinea-Bissau;26;0;2950;46
2021-02-17;GW;Guinea-Bissau;49;0;2999;46
2021-02-18;GW;Guinea-Bissau;26;0;3025;46
2021-02-19;GW;Guinea-Bissau;39;0;3064;46
2021-02-20;GW;Guinea-Bissau;27;0;3091;46
2021-02-21;GW;Guinea-Bissau;24;1;3115;47
2021-02-22;GW;Guinea-Bissau;0;0;3115;47
2021-02-23;GW;Guinea-Bissau;41;0;3156;47
2021-02-24;GW;Guinea-Bissau;15;1;3171;48
2021-02-25;GW;Guinea-Bissau;44;0;3215;48
2021-02-26;GW;Guinea-Bissau;26;0;3241;48
2021-02-27;GW;Guinea-Bissau;6;0;3247;48
2021-02-28;GW;Guinea-Bissau;15;0;3262;48
2021-03-01;GW;Guinea-Bissau;0;0;3262;48
2021-03-02;GW;Guinea-Bissau;9;0;3271;48
2021-03-03;GW;Guinea-Bissau;11;0;3282;48
2021-03-04;GW;Guinea-Bissau;19;1;3301;49
2021-03-05;GW;Guinea-Bissau;2;0;3303;49
2021-03-06;GW;Guinea-Bissau;9;0;3312;49
2021-03-07;GW;Guinea-Bissau;0;0;3312;49
2021-03-08;GW;Guinea-Bissau;0;0;3312;49
2021-03-09;GW;Guinea-Bissau;7;0;3319;49
2021-03-10;GW;Guinea-Bissau;8;2;3327;51
2021-03-11;GW;Guinea-Bissau;53;0;3380;51
2021-03-12;GW;Guinea-Bissau;18;1;3398;52
2021-03-13;GW;Guinea-Bissau;38;0;3436;52
2021-03-14;GW;Guinea-Bissau;11;0;3447;52
2021-03-15;GW;Guinea-Bissau;0;0;3447;52
2021-03-16;GW;Guinea-Bissau;22;0;3469;52
2021-03-17;GW;Guinea-Bissau;19;2;3488;54
2021-03-18;GW;Guinea-Bissau;30;0;3518;54
2021-03-19;GW;Guinea-Bissau;18;1;3536;55
2021-03-20;GW;Guinea-Bissau;22;0;3558;55
2021-03-21;GW;Guinea-Bissau;10;0;3568;55
2021-03-22;GW;Guinea-Bissau;0;0;3568;55
2021-03-23;GW;Guinea-Bissau;18;1;3586;56
2021-03-24;GW;Guinea-Bissau;5;0;3591;56
2021-03-25;GW;Guinea-Bissau;16;5;3607;61
2021-03-26;GW;Guinea-Bissau;8;0;3615;61
2021-03-27;GW;Guinea-Bissau;15;0;3630;61
2021-03-28;GW;Guinea-Bissau;4;0;3634;61
2021-03-29;GW;Guinea-Bissau;0;0;3634;61
2021-03-30;GW;Guinea-Bissau;13;0;3647;61
2021-03-31;GW;Guinea-Bissau;3;2;3650;63
2021-04-01;GW;Guinea-Bissau;11;0;3661;63
2021-04-02;GW;Guinea-Bissau;0;2;3661;65
2021-04-03;GW;Guinea-Bissau;0;0;3661;65
2021-04-04;GW;Guinea-Bissau;1;1;3662;66
2021-04-05;GW;Guinea-Bissau;0;0;3662;66
2021-04-06;GW;Guinea-Bissau;0;0;3662;66
2021-04-07;GW;Guinea-Bissau;1;0;3663;66
2021-04-08;GW;Guinea-Bissau;1;0;3664;66
2021-04-09;GW;Guinea-Bissau;11;0;3675;66
2021-04-10;GW;Guinea-Bissau;3;0;3678;66
2021-04-11;GW;Guinea-Bissau;2;0;3680;66
2021-04-12;GW;Guinea-Bissau;0;0;3680;66
2021-04-13;GW;Guinea-Bissau;13;0;3693;66
2021-04-14;GW;Guinea-Bissau;1;0;3694;66
2021-04-15;GW;Guinea-Bissau;12;0;3706;66
2021-04-16;GW;Guinea-Bissau;4;0;3710;66
2021-04-17;GW;Guinea-Bissau;0;0;3710;66
2021-04-18;GW;Guinea-Bissau;2;0;3712;66
2021-04-19;GW;Guinea-Bissau;0;0;3712;66
2021-04-20;GW;Guinea-Bissau;1;0;3713;66
2021-04-21;GW;Guinea-Bissau;0;0;3713;66
2021-04-22;GW;Guinea-Bissau;8;0;3721;66
2021-04-23;GW;Guinea-Bissau;1;0;3722;66
2021-04-24;GW;Guinea-Bissau;2;1;3724;67
2021-04-25;GW;Guinea-Bissau;2;0;3726;67
2021-04-26;GW;Guinea-Bissau;0;0;3726;67
2021-04-27;GW;Guinea-Bissau;5;0;3731;67
2021-04-28;GW;Guinea-Bissau;0;0;3731;67
2021-04-29;GW;Guinea-Bissau;2;0;3733;67
2021-04-30;GW;Guinea-Bissau;1;0;3734;67
2021-05-01;GW;Guinea-Bissau;2;0;3736;67
2021-05-02;GW;Guinea-Bissau;0;0;3736;67
2021-05-03;GW;Guinea-Bissau;0;0;3736;67
2021-05-04;GW;Guinea-Bissau;1;0;3737;67
2021-05-05;GW;Guinea-Bissau;1;0;3738;67
2021-05-06;GW;Guinea-Bissau;0;0;3738;67
2021-05-07;GW;Guinea-Bissau;1;0;3739;67
2021-05-08;GW;Guinea-Bissau;0;0;3739;67
2021-05-09;GW;Guinea-Bissau;2;0;3741;67
2021-05-10;GW;Guinea-Bissau;0;0;3741;67
2021-05-11;GW;Guinea-Bissau;0;0;3741;67
2021-05-12;GW;Guinea-Bissau;0;0;3741;67
2021-05-13;GW;Guinea-Bissau;2;0;3743;67
2021-05-14;GW;Guinea-Bissau;2;0;3745;67
2021-05-15;GW;Guinea-Bissau;1;0;3746;67
2021-05-16;GW;Guinea-Bissau;0;0;3746;67
2021-05-17;GW;Guinea-Bissau;0;0;3746;67
2021-05-18;GW;Guinea-Bissau;0;0;3746;67
2021-05-19;GW;Guinea-Bissau;0;1;3746;68
2021-05-20;GW;Guinea-Bissau;0;0;3746;68
2021-05-21;GW;Guinea-Bissau;3;0;3749;68
2021-05-22;GW;Guinea-Bissau;0;0;3749;68
2021-05-23;GW;Guinea-Bissau;2;0;3751;68
2021-05-24;GW;Guinea-Bissau;0;0;3751;68
2021-05-25;GW;Guinea-Bissau;2;0;3753;68
2021-05-26;GW;Guinea-Bissau;0;0;3753;68
2021-05-27;GW;Guinea-Bissau;3;0;3756;68
2021-05-28;GW;Guinea-Bissau;4;0;3760;68
2021-05-29;GW;Guinea-Bissau;1;0;3761;68
2021-05-30;GW;Guinea-Bissau;5;0;3766;68
2021-05-31;GW;Guinea-Bissau;0;0;3766;68
2021-06-01;GW;Guinea-Bissau;4;0;3770;68
2021-06-02;GW;Guinea-Bissau;13;0;3783;68
2021-06-03;GW;Guinea-Bissau;1;0;3784;68
2021-06-04;GW;Guinea-Bissau;3;0;3787;68
2021-06-05;GW;Guinea-Bissau;0;0;3787;68
2021-06-06;GW;Guinea-Bissau;0;0;3787;68
2021-06-07;GW;Guinea-Bissau;0;0;3787;68
2021-06-08;GW;Guinea-Bissau;3;0;3790;68
2021-06-09;GW;Guinea-Bissau;4;0;3794;68
2021-06-10;GW;Guinea-Bissau;6;0;3800;68
2021-06-11;GW;Guinea-Bissau;2;1;3802;69
2021-06-12;GW;Guinea-Bissau;0;0;3802;69
2021-06-13;GW;Guinea-Bissau;1;0;3803;69
2021-06-14;GW;Guinea-Bissau;0;0;3803;69
2021-06-15;GW;Guinea-Bissau;0;0;3803;69
2021-06-16;GW;Guinea-Bissau;7;0;3810;69
2021-06-17;GW;Guinea-Bissau;9;0;3819;69
2021-06-18;GW;Guinea-Bissau;5;0;3824;69
2021-06-19;GW;Guinea-Bissau;1;0;3825;69
2021-06-20;GW;Guinea-Bissau;0;0;3825;69
2021-06-21;GW;Guinea-Bissau;0;0;3825;69
2021-06-22;GW;Guinea-Bissau;9;0;3834;69
2021-06-23;GW;Guinea-Bissau;5;0;3839;69
2021-06-24;GW;Guinea-Bissau;5;0;3844;69
2021-06-25;GW;Guinea-Bissau;1;0;3845;69
2021-06-26;GW;Guinea-Bissau;1;0;3846;69
2021-06-27;GW;Guinea-Bissau;0;0;3846;69
2021-06-28;GW;Guinea-Bissau;0;0;3846;69
2021-06-29;GW;Guinea-Bissau;7;0;3853;69
2021-06-30;GW;Guinea-Bissau;6;0;3859;69
2021-07-01;GW;Guinea-Bissau;10;0;3869;69
2020-03-12;GY;Guyana;1;1;1;1
2020-03-13;GY;Guyana;0;0;1;1
2020-03-14;GY;Guyana;0;0;1;1
2020-03-15;GY;Guyana;3;0;4;1
2020-03-16;GY;Guyana;0;0;4;1
2020-03-17;GY;Guyana;3;0;7;1
2020-03-18;GY;Guyana;0;0;7;1
2020-03-19;GY;Guyana;0;0;7;1
2020-03-20;GY;Guyana;0;0;7;1
2020-03-21;GY;Guyana;0;0;7;1
2020-03-22;GY;Guyana;12;0;19;1
2020-03-23;GY;Guyana;1;0;20;1
2020-03-24;GY;Guyana;-15;0;5;1
2020-03-25;GY;Guyana;0;0;5;1
2020-03-26;GY;Guyana;0;0;5;1
2020-03-27;GY;Guyana;0;0;5;1
2020-03-28;GY;Guyana;3;0;8;1
2020-03-29;GY;Guyana;0;0;8;1
2020-03-30;GY;Guyana;0;0;8;1
2020-03-31;GY;Guyana;4;1;12;2
2020-04-01;GY;Guyana;7;0;19;2
2020-04-02;GY;Guyana;0;2;19;4
2020-04-03;GY;Guyana;4;0;23;4
2020-04-04;GY;Guyana;0;0;23;4
2020-04-05;GY;Guyana;1;0;24;4
2020-04-06;GY;Guyana;7;0;31;4
2020-04-07;GY;Guyana;2;1;33;5
2020-04-08;GY;Guyana;4;1;37;6
2020-04-09;GY;Guyana;0;0;37;6
2020-04-10;GY;Guyana;0;0;37;6
2020-04-11;GY;Guyana;8;0;45;6
2020-04-12;GY;Guyana;0;0;45;6
2020-04-13;GY;Guyana;0;0;45;6
2020-04-14;GY;Guyana;2;0;47;6
2020-04-15;GY;Guyana;8;0;55;6
2020-04-16;GY;Guyana;0;0;55;6
2020-04-17;GY;Guyana;8;0;63;6
2020-04-18;GY;Guyana;0;0;63;6
2020-04-19;GY;Guyana;2;1;65;7
2020-04-20;GY;Guyana;0;0;65;7
2020-04-21;GY;Guyana;1;0;66;7
2020-04-22;GY;Guyana;1;0;67;7
2020-04-23;GY;Guyana;3;0;70;7
2020-04-24;GY;Guyana;3;0;73;7
2020-04-25;GY;Guyana;0;0;73;7
2020-04-26;GY;Guyana;1;1;74;8
2020-04-27;GY;Guyana;0;0;74;8
2020-04-28;GY;Guyana;0;0;74;8
2020-04-29;GY;Guyana;4;0;78;8
2020-04-30;GY;Guyana;4;1;82;9
2020-05-01;GY;Guyana;0;0;82;9
2020-05-02;GY;Guyana;0;0;82;9
2020-05-03;GY;Guyana;0;0;82;9
2020-05-04;GY;Guyana;10;0;92;9
2020-05-05;GY;Guyana;1;1;93;10
2020-05-06;GY;Guyana;0;0;93;10
2020-05-07;GY;Guyana;0;0;93;10
2020-05-08;GY;Guyana;1;0;94;10
2020-05-09;GY;Guyana;0;0;94;10
2020-05-10;GY;Guyana;10;0;104;10
2020-05-11;GY;Guyana;5;0;109;10
2020-05-12;GY;Guyana;4;0;113;10
2020-05-13;GY;Guyana;0;0;113;10
2020-05-14;GY;Guyana;0;0;113;10
2020-05-15;GY;Guyana;3;0;116;10
2020-05-16;GY;Guyana;1;0;117;10
2020-05-17;GY;Guyana;0;0;117;10
2020-05-18;GY;Guyana;7;0;124;10
2020-05-19;GY;Guyana;1;0;125;10
2020-05-20;GY;Guyana;0;0;125;10
2020-05-21;GY;Guyana;2;0;127;10
2020-05-22;GY;Guyana;0;0;127;10
2020-05-23;GY;Guyana;0;0;127;10
2020-05-24;GY;Guyana;8;0;135;10
2020-05-25;GY;Guyana;2;1;137;11
2020-05-26;GY;Guyana;2;0;139;11
2020-05-27;GY;Guyana;0;0;139;11
2020-05-28;GY;Guyana;11;0;150;11
2020-05-29;GY;Guyana;0;0;150;11
2020-05-30;GY;Guyana;2;1;152;12
2020-05-31;GY;Guyana;1;0;153;12
2020-06-01;GY;Guyana;0;0;153;12
2020-06-02;GY;Guyana;0;0;153;12
2020-06-03;GY;Guyana;0;0;153;12
2020-06-04;GY;Guyana;0;0;153;12
2020-06-05;GY;Guyana;0;0;153;12
2020-06-06;GY;Guyana;1;0;154;12
2020-06-07;GY;Guyana;0;0;154;12
2020-06-08;GY;Guyana;0;0;154;12
2020-06-09;GY;Guyana;2;0;156;12
2020-06-10;GY;Guyana;0;0;156;12
2020-06-11;GY;Guyana;2;0;158;12
2020-06-12;GY;Guyana;1;0;159;12
2020-06-13;GY;Guyana;0;0;159;12
2020-06-14;GY;Guyana;0;0;159;12
2020-06-15;GY;Guyana;0;0;159;12
2020-06-16;GY;Guyana;12;0;171;12
2020-06-17;GY;Guyana;0;0;171;12
2020-06-18;GY;Guyana;12;0;183;12
2020-06-19;GY;Guyana;0;0;183;12
2020-06-20;GY;Guyana;0;0;183;12
2020-06-21;GY;Guyana;1;0;184;12
2020-06-22;GY;Guyana;21;0;205;12
2020-06-23;GY;Guyana;1;0;206;12
2020-06-24;GY;Guyana;3;0;209;12
2020-06-25;GY;Guyana;6;0;215;12
2020-06-26;GY;Guyana;0;0;215;12
2020-06-27;GY;Guyana;15;0;230;12
2020-06-28;GY;Guyana;0;0;230;12
2020-06-29;GY;Guyana;5;0;235;12
2020-06-30;GY;Guyana;10;0;245;12
2020-07-01;GY;Guyana;3;1;248;13
2020-07-02;GY;Guyana;2;1;250;14
2020-07-03;GY;Guyana;6;0;256;14
2020-07-04;GY;Guyana;16;0;272;14
2020-07-05;GY;Guyana;1;1;273;15
2020-07-06;GY;Guyana;0;0;273;15
2020-07-07;GY;Guyana;11;1;284;16
2020-07-08;GY;Guyana;0;0;284;16
2020-07-09;GY;Guyana;2;0;286;16
2020-07-10;GY;Guyana;4;0;290;16
2020-07-11;GY;Guyana;1;1;291;17
2020-07-12;GY;Guyana;6;0;297;17
2020-07-13;GY;Guyana;3;0;300;17
2020-07-14;GY;Guyana;8;0;308;17
2020-07-15;GY;Guyana;5;1;313;18
2020-07-16;GY;Guyana;2;1;315;19
2020-07-17;GY;Guyana;5;0;320;19
2020-07-18;GY;Guyana;7;0;327;19
2020-07-19;GY;Guyana;9;0;336;19
2020-07-20;GY;Guyana;1;0;337;19
2020-07-21;GY;Guyana;2;0;339;19
2020-07-22;GY;Guyana;11;0;350;19
2020-07-23;GY;Guyana;1;0;351;19
2020-07-24;GY;Guyana;1;1;352;20
2020-07-25;GY;Guyana;8;0;360;20
2020-07-26;GY;Guyana;10;0;370;20
2020-07-27;GY;Guyana;19;0;389;20
2020-07-28;GY;Guyana;7;0;396;20
2020-07-29;GY;Guyana;2;0;398;20
2020-07-30;GY;Guyana;3;0;401;20
2020-07-31;GY;Guyana;12;0;413;20
2020-08-01;GY;Guyana;17;0;430;20
2020-08-02;GY;Guyana;44;1;474;21
2020-08-03;GY;Guyana;0;0;474;21
2020-08-04;GY;Guyana;23;1;497;22
2020-08-05;GY;Guyana;12;0;509;22
2020-08-06;GY;Guyana;29;0;538;22
2020-08-07;GY;Guyana;0;0;538;22
2020-08-08;GY;Guyana;16;0;554;22
2020-08-09;GY;Guyana;14;0;568;22
2020-08-10;GY;Guyana;0;0;568;22
2020-08-11;GY;Guyana;34;0;602;22
2020-08-12;GY;Guyana;21;0;623;22
2020-08-13;GY;Guyana;8;0;631;22
2020-08-14;GY;Guyana;18;0;649;22
2020-08-15;GY;Guyana;25;0;674;22
2020-08-16;GY;Guyana;35;1;709;23
2020-08-17;GY;Guyana;0;0;709;23
2020-08-18;GY;Guyana;28;2;737;25
2020-08-19;GY;Guyana;39;2;776;27
2020-08-20;GY;Guyana;70;2;846;29
2020-08-21;GY;Guyana;35;1;881;30
2020-08-22;GY;Guyana;44;1;925;31
2020-08-23;GY;Guyana;30;0;955;31
2020-08-24;GY;Guyana;74;0;1029;31
2020-08-25;GY;Guyana;31;0;1060;31
2020-08-26;GY;Guyana;33;0;1093;31
2020-08-27;GY;Guyana;47;1;1140;32
2020-08-28;GY;Guyana;40;3;1180;35
2020-08-29;GY;Guyana;4;0;1184;35
2020-08-30;GY;Guyana;50;1;1234;36
2020-08-31;GY;Guyana;72;3;1306;39
2020-09-01;GY;Guyana;67;2;1373;41
2020-09-02;GY;Guyana;9;0;1382;41
2020-09-03;GY;Guyana;19;3;1401;44
2020-09-04;GY;Guyana;0;0;1401;44
2020-09-05;GY;Guyana;58;2;1459;46
2020-09-06;GY;Guyana;9;0;1468;46
2020-09-07;GY;Guyana;92;1;1560;47
2020-09-08;GY;Guyana;53;1;1613;48
2020-09-09;GY;Guyana;90;0;1703;48
2020-09-10;GY;Guyana;47;1;1750;49
2020-09-11;GY;Guyana;13;3;1763;52
2020-09-12;GY;Guyana;49;2;1812;54
2020-09-13;GY;Guyana;41;2;1853;56
2020-09-14;GY;Guyana;31;0;1884;56
2020-09-15;GY;Guyana;74;2;1958;58
2020-09-16;GY;Guyana;0;0;1958;58
2020-09-17;GY;Guyana;69;2;2027;60
2020-09-18;GY;Guyana;75;2;2102;62
2020-09-19;GY;Guyana;66;2;2168;64
2020-09-20;GY;Guyana;101;0;2269;64
2020-09-21;GY;Guyana;133;1;2402;65
2020-09-22;GY;Guyana;35;2;2437;67
2020-09-23;GY;Guyana;98;2;2535;69
2020-09-24;GY;Guyana;44;2;2579;71
2020-09-25;GY;Guyana;130;2;2709;73
2020-09-26;GY;Guyana;16;1;2725;74
2020-09-27;GY;Guyana;47;2;2772;76
2020-09-28;GY;Guyana;15;2;2787;78
2020-09-29;GY;Guyana;59;0;2846;78
2020-09-30;GY;Guyana;48;2;2894;80
2020-10-01;GY;Guyana;35;2;2929;82
2020-10-02;GY;Guyana;39;3;2968;85
2020-10-03;GY;Guyana;0;0;2968;85
2020-10-04;GY;Guyana;125;2;3093;87
2020-10-05;GY;Guyana;95;3;3188;90
2020-10-06;GY;Guyana;0;2;3188;92
2020-10-07;GY;Guyana;104;3;3292;95
2020-10-08;GY;Guyana;37;3;3329;98
2020-10-09;GY;Guyana;29;2;3358;100
2020-10-10;GY;Guyana;47;2;3405;102
2020-10-11;GY;Guyana;64;1;3469;103
2020-10-12;GY;Guyana;52;1;3521;104
2020-10-13;GY;Guyana;44;2;3565;106
2020-10-14;GY;Guyana;24;0;3589;106
2020-10-15;GY;Guyana;31;1;3620;107
2020-10-16;GY;Guyana;52;0;3672;107
2020-10-17;GY;Guyana;38;2;3710;109
2020-10-18;GY;Guyana;24;0;3734;109
2020-10-19;GY;Guyana;31;2;3765;111
2020-10-20;GY;Guyana;31;3;3796;114
2020-10-21;GY;Guyana;54;2;3850;116
2020-10-22;GY;Guyana;27;1;3877;117
2020-10-23;GY;Guyana;83;0;3960;117
2020-10-24;GY;Guyana;34;0;3994;117
2020-10-25;GY;Guyana;29;2;4023;119
2020-10-26;GY;Guyana;3;0;4026;119
2020-10-27;GY;Guyana;35;0;4061;119
2020-10-28;GY;Guyana;13;4;4074;123
2020-10-29;GY;Guyana;24;0;4098;123
2020-10-30;GY;Guyana;45;1;4143;124
2020-10-31;GY;Guyana;19;0;4162;124
2020-11-01;GY;Guyana;46;2;4208;126
2020-11-02;GY;Guyana;30;2;4238;128
2020-11-03;GY;Guyana;7;0;4245;128
2020-11-04;GY;Guyana;79;2;4324;130
2020-11-05;GY;Guyana;69;0;4393;130
2020-11-06;GY;Guyana;64;3;4457;133
2020-11-07;GY;Guyana;27;1;4484;134
2020-11-08;GY;Guyana;30;0;4514;134
2020-11-09;GY;Guyana;10;1;4524;135
2020-11-10;GY;Guyana;6;0;4530;135
2020-11-11;GY;Guyana;88;2;4618;137
2020-11-12;GY;Guyana;44;1;4662;138
2020-11-13;GY;Guyana;62;0;4724;138
2020-11-14;GY;Guyana;70;0;4794;138
2020-11-15;GY;Guyana;29;1;4823;139
2020-11-16;GY;Guyana;51;0;4874;139
2020-11-17;GY;Guyana;16;1;4890;140
2020-11-18;GY;Guyana;24;2;4914;142
2020-11-19;GY;Guyana;62;1;4976;143
2020-11-20;GY;Guyana;29;0;5005;143
2020-11-21;GY;Guyana;88;0;5093;143
2020-11-22;GY;Guyana;40;0;5133;143
2020-11-23;GY;Guyana;21;3;5154;146
2020-11-24;GY;Guyana;35;1;5189;147
2020-11-25;GY;Guyana;47;0;5236;147
2020-11-26;GY;Guyana;40;2;5276;149
2020-11-27;GY;Guyana;34;0;5310;149
2020-11-28;GY;Guyana;28;0;5338;149
2020-11-29;GY;Guyana;38;1;5376;150
2020-11-30;GY;Guyana;30;1;5406;151
2020-12-01;GY;Guyana;17;0;5423;151
2020-12-02;GY;Guyana;26;0;5449;151
2020-12-03;GY;Guyana;79;0;5528;151
2020-12-04;GY;Guyana;73;0;5601;151
2020-12-05;GY;Guyana;36;0;5637;151
2020-12-06;GY;Guyana;28;2;5665;153
2020-12-07;GY;Guyana;32;1;5697;154
2020-12-08;GY;Guyana;3;0;5700;154
2020-12-09;GY;Guyana;32;0;5732;154
2020-12-10;GY;Guyana;79;0;5811;154
2020-12-11;GY;Guyana;28;0;5839;154
2020-12-12;GY;Guyana;40;0;5879;154
2020-12-13;GY;Guyana;41;1;5920;155
2020-12-14;GY;Guyana;23;1;5943;156
2020-12-15;GY;Guyana;30;0;5973;156
2020-12-16;GY;Guyana;43;2;6016;158
2020-12-17;GY;Guyana;26;0;6042;158
2020-12-18;GY;Guyana;34;1;6076;159
2020-12-19;GY;Guyana;29;0;6105;159
2020-12-20;GY;Guyana;20;0;6125;159
2020-12-21;GY;Guyana;46;0;6171;159
2020-12-22;GY;Guyana;45;1;6216;160
2020-12-23;GY;Guyana;42;2;6258;162
2020-12-24;GY;Guyana;8;0;6266;162
2020-12-25;GY;Guyana;23;0;6289;162
2020-12-26;GY;Guyana;0;0;6289;162
2020-12-27;GY;Guyana;4;2;6293;164
2020-12-28;GY;Guyana;5;0;6298;164
2020-12-29;GY;Guyana;3;0;6301;164
2020-12-30;GY;Guyana;18;0;6319;164
2020-12-31;GY;Guyana;13;0;6332;164
2021-01-01;GY;Guyana;16;0;6348;164
2021-01-02;GY;Guyana;3;0;6351;164
2021-01-03;GY;Guyana;7;0;6358;164
2021-01-04;GY;Guyana;21;2;6379;166
2021-01-05;GY;Guyana;28;0;6407;166
2021-01-06;GY;Guyana;0;0;6407;166
2021-01-07;GY;Guyana;62;1;6469;167
2021-01-08;GY;Guyana;0;0;6469;167
2021-01-09;GY;Guyana;72;0;6541;167
2021-01-10;GY;Guyana;33;2;6574;169
2021-01-11;GY;Guyana;14;1;6588;170
2021-01-12;GY;Guyana;65;0;6653;170
2021-01-13;GY;Guyana;43;0;6696;170
2021-01-14;GY;Guyana;49;0;6745;170
2021-01-15;GY;Guyana;60;0;6805;170
2021-01-16;GY;Guyana;46;0;6851;170
2021-01-17;GY;Guyana;57;0;6908;170
2021-01-18;GY;Guyana;23;0;6931;170
2021-01-19;GY;Guyana;19;0;6950;170
2021-01-20;GY;Guyana;65;0;7015;170
2021-01-21;GY;Guyana;52;0;7067;170
2021-01-22;GY;Guyana;76;0;7143;170
2021-01-23;GY;Guyana;79;0;7222;170
2021-01-24;GY;Guyana;76;2;7298;172
2021-01-25;GY;Guyana;19;0;7317;172
2021-01-26;GY;Guyana;29;0;7346;172
2021-01-27;GY;Guyana;34;2;7380;174
2021-01-28;GY;Guyana;90;1;7470;175
2021-01-29;GY;Guyana;58;0;7528;175
2021-01-30;GY;Guyana;53;1;7581;176
2021-01-31;GY;Guyana;60;0;7641;176
2021-02-01;GY;Guyana;13;1;7654;177
2021-02-02;GY;Guyana;24;0;7678;177
2021-02-03;GY;Guyana;36;0;7714;177
2021-02-04;GY;Guyana;66;0;7780;177
2021-02-05;GY;Guyana;107;2;7887;179
2021-02-06;GY;Guyana;52;1;7939;180
2021-02-07;GY;Guyana;43;0;7982;180
2021-02-08;GY;Guyana;41;1;8023;181
2021-02-09;GY;Guyana;18;0;8041;181
2021-02-10;GY;Guyana;51;1;8092;182
2021-02-11;GY;Guyana;43;2;8135;184
2021-02-12;GY;Guyana;46;2;8181;186
2021-02-13;GY;Guyana;26;0;8207;186
2021-02-14;GY;Guyana;24;0;8231;186
2021-02-15;GY;Guyana;1;0;8232;186
2021-02-16;GY;Guyana;30;2;8262;188
2021-02-17;GY;Guyana;51;1;8313;189
2021-02-18;GY;Guyana;25;0;8338;189
2021-02-19;GY;Guyana;19;0;8357;189
2021-02-20;GY;Guyana;42;0;8399;189
2021-02-21;GY;Guyana;21;0;8420;189
2021-02-22;GY;Guyana;7;0;8427;189
2021-02-23;GY;Guyana;25;1;8452;190
2021-02-24;GY;Guyana;5;2;8457;192
2021-02-25;GY;Guyana;28;3;8485;195
2021-02-26;GY;Guyana;28;0;8513;195
2021-02-27;GY;Guyana;37;0;8550;195
2021-02-28;GY;Guyana;35;0;8585;195
2021-03-01;GY;Guyana;10;2;8595;197
2021-03-02;GY;Guyana;31;0;8626;197
2021-03-03;GY;Guyana;22;2;8648;199
2021-03-04;GY;Guyana;51;0;8699;199
2021-03-05;GY;Guyana;30;1;8729;200
2021-03-06;GY;Guyana;43;0;8772;200
2021-03-07;GY;Guyana;35;1;8807;201
2021-03-08;GY;Guyana;7;2;8814;203
2021-03-09;GY;Guyana;33;1;8847;204
2021-03-10;GY;Guyana;81;1;8928;205
2021-03-11;GY;Guyana;65;1;8993;206
2021-03-12;GY;Guyana;76;0;9069;206
2021-03-13;GY;Guyana;52;0;9121;206
2021-03-14;GY;Guyana;39;1;9160;207
2021-03-15;GY;Guyana;27;0;9187;207
2021-03-16;GY;Guyana;51;1;9238;208
2021-03-17;GY;Guyana;84;1;9322;209
2021-03-18;GY;Guyana;120;3;9442;212
2021-03-19;GY;Guyana;44;0;9486;212
2021-03-20;GY;Guyana;99;2;9585;214
2021-03-21;GY;Guyana;64;1;9649;215
2021-03-22;GY;Guyana;19;1;9668;216
2021-03-23;GY;Guyana;64;2;9732;218
2021-03-24;GY;Guyana;88;2;9820;220
2021-03-25;GY;Guyana;78;3;9898;223
2021-03-26;GY;Guyana;109;2;10007;225
2021-03-27;GY;Guyana;65;0;10072;225
2021-03-28;GY;Guyana;96;2;10168;227
2021-03-29;GY;Guyana;14;2;10182;229
2021-03-30;GY;Guyana;10;2;10192;231
2021-03-31;GY;Guyana;57;0;10249;231
2021-04-01;GY;Guyana;126;2;10375;233
2021-04-02;GY;Guyana;71;2;10446;235
2021-04-03;GY;Guyana;94;2;10540;237
2021-04-04;GY;Guyana;40;6;10580;243
2021-04-05;GY;Guyana;26;3;10606;246
2021-04-06;GY;Guyana;31;1;10637;247
2021-04-07;GY;Guyana;81;3;10718;250
2021-04-08;GY;Guyana;135;2;10853;252
2021-04-09;GY;Guyana;105;0;10958;252
2021-04-10;GY;Guyana;86;0;11044;252
2021-04-11;GY;Guyana;105;3;11149;255
2021-04-12;GY;Guyana;40;2;11189;257
2021-04-13;GY;Guyana;88;1;11277;258
2021-04-14;GY;Guyana;97;2;11374;260
2021-04-15;GY;Guyana;153;3;11527;263
2021-04-16;GY;Guyana;115;4;11642;267
2021-04-17;GY;Guyana;120;1;11762;268
2021-04-18;GY;Guyana;101;3;11863;271
2021-04-19;GY;Guyana;38;0;11901;271
2021-04-20;GY;Guyana;71;2;11972;273
2021-04-21;GY;Guyana;160;1;12132;274
2021-04-22;GY;Guyana;102;3;12234;277
2021-04-23;GY;Guyana;214;0;12448;277
2021-04-24;GY;Guyana;152;2;12600;279
2021-04-25;GY;Guyana;103;5;12703;284
2021-04-26;GY;Guyana;51;3;12754;287
2021-04-27;GY;Guyana;72;4;12826;291
2021-04-28;GY;Guyana;137;2;12963;293
2021-04-29;GY;Guyana;143;2;13106;295
2021-04-30;GY;Guyana;177;1;13283;296
2021-05-01;GY;Guyana;121;2;13404;298
2021-05-02;GY;Guyana;114;1;13518;299
2021-05-03;GY;Guyana;46;4;13564;303
2021-05-04;GY;Guyana;92;3;13656;306
2021-05-05;GY;Guyana;173;2;13829;308
2021-05-06;GY;Guyana;128;2;13957;310
2021-05-07;GY;Guyana;116;4;14073;314
2021-05-08;GY;Guyana;130;9;14203;323
2021-05-09;GY;Guyana;159;2;14362;325
2021-05-10;GY;Guyana;80;2;14442;327
2021-05-11;GY;Guyana;89;4;14531;331
2021-05-12;GY;Guyana;128;0;14659;331
2021-05-13;GY;Guyana;186;2;14845;333
2021-05-14;GY;Guyana;143;2;14988;335
2021-05-15;GY;Guyana;180;3;15168;338
2021-05-16;GY;Guyana;103;3;15271;341
2021-05-17;GY;Guyana;81;3;15352;344
2021-05-18;GY;Guyana;102;1;15454;345
2021-05-19;GY;Guyana;153;4;15607;349
2021-05-20;GY;Guyana;136;0;15743;349
2021-05-21;GY;Guyana;0;0;15743;349
2021-05-22;GY;Guyana;271;6;16014;355
2021-05-23;GY;Guyana;116;4;16130;359
2021-05-24;GY;Guyana;0;0;16130;359
2021-05-25;GY;Guyana;105;2;16235;361
2021-05-26;GY;Guyana;321;13;16556;374
2021-05-27;GY;Guyana;98;2;16654;376
2021-05-28;GY;Guyana;70;4;16724;380
2021-05-29;GY;Guyana;98;2;16822;382
2021-05-30;GY;Guyana;88;3;16910;385
2021-05-31;GY;Guyana;42;4;16952;389
2021-06-01;GY;Guyana;162;2;17114;391
2021-06-02;GY;Guyana;143;5;17257;396
2021-06-03;GY;Guyana;119;4;17376;400
2021-06-04;GY;Guyana;83;3;17459;403
2021-06-05;GY;Guyana;158;2;17617;405
2021-06-06;GY;Guyana;48;4;17665;409
2021-06-07;GY;Guyana;53;2;17718;411
2021-06-08;GY;Guyana;87;5;17805;416
2021-06-09;GY;Guyana;134;1;17939;417
2021-06-10;GY;Guyana;149;2;18088;419
2021-06-11;GY;Guyana;108;3;18196;422
2021-06-12;GY;Guyana;107;2;18303;424
2021-06-13;GY;Guyana;83;2;18386;426
2021-06-14;GY;Guyana;60;4;18446;430
2021-06-15;GY;Guyana;84;7;18530;437
2021-06-16;GY;Guyana;128;1;18658;438
2021-06-17;GY;Guyana;75;3;18733;441
2021-06-18;GY;Guyana;104;1;18837;442
2021-06-19;GY;Guyana;136;2;18973;444
2021-06-20;GY;Guyana;123;3;19096;447
2021-06-21;GY;Guyana;48;2;19144;449
2021-06-22;GY;Guyana;90;3;19234;452
2021-06-23;GY;Guyana;0;0;19234;452
2021-06-24;GY;Guyana;331;6;19565;458
2021-06-25;GY;Guyana;109;1;19674;459
2021-06-26;GY;Guyana;100;3;19774;462
2021-06-27;GY;Guyana;103;0;19877;462
2021-06-28;GY;Guyana;14;4;19891;466
2021-06-29;GY;Guyana;68;2;19959;468
2021-06-30;GY;Guyana;96;1;20055;469
2021-07-01;GY;Guyana;87;4;20142;473
2020-03-20;HT;Haiti;2;0;2;0
2020-03-21;HT;Haiti;0;0;2;0
2020-03-22;HT;Haiti;0;0;2;0
2020-03-23;HT;Haiti;0;0;2;0
2020-03-24;HT;Haiti;5;0;7;0
2020-03-25;HT;Haiti;0;0;7;0
2020-03-26;HT;Haiti;1;0;8;0
2020-03-27;HT;Haiti;0;0;8;0
2020-03-28;HT;Haiti;0;0;8;0
2020-03-29;HT;Haiti;0;0;8;0
2020-03-30;HT;Haiti;7;0;15;0
2020-03-31;HT;Haiti;0;0;15;0
2020-04-01;HT;Haiti;0;0;15;0
2020-04-02;HT;Haiti;1;0;16;0
2020-04-03;HT;Haiti;0;0;16;0
2020-04-04;HT;Haiti;2;0;18;0
2020-04-05;HT;Haiti;0;0;18;0
2020-04-06;HT;Haiti;3;0;21;0
2020-04-07;HT;Haiti;3;1;24;1
2020-04-08;HT;Haiti;1;0;25;1
2020-04-09;HT;Haiti;2;0;27;1
2020-04-10;HT;Haiti;3;1;30;2
2020-04-11;HT;Haiti;0;0;30;2
2020-04-12;HT;Haiti;1;0;31;2
2020-04-13;HT;Haiti;0;0;31;2
2020-04-14;HT;Haiti;9;1;40;3
2020-04-15;HT;Haiti;0;0;40;3
2020-04-16;HT;Haiti;1;0;41;3
2020-04-17;HT;Haiti;0;0;41;3
2020-04-18;HT;Haiti;2;0;43;3
2020-04-19;HT;Haiti;1;0;44;3
2020-04-20;HT;Haiti;0;0;44;3
2020-04-21;HT;Haiti;3;0;47;3
2020-04-22;HT;Haiti;10;0;57;3
2020-04-23;HT;Haiti;1;1;58;4
2020-04-24;HT;Haiti;4;-1;62;3
2020-04-25;HT;Haiti;10;2;72;5
2020-04-26;HT;Haiti;0;1;72;6
2020-04-27;HT;Haiti;0;0;72;6
2020-04-28;HT;Haiti;2;0;74;6
2020-04-29;HT;Haiti;2;0;76;6
2020-04-30;HT;Haiti;0;0;76;6
2020-05-01;HT;Haiti;0;1;76;7
2020-05-02;HT;Haiti;5;1;81;8
2020-05-03;HT;Haiti;4;0;85;8
2020-05-04;HT;Haiti;0;0;85;8
2020-05-05;HT;Haiti;3;1;88;9
2020-05-06;HT;Haiti;12;2;100;11
2020-05-07;HT;Haiti;1;1;101;12
2020-05-08;HT;Haiti;7;0;108;12
2020-05-09;HT;Haiti;21;0;129;12
2020-05-10;HT;Haiti;17;0;146;12
2020-05-11;HT;Haiti;5;0;151;12
2020-05-12;HT;Haiti;21;1;172;13
2020-05-13;HT;Haiti;37;3;209;16
2020-05-14;HT;Haiti;10;2;219;18
2020-05-15;HT;Haiti;15;0;234;18
2020-05-16;HT;Haiti;39;2;273;20
2020-05-17;HT;Haiti;37;0;310;20
2020-05-18;HT;Haiti;48;0;358;20
2020-05-19;HT;Haiti;98;0;456;20
2020-05-20;HT;Haiti;77;1;533;21
2020-05-21;HT;Haiti;63;1;596;22
2020-05-22;HT;Haiti;67;0;663;22
2020-05-23;HT;Haiti;71;3;734;25
2020-05-24;HT;Haiti;78;0;812;25
2020-05-25;HT;Haiti;53;1;865;26
2020-05-26;HT;Haiti;93;1;958;27
2020-05-27;HT;Haiti;105;4;1063;31
2020-05-28;HT;Haiti;111;2;1174;33
2020-05-29;HT;Haiti;146;1;1320;34
2020-05-30;HT;Haiti;123;1;1443;35
2020-05-31;HT;Haiti;141;0;1584;35
2020-06-01;HT;Haiti;281;6;1865;41
2020-06-02;HT;Haiti;259;3;2124;44
2020-06-03;HT;Haiti;102;1;2226;45
2020-06-04;HT;Haiti;281;3;2507;48
2020-06-05;HT;Haiti;97;2;2604;50
2020-06-06;HT;Haiti;36;0;2640;50
2020-06-07;HT;Haiti;284;0;2924;50
2020-06-08;HT;Haiti;148;0;3072;50
2020-06-09;HT;Haiti;262;1;3334;51
2020-06-10;HT;Haiti;204;3;3538;54
2020-06-11;HT;Haiti;124;2;3662;56
2020-06-12;HT;Haiti;134;2;3796;58
2020-06-13;HT;Haiti;145;6;3941;64
2020-06-14;HT;Haiti;0;0;3941;64
2020-06-15;HT;Haiti;224;6;4165;70
2020-06-16;HT;Haiti;144;3;4309;73
2020-06-17;HT;Haiti;132;3;4441;76
2020-06-18;HT;Haiti;106;4;4547;80
2020-06-19;HT;Haiti;141;2;4688;82
2020-06-20;HT;Haiti;228;2;4916;84
2020-06-21;HT;Haiti;64;3;4980;87
2020-06-22;HT;Haiti;97;1;5077;88
2020-06-23;HT;Haiti;134;0;5211;88
2020-06-24;HT;Haiti;5;0;5216;88
2020-06-25;HT;Haiti;108;1;5324;89
2020-06-26;HT;Haiti;105;3;5429;92
2020-06-27;HT;Haiti;114;4;5543;96
2020-06-28;HT;Haiti;179;2;5722;98
2020-06-29;HT;Haiti;0;0;5722;98
2020-06-30;HT;Haiti;125;6;5847;104
2020-07-01;HT;Haiti;86;1;5933;105
2020-07-02;HT;Haiti;42;0;5975;105
2020-07-03;HT;Haiti;65;2;6040;107
2020-07-04;HT;Haiti;61;3;6101;110
2020-07-05;HT;Haiti;129;0;6230;110
2020-07-06;HT;Haiti;64;3;6294;113
2020-07-07;HT;Haiti;39;0;6333;113
2020-07-08;HT;Haiti;38;0;6371;113
2020-07-09;HT;Haiti;61;4;6432;117
2020-07-10;HT;Haiti;54;6;6486;123
2020-07-11;HT;Haiti;96;7;6582;130
2020-07-12;HT;Haiti;35;5;6617;135
2020-07-13;HT;Haiti;73;4;6690;139
2020-07-14;HT;Haiti;37;0;6727;139
2020-07-15;HT;Haiti;0;2;6727;141
2020-07-16;HT;Haiti;104;2;6831;143
2020-07-17;HT;Haiti;71;2;6902;145
2020-07-18;HT;Haiti;46;0;6948;145
2020-07-19;HT;Haiti;27;1;6975;146
2020-07-20;HT;Haiti;78;0;7053;146
2020-07-21;HT;Haiti;10;0;7063;146
2020-07-22;HT;Haiti;37;5;7100;151
2020-07-23;HT;Haiti;46;3;7146;154
2020-07-24;HT;Haiti;21;0;7167;154
2020-07-25;HT;Haiti;30;0;7197;154
2020-07-26;HT;Haiti;63;2;7260;156
2020-07-27;HT;Haiti;37;1;7297;157
2020-07-28;HT;Haiti;18;0;7315;157
2020-07-29;HT;Haiti;25;1;7340;158
2020-07-30;HT;Haiti;31;0;7371;158
2020-07-31;HT;Haiti;7;1;7378;159
2020-08-01;HT;Haiti;34;2;7412;161
2020-08-02;HT;Haiti;12;0;7424;161
2020-08-03;HT;Haiti;44;4;7468;165
2020-08-04;HT;Haiti;8;0;7476;165
2020-08-05;HT;Haiti;35;1;7511;166
2020-08-06;HT;Haiti;21;5;7532;171
2020-08-07;HT;Haiti;12;0;7544;171
2020-08-08;HT;Haiti;38;0;7582;171
2020-08-09;HT;Haiti;17;6;7599;177
2020-08-10;HT;Haiti;12;5;7611;182
2020-08-11;HT;Haiti;23;1;7634;183
2020-08-12;HT;Haiti;15;0;7649;183
2020-08-13;HT;Haiti;94;4;7743;187
2020-08-14;HT;Haiti;38;5;7781;192
2020-08-15;HT;Haiti;29;0;7810;192
2020-08-16;HT;Haiti;21;4;7831;196
2020-08-17;HT;Haiti;48;0;7879;196
2020-08-18;HT;Haiti;18;0;7897;196
2020-08-19;HT;Haiti;24;0;7921;196
2020-08-20;HT;Haiti;28;0;7949;196
2020-08-21;HT;Haiti;48;0;7997;196
2020-08-22;HT;Haiti;19;0;8016;196
2020-08-23;HT;Haiti;34;0;8050;196
2020-08-24;HT;Haiti;32;0;8082;196
2020-08-25;HT;Haiti;28;0;8110;196
2020-08-26;HT;Haiti;2;0;8112;196
2020-08-27;HT;Haiti;10;1;8122;197
2020-08-28;HT;Haiti;29;3;8151;200
2020-08-29;HT;Haiti;10;1;8161;201
2020-08-30;HT;Haiti;13;0;8174;201
2020-08-31;HT;Haiti;35;0;8209;201
2020-09-01;HT;Haiti;15;0;8224;201
2020-09-02;HT;Haiti;0;0;8224;201
2020-09-03;HT;Haiti;34;5;8258;206
2020-09-04;HT;Haiti;0;0;8258;206
2020-09-05;HT;Haiti;68;6;8326;212
2020-09-06;HT;Haiti;0;0;8326;212
2020-09-07;HT;Haiti;34;2;8360;214
2020-09-08;HT;Haiti;0;0;8360;214
2020-09-09;HT;Haiti;2;0;8362;214
2020-09-10;HT;Haiti;14;0;8376;214
2020-09-11;HT;Haiti;53;1;8429;215
2020-09-12;HT;Haiti;28;1;8457;216
2020-09-13;HT;Haiti;0;0;8457;216
2020-09-14;HT;Haiti;21;3;8478;219
2020-09-15;HT;Haiti;15;0;8493;219
2020-09-16;HT;Haiti;6;0;8499;219
2020-09-17;HT;Haiti;31;1;8530;220
2020-09-18;HT;Haiti;26;0;8556;220
2020-09-19;HT;Haiti;0;0;8556;220
2020-09-20;HT;Haiti;44;1;8600;221
2020-09-21;HT;Haiti;0;0;8600;221
2020-09-22;HT;Haiti;24;0;8624;221
2020-09-23;HT;Haiti;0;0;8624;221
2020-09-24;HT;Haiti;22;4;8646;225
2020-09-25;HT;Haiti;0;0;8646;225
2020-09-26;HT;Haiti;38;2;8684;227
2020-09-27;HT;Haiti;0;0;8684;227
2020-09-28;HT;Haiti;39;0;8723;227
2020-09-29;HT;Haiti;17;0;8740;227
2020-09-30;HT;Haiti;0;0;8740;227
2020-10-01;HT;Haiti;26;2;8766;229
2020-10-02;HT;Haiti;0;0;8766;229
2020-10-03;HT;Haiti;26;0;8792;229
2020-10-04;HT;Haiti;0;0;8792;229
2020-10-05;HT;Haiti;27;0;8819;229
2020-10-06;HT;Haiti;0;0;8819;229
2020-10-07;HT;Haiti;0;0;8819;229
2020-10-08;HT;Haiti;19;0;8838;229
2020-10-09;HT;Haiti;16;1;8854;230
2020-10-10;HT;Haiti;0;0;8854;230
2020-10-11;HT;Haiti;6;0;8860;230
2020-10-12;HT;Haiti;22;0;8882;230
2020-10-13;HT;Haiti;0;0;8882;230
2020-10-14;HT;Haiti;5;0;8887;230
2020-10-15;HT;Haiti;21;1;8908;231
2020-10-16;HT;Haiti;0;0;8908;231
2020-10-17;HT;Haiti;17;0;8925;231
2020-10-18;HT;Haiti;0;0;8925;231
2020-10-19;HT;Haiti;0;0;8925;231
2020-10-20;HT;Haiti;0;0;8925;231
2020-10-21;HT;Haiti;51;0;8976;231
2020-10-22;HT;Haiti;3;0;8979;231
2020-10-23;HT;Haiti;0;0;8979;231
2020-10-24;HT;Haiti;20;0;8999;231
2020-10-25;HT;Haiti;16;0;9015;231
2020-10-26;HT;Haiti;11;1;9026;232
2020-10-27;HT;Haiti;0;0;9026;232
2020-10-28;HT;Haiti;0;0;9026;232
2020-10-29;HT;Haiti;20;0;9046;232
2020-10-30;HT;Haiti;8;0;9054;232
2020-10-31;HT;Haiti;0;0;9054;232
2020-11-01;HT;Haiti;0;0;9054;232
2020-11-02;HT;Haiti;0;0;9054;232
2020-11-03;HT;Haiti;0;0;9054;232
2020-11-04;HT;Haiti;0;0;9054;232
2020-11-05;HT;Haiti;46;0;9100;232
2020-11-06;HT;Haiti;9;0;9109;232
2020-11-07;HT;Haiti;0;0;9109;232
2020-11-08;HT;Haiti;18;0;9127;232
2020-11-09;HT;Haiti;0;0;9127;232
2020-11-10;HT;Haiti;0;0;9127;232
2020-11-11;HT;Haiti;10;0;9137;232
2020-11-12;HT;Haiti;15;0;9152;232
2020-11-13;HT;Haiti;0;0;9152;232
2020-11-14;HT;Haiti;16;0;9168;232
2020-11-15;HT;Haiti;0;0;9168;232
2020-11-16;HT;Haiti;11;0;9179;232
2020-11-17;HT;Haiti;9;0;9188;232
2020-11-18;HT;Haiti;3;0;9191;232
2020-11-19;HT;Haiti;0;0;9191;232
2020-11-20;HT;Haiti;17;0;9208;232
2020-11-21;HT;Haiti;3;0;9211;232
2020-11-22;HT;Haiti;3;0;9214;232
2020-11-23;HT;Haiti;0;0;9214;232
2020-11-24;HT;Haiti;10;0;9224;232
2020-11-25;HT;Haiti;5;0;9229;232
2020-11-26;HT;Haiti;19;0;9248;232
2020-11-27;HT;Haiti;8;0;9256;232
2020-11-28;HT;Haiti;8;0;9264;232
2020-11-29;HT;Haiti;0;0;9264;232
2020-11-30;HT;Haiti;8;0;9272;232
2020-12-01;HT;Haiti;22;1;9294;233
2020-12-02;HT;Haiti;2;0;9296;233
2020-12-03;HT;Haiti;7;0;9303;233
2020-12-04;HT;Haiti;10;0;9313;233
2020-12-05;HT;Haiti;34;0;9347;233
2020-12-06;HT;Haiti;23;0;9370;233
2020-12-07;HT;Haiti;0;0;9370;233
2020-12-08;HT;Haiti;29;0;9399;233
2020-12-09;HT;Haiti;0;0;9399;233
2020-12-10;HT;Haiti;35;0;9434;233
2020-12-11;HT;Haiti;0;0;9434;233
2020-12-12;HT;Haiti;31;0;9465;233
2020-12-13;HT;Haiti;26;0;9491;233
2020-12-14;HT;Haiti;18;1;9509;234
2020-12-15;HT;Haiti;56;0;9565;234
2020-12-16;HT;Haiti;32;0;9597;234
2020-12-17;HT;Haiti;0;0;9597;234
2020-12-18;HT;Haiti;30;0;9627;234
2020-12-19;HT;Haiti;21;0;9648;234
2020-12-20;HT;Haiti;26;0;9674;234
2020-12-21;HT;Haiti;0;0;9674;234
2020-12-22;HT;Haiti;97;0;9771;234
2020-12-23;HT;Haiti;34;1;9805;235
2020-12-24;HT;Haiti;41;0;9846;235
2020-12-25;HT;Haiti;0;0;9846;235
2020-12-26;HT;Haiti;0;0;9846;235
2020-12-27;HT;Haiti;0;0;9846;235
2020-12-28;HT;Haiti;112;1;9958;236
2020-12-29;HT;Haiti;0;0;9958;236
2020-12-30;HT;Haiti;41;0;9999;236
2020-12-31;HT;Haiti;0;0;9999;236
2021-01-01;HT;Haiti;16;0;10015;236
2021-01-02;HT;Haiti;0;0;10015;236
2021-01-03;HT;Haiti;62;0;10077;236
2021-01-04;HT;Haiti;50;0;10127;236
2021-01-05;HT;Haiti;0;0;10127;236
2021-01-06;HT;Haiti;0;0;10127;236
2021-01-07;HT;Haiti;0;0;10127;236
2021-01-08;HT;Haiti;76;0;10203;236
2021-01-09;HT;Haiti;38;1;10241;237
2021-01-10;HT;Haiti;0;0;10241;237
2021-01-11;HT;Haiti;31;1;10272;238
2021-01-12;HT;Haiti;0;0;10272;238
2021-01-13;HT;Haiti;114;0;10386;238
2021-01-14;HT;Haiti;29;0;10415;238
2021-01-15;HT;Haiti;154;0;10569;238
2021-01-16;HT;Haiti;66;0;10635;238
2021-01-17;HT;Haiti;146;2;10781;240
2021-01-18;HT;Haiti;0;0;10781;240
2021-01-19;HT;Haiti;71;0;10852;240
2021-01-20;HT;Haiti;55;0;10907;240
2021-01-21;HT;Haiti;56;0;10963;240
2021-01-22;HT;Haiti;0;0;10963;240
2021-01-23;HT;Haiti;72;3;11035;243
2021-01-24;HT;Haiti;64;0;11099;243
2021-01-25;HT;Haiti;0;0;11099;243
2021-01-26;HT;Haiti;187;0;11286;243
2021-01-27;HT;Haiti;0;0;11286;243
2021-01-28;HT;Haiti;0;0;11286;243
2021-01-29;HT;Haiti;116;1;11402;244
2021-01-30;HT;Haiti;58;1;11460;245
2021-01-31;HT;Haiti;73;0;11533;245
2021-02-01;HT;Haiti;0;0;11533;245
2021-02-02;HT;Haiti;57;0;11590;245
2021-02-03;HT;Haiti;82;0;11672;245
2021-02-04;HT;Haiti;20;0;11692;245
2021-02-05;HT;Haiti;0;0;11692;245
2021-02-06;HT;Haiti;66;0;11758;245
2021-02-07;HT;Haiti;48;1;11806;246
2021-02-08;HT;Haiti;0;0;11806;246
2021-02-09;HT;Haiti;102;0;11908;246
2021-02-10;HT;Haiti;61;0;11969;246
2021-02-11;HT;Haiti;22;0;11991;246
2021-02-12;HT;Haiti;25;0;12016;246
2021-02-13;HT;Haiti;0;0;12016;246
2021-02-14;HT;Haiti;127;1;12143;247
2021-02-15;HT;Haiti;0;0;12143;247
2021-02-16;HT;Haiti;49;0;12192;247
2021-02-17;HT;Haiti;14;0;12206;247
2021-02-18;HT;Haiti;0;0;12206;247
2021-02-19;HT;Haiti;0;0;12206;247
2021-02-20;HT;Haiti;48;0;12254;247
2021-02-21;HT;Haiti;20;0;12274;247
2021-02-22;HT;Haiti;35;0;12309;247
2021-02-23;HT;Haiti;0;0;12309;247
2021-02-24;HT;Haiti;43;0;12352;247
2021-02-25;HT;Haiti;0;0;12352;247
2021-02-26;HT;Haiti;0;0;12352;247
2021-02-27;HT;Haiti;78;3;12430;250
2021-02-28;HT;Haiti;0;0;12430;250
2021-03-01;HT;Haiti;18;0;12448;250
2021-03-02;HT;Haiti;45;0;12493;250
2021-03-03;HT;Haiti;38;0;12531;250
2021-03-04;HT;Haiti;5;0;12536;250
2021-03-05;HT;Haiti;0;0;12536;250
2021-03-06;HT;Haiti;0;1;12536;251
2021-03-07;HT;Haiti;0;0;12536;251
2021-03-08;HT;Haiti;0;0;12536;251
2021-03-09;HT;Haiti;0;0;12536;251
2021-03-10;HT;Haiti;58;0;12594;251
2021-03-11;HT;Haiti;0;0;12594;251
2021-03-12;HT;Haiti;38;0;12632;251
2021-03-13;HT;Haiti;0;-1;12632;250
2021-03-14;HT;Haiti;0;0;12632;250
2021-03-15;HT;Haiti;0;0;12632;250
2021-03-16;HT;Haiti;32;0;12664;250
2021-03-17;HT;Haiti;5;0;12669;250
2021-03-18;HT;Haiti;17;1;12686;251
2021-03-19;HT;Haiti;2;0;12688;251
2021-03-20;HT;Haiti;12;0;12700;251
2021-03-21;HT;Haiti;14;0;12714;251
2021-03-22;HT;Haiti;0;0;12714;251
2021-03-23;HT;Haiti;8;0;12722;251
2021-03-24;HT;Haiti;10;0;12732;251
2021-03-25;HT;Haiti;0;0;12732;251
2021-03-26;HT;Haiti;4;0;12736;251
2021-03-27;HT;Haiti;0;0;12736;251
2021-03-28;HT;Haiti;0;1;12736;252
2021-03-29;HT;Haiti;0;0;12736;252
2021-03-30;HT;Haiti;22;-1;12758;251
2021-03-31;HT;Haiti;0;1;12758;252
2021-04-01;HT;Haiti;4;0;12762;252
2021-04-02;HT;Haiti;26;0;12788;252
2021-04-03;HT;Haiti;0;0;12788;252
2021-04-04;HT;Haiti;0;0;12788;252
2021-04-05;HT;Haiti;0;0;12788;252
2021-04-06;HT;Haiti;15;0;12803;252
2021-04-07;HT;Haiti;0;0;12803;252
2021-04-08;HT;Haiti;0;0;12803;252
2021-04-09;HT;Haiti;13;0;12816;252
2021-04-10;HT;Haiti;24;0;12840;252
2021-04-11;HT;Haiti;0;0;12840;252
2021-04-12;HT;Haiti;0;0;12840;252
2021-04-13;HT;Haiti;15;-1;12855;251
2021-04-14;HT;Haiti;0;0;12855;251
2021-04-15;HT;Haiti;2;1;12857;252
2021-04-16;HT;Haiti;19;0;12876;252
2021-04-17;HT;Haiti;9;-1;12885;251
2021-04-18;HT;Haiti;33;0;12918;251
2021-04-19;HT;Haiti;0;0;12918;251
2021-04-20;HT;Haiti;0;0;12918;251
2021-04-21;HT;Haiti;0;0;12918;251
2021-04-22;HT;Haiti;26;0;12944;251
2021-04-23;HT;Haiti;0;0;12944;251
2021-04-24;HT;Haiti;0;0;12944;251
2021-04-25;HT;Haiti;14;0;12958;251
2021-04-26;HT;Haiti;0;1;12958;252
2021-04-27;HT;Haiti;41;1;12999;253
2021-04-28;HT;Haiti;18;1;13017;254
2021-04-29;HT;Haiti;0;0;13017;254
2021-04-30;HT;Haiti;39;0;13056;254
2021-05-01;HT;Haiti;0;0;13056;254
2021-05-02;HT;Haiti;38;0;13094;254
2021-05-03;HT;Haiti;0;0;13094;254
2021-05-04;HT;Haiti;41;3;13135;257
2021-05-05;HT;Haiti;14;3;13149;260
2021-05-06;HT;Haiti;15;3;13164;263
2021-05-07;HT;Haiti;0;0;13164;263
2021-05-08;HT;Haiti;0;0;13164;263
2021-05-09;HT;Haiti;0;0;13164;263
2021-05-10;HT;Haiti;0;0;13164;263
2021-05-11;HT;Haiti;15;1;13179;264
2021-05-12;HT;Haiti;48;2;13227;266
2021-05-13;HT;Haiti;28;2;13255;268
2021-05-14;HT;Haiti;13;1;13268;269
2021-05-15;HT;Haiti;85;2;13353;271
2021-05-16;HT;Haiti;40;0;13393;271
2021-05-17;HT;Haiti;67;0;13460;271
2021-05-18;HT;Haiti;60;3;13520;274
2021-05-19;HT;Haiti;78;2;13598;276
2021-05-20;HT;Haiti;0;0;13598;276
2021-05-21;HT;Haiti;26;0;13624;276
2021-05-22;HT;Haiti;0;0;13624;276
2021-05-23;HT;Haiti;111;4;13735;280
2021-05-24;HT;Haiti;171;8;13906;288
2021-05-25;HT;Haiti;0;0;13906;288
2021-05-26;HT;Haiti;131;4;14037;292
2021-05-27;HT;Haiti;0;0;14037;292
2021-05-28;HT;Haiti;0;0;14037;292
2021-05-29;HT;Haiti;91;10;14128;302
2021-05-30;HT;Haiti;130;5;14258;307
2021-05-31;HT;Haiti;93;2;14351;309
2021-06-01;HT;Haiti;214;8;14565;317
2021-06-02;HT;Haiti;146;2;14711;319
2021-06-03;HT;Haiti;220;2;14931;321
2021-06-04;HT;Haiti;127;0;15058;321
2021-06-05;HT;Haiti;65;0;15123;321
2021-06-06;HT;Haiti;159;2;15282;323
2021-06-07;HT;Haiti;153;2;15435;325
2021-06-08;HT;Haiti;460;8;15895;333
2021-06-09;HT;Haiti;106;9;16001;342
2021-06-10;HT;Haiti;0;0;16001;342
2021-06-11;HT;Haiti;78;4;16079;346
2021-06-12;HT;Haiti;0;0;16079;346
2021-06-13;HT;Haiti;0;0;16079;346
2021-06-14;HT;Haiti;482;9;16561;355
2021-06-15;HT;Haiti;101;3;16662;358
2021-06-16;HT;Haiti;0;0;16662;358
2021-06-17;HT;Haiti;197;3;16859;361
2021-06-18;HT;Haiti;0;0;16859;361
2021-06-19;HT;Haiti;0;0;16859;361
2021-06-20;HT;Haiti;0;0;16859;361
2021-06-21;HT;Haiti;202;8;17061;369
2021-06-22;HT;Haiti;0;0;17061;369
2021-06-23;HT;Haiti;542;19;17603;388
2021-06-24;HT;Haiti;0;0;17603;388
2021-06-25;HT;Haiti;360;12;17963;400
2021-06-26;HT;Haiti;0;0;17963;400
2021-06-27;HT;Haiti;0;0;17963;400
2021-06-28;HT;Haiti;249;13;18212;413
2021-06-29;HT;Haiti;129;2;18341;415
2021-06-30;HT;Haiti;221;10;18562;425
2021-07-01;HT;Haiti;96;11;18658;436
2020-03-11;HN;Honduras;2;0;2;0
2020-03-12;HN;Honduras;0;0;2;0
2020-03-13;HN;Honduras;0;0;2;0
2020-03-14;HN;Honduras;0;0;2;0
2020-03-15;HN;Honduras;1;0;3;0
2020-03-16;HN;Honduras;3;0;6;0
2020-03-17;HN;Honduras;2;0;8;0
2020-03-18;HN;Honduras;1;0;9;0
2020-03-19;HN;Honduras;3;0;12;0
2020-03-20;HN;Honduras;12;0;24;0
2020-03-21;HN;Honduras;0;0;24;0
2020-03-22;HN;Honduras;2;0;26;0
2020-03-23;HN;Honduras;4;0;30;0
2020-03-24;HN;Honduras;0;0;30;0
2020-03-25;HN;Honduras;6;0;36;0
2020-03-26;HN;Honduras;16;1;52;1
2020-03-27;HN;Honduras;16;0;68;1
2020-03-28;HN;Honduras;27;0;95;1
2020-03-29;HN;Honduras;15;2;110;3
2020-03-30;HN;Honduras;29;4;139;7
2020-03-31;HN;Honduras;2;0;141;7
2020-04-01;HN;Honduras;31;3;172;10
2020-04-02;HN;Honduras;47;4;219;14
2020-04-03;HN;Honduras;3;1;222;15
2020-04-04;HN;Honduras;42;0;264;15
2020-04-05;HN;Honduras;4;7;268;22
2020-04-06;HN;Honduras;30;0;298;22
2020-04-07;HN;Honduras;7;0;305;22
2020-04-08;HN;Honduras;7;0;312;22
2020-04-09;HN;Honduras;31;1;343;23
2020-04-10;HN;Honduras;39;0;382;23
2020-04-11;HN;Honduras;10;1;392;24
2020-04-12;HN;Honduras;1;1;393;25
2020-04-13;HN;Honduras;4;0;397;25
2020-04-14;HN;Honduras;10;1;407;26
2020-04-15;HN;Honduras;12;5;419;31
2020-04-16;HN;Honduras;7;4;426;35
2020-04-17;HN;Honduras;16;6;442;41
2020-04-18;HN;Honduras;15;5;457;46
2020-04-19;HN;Honduras;15;0;472;46
2020-04-20;HN;Honduras;5;0;477;46
2020-04-21;HN;Honduras;17;0;494;46
2020-04-22;HN;Honduras;16;0;510;46
2020-04-23;HN;Honduras;9;1;519;47
2020-04-24;HN;Honduras;72;8;591;55
2020-04-25;HN;Honduras;36;4;627;59
2020-04-26;HN;Honduras;0;0;627;59
2020-04-27;HN;Honduras;34;2;661;61
2020-04-28;HN;Honduras;41;3;702;64
2020-04-29;HN;Honduras;36;2;738;66
2020-04-30;HN;Honduras;33;5;771;71
2020-05-01;HN;Honduras;33;4;804;75
2020-05-02;HN;Honduras;206;1;1010;76
2020-05-03;HN;Honduras;45;6;1055;82
2020-05-04;HN;Honduras;123;1;1178;83
2020-05-05;HN;Honduras;92;10;1270;93
2020-05-06;HN;Honduras;191;6;1461;99
2020-05-07;HN;Honduras;224;6;1685;105
2020-05-08;HN;Honduras;86;2;1771;107
2020-05-09;HN;Honduras;59;1;1830;108
2020-05-10;HN;Honduras;142;0;1972;108
2020-05-11;HN;Honduras;128;8;2100;116
2020-05-12;HN;Honduras;-20;5;2080;121
2020-05-13;HN;Honduras;175;2;2255;123
2020-05-14;HN;Honduras;63;10;2318;133
2020-05-15;HN;Honduras;142;1;2460;134
2020-05-16;HN;Honduras;105;4;2565;138
2020-05-17;HN;Honduras;81;4;2646;142
2020-05-18;HN;Honduras;152;4;2798;146
2020-05-19;HN;Honduras;157;1;2955;147
2020-05-20;HN;Honduras;0;0;2955;147
2020-05-21;HN;Honduras;249;9;3204;156
2020-05-22;HN;Honduras;273;11;3477;167
2020-05-23;HN;Honduras;0;0;3477;167
2020-05-24;HN;Honduras;473;13;3950;180
2020-05-25;HN;Honduras;239;2;4189;182
2020-05-26;HN;Honduras;212;6;4401;188
2020-05-27;HN;Honduras;239;6;4640;194
2020-05-28;HN;Honduras;112;2;4752;196
2020-05-29;HN;Honduras;0;0;4752;196
2020-05-30;HN;Honduras;342;5;5094;201
2020-05-31;HN;Honduras;108;11;5202;212
2020-06-01;HN;Honduras;160;5;5362;217
2020-06-02;HN;Honduras;165;8;5527;225
2020-06-03;HN;Honduras;163;9;5690;234
2020-06-04;HN;Honduras;190;9;5880;243
2020-06-05;HN;Honduras;91;5;5971;248
2020-06-06;HN;Honduras;184;2;6155;250
2020-06-07;HN;Honduras;172;8;6327;258
2020-06-08;HN;Honduras;123;4;6450;262
2020-06-09;HN;Honduras;485;9;6935;271
2020-06-10;HN;Honduras;425;19;7360;290
2020-06-11;HN;Honduras;309;4;7669;294
2020-06-12;HN;Honduras;463;12;8132;306
2020-06-13;HN;Honduras;323;4;8455;310
2020-06-14;HN;Honduras;403;2;8858;312
2020-06-15;HN;Honduras;320;10;9178;322
2020-06-16;HN;Honduras;478;8;9656;330
2020-06-17;HN;Honduras;643;6;10299;336
2020-06-18;HN;Honduras;440;7;10739;343
2020-06-19;HN;Honduras;519;6;11258;349
2020-06-20;HN;Honduras;1048;9;12306;358
2020-06-21;HN;Honduras;463;5;12769;363
2020-06-22;HN;Honduras;587;32;13356;395
2020-06-23;HN;Honduras;587;10;13943;405
2020-06-24;HN;Honduras;628;12;14571;417
2020-06-25;HN;Honduras;795;9;15366;426
2020-06-26;HN;Honduras;628;45;15994;471
2020-06-27;HN;Honduras;1013;8;17007;479
2020-06-28;HN;Honduras;1075;0;18082;479
2020-06-29;HN;Honduras;736;6;18818;485
2020-06-30;HN;Honduras;740;12;19558;497
2020-07-01;HN;Honduras;704;45;20262;542
2020-07-02;HN;Honduras;858;49;21120;591
2020-07-03;HN;Honduras;996;14;22116;605
2020-07-04;HN;Honduras;805;24;22921;629
2020-07-05;HN;Honduras;1022;10;23943;639
2020-07-06;HN;Honduras;722;17;24665;656
2020-07-07;HN;Honduras;763;21;25428;677
2020-07-08;HN;Honduras;550;17;25978;694
2020-07-09;HN;Honduras;406;10;26384;704
2020-07-10;HN;Honduras;669;46;27053;750
2020-07-11;HN;Honduras;530;21;27583;771
2020-07-12;HN;Honduras;507;3;28090;774
2020-07-13;HN;Honduras;489;15;28579;789
2020-07-14;HN;Honduras;527;18;29106;807
2020-07-15;HN;Honduras;930;18;30036;825
2020-07-16;HN;Honduras;831;10;30867;835
2020-07-17;HN;Honduras;878;22;31745;857
2020-07-18;HN;Honduras;1048;34;32793;891
2020-07-19;HN;Honduras;1042;9;33835;900
2020-07-20;HN;Honduras;776;35;34611;935
2020-07-21;HN;Honduras;734;53;35345;988
2020-07-22;HN;Honduras;757;18;36102;1006
2020-07-23;HN;Honduras;800;5;36902;1011
2020-07-24;HN;Honduras;657;50;37559;1061
2020-07-25;HN;Honduras;879;37;38438;1098
2020-07-26;HN;Honduras;838;18;39276;1116
2020-07-27;HN;Honduras;465;50;39741;1166
2020-07-28;HN;Honduras;719;48;40460;1214
2020-07-29;HN;Honduras;484;45;40944;1259
2020-07-30;HN;Honduras;482;53;41426;1312
2020-07-31;HN;Honduras;588;25;42014;1337
2020-08-01;HN;Honduras;671;31;42685;1368
2020-08-02;HN;Honduras;512;9;43197;1377
2020-08-03;HN;Honduras;597;7;43794;1384
2020-08-04;HN;Honduras;505;16;44299;1400
2020-08-05;HN;Honduras;799;23;45098;1423
2020-08-06;HN;Honduras;657;23;45755;1446
2020-08-07;HN;Honduras;610;19;46365;1465
2020-08-08;HN;Honduras;608;11;46973;1476
2020-08-09;HN;Honduras;481;19;47454;1495
2020-08-10;HN;Honduras;418;11;47872;1506
2020-08-11;HN;Honduras;531;9;48403;1515
2020-08-12;HN;Honduras;254;18;48657;1533
2020-08-13;HN;Honduras;385;9;49042;1542
2020-08-14;HN;Honduras;425;6;49467;1548
2020-08-15;HN;Honduras;512;19;49979;1567
2020-08-16;HN;Honduras;523;8;50502;1575
2020-08-17;HN;Honduras;493;8;50995;1583
2020-08-18;HN;Honduras;675;10;51670;1593
2020-08-19;HN;Honduras;628;15;52298;1608
2020-08-20;HN;Honduras;521;11;52819;1619
2020-08-21;HN;Honduras;562;13;53381;1632
2020-08-22;HN;Honduras;602;11;53983;1643
2020-08-23;HN;Honduras;528;11;54511;1654
2020-08-24;HN;Honduras;968;29;55479;1683
2020-08-25;HN;Honduras;398;20;55877;1703
2020-08-26;HN;Honduras;772;44;56649;1747
2020-08-27;HN;Honduras;1020;56;57669;1803
2020-08-28;HN;Honduras;1141;24;58810;1827
2020-08-29;HN;Honduras;835;15;59645;1842
2020-08-30;HN;Honduras;529;16;60174;1858
2020-08-31;HN;Honduras;840;15;61014;1873
2020-09-01;HN;Honduras;755;15;61769;1888
2020-09-02;HN;Honduras;757;36;62526;1924
2020-09-03;HN;Honduras;632;30;63158;1954
2020-09-04;HN;Honduras;640;30;63798;1984
2020-09-05;HN;Honduras;554;22;64352;2006
2020-09-06;HN;Honduras;412;1;64764;2007
2020-09-07;HN;Honduras;50;16;64814;2023
2020-09-08;HN;Honduras;404;11;65218;2034
2020-09-09;HN;Honduras;379;10;65597;2044
2020-09-10;HN;Honduras;205;5;65802;2049
2020-09-11;HN;Honduras;247;9;66049;2058
2020-09-12;HN;Honduras;1087;7;67136;2065
2020-09-13;HN;Honduras;653;14;67789;2079
2020-09-14;HN;Honduras;831;8;68620;2087
2020-09-15;HN;Honduras;0;0;68620;2087
2020-09-16;HN;Honduras;1040;15;69660;2102
2020-09-17;HN;Honduras;460;20;70120;2122
2020-09-18;HN;Honduras;491;24;70611;2146
2020-09-19;HN;Honduras;532;20;71143;2166
2020-09-20;HN;Honduras;473;18;71616;2184
2020-09-21;HN;Honduras;459;20;72075;2204
2020-09-22;HN;Honduras;231;2;72306;2206
2020-09-23;HN;Honduras;369;16;72675;2222
2020-09-24;HN;Honduras;518;27;73193;2249
2020-09-25;HN;Honduras;647;22;73840;2271
2020-09-26;HN;Honduras;708;17;74548;2288
2020-09-27;HN;Honduras;0;0;74548;2288
2020-09-28;HN;Honduras;989;13;75537;2301
2020-09-29;HN;Honduras;561;22;76098;2323
2020-09-30;HN;Honduras;802;30;76900;2353
2020-10-01;HN;Honduras;698;27;77598;2380
2020-10-02;HN;Honduras;671;6;78269;2386
2020-10-03;HN;Honduras;519;13;78788;2399
2020-10-04;HN;Honduras;841;23;79629;2422
2020-10-05;HN;Honduras;391;11;80020;2433
2020-10-06;HN;Honduras;642;14;80662;2447
2020-10-07;HN;Honduras;354;19;81016;2466
2020-10-08;HN;Honduras;656;11;81672;2477
2020-10-09;HN;Honduras;880;15;82552;2492
2020-10-10;HN;Honduras;594;12;83146;2504
2020-10-11;HN;Honduras;935;8;84081;2512
2020-10-12;HN;Honduras;332;9;84413;2521
2020-10-13;HN;Honduras;439;7;84852;2528
2020-10-14;HN;Honduras;606;5;85458;2533
2020-10-15;HN;Honduras;631;19;86089;2552
2020-10-16;HN;Honduras;602;4;86691;2556
2020-10-17;HN;Honduras;903;7;87594;2563
2020-10-18;HN;Honduras;831;5;88425;2568
2020-10-19;HN;Honduras;956;8;89381;2576
2020-10-20;HN;Honduras;851;6;90232;2582
2020-10-21;HN;Honduras;846;14;91078;2596
2020-10-22;HN;Honduras;431;8;91509;2604
2020-10-23;HN;Honduras;0;0;91509;2604
2020-10-24;HN;Honduras;1215;13;92724;2617
2020-10-25;HN;Honduras;490;6;93214;2623
2020-10-26;HN;Honduras;752;10;93966;2633
2020-10-27;HN;Honduras;657;6;94623;2639
2020-10-28;HN;Honduras;576;13;95199;2652
2020-10-29;HN;Honduras;951;9;96150;2661
2020-10-30;HN;Honduras;738;8;96888;2669
2020-10-31;HN;Honduras;0;0;96888;2669
2020-11-01;HN;Honduras;1324;6;98212;2675
2020-11-02;HN;Honduras;193;13;98405;2688
2020-11-03;HN;Honduras;283;18;98688;2706
2020-11-04;HN;Honduras;436;24;99124;2730
2020-11-05;HN;Honduras;223;6;99347;2736
2020-11-06;HN;Honduras;229;5;99576;2741
2020-11-07;HN;Honduras;465;4;100041;2745
2020-11-08;HN;Honduras;0;0;100041;2745
2020-11-09;HN;Honduras;532;20;100573;2765
2020-11-10;HN;Honduras;231;15;100804;2780
2020-11-11;HN;Honduras;365;17;101169;2797
2020-11-12;HN;Honduras;299;7;101468;2804
2020-11-13;HN;Honduras;611;16;102079;2820
2020-11-14;HN;Honduras;476;2;102555;2822
2020-11-15;HN;Honduras;547;1;103102;2823
2020-11-16;HN;Honduras;137;16;103239;2839
2020-11-17;HN;Honduras;249;0;103488;2839
2020-11-18;HN;Honduras;0;0;103488;2839
2020-11-19;HN;Honduras;0;0;103488;2839
2020-11-20;HN;Honduras;63;14;103551;2853
2020-11-21;HN;Honduras;884;4;104435;2857
2020-11-22;HN;Honduras;0;0;104435;2857
2020-11-23;HN;Honduras;776;12;105211;2869
2020-11-24;HN;Honduras;0;0;105211;2869
2020-11-25;HN;Honduras;905;19;106116;2888
2020-11-26;HN;Honduras;565;4;106681;2892
2020-11-27;HN;Honduras;453;7;107134;2899
2020-11-28;HN;Honduras;379;6;107513;2905
2020-11-29;HN;Honduras;375;4;107888;2909
2020-11-30;HN;Honduras;365;9;108253;2918
2020-12-01;HN;Honduras;0;0;108253;2918
2020-12-02;HN;Honduras;891;12;109144;2930
2020-12-03;HN;Honduras;616;8;109760;2938
2020-12-04;HN;Honduras;0;0;109760;2938
2020-12-05;HN;Honduras;200;3;109960;2941
2020-12-06;HN;Honduras;1063;5;111023;2946
2020-12-07;HN;Honduras;0;0;111023;2946
2020-12-08;HN;Honduras;684;4;111707;2950
2020-12-09;HN;Honduras;1085;11;112792;2961
2020-12-10;HN;Honduras;415;7;113207;2968
2020-12-11;HN;Honduras;501;3;113708;2971
2020-12-12;HN;Honduras;335;3;114043;2974
2020-12-13;HN;Honduras;316;1;114359;2975
2020-12-14;HN;Honduras;283;14;114642;2989
2020-12-15;HN;Honduras;301;12;114943;3001
2020-12-16;HN;Honduras;374;12;115317;3013
2020-12-17;HN;Honduras;157;8;115474;3021
2020-12-18;HN;Honduras;738;2;116212;3023
2020-12-19;HN;Honduras;0;0;116212;3023
2020-12-20;HN;Honduras;810;4;117022;3027
2020-12-21;HN;Honduras;168;7;117190;3034
2020-12-22;HN;Honduras;398;12;117588;3046
2020-12-23;HN;Honduras;448;8;118036;3054
2020-12-24;HN;Honduras;0;0;118036;3054
2020-12-25;HN;Honduras;623;7;118659;3061
2020-12-26;HN;Honduras;438;4;119097;3065
2020-12-27;HN;Honduras;0;0;119097;3065
2020-12-28;HN;Honduras;616;1;119713;3066
2020-12-29;HN;Honduras;1199;45;120912;3111
2020-12-30;HN;Honduras;0;0;120912;3111
2020-12-31;HN;Honduras;915;19;121827;3130
2021-01-01;HN;Honduras;1147;30;122974;3160
2021-01-02;HN;Honduras;170;13;123144;3173
2021-01-03;HN;Honduras;225;7;123369;3180
2021-01-04;HN;Honduras;29;1;123398;3181
2021-01-05;HN;Honduras;424;5;123822;3186
2021-01-06;HN;Honduras;1077;6;124899;3192
2021-01-07;HN;Honduras;219;8;125118;3200
2021-01-08;HN;Honduras;439;44;125557;3244
2021-01-09;HN;Honduras;1386;20;126943;3264
2021-01-10;HN;Honduras;1002;9;127945;3273
2021-01-11;HN;Honduras;756;12;128701;3285
2021-01-12;HN;Honduras;1104;9;129805;3294
2021-01-13;HN;Honduras;1204;26;131009;3320
2021-01-14;HN;Honduras;954;15;131963;3335
2021-01-15;HN;Honduras;449;9;132412;3344
2021-01-16;HN;Honduras;1095;4;133507;3348
2021-01-17;HN;Honduras;604;6;134111;3354
2021-01-18;HN;Honduras;827;14;134938;3368
2021-01-19;HN;Honduras;1130;23;136068;3391
2021-01-20;HN;Honduras;830;15;136898;3406
2021-01-21;HN;Honduras;1146;16;138044;3422
2021-01-22;HN;Honduras;1138;17;139182;3439
2021-01-23;HN;Honduras;1056;2;140238;3441
2021-01-24;HN;Honduras;691;6;140929;3447
2021-01-25;HN;Honduras;1055;15;141984;3462
2021-01-26;HN;Honduras;896;24;142880;3486
2021-01-27;HN;Honduras;1127;26;144007;3512
2021-01-28;HN;Honduras;985;37;144992;3549
2021-01-29;HN;Honduras;1118;26;146110;3575
2021-01-30;HN;Honduras;990;17;147100;3592
2021-01-31;HN;Honduras;743;18;147843;3610
2021-02-01;HN;Honduras;0;0;147843;3610
2021-02-02;HN;Honduras;1108;4;148951;3614
2021-02-03;HN;Honduras;2152;48;151103;3662
2021-02-04;HN;Honduras;1122;7;152225;3669
2021-02-05;HN;Honduras;1028;25;153253;3694
2021-02-06;HN;Honduras;652;16;153905;3710
2021-02-07;HN;Honduras;663;11;154568;3721
2021-02-08;HN;Honduras;1167;21;155735;3742
2021-02-09;HN;Honduras;871;47;156606;3789
2021-02-10;HN;Honduras;862;17;157468;3806
2021-02-11;HN;Honduras;887;32;158355;3838
2021-02-12;HN;Honduras;669;10;159024;3848
2021-02-13;HN;Honduras;764;9;159788;3857
2021-02-14;HN;Honduras;383;9;160171;3866
2021-02-15;HN;Honduras;812;27;160983;3893
2021-02-16;HN;Honduras;744;20;161727;3913
2021-02-17;HN;Honduras;857;20;162584;3933
2021-02-18;HN;Honduras;721;32;163305;3965
2021-02-19;HN;Honduras;772;10;164077;3975
2021-02-20;HN;Honduras;418;17;164495;3992
2021-02-21;HN;Honduras;600;4;165095;3996
2021-02-22;HN;Honduras;642;28;165737;4024
2021-02-23;HN;Honduras;810;16;166547;4040
2021-02-24;HN;Honduras;947;36;167494;4076
2021-02-25;HN;Honduras;749;23;168243;4099
2021-02-26;HN;Honduras;668;18;168911;4117
2021-02-27;HN;Honduras;843;24;169754;4141
2021-02-28;HN;Honduras;550;10;170304;4151
2021-03-01;HN;Honduras;681;23;170985;4174
2021-03-02;HN;Honduras;773;13;171758;4187
2021-03-03;HN;Honduras;342;27;172100;4214
2021-03-04;HN;Honduras;477;17;172577;4231
2021-03-05;HN;Honduras;0;0;172577;4231
2021-03-06;HN;Honduras;443;16;173020;4247
2021-03-07;HN;Honduras;709;13;173729;4260
2021-03-08;HN;Honduras;514;23;174243;4283
2021-03-09;HN;Honduras;265;14;174508;4297
2021-03-10;HN;Honduras;934;4;175442;4301
2021-03-11;HN;Honduras;985;10;176427;4311
2021-03-12;HN;Honduras;741;14;177168;4325
2021-03-13;HN;Honduras;664;6;177832;4331
2021-03-14;HN;Honduras;445;3;178277;4334
2021-03-15;HN;Honduras;648;26;178925;4360
2021-03-16;HN;Honduras;590;13;179515;4373
2021-03-17;HN;Honduras;756;17;180271;4390
2021-03-18;HN;Honduras;525;12;180796;4402
2021-03-19;HN;Honduras;561;20;181357;4422
2021-03-20;HN;Honduras;574;8;181931;4430
2021-03-21;HN;Honduras;478;13;182409;4443
2021-03-22;HN;Honduras;871;26;183280;4469
2021-03-23;HN;Honduras;751;20;184031;4489
2021-03-24;HN;Honduras;790;17;184821;4506
2021-03-25;HN;Honduras;663;21;185484;4527
2021-03-26;HN;Honduras;853;9;186337;4536
2021-03-27;HN;Honduras;678;21;187015;4557
2021-03-28;HN;Honduras;445;1;187460;4558
2021-03-29;HN;Honduras;515;27;187975;4585
2021-03-30;HN;Honduras;539;14;188514;4599
2021-03-31;HN;Honduras;529;6;189043;4605
2021-04-01;HN;Honduras;683;17;189726;4622
2021-04-02;HN;Honduras;0;0;189726;4622
2021-04-03;HN;Honduras;416;11;190142;4633
2021-04-04;HN;Honduras;489;11;190631;4644
2021-04-05;HN;Honduras;505;37;191136;4681
2021-04-06;HN;Honduras;1277;5;192413;4686
2021-04-07;HN;Honduras;616;17;193029;4703
2021-04-08;HN;Honduras;754;12;193783;4715
2021-04-09;HN;Honduras;765;51;194548;4766
2021-04-10;HN;Honduras;977;4;195525;4770
2021-04-11;HN;Honduras;255;34;195780;4804
2021-04-12;HN;Honduras;306;57;196086;4861
2021-04-13;HN;Honduras;618;12;196704;4873
2021-04-14;HN;Honduras;1510;32;198214;4905
2021-04-15;HN;Honduras;761;24;198975;4929
2021-04-16;HN;Honduras;707;5;199682;4934
2021-04-17;HN;Honduras;577;20;200259;4954
2021-04-18;HN;Honduras;676;3;200935;4957
2021-04-19;HN;Honduras;742;6;201677;4963
2021-04-20;HN;Honduras;736;13;202413;4976
2021-04-21;HN;Honduras;0;0;202413;4976
2021-04-22;HN;Honduras;2415;71;204828;5047
2021-04-23;HN;Honduras;868;48;205696;5095
2021-04-24;HN;Honduras;0;0;205696;5095
2021-04-25;HN;Honduras;1211;46;206907;5141
2021-04-26;HN;Honduras;0;0;206907;5141
2021-04-27;HN;Honduras;413;52;207320;5193
2021-04-28;HN;Honduras;1036;19;208356;5212
2021-04-29;HN;Honduras;2720;49;211076;5261
2021-04-30;HN;Honduras;1257;20;212333;5281
2021-05-01;HN;Honduras;834;37;213167;5318
2021-05-02;HN;Honduras;0;0;213167;5318
2021-05-03;HN;Honduras;1308;49;214475;5367
2021-05-04;HN;Honduras;1358;19;215833;5386
2021-05-05;HN;Honduras;1131;53;216964;5439
2021-05-06;HN;Honduras;631;63;217595;5502
2021-05-07;HN;Honduras;735;83;218330;5585
2021-05-08;HN;Honduras;958;32;219288;5617
2021-05-09;HN;Honduras;0;0;219288;5617
2021-05-10;HN;Honduras;897;48;220185;5665
2021-05-11;HN;Honduras;1933;124;222118;5789
2021-05-12;HN;Honduras;874;64;222992;5853
2021-05-13;HN;Honduras;0;0;222992;5853
2021-05-14;HN;Honduras;930;45;223922;5898
2021-05-15;HN;Honduras;2042;56;225964;5954
2021-05-16;HN;Honduras;755;6;226719;5960
2021-05-17;HN;Honduras;797;10;227516;5970
2021-05-18;HN;Honduras;771;49;228287;6019
2021-05-19;HN;Honduras;924;32;229211;6051
2021-05-20;HN;Honduras;1100;42;230311;6093
2021-05-21;HN;Honduras;1249;40;231560;6133
2021-05-22;HN;Honduras;581;10;232141;6143
2021-05-23;HN;Honduras;531;3;232672;6146
2021-05-24;HN;Honduras;444;42;233116;6188
2021-05-25;HN;Honduras;800;22;233916;6210
2021-05-26;HN;Honduras;1007;30;234923;6240
2021-05-27;HN;Honduras;676;19;235599;6259
2021-05-28;HN;Honduras;852;25;236451;6284
2021-05-29;HN;Honduras;501;12;236952;6296
2021-05-30;HN;Honduras;0;0;236952;6296
2021-05-31;HN;Honduras;1275;57;238227;6353
2021-06-01;HN;Honduras;593;26;238820;6379
2021-06-02;HN;Honduras;608;24;239428;6403
2021-06-03;HN;Honduras;954;12;240382;6415
2021-06-04;HN;Honduras;657;39;241039;6454
2021-06-05;HN;Honduras;535;6;241574;6460
2021-06-06;HN;Honduras;252;19;241826;6479
2021-06-07;HN;Honduras;551;14;242377;6493
2021-06-08;HN;Honduras;419;39;242796;6532
2021-06-09;HN;Honduras;671;27;243467;6559
2021-06-10;HN;Honduras;828;8;244295;6567
2021-06-11;HN;Honduras;1400;32;245695;6599
2021-06-12;HN;Honduras;1379;7;247074;6606
2021-06-13;HN;Honduras;654;25;247728;6631
2021-06-14;HN;Honduras;387;22;248115;6653
2021-06-15;HN;Honduras;1003;21;249118;6674
2021-06-16;HN;Honduras;813;17;249931;6691
2021-06-17;HN;Honduras;0;0;249931;6691
2021-06-18;HN;Honduras;1218;28;251149;6719
2021-06-19;HN;Honduras;1979;40;253128;6759
2021-06-20;HN;Honduras;747;7;253875;6766
2021-06-21;HN;Honduras;319;6;254194;6772
2021-06-22;HN;Honduras;923;46;255117;6818
2021-06-23;HN;Honduras;546;26;255663;6844
2021-06-24;HN;Honduras;1155;35;256818;6879
2021-06-25;HN;Honduras;1531;23;258349;6902
2021-06-26;HN;Honduras;1279;14;259628;6916
2021-06-27;HN;Honduras;0;0;259628;6916
2021-06-28;HN;Honduras;703;6;260331;6922
2021-06-29;HN;Honduras;1738;58;262069;6980
2021-06-30;HN;Honduras;691;25;262760;7005
2021-07-01;HN;Honduras;616;25;263376;7030
2020-01-23;HK;Hong Kong;2;0;2;0
2020-01-24;HK;Hong Kong;0;0;2;0
2020-01-25;HK;Hong Kong;3;0;5;0
2020-01-26;HK;Hong Kong;3;0;8;0
2020-01-27;HK;Hong Kong;0;0;8;0
2020-01-28;HK;Hong Kong;0;0;8;0
2020-01-29;HK;Hong Kong;2;0;10;0
2020-01-30;HK;Hong Kong;0;0;10;0
2020-01-31;HK;Hong Kong;2;0;12;0
2020-02-01;HK;Hong Kong;1;0;13;0
2020-02-02;HK;Hong Kong;2;0;15;0
2020-02-03;HK;Hong Kong;0;0;15;0
2020-02-04;HK;Hong Kong;2;1;17;1
2020-02-05;HK;Hong Kong;4;0;21;1
2020-02-06;HK;Hong Kong;3;0;24;1
2020-02-07;HK;Hong Kong;1;0;25;1
2020-02-08;HK;Hong Kong;1;0;26;1
2020-02-09;HK;Hong Kong;3;0;29;1
2020-02-10;HK;Hong Kong;9;0;38;1
2020-02-11;HK;Hong Kong;11;0;49;1
2020-02-12;HK;Hong Kong;1;0;50;1
2020-02-13;HK;Hong Kong;3;0;53;1
2020-02-14;HK;Hong Kong;3;0;56;1
2020-02-15;HK;Hong Kong;0;0;56;1
2020-02-16;HK;Hong Kong;1;0;57;1
2020-02-17;HK;Hong Kong;3;0;60;1
2020-02-18;HK;Hong Kong;2;0;62;1
2020-02-19;HK;Hong Kong;1;1;63;2
2020-02-20;HK;Hong Kong;5;0;68;2
2020-02-21;HK;Hong Kong;0;0;68;2
2020-02-22;HK;Hong Kong;1;0;69;2
2020-02-23;HK;Hong Kong;5;0;74;2
2020-02-24;HK;Hong Kong;5;0;79;2
2020-02-25;HK;Hong Kong;5;0;84;2
2020-02-26;HK;Hong Kong;7;0;91;2
2020-02-27;HK;Hong Kong;1;0;92;2
2020-02-28;HK;Hong Kong;2;0;94;2
2020-02-29;HK;Hong Kong;1;0;95;2
2020-03-01;HK;Hong Kong;1;0;96;2
2020-03-02;HK;Hong Kong;4;0;100;2
2020-03-03;HK;Hong Kong;0;0;100;2
2020-03-04;HK;Hong Kong;5;0;105;2
2020-03-05;HK;Hong Kong;0;0;105;2
2020-03-06;HK;Hong Kong;2;0;107;2
2020-03-07;HK;Hong Kong;1;0;108;2
2020-03-08;HK;Hong Kong;6;1;114;3
2020-03-09;HK;Hong Kong;1;0;115;3
2020-03-10;HK;Hong Kong;5;0;120;3
2020-03-11;HK;Hong Kong;6;0;126;3
2020-03-12;HK;Hong Kong;3;0;129;3
2020-03-13;HK;Hong Kong;5;1;134;4
2020-03-14;HK;Hong Kong;6;0;140;4
2020-03-15;HK;Hong Kong;5;0;145;4
2020-03-16;HK;Hong Kong;10;0;155;4
2020-03-17;HK;Hong Kong;7;0;162;4
2020-03-18;HK;Hong Kong;19;0;181;4
2020-03-19;HK;Hong Kong;27;0;208;4
2020-03-20;HK;Hong Kong;48;0;256;4
2020-03-21;HK;Hong Kong;17;0;273;4
2020-03-22;HK;Hong Kong;44;0;317;4
2020-03-23;HK;Hong Kong;39;0;356;4
2020-03-24;HK;Hong Kong;30;0;386;4
2020-03-25;HK;Hong Kong;24;0;410;4
2020-03-26;HK;Hong Kong;43;0;453;4
2020-03-27;HK;Hong Kong;66;0;519;4
2020-03-28;HK;Hong Kong;42;0;561;4
2020-03-29;HK;Hong Kong;80;0;641;4
2020-03-30;HK;Hong Kong;41;0;682;4
2020-03-31;HK;Hong Kong;32;0;714;4
2020-04-01;HK;Hong Kong;51;0;765;4
2020-04-02;HK;Hong Kong;37;0;802;4
2020-04-03;HK;Hong Kong;43;0;845;4
2020-04-04;HK;Hong Kong;17;0;862;4
2020-04-05;HK;Hong Kong;28;0;890;4
2020-04-06;HK;Hong Kong;24;0;914;4
2020-04-07;HK;Hong Kong;21;0;935;4
2020-04-08;HK;Hong Kong;25;0;960;4
2020-04-09;HK;Hong Kong;13;0;973;4
2020-04-10;HK;Hong Kong;16;0;989;4
2020-04-11;HK;Hong Kong;11;0;1000;4
2020-04-12;HK;Hong Kong;4;0;1004;4
2020-04-13;HK;Hong Kong;5;0;1009;4
2020-04-14;HK;Hong Kong;3;0;1012;4
2020-04-15;HK;Hong Kong;5;0;1017;4
2020-04-16;HK;Hong Kong;0;0;1017;4
2020-04-17;HK;Hong Kong;4;0;1021;4
2020-04-18;HK;Hong Kong;3;0;1024;4
2020-04-19;HK;Hong Kong;1;0;1025;4
2020-04-20;HK;Hong Kong;0;0;1025;4
2020-04-21;HK;Hong Kong;4;0;1029;4
2020-04-22;HK;Hong Kong;4;0;1033;4
2020-04-23;HK;Hong Kong;2;0;1035;4
2020-04-24;HK;Hong Kong;0;0;1035;4
2020-04-25;HK;Hong Kong;2;0;1037;4
2020-04-26;HK;Hong Kong;0;0;1037;4
2020-04-27;HK;Hong Kong;0;0;1037;4
2020-04-28;HK;Hong Kong;0;0;1037;4
2020-04-29;HK;Hong Kong;0;0;1037;4
2020-04-30;HK;Hong Kong;0;0;1037;4
2020-05-01;HK;Hong Kong;2;0;1039;4
2020-05-02;HK;Hong Kong;0;0;1039;4
2020-05-03;HK;Hong Kong;0;0;1039;4
2020-05-04;HK;Hong Kong;1;0;1040;4
2020-05-05;HK;Hong Kong;0;0;1040;4
2020-05-06;HK;Hong Kong;0;0;1040;4
2020-05-07;HK;Hong Kong;4;0;1044;4
2020-05-08;HK;Hong Kong;0;0;1044;4
2020-05-09;HK;Hong Kong;0;0;1044;4
2020-05-10;HK;Hong Kong;3;0;1047;4
2020-05-11;HK;Hong Kong;0;0;1047;4
2020-05-12;HK;Hong Kong;0;0;1047;4
2020-05-13;HK;Hong Kong;3;0;1050;4
2020-05-14;HK;Hong Kong;1;0;1051;4
2020-05-15;HK;Hong Kong;1;0;1052;4
2020-05-16;HK;Hong Kong;0;0;1052;4
2020-05-17;HK;Hong Kong;3;0;1055;4
2020-05-18;HK;Hong Kong;0;0;1055;4
2020-05-19;HK;Hong Kong;0;0;1055;4
2020-05-20;HK;Hong Kong;0;0;1055;4
2020-05-21;HK;Hong Kong;0;0;1055;4
2020-05-22;HK;Hong Kong;10;0;1065;4
2020-05-23;HK;Hong Kong;0;0;1065;4
2020-05-24;HK;Hong Kong;0;0;1065;4
2020-05-25;HK;Hong Kong;0;0;1065;4
2020-05-26;HK;Hong Kong;0;0;1065;4
2020-05-27;HK;Hong Kong;1;0;1066;4
2020-05-28;HK;Hong Kong;0;0;1066;4
2020-05-29;HK;Hong Kong;13;0;1079;4
2020-05-30;HK;Hong Kong;3;0;1082;4
2020-05-31;HK;Hong Kong;2;0;1084;4
2020-06-01;HK;Hong Kong;3;0;1087;4
2020-06-02;HK;Hong Kong;6;0;1093;4
2020-06-03;HK;Hong Kong;0;0;1093;4
2020-06-04;HK;Hong Kong;6;0;1099;4
2020-06-05;HK;Hong Kong;3;0;1102;4
2020-06-06;HK;Hong Kong;3;0;1105;4
2020-06-07;HK;Hong Kong;1;0;1106;4
2020-06-08;HK;Hong Kong;1;0;1107;4
2020-06-09;HK;Hong Kong;0;0;1107;4
2020-06-10;HK;Hong Kong;0;0;1107;4
2020-06-11;HK;Hong Kong;0;0;1107;4
2020-06-12;HK;Hong Kong;1;0;1108;4
2020-06-13;HK;Hong Kong;1;0;1109;4
2020-06-14;HK;Hong Kong;0;0;1109;4
2020-06-15;HK;Hong Kong;3;0;1112;4
2020-06-16;HK;Hong Kong;0;0;1112;4
2020-06-17;HK;Hong Kong;8;0;1120;4
2020-06-18;HK;Hong Kong;4;0;1124;4
2020-06-19;HK;Hong Kong;0;0;1124;4
2020-06-20;HK;Hong Kong;4;1;1128;5
2020-06-21;HK;Hong Kong;3;0;1131;5
2020-06-22;HK;Hong Kong;30;0;1161;5
2020-06-23;HK;Hong Kong;16;1;1177;6
2020-06-24;HK;Hong Kong;2;0;1179;6
2020-06-25;HK;Hong Kong;14;1;1193;7
2020-06-26;HK;Hong Kong;3;0;1196;7
2020-06-27;HK;Hong Kong;1;0;1197;7
2020-06-28;HK;Hong Kong;2;0;1199;7
2020-06-29;HK;Hong Kong;4;0;1203;7
2020-06-30;HK;Hong Kong;2;0;1205;7
2020-07-01;HK;Hong Kong;28;0;1233;7
2020-07-02;HK;Hong Kong;9;0;1242;7
2020-07-03;HK;Hong Kong;5;0;1247;7
2020-07-04;HK;Hong Kong;11;0;1258;7
2020-07-05;HK;Hong Kong;10;0;1268;7
2020-07-06;HK;Hong Kong;17;0;1285;7
2020-07-07;HK;Hong Kong;14;0;1299;7
2020-07-08;HK;Hong Kong;24;0;1323;7
2020-07-09;HK;Hong Kong;42;0;1365;7
2020-07-10;HK;Hong Kong;0;0;1365;7
2020-07-11;HK;Hong Kong;66;0;1431;7
2020-07-12;HK;Hong Kong;38;0;1469;7
2020-07-13;HK;Hong Kong;0;0;1469;7
2020-07-14;HK;Hong Kong;100;1;1569;8
2020-07-15;HK;Hong Kong;19;2;1588;10
2020-07-16;HK;Hong Kong;67;0;1655;10
2020-07-17;HK;Hong Kong;58;1;1713;11
2020-07-18;HK;Hong Kong;0;1;1713;12
2020-07-19;HK;Hong Kong;64;0;1777;12
2020-07-20;HK;Hong Kong;108;0;1885;12
2020-07-21;HK;Hong Kong;73;2;1958;14
2020-07-22;HK;Hong Kong;173;0;2131;14
2020-07-23;HK;Hong Kong;118;1;2249;15
2020-07-24;HK;Hong Kong;123;1;2372;16
2020-07-25;HK;Hong Kong;133;2;2505;18
2020-07-26;HK;Hong Kong;128;0;2633;18
2020-07-27;HK;Hong Kong;145;4;2778;22
2020-07-28;HK;Hong Kong;106;1;2884;23
2020-07-29;HK;Hong Kong;118;1;3002;24
2020-07-30;HK;Hong Kong;149;1;3151;25
2020-07-31;HK;Hong Kong;121;2;3272;27
2020-08-01;HK;Hong Kong;124;6;3396;33
2020-08-02;HK;Hong Kong;115;2;3511;35
2020-08-03;HK;Hong Kong;78;3;3589;38
2020-08-04;HK;Hong Kong;80;4;3669;42
2020-08-05;HK;Hong Kong;85;1;3754;43
2020-08-06;HK;Hong Kong;95;3;3849;46
2020-08-07;HK;Hong Kong;89;1;3938;47
2020-08-08;HK;Hong Kong;69;0;4007;47
2020-08-09;HK;Hong Kong;72;5;4079;52
2020-08-10;HK;Hong Kong;69;3;4148;55
2020-08-11;HK;Hong Kong;33;4;4181;59
2020-08-12;HK;Hong Kong;62;4;4243;63
2020-08-13;HK;Hong Kong;69;3;4312;66
2020-08-14;HK;Hong Kong;48;1;4360;67
2020-08-15;HK;Hong Kong;46;2;4406;69
2020-08-16;HK;Hong Kong;74;0;4480;69
2020-08-17;HK;Hong Kong;44;0;4524;69
2020-08-18;HK;Hong Kong;36;2;4560;71
2020-08-19;HK;Hong Kong;26;1;4586;72
2020-08-20;HK;Hong Kong;18;3;4604;75
2020-08-21;HK;Hong Kong;27;0;4631;75
2020-08-22;HK;Hong Kong;26;2;4657;77
2020-08-23;HK;Hong Kong;25;0;4682;77
2020-08-24;HK;Hong Kong;9;0;4691;77
2020-08-25;HK;Hong Kong;19;1;4710;78
2020-08-26;HK;Hong Kong;24;1;4734;79
2020-08-27;HK;Hong Kong;21;2;4755;81
2020-08-28;HK;Hong Kong;13;3;4768;84
2020-08-29;HK;Hong Kong;18;3;4786;87
2020-08-30;HK;Hong Kong;15;1;4801;88
2020-08-31;HK;Hong Kong;9;1;4810;89
2020-09-01;HK;Hong Kong;12;1;4822;90
2020-09-02;HK;Hong Kong;8;3;4830;93
2020-09-03;HK;Hong Kong;8;1;4838;94
2020-09-04;HK;Hong Kong;12;0;4850;94
2020-09-05;HK;Hong Kong;7;0;4857;94
2020-09-06;HK;Hong Kong;21;2;4878;96
2020-09-07;HK;Hong Kong;11;2;4889;98
2020-09-08;HK;Hong Kong;6;1;4895;99
2020-09-09;HK;Hong Kong;6;0;4901;99
2020-09-10;HK;Hong Kong;12;0;4913;99
2020-09-11;HK;Hong Kong;12;0;4925;99
2020-09-12;HK;Hong Kong;13;1;4938;100
2020-09-13;HK;Hong Kong;19;0;4957;100
2020-09-14;HK;Hong Kong;14;1;4971;101
2020-09-15;HK;Hong Kong;4;1;4975;102
2020-09-16;HK;Hong Kong;9;0;4984;102
2020-09-17;HK;Hong Kong;9;0;4993;102
2020-09-18;HK;Hong Kong;3;1;4996;103
2020-09-19;HK;Hong Kong;13;0;5009;103
2020-09-20;HK;Hong Kong;23;0;5032;103
2020-09-21;HK;Hong Kong;6;0;5038;103
2020-09-22;HK;Hong Kong;8;0;5046;103
2020-09-23;HK;Hong Kong;3;1;5049;104
2020-09-24;HK;Hong Kong;7;0;5056;104
2020-09-25;HK;Hong Kong;2;1;5058;105
2020-09-26;HK;Hong Kong;1;0;5059;105
2020-09-27;HK;Hong Kong;6;0;5065;105
2020-09-28;HK;Hong Kong;10;0;5075;105
2020-09-29;HK;Hong Kong;4;0;5079;105
2020-09-30;HK;Hong Kong;8;0;5087;105
2020-10-01;HK;Hong Kong;10;0;5097;105
2020-10-02;HK;Hong Kong;7;0;5104;105
2020-10-03;HK;Hong Kong;4;0;5108;105
2020-10-04;HK;Hong Kong;5;0;5113;105
2020-10-05;HK;Hong Kong;11;0;5124;105
2020-10-06;HK;Hong Kong;8;0;5132;105
2020-10-07;HK;Hong Kong;11;0;5143;105
2020-10-08;HK;Hong Kong;18;0;5161;105
2020-10-09;HK;Hong Kong;8;0;5169;105
2020-10-10;HK;Hong Kong;6;0;5175;105
2020-10-11;HK;Hong Kong;7;0;5182;105
2020-10-12;HK;Hong Kong;11;0;5193;105
2020-10-13;HK;Hong Kong;8;0;5201;105
2020-10-14;HK;Hong Kong;0;0;5201;105
2020-10-15;HK;Hong Kong;12;0;5213;105
2020-10-16;HK;Hong Kong;7;0;5220;105
2020-10-17;HK;Hong Kong;17;0;5237;105
2020-10-18;HK;Hong Kong;4;0;5241;105
2020-10-19;HK;Hong Kong;15;0;5256;105
2020-10-20;HK;Hong Kong;5;0;5261;105
2020-10-21;HK;Hong Kong;8;0;5269;105
2020-10-22;HK;Hong Kong;11;0;5280;105
2020-10-23;HK;Hong Kong;4;0;5284;105
2020-10-24;HK;Hong Kong;5;0;5289;105
2020-10-25;HK;Hong Kong;6;0;5295;105
2020-10-26;HK;Hong Kong;8;0;5303;105
2020-10-27;HK;Hong Kong;5;0;5308;105
2020-10-28;HK;Hong Kong;2;0;5310;105
2020-10-29;HK;Hong Kong;3;0;5313;105
2020-10-30;HK;Hong Kong;7;0;5320;105
2020-10-31;HK;Hong Kong;3;0;5323;105
2020-11-01;HK;Hong Kong;7;0;5330;105
2020-11-02;HK;Hong Kong;6;0;5336;105
2020-11-03;HK;Hong Kong;9;0;5345;105
2020-11-04;HK;Hong Kong;3;1;5348;106
2020-11-05;HK;Hong Kong;7;1;5355;107
2020-11-06;HK;Hong Kong;6;0;5361;107
2020-11-07;HK;Hong Kong;3;0;5364;107
2020-11-08;HK;Hong Kong;10;0;5374;107
2020-11-09;HK;Hong Kong;6;0;5380;107
2020-11-10;HK;Hong Kong;9;1;5389;108
2020-11-11;HK;Hong Kong;18;0;5407;108
2020-11-12;HK;Hong Kong;23;0;5430;108
2020-11-13;HK;Hong Kong;6;0;5436;108
2020-11-14;HK;Hong Kong;8;0;5444;108
2020-11-15;HK;Hong Kong;14;0;5458;108
2020-11-16;HK;Hong Kong;8;0;5466;108
2020-11-17;HK;Hong Kong;4;0;5470;108
2020-11-18;HK;Hong Kong;9;0;5479;108
2020-11-19;HK;Hong Kong;12;0;5491;108
2020-11-20;HK;Hong Kong;26;0;5517;108
2020-11-21;HK;Hong Kong;43;0;5560;108
2020-11-22;HK;Hong Kong;68;0;5628;108
2020-11-23;HK;Hong Kong;73;0;5701;108
2020-11-24;HK;Hong Kong;80;0;5781;108
2020-11-25;HK;Hong Kong;85;0;5866;108
2020-11-26;HK;Hong Kong;81;0;5947;108
2020-11-27;HK;Hong Kong;92;0;6039;108
2020-11-28;HK;Hong Kong;84;1;6123;109
2020-11-29;HK;Hong Kong;115;0;6238;109
2020-11-30;HK;Hong Kong;76;0;6314;109
2020-12-01;HK;Hong Kong;82;0;6396;109
2020-12-02;HK;Hong Kong;103;1;6499;110
2020-12-03;HK;Hong Kong;90;1;6589;111
2020-12-04;HK;Hong Kong;112;1;6701;112
2020-12-05;HK;Hong Kong;101;0;6802;112
2020-12-06;HK;Hong Kong;95;0;6897;112
2020-12-07;HK;Hong Kong;78;0;6975;112
2020-12-08;HK;Hong Kong;100;0;7075;112
2020-12-09;HK;Hong Kong;104;2;7179;114
2020-12-10;HK;Hong Kong;112;0;7291;114
2020-12-11;HK;Hong Kong;86;0;7377;114
2020-12-12;HK;Hong Kong;69;1;7446;115
2020-12-13;HK;Hong Kong;95;2;7541;117
2020-12-14;HK;Hong Kong;82;3;7623;120
2020-12-15;HK;Hong Kong;98;3;7721;123
2020-12-16;HK;Hong Kong;82;0;7803;123
2020-12-17;HK;Hong Kong;96;2;7899;125
2020-12-18;HK;Hong Kong;70;4;7969;129
2020-12-19;HK;Hong Kong;109;0;8078;129
2020-12-20;HK;Hong Kong;74;1;8152;130
2020-12-21;HK;Hong Kong;85;1;8237;131
2020-12-22;HK;Hong Kong;63;1;8300;132
2020-12-23;HK;Hong Kong;53;1;8353;133
2020-12-24;HK;Hong Kong;71;2;8424;135
2020-12-25;HK;Hong Kong;57;1;8481;136
2020-12-26;HK;Hong Kong;59;0;8540;136
2020-12-27;HK;Hong Kong;70;1;8610;137
2020-12-28;HK;Hong Kong;61;4;8671;141
2020-12-29;HK;Hong Kong;53;2;8724;143
2020-12-30;HK;Hong Kong;54;4;8778;147
2020-12-31;HK;Hong Kong;68;1;8846;148
2021-01-01;HK;Hong Kong;42;0;8888;148
2021-01-02;HK;Hong Kong;35;2;8923;150
2021-01-03;HK;Hong Kong;41;0;8964;150
2021-01-04;HK;Hong Kong;53;3;9017;153
2021-01-05;HK;Hong Kong;32;0;9049;153
2021-01-06;HK;Hong Kong;25;1;9074;154
2021-01-07;HK;Hong Kong;33;0;9107;154
2021-01-08;HK;Hong Kong;45;1;9152;155
2021-01-09;HK;Hong Kong;59;2;9211;157
2021-01-10;HK;Hong Kong;31;1;9242;158
2021-01-11;HK;Hong Kong;41;1;9283;159
2021-01-12;HK;Hong Kong;60;1;9343;160
2021-01-13;HK;Hong Kong;42;1;9385;161
2021-01-14;HK;Hong Kong;29;0;9414;161
2021-01-15;HK;Hong Kong;38;0;9452;161
2021-01-16;HK;Hong Kong;50;1;9502;162
2021-01-17;HK;Hong Kong;55;0;9557;162
2021-01-18;HK;Hong Kong;107;1;9664;163
2021-01-19;HK;Hong Kong;56;2;9720;165
2021-01-20;HK;Hong Kong;77;1;9797;166
2021-01-21;HK;Hong Kong;131;2;9928;168
2021-01-22;HK;Hong Kong;0;0;9928;168
2021-01-23;HK;Hong Kong;81;0;10009;168
2021-01-24;HK;Hong Kong;76;1;10085;169
2021-01-25;HK;Hong Kong;73;2;10158;171
2021-01-26;HK;Hong Kong;64;2;10222;173
2021-01-27;HK;Hong Kong;60;2;10282;175
2021-01-28;HK;Hong Kong;39;2;10321;177
2021-01-29;HK;Hong Kong;50;1;10371;178
2021-01-30;HK;Hong Kong;28;1;10399;179
2021-01-31;HK;Hong Kong;53;2;10452;181
2021-02-01;HK;Hong Kong;34;1;10486;182
2021-02-02;HK;Hong Kong;25;2;10511;184
2021-02-03;HK;Hong Kong;19;1;10530;185
2021-02-04;HK;Hong Kong;22;1;10552;186
2021-02-05;HK;Hong Kong;37;0;10589;186
2021-02-06;HK;Hong Kong;19;0;10608;186
2021-02-07;HK;Hong Kong;27;0;10635;186
2021-02-08;HK;Hong Kong;32;0;10667;186
2021-02-09;HK;Hong Kong;26;2;10693;188
2021-02-10;HK;Hong Kong;17;1;10710;189
2021-02-11;HK;Hong Kong;21;2;10731;191
2021-02-12;HK;Hong Kong;24;1;10755;192
2021-02-13;HK;Hong Kong;12;1;10767;193
2021-02-14;HK;Hong Kong;12;0;10779;193
2021-02-15;HK;Hong Kong;9;0;10788;193
2021-02-16;HK;Hong Kong;8;2;10796;195
2021-02-17;HK;Hong Kong;16;2;10812;197
2021-02-18;HK;Hong Kong;8;0;10820;197
2021-02-19;HK;Hong Kong;13;0;10833;197
2021-02-20;HK;Hong Kong;15;0;10848;197
2021-02-21;HK;Hong Kong;20;0;10868;197
2021-02-22;HK;Hong Kong;16;0;10884;197
2021-02-23;HK;Hong Kong;12;0;10896;197
2021-02-24;HK;Hong Kong;17;1;10913;198
2021-02-25;HK;Hong Kong;13;0;10926;198
2021-02-26;HK;Hong Kong;24;0;10950;198
2021-02-27;HK;Hong Kong;33;0;10983;198
2021-02-28;HK;Hong Kong;22;1;11005;199
2021-03-01;HK;Hong Kong;14;1;11019;200
2021-03-02;HK;Hong Kong;13;0;11032;200
2021-03-03;HK;Hong Kong;14;0;11046;200
2021-03-04;HK;Hong Kong;9;1;11055;201
2021-03-05;HK;Hong Kong;11;0;11066;201
2021-03-06;HK;Hong Kong;8;1;11074;202
2021-03-07;HK;Hong Kong;16;0;11090;202
2021-03-08;HK;Hong Kong;9;0;11099;202
2021-03-09;HK;Hong Kong;21;0;11120;202
2021-03-10;HK;Hong Kong;8;1;11128;203
2021-03-11;HK;Hong Kong;22;0;11150;203
2021-03-12;HK;Hong Kong;60;0;11210;203
2021-03-13;HK;Hong Kong;47;0;11257;203
2021-03-14;HK;Hong Kong;24;0;11281;203
2021-03-15;HK;Hong Kong;30;0;11311;203
2021-03-16;HK;Hong Kong;18;0;11329;203
2021-03-17;HK;Hong Kong;11;0;11340;203
2021-03-18;HK;Hong Kong;10;0;11350;203
2021-03-19;HK;Hong Kong;13;0;11363;203
2021-03-20;HK;Hong Kong;8;0;11371;203
2021-03-21;HK;Hong Kong;8;0;11379;203
2021-03-22;HK;Hong Kong;18;0;11397;203
2021-03-23;HK;Hong Kong;12;1;11409;204
2021-03-24;HK;Hong Kong;10;0;11419;204
2021-03-25;HK;Hong Kong;9;0;11428;204
2021-03-26;HK;Hong Kong;11;1;11439;205
2021-03-27;HK;Hong Kong;6;0;11445;205
2021-03-28;HK;Hong Kong;1;0;11446;205
2021-03-29;HK;Hong Kong;8;0;11454;205
2021-03-30;HK;Hong Kong;7;0;11461;205
2021-03-31;HK;Hong Kong;6;0;11467;205
2021-04-01;HK;Hong Kong;13;0;11480;205
2021-04-02;HK;Hong Kong;19;0;11499;205
2021-04-03;HK;Hong Kong;2;0;11501;205
2021-04-04;HK;Hong Kong;7;0;11508;205
2021-04-05;HK;Hong Kong;16;0;11524;205
2021-04-06;HK;Hong Kong;7;0;11531;205
2021-04-07;HK;Hong Kong;8;0;11539;205
2021-04-08;HK;Hong Kong;10;0;11549;205
2021-04-09;HK;Hong Kong;14;2;11563;207
2021-04-10;HK;Hong Kong;5;0;11568;207
2021-04-11;HK;Hong Kong;13;0;11581;207
2021-04-12;HK;Hong Kong;13;0;11594;207
2021-04-13;HK;Hong Kong;13;1;11607;208
2021-04-14;HK;Hong Kong;5;1;11612;209
2021-04-15;HK;Hong Kong;6;0;11618;209
2021-04-16;HK;Hong Kong;17;0;11635;209
2021-04-17;HK;Hong Kong;18;0;11653;209
2021-04-18;HK;Hong Kong;30;0;11683;209
2021-04-19;HK;Hong Kong;12;0;11695;209
2021-04-20;HK;Hong Kong;8;0;11703;209
2021-04-21;HK;Hong Kong;1;0;11704;209
2021-04-22;HK;Hong Kong;14;0;11718;209
2021-04-23;HK;Hong Kong;9;0;11727;209
2021-04-24;HK;Hong Kong;3;0;11730;209
2021-04-25;HK;Hong Kong;6;0;11736;209
2021-04-26;HK;Hong Kong;4;0;11740;209
2021-04-27;HK;Hong Kong;8;0;11748;209
2021-04-28;HK;Hong Kong;7;0;11755;209
2021-04-29;HK;Hong Kong;15;0;11770;209
2021-04-30;HK;Hong Kong;4;0;11774;209
2021-05-01;HK;Hong Kong;8;1;11782;210
2021-05-02;HK;Hong Kong;2;0;11784;210
2021-05-03;HK;Hong Kong;2;0;11786;210
2021-05-04;HK;Hong Kong;4;0;11790;210
2021-05-05;HK;Hong Kong;6;0;11796;210
2021-05-06;HK;Hong Kong;2;0;11798;210
2021-05-07;HK;Hong Kong;3;0;11801;210
2021-05-08;HK;Hong Kong;5;0;11806;210
2021-05-09;HK;Hong Kong;1;0;11807;210
2021-05-10;HK;Hong Kong;4;0;11811;210
2021-05-11;HK;Hong Kong;1;0;11812;210
2021-05-12;HK;Hong Kong;2;0;11814;210
2021-05-13;HK;Hong Kong;3;0;11817;210
2021-05-14;HK;Hong Kong;1;0;11818;210
2021-05-15;HK;Hong Kong;3;0;11821;210
2021-05-16;HK;Hong Kong;3;0;11824;210
2021-05-17;HK;Hong Kong;1;0;11825;210
2021-05-18;HK;Hong Kong;1;0;11826;210
2021-05-19;HK;Hong Kong;1;0;11827;210
2021-05-20;HK;Hong Kong;1;0;11828;210
2021-05-21;HK;Hong Kong;1;0;11829;210
2021-05-22;HK;Hong Kong;1;0;11830;210
2021-05-23;HK;Hong Kong;2;0;11832;210
2021-05-24;HK;Hong Kong;1;0;11833;210
2021-05-25;HK;Hong Kong;2;0;11835;210
2021-05-26;HK;Hong Kong;1;0;11836;210
2021-05-27;HK;Hong Kong;0;0;11836;210
2021-05-28;HK;Hong Kong;0;0;11836;210
2021-05-29;HK;Hong Kong;1;0;11837;210
2021-05-30;HK;Hong Kong;0;0;11837;210
2021-05-31;HK;Hong Kong;4;0;11841;210
2021-06-01;HK;Hong Kong;7;0;11848;210
2021-06-02;HK;Hong Kong;0;0;11848;210
2021-06-03;HK;Hong Kong;1;0;11849;210
2021-06-04;HK;Hong Kong;1;0;11850;210
2021-06-05;HK;Hong Kong;1;0;11851;210
2021-06-06;HK;Hong Kong;7;0;11858;210
2021-06-07;HK;Hong Kong;7;0;11865;210
2021-06-08;HK;Hong Kong;3;0;11868;210
2021-06-09;HK;Hong Kong;4;0;11872;210
2021-06-10;HK;Hong Kong;2;0;11874;210
2021-06-11;HK;Hong Kong;0;0;11874;210
2021-06-12;HK;Hong Kong;3;0;11877;210
2021-06-13;HK;Hong Kong;0;0;11877;210
2021-06-14;HK;Hong Kong;1;0;11878;210
2021-06-15;HK;Hong Kong;2;0;11880;210
2021-06-16;HK;Hong Kong;1;0;11881;210
2021-06-17;HK;Hong Kong;0;0;11881;210
2021-06-18;HK;Hong Kong;3;0;11884;210
2021-06-19;HK;Hong Kong;1;0;11885;210
2021-06-20;HK;Hong Kong;1;0;11886;210
2021-06-21;HK;Hong Kong;3;0;11889;210
2021-06-22;HK;Hong Kong;7;0;11896;210
2021-06-23;HK;Hong Kong;2;0;11898;210
2021-06-24;HK;Hong Kong;7;0;11905;210
2021-06-25;HK;Hong Kong;4;1;11909;211
2021-06-26;HK;Hong Kong;2;-1;11911;210
2021-06-27;HK;Hong Kong;6;0;11917;210
2021-06-28;HK;Hong Kong;3;0;11920;210
2021-06-29;HK;Hong Kong;1;1;11921;211
2021-06-30;HK;Hong Kong;2;0;11923;211
2021-07-01;HK;Hong Kong;4;0;11927;211
2020-03-03;HU;Hungary;0;0;0;0
2020-03-04;HU;Hungary;2;0;2;0
2020-03-05;HU;Hungary;0;0;2;0
2020-03-06;HU;Hungary;0;0;2;0
2020-03-07;HU;Hungary;2;0;4;0
2020-03-08;HU;Hungary;3;0;7;0
2020-03-09;HU;Hungary;2;0;9;0
2020-03-10;HU;Hungary;0;0;9;0
2020-03-11;HU;Hungary;4;0;13;0
2020-03-12;HU;Hungary;0;0;13;0
2020-03-13;HU;Hungary;6;0;19;0
2020-03-14;HU;Hungary;11;0;30;0
2020-03-15;HU;Hungary;2;1;32;1
2020-03-16;HU;Hungary;7;0;39;1
2020-03-17;HU;Hungary;11;0;50;1
2020-03-18;HU;Hungary;8;0;58;1
2020-03-19;HU;Hungary;15;0;73;1
2020-03-20;HU;Hungary;12;2;85;3
2020-03-21;HU;Hungary;18;1;103;4
2020-03-22;HU;Hungary;28;2;131;6
2020-03-23;HU;Hungary;36;1;167;7
2020-03-24;HU;Hungary;20;2;187;9
2020-03-25;HU;Hungary;39;1;226;10
2020-03-26;HU;Hungary;35;0;261;10
2020-03-27;HU;Hungary;39;0;300;10
2020-03-28;HU;Hungary;43;1;343;11
2020-03-29;HU;Hungary;65;2;408;13
2020-03-30;HU;Hungary;39;2;447;15
2020-03-31;HU;Hungary;45;1;492;16
2020-04-01;HU;Hungary;33;4;525;20
2020-04-02;HU;Hungary;60;1;585;21
2020-04-03;HU;Hungary;38;5;623;26
2020-04-04;HU;Hungary;55;6;678;32
2020-04-05;HU;Hungary;55;2;733;34
2020-04-06;HU;Hungary;11;4;744;38
2020-04-07;HU;Hungary;73;9;817;47
2020-04-08;HU;Hungary;78;11;895;58
2020-04-09;HU;Hungary;85;8;980;66
2020-04-10;HU;Hungary;210;11;1190;77
2020-04-11;HU;Hungary;120;8;1310;85
2020-04-12;HU;Hungary;100;14;1410;99
2020-04-13;HU;Hungary;48;10;1458;109
2020-04-14;HU;Hungary;54;13;1512;122
2020-04-15;HU;Hungary;67;12;1579;134
2020-04-16;HU;Hungary;73;8;1652;142
2020-04-17;HU;Hungary;111;14;1763;156
2020-04-18;HU;Hungary;71;16;1834;172
2020-04-19;HU;Hungary;82;17;1916;189
2020-04-20;HU;Hungary;68;10;1984;199
2020-04-21;HU;Hungary;114;14;2098;213
2020-04-22;HU;Hungary;70;12;2168;225
2020-04-23;HU;Hungary;116;14;2284;239
2020-04-24;HU;Hungary;159;23;2443;262
2020-04-25;HU;Hungary;0;0;2443;262
2020-04-26;HU;Hungary;57;10;2500;272
2020-04-27;HU;Hungary;83;8;2583;280
2020-04-28;HU;Hungary;66;11;2649;291
2020-04-29;HU;Hungary;78;9;2727;300
2020-04-30;HU;Hungary;48;12;2775;312
2020-05-01;HU;Hungary;88;11;2863;323
2020-05-02;HU;Hungary;79;12;2942;335
2020-05-03;HU;Hungary;56;5;2998;340
2020-05-04;HU;Hungary;37;11;3035;351
2020-05-05;HU;Hungary;30;12;3065;363
2020-05-06;HU;Hungary;46;10;3111;373
2020-05-07;HU;Hungary;39;10;3150;383
2020-05-08;HU;Hungary;28;9;3178;392
2020-05-09;HU;Hungary;35;13;3213;405
2020-05-10;HU;Hungary;50;8;3263;413
2020-05-11;HU;Hungary;21;8;3284;421
2020-05-12;HU;Hungary;29;4;3313;425
2020-05-13;HU;Hungary;28;5;3341;430
2020-05-14;HU;Hungary;39;6;3380;436
2020-05-15;HU;Hungary;37;6;3417;442
2020-05-16;HU;Hungary;56;6;3473;448
2020-05-17;HU;Hungary;36;3;3509;451
2020-05-18;HU;Hungary;26;11;3535;462
2020-05-19;HU;Hungary;21;5;3556;467
2020-05-20;HU;Hungary;42;3;3598;470
2020-05-21;HU;Hungary;43;3;3641;473
2020-05-22;HU;Hungary;37;3;3678;476
2020-05-23;HU;Hungary;35;6;3713;482
2020-05-24;HU;Hungary;28;4;3741;486
2020-05-25;HU;Hungary;15;5;3756;491
2020-05-26;HU;Hungary;15;8;3771;499
2020-05-27;HU;Hungary;22;6;3793;505
2020-05-28;HU;Hungary;23;4;3816;509
2020-05-29;HU;Hungary;25;8;3841;517
2020-05-30;HU;Hungary;26;7;3867;524
2020-05-31;HU;Hungary;9;2;3876;526
2020-06-01;HU;Hungary;16;1;3892;527
2020-06-02;HU;Hungary;29;5;3921;532
2020-06-03;HU;Hungary;10;2;3931;534
2020-06-04;HU;Hungary;23;5;3954;539
2020-06-05;HU;Hungary;16;3;3970;542
2020-06-06;HU;Hungary;20;3;3990;545
2020-06-07;HU;Hungary;18;1;4008;546
2020-06-08;HU;Hungary;6;2;4014;548
2020-06-09;HU;Hungary;3;2;4017;550
2020-06-10;HU;Hungary;10;1;4027;551
2020-06-11;HU;Hungary;12;2;4039;553
2020-06-12;HU;Hungary;14;2;4053;555
2020-06-13;HU;Hungary;11;4;4064;559
2020-06-14;HU;Hungary;5;3;4069;562
2020-06-15;HU;Hungary;7;1;4076;563
2020-06-16;HU;Hungary;1;2;4077;565
2020-06-17;HU;Hungary;1;2;4078;567
2020-06-18;HU;Hungary;1;1;4079;568
2020-06-19;HU;Hungary;2;0;4081;568
2020-06-20;HU;Hungary;5;2;4086;570
2020-06-21;HU;Hungary;8;0;4094;570
2020-06-22;HU;Hungary;8;2;4102;572
2020-06-23;HU;Hungary;5;1;4107;573
2020-06-24;HU;Hungary;7;3;4114;576
2020-06-25;HU;Hungary;9;1;4123;577
2020-06-26;HU;Hungary;4;1;4127;578
2020-06-27;HU;Hungary;11;0;4138;578
2020-06-28;HU;Hungary;4;3;4142;581
2020-06-29;HU;Hungary;3;4;4145;585
2020-06-30;HU;Hungary;10;0;4155;585
2020-07-01;HU;Hungary;2;1;4157;586
2020-07-02;HU;Hungary;9;1;4166;587
2020-07-03;HU;Hungary;6;1;4172;588
2020-07-04;HU;Hungary;2;1;4174;589
2020-07-05;HU;Hungary;9;0;4183;589
2020-07-06;HU;Hungary;6;0;4189;589
2020-07-07;HU;Hungary;16;0;4205;589
2020-07-08;HU;Hungary;5;0;4210;589
2020-07-09;HU;Hungary;10;2;4220;591
2020-07-10;HU;Hungary;3;2;4223;593
2020-07-11;HU;Hungary;6;2;4229;595
2020-07-12;HU;Hungary;5;0;4234;595
2020-07-13;HU;Hungary;13;0;4247;595
2020-07-14;HU;Hungary;11;0;4258;595
2020-07-15;HU;Hungary;5;0;4263;595
2020-07-16;HU;Hungary;16;0;4279;595
2020-07-17;HU;Hungary;14;0;4293;595
2020-07-18;HU;Hungary;22;1;4315;596
2020-07-19;HU;Hungary;18;0;4333;596
2020-07-20;HU;Hungary;6;0;4339;596
2020-07-21;HU;Hungary;8;0;4347;596
2020-07-22;HU;Hungary;19;0;4366;596
2020-07-23;HU;Hungary;14;0;4380;596
2020-07-24;HU;Hungary;18;0;4398;596
2020-07-25;HU;Hungary;26;0;4424;596
2020-07-26;HU;Hungary;11;0;4435;596
2020-07-27;HU;Hungary;13;0;4448;596
2020-07-28;HU;Hungary;8;0;4456;596
2020-07-29;HU;Hungary;9;0;4465;596
2020-07-30;HU;Hungary;19;0;4484;596
2020-07-31;HU;Hungary;21;0;4505;596
2020-08-01;HU;Hungary;21;1;4526;597
2020-08-02;HU;Hungary;9;0;4535;597
2020-08-03;HU;Hungary;9;0;4544;597
2020-08-04;HU;Hungary;9;1;4553;598
2020-08-05;HU;Hungary;11;1;4564;599
2020-08-06;HU;Hungary;33;1;4597;600
2020-08-07;HU;Hungary;24;2;4621;602
2020-08-08;HU;Hungary;32;0;4653;602
2020-08-09;HU;Hungary;43;0;4696;602
2020-08-10;HU;Hungary;35;3;4731;605
2020-08-11;HU;Hungary;15;0;4746;605
2020-08-12;HU;Hungary;22;0;4768;605
2020-08-13;HU;Hungary;45;2;4813;607
2020-08-14;HU;Hungary;40;0;4853;607
2020-08-15;HU;Hungary;24;0;4877;607
2020-08-16;HU;Hungary;39;1;4916;608
2020-08-17;HU;Hungary;30;0;4946;608
2020-08-18;HU;Hungary;24;1;4970;609
2020-08-19;HU;Hungary;32;0;5002;609
2020-08-20;HU;Hungary;44;0;5046;609
2020-08-21;HU;Hungary;52;2;5098;611
2020-08-22;HU;Hungary;35;0;5133;611
2020-08-23;HU;Hungary;22;2;5155;613
2020-08-24;HU;Hungary;36;0;5191;613
2020-08-25;HU;Hungary;24;1;5215;614
2020-08-26;HU;Hungary;73;0;5288;614
2020-08-27;HU;Hungary;91;0;5379;614
2020-08-28;HU;Hungary;132;0;5511;614
2020-08-29;HU;Hungary;158;0;5669;614
2020-08-30;HU;Hungary;292;0;5961;614
2020-08-31;HU;Hungary;178;1;6139;615
2020-09-01;HU;Hungary;118;1;6257;616
2020-09-02;HU;Hungary;365;3;6622;619
2020-09-03;HU;Hungary;301;1;6923;620
2020-09-04;HU;Hungary;459;1;7382;621
2020-09-05;HU;Hungary;510;3;7892;624
2020-09-06;HU;Hungary;495;0;8387;624
2020-09-07;HU;Hungary;576;1;8963;625
2020-09-08;HU;Hungary;341;1;9304;626
2020-09-09;HU;Hungary;411;2;9715;628
2020-09-10;HU;Hungary;476;2;10191;630
2020-09-11;HU;Hungary;718;1;10909;631
2020-09-12;HU;Hungary;916;2;11825;633
2020-09-13;HU;Hungary;484;4;12309;637
2020-09-14;HU;Hungary;844;5;13153;642
2020-09-15;HU;Hungary;726;4;13879;646
2020-09-16;HU;Hungary;581;8;14460;654
2020-09-17;HU;Hungary;710;9;15170;663
2020-09-18;HU;Hungary;941;6;16111;669
2020-09-19;HU;Hungary;809;6;16920;675
2020-09-20;HU;Hungary;1070;8;17990;683
2020-09-21;HU;Hungary;876;3;18866;686
2020-09-22;HU;Hungary;633;8;19499;694
2020-09-23;HU;Hungary;951;8;20450;702
2020-09-24;HU;Hungary;750;7;21200;709
2020-09-25;HU;Hungary;927;9;22127;718
2020-09-26;HU;Hungary;950;12;23077;730
2020-09-27;HU;Hungary;937;6;24014;736
2020-09-28;HU;Hungary;702;13;24716;749
2020-09-29;HU;Hungary;851;8;25567;757
2020-09-30;HU;Hungary;894;8;26461;765
2020-10-01;HU;Hungary;848;16;27309;781
2020-10-02;HU;Hungary;1322;17;28631;798
2020-10-03;HU;Hungary;1086;14;29717;812
2020-10-04;HU;Hungary;858;10;30575;822
2020-10-05;HU;Hungary;905;11;31480;833
2020-10-06;HU;Hungary;818;20;32298;853
2020-10-07;HU;Hungary;816;24;33114;877
2020-10-08;HU;Hungary;932;21;34046;898
2020-10-09;HU;Hungary;1176;15;35222;913
2020-10-10;HU;Hungary;1374;20;36596;933
2020-10-11;HU;Hungary;1068;21;37664;954
2020-10-12;HU;Hungary;1173;14;38837;968
2020-10-13;HU;Hungary;1025;28;39862;996
2020-10-14;HU;Hungary;920;27;40782;1023
2020-10-15;HU;Hungary;950;29;41732;1052
2020-10-16;HU;Hungary;1293;33;43025;1085
2020-10-17;HU;Hungary;1791;24;44816;1109
2020-10-18;HU;Hungary;1474;33;46290;1142
2020-10-19;HU;Hungary;1478;31;47768;1173
2020-10-20;HU;Hungary;989;38;48757;1211
2020-10-21;HU;Hungary;1423;48;50180;1259
2020-10-22;HU;Hungary;2032;46;52212;1305
2020-10-23;HU;Hungary;2066;47;54278;1352
2020-10-24;HU;Hungary;1820;38;56098;1390
2020-10-25;HU;Hungary;3149;35;59247;1425
2020-10-26;HU;Hungary;2316;47;61563;1472
2020-10-27;HU;Hungary;2079;63;63642;1535
2020-10-28;HU;Hungary;2291;43;65933;1578
2020-10-29;HU;Hungary;2194;56;68127;1634
2020-10-30;HU;Hungary;3286;65;71413;1699
2020-10-31;HU;Hungary;3908;51;75321;1750
2020-11-01;HU;Hungary;3878;69;79199;1819
2020-11-02;HU;Hungary;3581;70;82780;1889
2020-11-03;HU;Hungary;3989;84;86769;1973
2020-11-04;HU;Hungary;4219;90;90988;2063
2020-11-05;HU;Hungary;3928;84;94916;2147
2020-11-06;HU;Hungary;4709;103;99625;2250
2020-11-07;HU;Hungary;5318;107;104943;2357
2020-11-08;HU;Hungary;4673;81;109616;2438
2020-11-09;HU;Hungary;5162;55;114778;2493
2020-11-10;HU;Hungary;4140;103;118918;2596
2020-11-11;HU;Hungary;3945;101;122863;2697
2020-11-12;HU;Hungary;3927;87;126790;2784
2020-11-13;HU;Hungary;5097;99;131887;2883
2020-11-14;HU;Hungary;4836;107;136723;2990
2020-11-15;HU;Hungary;4238;107;140961;3097
2020-11-16;HU;Hungary;6495;93;147456;3190
2020-11-17;HU;Hungary;5203;91;152659;3281
2020-11-18;HU;Hungary;4290;99;156949;3380
2020-11-19;HU;Hungary;4512;92;161461;3472
2020-11-20;HU;Hungary;4440;96;165901;3568
2020-11-21;HU;Hungary;4397;121;170298;3689
2020-11-22;HU;Hungary;4320;111;174618;3800
2020-11-23;HU;Hungary;3334;91;177952;3891
2020-11-24;HU;Hungary;3929;117;181881;4008
2020-11-25;HU;Hungary;3806;106;185687;4114
2020-11-26;HU;Hungary;6360;115;192047;4229
2020-11-27;HU;Hungary;6393;135;198440;4364
2020-11-28;HU;Hungary;6268;152;204708;4516
2020-11-29;HU;Hungary;6819;156;211527;4672
2020-11-30;HU;Hungary;5595;151;217122;4823
2020-12-01;HU;Hungary;3951;154;221073;4977
2020-12-02;HU;Hungary;4136;165;225209;5142
2020-12-03;HU;Hungary;6635;182;231844;5324
2020-12-04;HU;Hungary;6212;189;238056;5513
2020-12-05;HU;Hungary;5525;193;243581;5706
2020-12-06;HU;Hungary;6697;162;250278;5868
2020-12-07;HU;Hungary;3870;116;254148;5984
2020-12-08;HU;Hungary;2219;136;256367;6120
2020-12-09;HU;Hungary;3221;160;259588;6280
2020-12-10;HU;Hungary;5415;171;265003;6451
2020-12-11;HU;Hungary;6197;171;271200;6622
2020-12-12;HU;Hungary;5047;162;276247;6784
2020-12-13;HU;Hungary;4153;181;280400;6965
2020-12-14;HU;Hungary;3470;165;283870;7130
2020-12-15;HU;Hungary;1893;107;285763;7237
2020-12-16;HU;Hungary;2804;144;288567;7381
2020-12-17;HU;Hungary;2982;157;291549;7538
2020-12-18;HU;Hungary;4428;187;295977;7725
2020-12-19;HU;Hungary;4045;189;300022;7914
2020-12-20;HU;Hungary;2967;185;302989;8099
2020-12-21;HU;Hungary;2141;183;305130;8282
2020-12-22;HU;Hungary;1238;180;306368;8462
2020-12-23;HU;Hungary;1894;154;308262;8616
2020-12-24;HU;Hungary;3292;113;311554;8729
2020-12-25;HU;Hungary;2610;104;314164;8833
2020-12-26;HU;Hungary;1198;118;315362;8951
2020-12-27;HU;Hungary;698;96;316060;9047
2020-12-28;HU;Hungary;609;114;316669;9161
2020-12-29;HU;Hungary;902;131;317571;9292
2020-12-30;HU;Hungary;1972;137;319543;9429
2020-12-31;HU;Hungary;2971;108;322514;9537
2021-01-01;HU;Hungary;2764;130;325278;9667
2021-01-02;HU;Hungary;1410;114;326688;9781
2021-01-03;HU;Hungary;1307;103;327995;9884
2021-01-04;HU;Hungary;856;93;328851;9977
2021-01-05;HU;Hungary;870;103;329721;10080
2021-01-06;HU;Hungary;2047;118;331768;10198
2021-01-07;HU;Hungary;3068;127;334836;10325
2021-01-08;HU;Hungary;2907;115;337743;10440
2021-01-09;HU;Hungary;2716;114;340459;10554
2021-01-10;HU;Hungary;1778;94;342237;10648
2021-01-11;HU;Hungary;1419;77;343656;10725
2021-01-12;HU;Hungary;696;128;344352;10853
2021-01-13;HU;Hungary;1358;95;345710;10948
2021-01-14;HU;Hungary;1926;118;347636;11066
2021-01-15;HU;Hungary;1513;111;349149;11177
2021-01-16;HU;Hungary;1438;87;350587;11264
2021-01-17;HU;Hungary;1241;77;351828;11341
2021-01-18;HU;Hungary;875;68;352703;11409
2021-01-19;HU;Hungary;573;111;353276;11520
2021-01-20;HU;Hungary;976;95;354252;11615
2021-01-21;HU;Hungary;1410;98;355662;11713
2021-01-22;HU;Hungary;1311;98;356973;11811
2021-01-23;HU;Hungary;1344;93;358317;11904
2021-01-24;HU;Hungary;1257;64;359574;11968
2021-01-25;HU;Hungary;844;56;360418;12024
2021-01-26;HU;Hungary;459;89;360877;12113
2021-01-27;HU;Hungary;1004;85;361881;12198
2021-01-28;HU;Hungary;1569;93;363450;12291
2021-01-29;HU;Hungary;1459;83;364909;12374
2021-01-30;HU;Hungary;1370;89;366279;12463
2021-01-31;HU;Hungary;1307;61;367586;12524
2021-02-01;HU;Hungary;1124;54;368710;12578
2021-02-02;HU;Hungary;578;78;369288;12656
2021-02-03;HU;Hungary;1048;83;370336;12739
2021-02-04;HU;Hungary;1652;93;371988;12832
2021-02-05;HU;Hungary;1576;98;373564;12930
2021-02-06;HU;Hungary;1561;96;375125;13026
2021-02-07;HU;Hungary;1370;64;376495;13090
2021-02-08;HU;Hungary;1160;65;377655;13155
2021-02-09;HU;Hungary;1079;94;378734;13249
2021-02-10;HU;Hungary;1279;98;380013;13347
2021-02-11;HU;Hungary;1862;97;381875;13444
2021-02-12;HU;Hungary;1860;99;383735;13543
2021-02-13;HU;Hungary;2020;93;385755;13636
2021-02-14;HU;Hungary;1707;70;387462;13706
2021-02-15;HU;Hungary;1337;46;388799;13752
2021-02-16;HU;Hungary;823;85;389622;13837
2021-02-17;HU;Hungary;1548;94;391170;13931
2021-02-18;HU;Hungary;2853;104;394023;14035
2021-02-19;HU;Hungary;3093;110;397116;14145
2021-02-20;HU;Hungary;2995;107;400111;14252
2021-02-21;HU;Hungary;2912;47;403023;14299
2021-02-22;HU;Hungary;2623;48;405646;14347
2021-02-23;HU;Hungary;1628;103;407274;14450
2021-02-24;HU;Hungary;2855;102;410129;14552
2021-02-25;HU;Hungary;4385;120;414514;14672
2021-02-26;HU;Hungary;4668;123;419182;14795
2021-02-27;HU;Hungary;4948;107;424130;14902
2021-02-28;HU;Hungary;4469;72;428599;14974
2021-03-01;HU;Hungary;4326;84;432925;15058
2021-03-02;HU;Hungary;2764;130;435689;15188
2021-03-03;HU;Hungary;4211;136;439900;15324
2021-03-04;HU;Hungary;6278;152;446178;15476
2021-03-05;HU;Hungary;6369;143;452547;15619
2021-03-06;HU;Hungary;7269;146;459816;15765
2021-03-07;HU;Hungary;6201;108;466017;15873
2021-03-08;HU;Hungary;2696;115;468713;15988
2021-03-09;HU;Hungary;6494;158;475207;16146
2021-03-10;HU;Hungary;5653;179;480860;16325
2021-03-11;HU;Hungary;8312;172;489172;16497
2021-03-12;HU;Hungary;9011;130;498183;16627
2021-03-13;HU;Hungary;9444;163;507627;16790
2021-03-14;HU;Hungary;8863;162;516490;16952
2021-03-15;HU;Hungary;7706;131;524196;17083
2021-03-16;HU;Hungary;4926;143;529122;17226
2021-03-17;HU;Hungary;3456;195;532578;17421
2021-03-18;HU;Hungary;6502;207;539080;17628
2021-03-19;HU;Hungary;10759;213;549839;17841
2021-03-20;HU;Hungary;11132;227;560971;18068
2021-03-21;HU;Hungary;10625;194;571596;18262
2021-03-22;HU;Hungary;9046;189;580642;18451
2021-03-23;HU;Hungary;5481;252;586123;18703
2021-03-24;HU;Hungary;7587;249;593710;18952
2021-03-25;HU;Hungary;9637;272;603347;19224
2021-03-26;HU;Hungary;11265;275;614612;19499
2021-03-27;HU;Hungary;10167;253;624779;19752
2021-03-28;HU;Hungary;9082;220;633861;19972
2021-03-29;HU;Hungary;7263;189;641124;20161
2021-03-30;HU;Hungary;4609;274;645733;20435
2021-03-31;HU;Hungary;6700;302;652433;20737
2021-04-01;HU;Hungary;9288;258;661721;20995
2021-04-02;HU;Hungary;9055;267;670776;21262
2021-04-03;HU;Hungary;8637;242;679413;21504
2021-04-04;HU;Hungary;6566;211;685979;21715
2021-04-05;HU;Hungary;3874;213;689853;21928
2021-04-06;HU;Hungary;1890;170;691743;22098
2021-04-07;HU;Hungary;1933;311;693676;22409
2021-04-08;HU;Hungary;4814;272;698490;22681
2021-04-09;HU;Hungary;7325;285;705815;22966
2021-04-10;HU;Hungary;8053;245;713868;23211
2021-04-11;HU;Hungary;6296;206;720164;23417
2021-04-12;HU;Hungary;5077;291;725241;23708
2021-04-13;HU;Hungary;2837;272;728078;23980
2021-04-14;HU;Hungary;3597;285;731675;24265
2021-04-15;HU;Hungary;5307;256;736982;24521
2021-04-16;HU;Hungary;5216;241;742198;24762
2021-04-17;HU;Hungary;4604;217;746802;24979
2021-04-18;HU;Hungary;3706;205;750508;25184
2021-04-19;HU;Hungary;2680;197;753188;25381
2021-04-20;HU;Hungary;1645;199;754833;25580
2021-04-21;HU;Hungary;2527;207;757360;25787
2021-04-22;HU;Hungary;3607;214;760967;26001
2021-04-23;HU;Hungary;3427;207;764394;26208
2021-04-24;HU;Hungary;2796;212;767190;26420
2021-04-25;HU;Hungary;2328;205;769518;26625
2021-04-26;HU;Hungary;1936;176;771454;26801
2021-04-27;HU;Hungary;1253;183;772707;26984
2021-04-28;HU;Hungary;1692;188;774399;27172
2021-04-29;HU;Hungary;2584;186;776983;27358
2021-04-30;HU;Hungary;2365;182;779348;27540
2021-05-01;HU;Hungary;1951;161;781299;27701
2021-05-02;HU;Hungary;1593;101;782892;27802
2021-05-03;HU;Hungary;1219;106;784111;27908
2021-05-04;HU;Hungary;726;137;784837;28045
2021-05-05;HU;Hungary;1130;128;785967;28173
2021-05-06;HU;Hungary;1680;124;787647;28297
2021-05-07;HU;Hungary;1541;106;789188;28403
2021-05-08;HU;Hungary;1376;101;790564;28504
2021-05-09;HU;Hungary;1145;98;791709;28602
2021-05-10;HU;Hungary;677;91;792386;28693
2021-05-11;HU;Hungary;493;99;792879;28792
2021-05-12;HU;Hungary;905;96;793784;28888
2021-05-13;HU;Hungary;1416;82;795200;28970
2021-05-14;HU;Hungary;1190;71;796390;29041
2021-05-15;HU;Hungary;1039;73;797429;29114
2021-05-16;HU;Hungary;718;61;798147;29175
2021-05-17;HU;Hungary;426;38;798573;29213
2021-05-18;HU;Hungary;382;64;798955;29277
2021-05-19;HU;Hungary;633;52;799588;29329
2021-05-20;HU;Hungary;780;51;800368;29380
2021-05-21;HU;Hungary;657;47;801025;29427
2021-05-22;HU;Hungary;647;48;801672;29475
2021-05-23;HU;Hungary;416;44;802088;29519
2021-05-24;HU;Hungary;258;41;802346;29560
2021-05-25;HU;Hungary;164;21;802510;29581
2021-05-26;HU;Hungary;213;41;802723;29622
2021-05-27;HU;Hungary;396;32;803119;29654
2021-05-28;HU;Hungary;448;28;803567;29682
2021-05-29;HU;Hungary;465;27;804032;29709
2021-05-30;HU;Hungary;350;19;804382;29728
2021-05-31;HU;Hungary;156;5;804538;29733
2021-06-01;HU;Hungary;174;28;804712;29761
2021-06-02;HU;Hungary;275;13;804987;29774
2021-06-03;HU;Hungary;315;18;805302;29792
2021-06-04;HU;Hungary;269;26;805571;29818
2021-06-05;HU;Hungary;300;24;805871;29842
2021-06-06;HU;Hungary;137;12;806008;29854
2021-06-07;HU;Hungary;81;12;806089;29866
2021-06-08;HU;Hungary;117;17;806206;29883
2021-06-09;HU;Hungary;179;6;806385;29889
2021-06-10;HU;Hungary;206;7;806591;29896
2021-06-11;HU;Hungary;199;8;806790;29904
2021-06-12;HU;Hungary;0;0;806790;29904
2021-06-13;HU;Hungary;0;0;806790;29904
2021-06-14;HU;Hungary;255;21;807045;29925
2021-06-15;HU;Hungary;57;10;807102;29935
2021-06-16;HU;Hungary;107;9;807209;29944
2021-06-17;HU;Hungary;113;4;807322;29948
2021-06-18;HU;Hungary;106;2;807428;29950
2021-06-19;HU;Hungary;0;0;807428;29950
2021-06-20;HU;Hungary;0;0;807428;29950
2021-06-21;HU;Hungary;202;9;807630;29959
2021-06-22;HU;Hungary;54;4;807684;29963
2021-06-23;HU;Hungary;91;8;807775;29971
2021-06-24;HU;Hungary;69;1;807844;29972
2021-06-25;HU;Hungary;66;8;807910;29980
2021-06-26;HU;Hungary;0;0;807910;29980
2021-06-27;HU;Hungary;0;0;807910;29980
2021-06-28;HU;Hungary;132;9;808042;29989
2021-06-29;HU;Hungary;34;2;808076;29991
2021-06-30;HU;Hungary;52;1;808128;29992
2021-07-01;HU;Hungary;32;0;808160;29992
2020-02-27;IS;Iceland;0;0;0;0
2020-02-28;IS;Iceland;1;0;1;0
2020-02-29;IS;Iceland;0;0;1;0
2020-03-01;IS;Iceland;2;0;3;0
2020-03-02;IS;Iceland;3;0;6;0
2020-03-03;IS;Iceland;5;0;11;0
2020-03-04;IS;Iceland;15;0;26;0
2020-03-05;IS;Iceland;8;0;34;0
2020-03-06;IS;Iceland;9;0;43;0
2020-03-07;IS;Iceland;7;0;50;0
2020-03-08;IS;Iceland;0;0;50;0
2020-03-09;IS;Iceland;8;0;58;0
2020-03-10;IS;Iceland;11;0;69;0
2020-03-11;IS;Iceland;16;0;85;0
2020-03-12;IS;Iceland;18;0;103;0
2020-03-13;IS;Iceland;31;0;134;0
2020-03-14;IS;Iceland;22;0;156;0
2020-03-15;IS;Iceland;15;0;171;0
2020-03-16;IS;Iceland;9;0;180;0
2020-03-17;IS;Iceland;40;0;220;0
2020-03-18;IS;Iceland;30;0;250;0
2020-03-19;IS;Iceland;80;0;330;0
2020-03-20;IS;Iceland;79;0;409;0
2020-03-21;IS;Iceland;64;1;473;1
2020-03-22;IS;Iceland;95;0;568;1
2020-03-23;IS;Iceland;20;0;588;1
2020-03-24;IS;Iceland;60;1;648;2
2020-03-25;IS;Iceland;89;0;737;2
2020-03-26;IS;Iceland;65;0;802;2
2020-03-27;IS;Iceland;88;0;890;2
2020-03-28;IS;Iceland;73;0;963;2
2020-03-29;IS;Iceland;57;0;1020;2
2020-03-30;IS;Iceland;66;0;1086;2
2020-03-31;IS;Iceland;49;0;1135;2
2020-04-01;IS;Iceland;85;0;1220;2
2020-04-02;IS;Iceland;99;2;1319;4
2020-04-03;IS;Iceland;45;0;1364;4
2020-04-04;IS;Iceland;53;0;1417;4
2020-04-05;IS;Iceland;69;0;1486;4
2020-04-06;IS;Iceland;76;2;1562;6
2020-04-07;IS;Iceland;24;0;1586;6
2020-04-08;IS;Iceland;30;0;1616;6
2020-04-09;IS;Iceland;32;0;1648;6
2020-04-10;IS;Iceland;27;1;1675;7
2020-04-11;IS;Iceland;14;1;1689;8
2020-04-12;IS;Iceland;12;0;1701;8
2020-04-13;IS;Iceland;10;0;1711;8
2020-04-14;IS;Iceland;9;0;1720;8
2020-04-15;IS;Iceland;7;0;1727;8
2020-04-16;IS;Iceland;12;0;1739;8
2020-04-17;IS;Iceland;15;1;1754;9
2020-04-18;IS;Iceland;6;0;1760;9
2020-04-19;IS;Iceland;11;0;1771;9
2020-04-20;IS;Iceland;2;1;1773;10
2020-04-21;IS;Iceland;5;0;1778;10
2020-04-22;IS;Iceland;7;0;1785;10
2020-04-23;IS;Iceland;4;0;1789;10
2020-04-24;IS;Iceland;0;0;1789;10
2020-04-25;IS;Iceland;1;0;1790;10
2020-04-26;IS;Iceland;2;0;1792;10
2020-04-27;IS;Iceland;0;0;1792;10
2020-04-28;IS;Iceland;3;0;1795;10
2020-04-29;IS;Iceland;2;0;1797;10
2020-04-30;IS;Iceland;0;0;1797;10
2020-05-01;IS;Iceland;1;0;1798;10
2020-05-02;IS;Iceland;0;0;1798;10
2020-05-03;IS;Iceland;1;0;1799;10
2020-05-04;IS;Iceland;0;0;1799;10
2020-05-05;IS;Iceland;0;0;1799;10
2020-05-06;IS;Iceland;0;0;1799;10
2020-05-07;IS;Iceland;2;0;1801;10
2020-05-08;IS;Iceland;0;0;1801;10
2020-05-09;IS;Iceland;0;0;1801;10
2020-05-10;IS;Iceland;0;0;1801;10
2020-05-11;IS;Iceland;0;0;1801;10
2020-05-12;IS;Iceland;0;0;1801;10
2020-05-13;IS;Iceland;1;0;1802;10
2020-05-14;IS;Iceland;0;0;1802;10
2020-05-15;IS;Iceland;0;0;1802;10
2020-05-16;IS;Iceland;0;0;1802;10
2020-05-17;IS;Iceland;0;0;1802;10
2020-05-18;IS;Iceland;0;0;1802;10
2020-05-19;IS;Iceland;0;0;1802;10
2020-05-20;IS;Iceland;1;0;1803;10
2020-05-21;IS;Iceland;0;0;1803;10
2020-05-22;IS;Iceland;0;0;1803;10
2020-05-23;IS;Iceland;1;0;1804;10
2020-05-24;IS;Iceland;0;0;1804;10
2020-05-25;IS;Iceland;0;0;1804;10
2020-05-26;IS;Iceland;0;0;1804;10
2020-05-27;IS;Iceland;1;0;1805;10
2020-05-28;IS;Iceland;0;0;1805;10
2020-05-29;IS;Iceland;0;0;1805;10
2020-05-30;IS;Iceland;1;0;1806;10
2020-05-31;IS;Iceland;0;0;1806;10
2020-06-01;IS;Iceland;0;0;1806;10
2020-06-02;IS;Iceland;0;0;1806;10
2020-06-03;IS;Iceland;0;0;1806;10
2020-06-04;IS;Iceland;0;0;1806;10
2020-06-05;IS;Iceland;0;0;1806;10
2020-06-06;IS;Iceland;0;0;1806;10
2020-06-07;IS;Iceland;1;0;1807;10
2020-06-08;IS;Iceland;0;0;1807;10
2020-06-09;IS;Iceland;0;0;1807;10
2020-06-10;IS;Iceland;0;0;1807;10
2020-06-11;IS;Iceland;0;0;1807;10
2020-06-12;IS;Iceland;0;0;1807;10
2020-06-13;IS;Iceland;1;0;1808;10
2020-06-14;IS;Iceland;2;0;1810;10
2020-06-15;IS;Iceland;1;0;1811;10
2020-06-16;IS;Iceland;1;0;1812;10
2020-06-17;IS;Iceland;0;0;1812;10
2020-06-18;IS;Iceland;2;0;1814;10
2020-06-19;IS;Iceland;1;0;1815;10
2020-06-20;IS;Iceland;0;0;1815;10
2020-06-21;IS;Iceland;0;0;1815;10
2020-06-22;IS;Iceland;0;0;1815;10
2020-06-23;IS;Iceland;0;0;1815;10
2020-06-24;IS;Iceland;2;0;1817;10
2020-06-25;IS;Iceland;1;0;1818;10
2020-06-26;IS;Iceland;2;0;1820;10
2020-06-27;IS;Iceland;0;0;1820;10
2020-06-28;IS;Iceland;1;0;1821;10
2020-06-29;IS;Iceland;1;0;1822;10
2020-06-30;IS;Iceland;2;0;1824;10
2020-07-01;IS;Iceland;1;0;1825;10
2020-07-02;IS;Iceland;5;0;1830;10
2020-07-03;IS;Iceland;0;0;1830;10
2020-07-04;IS;Iceland;0;0;1830;10
2020-07-05;IS;Iceland;0;0;1830;10
2020-07-06;IS;Iceland;2;0;1832;10
2020-07-07;IS;Iceland;1;0;1833;10
2020-07-08;IS;Iceland;0;0;1833;10
2020-07-09;IS;Iceland;0;0;1833;10
2020-07-10;IS;Iceland;0;0;1833;10
2020-07-11;IS;Iceland;0;0;1833;10
2020-07-12;IS;Iceland;0;0;1833;10
2020-07-13;IS;Iceland;0;0;1833;10
2020-07-14;IS;Iceland;2;0;1835;10
2020-07-15;IS;Iceland;0;0;1835;10
2020-07-16;IS;Iceland;1;0;1836;10
2020-07-17;IS;Iceland;0;0;1836;10
2020-07-18;IS;Iceland;2;0;1838;10
2020-07-19;IS;Iceland;1;0;1839;10
2020-07-20;IS;Iceland;0;0;1839;10
2020-07-21;IS;Iceland;0;0;1839;10
2020-07-22;IS;Iceland;1;0;1840;10
2020-07-23;IS;Iceland;1;0;1841;10
2020-07-24;IS;Iceland;2;0;1843;10
2020-07-25;IS;Iceland;0;0;1843;10
2020-07-26;IS;Iceland;4;0;1847;10
2020-07-27;IS;Iceland;7;0;1854;10
2020-07-28;IS;Iceland;3;0;1857;10
2020-07-29;IS;Iceland;4;0;1861;10
2020-07-30;IS;Iceland;11;0;1872;10
2020-07-31;IS;Iceland;13;0;1885;10
2020-08-01;IS;Iceland;8;0;1893;10
2020-08-02;IS;Iceland;14;0;1907;10
2020-08-03;IS;Iceland;8;0;1915;10
2020-08-04;IS;Iceland;3;0;1918;10
2020-08-05;IS;Iceland;8;0;1926;10
2020-08-06;IS;Iceland;6;0;1932;10
2020-08-07;IS;Iceland;20;0;1952;10
2020-08-08;IS;Iceland;3;0;1955;10
2020-08-09;IS;Iceland;3;0;1958;10
2020-08-10;IS;Iceland;4;0;1962;10
2020-08-11;IS;Iceland;6;0;1968;10
2020-08-12;IS;Iceland;4;0;1972;10
2020-08-13;IS;Iceland;4;0;1976;10
2020-08-14;IS;Iceland;7;0;1983;10
2020-08-15;IS;Iceland;16;0;1999;10
2020-08-16;IS;Iceland;12;0;2011;10
2020-08-17;IS;Iceland;3;0;2014;10
2020-08-18;IS;Iceland;13;0;2027;10
2020-08-19;IS;Iceland;8;0;2035;10
2020-08-20;IS;Iceland;5;0;2040;10
2020-08-21;IS;Iceland;10;0;2050;10
2020-08-22;IS;Iceland;8;0;2058;10
2020-08-23;IS;Iceland;6;0;2064;10
2020-08-24;IS;Iceland;9;0;2073;10
2020-08-25;IS;Iceland;4;0;2077;10
2020-08-26;IS;Iceland;5;0;2082;10
2020-08-27;IS;Iceland;5;0;2087;10
2020-08-28;IS;Iceland;5;0;2092;10
2020-08-29;IS;Iceland;8;0;2100;10
2020-08-30;IS;Iceland;5;0;2105;10
2020-08-31;IS;Iceland;2;0;2107;10
2020-09-01;IS;Iceland;9;0;2116;10
2020-09-02;IS;Iceland;5;0;2121;10
2020-09-03;IS;Iceland;7;0;2128;10
2020-09-04;IS;Iceland;7;0;2135;10
2020-09-05;IS;Iceland;1;0;2136;10
2020-09-06;IS;Iceland;5;0;2141;10
2020-09-07;IS;Iceland;2;0;2143;10
2020-09-08;IS;Iceland;7;0;2150;10
2020-09-09;IS;Iceland;3;0;2153;10
2020-09-10;IS;Iceland;4;0;2157;10
2020-09-11;IS;Iceland;4;0;2161;10
2020-09-12;IS;Iceland;1;0;2162;10
2020-09-13;IS;Iceland;3;0;2165;10
2020-09-14;IS;Iceland;3;0;2168;10
2020-09-15;IS;Iceland;6;0;2174;10
2020-09-16;IS;Iceland;15;0;2189;10
2020-09-17;IS;Iceland;17;0;2206;10
2020-09-18;IS;Iceland;24;0;2230;10
2020-09-19;IS;Iceland;77;0;2307;10
2020-09-20;IS;Iceland;0;0;2307;10
2020-09-21;IS;Iceland;70;0;2377;10
2020-09-22;IS;Iceland;42;0;2419;10
2020-09-23;IS;Iceland;57;0;2476;10
2020-09-24;IS;Iceland;36;0;2512;10
2020-09-25;IS;Iceland;49;0;2561;10
2020-09-26;IS;Iceland;40;0;2601;10
2020-09-27;IS;Iceland;22;0;2623;10
2020-09-28;IS;Iceland;40;0;2663;10
2020-09-29;IS;Iceland;32;0;2695;10
2020-09-30;IS;Iceland;33;0;2728;10
2020-10-01;IS;Iceland;41;0;2769;10
2020-10-02;IS;Iceland;40;0;2809;10
2020-10-03;IS;Iceland;63;0;2872;10
2020-10-04;IS;Iceland;49;0;2921;10
2020-10-05;IS;Iceland;59;0;2980;10
2020-10-06;IS;Iceland;101;0;3081;10
2020-10-07;IS;Iceland;91;0;3172;10
2020-10-08;IS;Iceland;95;0;3267;10
2020-10-09;IS;Iceland;106;0;3373;10
2020-10-10;IS;Iceland;87;0;3460;10
2020-10-11;IS;Iceland;66;0;3526;10
2020-10-12;IS;Iceland;56;0;3582;10
2020-10-13;IS;Iceland;86;0;3668;10
2020-10-14;IS;Iceland;89;0;3757;10
2020-10-15;IS;Iceland;80;0;3837;10
2020-10-16;IS;Iceland;92;1;3929;11
2020-10-17;IS;Iceland;69;0;3998;11
2020-10-18;IS;Iceland;57;0;4055;11
2020-10-19;IS;Iceland;46;0;4101;11
2020-10-20;IS;Iceland;92;0;4193;11
2020-10-21;IS;Iceland;37;0;4230;11
2020-10-22;IS;Iceland;38;0;4268;11
2020-10-23;IS;Iceland;40;0;4308;11
2020-10-24;IS;Iceland;86;0;4394;11
2020-10-25;IS;Iceland;54;0;4448;11
2020-10-26;IS;Iceland;56;0;4504;11
2020-10-27;IS;Iceland;70;0;4574;11
2020-10-28;IS;Iceland;97;1;4671;12
2020-10-29;IS;Iceland;48;0;4719;12
2020-10-30;IS;Iceland;78;0;4797;12
2020-10-31;IS;Iceland;68;0;4865;12
2020-11-01;IS;Iceland;25;0;4890;12
2020-11-02;IS;Iceland;41;0;4931;12
2020-11-03;IS;Iceland;26;5;4957;17
2020-11-04;IS;Iceland;32;0;4989;17
2020-11-05;IS;Iceland;28;1;5017;18
2020-11-06;IS;Iceland;22;0;5039;18
2020-11-07;IS;Iceland;24;0;5063;18
2020-11-08;IS;Iceland;15;2;5078;20
2020-11-09;IS;Iceland;23;3;5101;23
2020-11-10;IS;Iceland;13;1;5114;24
2020-11-11;IS;Iceland;28;0;5142;24
2020-11-12;IS;Iceland;18;1;5160;25
2020-11-13;IS;Iceland;10;0;5170;25
2020-11-14;IS;Iceland;16;0;5186;25
2020-11-15;IS;Iceland;3;0;5189;25
2020-11-16;IS;Iceland;16;0;5205;25
2020-11-17;IS;Iceland;10;0;5215;25
2020-11-18;IS;Iceland;11;0;5226;25
2020-11-19;IS;Iceland;5;0;5231;25
2020-11-20;IS;Iceland;20;1;5251;26
2020-11-21;IS;Iceland;18;0;5269;26
2020-11-22;IS;Iceland;8;0;5277;26
2020-11-23;IS;Iceland;12;0;5289;26
2020-11-24;IS;Iceland;9;0;5298;26
2020-11-25;IS;Iceland;14;0;5312;26
2020-11-26;IS;Iceland;11;0;5323;26
2020-11-27;IS;Iceland;23;0;5346;26
2020-11-28;IS;Iceland;25;0;5371;26
2020-11-29;IS;Iceland;10;0;5381;26
2020-11-30;IS;Iceland;11;0;5392;26
2020-12-01;IS;Iceland;21;1;5413;27
2020-12-02;IS;Iceland;0;0;5413;27
2020-12-03;IS;Iceland;35;0;5448;27
2020-12-04;IS;Iceland;14;0;5462;27
2020-12-05;IS;Iceland;14;0;5476;27
2020-12-06;IS;Iceland;6;0;5482;27
2020-12-07;IS;Iceland;14;0;5496;27
2020-12-08;IS;Iceland;10;1;5506;28
2020-12-09;IS;Iceland;10;0;5516;28
2020-12-10;IS;Iceland;8;0;5524;28
2020-12-11;IS;Iceland;15;0;5539;28
2020-12-12;IS;Iceland;13;0;5552;28
2020-12-13;IS;Iceland;5;0;5557;28
2020-12-14;IS;Iceland;7;0;5564;28
2020-12-15;IS;Iceland;7;0;5571;28
2020-12-16;IS;Iceland;7;0;5578;28
2020-12-17;IS;Iceland;10;0;5588;28
2020-12-18;IS;Iceland;16;0;5604;28
2020-12-19;IS;Iceland;17;0;5621;28
2020-12-20;IS;Iceland;21;0;5642;28
2020-12-21;IS;Iceland;14;0;5656;28
2020-12-22;IS;Iceland;11;0;5667;28
2020-12-23;IS;Iceland;16;0;5683;28
2020-12-24;IS;Iceland;0;0;5683;28
2020-12-25;IS;Iceland;0;0;5683;28
2020-12-26;IS;Iceland;0;0;5683;28
2020-12-27;IS;Iceland;0;0;5683;28
2020-12-28;IS;Iceland;43;0;5726;28
2020-12-29;IS;Iceland;10;1;5736;29
2020-12-30;IS;Iceland;18;0;5754;29
2020-12-31;IS;Iceland;0;0;5754;29
2021-01-01;IS;Iceland;0;0;5754;29
2021-01-02;IS;Iceland;0;0;5754;29
2021-01-03;IS;Iceland;0;0;5754;29
2021-01-04;IS;Iceland;41;0;5795;29
2021-01-05;IS;Iceland;16;0;5811;29
2021-01-06;IS;Iceland;21;0;5832;29
2021-01-07;IS;Iceland;13;0;5845;29
2021-01-08;IS;Iceland;22;0;5867;29
2021-01-09;IS;Iceland;13;0;5880;29
2021-01-10;IS;Iceland;10;0;5890;29
2021-01-11;IS;Iceland;8;0;5898;29
2021-01-12;IS;Iceland;14;0;5912;29
2021-01-13;IS;Iceland;23;0;5935;29
2021-01-14;IS;Iceland;13;0;5948;29
2021-01-15;IS;Iceland;8;0;5956;29
2021-01-16;IS;Iceland;0;0;5956;29
2021-01-17;IS;Iceland;0;0;5956;29
2021-01-18;IS;Iceland;14;0;5970;29
2021-01-19;IS;Iceland;0;0;5970;29
2021-01-20;IS;Iceland;5;0;5975;29
2021-01-21;IS;Iceland;6;0;5981;29
2021-01-22;IS;Iceland;0;0;5981;29
2021-01-23;IS;Iceland;0;0;5981;29
2021-01-24;IS;Iceland;0;0;5981;29
2021-01-25;IS;Iceland;9;0;5990;29
2021-01-26;IS;Iceland;2;0;5992;29
2021-01-27;IS;Iceland;8;0;6000;29
2021-01-28;IS;Iceland;1;0;6001;29
2021-01-29;IS;Iceland;1;0;6002;29
2021-01-30;IS;Iceland;0;0;6002;29
2021-01-31;IS;Iceland;0;0;6002;29
2021-02-01;IS;Iceland;7;0;6009;29
2021-02-02;IS;Iceland;2;0;6011;29
2021-02-03;IS;Iceland;2;0;6013;29
2021-02-04;IS;Iceland;3;0;6016;29
2021-02-05;IS;Iceland;5;0;6021;29
2021-02-06;IS;Iceland;0;0;6021;29
2021-02-07;IS;Iceland;0;0;6021;29
2021-02-08;IS;Iceland;-1;0;6020;29
2021-02-09;IS;Iceland;5;0;6025;29
2021-02-10;IS;Iceland;1;0;6026;29
2021-02-11;IS;Iceland;0;0;6026;29
2021-02-12;IS;Iceland;7;0;6033;29
2021-02-13;IS;Iceland;0;0;6033;29
2021-02-14;IS;Iceland;0;0;6033;29
2021-02-15;IS;Iceland;6;0;6039;29
2021-02-16;IS;Iceland;0;0;6039;29
2021-02-17;IS;Iceland;5;0;6044;29
2021-02-18;IS;Iceland;0;0;6044;29
2021-02-19;IS;Iceland;1;0;6045;29
2021-02-20;IS;Iceland;0;0;6045;29
2021-02-21;IS;Iceland;0;0;6045;29
2021-02-22;IS;Iceland;4;0;6049;29
2021-02-23;IS;Iceland;0;0;6049;29
2021-02-24;IS;Iceland;0;0;6049;29
2021-02-25;IS;Iceland;0;0;6049;29
2021-02-26;IS;Iceland;0;0;6049;29
2021-02-27;IS;Iceland;0;0;6049;29
2021-02-28;IS;Iceland;0;0;6049;29
2021-03-01;IS;Iceland;5;0;6054;29
2021-03-02;IS;Iceland;1;0;6055;29
2021-03-03;IS;Iceland;3;0;6058;29
2021-03-04;IS;Iceland;0;0;6058;29
2021-03-05;IS;Iceland;1;0;6059;29
2021-03-06;IS;Iceland;0;0;6059;29
2021-03-07;IS;Iceland;0;0;6059;29
2021-03-08;IS;Iceland;5;0;6064;29
2021-03-09;IS;Iceland;3;0;6067;29
2021-03-10;IS;Iceland;2;0;6069;29
2021-03-11;IS;Iceland;1;0;6070;29
2021-03-12;IS;Iceland;2;0;6072;29
2021-03-13;IS;Iceland;0;0;6072;29
2021-03-14;IS;Iceland;0;0;6072;29
2021-03-15;IS;Iceland;11;0;6083;29
2021-03-16;IS;Iceland;4;0;6087;29
2021-03-17;IS;Iceland;2;0;6089;29
2021-03-18;IS;Iceland;2;0;6091;29
2021-03-19;IS;Iceland;6;0;6097;29
2021-03-20;IS;Iceland;0;0;6097;29
2021-03-21;IS;Iceland;0;0;6097;29
2021-03-22;IS;Iceland;22;0;6119;29
2021-03-23;IS;Iceland;3;0;6122;29
2021-03-24;IS;Iceland;22;0;6144;29
2021-03-25;IS;Iceland;14;0;6158;29
2021-03-26;IS;Iceland;5;0;6163;29
2021-03-27;IS;Iceland;0;0;6163;29
2021-03-28;IS;Iceland;0;0;6163;29
2021-03-29;IS;Iceland;20;0;6183;29
2021-03-30;IS;Iceland;11;0;6194;29
2021-03-31;IS;Iceland;11;0;6205;29
2021-04-01;IS;Iceland;0;0;6205;29
2021-04-02;IS;Iceland;0;0;6205;29
2021-04-03;IS;Iceland;20;0;6225;29
2021-04-04;IS;Iceland;0;0;6225;29
2021-04-05;IS;Iceland;0;0;6225;29
2021-04-06;IS;Iceland;16;0;6241;29
2021-04-07;IS;Iceland;10;0;6251;29
2021-04-08;IS;Iceland;5;0;6256;29
2021-04-09;IS;Iceland;2;0;6258;29
2021-04-10;IS;Iceland;0;0;6258;29
2021-04-11;IS;Iceland;0;0;6258;29
2021-04-12;IS;Iceland;9;0;6267;29
2021-04-13;IS;Iceland;7;0;6274;29
2021-04-14;IS;Iceland;1;0;6275;29
2021-04-15;IS;Iceland;4;0;6279;29
2021-04-16;IS;Iceland;7;0;6286;29
2021-04-17;IS;Iceland;0;0;6286;29
2021-04-18;IS;Iceland;0;0;6286;29
2021-04-19;IS;Iceland;43;0;6329;29
2021-04-20;IS;Iceland;21;0;6350;29
2021-04-21;IS;Iceland;12;0;6362;29
2021-04-22;IS;Iceland;17;0;6379;29
2021-04-23;IS;Iceland;11;0;6390;29
2021-04-24;IS;Iceland;0;0;6390;29
2021-04-25;IS;Iceland;0;0;6390;29
2021-04-26;IS;Iceland;39;0;6429;29
2021-04-27;IS;Iceland;18;0;6447;29
2021-04-28;IS;Iceland;9;0;6456;29
2021-04-29;IS;Iceland;10;0;6466;29
2021-04-30;IS;Iceland;6;0;6472;29
2021-05-01;IS;Iceland;0;0;6472;29
2021-05-02;IS;Iceland;0;0;6472;29
2021-05-03;IS;Iceland;11;0;6483;29
2021-05-04;IS;Iceland;8;0;6491;29
2021-05-05;IS;Iceland;6;0;6497;29
2021-05-06;IS;Iceland;3;0;6500;29
2021-05-07;IS;Iceland;6;0;6506;29
2021-05-08;IS;Iceland;0;0;6506;29
2021-05-09;IS;Iceland;0;0;6506;29
2021-05-10;IS;Iceland;13;0;6519;29
2021-05-11;IS;Iceland;3;0;6522;29
2021-05-12;IS;Iceland;4;0;6526;29
2021-05-13;IS;Iceland;0;0;6526;29
2021-05-14;IS;Iceland;11;0;6537;29
2021-05-15;IS;Iceland;0;0;6537;29
2021-05-16;IS;Iceland;0;0;6537;29
2021-05-17;IS;Iceland;11;0;6548;29
2021-05-18;IS;Iceland;1;0;6549;29
2021-05-19;IS;Iceland;2;0;6551;29
2021-05-20;IS;Iceland;4;0;6555;29
2021-05-21;IS;Iceland;0;0;6555;29
2021-05-22;IS;Iceland;0;0;6555;29
2021-05-23;IS;Iceland;0;0;6555;29
2021-05-24;IS;Iceland;0;0;6555;29
2021-05-25;IS;Iceland;0;0;6555;29
2021-05-26;IS;Iceland;0;0;6555;29
2021-05-27;IS;Iceland;0;0;6555;29
2021-05-28;IS;Iceland;0;0;6555;29
2021-05-29;IS;Iceland;0;0;6555;29
2021-05-30;IS;Iceland;0;0;6555;29
2021-05-31;IS;Iceland;0;0;6555;29
2021-06-01;IS;Iceland;0;0;6555;29
2021-06-02;IS;Iceland;0;0;6555;29
2021-06-03;IS;Iceland;0;0;6555;29
2021-06-04;IS;Iceland;0;0;6555;29
2021-06-05;IS;Iceland;0;0;6555;29
2021-06-06;IS;Iceland;0;0;6555;29
2021-06-07;IS;Iceland;0;0;6555;29
2021-06-08;IS;Iceland;0;0;6555;29
2021-06-09;IS;Iceland;0;0;6555;29
2021-06-10;IS;Iceland;0;0;6555;29
2021-06-11;IS;Iceland;0;0;6555;29
2021-06-12;IS;Iceland;0;0;6555;29
2021-06-13;IS;Iceland;0;0;6555;29
2021-06-14;IS;Iceland;0;0;6555;29
2021-06-15;IS;Iceland;0;0;6555;29
2021-06-16;IS;Iceland;0;0;6555;29
2021-06-17;IS;Iceland;0;0;6555;29
2021-06-18;IS;Iceland;0;0;6555;29
2021-06-19;IS;Iceland;0;0;6555;29
2021-06-20;IS;Iceland;0;0;6555;29
2021-06-21;IS;Iceland;0;0;6555;29
2021-06-22;IS;Iceland;0;0;6555;29
2021-06-23;IS;Iceland;0;0;6555;29
2021-06-24;IS;Iceland;0;0;6555;29
2021-06-25;IS;Iceland;0;0;6555;29
2021-06-26;IS;Iceland;0;0;6555;29
2021-06-27;IS;Iceland;0;0;6555;29
2021-06-28;IS;Iceland;0;0;6555;29
2021-06-29;IS;Iceland;0;0;6555;29
2021-06-30;IS;Iceland;0;0;6555;29
2021-07-01;IS;Iceland;0;0;6555;29
2020-01-30;IN;India;1;0;1;0
2020-01-31;IN;India;0;0;1;0
2020-02-01;IN;India;0;0;1;0
2020-02-02;IN;India;1;0;2;0
2020-02-03;IN;India;1;0;3;0
2020-02-04;IN;India;0;0;3;0
2020-02-05;IN;India;0;0;3;0
2020-02-06;IN;India;0;0;3;0
2020-02-07;IN;India;0;0;3;0
2020-02-08;IN;India;0;0;3;0
2020-02-09;IN;India;0;0;3;0
2020-02-10;IN;India;0;0;3;0
2020-02-11;IN;India;0;0;3;0
2020-02-12;IN;India;0;0;3;0
2020-02-13;IN;India;0;0;3;0
2020-02-14;IN;India;0;0;3;0
2020-02-15;IN;India;0;0;3;0
2020-02-16;IN;India;0;0;3;0
2020-02-17;IN;India;0;0;3;0
2020-02-18;IN;India;0;0;3;0
2020-02-19;IN;India;0;0;3;0
2020-02-20;IN;India;0;0;3;0
2020-02-21;IN;India;0;0;3;0
2020-02-22;IN;India;0;0;3;0
2020-02-23;IN;India;0;0;3;0
2020-02-24;IN;India;0;0;3;0
2020-02-25;IN;India;0;0;3;0
2020-02-26;IN;India;0;0;3;0
2020-02-27;IN;India;0;0;3;0
2020-02-28;IN;India;0;0;3;0
2020-02-29;IN;India;0;0;3;0
2020-03-01;IN;India;0;0;3;0
2020-03-02;IN;India;2;0;5;0
2020-03-03;IN;India;0;0;5;0
2020-03-04;IN;India;23;0;28;0
2020-03-05;IN;India;2;0;30;0
2020-03-06;IN;India;1;0;31;0
2020-03-07;IN;India;3;0;34;0
2020-03-08;IN;India;5;0;39;0
2020-03-09;IN;India;4;0;43;0
2020-03-10;IN;India;13;0;56;0
2020-03-11;IN;India;6;1;62;1
2020-03-12;IN;India;11;0;73;1
2020-03-13;IN;India;9;1;82;2
2020-03-14;IN;India;20;0;102;2
2020-03-15;IN;India;11;0;113;2
2020-03-16;IN;India;6;0;119;2
2020-03-17;IN;India;23;1;142;3
2020-03-18;IN;India;14;0;156;3
2020-03-19;IN;India;38;1;194;4
2020-03-20;IN;India;50;1;244;5
2020-03-21;IN;India;86;-1;330;4
2020-03-22;IN;India;66;3;396;7
2020-03-23;IN;India;103;3;499;10
2020-03-24;IN;India;37;0;536;10
2020-03-25;IN;India;121;2;657;12
2020-03-26;IN;India;70;8;727;20
2020-03-27;IN;India;160;0;887;20
2020-03-28;IN;India;100;4;987;24
2020-03-29;IN;India;37;3;1024;27
2020-03-30;IN;India;227;5;1251;32
2020-03-31;IN;India;146;3;1397;35
2020-04-01;IN;India;601;23;1998;58
2020-04-02;IN;India;545;14;2543;72
2020-04-03;IN;India;24;0;2567;72
2020-04-04;IN;India;515;14;3082;86
2020-04-05;IN;India;506;13;3588;99
2020-04-06;IN;India;1190;37;4778;136
2020-04-07;IN;India;533;14;5311;150
2020-04-08;IN;India;605;28;5916;178
2020-04-09;IN;India;809;48;6725;226
2020-04-10;IN;India;873;20;7598;246
2020-04-11;IN;India;848;42;8446;288
2020-04-12;IN;India;759;43;9205;331
2020-04-13;IN;India;1248;27;10453;358
2020-04-14;IN;India;1034;35;11487;393
2020-04-15;IN;India;835;12;12322;405
2020-04-16;IN;India;1108;43;13430;448
2020-04-17;IN;India;922;38;14352;486
2020-04-18;IN;India;1370;35;15722;521
2020-04-19;IN;India;1893;38;17615;559
2020-04-20;IN;India;924;33;18539;592
2020-04-21;IN;India;1541;53;20080;645
2020-04-22;IN;India;1290;36;21370;681
2020-04-23;IN;India;1707;40;23077;721
2020-04-24;IN;India;1453;59;24530;780
2020-04-25;IN;India;1753;45;26283;825
2020-04-26;IN;India;1607;56;27890;881
2020-04-27;IN;India;1561;58;29451;939
2020-04-28;IN;India;1873;69;31324;1008
2020-04-29;IN;India;1738;71;33062;1079
2020-04-30;IN;India;1801;75;34863;1154
2020-05-01;IN;India;2394;69;37257;1223
2020-05-02;IN;India;2442;100;39699;1323
2020-05-03;IN;India;2806;68;42505;1391
2020-05-04;IN;India;3932;175;46437;1566
2020-05-05;IN;India;2963;127;49400;1693
2020-05-06;IN;India;3587;92;52987;1785
2020-05-07;IN;India;3364;104;56351;1889
2020-05-08;IN;India;3344;96;59695;1985
2020-05-09;IN;India;3113;116;62808;2101
2020-05-10;IN;India;4353;111;67161;2212
2020-05-11;IN;India;3607;82;70768;2294
2020-05-12;IN;India;3524;121;74292;2415
2020-05-13;IN;India;3763;136;78055;2551
2020-05-14;IN;India;3942;98;81997;2649
2020-05-15;IN;India;3787;104;85784;2753
2020-05-16;IN;India;4864;118;90648;2871
2020-05-17;IN;India;5050;154;95698;3025
2020-05-18;IN;India;4630;131;100328;3156
2020-05-19;IN;India;6147;146;106475;3302
2020-05-20;IN;India;5553;132;112028;3434
2020-05-21;IN;India;6198;150;118226;3584
2020-05-22;IN;India;6568;142;124794;3726
2020-05-23;IN;India;6629;142;131423;3868
2020-05-24;IN;India;7113;156;138536;4024
2020-05-25;IN;India;6414;148;144950;4172
2020-05-26;IN;India;5843;172;150793;4344
2020-05-27;IN;India;7293;190;158086;4534
2020-05-28;IN;India;7300;177;165386;4711
2020-05-29;IN;India;8105;269;173491;4980
2020-05-30;IN;India;8336;205;181827;5185
2020-05-31;IN;India;8782;223;190609;5408
2020-06-01;IN;India;7761;200;198370;5608
2020-06-02;IN;India;8821;221;207191;5829
2020-06-03;IN;India;9633;259;216824;6088
2020-06-04;IN;India;9889;275;226713;6363
2020-06-05;IN;India;9471;286;236184;6649
2020-06-06;IN;India;10438;297;246622;6946
2020-06-07;IN;India;10864;261;257486;7207
2020-06-08;IN;India;8442;266;265928;7473
2020-06-09;IN;India;10218;277;276146;7750
2020-06-10;IN;India;10459;352;286605;8102
2020-06-11;IN;India;10930;396;297535;8498
2020-06-12;IN;India;11458;386;308993;8884
2020-06-13;IN;India;11929;311;320922;9195
2020-06-14;IN;India;11502;325;332424;9520
2020-06-15;IN;India;10667;380;343091;9900
2020-06-16;IN;India;10974;2003;354065;11903
2020-06-17;IN;India;12881;334;366946;12237
2020-06-18;IN;India;13586;336;380532;12573
2020-06-19;IN;India;14516;375;395048;12948
2020-06-20;IN;India;15403;306;410451;13254
2020-06-21;IN;India;14831;445;425282;13699
2020-06-22;IN;India;14933;312;440215;14011
2020-06-23;IN;India;15968;465;456183;14476
2020-06-24;IN;India;16922;418;473105;14894
2020-06-25;IN;India;17296;407;490401;15301
2020-06-26;IN;India;18552;384;508953;15685
2020-06-27;IN;India;19906;410;528859;16095
2020-06-28;IN;India;19459;380;548318;16475
2020-06-29;IN;India;18522;418;566840;16893
2020-06-30;IN;India;18641;507;585481;17400
2020-07-01;IN;India;19160;434;604641;17834
2020-07-02;IN;India;20903;379;625544;18213
2020-07-03;IN;India;22771;442;648315;18655
2020-07-04;IN;India;24850;613;673165;19268
2020-07-05;IN;India;24248;425;697413;19693
2020-07-06;IN;India;22251;466;719664;20159
2020-07-07;IN;India;22753;483;742417;20642
2020-07-08;IN;India;24879;487;767296;21129
2020-07-09;IN;India;26506;475;793802;21604
2020-07-10;IN;India;27114;519;820916;22123
2020-07-11;IN;India;28606;550;849522;22673
2020-07-12;IN;India;28732;501;878254;23174
2020-07-13;IN;India;28498;553;906752;23727
2020-07-14;IN;India;29429;582;936181;24309
2020-07-15;IN;India;32676;605;968857;24914
2020-07-16;IN;India;34975;688;1003832;25602
2020-07-17;IN;India;35252;671;1039084;26273
2020-07-18;IN;India;38697;543;1077781;26816
2020-07-19;IN;India;40425;681;1118206;27497
2020-07-20;IN;India;37132;585;1155338;28082
2020-07-21;IN;India;37740;650;1193078;28732
2020-07-22;IN;India;45720;1129;1238798;29861
2020-07-23;IN;India;49310;740;1288108;30601
2020-07-24;IN;India;48916;757;1337024;31358
2020-07-25;IN;India;48611;702;1385635;32060
2020-07-26;IN;India;49981;711;1435616;32771
2020-07-27;IN;India;44457;637;1480073;33408
2020-07-28;IN;India;51596;785;1531669;34193
2020-07-29;IN;India;50294;762;1581963;34955
2020-07-30;IN;India;52783;763;1634746;35718
2020-07-31;IN;India;61242;793;1695988;36511
2020-08-01;IN;India;54735;853;1750723;37364
2020-08-02;IN;India;52972;771;1803695;38135
2020-08-03;IN;India;52050;803;1855745;38938
2020-08-04;IN;India;52509;857;1908254;39795
2020-08-05;IN;India;56282;904;1964536;40699
2020-08-06;IN;India;62538;886;2027074;41585
2020-08-07;IN;India;61537;933;2088611;42518
2020-08-08;IN;India;64399;861;2153010;43379
2020-08-09;IN;India;62064;1007;2215074;44386
2020-08-10;IN;India;53601;871;2268675;45257
2020-08-11;IN;India;60963;834;2329638;46091
2020-08-12;IN;India;66999;942;2396637;47033
2020-08-13;IN;India;64553;1007;2461190;48040
2020-08-14;IN;India;64732;996;2525922;49036
2020-08-15;IN;India;64030;944;2589952;49980
2020-08-16;IN;India;57711;941;2647663;50921
2020-08-17;IN;India;55018;876;2702681;51797
2020-08-18;IN;India;64572;1091;2767253;52888
2020-08-19;IN;India;69672;978;2836925;53866
2020-08-20;IN;India;68900;983;2905825;54849
2020-08-21;IN;India;69876;945;2975701;55794
2020-08-22;IN;India;69239;912;3044940;56706
2020-08-23;IN;India;61408;836;3106348;57542
2020-08-24;IN;India;60975;848;3167323;58390
2020-08-25;IN;India;57224;967;3224547;59357
2020-08-26;IN;India;85687;1115;3310234;60472
2020-08-27;IN;India;77266;1057;3387500;61529
2020-08-28;IN;India;76472;1021;3463972;62550
2020-08-29;IN;India;78761;948;3542733;63498
2020-08-30;IN;India;78512;971;3621245;64469
2020-08-31;IN;India;69921;819;3691166;65288
2020-09-01;IN;India;78357;1045;3769523;66333
2020-09-02;IN;India;83883;1043;3853406;67376
2020-09-03;IN;India;83341;1096;3936747;68472
2020-09-04;IN;India;86432;1089;4023179;69561
2020-09-05;IN;India;90632;1065;4113811;70626
2020-09-06;IN;India;90802;1016;4204613;71642
2020-09-07;IN;India;75809;1133;4280422;72775
2020-09-08;IN;India;89706;1115;4370128;73890
2020-09-09;IN;India;95735;1172;4465863;75062
2020-09-10;IN;India;96551;1209;4562414;76271
2020-09-11;IN;India;97570;1201;4659984;77472
2020-09-12;IN;India;94372;1114;4754356;78586
2020-09-13;IN;India;92071;1136;4846427;79722
2020-09-14;IN;India;83809;1054;4930236;80776
2020-09-15;IN;India;90123;1290;5020359;82066
2020-09-16;IN;India;97894;1132;5118253;83198
2020-09-17;IN;India;96424;1174;5214677;84372
2020-09-18;IN;India;93337;1247;5308014;85619
2020-09-19;IN;India;92605;1133;5400619;86752
2020-09-20;IN;India;86961;1130;5487580;87882
2020-09-21;IN;India;75083;1053;5562663;88935
2020-09-22;IN;India;83347;1085;5646010;90020
2020-09-23;IN;India;86508;1129;5732518;91149
2020-09-24;IN;India;86052;1141;5818570;92290
2020-09-25;IN;India;85362;1089;5903932;93379
2020-09-26;IN;India;88600;1124;5992532;94503
2020-09-27;IN;India;82170;1039;6074702;95542
2020-09-28;IN;India;70589;776;6145291;96318
2020-09-29;IN;India;80472;1179;6225763;97497
2020-09-30;IN;India;86821;1181;6312584;98678
2020-10-01;IN;India;81484;1095;6394068;99773
2020-10-02;IN;India;79476;1069;6473544;100842
2020-10-03;IN;India;75829;940;6549373;101782
2020-10-04;IN;India;74442;903;6623815;102685
2020-10-05;IN;India;61267;884;6685082;103569
2020-10-06;IN;India;72049;986;6757131;104555
2020-10-07;IN;India;78524;971;6835655;105526
2020-10-08;IN;India;70496;964;6906151;106490
2020-10-09;IN;India;73272;926;6979423;107416
2020-10-10;IN;India;74383;918;7053806;108334
2020-10-11;IN;India;66732;816;7120538;109150
2020-10-12;IN;India;55342;706;7175880;109856
2020-10-13;IN;India;63509;730;7239389;110586
2020-10-14;IN;India;67708;680;7307097;111266
2020-10-15;IN;India;63371;895;7370468;112161
2020-10-16;IN;India;62212;837;7432680;112998
2020-10-17;IN;India;61871;1033;7494551;114031
2020-10-18;IN;India;55722;579;7550273;114610
2020-10-19;IN;India;46790;587;7597063;115197
2020-10-20;IN;India;54044;717;7651107;115914
2020-10-21;IN;India;55839;702;7706946;116616
2020-10-22;IN;India;54366;690;7761312;117306
2020-10-23;IN;India;53370;650;7814682;117956
2020-10-24;IN;India;50129;578;7864811;118534
2020-10-25;IN;India;45148;480;7909959;119014
2020-10-26;IN;India;36470;488;7946429;119502
2020-10-27;IN;India;43893;508;7990322;120010
2020-10-28;IN;India;49881;517;8040203;120527
2020-10-29;IN;India;48648;563;8088851;121090
2020-10-30;IN;India;48268;551;8137119;121641
2020-10-31;IN;India;46963;470;8184082;122111
2020-11-01;IN;India;45231;496;8229313;122607
2020-11-02;IN;India;38310;490;8267623;123097
2020-11-03;IN;India;46253;514;8313876;123611
2020-11-04;IN;India;50210;704;8364086;124315
2020-11-05;IN;India;47638;670;8411724;124985
2020-11-06;IN;India;50356;577;8462080;125562
2020-11-07;IN;India;45674;559;8507754;126121
2020-11-08;IN;India;45903;490;8553657;126611
2020-11-09;IN;India;38073;448;8591730;127059
2020-11-10;IN;India;44281;512;8636011;127571
2020-11-11;IN;India;47905;550;8683916;128121
2020-11-12;IN;India;44879;547;8728795;128668
2020-11-13;IN;India;44684;520;8773479;129188
2020-11-14;IN;India;41100;447;8814579;129635
2020-11-15;IN;India;30548;435;8845127;130070
2020-11-16;IN;India;29163;449;8874290;130519
2020-11-17;IN;India;38617;474;8912907;130993
2020-11-18;IN;India;45576;585;8958483;131578
2020-11-19;IN;India;45882;584;9004365;132162
2020-11-20;IN;India;46232;564;9050597;132726
2020-11-21;IN;India;45209;501;9095806;133227
2020-11-22;IN;India;44059;511;9139865;133738
2020-11-23;IN;India;37975;480;9177840;134218
2020-11-24;IN;India;44376;481;9222216;134699
2020-11-25;IN;India;44489;524;9266705;135223
2020-11-26;IN;India;43082;492;9309787;135715
2020-11-27;IN;India;41322;485;9351109;136200
2020-11-28;IN;India;41810;496;9392919;136696
2020-11-29;IN;India;38772;443;9431691;137139
2020-11-30;IN;India;31118;482;9462809;137621
2020-12-01;IN;India;36604;501;9499413;138122
2020-12-02;IN;India;35551;526;9534964;138648
2020-12-03;IN;India;36595;540;9571559;139188
2020-12-04;IN;India;36652;512;9608211;139700
2020-12-05;IN;India;36011;482;9644222;140182
2020-12-06;IN;India;32981;391;9677203;140573
2020-12-07;IN;India;26567;385;9703770;140958
2020-12-08;IN;India;32080;402;9735850;141360
2020-12-09;IN;India;31521;412;9767371;141772
2020-12-10;IN;India;29373;413;9796744;142185
2020-12-11;IN;India;30031;443;9826775;142628
2020-12-12;IN;India;30254;391;9857029;143019
2020-12-13;IN;India;27071;336;9884100;143355
2020-12-14;IN;India;22065;354;9906165;143709
2020-12-15;IN;India;26382;387;9932547;144096
2020-12-16;IN;India;24010;355;9956557;144451
2020-12-17;IN;India;22890;338;9979447;144789
2020-12-18;IN;India;25152;347;10004599;145136
2020-12-19;IN;India;26624;341;10031223;145477
2020-12-20;IN;India;24337;333;10055560;145810
2020-12-21;IN;India;19556;301;10075116;146111
2020-12-22;IN;India;23950;333;10099066;146444
2020-12-23;IN;India;24712;312;10123778;146756
2020-12-24;IN;India;23067;336;10146845;147092
2020-12-25;IN;India;22273;251;10169118;147343
2020-12-26;IN;India;18732;279;10187850;147622
2020-12-27;IN;India;20021;279;10207871;147901
2020-12-28;IN;India;16432;252;10224303;148153
2020-12-29;IN;India;20549;286;10244852;148439
2020-12-30;IN;India;21822;299;10266674;148738
2020-12-31;IN;India;0;0;10266674;148738
2021-01-01;IN;India;20035;256;10286709;148994
2021-01-02;IN;India;37256;441;10323965;149435
2021-01-03;IN;India;16504;214;10340469;149649
2021-01-04;IN;India;16375;201;10356844;149850
2021-01-05;IN;India;18088;264;10374932;150114
2021-01-06;IN;India;20346;222;10395278;150336
2021-01-07;IN;India;18139;234;10413417;150570
2021-01-08;IN;India;0;0;10413417;150570
2021-01-09;IN;India;36867;429;10450284;150999
2021-01-10;IN;India;16311;161;10466595;151160
2021-01-11;IN;India;12584;167;10479179;151327
2021-01-12;IN;India;15968;202;10495147;151529
2021-01-13;IN;India;16946;198;10512093;151727
2021-01-14;IN;India;15590;191;10527683;151918
2021-01-15;IN;India;15158;175;10542841;152093
2021-01-16;IN;India;15144;181;10557985;152274
2021-01-17;IN;India;13788;145;10571773;152419
2021-01-18;IN;India;10050;137;10581823;152556
2021-01-19;IN;India;13816;162;10595639;152718
2021-01-20;IN;India;15244;151;10610883;152869
2021-01-21;IN;India;14545;163;10625428;153032
2021-01-22;IN;India;14256;152;10639684;153184
2021-01-23;IN;India;14849;155;10654533;153339
2021-01-24;IN;India;13203;131;10667736;153470
2021-01-25;IN;India;9102;117;10676838;153587
2021-01-26;IN;India;12689;137;10689527;153724
2021-01-27;IN;India;11666;123;10701193;153847
2021-01-28;IN;India;18855;163;10720048;154010
2021-01-29;IN;India;13082;137;10733130;154147
2021-01-30;IN;India;13044;127;10746174;154274
2021-01-31;IN;India;11436;118;10757610;154392
2021-02-01;IN;India;8635;94;10766245;154486
2021-02-02;IN;India;11039;110;10777284;154596
2021-02-03;IN;India;12899;107;10790183;154703
2021-02-04;IN;India;12408;120;10802591;154823
2021-02-05;IN;India;11713;95;10814304;154918
2021-02-06;IN;India;12059;78;10826363;154996
2021-02-07;IN;India;11831;84;10838194;155080
2021-02-08;IN;India;9110;78;10847304;155158
2021-02-09;IN;India;11067;94;10858371;155252
2021-02-10;IN;India;12923;108;10871294;155360
2021-02-11;IN;India;9309;87;10880603;155447
2021-02-12;IN;India;12143;103;10892746;155550
2021-02-13;IN;India;12194;92;10904940;155642
2021-02-14;IN;India;11649;90;10916589;155732
2021-02-15;IN;India;9121;81;10925710;155813
2021-02-16;IN;India;11610;100;10937320;155913
2021-02-17;IN;India;12881;101;10950201;156014
2021-02-18;IN;India;13193;97;10963394;156111
2021-02-19;IN;India;13993;101;10977387;156212
2021-02-20;IN;India;14264;90;10991651;156302
2021-02-21;IN;India;14199;83;11005850;156385
2021-02-22;IN;India;10584;78;11016434;156463
2021-02-23;IN;India;13742;104;11030176;156567
2021-02-24;IN;India;16738;138;11046914;156705
2021-02-25;IN;India;16577;120;11063491;156825
2021-02-26;IN;India;16488;113;11079979;156938
2021-02-27;IN;India;16752;113;11096731;157051
2021-02-28;IN;India;15510;106;11112241;157157
2021-03-01;IN;India;12286;91;11124527;157248
2021-03-02;IN;India;14989;98;11139516;157346
2021-03-03;IN;India;17407;89;11156923;157435
2021-03-04;IN;India;16838;113;11173761;157548
2021-03-05;IN;India;18284;108;11192045;157656
2021-03-06;IN;India;18754;100;11210799;157756
2021-03-07;IN;India;18599;97;11229398;157853
2021-03-08;IN;India;15388;77;11244786;157930
2021-03-09;IN;India;17921;133;11262707;158063
2021-03-10;IN;India;22854;126;11285561;158189
2021-03-11;IN;India;23285;117;11308846;158306
2021-03-12;IN;India;24882;140;11333728;158446
2021-03-13;IN;India;25320;161;11359048;158607
2021-03-14;IN;India;26291;118;11385339;158725
2021-03-15;IN;India;24492;131;11409831;158856
2021-03-16;IN;India;28903;188;11438734;159044
2021-03-17;IN;India;35871;172;11474605;159216
2021-03-18;IN;India;39726;154;11514331;159370
2021-03-19;IN;India;40953;188;11555284;159558
2021-03-20;IN;India;43846;197;11599130;159755
2021-03-21;IN;India;46951;212;11646081;159967
2021-03-22;IN;India;40715;199;11686796;160166
2021-03-23;IN;India;47262;275;11734058;160441
2021-03-24;IN;India;53476;251;11787534;160692
2021-03-25;IN;India;59118;257;11846652;160949
2021-03-26;IN;India;62258;291;11908910;161240
2021-03-27;IN;India;62714;312;11971624;161552
2021-03-28;IN;India;68020;291;12039644;161843
2021-03-29;IN;India;56211;271;12095855;162114
2021-03-30;IN;India;53480;354;12149335;162468
2021-03-31;IN;India;72330;459;12221665;162927
2021-04-01;IN;India;81466;469;12303131;163396
2021-04-02;IN;India;89129;714;12392260;164110
2021-04-03;IN;India;93249;513;12485509;164623
2021-04-04;IN;India;103558;478;12589067;165101
2021-04-05;IN;India;96982;446;12686049;165547
2021-04-06;IN;India;115736;630;12801785;166177
2021-04-07;IN;India;126789;685;12928574;166862
2021-04-08;IN;India;131968;780;13060542;167642
2021-04-09;IN;India;145384;794;13205926;168436
2021-04-10;IN;India;152879;839;13358805;169275
2021-04-11;IN;India;168912;904;13527717;170179
2021-04-12;IN;India;161736;879;13689453;171058
2021-04-13;IN;India;184372;1027;13873825;172085
2021-04-14;IN;India;200739;1038;14074564;173123
2021-04-15;IN;India;217353;1185;14291917;174308
2021-04-16;IN;India;234692;1341;14526609;175649
2021-04-17;IN;India;261394;1501;14788003;177150
2021-04-18;IN;India;273802;1619;15061805;178769
2021-04-19;IN;India;259167;1761;15320972;180530
2021-04-20;IN;India;295158;2023;15616130;182553
2021-04-21;IN;India;314644;2104;15930774;184657
2021-04-22;IN;India;332921;2263;16263695;186920
2021-04-23;IN;India;346786;2624;16610481;189544
2021-04-24;IN;India;349691;2767;16960172;192311
2021-04-25;IN;India;352991;2812;17313163;195123
2021-04-26;IN;India;323023;2771;17636186;197894
2021-04-27;IN;India;360927;3293;17997113;201187
2021-04-28;IN;India;379308;3645;18376421;204832
2021-04-29;IN;India;386555;3498;18762976;208330
2021-04-30;IN;India;401993;3523;19164969;211853
2021-05-01;IN;India;392488;3689;19557457;215542
2021-05-02;IN;India;368060;3417;19925517;218959
2021-05-03;IN;India;357316;3449;20282833;222408
2021-05-04;IN;India;382146;3780;20664979;226188
2021-05-05;IN;India;412431;3980;21077410;230168
2021-05-06;IN;India;414188;3915;21491598;234083
2021-05-07;IN;India;401078;4187;21892676;238270
2021-05-08;IN;India;403405;4077;22296081;242347
2021-05-09;IN;India;366494;3769;22662575;246116
2021-05-10;IN;India;329942;3876;22992517;249992
2021-05-11;IN;India;348421;4205;23340938;254197
2021-05-12;IN;India;362727;4120;23703665;258317
2021-05-13;IN;India;343144;4000;24046809;262317
2021-05-14;IN;India;326098;3890;24372907;266207
2021-05-15;IN;India;311170;4077;24684077;270284
2021-05-16;IN;India;281386;4106;24965463;274390
2021-05-17;IN;India;263533;4329;25228996;278719
2021-05-18;IN;India;267334;4529;25496330;283248
2021-05-19;IN;India;276110;3874;25772440;287122
2021-05-20;IN;India;259551;4209;26031991;291331
2021-05-21;IN;India;257299;4194;26289290;295525
2021-05-22;IN;India;240842;3741;26530132;299266
2021-05-23;IN;India;222315;4454;26752447;303720
2021-05-24;IN;India;196427;3511;26948874;307231
2021-05-25;IN;India;208921;4157;27157795;311388
2021-05-26;IN;India;211298;3847;27369093;315235
2021-05-27;IN;India;186364;3660;27555457;318895
2021-05-28;IN;India;173790;3617;27729247;322512
2021-05-29;IN;India;165553;3460;27894800;325972
2021-05-30;IN;India;152734;3128;28047534;329100
2021-05-31;IN;India;127510;2795;28175044;331895
2021-06-01;IN;India;132788;3207;28307832;335102
2021-06-02;IN;India;134154;2887;28441986;337989
2021-06-03;IN;India;132364;2713;28574350;340702
2021-06-04;IN;India;120529;3380;28694879;344082
2021-06-05;IN;India;114460;2677;28809339;346759
2021-06-06;IN;India;100636;2427;28909975;349186
2021-06-07;IN;India;86498;2123;28996473;351309
2021-06-08;IN;India;92596;2219;29089069;353528
2021-06-09;IN;India;93463;2177;29182532;355705
2021-06-10;IN;India;92291;7374;29274823;363079
2021-06-11;IN;India;84332;4002;29359155;367081
2021-06-12;IN;India;80834;3303;29439989;370384
2021-06-13;IN;India;70421;3921;29510410;374305
2021-06-14;IN;India;60471;2726;29570881;377031
2021-06-15;IN;India;62224;2542;29633105;379573
2021-06-16;IN;India;67208;2330;29700313;381903
2021-06-17;IN;India;62480;1587;29762793;383490
2021-06-18;IN;India;60753;1647;29823546;385137
2021-06-19;IN;India;58226;1571;29881772;386708
2021-06-20;IN;India;53449;1427;29935221;388135
2021-06-21;IN;India;42640;1167;29977861;389302
2021-06-22;IN;India;50848;1358;30028709;390660
2021-06-23;IN;India;54069;1321;30082778;391981
2021-06-24;IN;India;51667;1329;30134445;393310
2021-06-25;IN;India;48698;1183;30183143;394493
2021-06-26;IN;India;50040;1258;30233183;395751
2021-06-27;IN;India;46148;979;30279331;396730
2021-06-28;IN;India;37566;907;30316897;397637
2021-06-29;IN;India;45951;817;30362848;398454
2021-06-30;IN;India;48786;1005;30411634;399459
2021-07-01;IN;India;46617;853;30458251;400312
2020-03-02;ID;Indonesia;2;0;2;0
2020-03-03;ID;Indonesia;0;0;2;0
2020-03-04;ID;Indonesia;0;0;2;0
2020-03-05;ID;Indonesia;0;0;2;0
2020-03-06;ID;Indonesia;2;0;4;0
2020-03-07;ID;Indonesia;0;0;4;0
2020-03-08;ID;Indonesia;2;0;6;0
2020-03-09;ID;Indonesia;13;0;19;0
2020-03-10;ID;Indonesia;8;0;27;0
2020-03-11;ID;Indonesia;7;1;34;1
2020-03-12;ID;Indonesia;0;0;34;1
2020-03-13;ID;Indonesia;35;3;69;4
2020-03-14;ID;Indonesia;27;1;96;5
2020-03-15;ID;Indonesia;21;0;117;5
2020-03-16;ID;Indonesia;17;0;134;5
2020-03-17;ID;Indonesia;38;0;172;5
2020-03-18;ID;Indonesia;55;14;227;19
2020-03-19;ID;Indonesia;84;6;311;25
2020-03-20;ID;Indonesia;58;7;369;32
2020-03-21;ID;Indonesia;81;6;450;38
2020-03-22;ID;Indonesia;64;10;514;48
2020-03-23;ID;Indonesia;65;1;579;49
2020-03-24;ID;Indonesia;107;6;686;55
2020-03-25;ID;Indonesia;104;3;790;58
2020-03-26;ID;Indonesia;103;20;893;78
2020-03-27;ID;Indonesia;153;9;1046;87
2020-03-28;ID;Indonesia;109;15;1155;102
2020-03-29;ID;Indonesia;130;12;1285;114
2020-03-30;ID;Indonesia;129;8;1414;122
2020-03-31;ID;Indonesia;114;14;1528;136
2020-04-01;ID;Indonesia;149;21;1677;157
2020-04-02;ID;Indonesia;113;13;1790;170
2020-04-03;ID;Indonesia;196;11;1986;181
2020-04-04;ID;Indonesia;106;10;2092;191
2020-04-05;ID;Indonesia;181;7;2273;198
2020-04-06;ID;Indonesia;218;11;2491;209
2020-04-07;ID;Indonesia;247;12;2738;221
2020-04-08;ID;Indonesia;218;19;2956;240
2020-04-09;ID;Indonesia;337;40;3293;280
2020-04-10;ID;Indonesia;219;26;3512;306
2020-04-11;ID;Indonesia;330;21;3842;327
2020-04-12;ID;Indonesia;399;46;4241;373
2020-04-13;ID;Indonesia;316;26;4557;399
2020-04-14;ID;Indonesia;282;60;4839;459
2020-04-15;ID;Indonesia;297;10;5136;469
2020-04-16;ID;Indonesia;380;27;5516;496
2020-04-17;ID;Indonesia;407;24;5923;520
2020-04-18;ID;Indonesia;325;15;6248;535
2020-04-19;ID;Indonesia;327;47;6575;582
2020-04-20;ID;Indonesia;185;8;6760;590
2020-04-21;ID;Indonesia;375;26;7135;616
2020-04-22;ID;Indonesia;283;19;7418;635
2020-04-23;ID;Indonesia;357;12;7775;647
2020-04-24;ID;Indonesia;436;42;8211;689
2020-04-25;ID;Indonesia;396;31;8607;720
2020-04-26;ID;Indonesia;275;23;8882;743
2020-04-27;ID;Indonesia;214;22;9096;765
2020-04-28;ID;Indonesia;415;8;9511;773
2020-04-29;ID;Indonesia;260;11;9771;784
2020-04-30;ID;Indonesia;347;8;10118;792
2020-05-01;ID;Indonesia;433;8;10551;800
2020-05-02;ID;Indonesia;292;31;10843;831
2020-05-03;ID;Indonesia;349;14;11192;845
2020-05-04;ID;Indonesia;395;19;11587;864
2020-05-05;ID;Indonesia;484;8;12071;872
2020-05-06;ID;Indonesia;367;23;12438;895
2020-05-07;ID;Indonesia;338;35;12776;930
2020-05-08;ID;Indonesia;336;13;13112;943
2020-05-09;ID;Indonesia;533;16;13645;959
2020-05-10;ID;Indonesia;387;14;14032;973
2020-05-11;ID;Indonesia;233;18;14265;991
2020-05-12;ID;Indonesia;484;16;14749;1007
2020-05-13;ID;Indonesia;689;21;15438;1028
2020-05-14;ID;Indonesia;568;15;16006;1043
2020-05-15;ID;Indonesia;490;33;16496;1076
2020-05-16;ID;Indonesia;529;13;17025;1089
2020-05-17;ID;Indonesia;489;59;17514;1148
2020-05-18;ID;Indonesia;496;43;18010;1191
2020-05-19;ID;Indonesia;486;30;18496;1221
2020-05-20;ID;Indonesia;693;21;19189;1242
2020-05-21;ID;Indonesia;973;36;20162;1278
2020-05-22;ID;Indonesia;634;48;20796;1326
2020-05-23;ID;Indonesia;949;25;21745;1351
2020-05-24;ID;Indonesia;526;21;22271;1372
2020-05-25;ID;Indonesia;479;19;22750;1391
2020-05-26;ID;Indonesia;415;27;23165;1418
2020-05-27;ID;Indonesia;686;55;23851;1473
2020-05-28;ID;Indonesia;687;23;24538;1496
2020-05-29;ID;Indonesia;678;24;25216;1520
2020-05-30;ID;Indonesia;557;53;25773;1573
2020-05-31;ID;Indonesia;700;40;26473;1613
2020-06-01;ID;Indonesia;467;28;26940;1641
2020-06-02;ID;Indonesia;609;22;27549;1663
2020-06-03;ID;Indonesia;684;35;28233;1698
2020-06-04;ID;Indonesia;585;23;28818;1721
2020-06-05;ID;Indonesia;703;49;29521;1770
2020-06-06;ID;Indonesia;993;31;30514;1801
2020-06-07;ID;Indonesia;672;50;31186;1851
2020-06-08;ID;Indonesia;847;32;32033;1883
2020-06-09;ID;Indonesia;1043;40;33076;1923
2020-06-10;ID;Indonesia;1240;36;34316;1959
2020-06-11;ID;Indonesia;979;41;35295;2000
2020-06-12;ID;Indonesia;1111;48;36406;2048
2020-06-13;ID;Indonesia;1014;43;37420;2091
2020-06-14;ID;Indonesia;857;43;38277;2134
2020-06-15;ID;Indonesia;1017;64;39294;2198
2020-06-16;ID;Indonesia;1106;33;40400;2231
2020-06-17;ID;Indonesia;1031;45;41431;2276
2020-06-18;ID;Indonesia;1331;63;42762;2339
2020-06-19;ID;Indonesia;1041;34;43803;2373
2020-06-20;ID;Indonesia;1226;56;45029;2429
2020-06-21;ID;Indonesia;862;36;45891;2465
2020-06-22;ID;Indonesia;954;35;46845;2500
2020-06-23;ID;Indonesia;1051;35;47896;2535
2020-06-24;ID;Indonesia;1113;38;49009;2573
2020-06-25;ID;Indonesia;1178;47;50187;2620
2020-06-26;ID;Indonesia;1240;63;51427;2683
2020-06-27;ID;Indonesia;1385;37;52812;2720
2020-06-28;ID;Indonesia;1198;34;54010;2754
2020-06-29;ID;Indonesia;1082;51;55092;2805
2020-06-30;ID;Indonesia;1293;71;56385;2876
2020-07-01;ID;Indonesia;1385;58;57770;2934
2020-07-02;ID;Indonesia;1624;53;59394;2987
2020-07-03;ID;Indonesia;1301;49;60695;3036
2020-07-04;ID;Indonesia;1447;53;62142;3089
2020-07-05;ID;Indonesia;1607;82;63749;3171
2020-07-06;ID;Indonesia;1209;70;64958;3241
2020-07-07;ID;Indonesia;1268;68;66226;3309
2020-07-08;ID;Indonesia;1853;50;68079;3359
2020-07-09;ID;Indonesia;2657;58;70736;3417
2020-07-10;ID;Indonesia;1611;52;72347;3469
2020-07-11;ID;Indonesia;1671;66;74018;3535
2020-07-12;ID;Indonesia;1681;71;75699;3606
2020-07-13;ID;Indonesia;1282;50;76981;3656
2020-07-14;ID;Indonesia;1591;54;78572;3710
2020-07-15;ID;Indonesia;1522;87;80094;3797
2020-07-16;ID;Indonesia;1574;76;81668;3873
2020-07-17;ID;Indonesia;1462;84;83130;3957
2020-07-18;ID;Indonesia;1752;59;84882;4016
2020-07-19;ID;Indonesia;1639;127;86521;4143
2020-07-20;ID;Indonesia;1693;96;88214;4239
2020-07-21;ID;Indonesia;1655;81;89869;4320
2020-07-22;ID;Indonesia;1882;139;91751;4459
2020-07-23;ID;Indonesia;1906;117;93657;4576
2020-07-24;ID;Indonesia;1761;89;95418;4665
2020-07-25;ID;Indonesia;1868;49;97286;4714
2020-07-26;ID;Indonesia;1492;67;98778;4781
2020-07-27;ID;Indonesia;1525;57;100303;4838
2020-07-28;ID;Indonesia;1748;63;102051;4901
2020-07-29;ID;Indonesia;2381;74;104432;4975
2020-07-30;ID;Indonesia;1904;83;106336;5058
2020-07-31;ID;Indonesia;2040;73;108376;5131
2020-08-01;ID;Indonesia;1560;62;109936;5193
2020-08-02;ID;Indonesia;1519;43;111455;5236
2020-08-03;ID;Indonesia;1679;66;113134;5302
2020-08-04;ID;Indonesia;1922;86;115056;5388
2020-08-05;ID;Indonesia;1815;64;116871;5452
2020-08-06;ID;Indonesia;1882;69;118753;5521
2020-08-07;ID;Indonesia;2473;72;121226;5593
2020-08-08;ID;Indonesia;2277;65;123503;5658
2020-08-09;ID;Indonesia;1893;65;125396;5723
2020-08-10;ID;Indonesia;1687;42;127083;5765
2020-08-11;ID;Indonesia;1693;59;128776;5824
2020-08-12;ID;Indonesia;1942;79;130718;5903
2020-08-13;ID;Indonesia;2098;65;132816;5968
2020-08-14;ID;Indonesia;2307;53;135123;6021
2020-08-15;ID;Indonesia;2345;50;137468;6071
2020-08-16;ID;Indonesia;2081;79;139549;6150
2020-08-17;ID;Indonesia;1821;57;141370;6207
2020-08-18;ID;Indonesia;1673;70;143043;6277
2020-08-19;ID;Indonesia;1902;69;144945;6346
2020-08-20;ID;Indonesia;2266;72;147211;6418
2020-08-21;ID;Indonesia;2197;82;149408;6500
2020-08-22;ID;Indonesia;2090;94;151498;6594
2020-08-23;ID;Indonesia;2037;86;153535;6680
2020-08-24;ID;Indonesia;1877;79;155412;6759
2020-08-25;ID;Indonesia;2447;99;157859;6858
2020-08-26;ID;Indonesia;2306;86;160165;6944
2020-08-27;ID;Indonesia;2719;120;162884;7064
2020-08-28;ID;Indonesia;3003;105;165887;7169
2020-08-29;ID;Indonesia;3308;92;169195;7261
2020-08-30;ID;Indonesia;2858;82;172053;7343
2020-08-31;ID;Indonesia;2743;74;174796;7417
2020-09-01;ID;Indonesia;2775;88;177571;7505
2020-09-02;ID;Indonesia;3075;111;180646;7616
2020-09-03;ID;Indonesia;3622;134;184268;7750
2020-09-04;ID;Indonesia;3269;82;187537;7832
2020-09-05;ID;Indonesia;3128;108;190665;7940
2020-09-06;ID;Indonesia;3444;85;194109;8025
2020-09-07;ID;Indonesia;2880;105;196989;8130
2020-09-08;ID;Indonesia;3046;100;200035;8230
2020-09-09;ID;Indonesia;3307;106;203342;8336
2020-09-10;ID;Indonesia;3861;120;207203;8456
2020-09-11;ID;Indonesia;3737;88;210940;8544
2020-09-12;ID;Indonesia;3806;106;214746;8650
2020-09-13;ID;Indonesia;3636;73;218382;8723
2020-09-14;ID;Indonesia;3141;118;221523;8841
2020-09-15;ID;Indonesia;3507;124;225030;8965
2020-09-16;ID;Indonesia;3963;135;228993;9100
2020-09-17;ID;Indonesia;3635;122;232628;9222
2020-09-18;ID;Indonesia;3891;114;236519;9336
2020-09-19;ID;Indonesia;4168;112;240687;9448
2020-09-20;ID;Indonesia;3989;105;244676;9553
2020-09-21;ID;Indonesia;4176;124;248852;9677
2020-09-22;ID;Indonesia;4071;160;252923;9837
2020-09-23;ID;Indonesia;4465;140;257388;9977
2020-09-24;ID;Indonesia;4634;128;262022;10105
2020-09-25;ID;Indonesia;4823;113;266845;10218
2020-09-26;ID;Indonesia;4494;90;271339;10308
2020-09-27;ID;Indonesia;3874;78;275213;10386
2020-09-28;ID;Indonesia;3509;87;278722;10473
2020-09-29;ID;Indonesia;4002;128;282724;10601
2020-09-30;ID;Indonesia;4284;139;287008;10740
2020-10-01;ID;Indonesia;4174;116;291182;10856
2020-10-02;ID;Indonesia;4317;116;295499;10972
2020-10-03;ID;Indonesia;4007;83;299506;11055
2020-10-04;ID;Indonesia;3992;96;303498;11151
2020-10-05;ID;Indonesia;3622;102;307120;11253
2020-10-06;ID;Indonesia;4056;121;311176;11374
2020-10-07;ID;Indonesia;4538;98;315714;11472
2020-10-08;ID;Indonesia;4850;108;320564;11580
2020-10-09;ID;Indonesia;4094;97;324658;11677
2020-10-10;ID;Indonesia;4294;88;328952;11765
2020-10-11;ID;Indonesia;4497;79;333449;11844
2020-10-12;ID;Indonesia;3267;91;336716;11935
2020-10-13;ID;Indonesia;3906;92;340622;12027
2020-10-14;ID;Indonesia;4127;129;344749;12156
2020-10-15;ID;Indonesia;4411;112;349160;12268
2020-10-16;ID;Indonesia;4301;79;353461;12347
2020-10-17;ID;Indonesia;4301;84;357762;12431
2020-10-18;ID;Indonesia;4105;80;361867;12511
2020-10-19;ID;Indonesia;3373;106;365240;12617
2020-10-20;ID;Indonesia;3602;117;368842;12734
2020-10-21;ID;Indonesia;4267;123;373109;12857
2020-10-22;ID;Indonesia;4432;102;377541;12959
2020-10-23;ID;Indonesia;4369;118;381910;13077
2020-10-24;ID;Indonesia;4070;128;385980;13205
2020-10-25;ID;Indonesia;3732;94;389712;13299
2020-10-26;ID;Indonesia;3222;112;392934;13411
2020-10-27;ID;Indonesia;3520;101;396454;13512
2020-10-28;ID;Indonesia;4029;100;400483;13612
2020-10-29;ID;Indonesia;3565;89;404048;13701
2020-10-30;ID;Indonesia;2897;81;406945;13782
2020-10-31;ID;Indonesia;3143;87;410088;13869
2020-11-01;ID;Indonesia;2696;74;412784;13943
2020-11-02;ID;Indonesia;2618;101;415402;14044
2020-11-03;ID;Indonesia;2973;102;418375;14146
2020-11-04;ID;Indonesia;3356;113;421731;14259
2020-11-05;ID;Indonesia;4065;89;425796;14348
2020-11-06;ID;Indonesia;3778;94;429574;14442
2020-11-07;ID;Indonesia;4262;98;433836;14540
2020-11-08;ID;Indonesia;3880;74;437716;14614
2020-11-09;ID;Indonesia;2853;75;440569;14689
2020-11-10;ID;Indonesia;3779;72;444348;14761
2020-11-11;ID;Indonesia;3770;75;448118;14836
2020-11-12;ID;Indonesia;4173;97;452291;14933
2020-11-13;ID;Indonesia;5444;104;457735;15037
2020-11-14;ID;Indonesia;5272;111;463007;15148
2020-11-15;ID;Indonesia;4106;63;467113;15211
2020-11-16;ID;Indonesia;3535;85;470648;15296
2020-11-17;ID;Indonesia;3807;97;474455;15393
2020-11-18;ID;Indonesia;4265;110;478720;15503
2020-11-19;ID;Indonesia;4798;97;483518;15600
2020-11-20;ID;Indonesia;4792;78;488310;15678
2020-11-21;ID;Indonesia;4998;96;493308;15774
2020-11-22;ID;Indonesia;4360;110;497668;15884
2020-11-23;ID;Indonesia;4442;118;502110;16002
2020-11-24;ID;Indonesia;4192;109;506302;16111
2020-11-25;ID;Indonesia;5534;114;511836;16225
2020-11-26;ID;Indonesia;4917;127;516753;16352
2020-11-27;ID;Indonesia;5828;169;522581;16521
2020-11-28;ID;Indonesia;5418;125;527999;16646
2020-11-29;ID;Indonesia;6267;169;534266;16815
2020-11-30;ID;Indonesia;4617;130;538883;16945
2020-12-01;ID;Indonesia;5092;136;543975;17081
2020-12-02;ID;Indonesia;5533;118;549508;17199
2020-12-03;ID;Indonesia;8369;156;557877;17355
2020-12-04;ID;Indonesia;5803;124;563680;17479
2020-12-05;ID;Indonesia;6027;110;569707;17589
2020-12-06;ID;Indonesia;6089;151;575796;17740
2020-12-07;ID;Indonesia;5754;127;581550;17867
2020-12-08;ID;Indonesia;5292;133;586842;18000
2020-12-09;ID;Indonesia;6058;171;592900;18171
2020-12-10;ID;Indonesia;6033;165;598933;18336
2020-12-11;ID;Indonesia;6310;175;605243;18511
2020-12-12;ID;Indonesia;6388;142;611631;18653
2020-12-13;ID;Indonesia;6189;166;617820;18819
2020-12-14;ID;Indonesia;5489;137;623309;18956
2020-12-15;ID;Indonesia;6120;155;629429;19111
2020-12-16;ID;Indonesia;6725;137;636154;19248
2020-12-17;ID;Indonesia;7354;142;643508;19390
2020-12-18;ID;Indonesia;6689;124;650197;19514
2020-12-19;ID;Indonesia;7751;145;657948;19659
2020-12-20;ID;Indonesia;6982;221;664930;19880
2020-12-21;ID;Indonesia;6848;205;671778;20085
2020-12-22;ID;Indonesia;6347;172;678125;20257
2020-12-23;ID;Indonesia;7514;151;685639;20408
2020-12-24;ID;Indonesia;7199;181;692838;20589
2020-12-25;ID;Indonesia;7259;258;700097;20847
2020-12-26;ID;Indonesia;6740;147;706837;20994
2020-12-27;ID;Indonesia;6528;243;713365;21237
2020-12-28;ID;Indonesia;5854;215;719219;21452
2020-12-29;ID;Indonesia;7903;251;727122;21703
2020-12-30;ID;Indonesia;8002;241;735124;21944
2020-12-31;ID;Indonesia;8074;194;743198;22138
2021-01-01;ID;Indonesia;8072;191;751270;22329
2021-01-02;ID;Indonesia;7203;226;758473;22555
2021-01-03;ID;Indonesia;6877;179;765350;22734
2021-01-04;ID;Indonesia;6753;177;772103;22911
2021-01-05;ID;Indonesia;7445;198;779548;23109
2021-01-06;ID;Indonesia;8854;187;788402;23296
2021-01-07;ID;Indonesia;9321;224;797723;23520
2021-01-08;ID;Indonesia;10617;233;808340;23753
2021-01-09;ID;Indonesia;10046;194;818386;23947
2021-01-10;ID;Indonesia;9640;182;828026;24129
2021-01-11;ID;Indonesia;8692;214;836718;24343
2021-01-12;ID;Indonesia;10047;302;846765;24645
2021-01-13;ID;Indonesia;11278;306;858043;24951
2021-01-14;ID;Indonesia;11557;295;869600;25246
2021-01-15;ID;Indonesia;12818;238;882418;25484
2021-01-16;ID;Indonesia;14224;283;896642;25767
2021-01-17;ID;Indonesia;11287;220;907929;25987
2021-01-18;ID;Indonesia;9086;295;917015;26282
2021-01-19;ID;Indonesia;10365;308;927380;26590
2021-01-20;ID;Indonesia;12568;267;939948;26857
2021-01-21;ID;Indonesia;11703;346;951651;27203
2021-01-22;ID;Indonesia;13632;250;965283;27453
2021-01-23;ID;Indonesia;12191;211;977474;27664
2021-01-24;ID;Indonesia;11788;171;989262;27835
2021-01-25;ID;Indonesia;9994;297;999256;28132
2021-01-26;ID;Indonesia;13094;336;1012350;28468
2021-01-27;ID;Indonesia;11948;387;1024298;28855
2021-01-28;ID;Indonesia;13695;476;1037993;29331
2021-01-29;ID;Indonesia;13802;187;1051795;29518
2021-01-30;ID;Indonesia;14518;210;1066313;29728
2021-01-31;ID;Indonesia;12001;270;1078314;29998
2021-02-01;ID;Indonesia;10994;279;1089308;30277
2021-02-02;ID;Indonesia;10379;304;1099687;30581
2021-02-03;ID;Indonesia;11984;189;1111671;30770
2021-02-04;ID;Indonesia;11434;231;1123105;31001
2021-02-05;ID;Indonesia;11749;201;1134854;31202
2021-02-06;ID;Indonesia;12156;191;1147010;31393
2021-02-07;ID;Indonesia;10827;163;1157837;31556
2021-02-08;ID;Indonesia;8242;207;1166079;31763
2021-02-09;ID;Indonesia;8700;213;1174779;31976
2021-02-10;ID;Indonesia;8776;191;1183555;32167
2021-02-11;ID;Indonesia;8435;214;1191990;32381
2021-02-12;ID;Indonesia;9869;275;1201859;32656
2021-02-13;ID;Indonesia;8844;280;1210703;32936
2021-02-14;ID;Indonesia;6765;247;1217468;33183
2021-02-15;ID;Indonesia;6462;184;1223930;33367
2021-02-16;ID;Indonesia;10029;229;1233959;33596
2021-02-17;ID;Indonesia;9687;192;1243646;33788
2021-02-18;ID;Indonesia;9039;181;1252685;33969
2021-02-19;ID;Indonesia;10614;183;1263299;34152
2021-02-20;ID;Indonesia;8054;164;1271353;34316
2021-02-21;ID;Indonesia;7300;173;1278653;34489
2021-02-22;ID;Indonesia;10180;202;1288833;34691
2021-02-23;ID;Indonesia;9775;323;1298608;35014
2021-02-24;ID;Indonesia;7533;240;1306141;35254
2021-02-25;ID;Indonesia;8493;264;1314634;35518
2021-02-26;ID;Indonesia;8232;268;1322866;35786
2021-02-27;ID;Indonesia;6208;195;1329074;35981
2021-02-28;ID;Indonesia;5560;185;1334634;36166
2021-03-01;ID;Indonesia;6680;159;1341314;36325
2021-03-02;ID;Indonesia;5712;193;1347026;36518
2021-03-03;ID;Indonesia;6808;203;1353834;36721
2021-03-04;ID;Indonesia;7264;176;1361098;36897
2021-03-05;ID;Indonesia;6971;129;1368069;37026
2021-03-06;ID;Indonesia;5767;128;1373836;37154
2021-03-07;ID;Indonesia;5826;112;1379662;37266
2021-03-08;ID;Indonesia;6894;281;1386556;37547
2021-03-09;ID;Indonesia;6389;210;1392945;37757
2021-03-10;ID;Indonesia;5633;175;1398578;37932
2021-03-11;ID;Indonesia;5144;117;1403722;38049
2021-03-12;ID;Indonesia;6412;180;1410134;38229
2021-03-13;ID;Indonesia;4607;100;1414741;38329
2021-03-14;ID;Indonesia;4714;97;1419455;38426
2021-03-15;ID;Indonesia;5589;147;1425044;38573
2021-03-16;ID;Indonesia;5414;180;1430458;38753
2021-03-17;ID;Indonesia;6825;162;1437283;38915
2021-03-18;ID;Indonesia;6570;227;1443853;39142
2021-03-19;ID;Indonesia;6279;197;1450132;39339
2021-03-20;ID;Indonesia;5656;108;1455788;39447
2021-03-21;ID;Indonesia;4396;103;1460184;39550
2021-03-22;ID;Indonesia;5744;161;1465928;39711
2021-03-23;ID;Indonesia;5297;154;1471225;39865
2021-03-24;ID;Indonesia;5227;118;1476452;39983
2021-03-25;ID;Indonesia;6107;98;1482559;40081
2021-03-26;ID;Indonesia;4982;85;1487541;40166
2021-03-27;ID;Indonesia;4461;198;1492002;40364
2021-03-28;ID;Indonesia;4083;85;1496085;40449
2021-03-29;ID;Indonesia;5008;132;1501093;40581
2021-03-30;ID;Indonesia;4682;173;1505775;40754
2021-03-31;ID;Indonesia;5937;104;1511712;40858
2021-04-01;ID;Indonesia;6142;196;1517854;41054
2021-04-02;ID;Indonesia;5325;97;1523179;41151
2021-04-03;ID;Indonesia;4345;91;1527524;41242
2021-04-04;ID;Indonesia;6731;427;1534255;41669
2021-04-05;ID;Indonesia;3712;146;1537967;41815
2021-04-06;ID;Indonesia;4549;162;1542516;41977
2021-04-07;ID;Indonesia;4860;87;1547376;42064
2021-04-08;ID;Indonesia;5504;163;1552880;42227
2021-04-09;ID;Indonesia;5265;121;1558145;42348
2021-04-10;ID;Indonesia;4723;95;1562868;42443
2021-04-11;ID;Indonesia;4127;87;1566995;42530
2021-04-12;ID;Indonesia;4829;126;1571824;42656
2021-04-13;ID;Indonesia;5702;126;1577526;42782
2021-04-14;ID;Indonesia;5656;124;1583182;42906
2021-04-15;ID;Indonesia;6177;167;1589359;43073
2021-04-16;ID;Indonesia;5363;123;1594722;43196
2021-04-17;ID;Indonesia;5041;132;1599763;43328
2021-04-18;ID;Indonesia;4585;96;1604348;43424
2021-04-19;ID;Indonesia;4952;143;1609300;43567
2021-04-20;ID;Indonesia;5549;210;1614849;43777
2021-04-21;ID;Indonesia;5720;230;1620569;44007
2021-04-22;ID;Indonesia;6243;165;1626812;44172
2021-04-23;ID;Indonesia;5436;174;1632248;44346
2021-04-24;ID;Indonesia;4544;154;1636792;44500
2021-04-25;ID;Indonesia;4402;94;1641194;44594
2021-04-26;ID;Indonesia;5944;177;1647138;44771
2021-04-27;ID;Indonesia;4656;168;1651794;44939
2021-04-28;ID;Indonesia;5241;177;1657035;45116
2021-04-29;ID;Indonesia;5833;218;1662868;45334
2021-04-30;ID;Indonesia;5500;187;1668368;45521
2021-05-01;ID;Indonesia;4512;131;1672880;45652
2021-05-02;ID;Indonesia;4394;144;1677274;45796
2021-05-03;ID;Indonesia;4730;153;1682004;45949
2021-05-04;ID;Indonesia;4369;188;1686373;46137
2021-05-05;ID;Indonesia;5285;212;1691658;46349
2021-05-06;ID;Indonesia;5647;147;1697305;46496
2021-05-07;ID;Indonesia;6327;167;1703632;46663
2021-05-08;ID;Indonesia;6130;179;1709762;46842
2021-05-09;ID;Indonesia;3922;170;1713684;47012
2021-05-10;ID;Indonesia;4891;206;1718575;47218
2021-05-11;ID;Indonesia;5021;247;1723596;47465
2021-05-12;ID;Indonesia;4608;152;1728204;47617
2021-05-13;ID;Indonesia;3448;99;1731652;47716
2021-05-14;ID;Indonesia;2633;107;1734285;47823
2021-05-15;ID;Indonesia;2385;144;1736670;47967
2021-05-16;ID;Indonesia;3080;126;1739750;48093
2021-05-17;ID;Indonesia;4295;212;1744045;48305
2021-05-18;ID;Indonesia;4185;172;1748230;48477
2021-05-19;ID;Indonesia;4871;192;1753101;48669
2021-05-20;ID;Indonesia;5797;218;1758898;48887
2021-05-21;ID;Indonesia;5746;186;1764644;49073
2021-05-22;ID;Indonesia;5296;132;1769940;49205
2021-05-23;ID;Indonesia;5280;123;1775220;49328
2021-05-24;ID;Indonesia;5907;127;1781127;49455
2021-05-25;ID;Indonesia;5060;172;1786187;49627
2021-05-26;ID;Indonesia;5034;144;1791221;49771
2021-05-27;ID;Indonesia;6278;136;1797499;49907
2021-05-28;ID;Indonesia;5862;193;1803361;50100
2021-05-29;ID;Indonesia;6565;162;1809926;50262
2021-05-30;ID;Indonesia;6115;142;1816041;50404
2021-05-31;ID;Indonesia;5662;174;1821703;50578
2021-06-01;ID;Indonesia;4824;145;1826527;50723
2021-06-02;ID;Indonesia;5246;185;1831773;50908
2021-06-03;ID;Indonesia;5353;187;1837126;51095
2021-06-04;ID;Indonesia;6486;201;1843612;51296
2021-06-05;ID;Indonesia;6594;153;1850206;51449
2021-06-06;ID;Indonesia;5832;163;1856038;51612
2021-06-07;ID;Indonesia;6993;191;1863031;51803
2021-06-08;ID;Indonesia;6294;189;1869325;51992
2021-06-09;ID;Indonesia;7725;170;1877050;52162
2021-06-10;ID;Indonesia;8892;211;1885942;52373
2021-06-11;ID;Indonesia;8083;193;1894025;52566
2021-06-12;ID;Indonesia;7465;164;1901490;52730
2021-06-13;ID;Indonesia;9868;149;1911358;52879
2021-06-14;ID;Indonesia;8189;237;1919547;53116
2021-06-15;ID;Indonesia;8161;164;1927708;53280
2021-06-16;ID;Indonesia;9944;196;1937652;53476
2021-06-17;ID;Indonesia;12624;277;1950276;53753
2021-06-18;ID;Indonesia;12990;290;1963266;54043
2021-06-19;ID;Indonesia;12906;248;1976172;54291
2021-06-20;ID;Indonesia;13737;371;1989909;54662
2021-06-21;ID;Indonesia;14536;294;2004445;54956
2021-06-22;ID;Indonesia;13668;335;2018113;55291
2021-06-23;ID;Indonesia;15308;303;2033421;55594
2021-06-24;ID;Indonesia;20574;355;2053995;55949
2021-06-25;ID;Indonesia;18872;422;2072867;56371
2021-06-26;ID;Indonesia;21095;358;2093962;56729
2021-06-27;ID;Indonesia;21342;409;2115304;57138
2021-06-28;ID;Indonesia;20694;423;2135998;57561
2021-06-29;ID;Indonesia;20467;463;2156465;58024
2021-06-30;ID;Indonesia;21807;467;2178272;58491
2021-07-01;ID;Indonesia;24836;504;2203108;58995
2020-02-07;;International;61;0;61;0
2020-02-08;;International;0;0;61;0
2020-02-09;;International;3;0;64;0
2020-02-10;;International;71;0;135;0
2020-02-11;;International;0;0;135;0
2020-02-12;;International;40;0;175;0
2020-02-13;;International;0;0;175;0
2020-02-14;;International;43;0;218;0
2020-02-15;;International;67;0;285;0
2020-02-16;;International;70;0;355;0
2020-02-17;;International;99;0;454;0
2020-02-18;;International;88;0;542;0
2020-02-19;;International;79;0;621;0
2020-02-20;;International;13;2;634;2
2020-02-21;;International;0;0;634;2
2020-02-22;;International;0;0;634;2
2020-02-23;;International;57;1;691;3
2020-02-24;;International;0;0;691;3
2020-02-25;;International;0;0;691;3
2020-02-26;;International;14;1;705;4
2020-02-27;;International;0;0;705;4
2020-02-28;;International;0;2;705;6
2020-02-29;;International;0;0;705;6
2020-03-01;;International;0;0;705;6
2020-03-02;;International;0;0;705;6
2020-03-03;;International;1;0;706;6
2020-03-04;;International;0;0;706;6
2020-03-05;;International;0;0;706;6
2020-03-06;;International;0;0;706;6
2020-03-07;;International;0;0;706;6
2020-03-08;;International;0;0;706;6
2020-03-09;;International;0;0;706;6
2020-03-10;;International;0;0;706;6
2020-03-11;;International;0;1;706;7
2020-03-12;;International;0;0;706;7
2020-03-13;;International;0;0;706;7
2020-03-14;;International;0;0;706;7
2020-03-15;;International;0;0;706;7
2020-03-16;;International;0;0;706;7
2020-03-17;;International;0;0;706;7
2020-03-18;;International;6;0;712;7
2020-03-19;;International;0;0;712;7
2020-03-20;;International;0;0;712;7
2020-03-21;;International;0;1;712;8
2020-03-22;;International;0;0;712;8
2020-03-23;;International;0;0;712;8
2020-03-24;;International;0;2;712;10
2020-03-25;;International;0;0;712;10
2020-03-26;;International;0;0;712;10
2020-03-27;;International;0;0;712;10
2020-03-28;;International;2;0;714;10
2020-03-29;;International;0;0;714;10
2020-03-30;;International;0;0;714;10
2020-03-31;;International;0;0;714;10
2020-04-01;;International;7;3;721;13
2020-04-02;;International;0;0;721;13
2020-04-03;;International;0;0;721;13
2020-04-04;;International;0;0;721;13
2020-04-05;;International;0;0;721;13
2020-04-06;;International;0;0;721;13
2020-04-07;;International;0;0;721;13
2020-04-08;;International;0;0;721;13
2020-04-09;;International;0;0;721;13
2020-04-10;;International;0;0;721;13
2020-04-11;;International;0;0;721;13
2020-04-12;;International;0;0;721;13
2020-04-13;;International;0;0;721;13
2020-04-14;;International;0;1;721;14
2020-04-15;;International;0;0;721;14
2020-04-16;;International;0;0;721;14
2020-04-17;;International;0;1;721;15
2020-04-18;;International;0;0;721;15
2020-04-19;;International;0;0;721;15
2020-04-20;;International;0;0;721;15
2020-04-21;;International;0;0;721;15
2020-04-22;;International;0;0;721;15
2020-04-23;;International;0;0;721;15
2020-04-24;;International;0;0;721;15
2020-04-25;;International;0;0;721;15
2020-04-26;;International;0;0;721;15
2020-04-27;;International;0;0;721;15
2020-04-28;;International;0;0;721;15
2020-04-29;;International;0;0;721;15
2020-04-30;;International;0;0;721;15
2020-05-01;;International;0;0;721;15
2020-05-02;;International;0;0;721;15
2020-05-03;;International;0;0;721;15
2020-05-04;;International;0;0;721;15
2020-05-05;;International;0;0;721;15
2020-05-06;;International;0;0;721;15
2020-05-07;;International;0;0;721;15
2020-05-08;;International;0;0;721;15
2020-05-09;;International;0;0;721;15
2020-05-10;;International;0;0;721;15
2020-05-11;;International;0;0;721;15
2020-05-12;;International;0;0;721;15
2020-05-13;;International;0;0;721;15
2020-05-14;;International;0;0;721;15
2020-05-15;;International;0;0;721;15
2020-05-16;;International;0;0;721;15
2020-05-17;;International;0;0;721;15
2020-05-18;;International;0;0;721;15
2020-05-19;;International;0;0;721;15
2020-05-20;;International;0;0;721;15
2020-05-21;;International;0;0;721;15
2020-05-22;;International;0;0;721;15
2020-05-23;;International;0;0;721;15
2020-05-24;;International;0;0;721;15
2020-05-25;;International;0;0;721;15
2020-05-26;;International;0;0;721;15
2020-05-27;;International;0;0;721;15
2020-05-28;;International;0;0;721;15
2020-05-29;;International;0;0;721;15
2020-05-30;;International;0;0;721;15
2020-05-31;;International;0;0;721;15
2020-06-01;;International;0;0;721;15
2020-06-02;;International;0;0;721;15
2020-06-03;;International;0;0;721;15
2020-06-04;;International;0;0;721;15
2020-06-05;;International;0;0;721;15
2020-06-06;;International;0;0;721;15
2020-06-07;;International;0;0;721;15
2020-06-08;;International;0;0;721;15
2020-06-09;;International;0;0;721;15
2020-06-10;;International;0;0;721;15
2020-06-11;;International;0;0;721;15
2020-06-12;;International;0;0;721;15
2020-06-13;;International;0;0;721;15
2020-06-14;;International;0;0;721;15
2020-06-15;;International;0;0;721;15
2020-06-16;;International;0;0;721;15
2020-06-17;;International;0;0;721;15
2020-06-18;;International;0;0;721;15
2020-06-19;;International;0;0;721;15
2020-06-20;;International;0;0;721;15
2020-06-21;;International;0;0;721;15
2020-06-22;;International;0;0;721;15
2020-06-23;;International;0;0;721;15
2020-06-24;;International;0;0;721;15
2020-06-25;;International;0;0;721;15
2020-06-26;;International;0;0;721;15
2020-06-27;;International;0;0;721;15
2020-06-28;;International;0;0;721;15
2020-06-29;;International;0;0;721;15
2020-06-30;;International;0;0;721;15
2020-07-01;;International;0;0;721;15
2020-07-02;;International;0;0;721;15
2020-07-03;;International;0;0;721;15
2020-07-04;;International;0;0;721;15
2020-07-05;;International;0;0;721;15
2020-07-06;;International;0;0;721;15
2020-07-07;;International;0;0;721;15
2020-07-08;;International;0;0;721;15
2020-07-09;;International;0;0;721;15
2020-07-10;;International;0;0;721;15
2020-07-11;;International;0;0;721;15
2020-07-12;;International;0;0;721;15
2020-07-13;;International;0;0;721;15
2020-07-14;;International;0;0;721;15
2020-07-15;;International;0;0;721;15
2020-07-16;;International;0;0;721;15
2020-07-17;;International;0;0;721;15
2020-07-18;;International;0;0;721;15
2020-07-19;;International;0;0;721;15
2020-07-20;;International;0;0;721;15
2020-07-21;;International;0;0;721;15
2020-07-22;;International;0;0;721;15
2020-07-23;;International;0;0;721;15
2020-07-24;;International;0;0;721;15
2020-07-25;;International;0;0;721;15
2020-07-26;;International;0;0;721;15
2020-07-27;;International;0;0;721;15
2020-07-28;;International;0;0;721;15
2020-07-29;;International;0;0;721;15
2020-07-30;;International;0;0;721;15
2020-07-31;;International;0;0;721;15
2020-08-01;;International;0;0;721;15
2020-08-02;;International;0;0;721;15
2020-08-03;;International;0;0;721;15
2020-08-04;;International;0;0;721;15
2020-08-05;;International;0;0;721;15
2020-08-06;;International;0;0;721;15
2020-08-07;;International;0;0;721;15
2020-08-08;;International;0;0;721;15
2020-08-09;;International;0;0;721;15
2020-08-10;;International;0;0;721;15
2020-08-11;;International;0;0;721;15
2020-08-12;;International;0;0;721;15
2020-08-13;;International;0;0;721;15
2020-08-14;;International;0;0;721;15
2020-08-15;;International;0;0;721;15
2020-08-16;;International;0;0;721;15
2020-08-17;;International;0;0;721;15
2020-08-18;;International;0;0;721;15
2020-08-19;;International;0;0;721;15
2020-08-20;;International;0;0;721;15
2020-08-21;;International;0;0;721;15
2020-08-22;;International;0;0;721;15
2020-08-23;;International;0;0;721;15
2020-08-24;;International;0;0;721;15
2020-08-25;;International;0;0;721;15
2020-08-26;;International;0;0;721;15
2020-08-27;;International;0;0;721;15
2020-08-28;;International;0;0;721;15
2020-08-29;;International;0;0;721;15
2020-08-30;;International;0;0;721;15
2020-08-31;;International;0;0;721;15
2020-09-01;;International;0;0;721;15
2020-09-02;;International;0;0;721;15
2020-09-03;;International;0;0;721;15
2020-09-04;;International;0;0;721;15
2020-09-05;;International;0;0;721;15
2020-09-06;;International;0;0;721;15
2020-09-07;;International;0;0;721;15
2020-09-08;;International;0;0;721;15
2020-09-09;;International;0;0;721;15
2020-09-10;;International;0;0;721;15
2020-09-11;;International;0;0;721;15
2020-09-12;;International;0;0;721;15
2020-09-13;;International;0;0;721;15
2020-09-14;;International;0;0;721;15
2020-09-15;;International;0;0;721;15
2020-09-16;;International;0;0;721;15
2020-09-17;;International;0;0;721;15
2020-09-18;;International;0;0;721;15
2020-09-19;;International;0;0;721;15
2020-09-20;;International;0;0;721;15
2020-09-21;;International;0;0;721;15
2020-09-22;;International;0;0;721;15
2020-09-23;;International;0;0;721;15
2020-09-24;;International;0;0;721;15
2020-09-25;;International;0;0;721;15
2020-09-26;;International;0;0;721;15
2020-09-27;;International;0;0;721;15
2020-09-28;;International;0;0;721;15
2020-09-29;;International;0;0;721;15
2020-09-30;;International;0;0;721;15
2020-10-01;;International;0;0;721;15
2020-10-02;;International;0;0;721;15
2020-10-03;;International;0;0;721;15
2020-10-04;;International;0;0;721;15
2020-10-05;;International;0;0;721;15
2020-10-06;;International;0;0;721;15
2020-10-07;;International;0;0;721;15
2020-10-08;;International;0;0;721;15
2020-10-09;;International;0;0;721;15
2020-10-10;;International;0;0;721;15
2020-10-11;;International;0;0;721;15
2020-10-12;;International;0;0;721;15
2020-10-13;;International;0;0;721;15
2020-10-14;;International;0;0;721;15
2020-10-15;;International;0;0;721;15
2020-10-16;;International;0;0;721;15
2020-10-17;;International;0;0;721;15
2020-10-18;;International;0;0;721;15
2020-10-19;;International;0;0;721;15
2020-10-20;;International;0;0;721;15
2020-10-21;;International;0;0;721;15
2020-10-22;;International;0;0;721;15
2020-10-23;;International;0;0;721;15
2020-10-24;;International;0;0;721;15
2020-10-25;;International;0;0;721;15
2020-10-26;;International;0;0;721;15
2020-10-27;;International;0;0;721;15
2020-10-28;;International;0;0;721;15
2020-10-29;;International;0;0;721;15
2020-10-30;;International;0;0;721;15
2020-10-31;;International;0;0;721;15
2020-11-01;;International;0;0;721;15
2020-11-02;;International;0;0;721;15
2020-11-03;;International;0;0;721;15
2020-11-04;;International;0;0;721;15
2020-11-05;;International;0;0;721;15
2020-11-06;;International;0;0;721;15
2020-11-07;;International;0;0;721;15
2020-11-08;;International;0;0;721;15
2020-11-09;;International;0;0;721;15
2020-11-10;;International;0;0;721;15
2020-11-11;;International;0;0;721;15
2020-11-12;;International;0;0;721;15
2020-11-13;;International;0;0;721;15
2020-11-14;;International;0;0;721;15
2020-11-15;;International;0;0;721;15
2020-11-16;;International;0;0;721;15
2020-11-17;;International;0;0;721;15
2020-11-18;;International;0;0;721;15
2020-11-19;;International;0;0;721;15
2020-11-20;;International;0;0;721;15
2020-11-21;;International;0;0;721;15
2020-11-22;;International;0;0;721;15
2020-11-23;;International;0;0;721;15
2020-11-24;;International;0;0;721;15
2020-11-25;;International;0;0;721;15
2020-11-26;;International;0;0;721;15
2020-11-27;;International;0;0;721;15
2020-11-28;;International;0;0;721;15
2020-11-29;;International;0;0;721;15
2020-11-30;;International;0;0;721;15
2020-12-01;;International;0;0;721;15
2020-12-02;;International;0;0;721;15
2020-12-03;;International;0;0;721;15
2020-12-04;;International;0;0;721;15
2020-12-05;;International;0;0;721;15
2020-12-06;;International;0;0;721;15
2020-12-07;;International;0;0;721;15
2020-12-08;;International;0;0;721;15
2020-12-09;;International;0;0;721;15
2020-12-10;;International;0;0;721;15
2020-12-11;;International;0;0;721;15
2020-12-12;;International;0;0;721;15
2020-12-13;;International;0;0;721;15
2020-12-14;;International;0;0;721;15
2020-12-15;;International;0;0;721;15
2020-12-16;;International;0;0;721;15
2020-12-17;;International;0;0;721;15
2020-12-18;;International;0;0;721;15
2020-12-19;;International;0;0;721;15
2020-12-20;;International;0;0;721;15
2020-12-21;;International;0;0;721;15
2020-12-22;;International;0;0;721;15
2020-12-23;;International;0;0;721;15
2020-12-24;;International;0;0;721;15
2020-12-25;;International;0;0;721;15
2020-12-26;;International;0;0;721;15
2020-12-27;;International;0;0;721;15
2020-12-28;;International;0;0;721;15
2020-12-29;;International;0;0;721;15
2020-12-30;;International;0;0;721;15
2020-12-31;;International;0;0;721;15
2021-01-01;;International;0;0;721;15
2021-01-02;;International;0;0;721;15
2021-01-03;;International;0;0;721;15
2021-01-04;;International;0;0;721;15
2021-01-05;;International;0;0;721;15
2021-01-06;;International;0;0;721;15
2021-01-07;;International;0;0;721;15
2021-01-08;;International;0;0;721;15
2021-01-09;;International;0;0;721;15
2021-01-10;;International;0;0;721;15
2021-01-11;;International;0;0;721;15
2021-01-12;;International;0;0;721;15
2021-01-13;;International;0;0;721;15
2021-01-14;;International;0;0;721;15
2021-01-15;;International;0;0;721;15
2021-01-16;;International;0;0;721;15
2021-01-17;;International;0;0;721;15
2021-01-18;;International;0;0;721;15
2021-01-19;;International;0;0;721;15
2021-01-20;;International;0;0;721;15
2021-01-21;;International;0;0;721;15
2021-01-22;;International;0;0;721;15
2021-01-23;;International;0;0;721;15
2021-01-24;;International;0;0;721;15
2021-01-25;;International;0;0;721;15
2021-01-26;;International;0;0;721;15
2021-01-27;;International;0;0;721;15
2021-01-28;;International;0;0;721;15
2021-01-29;;International;0;0;721;15
2021-01-30;;International;0;0;721;15
2021-01-31;;International;0;0;721;15
2021-02-01;;International;0;0;721;15
2021-02-02;;International;0;0;721;15
2021-02-03;;International;0;0;721;15
2021-02-04;;International;0;0;721;15
2021-02-05;;International;0;0;721;15
2021-02-06;;International;0;0;721;15
2021-02-07;;International;0;0;721;15
2021-02-08;;International;0;0;721;15
2021-02-09;;International;0;0;721;15
2021-02-10;;International;0;0;721;15
2021-02-11;;International;0;0;721;15
2021-02-12;;International;0;0;721;15
2021-02-13;;International;0;0;721;15
2021-02-14;;International;0;0;721;15
2021-02-15;;International;0;0;721;15
2021-02-16;;International;0;0;721;15
2021-02-17;;International;0;0;721;15
2021-02-18;;International;0;0;721;15
2021-02-19;;International;0;0;721;15
2021-02-20;;International;0;0;721;15
2021-02-21;;International;0;0;721;15
2021-02-22;;International;0;0;721;15
2021-02-23;;International;0;0;721;15
2021-02-24;;International;0;0;721;15
2021-02-25;;International;0;0;721;15
2021-02-26;;International;0;0;721;15
2021-02-27;;International;0;0;721;15
2021-02-28;;International;0;0;721;15
2021-03-01;;International;0;0;721;15
2021-03-02;;International;0;0;721;15
2021-03-03;;International;0;0;721;15
2021-03-04;;International;0;0;721;15
2021-03-05;;International;0;0;721;15
2021-03-06;;International;0;0;721;15
2021-03-07;;International;0;0;721;15
2021-03-08;;International;0;0;721;15
2021-03-09;;International;0;0;721;15
2021-03-10;;International;0;0;721;15
2021-03-11;;International;0;0;721;15
2021-03-12;;International;0;0;721;15
2021-03-13;;International;0;0;721;15
2021-03-14;;International;0;0;721;15
2021-03-15;;International;0;0;721;15
2021-03-16;;International;0;0;721;15
2021-03-17;;International;0;0;721;15
2021-03-18;;International;0;0;721;15
2021-03-19;;International;0;0;721;15
2021-03-20;;International;0;0;721;15
2021-03-21;;International;0;0;721;15
2021-03-22;;International;0;0;721;15
2021-03-23;;International;0;0;721;15
2021-03-24;;International;0;0;721;15
2021-03-25;;International;0;0;721;15
2021-03-26;;International;0;0;721;15
2021-03-27;;International;0;0;721;15
2021-03-28;;International;0;0;721;15
2021-03-29;;International;0;0;721;15
2021-03-30;;International;0;0;721;15
2021-03-31;;International;0;0;721;15
2021-04-01;;International;0;0;721;15
2021-04-02;;International;0;0;721;15
2021-04-03;;International;0;0;721;15
2021-04-04;;International;0;0;721;15
2021-04-05;;International;0;0;721;15
2021-04-06;;International;0;0;721;15
2021-04-07;;International;0;0;721;15
2021-04-08;;International;0;0;721;15
2021-04-09;;International;0;0;721;15
2021-04-10;;International;0;0;721;15
2021-04-11;;International;0;0;721;15
2021-04-12;;International;0;0;721;15
2021-04-13;;International;0;0;721;15
2021-04-14;;International;0;0;721;15
2021-04-15;;International;0;0;721;15
2021-04-16;;International;0;0;721;15
2021-04-17;;International;0;0;721;15
2021-04-18;;International;0;0;721;15
2021-04-19;;International;0;0;721;15
2021-04-20;;International;0;0;721;15
2021-04-21;;International;0;0;721;15
2021-04-22;;International;0;0;721;15
2021-04-23;;International;0;0;721;15
2021-04-24;;International;0;0;721;15
2021-04-25;;International;0;0;721;15
2021-04-26;;International;0;0;721;15
2021-04-27;;International;0;0;721;15
2021-04-28;;International;0;0;721;15
2021-04-29;;International;0;0;721;15
2021-04-30;;International;0;0;721;15
2021-05-01;;International;0;0;721;15
2021-05-02;;International;0;0;721;15
2021-05-03;;International;0;0;721;15
2021-05-04;;International;0;0;721;15
2021-05-05;;International;0;0;721;15
2021-05-06;;International;0;0;721;15
2021-05-07;;International;0;0;721;15
2021-05-08;;International;0;0;721;15
2021-05-09;;International;0;0;721;15
2021-05-10;;International;0;0;721;15
2021-05-11;;International;0;0;721;15
2021-05-12;;International;0;0;721;15
2021-05-13;;International;0;0;721;15
2021-05-14;;International;0;0;721;15
2021-05-15;;International;0;0;721;15
2021-05-16;;International;0;0;721;15
2021-05-17;;International;0;0;721;15
2021-05-18;;International;0;0;721;15
2021-05-19;;International;0;0;721;15
2021-05-20;;International;0;0;721;15
2021-05-21;;International;0;0;721;15
2021-05-22;;International;0;0;721;15
2021-05-23;;International;0;0;721;15
2021-05-24;;International;0;0;721;15
2021-05-25;;International;0;0;721;15
2021-05-26;;International;0;0;721;15
2021-05-27;;International;0;0;721;15
2021-05-28;;International;0;0;721;15
2021-05-29;;International;0;0;721;15
2021-05-30;;International;0;0;721;15
2021-05-31;;International;0;0;721;15
2021-06-01;;International;0;0;721;15
2021-06-02;;International;0;0;721;15
2021-06-03;;International;0;0;721;15
2021-06-04;;International;0;0;721;15
2021-06-05;;International;0;0;721;15
2021-06-06;;International;0;0;721;15
2021-06-07;;International;0;0;721;15
2021-06-08;;International;0;0;721;15
2021-06-09;;International;0;0;721;15
2021-06-10;;International;0;0;721;15
2021-06-11;;International;0;0;721;15
2021-06-12;;International;0;0;721;15
2021-06-13;;International;0;0;721;15
2021-06-14;;International;0;0;721;15
2021-06-15;;International;0;0;721;15
2021-06-16;;International;0;0;721;15
2021-06-17;;International;0;0;721;15
2021-06-18;;International;0;0;721;15
2021-06-19;;International;1;0;722;15
2021-06-20;;International;0;0;722;15
2021-06-21;;International;0;0;722;15
2021-06-22;;International;0;0;722;15
2021-06-23;;International;0;0;722;15
2021-06-24;;International;5;0;727;15
2021-06-25;;International;0;0;727;15
2021-06-26;;International;0;0;727;15
2021-06-27;;International;0;0;727;15
2021-06-28;;International;-5;0;722;15
2021-06-29;;International;0;0;722;15
2021-06-30;;International;0;0;722;15
2021-07-01;;International;0;0;722;15
2020-02-19;IR;Iran;2;2;2;2
2020-02-20;IR;Iran;3;0;5;2
2020-02-21;IR;Iran;13;2;18;4
2020-02-22;IR;Iran;10;1;28;5
2020-02-23;IR;Iran;15;3;43;8
2020-02-24;IR;Iran;18;4;61;12
2020-02-25;IR;Iran;34;4;95;16
2020-02-26;IR;Iran;44;3;139;19
2020-02-27;IR;Iran;106;7;245;26
2020-02-28;IR;Iran;143;8;388;34
2020-02-29;IR;Iran;205;9;593;43
2020-03-01;IR;Iran;385;11;978;54
2020-03-02;IR;Iran;523;12;1501;66
2020-03-03;IR;Iran;835;11;2336;77
2020-03-04;IR;Iran;586;15;2922;92
2020-03-05;IR;Iran;591;15;3513;107
2020-03-06;IR;Iran;1234;17;4747;124
2020-03-07;IR;Iran;1076;21;5823;145
2020-03-08;IR;Iran;743;49;6566;194
2020-03-09;IR;Iran;595;43;7161;237
2020-03-10;IR;Iran;881;54;8042;291
2020-03-11;IR;Iran;958;63;9000;354
2020-03-12;IR;Iran;1075;75;10075;429
2020-03-13;IR;Iran;1289;85;11364;514
2020-03-14;IR;Iran;1365;97;12729;611
2020-03-15;IR;Iran;1209;113;13938;724
2020-03-16;IR;Iran;1053;129;14991;853
2020-03-17;IR;Iran;1178;135;16169;988
2020-03-18;IR;Iran;1192;147;17361;1135
2020-03-19;IR;Iran;1046;149;18407;1284
2020-03-20;IR;Iran;1237;149;19644;1433
2020-03-21;IR;Iran;966;123;20610;1556
2020-03-22;IR;Iran;1028;129;21638;1685
2020-03-23;IR;Iran;1411;127;23049;1812
2020-03-24;IR;Iran;1762;122;24811;1934
2020-03-25;IR;Iran;2206;143;27017;2077
2020-03-26;IR;Iran;2389;157;29406;2234
2020-03-27;IR;Iran;2926;144;32332;2378
2020-03-28;IR;Iran;3076;139;35408;2517
2020-03-29;IR;Iran;2901;123;38309;2640
2020-03-30;IR;Iran;3186;117;41495;2757
2020-03-31;IR;Iran;3110;141;44605;2898
2020-04-01;IR;Iran;2988;138;47593;3036
2020-04-02;IR;Iran;2875;124;50468;3160
2020-04-03;IR;Iran;2715;134;53183;3294
2020-04-04;IR;Iran;2560;158;55743;3452
2020-04-05;IR;Iran;2483;151;58226;3603
2020-04-06;IR;Iran;2274;136;60500;3739
2020-04-07;IR;Iran;2089;133;62589;3872
2020-04-08;IR;Iran;1997;121;64586;3993
2020-04-09;IR;Iran;1634;117;66220;4110
2020-04-10;IR;Iran;1972;122;68192;4232
2020-04-11;IR;Iran;1837;125;70029;4357
2020-04-12;IR;Iran;1657;117;71686;4474
2020-04-13;IR;Iran;1617;111;73303;4585
2020-04-14;IR;Iran;1574;98;74877;4683
2020-04-15;IR;Iran;1512;94;76389;4777
2020-04-16;IR;Iran;1606;92;77995;4869
2020-04-17;IR;Iran;1499;89;79494;4958
2020-04-18;IR;Iran;1374;73;80868;5031
2020-04-19;IR;Iran;1343;87;82211;5118
2020-04-20;IR;Iran;1294;91;83505;5209
2020-04-21;IR;Iran;1297;88;84802;5297
2020-04-22;IR;Iran;1194;94;85996;5391
2020-04-23;IR;Iran;1030;90;87026;5481
2020-04-24;IR;Iran;1168;93;88194;5574
2020-04-25;IR;Iran;1134;76;89328;5650
2020-04-26;IR;Iran;1153;60;90481;5710
2020-04-27;IR;Iran;991;96;91472;5806
2020-04-28;IR;Iran;1112;71;92584;5877
2020-04-29;IR;Iran;1073;80;93657;5957
2020-04-30;IR;Iran;983;71;94640;6028
2020-05-01;IR;Iran;1006;63;95646;6091
2020-05-02;IR;Iran;802;65;96448;6156
2020-05-03;IR;Iran;976;47;97424;6203
2020-05-04;IR;Iran;1223;74;98647;6277
2020-05-05;IR;Iran;1323;63;99970;6340
2020-05-06;IR;Iran;1680;78;101650;6418
2020-05-07;IR;Iran;1485;68;103135;6486
2020-05-08;IR;Iran;1556;55;104691;6541
2020-05-09;IR;Iran;1529;48;106220;6589
2020-05-10;IR;Iran;1383;51;107603;6640
2020-05-11;IR;Iran;1683;45;109286;6685
2020-05-12;IR;Iran;1481;48;110767;6733
2020-05-13;IR;Iran;1958;50;112725;6783
2020-05-14;IR;Iran;1808;71;114533;6854
2020-05-15;IR;Iran;2102;48;116635;6902
2020-05-16;IR;Iran;1757;35;118392;6937
2020-05-17;IR;Iran;1806;51;120198;6988
2020-05-18;IR;Iran;2294;69;122492;7057
2020-05-19;IR;Iran;2111;62;124603;7119
2020-05-20;IR;Iran;2346;64;126949;7183
2020-05-21;IR;Iran;2392;66;129341;7249
2020-05-22;IR;Iran;2311;51;131652;7300
2020-05-23;IR;Iran;1869;59;133521;7359
2020-05-24;IR;Iran;2180;58;135701;7417
2020-05-25;IR;Iran;2023;34;137724;7451
2020-05-26;IR;Iran;1787;57;139511;7508
2020-05-27;IR;Iran;2080;56;141591;7564
2020-05-28;IR;Iran;2258;63;143849;7627
2020-05-29;IR;Iran;2819;50;146668;7677
2020-05-30;IR;Iran;2282;57;148950;7734
2020-05-31;IR;Iran;2516;63;151466;7797
2020-06-01;IR;Iran;2979;81;154445;7878
2020-06-02;IR;Iran;3117;64;157562;7942
2020-06-03;IR;Iran;3134;70;160696;8012
2020-06-04;IR;Iran;3574;59;164270;8071
2020-06-05;IR;Iran;2886;63;167156;8134
2020-06-06;IR;Iran;2269;75;169425;8209
2020-06-07;IR;Iran;2364;72;171789;8281
2020-06-08;IR;Iran;2043;70;173832;8351
2020-06-09;IR;Iran;2095;74;175927;8425
2020-06-10;IR;Iran;2011;81;177938;8506
2020-06-11;IR;Iran;2218;78;180156;8584
2020-06-12;IR;Iran;2369;75;182525;8659
2020-06-13;IR;Iran;2430;71;184955;8730
2020-06-14;IR;Iran;2472;107;187427;8837
2020-06-15;IR;Iran;2449;113;189876;8950
2020-06-16;IR;Iran;2563;115;192439;9065
2020-06-17;IR;Iran;2612;120;195051;9185
2020-06-18;IR;Iran;2596;87;197647;9272
2020-06-19;IR;Iran;2615;120;200262;9392
2020-06-20;IR;Iran;2322;115;202584;9507
2020-06-21;IR;Iran;2368;116;204952;9623
2020-06-22;IR;Iran;2573;119;207525;9742
2020-06-23;IR;Iran;2445;121;209970;9863
2020-06-24;IR;Iran;2531;133;212501;9996
2020-06-25;IR;Iran;2595;134;215096;10130
2020-06-26;IR;Iran;2628;109;217724;10239
2020-06-27;IR;Iran;2456;125;220180;10364
2020-06-28;IR;Iran;2489;144;222669;10508
2020-06-29;IR;Iran;2536;162;225205;10670
2020-06-30;IR;Iran;2457;147;227662;10817
2020-07-01;IR;Iran;2549;141;230211;10958
2020-07-02;IR;Iran;2652;148;232863;11106
2020-07-03;IR;Iran;2566;154;235429;11260
2020-07-04;IR;Iran;2449;148;237878;11408
2020-07-05;IR;Iran;2560;163;240438;11571
2020-07-06;IR;Iran;2613;160;243051;11731
2020-07-07;IR;Iran;2637;200;245688;11931
2020-07-08;IR;Iran;2691;153;248379;12084
2020-07-09;IR;Iran;2079;221;250458;12305
2020-07-10;IR;Iran;2262;142;252720;12447
2020-07-11;IR;Iran;2397;188;255117;12635
2020-07-12;IR;Iran;2186;194;257303;12829
2020-07-13;IR;Iran;2349;203;259652;13032
2020-07-14;IR;Iran;2521;179;262173;13211
2020-07-15;IR;Iran;2388;199;264561;13410
2020-07-16;IR;Iran;2500;198;267061;13608
2020-07-17;IR;Iran;2379;183;269440;13791
2020-07-18;IR;Iran;2166;188;271606;13979
2020-07-19;IR;Iran;2182;209;273788;14188
2020-07-20;IR;Iran;2414;217;276202;14405
2020-07-21;IR;Iran;2625;229;278827;14634
2020-07-22;IR;Iran;2586;219;281413;14853
2020-07-23;IR;Iran;2621;221;284034;15074
2020-07-24;IR;Iran;2489;215;286523;15289
2020-07-25;IR;Iran;2316;195;288839;15484
2020-07-26;IR;Iran;2333;216;291172;15700
2020-07-27;IR;Iran;2434;212;293606;15912
2020-07-28;IR;Iran;2667;235;296273;16147
2020-07-29;IR;Iran;2636;196;298909;16343
2020-07-30;IR;Iran;2621;226;301530;16569
2020-07-31;IR;Iran;2674;197;304204;16766
2020-08-01;IR;Iran;2548;216;306752;16982
2020-08-02;IR;Iran;2685;208;309437;17190
2020-08-03;IR;Iran;2598;215;312035;17405
2020-08-04;IR;Iran;2751;212;314786;17617
2020-08-05;IR;Iran;2697;185;317483;17802
2020-08-06;IR;Iran;2634;174;320117;17976
2020-08-07;IR;Iran;2450;156;322567;18132
2020-08-08;IR;Iran;2125;132;324692;18264
2020-08-09;IR;Iran;2020;163;326712;18427
2020-08-10;IR;Iran;2132;189;328844;18616
2020-08-11;IR;Iran;2345;184;331189;18800
2020-08-12;IR;Iran;2510;188;333699;18988
2020-08-13;IR;Iran;2625;174;336324;19162
2020-08-14;IR;Iran;2501;169;338825;19331
2020-08-15;IR;Iran;2245;161;341070;19492
2020-08-16;IR;Iran;2133;147;343203;19639
2020-08-17;IR;Iran;2247;165;345450;19804
2020-08-18;IR;Iran;2385;168;347835;19972
2020-08-19;IR;Iran;2444;153;350279;20125
2020-08-20;IR;Iran;2279;139;352558;20264
2020-08-21;IR;Iran;2206;112;354764;20376
2020-08-22;IR;Iran;2028;126;356792;20502
2020-08-23;IR;Iran;2113;141;358905;20643
2020-08-24;IR;Iran;2245;133;361150;20776
2020-08-25;IR;Iran;2213;125;363363;20901
2020-08-26;IR;Iran;2243;119;365606;21020
2020-08-27;IR;Iran;2190;117;367796;21137
2020-08-28;IR;Iran;2115;112;369911;21249
2020-08-29;IR;Iran;1905;110;371816;21359
2020-08-30;IR;Iran;1754;103;373570;21462
2020-08-31;IR;Iran;1642;109;375212;21571
2020-09-01;IR;Iran;1682;101;376894;21672
2020-09-02;IR;Iran;1858;125;378752;21797
2020-09-03;IR;Iran;1994;129;380746;21926
2020-09-04;IR;Iran;2026;118;382772;22044
2020-09-05;IR;Iran;1894;110;384666;22154
2020-09-06;IR;Iran;1992;139;386658;22293
2020-09-07;IR;Iran;2152;117;388810;22410
2020-09-08;IR;Iran;2302;132;391112;22542
2020-09-09;IR;Iran;2313;127;393425;22669
2020-09-10;IR;Iran;2063;129;395488;22798
2020-09-11;IR;Iran;2313;115;397801;22913
2020-09-12;IR;Iran;2139;116;399940;23029
2020-09-13;IR;Iran;2089;128;402029;23157
2020-09-14;IR;Iran;2619;156;404648;23313
2020-09-15;IR;Iran;2705;140;407353;23453
2020-09-16;IR;Iran;2981;179;410334;23632
2020-09-17;IR;Iran;2815;176;413149;23808
2020-09-18;IR;Iran;3049;144;416198;23952
2020-09-19;IR;Iran;2845;166;419043;24118
2020-09-20;IR;Iran;3097;183;422140;24301
2020-09-21;IR;Iran;3341;177;425481;24478
2020-09-22;IR;Iran;3712;178;429193;24656
2020-09-23;IR;Iran;3605;184;432798;24840
2020-09-24;IR;Iran;3521;175;436319;25015
2020-09-25;IR;Iran;3563;207;439882;25222
2020-09-26;IR;Iran;3204;172;443086;25394
2020-09-27;IR;Iran;3362;195;446448;25589
2020-09-28;IR;Iran;3512;190;449960;25779
2020-09-29;IR;Iran;3677;207;453637;25986
2020-09-30;IR;Iran;3582;183;457219;26169
2020-10-01;IR;Iran;3825;211;461044;26380
2020-10-02;IR;Iran;3552;187;464596;26567
2020-10-03;IR;Iran;3523;179;468119;26746
2020-10-04;IR;Iran;3653;211;471772;26957
2020-10-05;IR;Iran;3902;235;475674;27192
2020-10-06;IR;Iran;4151;227;479825;27419
2020-10-07;IR;Iran;4019;239;483844;27658
2020-10-08;IR;Iran;4392;230;488236;27888
2020-10-09;IR;Iran;4142;210;492378;28098
2020-10-10;IR;Iran;3875;195;496253;28293
2020-10-11;IR;Iran;3822;251;500075;28544
2020-10-12;IR;Iran;4206;272;504281;28816
2020-10-13;IR;Iran;4108;254;508389;29070
2020-10-14;IR;Iran;4830;279;513219;29349
2020-10-15;IR;Iran;4616;256;517835;29605
2020-10-16;IR;Iran;4552;265;522387;29870
2020-10-17;IR;Iran;4103;253;526490;30123
2020-10-18;IR;Iran;3890;252;530380;30375
2020-10-19;IR;Iran;4251;337;534631;30712
2020-10-20;IR;Iran;5039;322;539670;31034
2020-10-21;IR;Iran;5616;312;545286;31346
2020-10-22;IR;Iran;5471;304;550757;31650
2020-10-23;IR;Iran;6134;335;556891;31985
2020-10-24;IR;Iran;5814;335;562705;32320
2020-10-25;IR;Iran;6191;296;568896;32616
2020-10-26;IR;Iran;5960;337;574856;32953
2020-10-27;IR;Iran;6968;346;581824;33299
2020-10-28;IR;Iran;6824;415;588648;33714
2020-10-29;IR;Iran;8293;399;596941;34113
2020-10-30;IR;Iran;8011;365;604952;34478
2020-10-31;IR;Iran;7820;386;612772;34864
2020-11-01;IR;Iran;7719;434;620491;35298
2020-11-02;IR;Iran;8289;440;628780;35738
2020-11-03;IR;Iran;8932;422;637712;36160
2020-11-04;IR;Iran;8452;419;646164;36579
2020-11-05;IR;Iran;8772;406;654936;36985
2020-11-06;IR;Iran;8864;424;663800;37409
2020-11-07;IR;Iran;9450;423;673250;37832
2020-11-08;IR;Iran;9236;459;682486;38291
2020-11-09;IR;Iran;10463;458;692949;38749
2020-11-10;IR;Iran;10339;453;703288;39202
2020-11-11;IR;Iran;11780;462;715068;39664
2020-11-12;IR;Iran;11517;457;726585;40121
2020-11-13;IR;Iran;11737;461;738322;40582
2020-11-14;IR;Iran;11203;452;749525;41034
2020-11-15;IR;Iran;12543;459;762068;41493
2020-11-16;IR;Iran;13053;486;775121;41979
2020-11-17;IR;Iran;13352;482;788473;42461
2020-11-18;IR;Iran;13421;480;801894;42941
2020-11-19;IR;Iran;13223;476;815117;43417
2020-11-20;IR;Iran;13260;479;828377;43896
2020-11-21;IR;Iran;12931;431;841308;44327
2020-11-22;IR;Iran;13053;475;854361;44802
2020-11-23;IR;Iran;12460;453;866821;45255
2020-11-24;IR;Iran;13721;483;880542;45738
2020-11-25;IR;Iran;13843;469;894385;46207
2020-11-26;IR;Iran;13961;482;908346;46689
2020-11-27;IR;Iran;14051;406;922397;47095
2020-11-28;IR;Iran;13402;391;935799;47486
2020-11-29;IR;Iran;12950;388;948749;47874
2020-11-30;IR;Iran;13321;372;962070;48246
2020-12-01;IR;Iran;13881;382;975951;48628
2020-12-02;IR;Iran;13621;362;989572;48990
2020-12-03;IR;Iran;13922;358;1003494;49348
2020-12-04;IR;Iran;13341;347;1016835;49695
2020-12-05;IR;Iran;12151;321;1028986;50016
2020-12-06;IR;Iran;11561;294;1040547;50310
2020-12-07;IR;Iran;10827;284;1051374;50594
2020-12-08;IR;Iran;11023;323;1062397;50917
2020-12-09;IR;Iran;10223;295;1072620;51212
2020-12-10;IR;Iran;10403;284;1083023;51496
2020-12-11;IR;Iran;9384;231;1092407;51727
2020-12-12;IR;Iran;8411;222;1100818;51949
2020-12-13;IR;Iran;7451;247;1108269;52196
2020-12-14;IR;Iran;7501;251;1115770;52447
2020-12-15;IR;Iran;7704;223;1123474;52670
2020-12-16;IR;Iran;7603;213;1131077;52883
2020-12-17;IR;Iran;7453;212;1138530;53095
2020-12-18;IR;Iran;7121;178;1145651;53273
2020-12-19;IR;Iran;6421;175;1152072;53448
2020-12-20;IR;Iran;6312;177;1158384;53625
2020-12-21;IR;Iran;6151;191;1164535;53816
2020-12-22;IR;Iran;6208;187;1170743;54003
2020-12-23;IR;Iran;6261;153;1177004;54156
2020-12-24;IR;Iran;6178;152;1183182;54308
2020-12-25;IR;Iran;6021;132;1189203;54440
2020-12-26;IR;Iran;5760;134;1194963;54574
2020-12-27;IR;Iran;5502;119;1200465;54693
2020-12-28;IR;Iran;5908;121;1206373;54814
2020-12-29;IR;Iran;6108;132;1212481;54946
2020-12-30;IR;Iran;6272;149;1218753;55095
2020-12-31;IR;Iran;6389;128;1225142;55223
2021-01-01;IR;Iran;6287;114;1231429;55337
2021-01-02;IR;Iran;6045;101;1237474;55438
2021-01-03;IR;Iran;5960;102;1243434;55540
2021-01-04;IR;Iran;6073;110;1249507;55650
2021-01-05;IR;Iran;6113;98;1255620;55748
2021-01-06;IR;Iran;6283;82;1261903;55830
2021-01-07;IR;Iran;6360;103;1268263;55933
2021-01-08;IR;Iran;6251;85;1274514;56018
2021-01-09;IR;Iran;5924;82;1280438;56100
2021-01-10;IR;Iran;5968;71;1286406;56171
2021-01-11;IR;Iran;6208;91;1292614;56262
2021-01-12;IR;Iran;6408;98;1299022;56360
2021-01-13;IR;Iran;6317;97;1305339;56457
2021-01-14;IR;Iran;6471;81;1311810;56538
2021-01-15;IR;Iran;6485;83;1318295;56621
2021-01-16;IR;Iran;6100;96;1324395;56717
2021-01-17;IR;Iran;6016;86;1330411;56803
2021-01-18;IR;Iran;5806;83;1336217;56886
2021-01-19;IR;Iran;5917;87;1342134;56973
2021-01-20;IR;Iran;6182;84;1348316;57057
2021-01-21;IR;Iran;6204;93;1354520;57150
2021-01-22;IR;Iran;6332;75;1360852;57225
2021-01-23;IR;Iran;6180;69;1367032;57294
2021-01-24;IR;Iran;5945;89;1372977;57383
2021-01-25;IR;Iran;6309;98;1379286;57481
2021-01-26;IR;Iran;6420;79;1385706;57560
2021-01-27;IR;Iran;6608;91;1392314;57651
2021-01-28;IR;Iran;6527;85;1398841;57736
2021-01-29;IR;Iran;6573;71;1405414;57807
2021-01-30;IR;Iran;6317;82;1411731;57889
2021-01-31;IR;Iran;6268;70;1417999;57959
2021-02-01;IR;Iran;6597;79;1424596;58038
2021-02-02;IR;Iran;6820;72;1431416;58110
2021-02-03;IR;Iran;6870;79;1438286;58189
2021-02-04;IR;Iran;7040;67;1445326;58256
2021-02-05;IR;Iran;7054;80;1452380;58336
2021-02-06;IR;Iran;6990;76;1459370;58412
2021-02-07;IR;Iran;7065;57;1466435;58469
2021-02-08;IR;Iran;7321;67;1473756;58536
2021-02-09;IR;Iran;7640;89;1481396;58625
2021-02-10;IR;Iran;7585;61;1488981;58686
2021-02-11;IR;Iran;7474;65;1496455;58751
2021-02-12;IR;Iran;7298;58;1503753;58809
2021-02-13;IR;Iran;7120;74;1510873;58883
2021-02-14;IR;Iran;7390;62;1518263;58945
2021-02-15;IR;Iran;7760;83;1526023;59028
2021-02-16;IR;Iran;8011;89;1534034;59117
2021-02-17;IR;Iran;8042;67;1542076;59184
2021-02-18;IR;Iran;8066;80;1550142;59264
2021-02-19;IR;Iran;8017;77;1558159;59341
2021-02-20;IR;Iran;7922;68;1566081;59409
2021-02-21;IR;Iran;7931;74;1574012;59483
2021-02-22;IR;Iran;8263;89;1582275;59572
2021-02-23;IR;Iran;8330;91;1590605;59663
2021-02-24;IR;Iran;8270;73;1598875;59736
2021-02-25;IR;Iran;8206;94;1607081;59830
2021-02-26;IR;Iran;8103;69;1615184;59899
2021-02-27;IR;Iran;7975;81;1623159;59980
2021-02-28;IR;Iran;8010;93;1631169;60073
2021-03-01;IR;Iran;8510;108;1639679;60181
2021-03-02;IR;Iran;8495;86;1648174;60267
2021-03-03;IR;Iran;8525;86;1656699;60353
2021-03-04;IR;Iran;8404;78;1665103;60431
2021-03-05;IR;Iran;8367;81;1673470;60512
2021-03-06;IR;Iran;8212;82;1681682;60594
2021-03-07;IR;Iran;8010;93;1689692;60687
2021-03-08;IR;Iran;8313;99;1698005;60786
2021-03-09;IR;Iran;8554;81;1706559;60867
2021-03-10;IR;Iran;8603;61;1715162;60928
2021-03-11;IR;Iran;8308;88;1723470;61016
2021-03-12;IR;Iran;8088;53;1731558;61069
2021-03-13;IR;Iran;7802;73;1739360;61142
2021-03-14;IR;Iran;7593;88;1746953;61230
2021-03-15;IR;Iran;7980;100;1754933;61330
2021-03-16;IR;Iran;8380;97;1763313;61427
2021-03-17;IR;Iran;7802;65;1771115;61492
2021-03-18;IR;Iran;7530;89;1778645;61581
2021-03-19;IR;Iran;7620;68;1786265;61649
2021-03-20;IR;Iran;7540;75;1793805;61724
2021-03-21;IR;Iran;7260;73;1801065;61797
2021-03-22;IR;Iran;7357;80;1808422;61877
2021-03-23;IR;Iran;7290;74;1815712;61951
2021-03-24;IR;Iran;7605;94;1823317;62045
2021-03-25;IR;Iran;7506;97;1830823;62142
2021-03-26;IR;Iran;7980;81;1838803;62223
2021-03-27;IR;Iran;8120;85;1846923;62308
2021-03-28;IR;Iran;8751;89;1855674;62397
2021-03-29;IR;Iran;9310;81;1864984;62478
2021-03-30;IR;Iran;10250;91;1875234;62569
2021-03-31;IR;Iran;10330;96;1885564;62665
2021-04-01;IR;Iran;11750;94;1897314;62759
2021-04-02;IR;Iran;11660;117;1908974;62876
2021-04-03;IR;Iran;11420;123;1920394;62999
2021-04-04;IR;Iran;11680;161;1932074;63160
2021-04-05;IR;Iran;13890;172;1945964;63332
2021-04-06;IR;Iran;17430;174;1963394;63506
2021-04-07;IR;Iran;20954;193;1984348;63699
2021-04-08;IR;Iran;22586;185;2006934;63884
2021-04-09;IR;Iran;22478;155;2029412;64039
2021-04-10;IR;Iran;19666;193;2049078;64232
2021-04-11;IR;Iran;21063;258;2070141;64490
2021-04-12;IR;Iran;23311;274;2093452;64764
2021-04-13;IR;Iran;24760;291;2118212;65055
2021-04-14;IR;Iran;25582;304;2143794;65359
2021-04-15;IR;Iran;25078;321;2168872;65680
2021-04-16;IR;Iran;25261;328;2194133;66008
2021-04-17;IR;Iran;21312;319;2215445;66327
2021-04-18;IR;Iran;21644;405;2237089;66732
2021-04-19;IR;Iran;24346;398;2261435;67130
2021-04-20;IR;Iran;25492;395;2286927;67525
2021-04-21;IR;Iran;24886;388;2311813;67913
2021-04-22;IR;Iran;24092;453;2335905;68366
2021-04-23;IR;Iran;22904;380;2358809;68746
2021-04-24;IR;Iran;18230;374;2377039;69120
2021-04-25;IR;Iran;19165;454;2396204;69574
2021-04-26;IR;Iran;21026;496;2417230;70070
2021-04-27;IR;Iran;20963;462;2438193;70532
2021-04-28;IR;Iran;21713;434;2459906;70966
2021-04-29;IR;Iran;19899;385;2479805;71351
2021-04-30;IR;Iran;19272;407;2499077;71758
2021-05-01;IR;Iran;17080;332;2516157;72090
2021-05-02;IR;Iran;18698;394;2534855;72484
2021-05-03;IR;Iran;20732;391;2555587;72875
2021-05-04;IR;Iran;20150;344;2575737;73219
2021-05-05;IR;Iran;15872;349;2591609;73568
2021-05-06;IR;Iran;18409;338;2610018;73906
2021-05-07;IR;Iran;17076;335;2627094;74241
2021-05-08;IR;Iran;13576;283;2640670;74524
2021-05-09;IR;Iran;14141;386;2654811;74910
2021-05-10;IR;Iran;18408;351;2673219;75261
2021-05-11;IR;Iran;18133;307;2691352;75568
2021-05-12;IR;Iran;16409;366;2707761;75934
2021-05-13;IR;Iran;14246;297;2722007;76231
2021-05-14;IR;Iran;10145;202;2732152;76433
2021-05-15;IR;Iran;7723;200;2739875;76633
2021-05-16;IR;Iran;11291;303;2751166;76936
2021-05-17;IR;Iran;14319;286;2765485;77222
2021-05-18;IR;Iran;13930;310;2779415;77532
2021-05-19;IR;Iran;12789;233;2792204;77765
2021-05-20;IR;Iran;12428;229;2804632;77994
2021-05-21;IR;Iran;11250;200;2815882;78194
2021-05-22;IR;Iran;8005;187;2823887;78381
2021-05-23;IR;Iran;8631;216;2832518;78597
2021-05-24;IR;Iran;11005;251;2843523;78848
2021-05-25;IR;Iran;11873;208;2855396;79056
2021-05-26;IR;Iran;10468;163;2865864;79219
2021-05-27;IR;Iran;9994;165;2875858;79384
2021-05-28;IR;Iran;10253;184;2886111;79568
2021-05-29;IR;Iran;7107;173;2893218;79741
2021-05-30;IR;Iran;8876;198;2902094;79939
2021-05-31;IR;Iran;11042;217;2913136;80156
2021-06-01;IR;Iran;10687;171;2923823;80327
2021-06-02;IR;Iran;11620;161;2935443;80488
2021-06-03;IR;Iran;9657;170;2945100;80658
2021-06-04;IR;Iran;9209;155;2954309;80813
2021-06-05;IR;Iran;6442;128;2960751;80941
2021-06-06;IR;Iran;5612;122;2966363;81063
2021-06-07;IR;Iran;4907;120;2971270;81183
2021-06-08;IR;Iran;8846;179;2980116;81362
2021-06-09;IR;Iran;10598;157;2990714;81519
2021-06-10;IR;Iran;12398;153;3003112;81672
2021-06-11;IR;Iran;9966;124;3013078;81796
2021-06-12;IR;Iran;7444;115;3020522;81911
2021-06-13;IR;Iran;8195;187;3028717;82098
2021-06-14;IR;Iran;10715;119;3039432;82217
2021-06-15;IR;Iran;10216;134;3049648;82351
2021-06-16;IR;Iran;10487;129;3060135;82480
2021-06-17;IR;Iran;10291;139;3070426;82619
2021-06-18;IR;Iran;10100;127;3080526;82746
2021-06-19;IR;Iran;6448;108;3086974;82854
2021-06-20;IR;Iran;8161;111;3095135;82965
2021-06-21;IR;Iran;10485;136;3105620;83101
2021-06-22;IR;Iran;11716;116;3117336;83217
2021-06-23;IR;Iran;11059;112;3128395;83329
2021-06-24;IR;Iran;11734;144;3140129;83473
2021-06-25;IR;Iran;10820;115;3150949;83588
2021-06-26;IR;Iran;7034;123;3157983;83711
2021-06-27;IR;Iran;9758;134;3167741;83845
2021-06-28;IR;Iran;12351;140;3180092;83985
2021-06-29;IR;Iran;12717;142;3192809;84127
2021-06-30;IR;Iran;11748;137;3204557;84264
2021-07-01;IR;Iran;14303;125;3218860;84389
2020-02-24;IQ;Iraq;1;0;1;0
2020-02-25;IQ;Iraq;0;0;1;0
2020-02-26;IQ;Iraq;4;0;5;0
2020-02-27;IQ;Iraq;2;0;7;0
2020-02-28;IQ;Iraq;0;0;7;0
2020-02-29;IQ;Iraq;6;0;13;0
2020-03-01;IQ;Iraq;6;0;19;0
2020-03-02;IQ;Iraq;7;0;26;0
2020-03-03;IQ;Iraq;6;0;32;0
2020-03-04;IQ;Iraq;3;2;35;2
2020-03-05;IQ;Iraq;0;0;35;2
2020-03-06;IQ;Iraq;5;1;40;3
2020-03-07;IQ;Iraq;14;1;54;4
2020-03-08;IQ;Iraq;6;2;60;6
2020-03-09;IQ;Iraq;0;0;60;6
2020-03-10;IQ;Iraq;11;1;71;7
2020-03-11;IQ;Iraq;0;0;71;7
2020-03-12;IQ;Iraq;0;1;71;8
2020-03-13;IQ;Iraq;30;1;101;9
2020-03-14;IQ;Iraq;9;1;110;10
2020-03-15;IQ;Iraq;6;0;116;10
2020-03-16;IQ;Iraq;8;0;124;10
2020-03-17;IQ;Iraq;30;1;154;11
2020-03-18;IQ;Iraq;10;1;164;12
2020-03-19;IQ;Iraq;28;1;192;13
2020-03-20;IQ;Iraq;16;4;208;17
2020-03-21;IQ;Iraq;6;0;214;17
2020-03-22;IQ;Iraq;19;3;233;20
2020-03-23;IQ;Iraq;33;3;266;23
2020-03-24;IQ;Iraq;50;4;316;27
2020-03-25;IQ;Iraq;30;2;346;29
2020-03-26;IQ;Iraq;36;7;382;36
2020-03-27;IQ;Iraq;76;4;458;40
2020-03-28;IQ;Iraq;48;2;506;42
2020-03-29;IQ;Iraq;41;0;547;42
2020-03-30;IQ;Iraq;83;4;630;46
2020-03-31;IQ;Iraq;64;4;694;50
2020-04-01;IQ;Iraq;34;2;728;52
2020-04-02;IQ;Iraq;44;2;772;54
2020-04-03;IQ;Iraq;48;0;820;54
2020-04-04;IQ;Iraq;58;2;878;56
2020-04-05;IQ;Iraq;83;5;961;61
2020-04-06;IQ;Iraq;70;3;1031;64
2020-04-07;IQ;Iraq;91;1;1122;65
2020-04-08;IQ;Iraq;80;4;1202;69
2020-04-09;IQ;Iraq;30;0;1232;69
2020-04-10;IQ;Iraq;47;1;1279;70
2020-04-11;IQ;Iraq;39;2;1318;72
2020-04-12;IQ;Iraq;34;4;1352;76
2020-04-13;IQ;Iraq;26;2;1378;78
2020-04-14;IQ;Iraq;22;0;1400;78
2020-04-15;IQ;Iraq;15;1;1415;79
2020-04-16;IQ;Iraq;19;1;1434;80
2020-04-17;IQ;Iraq;48;1;1482;81
2020-04-18;IQ;Iraq;31;1;1513;82
2020-04-19;IQ;Iraq;26;0;1539;82
2020-04-20;IQ;Iraq;35;0;1574;82
2020-04-21;IQ;Iraq;28;1;1602;83
2020-04-22;IQ;Iraq;29;0;1631;83
2020-04-23;IQ;Iraq;46;0;1677;83
2020-04-24;IQ;Iraq;31;3;1708;86
2020-04-25;IQ;Iraq;55;0;1763;86
2020-04-26;IQ;Iraq;57;1;1820;87
2020-04-27;IQ;Iraq;27;1;1847;88
2020-04-28;IQ;Iraq;81;2;1928;90
2020-04-29;IQ;Iraq;75;2;2003;92
2020-04-30;IQ;Iraq;82;1;2085;93
2020-05-01;IQ;Iraq;68;1;2153;94
2020-05-02;IQ;Iraq;66;1;2219;95
2020-05-03;IQ;Iraq;77;2;2296;97
2020-05-04;IQ;Iraq;50;1;2346;98
2020-05-05;IQ;Iraq;85;4;2431;102
2020-05-06;IQ;Iraq;49;0;2480;102
2020-05-07;IQ;Iraq;63;0;2543;102
2020-05-08;IQ;Iraq;60;2;2603;104
2020-05-09;IQ;Iraq;76;3;2679;107
2020-05-10;IQ;Iraq;88;2;2767;109
2020-05-11;IQ;Iraq;51;1;2818;110
2020-05-12;IQ;Iraq;95;2;2913;112
2020-05-13;IQ;Iraq;119;3;3032;115
2020-05-14;IQ;Iraq;111;0;3143;115
2020-05-15;IQ;Iraq;50;2;3193;117
2020-05-16;IQ;Iraq;67;4;3260;121
2020-05-17;IQ;Iraq;144;2;3404;123
2020-05-18;IQ;Iraq;150;4;3554;127
2020-05-19;IQ;Iraq;57;4;3611;131
2020-05-20;IQ;Iraq;113;3;3724;134
2020-05-21;IQ;Iraq;153;6;3877;140
2020-05-22;IQ;Iraq;87;7;3964;147
2020-05-23;IQ;Iraq;308;5;4272;152
2020-05-24;IQ;Iraq;197;8;4469;160
2020-05-25;IQ;Iraq;163;3;4632;163
2020-05-26;IQ;Iraq;216;6;4848;169
2020-05-27;IQ;Iraq;287;6;5135;175
2020-05-28;IQ;Iraq;322;4;5457;179
2020-05-29;IQ;Iraq;416;6;5873;185
2020-05-30;IQ;Iraq;306;10;6179;195
2020-05-31;IQ;Iraq;260;10;6439;205
2020-06-01;IQ;Iraq;429;10;6868;215
2020-06-02;IQ;Iraq;519;20;7387;235
2020-06-03;IQ;Iraq;781;21;8168;256
2020-06-04;IQ;Iraq;672;15;8840;271
2020-06-05;IQ;Iraq;1006;14;9846;285
2020-06-06;IQ;Iraq;1252;33;11098;318
2020-06-07;IQ;Iraq;1268;28;12366;346
2020-06-08;IQ;Iraq;1115;24;13481;370
2020-06-09;IQ;Iraq;787;22;14268;392
2020-06-10;IQ;Iraq;1146;34;15414;426
2020-06-11;IQ;Iraq;1261;31;16675;457
2020-06-12;IQ;Iraq;1095;39;17770;496
2020-06-13;IQ;Iraq;1180;53;18950;549
2020-06-14;IQ;Iraq;1259;58;20209;607
2020-06-15;IQ;Iraq;1106;45;21315;652
2020-06-16;IQ;Iraq;1385;60;22700;712
2020-06-17;IQ;Iraq;1554;61;24254;773
2020-06-18;IQ;Iraq;1463;83;25717;856
2020-06-19;IQ;Iraq;1635;69;27352;925
2020-06-20;IQ;Iraq;1870;88;29222;1013
2020-06-21;IQ;Iraq;1646;87;30868;1100
2020-06-22;IQ;Iraq;1808;67;32676;1167
2020-06-23;IQ;Iraq;1826;84;34502;1251
2020-06-24;IQ;Iraq;2200;79;36702;1330
2020-06-25;IQ;Iraq;2437;107;39139;1437
2020-06-26;IQ;Iraq;2054;122;41193;1559
2020-06-27;IQ;Iraq;2069;101;43262;1660
2020-06-28;IQ;Iraq;2140;96;45402;1756
2020-06-29;IQ;Iraq;1749;83;47151;1839
2020-06-30;IQ;Iraq;1958;104;49109;1943
2020-07-01;IQ;Iraq;2415;107;51524;2050
2020-07-02;IQ;Iraq;2184;110;53708;2160
2020-07-03;IQ;Iraq;2312;102;56020;2262
2020-07-04;IQ;Iraq;2334;106;58354;2368
2020-07-05;IQ;Iraq;2125;105;60479;2473
2020-07-06;IQ;Iraq;1796;94;62275;2567
2020-07-07;IQ;Iraq;2426;118;64701;2685
2020-07-08;IQ;Iraq;2741;94;67442;2779
2020-07-09;IQ;Iraq;2170;103;69612;2882
2020-07-10;IQ;Iraq;2848;78;72460;2960
2020-07-11;IQ;Iraq;2734;95;75194;3055
2020-07-12;IQ;Iraq;2312;95;77506;3150
2020-07-13;IQ;Iraq;2229;100;79735;3250
2020-07-14;IQ;Iraq;2022;95;81757;3345
2020-07-15;IQ;Iraq;2110;87;83867;3432
2020-07-16;IQ;Iraq;2281;90;86148;3522
2020-07-17;IQ;Iraq;2023;94;88171;3616
2020-07-18;IQ;Iraq;2049;75;90220;3691
2020-07-19;IQ;Iraq;2310;90;92530;3781
2020-07-20;IQ;Iraq;2163;88;94693;3869
2020-07-21;IQ;Iraq;2466;81;97159;3950
2020-07-22;IQ;Iraq;2706;92;99865;4042
2020-07-23;IQ;Iraq;2361;80;102226;4122
2020-07-24;IQ;Iraq;2485;90;104711;4212
2020-07-25;IQ;Iraq;2862;72;107573;4284
2020-07-26;IQ;Iraq;2459;78;110032;4362
2020-07-27;IQ;Iraq;2553;96;112585;4458
2020-07-28;IQ;Iraq;2747;77;115332;4535
2020-07-29;IQ;Iraq;2968;68;118300;4603
2020-07-30;IQ;Iraq;2963;68;121263;4671
2020-07-31;IQ;Iraq;3346;70;124609;4741
2020-08-01;IQ;Iraq;2095;64;126704;4805
2020-08-02;IQ;Iraq;2447;63;129151;4868
2020-08-03;IQ;Iraq;2735;66;131886;4934
2020-08-04;IQ;Iraq;2836;83;134722;5017
2020-08-05;IQ;Iraq;2834;77;137556;5094
2020-08-06;IQ;Iraq;3047;67;140603;5161
2020-08-07;IQ;Iraq;3461;75;144064;5236
2020-08-08;IQ;Iraq;3325;74;147389;5310
2020-08-09;IQ;Iraq;2726;82;150115;5392
2020-08-10;IQ;Iraq;3484;72;153599;5464
2020-08-11;IQ;Iraq;3396;67;156995;5531
2020-08-12;IQ;Iraq;3441;57;160436;5588
2020-08-13;IQ;Iraq;3841;53;164277;5641
2020-08-14;IQ;Iraq;4013;68;168290;5709
2020-08-15;IQ;Iraq;4293;76;172583;5785
2020-08-16;IQ;Iraq;4348;75;176931;5860
2020-08-17;IQ;Iraq;3202;94;180133;5954
2020-08-18;IQ;Iraq;4576;82;184709;6036
2020-08-19;IQ;Iraq;4093;85;188802;6121
2020-08-20;IQ;Iraq;3995;87;192797;6208
2020-08-21;IQ;Iraq;4288;75;197085;6283
2020-08-22;IQ;Iraq;3965;70;201050;6353
2020-08-23;IQ;Iraq;3291;75;204341;6428
2020-08-24;IQ;Iraq;3644;91;207985;6519
2020-08-25;IQ;Iraq;3962;77;211947;6596
2020-08-26;IQ;Iraq;3837;72;215784;6668
2020-08-27;IQ;Iraq;3651;72;219435;6740
2020-08-28;IQ;Iraq;4177;74;223612;6814
2020-08-29;IQ;Iraq;3834;77;227446;6891
2020-08-30;IQ;Iraq;3731;68;231177;6959
2020-08-31;IQ;Iraq;3757;83;234934;7042
2020-09-01;IQ;Iraq;3404;81;238338;7123
2020-09-02;IQ;Iraq;3946;78;242284;7201
2020-09-03;IQ;Iraq;4755;74;247039;7275
2020-09-04;IQ;Iraq;5036;84;252075;7359
2020-09-05;IQ;Iraq;4644;63;256719;7422
2020-09-06;IQ;Iraq;3651;90;260370;7512
2020-09-07;IQ;Iraq;4314;77;264684;7589
2020-09-08;IQ;Iraq;4894;68;269578;7657
2020-09-09;IQ;Iraq;4243;75;273821;7732
2020-09-10;IQ;Iraq;4597;82;278418;7814
2020-09-11;IQ;Iraq;4254;67;282672;7881
2020-09-12;IQ;Iraq;4106;60;286778;7941
2020-09-13;IQ;Iraq;3531;73;290309;8014
2020-09-14;IQ;Iraq;4169;72;294478;8086
2020-09-15;IQ;Iraq;4224;80;298702;8166
2020-09-16;IQ;Iraq;4357;82;303059;8248
2020-09-17;IQ;Iraq;4326;84;307385;8332
2020-09-18;IQ;Iraq;4305;76;311690;8408
2020-09-19;IQ;Iraq;3907;83;315597;8491
2020-09-20;IQ;Iraq;3438;64;319035;8555
2020-09-21;IQ;Iraq;3821;70;322856;8625
2020-09-22;IQ;Iraq;4724;57;327580;8682
2020-09-23;IQ;Iraq;5055;72;332635;8754
2020-09-24;IQ;Iraq;4471;45;337106;8799
2020-09-25;IQ;Iraq;4593;68;341699;8867
2020-09-26;IQ;Iraq;4270;68;345969;8935
2020-09-27;IQ;Iraq;3481;55;349450;8990
2020-09-28;IQ;Iraq;4116;62;353566;9052
2020-09-29;IQ;Iraq;4724;70;358290;9122
2020-09-30;IQ;Iraq;4691;59;362981;9181
2020-10-01;IQ;Iraq;4493;50;367474;9231
2020-10-02;IQ;Iraq;4785;67;372259;9298
2020-10-03;IQ;Iraq;3672;49;375931;9347
2020-10-04;IQ;Iraq;3210;52;379141;9399
2020-10-05;IQ;Iraq;3808;65;382949;9464
2020-10-06;IQ;Iraq;4172;67;387121;9531
2020-10-07;IQ;Iraq;3923;73;391044;9604
2020-10-08;IQ;Iraq;3522;79;394566;9683
2020-10-09;IQ;Iraq;3214;52;397780;9735
2020-10-10;IQ;Iraq;2344;55;400124;9790
2020-10-11;IQ;Iraq;2206;62;402330;9852
2020-10-12;IQ;Iraq;3107;60;405437;9912
2020-10-13;IQ;Iraq;3921;58;409358;9970
2020-10-14;IQ;Iraq;3857;51;413215;10021
2020-10-15;IQ;Iraq;3587;65;416802;10086
2020-10-16;IQ;Iraq;3501;56;420303;10142
2020-10-17;IQ;Iraq;3221;56;423524;10198
2020-10-18;IQ;Iraq;3110;56;426634;10254
2020-10-19;IQ;Iraq;4044;63;430678;10317
2020-10-20;IQ;Iraq;3920;49;434598;10366
2020-10-21;IQ;Iraq;3667;52;438265;10418
2020-10-22;IQ;Iraq;3899;47;442164;10465
2020-10-23;IQ;Iraq;3785;48;445949;10513
2020-10-24;IQ;Iraq;3204;55;449153;10568
2020-10-25;IQ;Iraq;2554;55;451707;10623
2020-10-26;IQ;Iraq;3691;48;455398;10671
2020-10-27;IQ;Iraq;4510;53;459908;10724
2020-10-28;IQ;Iraq;4043;46;463951;10770
2020-10-29;IQ;Iraq;3804;45;467755;10815
2020-10-30;IQ;Iraq;2878;47;470633;10862
2020-10-31;IQ;Iraq;1997;48;472630;10910
2020-11-01;IQ;Iraq;2658;56;475288;10966
2020-11-02;IQ;Iraq;3413;51;478701;11017
2020-11-03;IQ;Iraq;3595;51;482296;11068
2020-11-04;IQ;Iraq;3574;60;485870;11128
2020-11-05;IQ;Iraq;3701;47;489571;11175
2020-11-06;IQ;Iraq;3568;69;493139;11244
2020-11-07;IQ;Iraq;2880;39;496019;11283
2020-11-08;IQ;Iraq;2530;44;498549;11327
2020-11-09;IQ;Iraq;3184;53;501733;11380
2020-11-10;IQ;Iraq;3577;52;505310;11432
2020-11-11;IQ;Iraq;3198;50;508508;11482
2020-11-12;IQ;Iraq;3298;50;511806;11532
2020-11-13;IQ;Iraq;2690;48;514496;11580
2020-11-14;IQ;Iraq;2419;43;516915;11623
2020-11-15;IQ;Iraq;2237;47;519152;11670
2020-11-16;IQ;Iraq;2390;42;521542;11712
2020-11-17;IQ;Iraq;2961;40;524503;11752
2020-11-18;IQ;Iraq;2349;43;526852;11795
2020-11-19;IQ;Iraq;2374;39;529226;11834
2020-11-20;IQ;Iraq;2543;49;531769;11883
2020-11-21;IQ;Iraq;1786;42;533555;11925
2020-11-22;IQ;Iraq;1766;33;535321;11958
2020-11-23;IQ;Iraq;2136;38;537457;11996
2020-11-24;IQ;Iraq;2292;35;539749;12031
2020-11-25;IQ;Iraq;2438;55;542187;12086
2020-11-26;IQ;Iraq;2483;39;544670;12125
2020-11-27;IQ;Iraq;2545;42;547215;12167
2020-11-28;IQ;Iraq;1606;33;548821;12200
2020-11-29;IQ;Iraq;1614;24;550435;12224
2020-11-30;IQ;Iraq;2114;34;552549;12258
2020-12-01;IQ;Iraq;2218;48;554767;12306
2020-12-02;IQ;Iraq;1961;34;556728;12340
2020-12-03;IQ;Iraq;2039;21;558767;12361
2020-12-04;IQ;Iraq;1855;26;560622;12387
2020-12-05;IQ;Iraq;1898;24;562520;12411
2020-12-06;IQ;Iraq;1680;21;564200;12432
2020-12-07;IQ;Iraq;1815;28;566015;12460
2020-12-08;IQ;Iraq;2123;17;568138;12477
2020-12-09;IQ;Iraq;1735;24;569873;12501
2020-12-10;IQ;Iraq;1380;25;571253;12526
2020-12-11;IQ;Iraq;1347;23;572600;12549
2020-12-12;IQ;Iraq;1022;16;573622;12565
2020-12-13;IQ;Iraq;1012;14;574634;12579
2020-12-14;IQ;Iraq;1338;24;575972;12603
2020-12-15;IQ;Iraq;1391;11;577363;12614
2020-12-16;IQ;Iraq;1553;22;578916;12636
2020-12-17;IQ;Iraq;1533;14;580449;12650
2020-12-18;IQ;Iraq;1362;20;581811;12670
2020-12-19;IQ;Iraq;1307;10;583118;12680
2020-12-20;IQ;Iraq;1027;17;584145;12697
2020-12-21;IQ;Iraq;1200;13;585345;12710
2020-12-22;IQ;Iraq;1158;15;586503;12725
2020-12-23;IQ;Iraq;1173;12;587676;12737
2020-12-24;IQ;Iraq;1127;7;588803;12744
2020-12-25;IQ;Iraq;1140;11;589943;12755
2020-12-26;IQ;Iraq;836;12;590779;12767
2020-12-27;IQ;Iraq;818;13;591597;12780
2020-12-28;IQ;Iraq;931;11;592528;12791
2020-12-29;IQ;Iraq;1013;9;593541;12800
2020-12-30;IQ;Iraq;901;8;594442;12808
2020-12-31;IQ;Iraq;849;5;595291;12813
2021-01-01;IQ;Iraq;902;11;596193;12824
2021-01-02;IQ;Iraq;840;5;597033;12829
2021-01-03;IQ;Iraq;741;5;597774;12834
2021-01-04;IQ;Iraq;595;10;598369;12844
2021-01-05;IQ;Iraq;757;12;599126;12856
2021-01-06;IQ;Iraq;839;9;599965;12865
2021-01-07;IQ;Iraq;790;4;600755;12869
2021-01-08;IQ;Iraq;669;8;601424;12877
2021-01-09;IQ;Iraq;907;4;602331;12881
2021-01-10;IQ;Iraq;607;14;602938;12895
2021-01-11;IQ;Iraq;801;11;603739;12906
2021-01-12;IQ;Iraq;810;5;604549;12911
2021-01-13;IQ;Iraq;867;4;605416;12915
2021-01-14;IQ;Iraq;770;7;606186;12922
2021-01-15;IQ;Iraq;805;10;606991;12932
2021-01-16;IQ;Iraq;596;3;607587;12935
2021-01-17;IQ;Iraq;645;9;608232;12944
2021-01-18;IQ;Iraq;797;9;609029;12953
2021-01-19;IQ;Iraq;823;9;609852;12962
2021-01-20;IQ;Iraq;746;6;610598;12968
2021-01-21;IQ;Iraq;809;9;611407;12977
2021-01-22;IQ;Iraq;685;7;612092;12984
2021-01-23;IQ;Iraq;778;4;612870;12988
2021-01-24;IQ;Iraq;893;5;613763;12993
2021-01-25;IQ;Iraq;813;7;614576;13000
2021-01-26;IQ;Iraq;804;10;615380;13010
2021-01-27;IQ;Iraq;879;8;616259;13018
2021-01-28;IQ;Iraq;943;6;617202;13024
2021-01-29;IQ;Iraq;945;12;618147;13036
2021-01-30;IQ;Iraq;775;5;618922;13041
2021-01-31;IQ;Iraq;714;6;619636;13047
2021-02-01;IQ;Iraq;984;10;620620;13057
2021-02-02;IQ;Iraq;1135;11;621755;13068
2021-02-03;IQ;Iraq;1317;11;623072;13079
2021-02-04;IQ;Iraq;1150;12;624222;13091
2021-02-05;IQ;Iraq;1534;12;625756;13103
2021-02-06;IQ;Iraq;1660;8;627416;13111
2021-02-07;IQ;Iraq;1134;9;628550;13120
2021-02-08;IQ;Iraq;1713;6;630263;13126
2021-02-09;IQ;Iraq;1994;8;632257;13134
2021-02-10;IQ;Iraq;2282;6;634539;13140
2021-02-11;IQ;Iraq;2369;4;636908;13144
2021-02-12;IQ;Iraq;2530;13;639438;13157
2021-02-13;IQ;Iraq;2190;7;641628;13164
2021-02-14;IQ;Iraq;2224;15;643852;13179
2021-02-15;IQ;Iraq;2798;6;646650;13185
2021-02-16;IQ;Iraq;3332;7;649982;13192
2021-02-17;IQ;Iraq;3575;12;653557;13204
2021-02-18;IQ;Iraq;3896;16;657453;13220
2021-02-19;IQ;Iraq;4024;12;661477;13232
2021-02-20;IQ;Iraq;3273;13;664750;13245
2021-02-21;IQ;Iraq;3187;27;667937;13272
2021-02-22;IQ;Iraq;3864;23;671801;13295
2021-02-23;IQ;Iraq;4181;16;675982;13311
2021-02-24;IQ;Iraq;4306;13;680288;13324
2021-02-25;IQ;Iraq;4074;27;684362;13351
2021-02-26;IQ;Iraq;4336;14;688698;13365
2021-02-27;IQ;Iraq;3543;18;692241;13383
2021-02-28;IQ;Iraq;3248;23;695489;13406
2021-03-01;IQ;Iraq;3599;22;699088;13428
2021-03-02;IQ;Iraq;4690;30;703778;13458
2021-03-03;IQ;Iraq;5173;25;708951;13483
2021-03-04;IQ;Iraq;5043;24;713994;13507
2021-03-05;IQ;Iraq;5127;30;719121;13537
2021-03-06;IQ;Iraq;4068;11;723189;13548
2021-03-07;IQ;Iraq;3359;24;726548;13572
2021-03-08;IQ;Iraq;4468;24;731016;13596
2021-03-09;IQ;Iraq;4610;22;735626;13618
2021-03-10;IQ;Iraq;4846;27;740472;13645
2021-03-11;IQ;Iraq;5170;26;745642;13671
2021-03-12;IQ;Iraq;4622;25;750264;13696
2021-03-13;IQ;Iraq;4054;23;754318;13719
2021-03-14;IQ;Iraq;3866;32;758184;13751
2021-03-15;IQ;Iraq;4901;37;763085;13788
2021-03-16;IQ;Iraq;5267;39;768352;13827
2021-03-17;IQ;Iraq;5663;33;774015;13860
2021-03-18;IQ;Iraq;5443;36;779458;13896
2021-03-19;IQ;Iraq;5258;41;784716;13937
2021-03-20;IQ;Iraq;4674;32;789390;13969
2021-03-21;IQ;Iraq;4502;38;793892;14007
2021-03-22;IQ;Iraq;4655;29;798547;14036
2021-03-23;IQ;Iraq;4494;30;803041;14066
2021-03-24;IQ;Iraq;6051;29;809092;14095
2021-03-25;IQ;Iraq;6513;33;815605;14128
2021-03-26;IQ;Iraq;6490;29;822095;14157
2021-03-27;IQ;Iraq;5062;20;827157;14177
2021-03-28;IQ;Iraq;5271;35;832428;14212
2021-03-29;IQ;Iraq;5837;37;838265;14249
2021-03-30;IQ;Iraq;5995;37;844260;14286
2021-03-31;IQ;Iraq;6664;37;850924;14323
2021-04-01;IQ;Iraq;6015;37;856939;14360
2021-04-02;IQ;Iraq;5882;30;862821;14390
2021-04-03;IQ;Iraq;5379;40;868200;14430
2021-04-04;IQ;Iraq;5368;33;873568;14463
2021-04-05;IQ;Iraq;6423;39;879991;14502
2021-04-06;IQ;Iraq;7300;33;887291;14535
2021-04-07;IQ;Iraq;8331;37;895622;14572
2021-04-08;IQ;Iraq;7817;34;903439;14606
2021-04-09;IQ;Iraq;7937;35;911376;14641
2021-04-10;IQ;Iraq;6779;37;918155;14678
2021-04-11;IQ;Iraq;6791;35;924946;14713
2021-04-12;IQ;Iraq;7953;44;932899;14757
2021-04-13;IQ;Iraq;8179;39;941078;14796
2021-04-14;IQ;Iraq;7972;40;949050;14836
2021-04-15;IQ;Iraq;7810;49;956860;14885
2021-04-16;IQ;Iraq;7575;30;964435;14915
2021-04-17;IQ;Iraq;6552;33;970987;14948
2021-04-18;IQ;Iraq;6188;33;977175;14981
2021-04-19;IQ;Iraq;7775;45;984950;15026
2021-04-20;IQ;Iraq;8208;34;993158;15060
2021-04-21;IQ;Iraq;8696;38;1001854;15098
2021-04-22;IQ;Iraq;8450;30;1010304;15128
2021-04-23;IQ;Iraq;8017;46;1018321;15174
2021-04-24;IQ;Iraq;6967;43;1025288;15217
2021-04-25;IQ;Iraq;6034;40;1031322;15257
2021-04-26;IQ;Iraq;6536;46;1037858;15303
2021-04-27;IQ;Iraq;7152;45;1045010;15348
2021-04-28;IQ;Iraq;6858;44;1051868;15392
2021-04-29;IQ;Iraq;6926;41;1058794;15433
2021-04-30;IQ;Iraq;6405;32;1065199;15465
2021-05-01;IQ;Iraq;5167;33;1070366;15498
2021-05-02;IQ;Iraq;4564;38;1074930;15536
2021-05-03;IQ;Iraq;5068;30;1079998;15566
2021-05-04;IQ;Iraq;6143;42;1086141;15608
2021-05-05;IQ;Iraq;5813;32;1091954;15640
2021-05-06;IQ;Iraq;6233;33;1098187;15673
2021-05-07;IQ;Iraq;5763;29;1103950;15702
2021-05-08;IQ;Iraq;4608;39;1108558;15741
2021-05-09;IQ;Iraq;4167;30;1112725;15771
2021-05-10;IQ;Iraq;4902;29;1117627;15800
2021-05-11;IQ;Iraq;5287;34;1122914;15834
2021-05-12;IQ;Iraq;4666;21;1127580;15855
2021-05-13;IQ;Iraq;4512;28;1132092;15883
2021-05-14;IQ;Iraq;2767;27;1134859;15910
2021-05-15;IQ;Iraq;2058;20;1136917;15930
2021-05-16;IQ;Iraq;2456;24;1139373;15954
2021-05-17;IQ;Iraq;3552;41;1142925;15995
2021-05-18;IQ;Iraq;4023;34;1146948;16029
2021-05-19;IQ;Iraq;4609;40;1151557;16069
2021-05-20;IQ;Iraq;4580;33;1156137;16102
2021-05-21;IQ;Iraq;4357;35;1160494;16137
2021-05-22;IQ;Iraq;3655;21;1164149;16158
2021-05-23;IQ;Iraq;3791;32;1167940;16190
2021-05-24;IQ;Iraq;4102;24;1172042;16214
2021-05-25;IQ;Iraq;4938;27;1176980;16241
2021-05-26;IQ;Iraq;4718;26;1181698;16267
2021-05-27;IQ;Iraq;4611;22;1186309;16289
2021-05-28;IQ;Iraq;4042;22;1190351;16311
2021-05-29;IQ;Iraq;3257;23;1193608;16334
2021-05-30;IQ;Iraq;3474;17;1197082;16351
2021-05-31;IQ;Iraq;4270;24;1201352;16375
2021-06-01;IQ;Iraq;4170;30;1205522;16405
2021-06-02;IQ;Iraq;4583;31;1210105;16436
2021-06-03;IQ;Iraq;4262;26;1214367;16462
2021-06-04;IQ;Iraq;4157;26;1218524;16488
2021-06-05;IQ;Iraq;3154;30;1221678;16518
2021-06-06;IQ;Iraq;3314;20;1224992;16538
2021-06-07;IQ;Iraq;4129;28;1229121;16566
2021-06-08;IQ;Iraq;4119;23;1233240;16589
2021-06-09;IQ;Iraq;4616;25;1237856;16614
2021-06-10;IQ;Iraq;4684;34;1242540;16648
2021-06-11;IQ;Iraq;4320;20;1246860;16668
2021-06-12;IQ;Iraq;3831;22;1250691;16690
2021-06-13;IQ;Iraq;3952;15;1254643;16705
2021-06-14;IQ;Iraq;5040;31;1259683;16736
2021-06-15;IQ;Iraq;4618;26;1264301;16762
2021-06-16;IQ;Iraq;5139;19;1269440;16781
2021-06-17;IQ;Iraq;5189;30;1274629;16811
2021-06-18;IQ;Iraq;5068;23;1279697;16834
2021-06-19;IQ;Iraq;3608;26;1283305;16860
2021-06-20;IQ;Iraq;4160;25;1287465;16885
2021-06-21;IQ;Iraq;5235;25;1292700;16910
2021-06-22;IQ;Iraq;6003;25;1298703;16935
2021-06-23;IQ;Iraq;6297;33;1305000;16968
2021-06-24;IQ;Iraq;6093;31;1311093;16999
2021-06-25;IQ;Iraq;5325;34;1316418;17033
2021-06-26;IQ;Iraq;4814;28;1321232;17061
2021-06-27;IQ;Iraq;4468;30;1325700;17091
2021-06-28;IQ;Iraq;6346;30;1332046;17121
2021-06-29;IQ;Iraq;6558;35;1338604;17156
2021-06-30;IQ;Iraq;7300;30;1345904;17186
2021-07-01;IQ;Iraq;7554;30;1353458;17216
2020-02-29;IE;Ireland;1;0;1;0
2020-03-01;IE;Ireland;0;0;1;0
2020-03-02;IE;Ireland;0;0;1;0
2020-03-03;IE;Ireland;1;0;2;0
2020-03-04;IE;Ireland;4;0;6;0
2020-03-05;IE;Ireland;0;0;6;0
2020-03-06;IE;Ireland;12;0;18;0
2020-03-07;IE;Ireland;0;0;18;0
2020-03-08;IE;Ireland;1;0;19;0
2020-03-09;IE;Ireland;2;0;21;0
2020-03-10;IE;Ireland;13;0;34;0
2020-03-11;IE;Ireland;9;1;43;1
2020-03-12;IE;Ireland;0;0;43;1
2020-03-13;IE;Ireland;47;0;90;1
2020-03-14;IE;Ireland;39;1;129;2
2020-03-15;IE;Ireland;0;0;129;2
2020-03-16;IE;Ireland;40;0;169;2
2020-03-17;IE;Ireland;54;0;223;2
2020-03-18;IE;Ireland;69;0;292;2
2020-03-19;IE;Ireland;265;1;557;3
2020-03-20;IE;Ireland;126;0;683;3
2020-03-21;IE;Ireland;102;0;785;3
2020-03-22;IE;Ireland;121;1;906;4
2020-03-23;IE;Ireland;219;2;1125;6
2020-03-24;IE;Ireland;204;1;1329;7
2020-03-25;IE;Ireland;235;2;1564;9
2020-03-26;IE;Ireland;255;10;1819;19
2020-03-27;IE;Ireland;302;3;2121;22
2020-03-28;IE;Ireland;294;14;2415;36
2020-03-29;IE;Ireland;200;10;2615;46
2020-03-30;IE;Ireland;295;8;2910;54
2020-03-31;IE;Ireland;325;17;3235;71
2020-04-01;IE;Ireland;212;14;3447;85
2020-04-02;IE;Ireland;402;13;3849;98
2020-04-03;IE;Ireland;424;22;4273;120
2020-04-04;IE;Ireland;331;17;4604;137
2020-04-05;IE;Ireland;390;21;4994;158
2020-04-06;IE;Ireland;370;16;5364;174
2020-04-07;IE;Ireland;345;36;5709;210
2020-04-08;IE;Ireland;365;25;6074;235
2020-04-09;IE;Ireland;500;28;6574;263
2020-04-10;IE;Ireland;1515;24;8089;287
2020-04-11;IE;Ireland;839;33;8928;320
2020-04-12;IE;Ireland;727;14;9655;334
2020-04-13;IE;Ireland;992;31;10647;365
2020-04-14;IE;Ireland;832;41;11479;406
2020-04-15;IE;Ireland;1068;38;12547;444
2020-04-16;IE;Ireland;724;42;13271;486
2020-04-17;IE;Ireland;709;44;13980;530
2020-04-18;IE;Ireland;778;41;14758;571
2020-04-19;IE;Ireland;493;39;15251;610
2020-04-20;IE;Ireland;401;77;15652;687
2020-04-21;IE;Ireland;388;43;16040;730
2020-04-22;IE;Ireland;631;39;16671;769
2020-04-23;IE;Ireland;936;25;17607;794
2020-04-24;IE;Ireland;577;220;18184;1014
2020-04-25;IE;Ireland;377;49;18561;1063
2020-04-26;IE;Ireland;701;24;19262;1087
2020-04-27;IE;Ireland;386;15;19648;1102
2020-04-28;IE;Ireland;229;57;19877;1159
2020-04-29;IE;Ireland;376;31;20253;1190
2020-04-30;IE;Ireland;359;42;20612;1232
2020-05-01;IE;Ireland;221;33;20833;1265
2020-05-02;IE;Ireland;343;21;21176;1286
2020-05-03;IE;Ireland;330;17;21506;1303
2020-05-04;IE;Ireland;266;16;21772;1319
2020-05-05;IE;Ireland;211;20;21983;1339
2020-05-06;IE;Ireland;265;36;22248;1375
2020-05-07;IE;Ireland;137;28;22385;1403
2020-05-08;IE;Ireland;156;26;22541;1429
2020-05-09;IE;Ireland;219;17;22760;1446
2020-05-10;IE;Ireland;236;12;22996;1458
2020-05-11;IE;Ireland;139;9;23135;1467
2020-05-12;IE;Ireland;107;21;23242;1488
2020-05-13;IE;Ireland;159;9;23401;1497
2020-05-14;IE;Ireland;426;9;23827;1506
2020-05-15;IE;Ireland;129;12;23956;1518
2020-05-16;IE;Ireland;92;15;24048;1533
2020-05-17;IE;Ireland;64;10;24112;1543
2020-05-18;IE;Ireland;88;4;24200;1547
2020-05-19;IE;Ireland;51;14;24251;1561
2020-05-20;IE;Ireland;64;10;24315;1571
2020-05-21;IE;Ireland;76;12;24391;1583
2020-05-22;IE;Ireland;115;9;24506;1592
2020-05-23;IE;Ireland;76;12;24582;1604
2020-05-24;IE;Ireland;57;4;24639;1608
2020-05-25;IE;Ireland;59;-2;24698;1606
2020-05-26;IE;Ireland;37;9;24735;1615
2020-05-27;IE;Ireland;68;16;24803;1631
2020-05-28;IE;Ireland;38;8;24841;1639
2020-05-29;IE;Ireland;35;6;24876;1645
2020-05-30;IE;Ireland;53;6;24929;1651
2020-05-31;IE;Ireland;61;1;24990;1652
2020-06-01;IE;Ireland;72;-2;25062;1650
2020-06-02;IE;Ireland;4;8;25066;1658
2020-06-03;IE;Ireland;45;1;25111;1659
2020-06-04;IE;Ireland;31;5;25142;1664
2020-06-05;IE;Ireland;21;6;25163;1670
2020-06-06;IE;Ireland;20;8;25183;1678
2020-06-07;IE;Ireland;18;1;25201;1679
2020-06-08;IE;Ireland;6;4;25207;1683
2020-06-09;IE;Ireland;8;8;25215;1691
2020-06-10;IE;Ireland;16;4;25231;1695
2020-06-11;IE;Ireland;7;8;25238;1703
2020-06-12;IE;Ireland;12;2;25250;1705
2020-06-13;IE;Ireland;45;0;25295;1705
2020-06-14;IE;Ireland;8;1;25303;1706
2020-06-15;IE;Ireland;18;0;25321;1706
2020-06-16;IE;Ireland;13;3;25334;1709
2020-06-17;IE;Ireland;7;1;25341;1710
2020-06-18;IE;Ireland;14;4;25355;1714
2020-06-19;IE;Ireland;13;0;25368;1714
2020-06-20;IE;Ireland;6;1;25374;1715
2020-06-21;IE;Ireland;5;0;25379;1715
2020-06-22;IE;Ireland;4;2;25383;1717
2020-06-23;IE;Ireland;8;3;25391;1720
2020-06-24;IE;Ireland;5;6;25396;1726
2020-06-25;IE;Ireland;9;1;25405;1727
2020-06-26;IE;Ireland;9;3;25414;1730
2020-06-27;IE;Ireland;23;4;25437;1734
2020-06-28;IE;Ireland;2;1;25439;1735
2020-06-29;IE;Ireland;23;0;25462;1735
2020-06-30;IE;Ireland;11;1;25473;1736
2020-07-01;IE;Ireland;4;2;25477;1738
2020-07-02;IE;Ireland;12;0;25489;1738
2020-07-03;IE;Ireland;9;2;25498;1740
2020-07-04;IE;Ireland;11;1;25509;1741
2020-07-05;IE;Ireland;18;0;25527;1741
2020-07-06;IE;Ireland;4;0;25531;1741
2020-07-07;IE;Ireland;7;1;25538;1742
2020-07-08;IE;Ireland;4;-4;25542;1738
2020-07-09;IE;Ireland;23;5;25565;1743
2020-07-10;IE;Ireland;24;1;25589;1744
2020-07-11;IE;Ireland;22;2;25611;1746
2020-07-12;IE;Ireland;17;0;25628;1746
2020-07-13;IE;Ireland;10;0;25638;1746
2020-07-14;IE;Ireland;32;0;25670;1746
2020-07-15;IE;Ireland;13;2;25683;1748
2020-07-16;IE;Ireland;15;1;25698;1749
2020-07-17;IE;Ireland;32;3;25730;1752
2020-07-18;IE;Ireland;20;1;25750;1753
2020-07-19;IE;Ireland;10;0;25760;1753
2020-07-20;IE;Ireland;6;0;25766;1753
2020-07-21;IE;Ireland;36;0;25802;1753
2020-07-22;IE;Ireland;17;1;25819;1754
2020-07-23;IE;Ireland;7;9;25826;1763
2020-07-24;IE;Ireland;19;0;25845;1763
2020-07-25;IE;Ireland;24;1;25869;1764
2020-07-26;IE;Ireland;12;0;25881;1764
2020-07-27;IE;Ireland;11;0;25892;1764
2020-07-28;IE;Ireland;37;0;25929;1764
2020-07-29;IE;Ireland;13;0;25942;1764
2020-07-30;IE;Ireland;85;-1;26027;1763
2020-07-31;IE;Ireland;38;0;26065;1763
2020-08-01;IE;Ireland;44;0;26109;1763
2020-08-02;IE;Ireland;53;0;26162;1763
2020-08-03;IE;Ireland;46;0;26208;1763
2020-08-04;IE;Ireland;45;0;26253;1763
2020-08-05;IE;Ireland;50;0;26303;1763
2020-08-06;IE;Ireland;69;5;26372;1768
2020-08-07;IE;Ireland;98;4;26470;1772
2020-08-08;IE;Ireland;174;0;26644;1772
2020-08-09;IE;Ireland;68;0;26712;1772
2020-08-10;IE;Ireland;56;0;26768;1772
2020-08-11;IE;Ireland;33;1;26801;1773
2020-08-12;IE;Ireland;37;1;26838;1774
2020-08-13;IE;Ireland;91;0;26929;1774
2020-08-14;IE;Ireland;66;0;26995;1774
2020-08-15;IE;Ireland;196;0;27191;1774
2020-08-16;IE;Ireland;66;0;27257;1774
2020-08-17;IE;Ireland;56;0;27313;1774
2020-08-18;IE;Ireland;186;1;27499;1775
2020-08-19;IE;Ireland;48;0;27547;1775
2020-08-20;IE;Ireland;129;1;27676;1776
2020-08-21;IE;Ireland;79;0;27755;1776
2020-08-22;IE;Ireland;153;1;27908;1777
2020-08-23;IE;Ireland;61;0;27969;1777
2020-08-24;IE;Ireland;147;0;28116;1777
2020-08-25;IE;Ireland;85;0;28201;1777
2020-08-26;IE;Ireland;162;0;28363;1777
2020-08-27;IE;Ireland;90;0;28453;1777
2020-08-28;IE;Ireland;125;0;28578;1777
2020-08-29;IE;Ireland;142;0;28720;1777
2020-08-30;IE;Ireland;40;0;28760;1777
2020-08-31;IE;Ireland;51;0;28811;1777
2020-09-01;IE;Ireland;214;0;29025;1777
2020-09-02;IE;Ireland;89;0;29114;1777
2020-09-03;IE;Ireland;92;0;29206;1777
2020-09-04;IE;Ireland;97;0;29303;1777
2020-09-05;IE;Ireland;231;0;29534;1777
2020-09-06;IE;Ireland;138;0;29672;1777
2020-09-07;IE;Ireland;102;0;29774;1777
2020-09-08;IE;Ireland;306;1;30080;1778
2020-09-09;IE;Ireland;84;3;30164;1781
2020-09-10;IE;Ireland;196;0;30360;1781
2020-09-11;IE;Ireland;211;0;30571;1781
2020-09-12;IE;Ireland;159;2;30730;1783
2020-09-13;IE;Ireland;255;1;30985;1784
2020-09-14;IE;Ireland;207;0;31192;1784
2020-09-15;IE;Ireland;357;3;31549;1787
2020-09-16;IE;Ireland;250;1;31799;1788
2020-09-17;IE;Ireland;224;1;32023;1789
2020-09-18;IE;Ireland;248;3;32271;1792
2020-09-19;IE;Ireland;267;0;32538;1792
2020-09-20;IE;Ireland;395;0;32933;1792
2020-09-21;IE;Ireland;188;0;33121;1792
2020-09-22;IE;Ireland;323;0;33444;1792
2020-09-23;IE;Ireland;231;2;33675;1794
2020-09-24;IE;Ireland;319;3;33994;1797
2020-09-25;IE;Ireland;321;0;34315;1797
2020-09-26;IE;Ireland;245;5;34560;1802
2020-09-27;IE;Ireland;430;0;34990;1802
2020-09-28;IE;Ireland;387;0;35377;1802
2020-09-29;IE;Ireland;363;1;35740;1803
2020-09-30;IE;Ireland;415;1;36155;1804
2020-10-01;IE;Ireland;442;2;36597;1806
2020-10-02;IE;Ireland;466;-5;37063;1801
2020-10-03;IE;Ireland;605;9;37668;1810
2020-10-04;IE;Ireland;364;0;38032;1810
2020-10-05;IE;Ireland;517;0;38549;1810
2020-10-06;IE;Ireland;424;1;38973;1811
2020-10-07;IE;Ireland;611;5;39584;1816
2020-10-08;IE;Ireland;502;1;40086;1817
2020-10-09;IE;Ireland;617;4;40703;1821
2020-10-10;IE;Ireland;1011;3;41714;1824
2020-10-11;IE;Ireland;814;2;42528;1826
2020-10-12;IE;Ireland;823;1;43351;1827
2020-10-13;IE;Ireland;808;3;44159;1830
2020-10-14;IE;Ireland;1084;5;45243;1835
2020-10-15;IE;Ireland;1186;3;46429;1838
2020-10-16;IE;Ireland;998;3;47427;1841
2020-10-17;IE;Ireland;1251;8;48678;1849
2020-10-18;IE;Ireland;1284;3;49962;1852
2020-10-19;IE;Ireland;1031;0;50993;1852
2020-10-20;IE;Ireland;1263;13;52256;1865
2020-10-21;IE;Ireland;1166;3;53422;1868
2020-10-22;IE;Ireland;1054;3;54476;1871
2020-10-23;IE;Ireland;785;7;55261;1878
2020-10-24;IE;Ireland;847;4;56108;1882
2020-10-25;IE;Ireland;1020;0;57128;1882
2020-10-26;IE;Ireland;939;3;58067;1885
2020-10-27;IE;Ireland;700;5;58767;1890
2020-10-28;IE;Ireland;667;6;59434;1896
2020-10-29;IE;Ireland;863;6;60297;1902
2020-10-30;IE;Ireland;762;6;61059;1908
2020-10-31;IE;Ireland;397;5;61456;1913
2020-11-01;IE;Ireland;546;2;62002;1915
2020-11-02;IE;Ireland;748;2;62750;1917
2020-11-03;IE;Ireland;298;5;63048;1922
2020-11-04;IE;Ireland;435;8;63483;1930
2020-11-05;IE;Ireland;563;3;64046;1933
2020-11-06;IE;Ireland;492;7;64538;1940
2020-11-07;IE;Ireland;317;5;64855;1945
2020-11-08;IE;Ireland;539;2;65394;1947
2020-11-09;IE;Ireland;265;1;65659;1948
2020-11-10;IE;Ireland;230;15;65889;1963
2020-11-11;IE;Ireland;358;2;66247;1965
2020-11-12;IE;Ireland;385;0;66632;1965
2020-11-13;IE;Ireland;467;7;67099;1972
2020-11-14;IE;Ireland;427;6;67526;1978
2020-11-15;IE;Ireland;377;1;67903;1979
2020-11-16;IE;Ireland;453;5;68356;1984
2020-11-17;IE;Ireland;330;11;68686;1995
2020-11-18;IE;Ireland;372;11;69058;2006
2020-11-19;IE;Ireland;415;4;69473;2010
2020-11-20;IE;Ireland;329;8;69802;2018
2020-11-21;IE;Ireland;341;4;70143;2022
2020-11-22;IE;Ireland;318;1;70461;2023
2020-11-23;IE;Ireland;250;0;70711;2023
2020-11-24;IE;Ireland;219;5;70930;2028
2020-11-25;IE;Ireland;257;5;71187;2033
2020-11-26;IE;Ireland;307;3;71494;2036
2020-11-27;IE;Ireland;205;7;71699;2043
2020-11-28;IE;Ireland;243;7;71942;2050
2020-11-29;IE;Ireland;299;2;72241;2052
2020-11-30;IE;Ireland;303;1;72544;2053
2020-12-01;IE;Ireland;254;16;72798;2069
2020-12-02;IE;Ireland;268;5;73066;2074
2020-12-03;IE;Ireland;162;6;73228;2080
2020-12-04;IE;Ireland;263;6;73491;2086
2020-12-05;IE;Ireland;457;13;73948;2099
2020-12-06;IE;Ireland;298;0;74246;2099
2020-12-07;IE;Ireland;222;0;74468;2099
2020-12-08;IE;Ireland;214;-2;74682;2097
2020-12-09;IE;Ireland;218;5;74900;2102
2020-12-10;IE;Ireland;303;15;75203;2117
2020-12-11;IE;Ireland;304;3;75507;2120
2020-12-12;IE;Ireland;249;3;75756;2123
2020-12-13;IE;Ireland;429;1;76185;2124
2020-12-14;IE;Ireland;264;2;76449;2126
2020-12-15;IE;Ireland;327;8;76776;2134
2020-12-16;IE;Ireland;421;6;77197;2140
2020-12-17;IE;Ireland;481;3;77678;2143
2020-12-18;IE;Ireland;576;6;78254;2149
2020-12-19;IE;Ireland;522;5;78776;2154
2020-12-20;IE;Ireland;766;4;79542;2158
2020-12-21;IE;Ireland;725;0;80267;2158
2020-12-22;IE;Ireland;961;13;81228;2171
2020-12-23;IE;Ireland;927;13;82155;2184
2020-12-24;IE;Ireland;918;8;83073;2192
2020-12-25;IE;Ireland;1025;2;84098;2194
2020-12-26;IE;Ireland;1296;6;85394;2200
2020-12-27;IE;Ireland;735;4;86129;2204
2020-12-28;IE;Ireland;765;1;86894;2205
2020-12-29;IE;Ireland;1545;8;88439;2213
2020-12-30;IE;Ireland;1718;13;90157;2226
2020-12-31;IE;Ireland;1622;11;91779;2237
2021-01-01;IE;Ireland;1753;11;93532;2248
2021-01-02;IE;Ireland;3394;4;96926;2252
2021-01-03;IE;Ireland;4961;7;101887;2259
2021-01-04;IE;Ireland;6110;6;107997;2265
2021-01-05;IE;Ireland;5325;17;113322;2282
2021-01-06;IE;Ireland;7832;17;121154;2299
2021-01-07;IE;Ireland;6503;8;127657;2307
2021-01-08;IE;Ireland;8227;20;135884;2327
2021-01-09;IE;Ireland;4843;9;140727;2336
2021-01-10;IE;Ireland;6886;8;147613;2344
2021-01-11;IE;Ireland;4926;8;152539;2352
2021-01-12;IE;Ireland;3052;45;155591;2397
2021-01-13;IE;Ireland;3553;63;159144;2460
2021-01-14;IE;Ireland;3913;28;163057;2488
2021-01-15;IE;Ireland;3491;48;166548;2536
2021-01-16;IE;Ireland;3232;59;169780;2595
2021-01-17;IE;Ireland;2946;13;172726;2608
2021-01-18;IE;Ireland;2117;8;174843;2616
2021-01-19;IE;Ireland;1996;92;176839;2708
2021-01-20;IE;Ireland;2485;60;179324;2768
2021-01-21;IE;Ireland;2598;50;181922;2818
2021-01-22;IE;Ireland;2357;52;184279;2870
2021-01-23;IE;Ireland;1905;77;186184;2947
2021-01-24;IE;Ireland;1370;23;187554;2970
2021-01-25;IE;Ireland;1369;7;188923;2977
2021-01-26;IE;Ireland;928;89;189851;3066
2021-01-27;IE;Ireland;1331;54;191182;3120
2021-01-28;IE;Ireland;1463;47;192645;3167
2021-01-29;IE;Ireland;1247;47;193892;3214
2021-01-30;IE;Ireland;1411;78;195303;3292
2021-01-31;IE;Ireland;1244;15;196547;3307
2021-02-01;IE;Ireland;1006;10;197553;3317
2021-02-02;IE;Ireland;871;101;198424;3418
2021-02-03;IE;Ireland;1006;94;199430;3512
2021-02-04;IE;Ireland;1314;74;200744;3586
2021-02-05;IE;Ireland;1019;35;201763;3621
2021-02-06;IE;Ireland;785;53;202548;3674
2021-02-07;IE;Ireland;1020;12;203568;3686
2021-02-08;IE;Ireland;829;1;204397;3687
2021-02-09;IE;Ireland;543;65;204940;3752
2021-02-10;IE;Ireland;999;42;205939;3794
2021-02-11;IE;Ireland;862;52;206801;3846
2021-02-12;IE;Ireland;919;19;207720;3865
2021-02-13;IE;Ireland;1076;66;208796;3931
2021-02-14;IE;Ireland;786;17;209582;3948
2021-02-15;IE;Ireland;820;0;210402;3948
2021-02-16;IE;Ireland;711;32;211113;3980
2021-02-17;IE;Ireland;638;56;211751;4036
2021-02-18;IE;Ireland;896;46;212647;4082
2021-02-19;IE;Ireland;753;27;213400;4109
2021-02-20;IE;Ireland;978;26;214378;4135
2021-02-21;IE;Ireland;679;1;215057;4136
2021-02-22;IE;Ireland;686;1;215743;4137
2021-02-23;IE;Ireland;557;44;216300;4181
2021-02-24;IE;Ireland;540;56;216840;4237
2021-02-25;IE;Ireland;638;34;217478;4271
2021-02-26;IE;Ireland;773;29;218251;4300
2021-02-27;IE;Ireland;729;13;218980;4313
2021-02-28;IE;Ireland;612;6;219592;4319
2021-03-01;IE;Ireland;681;0;220273;4319
2021-03-02;IE;Ireland;357;14;220630;4333
2021-03-03;IE;Ireland;559;24;221189;4357
2021-03-04;IE;Ireland;460;39;221649;4396
2021-03-05;IE;Ireland;520;9;222169;4405
2021-03-06;IE;Ireland;530;14;222699;4419
2021-03-07;IE;Ireland;520;3;223219;4422
2021-03-08;IE;Ireland;432;0;223651;4422
2021-03-09;IE;Ireland;306;30;223957;4452
2021-03-10;IE;Ireland;631;47;224588;4499
2021-03-11;IE;Ireland;591;10;225179;4509
2021-03-12;IE;Ireland;641;9;225820;4518
2021-03-13;IE;Ireland;538;16;226358;4534
2021-03-14;IE;Ireland;383;0;226741;4534
2021-03-15;IE;Ireland;575;0;227316;4534
2021-03-16;IE;Ireland;347;18;227663;4552
2021-03-17;IE;Ireland;552;14;228215;4566
2021-03-18;IE;Ireland;581;0;228796;4566
2021-03-19;IE;Ireland;510;10;229306;4576
2021-03-20;IE;Ireland;525;9;229831;4585
2021-03-21;IE;Ireland;768;2;230599;4587
2021-03-22;IE;Ireland;520;1;231119;4588
2021-03-23;IE;Ireland;365;22;231484;4610
2021-03-24;IE;Ireland;680;18;232164;4628
2021-03-25;IE;Ireland;594;3;232758;4631
2021-03-26;IE;Ireland;569;20;233327;4651
2021-03-27;IE;Ireland;610;2;233937;4653
2021-03-28;IE;Ireland;604;13;234541;4666
2021-03-29;IE;Ireland;537;1;235078;4667
2021-03-30;IE;Ireland;366;14;235444;4681
2021-03-31;IE;Ireland;410;6;235854;4687
2021-04-01;IE;Ireland;746;18;236600;4705
2021-04-02;IE;Ireland;587;8;237187;4713
2021-04-03;IE;Ireland;508;2;237695;4715
2021-04-04;IE;Ireland;453;3;238148;4718
2021-04-05;IE;Ireland;318;0;238466;4718
2021-04-06;IE;Ireland;441;9;238907;4727
2021-04-07;IE;Ireland;418;5;239325;4732
2021-04-08;IE;Ireland;398;5;239723;4737
2021-04-09;IE;Ireland;469;32;240192;4769
2021-04-10;IE;Ireland;451;14;240643;4783
2021-04-11;IE;Ireland;302;2;240945;4785
2021-04-12;IE;Ireland;385;0;241330;4785
2021-04-13;IE;Ireland;354;18;241684;4803
2021-04-14;IE;Ireland;421;9;242105;4812
2021-04-15;IE;Ireland;297;8;242402;4820
2021-04-16;IE;Ireland;417;11;242819;4831
2021-04-17;IE;Ireland;419;4;243238;4835
2021-04-18;IE;Ireland;270;1;243508;4836
2021-04-19;IE;Ireland;403;0;243911;4836
2021-04-20;IE;Ireland;386;11;244297;4847
2021-04-21;IE;Ireland;398;9;244695;4856
2021-04-22;IE;Ireland;615;10;245310;4866
2021-04-23;IE;Ireland;433;1;245743;4867
2021-04-24;IE;Ireland;461;5;246204;4872
2021-04-25;IE;Ireland;429;1;246633;4873
2021-04-26;IE;Ireland;436;1;247069;4874
2021-04-27;IE;Ireland;420;10;247489;4884
2021-04-28;IE;Ireland;368;12;247857;4896
2021-04-29;IE;Ireland;469;3;248326;4899
2021-04-30;IE;Ireland;544;4;248870;4903
2021-05-01;IE;Ireland;567;3;249437;4906
2021-05-02;IE;Ireland;401;0;249838;4906
2021-05-03;IE;Ireland;452;0;250290;4906
2021-05-04;IE;Ireland;382;2;250672;4908
2021-05-05;IE;Ireland;415;7;251087;4915
2021-05-06;IE;Ireland;387;6;251474;4921
2021-05-07;IE;Ireland;430;-3;251904;4918
2021-05-08;IE;Ireland;399;1;252303;4919
2021-05-09;IE;Ireland;506;2;252809;4921
2021-05-10;IE;Ireland;380;0;253189;4921
2021-05-11;IE;Ireland;378;8;253567;4929
2021-05-12;IE;Ireland;446;8;254013;4937
2021-05-13;IE;Ireland;437;0;254450;4937
2021-05-14;IE;Ireland;420;4;254870;4941
2021-05-15;IE;Ireland;461;0;255331;4941
2021-05-16;IE;Ireland;375;0;255706;4941
2021-05-17;IE;Ireland;379;0;256085;4941
2021-05-18;IE;Ireland;365;0;256450;4941
2021-05-19;IE;Ireland;526;0;256976;4941
2021-05-20;IE;Ireland;470;0;257446;4941
2021-05-21;IE;Ireland;533;0;257979;4941
2021-05-22;IE;Ireland;384;0;258363;4941
2021-05-23;IE;Ireland;447;0;258810;4941
2021-05-24;IE;Ireland;349;0;259159;4941
2021-05-25;IE;Ireland;353;0;259512;4941
2021-05-26;IE;Ireland;445;0;259957;4941
2021-05-27;IE;Ireland;432;0;260389;4941
2021-05-28;IE;Ireland;461;0;260850;4941
2021-05-29;IE;Ireland;456;0;261306;4941
2021-05-30;IE;Ireland;367;0;261673;4941
2021-05-31;IE;Ireland;370;0;262043;4941
2021-06-01;IE;Ireland;337;0;262380;4941
2021-06-02;IE;Ireland;407;0;262787;4941
2021-06-03;IE;Ireland;465;0;263252;4941
2021-06-04;IE;Ireland;517;0;263769;4941
2021-06-05;IE;Ireland;416;0;264185;4941
2021-06-06;IE;Ireland;313;0;264498;4941
2021-06-07;IE;Ireland;377;0;264875;4941
2021-06-08;IE;Ireland;239;0;265114;4941
2021-06-09;IE;Ireland;227;0;265341;4941
2021-06-10;IE;Ireland;398;0;265739;4941
2021-06-11;IE;Ireland;319;0;266058;4941
2021-06-12;IE;Ireland;431;0;266489;4941
2021-06-13;IE;Ireland;315;0;266804;4941
2021-06-14;IE;Ireland;202;0;267006;4941
2021-06-15;IE;Ireland;283;0;267289;4941
2021-06-16;IE;Ireland;287;0;267576;4941
2021-06-17;IE;Ireland;373;38;267949;4979
2021-06-18;IE;Ireland;302;0;268251;4979
2021-06-19;IE;Ireland;393;0;268644;4979
2021-06-20;IE;Ireland;393;0;269037;4979
2021-06-21;IE;Ireland;284;0;269321;4979
2021-06-22;IE;Ireland;174;0;269495;4979
2021-06-23;IE;Ireland;298;10;269793;4989
2021-06-24;IE;Ireland;304;0;270097;4989
2021-06-25;IE;Ireland;380;0;270477;4989
2021-06-26;IE;Ireland;443;0;270920;4989
2021-06-27;IE;Ireland;340;0;271260;4989
2021-06-28;IE;Ireland;329;0;271589;4989
2021-06-29;IE;Ireland;342;0;271931;4989
2021-06-30;IE;Ireland;-23;9;271908;4998
2021-07-01;IE;Ireland;876;2;272784;5000
2021-01-21;IM;Isle of Man;0;0;0;0
2021-01-22;IM;Isle of Man;0;0;0;0
2021-01-23;IM;Isle of Man;0;0;0;0
2021-01-24;IM;Isle of Man;0;0;0;0
2021-01-25;IM;Isle of Man;0;0;0;0
2021-01-26;IM;Isle of Man;0;0;0;0
2021-01-27;IM;Isle of Man;0;0;0;0
2021-01-28;IM;Isle of Man;0;0;0;0
2021-01-29;IM;Isle of Man;0;0;0;0
2021-01-30;IM;Isle of Man;0;0;0;0
2021-01-31;IM;Isle of Man;0;0;0;0
2021-02-01;IM;Isle of Man;0;0;0;0
2021-02-02;IM;Isle of Man;0;0;0;0
2021-02-03;IM;Isle of Man;0;0;0;0
2021-02-04;IM;Isle of Man;0;0;0;0
2021-02-05;IM;Isle of Man;0;0;0;0
2021-02-06;IM;Isle of Man;0;0;0;0
2021-02-07;IM;Isle of Man;0;0;0;0
2021-02-08;IM;Isle of Man;0;0;0;0
2021-02-09;IM;Isle of Man;0;0;0;0
2021-02-10;IM;Isle of Man;0;0;0;0
2021-02-11;IM;Isle of Man;0;0;0;0
2021-02-12;IM;Isle of Man;0;0;0;0
2021-02-13;IM;Isle of Man;0;0;0;0
2021-02-14;IM;Isle of Man;0;0;0;0
2021-02-15;IM;Isle of Man;0;0;0;0
2021-02-16;IM;Isle of Man;0;0;0;0
2021-02-17;IM;Isle of Man;0;0;0;0
2021-02-18;IM;Isle of Man;0;0;0;0
2021-02-19;IM;Isle of Man;0;0;0;0
2021-02-20;IM;Isle of Man;0;0;0;0
2021-02-21;IM;Isle of Man;0;0;0;0
2021-02-22;IM;Isle of Man;0;0;0;0
2021-02-23;IM;Isle of Man;0;0;0;0
2021-02-24;IM;Isle of Man;0;0;0;0
2021-02-25;IM;Isle of Man;0;0;0;0
2021-02-26;IM;Isle of Man;0;0;0;0
2021-02-27;IM;Isle of Man;0;0;0;0
2021-02-28;IM;Isle of Man;0;0;0;0
2021-03-01;IM;Isle of Man;0;0;0;0
2021-03-02;IM;Isle of Man;0;0;0;0
2021-03-03;IM;Isle of Man;0;0;0;0
2021-03-04;IM;Isle of Man;0;0;0;0
2021-03-05;IM;Isle of Man;0;0;0;0
2021-03-06;IM;Isle of Man;0;0;0;0
2021-03-07;IM;Isle of Man;0;0;0;0
2021-03-08;IM;Isle of Man;0;0;0;0
2021-03-09;IM;Isle of Man;0;0;0;0
2021-03-10;IM;Isle of Man;0;0;0;0
2021-03-11;IM;Isle of Man;0;0;0;0
2021-03-12;IM;Isle of Man;0;0;0;0
2021-03-13;IM;Isle of Man;0;0;0;0
2021-03-14;IM;Isle of Man;0;0;0;0
2021-03-15;IM;Isle of Man;0;0;0;0
2021-03-16;IM;Isle of Man;0;0;0;0
2021-03-17;IM;Isle of Man;0;0;0;0
2021-03-18;IM;Isle of Man;0;0;0;0
2021-03-19;IM;Isle of Man;0;0;0;0
2021-03-20;IM;Isle of Man;0;0;0;0
2021-03-21;IM;Isle of Man;0;0;0;0
2021-03-22;IM;Isle of Man;0;0;0;0
2021-03-23;IM;Isle of Man;0;0;0;0
2021-03-24;IM;Isle of Man;0;0;0;0
2021-03-25;IM;Isle of Man;0;0;0;0
2021-03-26;IM;Isle of Man;0;0;0;0
2021-03-27;IM;Isle of Man;0;0;0;0
2021-03-28;IM;Isle of Man;0;0;0;0
2021-03-29;IM;Isle of Man;0;0;0;0
2021-03-30;IM;Isle of Man;0;0;0;0
2021-03-31;IM;Isle of Man;0;0;0;0
2021-04-01;IM;Isle of Man;0;0;0;0
2021-04-02;IM;Isle of Man;0;0;0;0
2021-04-03;IM;Isle of Man;0;0;0;0
2021-04-04;IM;Isle of Man;0;0;0;0
2021-04-05;IM;Isle of Man;0;0;0;0
2021-04-06;IM;Isle of Man;0;0;0;0
2021-04-07;IM;Isle of Man;0;0;0;0
2021-04-08;IM;Isle of Man;0;0;0;0
2021-04-09;IM;Isle of Man;0;0;0;0
2021-04-10;IM;Isle of Man;0;0;0;0
2021-04-11;IM;Isle of Man;0;0;0;0
2021-04-12;IM;Isle of Man;0;0;0;0
2021-04-13;IM;Isle of Man;0;0;0;0
2021-04-14;IM;Isle of Man;0;0;0;0
2021-04-15;IM;Isle of Man;0;0;0;0
2021-04-16;IM;Isle of Man;0;0;0;0
2021-04-17;IM;Isle of Man;0;0;0;0
2021-04-18;IM;Isle of Man;0;0;0;0
2021-04-19;IM;Isle of Man;0;0;0;0
2021-04-20;IM;Isle of Man;0;0;0;0
2021-04-21;IM;Isle of Man;0;0;0;0
2021-04-22;IM;Isle of Man;0;0;0;0
2021-04-23;IM;Isle of Man;0;0;0;0
2021-04-24;IM;Isle of Man;0;0;0;0
2021-04-25;IM;Isle of Man;0;0;0;0
2021-04-26;IM;Isle of Man;0;0;0;0
2021-04-27;IM;Isle of Man;0;0;0;0
2021-04-28;IM;Isle of Man;0;0;0;0
2021-04-29;IM;Isle of Man;0;0;0;0
2021-04-30;IM;Isle of Man;0;0;0;0
2021-05-01;IM;Isle of Man;0;0;0;0
2021-05-02;IM;Isle of Man;0;0;0;0
2021-05-03;IM;Isle of Man;0;0;0;0
2021-05-04;IM;Isle of Man;0;0;0;0
2021-05-05;IM;Isle of Man;0;0;0;0
2021-05-06;IM;Isle of Man;0;0;0;0
2021-05-07;IM;Isle of Man;0;0;0;0
2021-05-08;IM;Isle of Man;0;0;0;0
2021-05-09;IM;Isle of Man;0;0;0;0
2021-05-10;IM;Isle of Man;0;0;0;0
2021-05-11;IM;Isle of Man;0;0;0;0
2021-05-12;IM;Isle of Man;0;0;0;0
2021-05-13;IM;Isle of Man;0;0;0;0
2021-05-14;IM;Isle of Man;0;0;0;0
2021-05-15;IM;Isle of Man;0;0;0;0
2021-05-16;IM;Isle of Man;0;0;0;0
2021-05-17;IM;Isle of Man;0;0;0;0
2021-05-18;IM;Isle of Man;0;0;0;0
2021-05-19;IM;Isle of Man;0;0;0;0
2021-05-20;IM;Isle of Man;0;0;0;0
2021-05-21;IM;Isle of Man;0;0;0;0
2021-05-22;IM;Isle of Man;0;0;0;0
2021-05-23;IM;Isle of Man;0;0;0;0
2021-05-24;IM;Isle of Man;0;0;0;0
2021-05-25;IM;Isle of Man;0;0;0;0
2021-05-26;IM;Isle of Man;0;0;0;0
2021-05-27;IM;Isle of Man;0;0;0;0
2021-05-28;IM;Isle of Man;0;0;0;0
2021-05-29;IM;Isle of Man;0;0;0;0
2021-05-30;IM;Isle of Man;0;0;0;0
2021-05-31;IM;Isle of Man;0;0;0;0
2021-06-01;IM;Isle of Man;0;0;0;0
2021-06-02;IM;Isle of Man;0;0;0;0
2021-06-03;IM;Isle of Man;0;0;0;0
2021-06-04;IM;Isle of Man;0;0;0;0
2021-06-05;IM;Isle of Man;0;0;0;0
2021-06-06;IM;Isle of Man;0;0;0;0
2021-06-07;IM;Isle of Man;0;0;0;0
2021-06-08;IM;Isle of Man;0;0;0;0
2021-06-09;IM;Isle of Man;0;0;0;0
2021-06-10;IM;Isle of Man;0;0;0;0
2021-06-11;IM;Isle of Man;0;0;0;0
2021-06-12;IM;Isle of Man;0;0;0;0
2021-06-13;IM;Isle of Man;0;0;0;0
2021-06-14;IM;Isle of Man;0;0;0;0
2021-06-15;IM;Isle of Man;0;0;0;0
2021-06-16;IM;Isle of Man;0;0;0;0
2021-06-17;IM;Isle of Man;0;0;0;0
2021-06-18;IM;Isle of Man;0;0;0;0
2021-06-19;IM;Isle of Man;0;0;0;0
2021-06-20;IM;Isle of Man;0;0;0;0
2021-06-21;IM;Isle of Man;0;0;0;0
2021-06-22;IM;Isle of Man;0;0;0;0
2021-06-23;IM;Isle of Man;0;0;0;0
2021-06-24;IM;Isle of Man;0;0;0;0
2021-06-25;IM;Isle of Man;0;0;0;0
2021-06-26;IM;Isle of Man;0;0;0;0
2021-06-27;IM;Isle of Man;0;0;0;0
2021-06-28;IM;Isle of Man;0;0;0;0
2021-06-29;IM;Isle of Man;0;0;0;0
2021-06-30;IM;Isle of Man;0;0;0;0
2021-07-01;IM;Isle of Man;0;0;0;0
2020-02-20;IL;Israel;0;0;0;0
2020-02-21;IL;Israel;1;0;1;0
2020-02-22;IL;Israel;0;0;1;0
2020-02-23;IL;Israel;0;0;1;0
2020-02-24;IL;Israel;0;0;1;0
2020-02-25;IL;Israel;0;0;1;0
2020-02-26;IL;Israel;1;0;2;0
2020-02-27;IL;Israel;1;0;3;0
2020-02-28;IL;Israel;3;0;6;0
2020-02-29;IL;Israel;0;0;6;0
2020-03-01;IL;Israel;1;0;7;0
2020-03-02;IL;Israel;5;0;12;0
2020-03-03;IL;Israel;3;0;15;0
2020-03-04;IL;Israel;0;0;15;0
2020-03-05;IL;Israel;6;0;21;0
2020-03-06;IL;Israel;16;0;37;0
2020-03-07;IL;Israel;10;0;47;0
2020-03-08;IL;Israel;9;0;56;0
2020-03-09;IL;Israel;4;0;60;0
2020-03-10;IL;Israel;28;0;88;0
2020-03-11;IL;Israel;-28;0;60;0
2020-03-12;IL;Israel;21;0;81;0
2020-03-13;IL;Israel;31;0;112;0
2020-03-14;IL;Israel;26;0;138;0
2020-03-15;IL;Israel;39;0;177;0
2020-03-16;IL;Israel;74;0;251;0
2020-03-17;IL;Israel;44;0;295;0
2020-03-18;IL;Israel;76;0;371;0
2020-03-19;IL;Israel;15;0;386;0
2020-03-20;IL;Israel;242;1;628;1
2020-03-21;IL;Israel;215;0;843;1
2020-03-22;IL;Israel;237;0;1080;1
2020-03-23;IL;Israel;169;0;1249;1
2020-03-24;IL;Israel;102;3;1351;4
2020-03-25;IL;Israel;1117;1;2468;5
2020-03-26;IL;Israel;520;5;2988;10
2020-03-27;IL;Israel;433;2;3421;12
2020-03-28;IL;Israel;480;1;3901;13
2020-03-29;IL;Israel;532;3;4433;16
2020-03-30;IL;Israel;546;1;4979;17
2020-03-31;IL;Israel;738;4;5717;21
2020-04-01;IL;Israel;696;8;6413;29
2020-04-02;IL;Israel;719;9;7132;38
2020-04-03;IL;Israel;597;5;7729;43
2020-04-04;IL;Israel;428;6;8157;49
2020-04-05;IL;Israel;583;7;8740;56
2020-04-06;IL;Israel;451;8;9191;64
2020-04-07;IL;Israel;377;8;9568;72
2020-04-08;IL;Israel;338;8;9906;80
2020-04-09;IL;Israel;343;9;10249;89
2020-04-10;IL;Israel;358;8;10607;97
2020-04-11;IL;Israel;345;6;10952;103
2020-04-12;IL;Israel;552;6;11504;109
2020-04-13;IL;Israel;438;9;11942;118
2020-04-14;IL;Israel;399;8;12341;126
2020-04-15;IL;Israel;311;13;12652;139
2020-04-16;IL;Israel;296;7;12948;146
2020-04-17;IL;Israel;298;9;13246;155
2020-04-18;IL;Israel;291;11;13537;166
2020-04-19;IL;Israel;276;8;13813;174
2020-04-20;IL;Israel;299;6;14112;180
2020-04-21;IL;Israel;282;9;14394;189
2020-04-22;IL;Israel;225;3;14619;192
2020-04-23;IL;Israel;276;4;14895;196
2020-04-24;IL;Israel;248;3;15143;199
2020-04-25;IL;Israel;159;3;15302;202
2020-04-26;IL;Israel;83;2;15385;204
2020-04-27;IL;Israel;128;4;15513;208
2020-04-28;IL;Israel;159;5;15672;213
2020-04-29;IL;Israel;82;6;15754;219
2020-04-30;IL;Israel;142;6;15896;225
2020-05-01;IL;Israel;116;4;16012;229
2020-05-02;IL;Israel;57;3;16069;232
2020-05-03;IL;Israel;27;3;16096;235
2020-05-04;IL;Israel;53;3;16149;238
2020-05-05;IL;Israel;32;2;16181;240
2020-05-06;IL;Israel;65;1;16246;241
2020-05-07;IL;Israel;61;1;16307;242
2020-05-08;IL;Israel;33;6;16340;248
2020-05-09;IL;Israel;19;3;16359;251
2020-05-10;IL;Israel;29;4;16388;255
2020-05-11;IL;Israel;39;5;16427;260
2020-05-12;IL;Israel;23;3;16450;263
2020-05-13;IL;Israel;39;3;16489;266
2020-05-14;IL;Israel;22;2;16511;268
2020-05-15;IL;Israel;12;0;16523;268
2020-05-16;IL;Israel;5;3;16528;271
2020-05-17;IL;Israel;15;4;16543;275
2020-05-18;IL;Israel;27;3;16570;278
2020-05-19;IL;Israel;22;2;16592;280
2020-05-20;IL;Israel;15;1;16607;281
2020-05-21;IL;Israel;17;0;16624;281
2020-05-22;IL;Israel;19;0;16643;281
2020-05-23;IL;Israel;5;0;16648;281
2020-05-24;IL;Israel;13;1;16661;282
2020-05-25;IL;Israel;22;2;16683;284
2020-05-26;IL;Israel;50;0;16733;284
2020-05-27;IL;Israel;40;2;16773;286
2020-05-28;IL;Israel;77;1;16850;287
2020-05-29;IL;Israel;113;0;16963;287
2020-05-30;IL;Israel;29;0;16992;287
2020-05-31;IL;Israel;87;0;17079;287
2020-06-01;IL;Israel;100;3;17179;290
2020-06-02;IL;Israel;121;2;17300;292
2020-06-03;IL;Israel;97;1;17397;293
2020-06-04;IL;Israel;142;0;17539;293
2020-06-05;IL;Israel;127;1;17666;294
2020-06-06;IL;Israel;78;4;17744;298
2020-06-07;IL;Israel;140;2;17884;300
2020-06-08;IL;Israel;179;0;18063;300
2020-06-09;IL;Israel;173;1;18236;301
2020-06-10;IL;Israel;240;1;18476;302
2020-06-11;IL;Israel;191;0;18667;302
2020-06-12;IL;Israel;184;0;18851;302
2020-06-13;IL;Israel;149;1;19000;303
2020-06-14;IL;Israel;136;2;19136;305
2020-06-15;IL;Israel;198;0;19334;305
2020-06-16;IL;Israel;300;1;19634;306
2020-06-17;IL;Israel;271;0;19905;306
2020-06-18;IL;Israel;302;0;20207;306
2020-06-19;IL;Israel;310;1;20517;307
2020-06-20;IL;Israel;159;1;20676;308
2020-06-21;IL;Israel;173;0;20849;308
2020-06-22;IL;Israel;345;1;21194;309
2020-06-23;IL;Israel;451;2;21645;311
2020-06-24;IL;Israel;487;3;22132;314
2020-06-25;IL;Israel;516;4;22648;318
2020-06-26;IL;Israel;464;3;23112;321
2020-06-27;IL;Israel;398;3;23510;324
2020-06-28;IL;Israel;385;2;23895;326
2020-06-29;IL;Israel;757;0;24652;326
2020-06-30;IL;Israel;786;1;25438;327
2020-07-01;IL;Israel;972;3;26410;330
2020-07-02;IL;Israel;1146;1;27556;331
2020-07-03;IL;Israel;939;3;28495;334
2020-07-04;IL;Israel;821;5;29316;339
2020-07-05;IL;Israel;831;2;30147;341
2020-07-06;IL;Israel;1134;8;31281;349
2020-07-07;IL;Israel;1390;5;32671;354
2020-07-08;IL;Israel;1327;5;33998;359
2020-07-09;IL;Israel;1525;5;35523;364
2020-07-10;IL;Israel;1409;4;36932;368
2020-07-11;IL;Israel;1168;5;38100;373
2020-07-12;IL;Israel;1238;7;39338;380
2020-07-13;IL;Israel;1720;4;41058;384
2020-07-14;IL;Israel;1604;7;42662;391
2020-07-15;IL;Israel;1877;6;44539;397
2020-07-16;IL;Israel;1939;9;46478;406
2020-07-17;IL;Israel;1605;12;48083;418
2020-07-18;IL;Israel;1448;8;49531;426
2020-07-19;IL;Israel;1016;10;50547;436
2020-07-20;IL;Israel;1887;12;52434;448
2020-07-21;IL;Israel;2006;9;54440;457
2020-07-22;IL;Israel;2044;6;56484;463
2020-07-23;IL;Israel;1990;16;58474;479
2020-07-24;IL;Israel;1830;8;60304;487
2020-07-25;IL;Israel;1112;7;61416;494
2020-07-26;IL;Israel;1042;11;62458;505
2020-07-27;IL;Israel;2048;7;64506;512
2020-07-28;IL;Israel;2125;8;66631;520
2020-07-29;IL;Israel;1954;15;68585;535
2020-07-30;IL;Israel;1787;15;70372;550
2020-07-31;IL;Israel;1362;14;71734;564
2020-08-01;IL;Israel;625;14;72359;578
2020-08-02;IL;Israel;708;11;73067;589
2020-08-03;IL;Israel;1800;15;74867;604
2020-08-04;IL;Israel;1729;11;76596;615
2020-08-05;IL;Israel;1690;10;78286;625
2020-08-06;IL;Israel;1677;9;79963;634
2020-08-07;IL;Israel;1764;12;81727;646
2020-08-08;IL;Israel;754;13;82481;659
2020-08-09;IL;Israel;924;7;83405;666
2020-08-10;IL;Israel;1704;15;85109;681
2020-08-11;IL;Israel;1823;11;86932;692
2020-08-12;IL;Israel;1622;15;88554;707
2020-08-13;IL;Israel;1643;16;90197;723
2020-08-14;IL;Israel;1388;12;91585;735
2020-08-15;IL;Israel;757;10;92342;745
2020-08-16;IL;Israel;1068;19;93410;764
2020-08-17;IL;Israel;1650;4;95060;768
2020-08-18;IL;Israel;1649;14;96709;782
2020-08-19;IL;Israel;1640;12;98349;794
2020-08-20;IL;Israel;1487;12;99836;806
2020-08-21;IL;Israel;1493;13;101329;819
2020-08-22;IL;Israel;711;10;102040;829
2020-08-23;IL;Israel;965;13;103005;842
2020-08-24;IL;Israel;1900;16;104905;858
2020-08-25;IL;Israel;1956;19;106861;877
2020-08-26;IL;Israel;1953;11;108814;888
2020-08-27;IL;Israel;2071;11;110885;899
2020-08-28;IL;Israel;1832;12;112717;911
2020-08-29;IL;Israel;910;5;113627;916
2020-08-30;IL;Israel;1101;14;114728;930
2020-08-31;IL;Israel;2178;23;116906;953
2020-09-01;IL;Israel;2252;15;119158;968
2020-09-02;IL;Israel;3193;14;122351;982
2020-09-03;IL;Israel;2661;16;125012;998
2020-09-04;IL;Israel;2623;12;127635;1010
2020-09-05;IL;Israel;1505;15;129140;1025
2020-09-06;IL;Israel;2177;12;131317;1037
2020-09-07;IL;Israel;3388;17;134705;1054
2020-09-08;IL;Israel;3489;20;138194;1074
2020-09-09;IL;Israel;3996;15;142190;1089
2020-09-10;IL;Israel;4161;14;146351;1103
2020-09-11;IL;Israel;3975;20;150326;1123
2020-09-12;IL;Israel;2719;15;153045;1138
2020-09-13;IL;Israel;3175;17;156220;1155
2020-09-14;IL;Israel;4805;20;161025;1175
2020-09-15;IL;Israel;5539;16;166564;1191
2020-09-16;IL;Israel;4574;26;171138;1217
2020-09-17;IL;Israel;5385;18;176523;1235
2020-09-18;IL;Israel;5340;20;181863;1255
2020-09-19;IL;Israel;3809;27;185672;1282
2020-09-20;IL;Israel;2579;21;188251;1303
2020-09-21;IL;Israel;3866;31;192117;1334
2020-09-22;IL;Israel;7021;26;199138;1360
2020-09-23;IL;Israel;7125;25;206263;1385
2020-09-24;IL;Israel;8234;31;214497;1416
2020-09-25;IL;Israel;8390;30;222887;1446
2020-09-26;IL;Israel;5882;25;228769;1471
2020-09-27;IL;Israel;3414;32;232183;1503
2020-09-28;IL;Israel;1159;29;233342;1532
2020-09-29;IL;Israel;4991;35;238333;1567
2020-09-30;IL;Israel;9078;37;247411;1604
2020-10-01;IL;Israel;7731;46;255142;1650
2020-10-02;IL;Israel;7058;25;262200;1675
2020-10-03;IL;Israel;2593;37;264793;1712
2020-10-04;IL;Israel;2937;36;267730;1748
2020-10-05;IL;Israel;5721;27;273451;1775
2020-10-06;IL;Israel;4724;45;278175;1820
2020-10-07;IL;Israel;4165;26;282340;1846
2020-10-08;IL;Israel;3755;47;286095;1893
2020-10-09;IL;Israel;2963;40;289058;1933
2020-10-10;IL;Israel;916;35;289974;1968
2020-10-11;IL;Israel;1646;46;291620;2014
2020-10-12;IL;Israel;3169;30;294789;2044
2020-10-13;IL;Israel;2336;38;297125;2082
2020-10-14;IL;Israel;2117;35;299242;2117
2020-10-15;IL;Israel;1612;31;300854;2148
2020-10-16;IL;Israel;1500;34;302354;2182
2020-10-17;IL;Israel;411;32;302765;2214
2020-10-18;IL;Israel;922;33;303687;2247
2020-10-19;IL;Israel;1517;31;305204;2278
2020-10-20;IL;Israel;1193;20;306397;2298
2020-10-21;IL;Israel;1172;25;307569;2323
2020-10-22;IL;Israel;1032;29;308601;2352
2020-10-23;IL;Israel;849;26;309450;2378
2020-10-24;IL;Israel;246;27;309696;2405
2020-10-25;IL;Israel;607;35;310303;2440
2020-10-26;IL;Israel;884;28;311187;2468
2020-10-27;IL;Israel;887;28;312074;2496
2020-10-28;IL;Israel;723;10;312797;2506
2020-10-29;IL;Israel;644;19;313441;2525
2020-10-30;IL;Israel;680;11;314121;2536
2020-10-31;IL;Israel;228;25;314349;2561
2020-11-01;IL;Israel;658;19;315007;2580
2020-11-02;IL;Israel;788;16;315795;2596
2020-11-03;IL;Israel;846;26;316641;2622
2020-11-04;IL;Israel;769;17;317410;2639
2020-11-05;IL;Israel;570;13;317980;2652
2020-11-06;IL;Israel;691;16;318671;2668
2020-11-07;IL;Israel;212;8;318883;2676
2020-11-08;IL;Israel;534;7;319417;2683
2020-11-09;IL;Israel;719;6;320136;2689
2020-11-10;IL;Israel;675;10;320811;2699
2020-11-11;IL;Israel;763;7;321574;2706
2020-11-12;IL;Israel;836;12;322410;2718
2020-11-13;IL;Israel;761;5;323171;2723
2020-11-14;IL;Israel;292;12;323463;2735
2020-11-15;IL;Israel;625;9;324088;2744
2020-11-16;IL;Israel;873;7;324961;2751
2020-11-17;IL;Israel;829;12;325790;2763
2020-11-18;IL;Israel;795;7;326585;2770
2020-11-19;IL;Israel;770;8;327355;2778
2020-11-20;IL;Israel;774;6;328129;2784
2020-11-21;IL;Israel;422;12;328551;2796
2020-11-22;IL;Israel;765;17;329316;2813
2020-11-23;IL;Israel;959;7;330275;2820
2020-11-24;IL;Israel;857;6;331132;2826
2020-11-25;IL;Israel;1079;5;332211;2831
2020-11-26;IL;Israel;1085;9;333296;2840
2020-11-27;IL;Israel;1032;6;334328;2846
2020-11-28;IL;Israel;580;10;334908;2856
2020-11-29;IL;Israel;1025;8;335933;2864
2020-11-30;IL;Israel;1258;8;337191;2872
2020-12-01;IL;Israel;1198;10;338389;2882
2020-12-02;IL;Israel;1579;4;339968;2886
2020-12-03;IL;Israel;1438;9;341406;2895
2020-12-04;IL;Israel;695;1;342101;2896
2020-12-05;IL;Israel;1725;13;343826;2909
2020-12-06;IL;Israel;1080;8;344906;2917
2020-12-07;IL;Israel;1891;7;346797;2924
2020-12-08;IL;Israel;1488;8;348285;2932
2020-12-09;IL;Israel;1986;2;350271;2934
2020-12-10;IL;Israel;2126;27;352397;2961
2020-12-11;IL;Israel;872;8;353269;2969
2020-12-12;IL;Israel;2517;14;355786;2983
2020-12-13;IL;Israel;1390;16;357176;2999
2020-12-14;IL;Israel;2330;5;359506;3004
2020-12-15;IL;Israel;1124;10;360630;3014
2020-12-16;IL;Israel;4412;20;365042;3034
2020-12-17;IL;Israel;2933;16;367975;3050
2020-12-18;IL;Israel;2177;7;370152;3057
2020-12-19;IL;Israel;2734;17;372886;3074
2020-12-20;IL;Israel;1874;25;374760;3099
2020-12-21;IL;Israel;3499;12;378259;3111
2020-12-22;IL;Israel;4228;25;382487;3136
2020-12-23;IL;Israel;2535;14;385022;3150
2020-12-24;IL;Israel;4656;21;389678;3171
2020-12-25;IL;Israel;4713;15;394391;3186
2020-12-26;IL;Israel;4273;24;398664;3210
2020-12-27;IL;Israel;2806;16;401470;3226
2020-12-28;IL;Israel;5815;30;407285;3256
2020-12-29;IL;Israel;5113;36;412398;3292
2020-12-30;IL;Israel;4186;15;416584;3307
2020-12-31;IL;Israel;6678;18;423262;3325
2021-01-01;IL;Israel;5248;31;428510;3356
2021-01-02;IL;Israel;6289;36;434799;3392
2021-01-03;IL;Israel;6743;24;441542;3416
2021-01-04;IL;Israel;6631;29;448173;3445
2021-01-05;IL;Israel;7966;51;456139;3496
2021-01-06;IL;Israel;7309;33;463448;3529
2021-01-07;IL;Israel;7600;23;471048;3552
2021-01-08;IL;Israel;6309;44;477357;3596
2021-01-09;IL;Israel;8077;49;485434;3645
2021-01-10;IL;Israel;5885;26;491319;3671
2021-01-11;IL;Israel;9754;33;501073;3704
2021-01-12;IL;Israel;8990;67;510063;3771
2021-01-13;IL;Israel;9997;46;520060;3817
2021-01-14;IL;Israel;9754;53;529814;3870
2021-01-15;IL;Israel;5235;40;535049;3910
2021-01-16;IL;Israel;8450;49;543499;3959
2021-01-17;IL;Israel;8190;46;551689;4005
2021-01-18;IL;Israel;6560;39;558249;4044
2021-01-19;IL;Israel;7380;36;565629;4080
2021-01-20;IL;Israel;10213;101;575842;4181
2021-01-21;IL;Israel;7027;64;582869;4245
2021-01-22;IL;Israel;6159;21;589028;4266
2021-01-23;IL;Israel;4933;75;593961;4341
2021-01-24;IL;Israel;3442;78;597403;4419
2021-01-25;IL;Israel;3666;79;601069;4498
2021-01-26;IL;Israel;8587;15;609656;4513
2021-01-27;IL;Israel;11934;92;621590;4605
2021-01-28;IL;Israel;7305;64;628895;4669
2021-01-29;IL;Israel;5096;31;633991;4700
2021-01-30;IL;Israel;4798;38;638789;4738
2021-01-31;IL;Israel;4646;58;643435;4796
2021-02-01;IL;Israel;8811;20;652246;4816
2021-02-02;IL;Israel;7732;71;659978;4887
2021-02-03;IL;Israel;8896;61;668874;4948
2021-02-04;IL;Israel;6744;53;675618;5001
2021-02-05;IL;Israel;5238;19;680856;5020
2021-02-06;IL;Israel;4727;51;685583;5071
2021-02-07;IL;Israel;6518;50;692101;5121
2021-02-08;IL;Israel;4427;50;696528;5171
2021-02-09;IL;Israel;7191;45;703719;5216
2021-02-10;IL;Israel;6010;41;709729;5257
2021-02-11;IL;Israel;5083;26;714812;5283
2021-02-12;IL;Israel;3934;21;718746;5304
2021-02-13;IL;Israel;3100;47;721846;5351
2021-02-14;IL;Israel;2534;37;724380;5388
2021-02-15;IL;Israel;5913;26;730293;5414
2021-02-16;IL;Israel;4282;27;734575;5441
2021-02-17;IL;Israel;4054;32;738629;5473
2021-02-18;IL;Israel;3305;36;741934;5509
2021-02-19;IL;Israel;2579;17;744513;5526
2021-02-20;IL;Israel;0;0;744513;5526
2021-02-21;IL;Israel;5530;51;750043;5577
2021-02-22;IL;Israel;4955;19;754998;5596
2021-02-23;IL;Israel;4574;38;759572;5634
2021-02-24;IL;Israel;4184;26;763756;5660
2021-02-25;IL;Israel;3970;27;767726;5687
2021-02-26;IL;Israel;3054;10;770780;5697
2021-02-27;IL;Israel;2555;35;773335;5732
2021-02-28;IL;Israel;2472;20;775807;5752
2021-03-01;IL;Israel;4151;8;779958;5760
2021-03-02;IL;Israel;5260;30;785218;5790
2021-03-03;IL;Israel;4267;13;789485;5803
2021-03-04;IL;Israel;3922;19;793407;5822
2021-03-05;IL;Israel;3058;12;796465;5834
2021-03-06;IL;Israel;3262;22;799727;5856
2021-03-07;IL;Israel;1848;35;801575;5891
2021-03-08;IL;Israel;3541;26;805116;5917
2021-03-09;IL;Israel;3146;16;808262;5933
2021-03-10;IL;Israel;3230;17;811492;5950
2021-03-11;IL;Israel;2758;17;814250;5967
2021-03-12;IL;Israel;1948;13;816198;5980
2021-03-13;IL;Israel;1601;8;817799;5988
2021-03-14;IL;Israel;1178;23;818977;6011
2021-03-15;IL;Israel;1936;19;820913;6030
2021-03-16;IL;Israel;1790;18;822703;6048
2021-03-17;IL;Israel;1475;9;824178;6057
2021-03-18;IL;Israel;1384;12;825562;6069
2021-03-19;IL;Israel;1047;4;826609;6073
2021-03-20;IL;Israel;611;9;827220;6082
2021-03-21;IL;Israel;552;10;827772;6092
2021-03-22;IL;Israel;992;17;828764;6109
2021-03-23;IL;Israel;925;13;829689;6122
2021-03-24;IL;Israel;339;32;830028;6154
2021-03-25;IL;Israel;817;9;830845;6163
2021-03-26;IL;Israel;538;2;831383;6165
2021-03-27;IL;Israel;0;0;831383;6165
2021-03-28;IL;Israel;541;20;831924;6185
2021-03-29;IL;Israel;201;12;832125;6197
2021-03-30;IL;Israel;514;-4;832639;6193
2021-03-31;IL;Israel;466;16;833105;6209
2021-04-01;IL;Israel;351;11;833456;6220
2021-04-02;IL;Israel;251;0;833707;6220
2021-04-03;IL;Israel;363;16;834070;6236
2021-04-04;IL;Israel;177;7;834247;6243
2021-04-05;IL;Israel;356;5;834603;6248
2021-04-06;IL;Israel;317;9;834920;6257
2021-04-07;IL;Israel;296;9;835216;6266
2021-04-08;IL;Israel;270;13;835486;6279
2021-04-09;IL;Israel;188;1;835674;6280
2021-04-10;IL;Israel;139;12;835813;6292
2021-04-11;IL;Israel;120;4;835933;6296
2021-04-12;IL;Israel;225;8;836158;6304
2021-04-13;IL;Israel;176;5;836334;6309
2021-04-14;IL;Israel;256;3;836590;6312
2021-04-15;IL;Israel;312;3;836902;6315
2021-04-16;IL;Israel;34;1;836936;6316
2021-04-17;IL;Israel;-53;15;836883;6331
2021-04-18;IL;Israel;164;4;837047;6335
2021-04-19;IL;Israel;171;6;837218;6341
2021-04-20;IL;Israel;139;4;837357;6345
2021-04-21;IL;Israel;135;1;837492;6346
2021-04-22;IL;Israel;315;0;837807;6346
2021-04-23;IL;Israel;85;0;837892;6346
2021-04-24;IL;Israel;82;4;837974;6350
2021-04-25;IL;Israel;50;2;838024;6352
2021-04-26;IL;Israel;83;1;838107;6353
2021-04-27;IL;Israel;110;6;838217;6359
2021-04-28;IL;Israel;106;2;838323;6361
2021-04-29;IL;Israel;84;1;838407;6362
2021-04-30;IL;Israel;74;1;838481;6363
2021-05-01;IL;Israel;0;0;838481;6363
2021-05-02;IL;Israel;73;3;838554;6366
2021-05-03;IL;Israel;67;1;838621;6367
2021-05-04;IL;Israel;76;2;838697;6369
2021-05-05;IL;Israel;70;1;838767;6370
2021-05-06;IL;Israel;61;4;838828;6374
2021-05-07;IL;Israel;30;1;838858;6375
2021-05-08;IL;Israel;28;1;838886;6376
2021-05-09;IL;Israel;8;1;838894;6377
2021-05-10;IL;Israel;63;1;838957;6378
2021-05-11;IL;Israel;43;0;839000;6378
2021-05-12;IL;Israel;30;1;839030;6379
2021-05-13;IL;Israel;29;0;839059;6379
2021-05-14;IL;Israel;20;1;839079;6380
2021-05-15;IL;Israel;39;1;839118;6381
2021-05-16;IL;Israel;1;1;839119;6382
2021-05-17;IL;Israel;40;7;839159;6389
2021-05-18;IL;Israel;8;3;839167;6392
2021-05-19;IL;Israel;54;3;839221;6395
2021-05-20;IL;Israel;42;1;839263;6396
2021-05-21;IL;Israel;27;1;839290;6397
2021-05-22;IL;Israel;18;0;839308;6397
2021-05-23;IL;Israel;11;7;839319;6404
2021-05-24;IL;Israel;48;2;839367;6406
2021-05-25;IL;Israel;22;0;839389;6406
2021-05-26;IL;Israel;19;0;839408;6406
2021-05-27;IL;Israel;12;0;839420;6406
2021-05-28;IL;Israel;13;1;839433;6407
2021-05-29;IL;Israel;20;0;839453;6407
2021-05-30;IL;Israel;5;4;839458;6411
2021-05-31;IL;Israel;17;1;839475;6412
2021-06-01;IL;Israel;36;1;839511;6413
2021-06-02;IL;Israel;6;2;839517;6415
2021-06-03;IL;Israel;15;1;839532;6416
2021-06-04;IL;Israel;7;1;839539;6417
2021-06-05;IL;Israel;27;1;839566;6418
2021-06-06;IL;Israel;5;0;839571;6418
2021-06-07;IL;Israel;14;0;839585;6418
2021-06-08;IL;Israel;0;0;839585;6418
2021-06-09;IL;Israel;0;0;839585;6418
2021-06-10;IL;Israel;45;10;839630;6428
2021-06-11;IL;Israel;23;0;839653;6428
2021-06-12;IL;Israel;8;0;839661;6428
2021-06-13;IL;Israel;5;2;839666;6430
2021-06-14;IL;Israel;24;-2;839690;6428
2021-06-15;IL;Israel;11;0;839701;6428
2021-06-16;IL;Israel;19;0;839720;6428
2021-06-17;IL;Israel;27;-1;839747;6427
2021-06-18;IL;Israel;22;0;839769;6427
2021-06-19;IL;Israel;61;0;839830;6427
2021-06-20;IL;Israel;37;0;839867;6427
2021-06-21;IL;Israel;123;0;839990;6427
2021-06-22;IL;Israel;89;1;840079;6428
2021-06-23;IL;Israel;146;0;840225;6428
2021-06-24;IL;Israel;219;1;840444;6429
2021-06-25;IL;Israel;194;0;840638;6429
2021-06-26;IL;Israel;185;0;840823;6429
2021-06-27;IL;Israel;65;0;840888;6429
2021-06-28;IL;Israel;308;0;841196;6429
2021-06-29;IL;Israel;290;0;841486;6429
2021-06-30;IL;Israel;291;0;841777;6429
2021-07-01;IL;Israel;290;0;842067;6429
2021-07-02;IL;Israel;0;0;0;0
2020-01-31;IT;Italy;2;0;2;0
2020-02-01;IT;Italy;0;0;2;0
2020-02-02;IT;Italy;0;0;2;0
2020-02-03;IT;Italy;0;0;2;0
2020-02-04;IT;Italy;0;0;2;0
2020-02-05;IT;Italy;0;0;2;0
2020-02-06;IT;Italy;0;0;2;0
2020-02-07;IT;Italy;1;0;3;0
2020-02-08;IT;Italy;0;0;3;0
2020-02-09;IT;Italy;0;0;3;0
2020-02-10;IT;Italy;0;0;3;0
2020-02-11;IT;Italy;0;0;3;0
2020-02-12;IT;Italy;0;0;3;0
2020-02-13;IT;Italy;0;0;3;0
2020-02-14;IT;Italy;0;0;3;0
2020-02-15;IT;Italy;0;0;3;0
2020-02-16;IT;Italy;0;0;3;0
2020-02-17;IT;Italy;0;0;3;0
2020-02-18;IT;Italy;0;0;3;0
2020-02-19;IT;Italy;0;0;3;0
2020-02-20;IT;Italy;0;0;3;0
2020-02-21;IT;Italy;17;1;20;1
2020-02-22;IT;Italy;42;1;62;2
2020-02-23;IT;Italy;93;1;155;3
2020-02-24;IT;Italy;74;4;229;7
2020-02-25;IT;Italy;93;3;322;10
2020-02-26;IT;Italy;131;2;453;12
2020-02-27;IT;Italy;202;5;655;17
2020-02-28;IT;Italy;233;4;888;21
2020-02-29;IT;Italy;240;8;1128;29
2020-03-01;IT;Italy;566;5;1694;34
2020-03-02;IT;Italy;342;18;2036;52
2020-03-03;IT;Italy;466;27;2502;79
2020-03-04;IT;Italy;587;28;3089;107
2020-03-05;IT;Italy;769;41;3858;148
2020-03-06;IT;Italy;778;49;4636;197
2020-03-07;IT;Italy;1247;36;5883;233
2020-03-08;IT;Italy;1492;133;7375;366
2020-03-09;IT;Italy;1797;97;9172;463
2020-03-10;IT;Italy;977;168;10149;631
2020-03-11;IT;Italy;2313;196;12462;827
2020-03-12;IT;Italy;2651;189;15113;1016
2020-03-13;IT;Italy;2547;250;17660;1266
2020-03-14;IT;Italy;3497;175;21157;1441
2020-03-15;IT;Italy;3590;368;24747;1809
2020-03-16;IT;Italy;3233;349;27980;2158
2020-03-17;IT;Italy;3526;345;31506;2503
2020-03-18;IT;Italy;4207;475;35713;2978
2020-03-19;IT;Italy;5322;427;41035;3405
2020-03-20;IT;Italy;5986;627;47021;4032
2020-03-21;IT;Italy;6557;793;53578;4825
2020-03-22;IT;Italy;5560;651;59138;5476
2020-03-23;IT;Italy;4789;601;63927;6077
2020-03-24;IT;Italy;5249;743;69176;6820
2020-03-25;IT;Italy;5210;683;74386;7503
2020-03-26;IT;Italy;6203;712;80589;8215
2020-03-27;IT;Italy;5909;919;86498;9134
2020-03-28;IT;Italy;5974;889;92472;10023
2020-03-29;IT;Italy;5217;756;97689;10779
2020-03-30;IT;Italy;4050;812;101739;11591
2020-03-31;IT;Italy;4053;837;105792;12428
2020-04-01;IT;Italy;4782;727;110574;13155
2020-04-02;IT;Italy;4668;760;115242;13915
2020-04-03;IT;Italy;4585;766;119827;14681
2020-04-04;IT;Italy;4805;681;124632;15362
2020-04-05;IT;Italy;4316;525;128948;15887
2020-04-06;IT;Italy;3599;636;132547;16523
2020-04-07;IT;Italy;3039;604;135586;17127
2020-04-08;IT;Italy;3836;542;139422;17669
2020-04-09;IT;Italy;4204;610;143626;18279
2020-04-10;IT;Italy;3951;570;147577;18849
2020-04-11;IT;Italy;4694;619;152271;19468
2020-04-12;IT;Italy;4092;431;156363;19899
2020-04-13;IT;Italy;3153;566;159516;20465
2020-04-14;IT;Italy;2972;602;162488;21067
2020-04-15;IT;Italy;2667;578;165155;21645
2020-04-16;IT;Italy;3786;525;168941;22170
2020-04-17;IT;Italy;3493;575;172434;22745
2020-04-18;IT;Italy;3491;482;175925;23227
2020-04-19;IT;Italy;3047;433;178972;23660
2020-04-20;IT;Italy;2256;454;181228;24114
2020-04-21;IT;Italy;2729;534;183957;24648
2020-04-22;IT;Italy;3370;437;187327;25085
2020-04-23;IT;Italy;2646;464;189973;25549
2020-04-24;IT;Italy;3021;420;192994;25969
2020-04-25;IT;Italy;2357;415;195351;26384
2020-04-26;IT;Italy;2324;260;197675;26644
2020-04-27;IT;Italy;1739;333;199414;26977
2020-04-28;IT;Italy;2091;382;201505;27359
2020-04-29;IT;Italy;2086;323;203591;27682
2020-04-30;IT;Italy;1872;285;205463;27967
2020-05-01;IT;Italy;1965;269;207428;28236
2020-05-02;IT;Italy;1900;474;209328;28710
2020-05-03;IT;Italy;1389;174;210717;28884
2020-05-04;IT;Italy;1221;195;211938;29079
2020-05-05;IT;Italy;1075;236;213013;29315
2020-05-06;IT;Italy;1444;369;214457;29684
2020-05-07;IT;Italy;1401;274;215858;29958
2020-05-08;IT;Italy;1327;243;217185;30201
2020-05-09;IT;Italy;1083;194;218268;30395
2020-05-10;IT;Italy;802;165;219070;30560
2020-05-11;IT;Italy;744;179;219814;30739
2020-05-12;IT;Italy;1402;172;221216;30911
2020-05-13;IT;Italy;888;195;222104;31106
2020-05-14;IT;Italy;992;262;223096;31368
2020-05-15;IT;Italy;789;242;223885;31610
2020-05-16;IT;Italy;875;153;224760;31763
2020-05-17;IT;Italy;675;145;225435;31908
2020-05-18;IT;Italy;451;99;225886;32007
2020-05-19;IT;Italy;813;162;226699;32169
2020-05-20;IT;Italy;665;161;227364;32330
2020-05-21;IT;Italy;642;156;228006;32486
2020-05-22;IT;Italy;652;130;228658;32616
2020-05-23;IT;Italy;669;119;229327;32735
2020-05-24;IT;Italy;531;50;229858;32785
2020-05-25;IT;Italy;300;92;230158;32877
2020-05-26;IT;Italy;397;78;230555;32955
2020-05-27;IT;Italy;584;117;231139;33072
2020-05-28;IT;Italy;593;70;231732;33142
2020-05-29;IT;Italy;516;87;232248;33229
2020-05-30;IT;Italy;416;111;232664;33340
2020-05-31;IT;Italy;333;75;232997;33415
2020-06-01;IT;Italy;200;60;233197;33475
2020-06-02;IT;Italy;318;55;233515;33530
2020-06-03;IT;Italy;321;71;233836;33601
2020-06-04;IT;Italy;177;88;234013;33689
2020-06-05;IT;Italy;518;85;234531;33774
2020-06-06;IT;Italy;270;72;234801;33846
2020-06-07;IT;Italy;197;53;234998;33899
2020-06-08;IT;Italy;280;65;235278;33964
2020-06-09;IT;Italy;283;79;235561;34043
2020-06-10;IT;Italy;202;71;235763;34114
2020-06-11;IT;Italy;379;53;236142;34167
2020-06-12;IT;Italy;163;56;236305;34223
2020-06-13;IT;Italy;346;78;236651;34301
2020-06-14;IT;Italy;338;44;236989;34345
2020-06-15;IT;Italy;301;26;237290;34371
2020-06-16;IT;Italy;210;34;237500;34405
2020-06-17;IT;Italy;328;43;237828;34448
2020-06-18;IT;Italy;331;66;238159;34514
2020-06-19;IT;Italy;-148;47;238011;34561
2020-06-20;IT;Italy;264;49;238275;34610
2020-06-21;IT;Italy;224;24;238499;34634
2020-06-22;IT;Italy;221;23;238720;34657
2020-06-23;IT;Italy;113;18;238833;34675
2020-06-24;IT;Italy;577;-31;239410;34644
2020-06-25;IT;Italy;296;34;239706;34678
2020-06-26;IT;Italy;255;30;239961;34708
2020-06-27;IT;Italy;175;8;240136;34716
2020-06-28;IT;Italy;174;22;240310;34738
2020-06-29;IT;Italy;126;6;240436;34744
2020-06-30;IT;Italy;142;23;240578;34767
2020-07-01;IT;Italy;182;21;240760;34788
2020-07-02;IT;Italy;201;30;240961;34818
2020-07-03;IT;Italy;223;15;241184;34833
2020-07-04;IT;Italy;235;21;241419;34854
2020-07-05;IT;Italy;192;7;241611;34861
2020-07-06;IT;Italy;208;8;241819;34869
2020-07-07;IT;Italy;137;30;241956;34899
2020-07-08;IT;Italy;193;15;242149;34914
2020-07-09;IT;Italy;214;12;242363;34926
2020-07-10;IT;Italy;276;12;242639;34938
2020-07-11;IT;Italy;188;7;242827;34945
2020-07-12;IT;Italy;234;9;243061;34954
2020-07-13;IT;Italy;169;13;243230;34967
2020-07-14;IT;Italy;114;17;243344;34984
2020-07-15;IT;Italy;162;13;243506;34997
2020-07-16;IT;Italy;230;20;243736;35017
2020-07-17;IT;Italy;231;11;243967;35028
2020-07-18;IT;Italy;249;14;244216;35042
2020-07-19;IT;Italy;218;3;244434;35045
2020-07-20;IT;Italy;190;13;244624;35058
2020-07-21;IT;Italy;128;15;244752;35073
2020-07-22;IT;Italy;280;9;245032;35082
2020-07-23;IT;Italy;306;10;245338;35092
2020-07-24;IT;Italy;252;5;245590;35097
2020-07-25;IT;Italy;274;5;245864;35102
2020-07-26;IT;Italy;254;5;246118;35107
2020-07-27;IT;Italy;168;5;246286;35112
2020-07-28;IT;Italy;202;11;246488;35123
2020-07-29;IT;Italy;288;6;246776;35129
2020-07-30;IT;Italy;382;3;247158;35132
2020-07-31;IT;Italy;379;9;247537;35141
2020-08-01;IT;Italy;295;5;247832;35146
2020-08-02;IT;Italy;238;8;248070;35154
2020-08-03;IT;Italy;159;12;248229;35166
2020-08-04;IT;Italy;190;5;248419;35171
2020-08-05;IT;Italy;384;10;248803;35181
2020-08-06;IT;Italy;401;6;249204;35187
2020-08-07;IT;Italy;552;3;249756;35190
2020-08-08;IT;Italy;347;13;250103;35203
2020-08-09;IT;Italy;463;2;250566;35205
2020-08-10;IT;Italy;259;4;250825;35209
2020-08-11;IT;Italy;412;6;251237;35215
2020-08-12;IT;Italy;476;10;251713;35225
2020-08-13;IT;Italy;522;6;252235;35231
2020-08-14;IT;Italy;574;3;252809;35234
2020-08-15;IT;Italy;629;158;253438;35392
2020-08-16;IT;Italy;477;4;253915;35396
2020-08-17;IT;Italy;320;4;254235;35400
2020-08-18;IT;Italy;401;5;254636;35405
2020-08-19;IT;Italy;642;7;255278;35412
2020-08-20;IT;Italy;840;6;256118;35418
2020-08-21;IT;Italy;947;9;257065;35427
2020-08-22;IT;Italy;1071;3;258136;35430
2020-08-23;IT;Italy;1209;7;259345;35437
2020-08-24;IT;Italy;953;4;260298;35441
2020-08-25;IT;Italy;876;4;261174;35445
2020-08-26;IT;Italy;1366;13;262540;35458
2020-08-27;IT;Italy;1409;5;263949;35463
2020-08-28;IT;Italy;1460;9;265409;35472
2020-08-29;IT;Italy;1444;1;266853;35473
2020-08-30;IT;Italy;1365;4;268218;35477
2020-08-31;IT;Italy;996;6;269214;35483
2020-09-01;IT;Italy;975;8;270189;35491
2020-09-02;IT;Italy;1326;6;271515;35497
2020-09-03;IT;Italy;1397;10;272912;35507
2020-09-04;IT;Italy;1732;11;274644;35518
2020-09-05;IT;Italy;1694;16;276338;35534
2020-09-06;IT;Italy;1296;7;277634;35541
2020-09-07;IT;Italy;1150;12;278784;35553
2020-09-08;IT;Italy;1369;10;280153;35563
2020-09-09;IT;Italy;1430;14;281583;35577
2020-09-10;IT;Italy;1597;10;283180;35587
2020-09-11;IT;Italy;1616;10;284796;35597
2020-09-12;IT;Italy;1501;6;286297;35603
2020-09-13;IT;Italy;1456;7;287753;35610
2020-09-14;IT;Italy;1008;14;288761;35624
2020-09-15;IT;Italy;1229;9;289990;35633
2020-09-16;IT;Italy;1452;12;291442;35645
2020-09-17;IT;Italy;1583;13;293025;35658
2020-09-18;IT;Italy;1907;10;294932;35668
2020-09-19;IT;Italy;1637;24;296569;35692
2020-09-20;IT;Italy;1587;15;298156;35707
2020-09-21;IT;Italy;1350;17;299506;35724
2020-09-22;IT;Italy;1391;14;300897;35738
2020-09-23;IT;Italy;1640;20;302537;35758
2020-09-24;IT;Italy;1786;23;304323;35781
2020-09-25;IT;Italy;1912;20;306235;35801
2020-09-26;IT;Italy;1869;17;308104;35818
2020-09-27;IT;Italy;1766;17;309870;35835
2020-09-28;IT;Italy;1494;16;311364;35851
2020-09-29;IT;Italy;1647;24;313011;35875
2020-09-30;IT;Italy;1850;19;314861;35894
2020-10-01;IT;Italy;2548;24;317409;35918
2020-10-02;IT;Italy;2499;23;319908;35941
2020-10-03;IT;Italy;2843;27;322751;35968
2020-10-04;IT;Italy;2578;18;325329;35986
2020-10-05;IT;Italy;2257;16;327586;36002
2020-10-06;IT;Italy;2677;28;330263;36030
2020-10-07;IT;Italy;3677;31;333940;36061
2020-10-08;IT;Italy;4458;22;338398;36083
2020-10-09;IT;Italy;5372;28;343770;36111
2020-10-10;IT;Italy;5724;29;349494;36140
2020-10-11;IT;Italy;5456;26;354950;36166
2020-10-12;IT;Italy;4619;39;359569;36205
2020-10-13;IT;Italy;5898;41;365467;36246
2020-10-14;IT;Italy;7332;43;372799;36289
2020-10-15;IT;Italy;8803;83;381602;36372
2020-10-16;IT;Italy;10009;55;391611;36427
2020-10-17;IT;Italy;10925;47;402536;36474
2020-10-18;IT;Italy;11705;69;414241;36543
2020-10-19;IT;Italy;9337;73;423578;36616
2020-10-20;IT;Italy;10871;89;434449;36705
2020-10-21;IT;Italy;15199;127;449648;36832
2020-10-22;IT;Italy;16078;136;465726;36968
2020-10-23;IT;Italy;19143;91;484869;37059
2020-10-24;IT;Italy;19640;151;504509;37210
2020-10-25;IT;Italy;21273;128;525782;37338
2020-10-26;IT;Italy;17007;141;542789;37479
2020-10-27;IT;Italy;21989;221;564778;37700
2020-10-28;IT;Italy;24988;205;589766;37905
2020-10-29;IT;Italy;26829;217;616595;38122
2020-10-30;IT;Italy;31079;199;647674;38321
2020-10-31;IT;Italy;31756;297;679430;38618
2020-11-01;IT;Italy;29905;208;709335;38826
2020-11-02;IT;Italy;22253;233;731588;39059
2020-11-03;IT;Italy;28241;353;759829;39412
2020-11-04;IT;Italy;30548;352;790377;39764
2020-11-05;IT;Italy;34502;428;824879;40192
2020-11-06;IT;Italy;37802;446;862681;40638
2020-11-07;IT;Italy;39809;425;902490;41063
2020-11-08;IT;Italy;32614;331;935104;41394
2020-11-09;IT;Italy;25269;356;960373;41750
2020-11-10;IT;Italy;35090;580;995463;42330
2020-11-11;IT;Italy;32961;623;1028424;42953
2020-11-12;IT;Italy;37977;636;1066401;43589
2020-11-13;IT;Italy;40902;550;1107303;44139
2020-11-14;IT;Italy;37249;544;1144552;44683
2020-11-15;IT;Italy;33977;546;1178529;45229
2020-11-16;IT;Italy;27352;504;1205881;45733
2020-11-17;IT;Italy;32191;731;1238072;46464
2020-11-18;IT;Italy;34280;753;1272352;47217
2020-11-19;IT;Italy;36176;653;1308528;47870
2020-11-20;IT;Italy;37239;699;1345767;48569
2020-11-21;IT;Italy;34764;692;1380531;49261
2020-11-22;IT;Italy;28337;562;1408868;49823
2020-11-23;IT;Italy;22927;630;1431795;50453
2020-11-24;IT;Italy;23227;853;1455022;51306
2020-11-25;IT;Italy;25852;722;1480874;52028
2020-11-26;IT;Italy;29001;822;1509875;52850
2020-11-27;IT;Italy;28342;827;1538217;53677
2020-11-28;IT;Italy;26315;686;1564532;54363
2020-11-29;IT;Italy;20646;541;1585178;54904
2020-11-30;IT;Italy;16376;672;1601554;55576
2020-12-01;IT;Italy;19347;785;1620901;56361
2020-12-02;IT;Italy;20709;684;1641610;57045
2020-12-03;IT;Italy;23219;993;1664829;58038
2020-12-04;IT;Italy;24110;814;1688939;58852
2020-12-05;IT;Italy;21052;662;1709991;59514
2020-12-06;IT;Italy;18887;564;1728878;60078
2020-12-07;IT;Italy;13679;528;1742557;60606
2020-12-08;IT;Italy;14837;634;1757394;61240
2020-12-09;IT;Italy;12755;499;1770149;61739
2020-12-10;IT;Italy;16998;887;1787147;62626
2020-12-11;IT;Italy;18726;761;1805873;63387
2020-12-12;IT;Italy;19902;649;1825775;64036
2020-12-13;IT;Italy;17937;484;1843712;64520
2020-12-14;IT;Italy;12025;491;1855737;65011
2020-12-15;IT;Italy;14839;846;1870576;65857
2020-12-16;IT;Italy;17568;680;1888144;66537
2020-12-17;IT;Italy;18233;683;1906377;67220
2020-12-18;IT;Italy;15401;674;1921778;67894
2020-12-19;IT;Italy;16305;553;1938083;68447
2020-12-20;IT;Italy;15102;352;1953185;68799
2020-12-21;IT;Italy;10869;415;1964054;69214
2020-12-22;IT;Italy;13316;628;1977370;69842
2020-12-23;IT;Italy;13908;553;1991278;70395
2020-12-24;IT;Italy;18039;505;2009317;70900
2020-12-25;IT;Italy;19037;459;2028354;71359
2020-12-26;IT;Italy;10405;261;2038759;71620
2020-12-27;IT;Italy;8937;305;2047696;71925
2020-12-28;IT;Italy;8581;445;2056277;72370
2020-12-29;IT;Italy;11210;659;2067487;73029
2020-12-30;IT;Italy;16202;575;2083689;73604
2020-12-31;IT;Italy;23477;555;2107166;74159
2021-01-01;IT;Italy;22210;462;2129376;74621
2021-01-02;IT;Italy;11825;364;2141201;74985
2021-01-03;IT;Italy;14245;347;2155446;75332
2021-01-04;IT;Italy;10798;348;2166244;75680
2021-01-05;IT;Italy;15375;649;2181619;76329
2021-01-06;IT;Italy;20326;548;2201945;76877
2021-01-07;IT;Italy;18416;414;2220361;77291
2021-01-08;IT;Italy;17529;620;2237890;77911
2021-01-09;IT;Italy;19976;483;2257866;78394
2021-01-10;IT;Italy;18625;361;2276491;78755
2021-01-11;IT;Italy;12530;448;2289021;79203
2021-01-12;IT;Italy;14242;616;2303263;79819
2021-01-13;IT;Italy;15773;507;2319036;80326
2021-01-14;IT;Italy;17243;522;2336279;80848
2021-01-15;IT;Italy;16144;477;2352423;81325
2021-01-16;IT;Italy;16310;475;2368733;81800
2021-01-17;IT;Italy;12544;377;2381277;82177
2021-01-18;IT;Italy;8825;377;2390102;82554
2021-01-19;IT;Italy;10496;603;2400598;83157
2021-01-20;IT;Italy;13568;524;2414166;83681
2021-01-21;IT;Italy;14055;521;2428221;84202
2021-01-22;IT;Italy;13633;472;2441854;84674
2021-01-23;IT;Italy;13331;488;2455185;85162
2021-01-24;IT;Italy;11628;299;2466813;85461
2021-01-25;IT;Italy;8559;420;2475372;85881
2021-01-26;IT;Italy;10584;541;2485956;86422
2021-01-27;IT;Italy;15191;467;2501147;86889
2021-01-28;IT;Italy;14360;492;2515507;87381
2021-01-29;IT;Italy;13563;477;2529070;87858
2021-01-30;IT;Italy;12713;421;2541783;88279
2021-01-31;IT;Italy;11249;237;2553032;88516
2021-02-01;IT;Italy;7925;329;2560957;88845
2021-02-02;IT;Italy;9651;499;2570608;89344
2021-02-03;IT;Italy;13182;476;2583790;89820
2021-02-04;IT;Italy;13656;421;2597446;90241
2021-02-05;IT;Italy;14213;377;2611659;90618
2021-02-06;IT;Italy;13439;385;2625098;91003
2021-02-07;IT;Italy;11640;270;2636738;91273
2021-02-08;IT;Italy;7969;307;2644707;91580
2021-02-09;IT;Italy;10612;422;2655319;92002
2021-02-10;IT;Italy;12947;336;2668266;92338
2021-02-11;IT;Italy;15137;391;2683403;92729
2021-02-12;IT;Italy;13893;316;2697296;93045
2021-02-13;IT;Italy;13523;311;2710819;93356
2021-02-14;IT;Italy;11060;221;2721879;93577
2021-02-15;IT;Italy;7344;258;2729223;93835
2021-02-16;IT;Italy;10368;336;2739591;94171
2021-02-17;IT;Italy;12066;369;2751657;94540
2021-02-18;IT;Italy;13755;347;2765412;94887
2021-02-19;IT;Italy;15470;348;2780882;95235
2021-02-20;IT;Italy;14914;251;2795796;95486
2021-02-21;IT;Italy;13450;232;2809246;95718
2021-02-22;IT;Italy;9617;274;2818863;95992
2021-02-23;IT;Italy;13299;356;2832162;96348
2021-02-24;IT;Italy;16402;318;2848564;96666
2021-02-25;IT;Italy;19871;308;2868435;96974
2021-02-26;IT;Italy;20488;253;2888923;97227
2021-02-27;IT;Italy;18902;280;2907825;97507
2021-02-28;IT;Italy;17440;192;2925265;97699
2021-03-01;IT;Italy;13106;246;2938371;97945
2021-03-02;IT;Italy;17063;343;2955434;98288
2021-03-03;IT;Italy;20840;347;2976274;98635
2021-03-04;IT;Italy;22845;339;2999119;98974
2021-03-05;IT;Italy;24010;297;3023129;99271
2021-03-06;IT;Italy;23633;307;3046762;99578
2021-03-07;IT;Italy;20724;207;3067486;99785
2021-03-08;IT;Italy;13882;318;3081368;100103
2021-03-09;IT;Italy;19725;376;3101093;100479
2021-03-10;IT;Italy;22275;332;3123368;100811
2021-03-11;IT;Italy;25649;373;3149017;101184
2021-03-12;IT;Italy;26790;380;3175807;101564
2021-03-13;IT;Italy;26031;317;3201838;101881
2021-03-14;IT;Italy;21304;264;3223142;102145
2021-03-15;IT;Italy;15252;354;3238394;102499
2021-03-16;IT;Italy;20376;502;3258770;103001
2021-03-17;IT;Italy;23040;431;3281810;103432
2021-03-18;IT;Italy;24901;423;3306711;103855
2021-03-19;IT;Italy;25707;386;3332418;104241
2021-03-20;IT;Italy;23913;401;3356331;104642
2021-03-21;IT;Italy;20045;300;3376376;104942
2021-03-22;IT;Italy;24501;386;3400877;105328
2021-03-23;IT;Italy;18739;551;3419616;105879
2021-03-24;IT;Italy;21246;460;3440862;106339
2021-03-25;IT;Italy;23681;460;3464543;106799
2021-03-26;IT;Italy;24076;457;3488619;107256
2021-03-27;IT;Italy;23834;380;3512453;107636
2021-03-28;IT;Italy;19604;297;3532057;107933
2021-03-29;IT;Italy;12900;417;3544957;108350
2021-03-30;IT;Italy;16055;529;3561012;108879
2021-03-31;IT;Italy;23887;467;3584899;109346
2021-04-01;IT;Italy;22184;501;3607083;109847
2021-04-02;IT;Italy;21917;481;3629000;110328
2021-04-03;IT;Italy;21247;376;3650247;110704
2021-04-04;IT;Italy;18017;326;3668264;111030
2021-04-05;IT;Italy;10680;296;3678944;111326
2021-04-06;IT;Italy;7763;421;3686707;111747
2021-04-07;IT;Italy;13686;627;3700393;112374
2021-04-08;IT;Italy;17209;487;3717602;112861
2021-04-09;IT;Italy;18924;718;3736526;113579
2021-04-10;IT;Italy;17551;344;3754077;113923
2021-04-11;IT;Italy;15737;331;3769814;114254
2021-04-12;IT;Italy;9780;358;3779594;114612
2021-04-13;IT;Italy;13439;476;3793033;115088
2021-04-14;IT;Italy;16160;469;3809193;115557
2021-04-15;IT;Italy;16963;380;3826156;115937
2021-04-16;IT;Italy;15923;429;3842079;116366
2021-04-17;IT;Italy;15364;310;3857443;116676
2021-04-18;IT;Italy;12688;251;3870131;116927
2021-04-19;IT;Italy;8863;316;3878994;117243
2021-04-20;IT;Italy;12069;390;3891063;117633
2021-04-21;IT;Italy;13836;364;3904899;117997
2021-04-22;IT;Italy;16046;360;3920945;118357
2021-04-23;IT;Italy;14758;342;3935703;118699
2021-04-24;IT;Italy;13814;322;3949517;119021
2021-04-25;IT;Italy;13157;217;3962674;119238
2021-04-26;IT;Italy;8440;301;3971114;119539
2021-04-27;IT;Italy;10398;373;3981512;119912
2021-04-28;IT;Italy;13382;344;3994894;120256
2021-04-29;IT;Italy;14314;288;4009208;120544
2021-04-30;IT;Italy;13445;263;4022653;120807
2021-05-01;IT;Italy;12964;226;4035617;121033
2021-05-02;IT;Italy;9145;144;4044762;121177
2021-05-03;IT;Italy;5946;256;4050708;121433
2021-05-04;IT;Italy;9113;305;4059821;121738
2021-05-05;IT;Italy;10579;267;4070400;122005
2021-05-06;IT;Italy;11798;258;4082198;122263
2021-05-07;IT;Italy;10549;207;4092747;122470
2021-05-08;IT;Italy;10174;224;4102921;122694
2021-05-09;IT;Italy;8289;139;4111210;122833
2021-05-10;IT;Italy;5077;198;4116287;123031
2021-05-11;IT;Italy;6943;251;4123230;123282
2021-05-12;IT;Italy;7848;262;4131078;123544
2021-05-13;IT;Italy;8082;201;4139160;123745
2021-05-14;IT;Italy;7562;182;4146722;123927
2021-05-15;IT;Italy;6652;136;4153374;124063
2021-05-16;IT;Italy;5748;93;4159122;124156
2021-05-17;IT;Italy;3454;140;4162576;124296
2021-05-18;IT;Italy;4449;201;4167025;124497
2021-05-19;IT;Italy;5500;149;4172525;124646
2021-05-20;IT;Italy;5736;164;4178261;124810
2021-05-21;IT;Italy;5215;218;4183476;125028
2021-05-22;IT;Italy;4714;125;4188190;125153
2021-05-23;IT;Italy;3993;72;4192183;125225
2021-05-24;IT;Italy;2489;110;4194672;125335
2021-05-25;IT;Italy;3220;166;4197892;125501
2021-05-26;IT;Italy;3935;121;4201827;125622
2021-05-27;IT;Italy;4143;171;4205970;125793
2021-05-28;IT;Italy;3737;126;4209707;125919
2021-05-29;IT;Italy;3348;83;4213055;126002
2021-05-30;IT;Italy;2948;44;4216003;126046
2021-05-31;IT;Italy;1818;82;4217821;126128
2021-06-01;IT;Italy;2483;93;4220304;126221
2021-06-02;IT;Italy;2896;62;4223200;126283
2021-06-03;IT;Italy;1963;59;4225163;126342
2021-06-04;IT;Italy;2556;73;4227719;126415
2021-06-05;IT;Italy;2434;57;4230153;126472
2021-06-06;IT;Italy;2275;51;4232428;126523
2021-06-07;IT;Italy;1270;65;4233698;126588
2021-06-08;IT;Italy;1894;102;4235592;126690
2021-06-09;IT;Italy;2198;77;4237790;126767
2021-06-10;IT;Italy;2078;88;4239868;126855
2021-06-11;IT;Italy;1892;69;4241760;126924
2021-06-12;IT;Italy;1722;52;4243482;126976
2021-06-13;IT;Italy;1390;26;4244872;127002
2021-06-14;IT;Italy;907;36;4245779;127038
2021-06-15;IT;Italy;1253;63;4247032;127101
2021-06-16;IT;Italy;1400;52;4248432;127153
2021-06-17;IT;Italy;1323;37;4249755;127190
2021-06-18;IT;Italy;1147;35;4250902;127225
2021-06-19;IT;Italy;1193;28;4252095;127253
2021-06-20;IT;Italy;881;17;4252976;127270
2021-06-21;IT;Italy;484;21;4253460;127291
2021-06-22;IT;Italy;834;31;4254294;127322
2021-06-23;IT;Italy;1140;30;4255434;127352
2021-06-24;IT;Italy;266;10;4255700;127362
2021-06-25;IT;Italy;751;56;4256451;127418
2021-06-26;IT;Italy;838;40;4257289;127458
2021-06-27;IT;Italy;780;14;4258069;127472
2021-06-28;IT;Italy;387;28;4258456;127500
2021-06-29;IT;Italy;677;42;4259133;127542
2021-06-30;IT;Italy;776;24;4259909;127566
2021-07-01;IT;Italy;879;21;4260788;127587
2020-03-11;JM;Jamaica;1;0;1;0
2020-03-12;JM;Jamaica;1;0;2;0
2020-03-13;JM;Jamaica;6;0;8;0
2020-03-14;JM;Jamaica;0;0;8;0
2020-03-15;JM;Jamaica;2;0;10;0
2020-03-16;JM;Jamaica;0;0;10;0
2020-03-17;JM;Jamaica;2;0;12;0
2020-03-18;JM;Jamaica;1;0;13;0
2020-03-19;JM;Jamaica;2;1;15;1
2020-03-20;JM;Jamaica;1;0;16;1
2020-03-21;JM;Jamaica;0;0;16;1
2020-03-22;JM;Jamaica;3;0;19;1
2020-03-23;JM;Jamaica;0;0;19;1
2020-03-24;JM;Jamaica;2;0;21;1
2020-03-25;JM;Jamaica;5;0;26;1
2020-03-26;JM;Jamaica;0;0;26;1
2020-03-27;JM;Jamaica;0;0;26;1
2020-03-28;JM;Jamaica;4;0;30;1
2020-03-29;JM;Jamaica;2;0;32;1
2020-03-30;JM;Jamaica;4;0;36;1
2020-03-31;JM;Jamaica;0;0;36;1
2020-04-01;JM;Jamaica;8;2;44;3
2020-04-02;JM;Jamaica;3;0;47;3
2020-04-03;JM;Jamaica;0;0;47;3
2020-04-04;JM;Jamaica;6;0;53;3
2020-04-05;JM;Jamaica;5;0;58;3
2020-04-06;JM;Jamaica;0;0;58;3
2020-04-07;JM;Jamaica;5;0;63;3
2020-04-08;JM;Jamaica;0;1;63;4
2020-04-09;JM;Jamaica;0;0;63;4
2020-04-10;JM;Jamaica;0;0;63;4
2020-04-11;JM;Jamaica;2;0;65;4
2020-04-12;JM;Jamaica;4;0;69;4
2020-04-13;JM;Jamaica;4;0;73;4
2020-04-14;JM;Jamaica;0;0;73;4
2020-04-15;JM;Jamaica;52;1;125;5
2020-04-16;JM;Jamaica;18;0;143;5
2020-04-17;JM;Jamaica;0;0;143;5
2020-04-18;JM;Jamaica;20;0;163;5
2020-04-19;JM;Jamaica;10;0;173;5
2020-04-20;JM;Jamaica;50;0;223;5
2020-04-21;JM;Jamaica;0;1;223;6
2020-04-22;JM;Jamaica;10;0;233;6
2020-04-23;JM;Jamaica;24;0;257;6
2020-04-24;JM;Jamaica;31;1;288;7
2020-04-25;JM;Jamaica;17;0;305;7
2020-04-26;JM;Jamaica;45;0;350;7
2020-04-27;JM;Jamaica;14;0;364;7
2020-04-28;JM;Jamaica;0;0;364;7
2020-04-29;JM;Jamaica;32;0;396;7
2020-04-30;JM;Jamaica;26;1;422;8
2020-05-01;JM;Jamaica;10;0;432;8
2020-05-02;JM;Jamaica;31;0;463;8
2020-05-03;JM;Jamaica;6;1;469;9
2020-05-04;JM;Jamaica;2;0;471;9
2020-05-05;JM;Jamaica;2;0;473;9
2020-05-06;JM;Jamaica;5;0;478;9
2020-05-07;JM;Jamaica;10;0;488;9
2020-05-08;JM;Jamaica;2;0;490;9
2020-05-09;JM;Jamaica;0;0;490;9
2020-05-10;JM;Jamaica;12;0;502;9
2020-05-11;JM;Jamaica;3;0;505;9
2020-05-12;JM;Jamaica;2;0;507;9
2020-05-13;JM;Jamaica;2;0;509;9
2020-05-14;JM;Jamaica;0;0;509;9
2020-05-15;JM;Jamaica;2;0;511;9
2020-05-16;JM;Jamaica;6;0;517;9
2020-05-17;JM;Jamaica;3;0;520;9
2020-05-18;JM;Jamaica;0;0;520;9
2020-05-19;JM;Jamaica;0;0;520;9
2020-05-20;JM;Jamaica;9;0;529;9
2020-05-21;JM;Jamaica;5;0;534;9
2020-05-22;JM;Jamaica;10;0;544;9
2020-05-23;JM;Jamaica;6;0;550;9
2020-05-24;JM;Jamaica;2;0;552;9
2020-05-25;JM;Jamaica;4;0;556;9
2020-05-26;JM;Jamaica;8;0;564;9
2020-05-27;JM;Jamaica;5;0;569;9
2020-05-28;JM;Jamaica;0;0;569;9
2020-05-29;JM;Jamaica;6;0;575;9
2020-05-30;JM;Jamaica;6;0;581;9
2020-05-31;JM;Jamaica;5;0;586;9
2020-06-01;JM;Jamaica;2;0;588;9
2020-06-02;JM;Jamaica;2;0;590;9
2020-06-03;JM;Jamaica;1;1;591;10
2020-06-04;JM;Jamaica;0;0;591;10
2020-06-05;JM;Jamaica;4;0;595;10
2020-06-06;JM;Jamaica;1;0;596;10
2020-06-07;JM;Jamaica;2;0;598;10
2020-06-08;JM;Jamaica;1;0;599;10
2020-06-09;JM;Jamaica;6;0;605;10
2020-06-10;JM;Jamaica;0;0;605;10
2020-06-11;JM;Jamaica;6;0;611;10
2020-06-12;JM;Jamaica;3;0;614;10
2020-06-13;JM;Jamaica;1;0;615;10
2020-06-14;JM;Jamaica;2;0;617;10
2020-06-15;JM;Jamaica;4;0;621;10
2020-06-16;JM;Jamaica;0;0;621;10
2020-06-17;JM;Jamaica;5;0;626;10
2020-06-18;JM;Jamaica;12;0;638;10
2020-06-19;JM;Jamaica;14;0;652;10
2020-06-20;JM;Jamaica;5;0;657;10
2020-06-21;JM;Jamaica;2;0;659;10
2020-06-22;JM;Jamaica;6;0;665;10
2020-06-23;JM;Jamaica;5;0;670;10
2020-06-24;JM;Jamaica;8;0;678;10
2020-06-25;JM;Jamaica;6;0;684;10
2020-06-26;JM;Jamaica;2;0;686;10
2020-06-27;JM;Jamaica;4;0;690;10
2020-06-28;JM;Jamaica;6;0;696;10
2020-06-29;JM;Jamaica;2;0;698;10
2020-06-30;JM;Jamaica;4;0;702;10
2020-07-01;JM;Jamaica;5;0;707;10
2020-07-02;JM;Jamaica;8;0;715;10
2020-07-03;JM;Jamaica;6;0;721;10
2020-07-04;JM;Jamaica;7;0;728;10
2020-07-05;JM;Jamaica;4;0;732;10
2020-07-06;JM;Jamaica;5;0;737;10
2020-07-07;JM;Jamaica;8;0;745;10
2020-07-08;JM;Jamaica;6;0;751;10
2020-07-09;JM;Jamaica;2;0;753;10
2020-07-10;JM;Jamaica;0;0;753;10
2020-07-11;JM;Jamaica;5;0;758;10
2020-07-12;JM;Jamaica;0;0;758;10
2020-07-13;JM;Jamaica;1;0;759;10
2020-07-14;JM;Jamaica;3;0;762;10
2020-07-15;JM;Jamaica;1;0;763;10
2020-07-16;JM;Jamaica;2;0;765;10
2020-07-17;JM;Jamaica;3;0;768;10
2020-07-18;JM;Jamaica;6;0;774;10
2020-07-19;JM;Jamaica;16;0;790;10
2020-07-20;JM;Jamaica;19;0;809;10
2020-07-21;JM;Jamaica;1;0;810;10
2020-07-22;JM;Jamaica;6;0;816;10
2020-07-23;JM;Jamaica;5;0;821;10
2020-07-24;JM;Jamaica;10;0;831;10
2020-07-25;JM;Jamaica;6;0;837;10
2020-07-26;JM;Jamaica;5;0;842;10
2020-07-27;JM;Jamaica;11;0;853;10
2020-07-28;JM;Jamaica;2;0;855;10
2020-07-29;JM;Jamaica;1;0;856;10
2020-07-30;JM;Jamaica;8;0;864;10
2020-07-31;JM;Jamaica;14;0;878;10
2020-08-01;JM;Jamaica;5;0;883;10
2020-08-02;JM;Jamaica;11;2;894;12
2020-08-03;JM;Jamaica;11;0;905;12
2020-08-04;JM;Jamaica;15;0;920;12
2020-08-05;JM;Jamaica;8;0;928;12
2020-08-06;JM;Jamaica;30;0;958;12
2020-08-07;JM;Jamaica;29;1;987;13
2020-08-08;JM;Jamaica;16;0;1003;13
2020-08-09;JM;Jamaica;20;1;1023;14
2020-08-10;JM;Jamaica;8;0;1031;14
2020-08-11;JM;Jamaica;16;0;1047;14
2020-08-12;JM;Jamaica;18;0;1065;14
2020-08-13;JM;Jamaica;6;0;1071;14
2020-08-14;JM;Jamaica;11;0;1082;14
2020-08-15;JM;Jamaica;0;0;1082;14
2020-08-16;JM;Jamaica;31;0;1113;14
2020-08-17;JM;Jamaica;16;0;1129;14
2020-08-18;JM;Jamaica;17;0;1146;14
2020-08-19;JM;Jamaica;46;0;1192;14
2020-08-20;JM;Jamaica;98;1;1290;15
2020-08-21;JM;Jamaica;56;1;1346;16
2020-08-22;JM;Jamaica;0;0;1346;16
2020-08-23;JM;Jamaica;183;0;1529;16
2020-08-24;JM;Jamaica;83;0;1612;16
2020-08-25;JM;Jamaica;120;3;1732;19
2020-08-26;JM;Jamaica;72;0;1804;19
2020-08-27;JM;Jamaica;66;0;1870;19
2020-08-28;JM;Jamaica;141;0;2011;19
2020-08-29;JM;Jamaica;102;1;2113;20
2020-08-30;JM;Jamaica;244;1;2357;21
2020-08-31;JM;Jamaica;102;0;2459;21
2020-09-01;JM;Jamaica;0;0;2459;21
2020-09-02;JM;Jamaica;224;3;2683;24
2020-09-03;JM;Jamaica;213;5;2896;29
2020-09-04;JM;Jamaica;68;1;2964;30
2020-09-05;JM;Jamaica;60;2;3024;32
2020-09-06;JM;Jamaica;79;1;3103;33
2020-09-07;JM;Jamaica;80;1;3183;34
2020-09-08;JM;Jamaica;140;2;3323;36
2020-09-09;JM;Jamaica;114;2;3437;38
2020-09-10;JM;Jamaica;74;2;3511;40
2020-09-11;JM;Jamaica;0;0;3511;40
2020-09-12;JM;Jamaica;112;0;3623;40
2020-09-13;JM;Jamaica;148;2;3771;42
2020-09-14;JM;Jamaica;162;2;3933;44
2020-09-15;JM;Jamaica;109;2;4042;46
2020-09-16;JM;Jamaica;122;0;4164;46
2020-09-17;JM;Jamaica;210;5;4374;51
2020-09-18;JM;Jamaica;197;4;4571;55
2020-09-19;JM;Jamaica;187;5;4758;60
2020-09-20;JM;Jamaica;230;7;4988;67
2020-09-21;JM;Jamaica;155;3;5143;70
2020-09-22;JM;Jamaica;127;5;5270;75
2020-09-23;JM;Jamaica;125;1;5395;76
2020-09-24;JM;Jamaica;193;1;5588;77
2020-09-25;JM;Jamaica;135;3;5723;80
2020-09-26;JM;Jamaica;131;8;5854;88
2020-09-27;JM;Jamaica;163;1;6017;89
2020-09-28;JM;Jamaica;153;4;6170;93
2020-09-29;JM;Jamaica;238;8;6408;101
2020-09-30;JM;Jamaica;74;6;6482;107
2020-10-01;JM;Jamaica;73;4;6555;111
2020-10-02;JM;Jamaica;149;5;6704;116
2020-10-03;JM;Jamaica;91;3;6795;119
2020-10-04;JM;Jamaica;100;1;6895;120
2020-10-05;JM;Jamaica;117;0;7012;120
2020-10-06;JM;Jamaica;97;3;7109;123
2020-10-07;JM;Jamaica;82;3;7191;126
2020-10-08;JM;Jamaica;82;2;7273;128
2020-10-09;JM;Jamaica;90;4;7363;132
2020-10-10;JM;Jamaica;196;6;7559;138
2020-10-11;JM;Jamaica;159;1;7718;139
2020-10-12;JM;Jamaica;95;7;7813;146
2020-10-13;JM;Jamaica;97;0;7910;146
2020-10-14;JM;Jamaica;79;5;7989;151
2020-10-15;JM;Jamaica;78;9;8067;160
2020-10-16;JM;Jamaica;65;2;8132;162
2020-10-17;JM;Jamaica;63;6;8195;168
2020-10-18;JM;Jamaica;79;3;8274;171
2020-10-19;JM;Jamaica;47;2;8321;173
2020-10-20;JM;Jamaica;53;1;8374;174
2020-10-21;JM;Jamaica;71;0;8445;174
2020-10-22;JM;Jamaica;155;5;8600;179
2020-10-23;JM;Jamaica;38;3;8638;182
2020-10-24;JM;Jamaica;32;4;8670;186
2020-10-25;JM;Jamaica;44;2;8714;188
2020-10-26;JM;Jamaica;35;4;8749;192
2020-10-27;JM;Jamaica;38;4;8787;196
2020-10-28;JM;Jamaica;64;2;8851;198
2020-10-29;JM;Jamaica;76;4;8927;202
2020-10-30;JM;Jamaica;78;3;9005;205
2020-10-31;JM;Jamaica;89;1;9094;206
2020-11-01;JM;Jamaica;37;2;9131;208
2020-11-02;JM;Jamaica;126;2;9257;210
2020-11-03;JM;Jamaica;39;4;9296;214
2020-11-04;JM;Jamaica;30;1;9326;215
2020-11-05;JM;Jamaica;47;2;9373;217
2020-11-06;JM;Jamaica;53;1;9426;218
2020-11-07;JM;Jamaica;46;0;9472;218
2020-11-08;JM;Jamaica;34;3;9506;221
2020-11-09;JM;Jamaica;36;0;9542;221
2020-11-10;JM;Jamaica;31;3;9573;224
2020-11-11;JM;Jamaica;8;1;9581;225
2020-11-12;JM;Jamaica;53;0;9634;225
2020-11-13;JM;Jamaica;89;2;9723;227
2020-11-14;JM;Jamaica;57;2;9780;229
2020-11-15;JM;Jamaica;104;2;9884;231
2020-11-16;JM;Jamaica;45;0;9929;231
2020-11-17;JM;Jamaica;30;0;9959;231
2020-11-18;JM;Jamaica;60;2;10019;233
2020-11-19;JM;Jamaica;69;2;10088;235
2020-11-20;JM;Jamaica;63;0;10151;235
2020-11-21;JM;Jamaica;89;2;10240;237
2020-11-22;JM;Jamaica;44;1;10284;238
2020-11-23;JM;Jamaica;59;1;10343;239
2020-11-24;JM;Jamaica;79;4;10422;243
2020-11-25;JM;Jamaica;66;4;10488;247
2020-11-26;JM;Jamaica;53;1;10541;248
2020-11-27;JM;Jamaica;59;2;10600;250
2020-11-28;JM;Jamaica;69;1;10669;251
2020-11-29;JM;Jamaica;40;5;10709;256
2020-11-30;JM;Jamaica;54;1;10763;257
2020-12-01;JM;Jamaica;47;1;10810;258
2020-12-02;JM;Jamaica;54;0;10864;258
2020-12-03;JM;Jamaica;47;1;10911;259
2020-12-04;JM;Jamaica;76;1;10987;260
2020-12-05;JM;Jamaica;76;1;11063;261
2020-12-06;JM;Jamaica;57;4;11120;265
2020-12-07;JM;Jamaica;64;0;11184;265
2020-12-08;JM;Jamaica;87;0;11271;265
2020-12-09;JM;Jamaica;98;1;11369;266
2020-12-10;JM;Jamaica;74;4;11443;270
2020-12-11;JM;Jamaica;66;0;11509;270
2020-12-12;JM;Jamaica;99;1;11608;271
2020-12-13;JM;Jamaica;102;2;11710;273
2020-12-14;JM;Jamaica;82;0;11792;273
2020-12-15;JM;Jamaica;83;3;11875;276
2020-12-16;JM;Jamaica;32;0;11907;276
2020-12-17;JM;Jamaica;61;3;11968;279
2020-12-18;JM;Jamaica;71;4;12039;283
2020-12-19;JM;Jamaica;96;2;12135;285
2020-12-20;JM;Jamaica;89;1;12224;286
2020-12-21;JM;Jamaica;65;0;12289;286
2020-12-22;JM;Jamaica;65;2;12354;288
2020-12-23;JM;Jamaica;69;2;12423;290
2020-12-24;JM;Jamaica;96;2;12519;292
2020-12-25;JM;Jamaica;78;2;12597;294
2020-12-26;JM;Jamaica;87;0;12684;294
2020-12-27;JM;Jamaica;39;1;12723;295
2020-12-28;JM;Jamaica;9;3;12732;298
2020-12-29;JM;Jamaica;20;0;12752;298
2020-12-30;JM;Jamaica;41;4;12793;302
2020-12-31;JM;Jamaica;34;0;12827;302
2021-01-01;JM;Jamaica;88;1;12915;303
2021-01-02;JM;Jamaica;16;0;12931;303
2021-01-03;JM;Jamaica;118;1;13049;304
2021-01-04;JM;Jamaica;154;0;13203;304
2021-01-05;JM;Jamaica;43;1;13246;305
2021-01-06;JM;Jamaica;84;1;13330;306
2021-01-07;JM;Jamaica;38;0;13368;306
2021-01-08;JM;Jamaica;43;1;13411;307
2021-01-09;JM;Jamaica;44;4;13455;311
2021-01-10;JM;Jamaica;93;1;13548;312
2021-01-11;JM;Jamaica;89;1;13637;313
2021-01-12;JM;Jamaica;123;2;13760;315
2021-01-13;JM;Jamaica;92;2;13852;317
2021-01-14;JM;Jamaica;63;5;13915;322
2021-01-15;JM;Jamaica;77;1;13992;323
2021-01-16;JM;Jamaica;104;0;14096;323
2021-01-17;JM;Jamaica;65;1;14161;324
2021-01-18;JM;Jamaica;113;2;14274;326
2021-01-19;JM;Jamaica;145;3;14419;329
2021-01-20;JM;Jamaica;68;2;14487;331
2021-01-21;JM;Jamaica;63;0;14550;331
2021-01-22;JM;Jamaica;108;1;14658;332
2021-01-23;JM;Jamaica;114;4;14772;336
2021-01-24;JM;Jamaica;107;0;14879;336
2021-01-25;JM;Jamaica;133;2;15012;338
2021-01-26;JM;Jamaica;141;1;15153;339
2021-01-27;JM;Jamaica;88;3;15241;342
2021-01-28;JM;Jamaica;194;2;15435;344
2021-01-29;JM;Jamaica;27;1;15462;345
2021-01-30;JM;Jamaica;65;3;15527;348
2021-01-31;JM;Jamaica;126;2;15653;350
2021-02-01;JM;Jamaica;125;2;15778;352
2021-02-02;JM;Jamaica;195;1;15973;353
2021-02-03;JM;Jamaica;100;2;16073;355
2021-02-04;JM;Jamaica;177;0;16250;355
2021-02-05;JM;Jamaica;263;2;16513;357
2021-02-06;JM;Jamaica;328;0;16841;357
2021-02-07;JM;Jamaica;244;1;17085;358
2021-02-08;JM;Jamaica;213;0;17298;358
2021-02-09;JM;Jamaica;403;1;17701;359
2021-02-10;JM;Jamaica;207;3;17908;362
2021-02-11;JM;Jamaica;329;1;18237;363
2021-02-12;JM;Jamaica;290;5;18527;368
2021-02-13;JM;Jamaica;303;4;18830;372
2021-02-14;JM;Jamaica;205;2;19035;374
2021-02-15;JM;Jamaica;270;4;19305;378
2021-02-16;JM;Jamaica;468;0;19773;378
2021-02-17;JM;Jamaica;243;3;20016;381
2021-02-18;JM;Jamaica;294;3;20310;384
2021-02-19;JM;Jamaica;271;7;20581;391
2021-02-20;JM;Jamaica;343;0;20924;391
2021-02-21;JM;Jamaica;458;5;21382;396
2021-02-22;JM;Jamaica;297;3;21679;399
2021-02-23;JM;Jamaica;147;6;21826;405
2021-02-24;JM;Jamaica;193;1;22019;406
2021-02-25;JM;Jamaica;248;4;22267;410
2021-02-26;JM;Jamaica;204;3;22471;413
2021-02-27;JM;Jamaica;346;4;22817;417
2021-02-28;JM;Jamaica;446;5;23263;422
2021-03-01;JM;Jamaica;336;3;23599;425
2021-03-02;JM;Jamaica;239;7;23838;432
2021-03-03;JM;Jamaica;265;3;24103;435
2021-03-04;JM;Jamaica;341;1;24444;436
2021-03-05;JM;Jamaica;332;7;24776;443
2021-03-06;JM;Jamaica;527;3;25303;446
2021-03-07;JM;Jamaica;723;7;26026;453
2021-03-08;JM;Jamaica;878;1;26904;454
2021-03-09;JM;Jamaica;561;6;27465;460
2021-03-10;JM;Jamaica;808;3;28273;463
2021-03-11;JM;Jamaica;695;12;28968;475
2021-03-12;JM;Jamaica;419;5;29387;480
2021-03-13;JM;Jamaica;525;4;29912;484
2021-03-14;JM;Jamaica;587;1;30499;485
2021-03-15;JM;Jamaica;806;7;31305;492
2021-03-16;JM;Jamaica;602;2;31907;494
2021-03-17;JM;Jamaica;821;13;32728;507
2021-03-18;JM;Jamaica;638;4;33366;511
2021-03-19;JM;Jamaica;604;8;33970;519
2021-03-20;JM;Jamaica;695;5;34665;524
2021-03-21;JM;Jamaica;673;9;35338;533
2021-03-22;JM;Jamaica;558;3;35896;536
2021-03-23;JM;Jamaica;335;6;36231;542
2021-03-24;JM;Jamaica;439;3;36670;545
2021-03-25;JM;Jamaica;458;1;37128;546
2021-03-26;JM;Jamaica;330;11;37458;557
2021-03-27;JM;Jamaica;289;9;37747;566
2021-03-28;JM;Jamaica;480;4;38227;570
2021-03-29;JM;Jamaica;287;16;38514;586
2021-03-30;JM;Jamaica;334;1;38848;587
2021-03-31;JM;Jamaica;389;9;39237;596
2021-04-01;JM;Jamaica;306;3;39543;599
2021-04-02;JM;Jamaica;424;8;39967;607
2021-04-03;JM;Jamaica;482;6;40449;613
2021-04-04;JM;Jamaica;214;2;40663;615
2021-04-05;JM;Jamaica;350;3;41013;618
2021-04-06;JM;Jamaica;315;4;41328;622
2021-04-07;JM;Jamaica;72;9;41400;631
2021-04-08;JM;Jamaica;204;15;41604;646
2021-04-09;JM;Jamaica;239;15;41843;661
2021-04-10;JM;Jamaica;276;8;42119;669
2021-04-11;JM;Jamaica;381;3;42500;672
2021-04-12;JM;Jamaica;263;4;42763;676
2021-04-13;JM;Jamaica;161;6;42924;682
2021-04-14;JM;Jamaica;130;10;43054;692
2021-04-15;JM;Jamaica;186;5;43240;697
2021-04-16;JM;Jamaica;233;16;43473;713
2021-04-17;JM;Jamaica;211;8;43684;721
2021-04-18;JM;Jamaica;206;2;43890;723
2021-04-19;JM;Jamaica;246;4;44136;727
2021-04-20;JM;Jamaica;118;11;44254;738
2021-04-21;JM;Jamaica;83;6;44337;744
2021-04-22;JM;Jamaica;165;7;44502;751
2021-04-23;JM;Jamaica;140;1;44642;752
2021-04-24;JM;Jamaica;225;4;44867;756
2021-04-25;JM;Jamaica;137;4;45004;760
2021-04-26;JM;Jamaica;141;1;45145;761
2021-04-27;JM;Jamaica;67;6;45212;767
2021-04-28;JM;Jamaica;80;3;45292;770
2021-04-29;JM;Jamaica;122;0;45414;770
2021-04-30;JM;Jamaica;164;8;45578;778
2021-05-01;JM;Jamaica;199;1;45777;779
2021-05-02;JM;Jamaica;90;5;45867;784
2021-05-03;JM;Jamaica;172;6;46039;790
2021-05-04;JM;Jamaica;48;3;46087;793
2021-05-05;JM;Jamaica;107;1;46194;794
2021-05-06;JM;Jamaica;144;4;46338;798
2021-05-07;JM;Jamaica;90;3;46428;801
2021-05-08;JM;Jamaica;160;2;46588;803
2021-05-09;JM;Jamaica;120;3;46708;806
2021-05-10;JM;Jamaica;74;3;46782;809
2021-05-11;JM;Jamaica;39;5;46821;814
2021-05-12;JM;Jamaica;101;6;46922;820
2021-05-13;JM;Jamaica;98;14;47020;834
2021-05-14;JM;Jamaica;130;4;47150;838
2021-05-15;JM;Jamaica;83;5;47233;843
2021-05-16;JM;Jamaica;86;17;47319;860
2021-05-17;JM;Jamaica;77;3;47396;863
2021-05-18;JM;Jamaica;83;15;47479;878
2021-05-19;JM;Jamaica;93;14;47572;892
2021-05-20;JM;Jamaica;100;10;47672;902
2021-05-21;JM;Jamaica;104;2;47776;904
2021-05-22;JM;Jamaica;123;8;47899;912
2021-05-23;JM;Jamaica;60;5;47959;917
2021-05-24;JM;Jamaica;95;8;48054;925
2021-05-25;JM;Jamaica;27;6;48081;931
2021-05-26;JM;Jamaica;20;3;48101;934
2021-05-27;JM;Jamaica;79;1;48180;935
2021-05-28;JM;Jamaica;108;1;48288;936
2021-05-29;JM;Jamaica;86;6;48374;942
2021-05-30;JM;Jamaica;93;3;48467;945
2021-05-31;JM;Jamaica;90;3;48557;948
2021-06-01;JM;Jamaica;37;1;48594;949
2021-06-02;JM;Jamaica;45;2;48639;951
2021-06-03;JM;Jamaica;94;0;48733;951
2021-06-04;JM;Jamaica;88;9;48821;960
2021-06-05;JM;Jamaica;80;4;48901;964
2021-06-06;JM;Jamaica;50;6;48951;970
2021-06-07;JM;Jamaica;32;1;48983;971
2021-06-08;JM;Jamaica;48;3;49031;974
2021-06-09;JM;Jamaica;59;14;49090;988
2021-06-10;JM;Jamaica;20;1;49110;989
2021-06-11;JM;Jamaica;69;1;49179;990
2021-06-12;JM;Jamaica;53;6;49232;996
2021-06-13;JM;Jamaica;45;1;49277;997
2021-06-14;JM;Jamaica;79;14;49356;1011
2021-06-15;JM;Jamaica;23;1;49379;1012
2021-06-16;JM;Jamaica;50;0;49429;1012
2021-06-17;JM;Jamaica;74;11;49503;1023
2021-06-18;JM;Jamaica;61;5;49564;1028
2021-06-19;JM;Jamaica;43;3;49607;1031
2021-06-20;JM;Jamaica;61;2;49668;1033
2021-06-21;JM;Jamaica;44;1;49712;1034
2021-06-22;JM;Jamaica;23;3;49735;1037
2021-06-23;JM;Jamaica;60;5;49795;1042
2021-06-24;JM;Jamaica;46;7;49841;1049
2021-06-25;JM;Jamaica;68;2;49909;1051
2021-06-26;JM;Jamaica;55;6;49964;1057
2021-06-27;JM;Jamaica;41;4;50005;1061
2021-06-28;JM;Jamaica;49;0;50054;1061
2021-06-29;JM;Jamaica;26;4;50080;1065
2021-06-30;JM;Jamaica;44;10;50124;1075
2021-07-01;JM;Jamaica;42;5;50166;1080
2020-01-22;JP;Japan;0;0;2;0
2020-01-23;JP;Japan;0;0;2;0
2020-01-24;JP;Japan;0;0;2;0
2020-01-25;JP;Japan;0;0;2;0
2020-01-26;JP;Japan;2;0;4;0
2020-01-27;JP;Japan;0;0;4;0
2020-01-28;JP;Japan;3;0;7;0
2020-01-29;JP;Japan;0;0;7;0
2020-01-30;JP;Japan;4;0;11;0
2020-01-31;JP;Japan;4;0;15;0
2020-02-01;JP;Japan;5;0;20;0
2020-02-02;JP;Japan;0;0;20;0
2020-02-03;JP;Japan;0;0;20;0
2020-02-04;JP;Japan;2;0;22;0
2020-02-05;JP;Japan;1;0;23;0
2020-02-06;JP;Japan;0;0;23;0
2020-02-07;JP;Japan;0;0;23;0
2020-02-08;JP;Japan;1;0;24;0
2020-02-09;JP;Japan;0;0;24;0
2020-02-10;JP;Japan;2;0;26;0
2020-02-11;JP;Japan;1;0;27;0
2020-02-12;JP;Japan;1;0;28;0
2020-02-13;JP;Japan;5;1;33;1
2020-02-14;JP;Japan;10;0;43;1
2020-02-15;JP;Japan;11;0;54;1
2020-02-16;JP;Japan;6;0;60;1
2020-02-17;JP;Japan;7;0;67;1
2020-02-18;JP;Japan;12;1;79;2
2020-02-19;JP;Japan;6;0;85;2
2020-02-20;JP;Japan;10;0;95;2
2020-02-21;JP;Japan;17;0;112;2
2020-02-22;JP;Japan;25;0;137;2
2020-02-23;JP;Japan;12;0;149;2
2020-02-24;JP;Japan;11;0;160;2
2020-02-25;JP;Japan;13;1;173;3
2020-02-26;JP;Japan;19;0;192;3
2020-02-27;JP;Japan;26;1;218;4
2020-02-28;JP;Japan;18;1;236;5
2020-02-29;JP;Japan;9;1;245;6
2020-03-01;JP;Japan;14;0;259;6
2020-03-02;JP;Japan;19;0;278;6
2020-03-03;JP;Japan;20;0;298;6
2020-03-04;JP;Japan;35;1;333;7
2020-03-05;JP;Japan;32;0;365;7
2020-03-06;JP;Japan;55;0;420;7
2020-03-07;JP;Japan;46;0;466;7
2020-03-08;JP;Japan;33;1;499;8
2020-03-09;JP;Japan;28;2;527;10
2020-03-10;JP;Japan;58;3;585;13
2020-03-11;JP;Japan;55;2;640;15
2020-03-12;JP;Japan;56;4;696;19
2020-03-13;JP;Japan;37;2;733;21
2020-03-14;JP;Japan;62;1;795;22
2020-03-15;JP;Japan;31;2;826;24
2020-03-16;JP;Japan;17;6;843;30
2020-03-17;JP;Japan;50;0;893;30
2020-03-18;JP;Japan;35;2;928;32
2020-03-19;JP;Japan;40;1;968;33
2020-03-20;JP;Japan;54;1;1022;34
2020-03-21;JP;Japan;37;2;1059;36
2020-03-22;JP;Japan;45;4;1104;40
2020-03-23;JP;Japan;40;1;1144;41
2020-03-24;JP;Japan;73;1;1217;42
2020-03-25;JP;Japan;97;3;1314;45
2020-03-26;JP;Japan;102;2;1416;47
2020-03-27;JP;Japan;114;6;1530;53
2020-03-28;JP;Japan;198;3;1728;56
2020-03-29;JP;Japan;179;7;1907;63
2020-03-30;JP;Japan;94;2;2001;65
2020-03-31;JP;Japan;254;2;2255;67
2020-04-01;JP;Japan;280;5;2535;72
2020-04-02;JP;Japan;283;3;2818;75
2020-04-03;JP;Japan;336;6;3154;81
2020-04-04;JP;Japan;371;6;3525;87
2020-04-05;JP;Japan;351;6;3876;93
2020-04-06;JP;Japan;234;3;4110;96
2020-04-07;JP;Japan;375;2;4485;98
2020-04-08;JP;Japan;535;7;5020;105
2020-04-09;JP;Japan;594;8;5614;113
2020-04-10;JP;Japan;636;12;6250;125
2020-04-11;JP;Japan;701;13;6951;138
2020-04-12;JP;Japan;522;9;7473;147
2020-04-13;JP;Japan;300;9;7773;156
2020-04-14;JP;Japan;504;14;8277;170
2020-04-15;JP;Japan;558;16;8835;186
2020-04-16;JP;Japan;563;18;9398;204
2020-04-17;JP;Japan;560;13;9958;217
2020-04-18;JP;Japan;590;19;10548;236
2020-04-19;JP;Japan;366;19;10914;255
2020-04-20;JP;Japan;344;20;11258;275
2020-04-21;JP;Japan;383;28;11641;303
2020-04-22;JP;Japan;396;20;12037;323
2020-04-23;JP;Japan;432;28;12469;351
2020-04-24;JP;Japan;385;9;12854;360
2020-04-25;JP;Japan;332;19;13186;379
2020-04-26;JP;Japan;219;16;13405;395
2020-04-27;JP;Japan;171;22;13576;417
2020-04-28;JP;Japan;284;19;13860;436
2020-04-29;JP;Japan;216;18;14076;454
2020-04-30;JP;Japan;208;27;14284;481
2020-05-01;JP;Japan;274;29;14558;510
2020-05-02;JP;Japan;303;26;14861;536
2020-05-03;JP;Japan;200;24;15061;560
2020-05-04;JP;Japan;168;22;15229;582
2020-05-05;JP;Japan;125;11;15354;593
2020-05-06;JP;Japan;101;12;15455;605
2020-05-07;JP;Japan;98;12;15553;617
2020-05-08;JP;Japan;87;17;15640;634
2020-05-09;JP;Japan;115;20;15755;654
2020-05-10;JP;Japan;69;12;15824;666
2020-05-11;JP;Japan;37;19;15861;685
2020-05-12;JP;Japan;87;22;15948;707
2020-05-13;JP;Japan;50;19;15998;726
2020-05-14;JP;Japan;98;16;16096;742
2020-05-15;JP;Japan;52;18;16148;760
2020-05-16;JP;Japan;54;18;16202;778
2020-05-17;JP;Japan;24;9;16226;787
2020-05-18;JP;Japan;33;9;16259;796
2020-05-19;JP;Japan;28;9;16287;805
2020-05-20;JP;Japan;34;13;16321;818
2020-05-21;JP;Japan;41;8;16362;826
2020-05-22;JP;Japan;23;10;16385;836
2020-05-23;JP;Japan;25;9;16410;845
2020-05-24;JP;Japan;41;7;16451;852
2020-05-25;JP;Japan;21;5;16472;857
2020-05-26;JP;Japan;30;6;16502;863
2020-05-27;JP;Japan;26;7;16528;870
2020-05-28;JP;Japan;70;11;16598;881
2020-05-29;JP;Japan;75;6;16673;887
2020-05-30;JP;Japan;43;7;16716;894
2020-05-31;JP;Japan;35;4;16751;898
2020-06-01;JP;Japan;36;1;16787;899
2020-06-02;JP;Japan;50;3;16837;902
2020-06-03;JP;Japan;30;3;16867;905
2020-06-04;JP;Japan;44;6;16911;911
2020-06-05;JP;Japan;47;5;16958;916
2020-06-06;JP;Japan;42;-1;17000;915
2020-06-07;JP;Japan;39;2;17039;917
2020-06-08;JP;Japan;21;3;17060;920
2020-06-09;JP;Japan;51;0;17111;920
2020-06-10;JP;Japan;35;2;17146;922
2020-06-11;JP;Japan;41;0;17187;922
2020-06-12;JP;Japan;63;2;17250;924
2020-06-13;JP;Japan;43;3;17293;927
2020-06-14;JP;Japan;76;0;17369;927
2020-06-15;JP;Japan;70;2;17439;929
2020-06-16;JP;Japan;45;5;17484;934
2020-06-17;JP;Japan;46;1;17530;935
2020-06-18;JP;Japan;58;0;17588;935
2020-06-19;JP;Japan;70;16;17658;951
2020-06-20;JP;Japan;67;4;17725;955
2020-06-21;JP;Japan;55;0;17780;955
2020-06-22;JP;Japan;40;0;17820;955
2020-06-23;JP;Japan;59;10;17879;965
2020-06-24;JP;Japan;84;2;17963;967
2020-06-25;JP;Japan;92;4;18055;971
2020-06-26;JP;Japan;107;0;18162;971
2020-06-27;JP;Japan;92;0;18254;971
2020-06-28;JP;Japan;112;1;18366;972
2020-06-29;JP;Japan;110;0;18476;972
2020-06-30;JP;Japan;139;0;18615;972
2020-07-01;JP;Japan;223;4;18838;976
2020-07-02;JP;Japan;217;1;19055;977
2020-07-03;JP;Japan;130;0;19185;977
2020-07-04;JP;Japan;276;0;19461;977
2020-07-05;JP;Japan;207;0;19668;977
2020-07-06;JP;Japan;180;1;19848;978
2020-07-07;JP;Japan;207;3;20055;981
2020-07-08;JP;Japan;206;1;20261;982
2020-07-09;JP;Japan;356;0;20617;982
2020-07-10;JP;Japan;427;0;21044;982
2020-07-11;JP;Japan;386;0;21430;982
2020-07-12;JP;Japan;411;1;21841;983
2020-07-13;JP;Japan;284;1;22125;984
2020-07-14;JP;Japan;312;0;22437;984
2020-07-15;JP;Japan;735;0;23172;984
2020-07-16;JP;Japan;338;1;23510;985
2020-07-17;JP;Japan;594;0;24104;985
2020-07-18;JP;Japan;842;1;24946;986
2020-07-19;JP;Japan;500;0;25446;986
2020-07-20;JP;Japan;260;2;25706;988
2020-07-21;JP;Japan;757;0;26463;988
2020-07-22;JP;Japan;673;2;27136;990
2020-07-23;JP;Japan;978;2;28114;992
2020-07-24;JP;Japan;769;2;28883;994
2020-07-25;JP;Japan;801;2;29684;996
2020-07-26;JP;Japan;864;2;30548;998
2020-07-27;JP;Japan;594;0;31142;998
2020-07-28;JP;Japan;974;3;32116;1001
2020-07-29;JP;Japan;1266;0;33382;1001
2020-07-30;JP;Japan;1762;6;35144;1007
2020-07-31;JP;Japan;1090;1;36234;1008
2020-08-01;JP;Japan;1570;4;37804;1012
2020-08-02;JP;Japan;1312;1;39116;1013
2020-08-03;JP;Japan;983;5;40099;1018
2020-08-04;JP;Japan;1248;5;41347;1023
2020-08-05;JP;Japan;1339;5;42686;1028
2020-08-06;JP;Japan;1481;6;44167;1034
2020-08-07;JP;Japan;1597;8;45764;1042
2020-08-08;JP;Japan;1578;0;47342;1042
2020-08-09;JP;Japan;1440;5;48782;1047
2020-08-10;JP;Japan;835;5;49617;1052
2020-08-11;JP;Japan;685;6;50302;1058
2020-08-12;JP;Japan;986;8;51288;1066
2020-08-13;JP;Japan;1183;7;52471;1073
2020-08-14;JP;Japan;1347;7;53818;1080
2020-08-15;JP;Japan;1233;13;55051;1093
2020-08-16;JP;Japan;1023;10;56074;1103
2020-08-17;JP;Japan;643;9;56717;1112
2020-08-18;JP;Japan;919;23;57636;1135
2020-08-19;JP;Japan;1092;13;58728;1148
2020-08-20;JP;Japan;1172;9;59900;1157
2020-08-21;JP;Japan;1049;18;60949;1175
2020-08-22;JP;Japan;967;4;61916;1179
2020-08-23;JP;Japan;742;9;62658;1188
2020-08-24;JP;Japan;500;13;63158;1201
2020-08-25;JP;Japan;730;18;63888;1219
2020-08-26;JP;Japan;891;11;64779;1230
2020-08-27;JP;Japan;874;11;65653;1241
2020-08-28;JP;Japan;846;10;66499;1251
2020-08-29;JP;Japan;854;20;67353;1271
2020-08-30;JP;Japan;605;14;67958;1285
2020-08-31;JP;Japan;438;13;68396;1298
2020-09-01;JP;Japan;627;15;69023;1313
2020-09-02;JP;Japan;596;14;69619;1327
2020-09-03;JP;Japan;659;7;70278;1334
2020-09-04;JP;Japan;588;18;70866;1352
2020-09-05;JP;Japan;601;9;71467;1361
2020-09-06;JP;Japan;451;5;71918;1366
2020-09-07;JP;Japan;295;11;72213;1377
2020-09-08;JP;Japan;511;21;72724;1398
2020-09-09;JP;Japan;540;14;73264;1412
2020-09-10;JP;Japan;652;4;73916;1416
2020-09-11;JP;Japan;642;12;74558;1428
2020-09-12;JP;Japan;648;13;75206;1441
2020-09-13;JP;Japan;440;7;75646;1448
2020-09-14;JP;Japan;268;7;75914;1455
2020-09-15;JP;Japan;532;8;76446;1463
2020-09-16;JP;Japan;551;18;76997;1481
2020-09-17;JP;Japan;491;9;77488;1490
2020-09-18;JP;Japan;573;10;78061;1500
2020-09-19;JP;Japan;601;4;78662;1504
2020-09-20;JP;Japan;480;4;79142;1508
2020-09-21;JP;Japan;320;10;79462;1518
2020-09-22;JP;Japan;311;1;79773;1519
2020-09-23;JP;Japan;236;6;80009;1525
2020-09-24;JP;Japan;481;15;80490;1540
2020-09-25;JP;Japan;564;4;81054;1544
2020-09-26;JP;Japan;649;3;81703;1547
2020-09-27;JP;Japan;483;2;82186;1549
2020-09-28;JP;Japan;298;12;82484;1561
2020-09-29;JP;Japan;538;7;83022;1568
2020-09-30;JP;Japan;569;7;83591;1575
2020-10-01;JP;Japan;653;5;84244;1580
2020-10-02;JP;Japan;524;11;84768;1591
2020-10-03;JP;Japan;577;3;85345;1594
2020-10-04;JP;Japan;401;4;85746;1598
2020-10-05;JP;Japan;281;4;86027;1602
2020-10-06;JP;Japan;513;7;86540;1609
2020-10-07;JP;Japan;499;5;87039;1614
2020-10-08;JP;Japan;640;3;87679;1617
2020-10-09;JP;Japan;588;6;88267;1623
2020-10-10;JP;Japan;695;3;88962;1626
2020-10-11;JP;Japan;438;2;89400;1628
2020-10-12;JP;Japan;252;3;89652;1631
2020-10-13;JP;Japan;501;4;90153;1635
2020-10-14;JP;Japan;541;11;90694;1646
2020-10-15;JP;Japan;708;4;91402;1650
2020-10-16;JP;Japan;642;14;92044;1664
2020-10-17;JP;Japan;626;6;92670;1670
2020-10-18;JP;Japan;428;2;93098;1672
2020-10-19;JP;Japan;310;4;93408;1676
2020-10-20;JP;Japan;487;3;93895;1679
2020-10-21;JP;Japan;620;7;94515;1686
2020-10-22;JP;Japan;619;11;95134;1697
2020-10-23;JP;Japan;734;9;95868;1706
2020-10-24;JP;Japan;731;4;96599;1710
2020-10-25;JP;Japan;496;6;97095;1716
2020-10-26;JP;Japan;408;5;97503;1721
2020-10-27;JP;Japan;643;5;98146;1726
2020-10-28;JP;Japan;731;5;98877;1731
2020-10-29;JP;Japan;797;17;99674;1748
2020-10-30;JP;Japan;776;8;100450;1756
2020-10-31;JP;Japan;877;13;101327;1769
2020-11-01;JP;Japan;616;7;101943;1776
2020-11-02;JP;Japan;488;11;102431;1787
2020-11-03;JP;Japan;878;7;103309;1794
2020-11-04;JP;Japan;619;5;103928;1799
2020-11-05;JP;Japan;1036;7;104964;1806
2020-11-06;JP;Japan;1172;4;106136;1810
2020-11-07;JP;Japan;1303;5;107439;1815
2020-11-08;JP;Japan;955;6;108394;1821
2020-11-09;JP;Japan;797;13;109191;1834
2020-11-10;JP;Japan;1296;6;110487;1840
2020-11-11;JP;Japan;1524;7;112011;1847
2020-11-12;JP;Japan;1644;7;113655;1854
2020-11-13;JP;Japan;1705;10;115360;1864
2020-11-14;JP;Japan;1753;1;117113;1865
2020-11-15;JP;Japan;1498;9;118611;1874
2020-11-16;JP;Japan;946;9;119557;1883
2020-11-17;JP;Japan;1690;12;121247;1895
2020-11-18;JP;Japan;2230;13;123477;1908
2020-11-19;JP;Japan;2382;12;125859;1920
2020-11-20;JP;Japan;2426;10;128285;1930
2020-11-21;JP;Japan;2586;2;130871;1932
2020-11-22;JP;Japan;2163;11;133034;1943
2020-11-23;JP;Japan;1520;6;134554;1949
2020-11-24;JP;Japan;1232;14;135786;1963
2020-11-25;JP;Japan;1949;20;137735;1983
2020-11-26;JP;Japan;2490;13;140225;1996
2020-11-27;JP;Japan;2553;32;142778;2028
2020-11-28;JP;Japan;2679;14;145457;2042
2020-11-29;JP;Japan;2058;15;147515;2057
2020-11-30;JP;Japan;1447;19;148962;2076
2020-12-01;JP;Japan;2014;33;150976;2109
2020-12-02;JP;Japan;2456;32;153432;2141
2020-12-03;JP;Japan;2506;33;155938;2174
2020-12-04;JP;Japan;2449;36;158387;2210
2020-12-05;JP;Japan;2483;19;160870;2229
2020-12-06;JP;Japan;2047;30;162917;2259
2020-12-07;JP;Japan;1517;40;164434;2299
2020-12-08;JP;Japan;2158;35;166592;2334
2020-12-09;JP;Japan;2837;42;169429;2376
2020-12-10;JP;Japan;2977;19;172406;2395
2020-12-11;JP;Japan;2904;51;175310;2446
2020-12-12;JP;Japan;2962;16;178272;2462
2020-12-13;JP;Japan;2367;19;180639;2481
2020-12-14;JP;Japan;1672;49;182311;2530
2020-12-15;JP;Japan;2441;51;184752;2581
2020-12-16;JP;Japan;2999;42;187751;2623
2020-12-17;JP;Japan;3199;38;190950;2661
2020-12-18;JP;Japan;2803;48;193753;2709
2020-12-19;JP;Japan;3062;40;196815;2749
2020-12-20;JP;Japan;2455;35;199270;2784
2020-12-21;JP;Japan;1804;49;201074;2833
2020-12-22;JP;Japan;2658;44;203732;2877
2020-12-23;JP;Japan;3275;64;207007;2941
2020-12-24;JP;Japan;3762;26;210769;2967
2020-12-25;JP;Japan;3806;49;214575;3016
2020-12-26;JP;Japan;3892;46;218467;3062
2020-12-27;JP;Japan;2945;38;221412;3100
2020-12-28;JP;Japan;2374;52;223786;3152
2020-12-29;JP;Japan;3629;44;227415;3196
2020-12-30;JP;Japan;3856;47;231271;3243
2020-12-31;JP;Japan;4540;49;235811;3292
2021-01-01;JP;Japan;3257;248;239068;3540
2021-01-02;JP;Japan;3029;31;242097;3571
2021-01-03;JP;Japan;3196;60;245293;3631
2021-01-04;JP;Japan;3332;48;248625;3679
2021-01-05;JP;Japan;4946;76;253571;3755
2021-01-06;JP;Japan;5950;65;259521;3820
2021-01-07;JP;Japan;7563;64;267084;3884
2021-01-08;JP;Japan;7863;78;274947;3962
2021-01-09;JP;Japan;7790;59;282737;4021
2021-01-10;JP;Japan;6081;45;288818;4066
2021-01-11;JP;Japan;4928;48;293746;4114
2021-01-12;JP;Japan;4575;64;298321;4178
2021-01-13;JP;Japan;5819;97;304140;4275
2021-01-14;JP;Japan;6594;66;310734;4341
2021-01-15;JP;Japan;7137;78;317871;4419
2021-01-16;JP;Japan;7071;56;324942;4475
2021-01-17;JP;Japan;5773;49;330715;4524
2021-01-18;JP;Japan;4890;58;335605;4582
2021-01-19;JP;Japan;5384;104;340989;4686
2021-01-20;JP;Japan;5519;92;346508;4778
2021-01-21;JP;Japan;5621;94;352129;4872
2021-01-22;JP;Japan;5045;108;357174;4980
2021-01-23;JP;Japan;4754;83;361928;5063
2021-01-24;JP;Japan;3971;56;365899;5119
2021-01-25;JP;Japan;2785;74;368684;5193
2021-01-26;JP;Japan;3861;104;372545;5297
2021-01-27;JP;Japan;3937;90;376482;5387
2021-01-28;JP;Japan;4162;113;380644;5500
2021-01-29;JP;Japan;3536;97;384180;5597
2021-01-30;JP;Japan;3319;91;387499;5688
2021-01-31;JP;Japan;2667;65;390166;5753
2021-02-01;JP;Japan;1790;80;391956;5833
2021-02-02;JP;Japan;2313;119;394269;5952
2021-02-03;JP;Japan;2631;116;396900;6068
2021-02-04;JP;Japan;2592;104;399492;6172
2021-02-05;JP;Japan;2366;106;401858;6278
2021-02-06;JP;Japan;2270;94;404128;6372
2021-02-07;JP;Japan;1637;52;405765;6424
2021-02-08;JP;Japan;1227;83;406992;6507
2021-02-09;JP;Japan;1558;95;408550;6602
2021-02-10;JP;Japan;1884;121;410434;6723
2021-02-11;JP;Japan;1691;77;412125;6800
2021-02-12;JP;Japan;1316;63;413441;6863
2021-02-13;JP;Japan;1362;65;414803;6928
2021-02-14;JP;Japan;1351;38;416154;6966
2021-02-15;JP;Japan;973;72;417127;7038
2021-02-16;JP;Japan;1308;101;418435;7139
2021-02-17;JP;Japan;1461;79;419896;7218
2021-02-18;JP;Japan;1525;76;421421;7294
2021-02-19;JP;Japan;1297;66;422718;7360
2021-02-20;JP;Japan;1234;78;423952;7438
2021-02-21;JP;Japan;1036;47;424988;7485
2021-02-22;JP;Japan;737;56;425725;7541
2021-02-23;JP;Japan;1103;54;426828;7595
2021-02-24;JP;Japan;904;69;427732;7664
2021-02-25;JP;Japan;1084;74;428816;7738
2021-02-26;JP;Japan;1057;80;429873;7818
2021-02-27;JP;Japan;1220;41;431093;7859
2021-02-28;JP;Japan;997;30;432090;7889
2021-03-01;JP;Japan;688;51;432778;7940
2021-03-02;JP;Japan;922;65;433700;8005
2021-03-03;JP;Japan;1244;63;434944;8068
2021-03-04;JP;Japan;1149;67;436093;8135
2021-03-05;JP;Japan;1129;55;437222;8190
2021-03-06;JP;Japan;412;6;437634;8196
2021-03-07;JP;Japan;1722;59;439356;8255
2021-03-08;JP;Japan;621;46;439977;8301
2021-03-09;JP;Japan;1175;58;441152;8359
2021-03-10;JP;Japan;1259;53;442411;8412
2021-03-11;JP;Japan;1303;45;443714;8457
2021-03-12;JP;Japan;1263;58;444977;8515
2021-03-13;JP;Japan;1335;51;446312;8566
2021-03-14;JP;Japan;975;21;447287;8587
2021-03-15;JP;Japan;713;38;448000;8625
2021-03-16;JP;Japan;1142;57;449142;8682
2021-03-17;JP;Japan;1545;36;450687;8718
2021-03-18;JP;Japan;1460;32;452147;8750
2021-03-19;JP;Japan;1469;33;453616;8783
2021-03-20;JP;Japan;1596;19;455212;8802
2021-03-21;JP;Japan;1106;19;456318;8821
2021-03-22;JP;Japan;786;36;457104;8857
2021-03-23;JP;Japan;1517;51;458621;8908
2021-03-24;JP;Japan;1974;21;460595;8929
2021-03-25;JP;Japan;1911;27;462506;8956
2021-03-26;JP;Japan;1977;33;464483;8989
2021-03-27;JP;Japan;2080;32;466563;9021
2021-03-28;JP;Japan;1783;29;468346;9050
2021-03-29;JP;Japan;1290;29;469636;9079
2021-03-30;JP;Japan;2141;33;471777;9112
2021-03-31;JP;Japan;2864;43;474641;9155
2021-04-01;JP;Japan;2598;18;477239;9173
2021-04-02;JP;Japan;2714;18;479953;9191
2021-04-03;JP;Japan;2751;7;482704;9198
2021-04-04;JP;Japan;2522;12;485226;9210
2021-04-05;JP;Japan;1566;19;486792;9229
2021-04-06;JP;Japan;2615;22;489407;9251
2021-04-07;JP;Japan;3453;35;492860;9286
2021-04-08;JP;Japan;3491;25;496351;9311
2021-04-09;JP;Japan;3480;14;499831;9325
2021-04-10;JP;Japan;3706;27;503537;9352
2021-04-11;JP;Japan;2700;17;506237;9369
2021-04-12;JP;Japan;2113;24;508350;9393
2021-04-13;JP;Japan;3449;29;511799;9422
2021-04-14;JP;Japan;5482;49;517281;9471
2021-04-15;JP;Japan;4515;35;521796;9506
2021-04-16;JP;Japan;4511;46;526307;9552
2021-04-17;JP;Japan;4802;41;531109;9593
2021-04-18;JP;Japan;4111;17;535220;9610
2021-04-19;JP;Japan;2274;19;537494;9629
2021-04-20;JP;Japan;4973;53;542467;9682
2021-04-21;JP;Japan;5369;55;547836;9737
2021-04-22;JP;Japan;5526;41;553362;9778
2021-04-23;JP;Japan;5014;56;558376;9834
2021-04-24;JP;Japan;5622;56;563998;9890
2021-04-25;JP;Japan;4623;49;568621;9939
2021-04-26;JP;Japan;3283;29;571904;9968
2021-04-27;JP;Japan;4966;63;576870;10031
2021-04-28;JP;Japan;3796;21;580666;10052
2021-04-29;JP;Japan;7914;108;588580;10160
2021-04-30;JP;Japan;4684;39;593264;10199
2021-05-01;JP;Japan;5989;82;599253;10281
2021-05-02;JP;Japan;5897;61;605150;10342
2021-05-03;JP;Japan;4475;49;609625;10391
2021-05-04;JP;Japan;4197;50;613822;10441
2021-05-05;JP;Japan;4068;60;617890;10501
2021-05-06;JP;Japan;4383;65;622273;10566
2021-05-07;JP;Japan;6046;146;628319;10712
2021-05-08;JP;Japan;7249;84;635568;10796
2021-05-09;JP;Japan;6578;64;642146;10860
2021-05-10;JP;Japan;4857;71;647003;10931
2021-05-11;JP;Japan;6360;114;653363;11045
2021-05-12;JP;Japan;7521;103;660884;11148
2021-05-13;JP;Japan;6367;101;667251;11249
2021-05-14;JP;Japan;6288;81;673539;11330
2021-05-15;JP;Japan;6331;94;679870;11424
2021-05-16;JP;Japan;5265;47;685135;11471
2021-05-17;JP;Japan;3738;116;688873;11587
2021-05-18;JP;Japan;5204;216;694077;11803
2021-05-19;JP;Japan;5854;97;699931;11900
2021-05-20;JP;Japan;5710;106;705641;12006
2021-05-21;JP;Japan;5254;113;710895;12119
2021-05-22;JP;Japan;4985;84;715880;12203
2021-05-23;JP;Japan;4045;62;719925;12265
2021-05-24;JP;Japan;2743;86;722668;12351
2021-05-25;JP;Japan;3918;106;726586;12457
2021-05-26;JP;Japan;4485;116;731071;12573
2021-05-27;JP;Japan;4163;118;735234;12691
2021-05-28;JP;Japan;3701;95;738935;12786
2021-05-29;JP;Japan;3604;91;742539;12877
2021-05-30;JP;Japan;2853;49;745392;12926
2021-05-31;JP;Japan;1796;80;747188;13006
2021-06-01;JP;Japan;2641;101;749829;13107
2021-06-02;JP;Japan;3036;113;752865;13220
2021-06-03;JP;Japan;2848;111;755713;13331
2021-06-04;JP;Japan;2577;86;758290;13417
2021-06-05;JP;Japan;2663;64;760953;13481
2021-06-06;JP;Japan;2027;50;762980;13531
2021-06-07;JP;Japan;1205;75;764185;13606
2021-06-08;JP;Japan;1883;99;766068;13705
2021-06-09;JP;Japan;2245;96;768313;13801
2021-06-10;JP;Japan;2044;71;770357;13872
2021-06-11;JP;Japan;1936;64;772293;13936
2021-06-12;JP;Japan;1947;55;774240;13991
2021-06-13;JP;Japan;1384;32;775624;14023
2021-06-14;JP;Japan;941;60;776565;14083
2021-06-15;JP;Japan;1414;67;777979;14150
2021-06-16;JP;Japan;1717;80;779696;14230
2021-06-17;JP;Japan;1545;47;781241;14277
2021-06-18;JP;Japan;1636;48;782877;14325
2021-06-19;JP;Japan;1507;28;784384;14353
2021-06-20;JP;Japan;1318;20;785702;14373
2021-06-21;JP;Japan;864;35;786566;14408
2021-06-22;JP;Japan;1443;43;788009;14451
2021-06-23;JP;Japan;1778;58;789787;14509
2021-06-24;JP;Japan;1665;42;791452;14551
2021-06-25;JP;Japan;1727;31;793179;14582
2021-06-26;JP;Japan;1626;29;794805;14611
2021-06-27;JP;Japan;1272;10;796077;14621
2021-06-28;JP;Japan;1007;38;797084;14659
2021-06-29;JP;Japan;1401;30;798485;14689
2021-06-30;JP;Japan;1820;41;800305;14730
2021-07-01;JP;Japan;1733;24;802038;14754
2021-03-14;JE;Jersey;0;0;0;0
2021-03-15;JE;Jersey;0;0;0;0
2021-03-16;JE;Jersey;0;0;0;0
2021-03-17;JE;Jersey;0;0;0;0
2021-03-18;JE;Jersey;0;0;0;0
2021-03-19;JE;Jersey;0;0;0;0
2021-03-20;JE;Jersey;0;0;0;0
2021-03-21;JE;Jersey;0;0;0;0
2021-03-22;JE;Jersey;0;0;0;0
2021-03-23;JE;Jersey;0;0;0;0
2021-03-24;JE;Jersey;0;0;0;0
2021-03-25;JE;Jersey;0;0;0;0
2021-03-26;JE;Jersey;0;0;0;0
2021-03-27;JE;Jersey;0;0;0;0
2021-03-28;JE;Jersey;0;0;0;0
2021-03-29;JE;Jersey;0;0;0;0
2021-03-30;JE;Jersey;0;0;0;0
2021-03-31;JE;Jersey;0;0;0;0
2021-04-01;JE;Jersey;0;0;0;0
2021-04-02;JE;Jersey;0;0;0;0
2021-04-03;JE;Jersey;0;0;0;0
2021-04-04;JE;Jersey;0;0;0;0
2021-04-05;JE;Jersey;0;0;0;0
2021-04-06;JE;Jersey;0;0;0;0
2021-04-07;JE;Jersey;0;0;0;0
2021-04-08;JE;Jersey;0;0;0;0
2021-04-09;JE;Jersey;0;0;0;0
2021-04-10;JE;Jersey;0;0;0;0
2021-04-11;JE;Jersey;0;0;0;0
2021-04-12;JE;Jersey;0;0;0;0
2021-04-13;JE;Jersey;0;0;0;0
2021-04-14;JE;Jersey;0;0;0;0
2021-04-15;JE;Jersey;0;0;0;0
2021-04-16;JE;Jersey;0;0;0;0
2021-04-17;JE;Jersey;0;0;0;0
2021-04-18;JE;Jersey;0;0;0;0
2021-04-19;JE;Jersey;0;0;0;0
2021-04-20;JE;Jersey;0;0;0;0
2021-04-21;JE;Jersey;0;0;0;0
2021-04-22;JE;Jersey;0;0;0;0
2021-04-23;JE;Jersey;0;0;0;0
2021-04-24;JE;Jersey;0;0;0;0
2021-04-25;JE;Jersey;0;0;0;0
2021-04-26;JE;Jersey;0;0;0;0
2021-04-27;JE;Jersey;0;0;0;0
2021-04-28;JE;Jersey;0;0;0;0
2021-04-29;JE;Jersey;0;0;0;0
2021-04-30;JE;Jersey;0;0;0;0
2021-05-01;JE;Jersey;0;0;0;0
2021-05-02;JE;Jersey;0;0;0;0
2021-05-03;JE;Jersey;0;0;0;0
2021-05-04;JE;Jersey;0;0;0;0
2021-05-05;JE;Jersey;0;0;0;0
2021-05-06;JE;Jersey;0;0;0;0
2021-05-07;JE;Jersey;0;0;0;0
2021-05-08;JE;Jersey;0;0;0;0
2021-05-09;JE;Jersey;0;0;0;0
2021-05-10;JE;Jersey;0;0;0;0
2021-05-11;JE;Jersey;0;0;0;0
2021-05-12;JE;Jersey;0;0;0;0
2021-05-13;JE;Jersey;0;0;0;0
2021-05-14;JE;Jersey;0;0;0;0
2021-05-15;JE;Jersey;0;0;0;0
2021-05-16;JE;Jersey;0;0;0;0
2021-05-17;JE;Jersey;0;0;0;0
2021-05-18;JE;Jersey;0;0;0;0
2021-05-19;JE;Jersey;0;0;0;0
2021-05-20;JE;Jersey;0;0;0;0
2021-05-21;JE;Jersey;0;0;0;0
2021-05-22;JE;Jersey;0;0;0;0
2021-05-23;JE;Jersey;0;0;0;0
2021-05-24;JE;Jersey;0;0;0;0
2021-05-25;JE;Jersey;0;0;0;0
2021-05-26;JE;Jersey;0;0;0;0
2021-05-27;JE;Jersey;0;0;0;0
2021-05-28;JE;Jersey;0;0;0;0
2021-05-29;JE;Jersey;0;0;0;0
2021-05-30;JE;Jersey;0;0;0;0
2021-05-31;JE;Jersey;0;0;0;0
2021-06-01;JE;Jersey;0;0;0;0
2021-06-02;JE;Jersey;0;0;0;0
2021-06-03;JE;Jersey;0;0;0;0
2021-06-04;JE;Jersey;0;0;0;0
2021-06-05;JE;Jersey;0;0;0;0
2021-06-06;JE;Jersey;0;0;0;0
2021-06-07;JE;Jersey;0;0;0;0
2021-06-08;JE;Jersey;0;0;0;0
2021-06-09;JE;Jersey;0;0;0;0
2021-06-10;JE;Jersey;0;0;0;0
2021-06-11;JE;Jersey;0;0;0;0
2021-06-12;JE;Jersey;0;0;0;0
2021-06-13;JE;Jersey;0;0;0;0
2021-06-14;JE;Jersey;0;0;0;0
2021-06-15;JE;Jersey;0;0;0;0
2021-06-16;JE;Jersey;0;0;0;0
2021-06-17;JE;Jersey;0;0;0;0
2021-06-18;JE;Jersey;0;0;0;0
2021-06-19;JE;Jersey;0;0;0;0
2021-06-20;JE;Jersey;0;0;0;0
2021-06-21;JE;Jersey;0;0;0;0
2021-06-22;JE;Jersey;0;0;0;0
2021-06-23;JE;Jersey;0;0;0;0
2021-06-24;JE;Jersey;0;0;0;0
2021-06-25;JE;Jersey;0;0;0;0
2021-06-26;JE;Jersey;0;0;0;0
2021-06-27;JE;Jersey;0;0;0;0
2020-03-03;JO;Jordan;1;0;1;0
2020-03-04;JO;Jordan;0;0;1;0
2020-03-05;JO;Jordan;0;0;1;0
2020-03-06;JO;Jordan;0;0;1;0
2020-03-07;JO;Jordan;0;0;1;0
2020-03-08;JO;Jordan;0;0;1;0
2020-03-09;JO;Jordan;0;0;1;0
2020-03-10;JO;Jordan;0;0;1;0
2020-03-11;JO;Jordan;0;0;1;0
2020-03-12;JO;Jordan;0;0;1;0
2020-03-13;JO;Jordan;0;0;1;0
2020-03-14;JO;Jordan;0;0;1;0
2020-03-15;JO;Jordan;7;0;8;0
2020-03-16;JO;Jordan;9;0;17;0
2020-03-17;JO;Jordan;17;0;34;0
2020-03-18;JO;Jordan;18;0;52;0
2020-03-19;JO;Jordan;17;0;69;0
2020-03-20;JO;Jordan;16;0;85;0
2020-03-21;JO;Jordan;0;0;85;0
2020-03-22;JO;Jordan;27;0;112;0
2020-03-23;JO;Jordan;15;0;127;0
2020-03-24;JO;Jordan;27;0;154;0
2020-03-25;JO;Jordan;18;0;172;0
2020-03-26;JO;Jordan;40;0;212;0
2020-03-27;JO;Jordan;23;1;235;1
2020-03-28;JO;Jordan;11;0;246;1
2020-03-29;JO;Jordan;13;2;259;3
2020-03-30;JO;Jordan;9;2;268;5
2020-03-31;JO;Jordan;6;0;274;5
2020-04-01;JO;Jordan;4;0;278;5
2020-04-02;JO;Jordan;21;0;299;5
2020-04-03;JO;Jordan;11;0;310;5
2020-04-04;JO;Jordan;13;0;323;5
2020-04-05;JO;Jordan;22;0;345;5
2020-04-06;JO;Jordan;4;1;349;6
2020-04-07;JO;Jordan;4;0;353;6
2020-04-08;JO;Jordan;5;0;358;6
2020-04-09;JO;Jordan;14;1;372;7
2020-04-10;JO;Jordan;0;0;372;7
2020-04-11;JO;Jordan;9;0;381;7
2020-04-12;JO;Jordan;8;0;389;7
2020-04-13;JO;Jordan;2;0;391;7
2020-04-14;JO;Jordan;6;0;397;7
2020-04-15;JO;Jordan;4;0;401;7
2020-04-16;JO;Jordan;1;0;402;7
2020-04-17;JO;Jordan;5;0;407;7
2020-04-18;JO;Jordan;6;0;413;7
2020-04-19;JO;Jordan;4;0;417;7
2020-04-20;JO;Jordan;8;0;425;7
2020-04-21;JO;Jordan;3;0;428;7
2020-04-22;JO;Jordan;7;0;435;7
2020-04-23;JO;Jordan;2;0;437;7
2020-04-24;JO;Jordan;4;0;441;7
2020-04-25;JO;Jordan;3;0;444;7
2020-04-26;JO;Jordan;3;0;447;7
2020-04-27;JO;Jordan;2;0;449;7
2020-04-28;JO;Jordan;0;1;449;8
2020-04-29;JO;Jordan;2;0;451;8
2020-04-30;JO;Jordan;2;0;453;8
2020-05-01;JO;Jordan;6;0;459;8
2020-05-02;JO;Jordan;1;1;460;9
2020-05-03;JO;Jordan;1;0;461;9
2020-05-04;JO;Jordan;4;0;465;9
2020-05-05;JO;Jordan;6;0;471;9
2020-05-06;JO;Jordan;2;0;473;9
2020-05-07;JO;Jordan;21;0;494;9
2020-05-08;JO;Jordan;14;0;508;9
2020-05-09;JO;Jordan;14;0;522;9
2020-05-10;JO;Jordan;18;0;540;9
2020-05-11;JO;Jordan;22;0;562;9
2020-05-12;JO;Jordan;14;0;576;9
2020-05-13;JO;Jordan;6;0;582;9
2020-05-14;JO;Jordan;4;0;586;9
2020-05-15;JO;Jordan;10;0;596;9
2020-05-16;JO;Jordan;11;0;607;9
2020-05-17;JO;Jordan;6;0;613;9
2020-05-18;JO;Jordan;16;0;629;9
2020-05-19;JO;Jordan;20;0;649;9
2020-05-20;JO;Jordan;23;0;672;9
2020-05-21;JO;Jordan;12;0;684;9
2020-05-22;JO;Jordan;16;0;700;9
2020-05-23;JO;Jordan;4;0;704;9
2020-05-24;JO;Jordan;4;0;708;9
2020-05-25;JO;Jordan;3;0;711;9
2020-05-26;JO;Jordan;7;0;718;9
2020-05-27;JO;Jordan;2;0;720;9
2020-05-28;JO;Jordan;8;0;728;9
2020-05-29;JO;Jordan;2;0;730;9
2020-05-30;JO;Jordan;4;0;734;9
2020-05-31;JO;Jordan;5;0;739;9
2020-06-01;JO;Jordan;7;0;746;9
2020-06-02;JO;Jordan;9;0;755;9
2020-06-03;JO;Jordan;2;0;757;9
2020-06-04;JO;Jordan;8;0;765;9
2020-06-05;JO;Jordan;19;0;784;9
2020-06-06;JO;Jordan;11;0;795;9
2020-06-07;JO;Jordan;13;0;808;9
2020-06-08;JO;Jordan;23;0;831;9
2020-06-09;JO;Jordan;14;0;845;9
2020-06-10;JO;Jordan;18;0;863;9
2020-06-11;JO;Jordan;27;0;890;9
2020-06-12;JO;Jordan;25;0;915;9
2020-06-13;JO;Jordan;38;0;953;9
2020-06-14;JO;Jordan;8;0;961;9
2020-06-15;JO;Jordan;18;0;979;9
2020-06-16;JO;Jordan;2;0;981;9
2020-06-17;JO;Jordan;6;0;987;9
2020-06-18;JO;Jordan;14;0;1001;9
2020-06-19;JO;Jordan;7;0;1008;9
2020-06-20;JO;Jordan;7;0;1015;9
2020-06-21;JO;Jordan;18;0;1033;9
2020-06-22;JO;Jordan;9;0;1042;9
2020-06-23;JO;Jordan;5;0;1047;9
2020-06-24;JO;Jordan;24;0;1071;9
2020-06-25;JO;Jordan;15;0;1086;9
2020-06-26;JO;Jordan;18;0;1104;9
2020-06-27;JO;Jordan;7;0;1111;9
2020-06-28;JO;Jordan;10;0;1121;9
2020-06-29;JO;Jordan;7;0;1128;9
2020-06-30;JO;Jordan;4;0;1132;9
2020-07-01;JO;Jordan;1;0;1133;9
2020-07-02;JO;Jordan;3;0;1136;9
2020-07-03;JO;Jordan;11;1;1147;10
2020-07-04;JO;Jordan;3;0;1150;10
2020-07-05;JO;Jordan;14;0;1164;10
2020-07-06;JO;Jordan;3;0;1167;10
2020-07-07;JO;Jordan;2;0;1169;10
2020-07-08;JO;Jordan;0;0;1169;10
2020-07-09;JO;Jordan;0;0;1169;10
2020-07-10;JO;Jordan;4;0;1173;10
2020-07-11;JO;Jordan;3;0;1176;10
2020-07-12;JO;Jordan;3;0;1179;10
2020-07-13;JO;Jordan;4;0;1183;10
2020-07-14;JO;Jordan;15;0;1198;10
2020-07-15;JO;Jordan;3;0;1201;10
2020-07-16;JO;Jordan;5;0;1206;10
2020-07-17;JO;Jordan;3;0;1209;10
2020-07-18;JO;Jordan;5;1;1214;11
2020-07-19;JO;Jordan;4;0;1218;11
2020-07-20;JO;Jordan;5;0;1223;11
2020-07-21;JO;Jordan;-110;0;1113;11
2020-07-22;JO;Jordan;7;0;1120;11
2020-07-23;JO;Jordan;11;0;1131;11
2020-07-24;JO;Jordan;15;0;1146;11
2020-07-25;JO;Jordan;8;0;1154;11
2020-07-26;JO;Jordan;14;0;1168;11
2020-07-27;JO;Jordan;8;0;1176;11
2020-07-28;JO;Jordan;6;0;1182;11
2020-07-29;JO;Jordan;5;0;1187;11
2020-07-30;JO;Jordan;4;0;1191;11
2020-07-31;JO;Jordan;2;0;1193;11
2020-08-01;JO;Jordan;15;0;1208;11
2020-08-02;JO;Jordan;5;0;1213;11
2020-08-03;JO;Jordan;5;0;1218;11
2020-08-04;JO;Jordan;6;0;1224;11
2020-08-05;JO;Jordan;7;0;1231;11
2020-08-06;JO;Jordan;1;0;1232;11
2020-08-07;JO;Jordan;5;0;1237;11
2020-08-08;JO;Jordan;9;0;1246;11
2020-08-09;JO;Jordan;6;0;1252;11
2020-08-10;JO;Jordan;16;0;1268;11
2020-08-11;JO;Jordan;15;0;1283;11
2020-08-12;JO;Jordan;20;0;1303;11
2020-08-13;JO;Jordan;17;0;1320;11
2020-08-14;JO;Jordan;9;0;1329;11
2020-08-15;JO;Jordan;10;0;1339;11
2020-08-16;JO;Jordan;39;0;1378;11
2020-08-17;JO;Jordan;20;0;1398;11
2020-08-18;JO;Jordan;40;0;1438;11
2020-08-19;JO;Jordan;44;0;1482;11
2020-08-20;JO;Jordan;16;0;1498;11
2020-08-21;JO;Jordan;34;0;1532;11
2020-08-22;JO;Jordan;44;0;1576;11
2020-08-23;JO;Jordan;33;1;1609;12
2020-08-24;JO;Jordan;30;2;1639;14
2020-08-25;JO;Jordan;77;0;1716;14
2020-08-26;JO;Jordan;40;1;1756;15
2020-08-27;JO;Jordan;45;0;1801;15
2020-08-28;JO;Jordan;68;0;1869;15
2020-08-29;JO;Jordan;24;0;1893;15
2020-08-30;JO;Jordan;73;0;1966;15
2020-08-31;JO;Jordan;68;0;2034;15
2020-09-01;JO;Jordan;63;0;2097;15
2020-09-02;JO;Jordan;64;0;2161;15
2020-09-03;JO;Jordan;72;0;2233;15
2020-09-04;JO;Jordan;68;1;2301;16
2020-09-05;JO;Jordan;52;0;2353;16
2020-09-06;JO;Jordan;58;0;2411;16
2020-09-07;JO;Jordan;67;1;2478;17
2020-09-08;JO;Jordan;103;2;2581;19
2020-09-09;JO;Jordan;78;0;2659;19
2020-09-10;JO;Jordan;80;1;2739;20
2020-09-11;JO;Jordan;206;1;2945;21
2020-09-12;JO;Jordan;117;1;3062;22
2020-09-13;JO;Jordan;252;2;3314;24
2020-09-14;JO;Jordan;214;2;3528;26
2020-09-15;JO;Jordan;149;0;3677;26
2020-09-16;JO;Jordan;175;0;3852;26
2020-09-17;JO;Jordan;279;0;4131;26
2020-09-18;JO;Jordan;213;3;4344;29
2020-09-19;JO;Jordan;196;1;4540;30
2020-09-20;JO;Jordan;239;0;4779;30
2020-09-21;JO;Jordan;266;2;5045;32
2020-09-22;JO;Jordan;634;1;5679;33
2020-09-23;JO;Jordan;363;2;6042;35
2020-09-24;JO;Jordan;549;1;6591;36
2020-09-25;JO;Jordan;620;3;7211;39
2020-09-26;JO;Jordan;850;4;8061;43
2020-09-27;JO;Jordan;431;2;8492;45
2020-09-28;JO;Jordan;734;6;9226;51
2020-09-29;JO;Jordan;823;6;10049;57
2020-09-30;JO;Jordan;1776;4;11825;61
2020-10-01;JO;Jordan;1276;8;13101;69
2020-10-02;JO;Jordan;549;10;13650;79
2020-10-03;JO;Jordan;1099;9;14749;88
2020-10-04;JO;Jordan;891;13;15640;101
2020-10-05;JO;Jordan;1824;9;17464;110
2020-10-06;JO;Jordan;1537;12;19001;122
2020-10-07;JO;Jordan;1199;9;20200;131
2020-10-08;JO;Jordan;1317;13;21517;144
2020-10-09;JO;Jordan;1246;22;22763;166
2020-10-10;JO;Jordan;1235;15;23998;181
2020-10-11;JO;Jordan;928;10;24926;191
2020-10-12;JO;Jordan;1147;16;26073;207
2020-10-13;JO;Jordan;2054;18;28127;225
2020-10-14;JO;Jordan;2423;32;30550;257
2020-10-15;JO;Jordan;2459;25;33009;282
2020-10-16;JO;Jordan;1539;28;34548;310
2020-10-17;JO;Jordan;1505;20;36053;330
2020-10-18;JO;Jordan;1520;15;37573;345
2020-10-19;JO;Jordan;1364;35;38937;380
2020-10-20;JO;Jordan;2035;34;40972;414
2020-10-21;JO;Jordan;2648;29;43620;443
2020-10-22;JO;Jordan;2821;38;46441;481
2020-10-23;JO;Jordan;2489;27;48930;508
2020-10-24;JO;Jordan;1820;32;50750;540
2020-10-25;JO;Jordan;2337;39;53087;579
2020-10-26;JO;Jordan;1968;45;55055;624
2020-10-27;JO;Jordan;3800;44;58855;668
2020-10-28;JO;Jordan;3087;32;61942;700
2020-10-29;JO;Jordan;3443;40;65385;740
2020-10-30;JO;Jordan;3921;32;69306;772
2020-10-31;JO;Jordan;3301;57;72607;829
2020-11-01;JO;Jordan;3259;37;75866;866
2020-11-02;JO;Jordan;5877;47;81743;913
2020-11-03;JO;Jordan;4833;54;86576;967
2020-11-04;JO;Jordan;4658;62;91234;1029
2020-11-05;JO;Jordan;4630;40;95864;1069
2020-11-06;JO;Jordan;5384;67;101248;1136
2020-11-07;JO;Jordan;3554;45;104802;1181
2020-11-08;JO;Jordan;4519;52;109321;1233
2020-11-09;JO;Jordan;5665;62;114986;1295
2020-11-10;JO;Jordan;5996;91;120982;1386
2020-11-11;JO;Jordan;5419;81;126401;1467
2020-11-12;JO;Jordan;5685;80;132086;1547
2020-11-13;JO;Jordan;4469;71;136555;1618
2020-11-14;JO;Jordan;4750;86;141305;1704
2020-11-15;JO;Jordan;2373;68;143678;1772
2020-11-16;JO;Jordan;5861;71;149539;1843
2020-11-17;JO;Jordan;6454;66;155993;1909
2020-11-18;JO;Jordan;7933;60;163926;1969
2020-11-19;JO;Jordan;5469;84;169395;2053
2020-11-20;JO;Jordan;4940;63;174335;2116
2020-11-21;JO;Jordan;3826;56;178161;2172
2020-11-22;JO;Jordan;5268;64;183429;2236
2020-11-23;JO;Jordan;4981;66;188410;2302
2020-11-24;JO;Jordan;4586;78;192996;2380
2020-11-25;JO;Jordan;5025;62;198021;2442
2020-11-26;JO;Jordan;5000;67;203021;2509
2020-11-27;JO;Jordan;4580;61;207601;2570
2020-11-28;JO;Jordan;3108;56;210709;2626
2020-11-29;JO;Jordan;3598;68;214307;2694
2020-11-30;JO;Jordan;5123;57;219430;2751
2020-12-01;JO;Jordan;4187;51;223617;2802
2020-12-02;JO;Jordan;3591;52;227208;2854
2020-12-03;JO;Jordan;4029;55;231237;2909
2020-12-04;JO;Jordan;3116;51;234353;2960
2020-12-05;JO;Jordan;3160;50;237513;3010
2020-12-06;JO;Jordan;2576;46;240089;3056
2020-12-07;JO;Jordan;3980;60;244069;3116
2020-12-08;JO;Jordan;3062;46;247131;3162
2020-12-09;JO;Jordan;3088;44;250219;3206
2020-12-10;JO;Jordan;2902;44;253121;3250
2020-12-11;JO;Jordan;2338;36;255459;3286
2020-12-12;JO;Jordan;1816;49;257275;3335
2020-12-13;JO;Jordan;2339;30;259614;3365
2020-12-14;JO;Jordan;2863;42;262477;3407
2020-12-15;JO;Jordan;2547;30;265024;3437
2020-12-16;JO;Jordan;2561;28;267585;3465
2020-12-17;JO;Jordan;2221;31;269806;3496
2020-12-18;JO;Jordan;1708;22;271514;3518
2020-12-19;JO;Jordan;1283;27;272797;3545
2020-12-20;JO;Jordan;2152;23;274949;3568
2020-12-21;JO;Jordan;2499;36;277448;3604
2020-12-22;JO;Jordan;2444;23;279892;3627
2020-12-23;JO;Jordan;2091;25;281983;3652
2020-12-24;JO;Jordan;1707;29;283690;3681
2020-12-25;JO;Jordan;1616;30;285306;3711
2020-12-26;JO;Jordan;1050;18;286356;3729
2020-12-27;JO;Jordan;1590;29;287946;3758
2020-12-28;JO;Jordan;1802;20;289748;3778
2020-12-29;JO;Jordan;1645;23;291393;3801
2020-12-30;JO;Jordan;1674;14;293067;3815
2020-12-31;JO;Jordan;1427;19;294494;3834
2021-01-01;JO;Jordan;1271;17;295765;3851
2021-01-02;JO;Jordan;903;26;296668;3877
2021-01-03;JO;Jordan;1540;26;298208;3903
2021-01-04;JO;Jordan;1623;16;299831;3919
2021-01-05;JO;Jordan;1472;21;301303;3940
2021-01-06;JO;Jordan;1553;15;302856;3955
2021-01-07;JO;Jordan;1215;13;304071;3968
2021-01-08;JO;Jordan;1092;21;305163;3989
2021-01-09;JO;Jordan;796;20;305959;4009
2021-01-10;JO;Jordan;1250;15;307209;4024
2021-01-11;JO;Jordan;1461;19;308670;4043
2021-01-12;JO;Jordan;1176;33;309846;4076
2021-01-13;JO;Jordan;1122;15;310968;4091
2021-01-14;JO;Jordan;1075;16;312043;4107
2021-01-15;JO;Jordan;808;14;312851;4121
2021-01-16;JO;Jordan;706;16;313557;4137
2021-01-17;JO;Jordan;957;8;314514;4145
2021-01-18;JO;Jordan;1030;8;315544;4153
2021-01-19;JO;Jordan;883;17;316427;4170
2021-01-20;JO;Jordan;978;17;317405;4187
2021-01-21;JO;Jordan;776;11;318181;4198
2021-01-22;JO;Jordan;730;9;318911;4207
2021-01-23;JO;Jordan;608;10;319519;4217
2021-01-24;JO;Jordan;934;7;320453;4224
2021-01-25;JO;Jordan;845;15;321298;4239
2021-01-26;JO;Jordan;943;9;322241;4248
2021-01-27;JO;Jordan;870;14;323111;4262
2021-01-28;JO;Jordan;1058;7;324169;4269
2021-01-29;JO;Jordan;864;12;325033;4281
2021-01-30;JO;Jordan;641;23;325674;4304
2021-01-31;JO;Jordan;1181;12;326855;4316
2021-02-01;JO;Jordan;1207;10;328062;4326
2021-02-02;JO;Jordan;1132;8;329194;4334
2021-02-03;JO;Jordan;1280;10;330474;4344
2021-02-04;JO;Jordan;1294;10;331768;4354
2021-02-05;JO;Jordan;1222;8;332990;4362
2021-02-06;JO;Jordan;865;7;333855;4369
2021-02-07;JO;Jordan;1299;10;335154;4379
2021-02-08;JO;Jordan;1685;6;336839;4385
2021-02-09;JO;Jordan;1483;10;338322;4395
2021-02-10;JO;Jordan;1855;16;340177;4411
2021-02-11;JO;Jordan;1807;10;341984;4421
2021-02-12;JO;Jordan;1579;12;343563;4433
2021-02-13;JO;Jordan;1240;11;344803;4444
2021-02-14;JO;Jordan;2447;11;347250;4455
2021-02-15;JO;Jordan;2312;18;349562;4473
2021-02-16;JO;Jordan;2657;18;352219;4491
2021-02-17;JO;Jordan;2887;12;355106;4503
2021-02-18;JO;Jordan;1638;9;356744;4512
2021-02-19;JO;Jordan;867;16;357611;4528
2021-02-20;JO;Jordan;2200;15;359811;4543
2021-02-21;JO;Jordan;3917;11;363728;4554
2021-02-22;JO;Jordan;4550;16;368278;4570
2021-02-23;JO;Jordan;4139;19;372417;4589
2021-02-24;JO;Jordan;4024;22;376441;4611
2021-02-25;JO;Jordan;3827;16;380268;4627
2021-02-26;JO;Jordan;3644;23;383912;4650
2021-02-27;JO;Jordan;2584;25;386496;4675
2021-02-28;JO;Jordan;4594;26;391090;4701
2021-03-01;JO;Jordan;6068;26;397158;4727
2021-03-02;JO;Jordan;5124;29;402282;4756
2021-03-03;JO;Jordan;5335;37;407617;4793
2021-03-04;JO;Jordan;5733;40;413350;4833
2021-03-05;JO;Jordan;4584;29;417934;4862
2021-03-06;JO;Jordan;3481;38;421415;4900
2021-03-07;JO;Jordan;6302;35;427717;4935
2021-03-08;JO;Jordan;7413;52;435130;4987
2021-03-09;JO;Jordan;7072;59;442202;5046
2021-03-10;JO;Jordan;6649;60;448851;5106
2021-03-11;JO;Jordan;8300;63;457151;5169
2021-03-12;JO;Jordan;7705;55;464856;5224
2021-03-13;JO;Jordan;4144;61;469000;5285
2021-03-14;JO;Jordan;8053;61;477053;5346
2021-03-15;JO;Jordan;9417;82;486470;5428
2021-03-16;JO;Jordan;8910;69;495380;5497
2021-03-17;JO;Jordan;9535;56;504915;5553
2021-03-18;JO;Jordan;9192;74;514107;5627
2021-03-19;JO;Jordan;7354;74;521461;5701
2021-03-20;JO;Jordan;5205;87;526666;5788
2021-03-21;JO;Jordan;8789;88;535455;5876
2021-03-22;JO;Jordan;9269;109;544724;5985
2021-03-23;JO;Jordan;9003;92;553727;6077
2021-03-24;JO;Jordan;9130;104;562857;6181
2021-03-25;JO;Jordan;8433;96;571290;6277
2021-03-26;JO;Jordan;6444;97;577734;6374
2021-03-27;JO;Jordan;4399;98;582133;6472
2021-03-28;JO;Jordan;7183;82;589316;6554
2021-03-29;JO;Jordan;7940;97;597256;6651
2021-03-30;JO;Jordan;7751;96;605007;6747
2021-03-31;JO;Jordan;6570;111;611577;6858
2021-04-01;JO;Jordan;6482;82;618059;6940
2021-04-02;JO;Jordan;4774;99;622833;7039
2021-04-03;JO;Jordan;4042;91;626875;7130
2021-04-04;JO;Jordan;6032;71;632907;7201
2021-04-05;JO;Jordan;6537;82;639444;7283
2021-04-06;JO;Jordan;6005;100;645449;7383
2021-04-07;JO;Jordan;5232;86;650681;7469
2021-04-08;JO;Jordan;4775;96;655456;7565
2021-04-09;JO;Jordan;3794;81;659250;7646
2021-04-10;JO;Jordan;3145;62;662395;7708
2021-04-11;JO;Jordan;3340;65;665735;7773
2021-04-12;JO;Jordan;3565;82;669300;7855
2021-04-13;JO;Jordan;2790;82;672090;7937
2021-04-14;JO;Jordan;4085;50;676175;7987
2021-04-15;JO;Jordan;2963;70;679138;8057
2021-04-16;JO;Jordan;2732;60;681870;8117
2021-04-17;JO;Jordan;1596;61;683466;8178
2021-04-18;JO;Jordan;2507;68;685973;8246
2021-04-19;JO;Jordan;3509;62;689482;8308
2021-04-20;JO;Jordan;2699;64;692181;8372
2021-04-21;JO;Jordan;3209;57;695390;8429
2021-04-22;JO;Jordan;2097;45;697487;8474
2021-04-23;JO;Jordan;1677;40;699164;8514
2021-04-24;JO;Jordan;1259;49;700423;8563
2021-04-25;JO;Jordan;1731;52;702154;8615
2021-04-26;JO;Jordan;2386;45;704540;8660
2021-04-27;JO;Jordan;1815;47;706355;8707
2021-04-28;JO;Jordan;1910;47;708265;8754
2021-04-29;JO;Jordan;1552;47;709817;8801
2021-04-30;JO;Jordan;1556;35;711373;8836
2021-05-01;JO;Jordan;704;35;712077;8871
2021-05-02;JO;Jordan;824;26;712901;8897
2021-05-03;JO;Jordan;1272;28;714173;8925
2021-05-04;JO;Jordan;1530;30;715703;8955
2021-05-05;JO;Jordan;1220;33;716923;8988
2021-05-06;JO;Jordan;1007;26;717930;9014
2021-05-07;JO;Jordan;702;33;718632;9047
2021-05-08;JO;Jordan;601;29;719233;9076
2021-05-09;JO;Jordan;0;0;719233;9076
2021-05-10;JO;Jordan;1765;49;720998;9125
2021-05-11;JO;Jordan;855;26;721853;9151
2021-05-12;JO;Jordan;0;0;721853;9151
2021-05-13;JO;Jordan;901;52;722754;9203
2021-05-14;JO;Jordan;0;0;722754;9203
2021-05-15;JO;Jordan;0;0;722754;9203
2021-05-16;JO;Jordan;1400;56;724154;9259
2021-05-17;JO;Jordan;1104;17;725258;9276
2021-05-18;JO;Jordan;1174;19;726432;9295
2021-05-19;JO;Jordan;0;0;726432;9295
2021-05-20;JO;Jordan;0;0;726432;9295
2021-05-21;JO;Jordan;0;0;726432;9295
2021-05-22;JO;Jordan;0;0;726432;9295
2021-05-23;JO;Jordan;0;0;726432;9295
2021-05-24;JO;Jordan;5004;89;731436;9384
2021-05-25;JO;Jordan;0;0;731436;9384
2021-05-26;JO;Jordan;0;0;731436;9384
2021-05-27;JO;Jordan;2603;39;734039;9423
2021-05-28;JO;Jordan;620;13;734659;9436
2021-05-29;JO;Jordan;0;0;734659;9436
2021-05-30;JO;Jordan;0;0;734659;9436
2021-05-31;JO;Jordan;1875;26;736534;9462
2021-06-01;JO;Jordan;750;10;737284;9472
2021-06-02;JO;Jordan;604;17;737888;9489
2021-06-03;JO;Jordan;633;11;738521;9500
2021-06-04;JO;Jordan;494;9;739015;9509
2021-06-05;JO;Jordan;304;7;739319;9516
2021-06-06;JO;Jordan;528;14;739847;9530
2021-06-07;JO;Jordan;655;11;740502;9541
2021-06-08;JO;Jordan;599;8;741101;9549
2021-06-09;JO;Jordan;598;12;741699;9561
2021-06-10;JO;Jordan;479;9;742178;9570
2021-06-11;JO;Jordan;343;7;742521;9577
2021-06-12;JO;Jordan;310;5;742831;9582
2021-06-13;JO;Jordan;500;10;743331;9592
2021-06-14;JO;Jordan;546;10;743877;9602
2021-06-15;JO;Jordan;500;12;744377;9614
2021-06-16;JO;Jordan;467;8;744844;9622
2021-06-17;JO;Jordan;522;13;745366;9635
2021-06-18;JO;Jordan;301;12;745667;9647
2021-06-19;JO;Jordan;311;9;745978;9656
2021-06-20;JO;Jordan;502;6;746480;9662
2021-06-21;JO;Jordan;520;9;747000;9671
2021-06-22;JO;Jordan;504;12;747504;9683
2021-06-23;JO;Jordan;599;10;748103;9693
2021-06-24;JO;Jordan;582;10;748685;9703
2021-06-25;JO;Jordan;361;7;749046;9710
2021-06-26;JO;Jordan;273;8;749319;9718
2021-06-27;JO;Jordan;465;9;749784;9727
2021-06-28;JO;Jordan;605;10;750389;9737
2021-06-29;JO;Jordan;497;6;750886;9743
2021-06-30;JO;Jordan;518;7;751404;9750
2021-07-01;JO;Jordan;533;6;751937;9756
2020-03-13;KZ;Kazakhstan;4;0;4;0
2020-03-14;KZ;Kazakhstan;2;0;6;0
2020-03-15;KZ;Kazakhstan;3;0;9;0
2020-03-16;KZ;Kazakhstan;1;0;10;0
2020-03-17;KZ;Kazakhstan;23;0;33;0
2020-03-18;KZ;Kazakhstan;2;0;35;0
2020-03-19;KZ;Kazakhstan;9;0;44;0
2020-03-20;KZ;Kazakhstan;5;0;49;0
2020-03-21;KZ;Kazakhstan;4;0;53;0
2020-03-22;KZ;Kazakhstan;8;0;61;0
2020-03-23;KZ;Kazakhstan;1;0;62;0
2020-03-24;KZ;Kazakhstan;10;0;72;0
2020-03-25;KZ;Kazakhstan;9;0;81;0
2020-03-26;KZ;Kazakhstan;30;1;111;1
2020-03-27;KZ;Kazakhstan;39;0;150;1
2020-03-28;KZ;Kazakhstan;78;0;228;1
2020-03-29;KZ;Kazakhstan;56;0;284;1
2020-03-30;KZ;Kazakhstan;18;0;302;1
2020-03-31;KZ;Kazakhstan;41;1;343;2
2020-04-01;KZ;Kazakhstan;37;1;380;3
2020-04-02;KZ;Kazakhstan;55;0;435;3
2020-04-03;KZ;Kazakhstan;29;3;464;6
2020-04-04;KZ;Kazakhstan;67;-1;531;5
2020-04-05;KZ;Kazakhstan;53;1;584;6
2020-04-06;KZ;Kazakhstan;78;0;662;6
2020-04-07;KZ;Kazakhstan;35;0;697;6
2020-04-08;KZ;Kazakhstan;30;1;727;7
2020-04-09;KZ;Kazakhstan;54;1;781;8
2020-04-10;KZ;Kazakhstan;31;2;812;10
2020-04-11;KZ;Kazakhstan;53;0;865;10
2020-04-12;KZ;Kazakhstan;86;0;951;10
2020-04-13;KZ;Kazakhstan;140;2;1091;12
2020-04-14;KZ;Kazakhstan;141;2;1232;14
2020-04-15;KZ;Kazakhstan;63;2;1295;16
2020-04-16;KZ;Kazakhstan;107;1;1402;17
2020-04-17;KZ;Kazakhstan;144;0;1546;17
2020-04-18;KZ;Kazakhstan;69;0;1615;17
2020-04-19;KZ;Kazakhstan;61;0;1676;17
2020-04-20;KZ;Kazakhstan;176;2;1852;19
2020-04-21;KZ;Kazakhstan;143;0;1995;19
2020-04-22;KZ;Kazakhstan;140;0;2135;19
2020-04-23;KZ;Kazakhstan;154;1;2289;20
2020-04-24;KZ;Kazakhstan;193;5;2482;25
2020-04-25;KZ;Kazakhstan;119;0;2601;25
2020-04-26;KZ;Kazakhstan;116;0;2717;25
2020-04-27;KZ;Kazakhstan;118;0;2835;25
2020-04-28;KZ;Kazakhstan;192;0;3027;25
2020-04-29;KZ;Kazakhstan;111;0;3138;25
2020-04-30;KZ;Kazakhstan;264;0;3402;25
2020-05-01;KZ;Kazakhstan;195;0;3597;25
2020-05-02;KZ;Kazakhstan;260;0;3857;25
2020-05-03;KZ;Kazakhstan;63;2;3920;27
2020-05-04;KZ;Kazakhstan;129;2;4049;29
2020-05-05;KZ;Kazakhstan;156;0;4205;29
2020-05-06;KZ;Kazakhstan;217;1;4422;30
2020-05-07;KZ;Kazakhstan;156;0;4578;30
2020-05-08;KZ;Kazakhstan;256;1;4834;31
2020-05-09;KZ;Kazakhstan;141;0;4975;31
2020-05-10;KZ;Kazakhstan;115;0;5090;31
2020-05-11;KZ;Kazakhstan;117;1;5207;32
2020-05-12;KZ;Kazakhstan;72;0;5279;32
2020-05-13;KZ;Kazakhstan;138;0;5417;32
2020-05-14;KZ;Kazakhstan;154;0;5571;32
2020-05-15;KZ;Kazakhstan;118;2;5689;34
2020-05-16;KZ;Kazakhstan;161;0;5850;34
2020-05-17;KZ;Kazakhstan;307;0;6157;34
2020-05-18;KZ;Kazakhstan;594;1;6751;35
2020-05-19;KZ;Kazakhstan;0;0;6751;35
2020-05-20;KZ;Kazakhstan;218;0;6969;35
2020-05-21;KZ;Kazakhstan;265;0;7234;35
2020-05-22;KZ;Kazakhstan;685;0;7919;35
2020-05-23;KZ;Kazakhstan;0;0;7919;35
2020-05-24;KZ;Kazakhstan;612;0;8531;35
2020-05-25;KZ;Kazakhstan;438;0;8969;35
2020-05-26;KZ;Kazakhstan;0;2;8969;37
2020-05-27;KZ;Kazakhstan;335;0;9304;37
2020-05-28;KZ;Kazakhstan;272;0;9576;37
2020-05-29;KZ;Kazakhstan;356;0;9932;37
2020-05-30;KZ;Kazakhstan;450;1;10382;38
2020-05-31;KZ;Kazakhstan;476;2;10858;40
2020-06-01;KZ;Kazakhstan;450;1;11308;41
2020-06-02;KZ;Kazakhstan;263;3;11571;44
2020-06-03;KZ;Kazakhstan;496;4;12067;48
2020-06-04;KZ;Kazakhstan;0;4;12067;52
2020-06-05;KZ;Kazakhstan;245;0;12312;52
2020-06-06;KZ;Kazakhstan;199;1;12511;53
2020-06-07;KZ;Kazakhstan;183;3;12694;56
2020-06-08;KZ;Kazakhstan;165;0;12859;56
2020-06-09;KZ;Kazakhstan;215;5;13074;61
2020-06-10;KZ;Kazakhstan;245;6;13319;67
2020-06-11;KZ;Kazakhstan;553;0;13872;67
2020-06-12;KZ;Kazakhstan;0;3;13872;70
2020-06-13;KZ;Kazakhstan;366;3;14238;73
2020-06-14;KZ;Kazakhstan;258;4;14496;77
2020-06-15;KZ;Kazakhstan;696;4;15192;81
2020-06-16;KZ;Kazakhstan;350;7;15542;88
2020-06-17;KZ;Kazakhstan;335;9;15877;97
2020-06-18;KZ;Kazakhstan;0;3;15877;100
2020-06-19;KZ;Kazakhstan;902;13;16779;113
2020-06-20;KZ;Kazakhstan;446;5;17225;118
2020-06-21;KZ;Kazakhstan;507;2;17732;120
2020-06-22;KZ;Kazakhstan;499;7;18231;127
2020-06-23;KZ;Kazakhstan;534;7;18765;134
2020-06-24;KZ;Kazakhstan;520;2;19285;136
2020-06-25;KZ;Kazakhstan;465;4;19750;140
2020-06-26;KZ;Kazakhstan;569;10;20319;150
2020-06-27;KZ;Kazakhstan;0;16;20319;166
2020-06-28;KZ;Kazakhstan;1008;12;21327;178
2020-06-29;KZ;Kazakhstan;492;10;21819;188
2020-06-30;KZ;Kazakhstan;489;0;22308;188
2020-07-01;KZ;Kazakhstan;18757;0;41065;188
2020-07-02;KZ;Kazakhstan;1509;0;42574;188
2020-07-03;KZ;Kazakhstan;3145;0;45719;188
2020-07-04;KZ;Kazakhstan;1452;0;47171;188
2020-07-05;KZ;Kazakhstan;1403;0;48574;188
2020-07-06;KZ;Kazakhstan;1109;76;49683;264
2020-07-07;KZ;Kazakhstan;1376;0;51059;264
2020-07-08;KZ;Kazakhstan;0;0;51059;264
2020-07-09;KZ;Kazakhstan;3688;0;54747;264
2020-07-10;KZ;Kazakhstan;1708;0;56455;264
2020-07-11;KZ;Kazakhstan;1798;0;58253;264
2020-07-12;KZ;Kazakhstan;0;111;58253;375
2020-07-13;KZ;Kazakhstan;3502;0;61755;375
2020-07-14;KZ;Kazakhstan;1759;0;63514;375
2020-07-15;KZ;Kazakhstan;1674;0;65188;375
2020-07-16;KZ;Kazakhstan;1707;0;66895;375
2020-07-17;KZ;Kazakhstan;1808;0;68703;375
2020-07-18;KZ;Kazakhstan;0;0;68703;375
2020-07-19;KZ;Kazakhstan;3135;0;71838;375
2020-07-20;KZ;Kazakhstan;1630;210;73468;585
2020-07-21;KZ;Kazakhstan;1685;0;75153;585
2020-07-22;KZ;Kazakhstan;0;0;75153;585
2020-07-23;KZ;Kazakhstan;3333;0;78486;585
2020-07-24;KZ;Kazakhstan;1740;0;80226;585
2020-07-25;KZ;Kazakhstan;1494;0;81720;585
2020-07-26;KZ;Kazakhstan;1402;0;83122;585
2020-07-27;KZ;Kazakhstan;1526;0;84648;585
2020-07-28;KZ;Kazakhstan;1544;208;86192;793
2020-07-29;KZ;Kazakhstan;1472;0;87664;793
2020-07-30;KZ;Kazakhstan;1414;0;89078;793
2020-07-31;KZ;Kazakhstan;1289;0;90367;793
2020-08-01;KZ;Kazakhstan;0;0;90367;793
2020-08-02;KZ;Kazakhstan;6407;30;96774;823
2020-08-03;KZ;Kazakhstan;1867;286;98641;1109
2020-08-04;KZ;Kazakhstan;1434;0;100075;1109
2020-08-05;KZ;Kazakhstan;2861;0;102936;1109
2020-08-06;KZ;Kazakhstan;2590;0;105526;1109
2020-08-07;KZ;Kazakhstan;2404;0;107930;1109
2020-08-08;KZ;Kazakhstan;2009;0;109939;1109
2020-08-09;KZ;Kazakhstan;1883;0;111822;1109
2020-08-10;KZ;Kazakhstan;900;324;112722;1433
2020-08-11;KZ;Kazakhstan;779;0;113501;1433
2020-08-12;KZ;Kazakhstan;2114;0;115615;1433
2020-08-13;KZ;Kazakhstan;1489;0;117104;1433
2020-08-14;KZ;Kazakhstan;1410;0;118514;1433
2020-08-15;KZ;Kazakhstan;1267;47;119781;1480
2020-08-16;KZ;Kazakhstan;1380;5;121161;1485
2020-08-17;KZ;Kazakhstan;478;2;121639;1487
2020-08-18;KZ;Kazakhstan;334;148;121973;1635
2020-08-19;KZ;Kazakhstan;1352;11;123325;1646
2020-08-20;KZ;Kazakhstan;1031;6;124356;1652
2020-08-21;KZ;Kazakhstan;979;6;125335;1658
2020-08-22;KZ;Kazakhstan;908;5;126243;1663
2020-08-23;KZ;Kazakhstan;960;8;127203;1671
2020-08-24;KZ;Kazakhstan;259;110;127462;1781
2020-08-25;KZ;Kazakhstan;0;0;127462;1781
2020-08-26;KZ;Kazakhstan;0;0;127462;1781
2020-08-27;KZ;Kazakhstan;202;0;127664;1781
2020-08-28;KZ;Kazakhstan;954;0;128618;1781
2020-08-29;KZ;Kazakhstan;1422;0;130040;1781
2020-08-30;KZ;Kazakhstan;633;0;130673;1781
2020-08-31;KZ;Kazakhstan;0;0;130673;1781
2020-09-01;KZ;Kazakhstan;923;34;131596;1815
2020-09-02;KZ;Kazakhstan;99;68;131695;1883
2020-09-03;KZ;Kazakhstan;659;6;132354;1889
2020-09-04;KZ;Kazakhstan;570;4;132924;1893
2020-09-05;KZ;Kazakhstan;104;0;133028;1893
2020-09-06;KZ;Kazakhstan;896;8;133924;1901
2020-09-07;KZ;Kazakhstan;199;1;134123;1902
2020-09-08;KZ;Kazakhstan;80;1;134203;1903
2020-09-09;KZ;Kazakhstan;523;47;134726;1950
2020-09-10;KZ;Kazakhstan;433;1;135159;1951
2020-09-11;KZ;Kazakhstan;430;1;135589;1952
2020-09-12;KZ;Kazakhstan;375;2;135964;1954
2020-09-13;KZ;Kazakhstan;420;1;136384;1955
2020-09-14;KZ;Kazakhstan;129;7;136513;1962
2020-09-15;KZ;Kazakhstan;73;3;136586;1965
2020-09-16;KZ;Kazakhstan;472;38;137058;2003
2020-09-17;KZ;Kazakhstan;335;3;137393;2006
2020-09-18;KZ;Kazakhstan;320;2;137713;2008
2020-09-19;KZ;Kazakhstan;300;1;138013;2009
2020-09-20;KZ;Kazakhstan;335;5;138348;2014
2020-09-21;KZ;Kazakhstan;107;1;138455;2015
2020-09-22;KZ;Kazakhstan;87;1;138542;2016
2020-09-23;KZ;Kazakhstan;440;28;138982;2044
2020-09-24;KZ;Kazakhstan;307;1;139289;2045
2020-09-25;KZ;Kazakhstan;292;1;139581;2046
2020-09-26;KZ;Kazakhstan;301;0;139882;2046
2020-09-27;KZ;Kazakhstan;293;2;140175;2048
2020-09-28;KZ;Kazakhstan;90;1;140265;2049
2020-09-29;KZ;Kazakhstan;68;1;140333;2050
2020-09-30;KZ;Kazakhstan;374;28;140707;2078
2020-10-01;KZ;Kazakhstan;251;2;140958;2080
2020-10-02;KZ;Kazakhstan;298;2;141256;2082
2020-10-03;KZ;Kazakhstan;228;1;141484;2083
2020-10-04;KZ;Kazakhstan;264;0;141748;2083
2020-10-05;KZ;Kazakhstan;96;2;141844;2085
2020-10-06;KZ;Kazakhstan;60;0;141904;2085
2020-10-07;KZ;Kazakhstan;335;22;142239;2107
2020-10-08;KZ;Kazakhstan;358;1;142597;2108
2020-10-09;KZ;Kazakhstan;348;2;142945;2110
2020-10-10;KZ;Kazakhstan;335;1;143280;2111
2020-10-11;KZ;Kazakhstan;352;2;143632;2113
2020-10-12;KZ;Kazakhstan;108;1;143740;2114
2020-10-13;KZ;Kazakhstan;74;2;143814;2116
2020-10-14;KZ;Kazakhstan;404;25;144218;2141
2020-10-15;KZ;Kazakhstan;110;0;144328;2141
2020-10-16;KZ;Kazakhstan;433;3;144761;2144
2020-10-17;KZ;Kazakhstan;258;4;145019;2148
2020-10-18;KZ;Kazakhstan;301;1;145320;2149
2020-10-19;KZ;Kazakhstan;153;1;145473;2150
2020-10-20;KZ;Kazakhstan;130;5;145603;2155
2020-10-21;KZ;Kazakhstan;363;29;145966;2184
2020-10-22;KZ;Kazakhstan;322;2;146288;2186
2020-10-23;KZ;Kazakhstan;365;1;146653;2187
2020-10-24;KZ;Kazakhstan;329;2;146982;2189
2020-10-25;KZ;Kazakhstan;315;0;147297;2189
2020-10-26;KZ;Kazakhstan;166;1;147463;2190
2020-10-27;KZ;Kazakhstan;152;1;147615;2191
2020-10-28;KZ;Kazakhstan;422;30;148037;2221
2020-10-29;KZ;Kazakhstan;442;1;148479;2222
2020-10-30;KZ;Kazakhstan;587;2;149066;2224
2020-10-31;KZ;Kazakhstan;633;2;149699;2226
2020-11-01;KZ;Kazakhstan;681;1;150380;2227
2020-11-02;KZ;Kazakhstan;483;0;150863;2227
2020-11-03;KZ;Kazakhstan;458;34;151321;2261
2020-11-04;KZ;Kazakhstan;701;1;152022;2262
2020-11-05;KZ;Kazakhstan;703;1;152725;2263
2020-11-06;KZ;Kazakhstan;822;0;153547;2263
2020-11-07;KZ;Kazakhstan;774;2;154321;2265
2020-11-08;KZ;Kazakhstan;899;1;155220;2266
2020-11-09;KZ;Kazakhstan;656;0;155876;2266
2020-11-10;KZ;Kazakhstan;575;1;156451;2267
2020-11-11;KZ;Kazakhstan;810;0;157261;2267
2020-11-12;KZ;Kazakhstan;775;44;158036;2311
2020-11-13;KZ;Kazakhstan;817;3;158853;2314
2020-11-14;KZ;Kazakhstan;903;1;159756;2315
2020-11-15;KZ;Kazakhstan;856;2;160612;2317
2020-11-16;KZ;Kazakhstan;1238;2;161850;2319
2020-11-17;KZ;Kazakhstan;705;1;162555;2320
2020-11-18;KZ;Kazakhstan;1030;46;163585;2366
2020-11-19;KZ;Kazakhstan;993;2;164578;2368
2020-11-20;KZ;Kazakhstan;980;1;165558;2369
2020-11-21;KZ;Kazakhstan;910;1;166468;2370
2020-11-22;KZ;Kazakhstan;873;2;167341;2372
2020-11-23;KZ;Kazakhstan;44;0;167385;2372
2020-11-24;KZ;Kazakhstan;1418;1;168803;2373
2020-11-25;KZ;Kazakhstan;1024;49;169827;2422
2020-11-26;KZ;Kazakhstan;981;2;170808;2424
2020-11-27;KZ;Kazakhstan;987;5;171795;2429
2020-11-28;KZ;Kazakhstan;1010;1;172805;2430
2020-11-29;KZ;Kazakhstan;958;3;173763;2433
2020-11-30;KZ;Kazakhstan;800;0;174563;2433
2020-12-01;KZ;Kazakhstan;1002;1;175565;2434
2020-12-02;KZ;Kazakhstan;777;2;176342;2436
2020-12-03;KZ;Kazakhstan;1044;2;177386;2438
2020-12-04;KZ;Kazakhstan;992;46;178378;2484
2020-12-05;KZ;Kazakhstan;966;4;179344;2488
2020-12-06;KZ;Kazakhstan;745;0;180089;2488
2020-12-07;KZ;Kazakhstan;688;2;180777;2490
2020-12-08;KZ;Kazakhstan;944;54;181721;2544
2020-12-09;KZ;Kazakhstan;936;2;182657;2546
2020-12-10;KZ;Kazakhstan;973;4;183630;2550
2020-12-11;KZ;Kazakhstan;927;1;184557;2551
2020-12-12;KZ;Kazakhstan;956;1;185513;2552
2020-12-13;KZ;Kazakhstan;764;0;186277;2552
2020-12-14;KZ;Kazakhstan;683;2;186960;2554
2020-12-15;KZ;Kazakhstan;930;59;187890;2613
2020-12-16;KZ;Kazakhstan;947;0;188837;2613
2020-12-17;KZ;Kazakhstan;714;2;189551;2615
2020-12-18;KZ;Kazakhstan;741;2;190292;2617
2020-12-19;KZ;Kazakhstan;677;4;190969;2621
2020-12-20;KZ;Kazakhstan;681;1;191650;2622
2020-12-21;KZ;Kazakhstan;929;4;192579;2626
2020-12-22;KZ;Kazakhstan;924;51;193503;2677
2020-12-23;KZ;Kazakhstan;754;0;194257;2677
2020-12-24;KZ;Kazakhstan;736;0;194993;2677
2020-12-25;KZ;Kazakhstan;1223;8;196216;2685
2020-12-26;KZ;Kazakhstan;926;1;197142;2686
2020-12-27;KZ;Kazakhstan;760;0;197902;2686
2020-12-28;KZ;Kazakhstan;757;3;198659;2689
2020-12-29;KZ;Kazakhstan;896;71;199555;2760
2020-12-30;KZ;Kazakhstan;888;1;200443;2761
2020-12-31;KZ;Kazakhstan;753;0;201196;2761
2021-01-01;KZ;Kazakhstan;864;4;202060;2765
2021-01-02;KZ;Kazakhstan;820;5;202880;2770
2021-01-03;KZ;Kazakhstan;683;1;203563;2771
2021-01-04;KZ;Kazakhstan;730;4;204293;2775
2021-01-05;KZ;Kazakhstan;771;0;205064;2775
2021-01-06;KZ;Kazakhstan;869;6;205933;2781
2021-01-07;KZ;Kazakhstan;907;0;206840;2781
2021-01-08;KZ;Kazakhstan;843;57;207683;2838
2021-01-09;KZ;Kazakhstan;913;5;208596;2843
2021-01-10;KZ;Kazakhstan;773;1;209369;2844
2021-01-11;KZ;Kazakhstan;717;1;210086;2845
2021-01-12;KZ;Kazakhstan;890;34;210976;2879
2021-01-13;KZ;Kazakhstan;925;2;211901;2881
2021-01-14;KZ;Kazakhstan;911;1;212812;2882
2021-01-15;KZ;Kazakhstan;1043;1;213855;2883
2021-01-16;KZ;Kazakhstan;1072;4;214927;2887
2021-01-17;KZ;Kazakhstan;1020;2;215947;2889
2021-01-18;KZ;Kazakhstan;1017;2;216964;2891
2021-01-19;KZ;Kazakhstan;1252;3;218216;2894
2021-01-20;KZ;Kazakhstan;1311;56;219527;2950
2021-01-21;KZ;Kazakhstan;1526;2;221053;2952
2021-01-22;KZ;Kazakhstan;1648;1;222701;2953
2021-01-23;KZ;Kazakhstan;1694;2;224395;2955
2021-01-24;KZ;Kazakhstan;1496;3;225891;2958
2021-01-25;KZ;Kazakhstan;1274;3;227165;2961
2021-01-26;KZ;Kazakhstan;1527;74;228692;3035
2021-01-27;KZ;Kazakhstan;1496;5;230188;3040
2021-01-28;KZ;Kazakhstan;1528;0;231716;3040
2021-01-29;KZ;Kazakhstan;1440;2;233156;3042
2021-01-30;KZ;Kazakhstan;1413;3;234569;3045
2021-01-31;KZ;Kazakhstan;1275;1;235844;3046
2021-02-01;KZ;Kazakhstan;1185;0;237029;3046
2021-02-02;KZ;Kazakhstan;1335;1;238364;3047
2021-02-03;KZ;Kazakhstan;1362;1;239726;3048
2021-02-04;KZ;Kazakhstan;1257;71;240983;3119
2021-02-05;KZ;Kazakhstan;0;0;240983;3119
2021-02-06;KZ;Kazakhstan;2421;0;243404;3119
2021-02-07;KZ;Kazakhstan;1024;5;244428;3124
2021-02-08;KZ;Kazakhstan;923;0;245351;3124
2021-02-09;KZ;Kazakhstan;1123;3;246474;3127
2021-02-10;KZ;Kazakhstan;1059;4;247533;3131
2021-02-11;KZ;Kazakhstan;1033;1;248566;3132
2021-02-12;KZ;Kazakhstan;996;3;249562;3135
2021-02-13;KZ;Kazakhstan;837;0;250399;3135
2021-02-14;KZ;Kazakhstan;868;5;251267;3140
2021-02-15;KZ;Kazakhstan;692;2;251959;3142
2021-02-16;KZ;Kazakhstan;862;2;252821;3144
2021-02-17;KZ;Kazakhstan;930;0;253751;3144
2021-02-18;KZ;Kazakhstan;961;1;254712;3145
2021-02-19;KZ;Kazakhstan;872;3;255584;3148
2021-02-20;KZ;Kazakhstan;804;2;256388;3150
2021-02-21;KZ;Kazakhstan;712;2;257100;3152
2021-02-22;KZ;Kazakhstan;700;1;257800;3153
2021-02-23;KZ;Kazakhstan;809;2;258609;3155
2021-02-24;KZ;Kazakhstan;869;4;259478;3159
2021-02-25;KZ;Kazakhstan;906;1;260384;3160
2021-02-26;KZ;Kazakhstan;860;0;261244;3160
2021-02-27;KZ;Kazakhstan;849;2;262093;3162
2021-02-28;KZ;Kazakhstan;622;0;262715;3162
2021-03-01;KZ;Kazakhstan;681;6;263396;3168
2021-03-02;KZ;Kazakhstan;782;2;264178;3170
2021-03-03;KZ;Kazakhstan;850;5;265028;3175
2021-03-04;KZ;Kazakhstan;901;0;265929;3175
2021-03-05;KZ;Kazakhstan;874;2;266803;3177
2021-03-06;KZ;Kazakhstan;854;3;267657;3180
2021-03-07;KZ;Kazakhstan;670;4;268327;3184
2021-03-08;KZ;Kazakhstan;575;2;268902;3186
2021-03-09;KZ;Kazakhstan;697;1;269599;3187
2021-03-10;KZ;Kazakhstan;800;3;270399;3190
2021-03-11;KZ;Kazakhstan;964;2;271363;3192
2021-03-12;KZ;Kazakhstan;1002;0;272365;3192
2021-03-13;KZ;Kazakhstan;1104;1;273469;3193
2021-03-14;KZ;Kazakhstan;1072;2;274541;3195
2021-03-15;KZ;Kazakhstan;961;1;275502;3196
2021-03-16;KZ;Kazakhstan;1161;0;276663;3196
2021-03-17;KZ;Kazakhstan;1243;3;277906;3199
2021-03-18;KZ;Kazakhstan;1314;0;279220;3199
2021-03-19;KZ;Kazakhstan;1356;1;280576;3200
2021-03-20;KZ;Kazakhstan;1222;1;281798;3201
2021-03-21;KZ;Kazakhstan;1229;1;283027;3202
2021-03-22;KZ;Kazakhstan;1111;2;284138;3204
2021-03-23;KZ;Kazakhstan;1103;3;285241;3207
2021-03-24;KZ;Kazakhstan;1111;2;286352;3209
2021-03-25;KZ;Kazakhstan;1121;3;287473;3212
2021-03-26;KZ;Kazakhstan;1629;5;289102;3217
2021-03-27;KZ;Kazakhstan;1690;3;290792;3220
2021-03-28;KZ;Kazakhstan;1514;2;292306;3222
2021-03-29;KZ;Kazakhstan;1455;2;293761;3224
2021-03-30;KZ;Kazakhstan;1745;4;295506;3228
2021-03-31;KZ;Kazakhstan;1966;4;297472;3232
2021-04-01;KZ;Kazakhstan;2154;2;299626;3234
2021-04-02;KZ;Kazakhstan;2192;2;301818;3236
2021-04-03;KZ;Kazakhstan;2104;4;303922;3240
2021-04-04;KZ;Kazakhstan;1938;2;305860;3242
2021-04-05;KZ;Kazakhstan;1816;7;307676;3249
2021-04-06;KZ;Kazakhstan;2080;0;309756;3249
2021-04-07;KZ;Kazakhstan;2802;9;312558;3258
2021-04-08;KZ;Kazakhstan;2544;3;315102;3261
2021-04-09;KZ;Kazakhstan;2835;1;317937;3262
2021-04-10;KZ;Kazakhstan;2944;5;320881;3267
2021-04-11;KZ;Kazakhstan;2326;0;323207;3267
2021-04-12;KZ;Kazakhstan;2027;4;325234;3271
2021-04-13;KZ;Kazakhstan;2359;5;327593;3276
2021-04-14;KZ;Kazakhstan;2726;5;330319;3281
2021-04-15;KZ;Kazakhstan;2727;1;333046;3282
2021-04-16;KZ;Kazakhstan;2822;0;335868;3282
2021-04-17;KZ;Kazakhstan;2896;6;338764;3288
2021-04-18;KZ;Kazakhstan;2835;3;341599;3291
2021-04-19;KZ;Kazakhstan;2541;3;344140;3294
2021-04-20;KZ;Kazakhstan;2831;3;346971;3297
2021-04-21;KZ;Kazakhstan;3016;4;349987;3301
2021-04-22;KZ;Kazakhstan;3001;3;352988;3304
2021-04-23;KZ;Kazakhstan;2930;0;355918;3304
2021-04-24;KZ;Kazakhstan;2916;7;358834;3311
2021-04-25;KZ;Kazakhstan;2741;4;361575;3315
2021-04-26;KZ;Kazakhstan;2296;7;363871;3322
2021-04-27;KZ;Kazakhstan;2838;4;366709;3326
2021-04-28;KZ;Kazakhstan;2995;5;369704;3331
2021-04-29;KZ;Kazakhstan;2958;3;372662;3334
2021-04-30;KZ;Kazakhstan;2877;0;375539;3334
2021-05-01;KZ;Kazakhstan;2902;7;378441;3341
2021-05-02;KZ;Kazakhstan;2637;8;381078;3349
2021-05-03;KZ;Kazakhstan;2086;3;383164;3352
2021-05-04;KZ;Kazakhstan;2327;5;385491;3357
2021-05-05;KZ;Kazakhstan;2620;6;388111;3363
2021-05-06;KZ;Kazakhstan;2941;6;391052;3369
2021-05-07;KZ;Kazakhstan;2587;0;393639;3369
2021-05-08;KZ;Kazakhstan;2491;2;396130;3371
2021-05-09;KZ;Kazakhstan;2142;0;398272;3371
2021-05-10;KZ;Kazakhstan;23;1;398295;3372
2021-05-11;KZ;Kazakhstan;3597;10;401892;3382
2021-05-12;KZ;Kazakhstan;2456;5;404348;3387
2021-05-13;KZ;Kazakhstan;2676;4;407024;3391
2021-05-14;KZ;Kazakhstan;2635;1;409659;3392
2021-05-15;KZ;Kazakhstan;2577;2;412236;3394
2021-05-16;KZ;Kazakhstan;2089;0;414325;3394
2021-05-17;KZ;Kazakhstan;20;6;414345;3400
2021-05-18;KZ;Kazakhstan;3856;3;418201;3403
2021-05-19;KZ;Kazakhstan;2662;6;420863;3409
2021-05-20;KZ;Kazakhstan;2267;0;423130;3409
2021-05-21;KZ;Kazakhstan;2267;0;425397;3409
2021-05-22;KZ;Kazakhstan;2476;14;427873;3423
2021-05-23;KZ;Kazakhstan;1847;5;429720;3428
2021-05-24;KZ;Kazakhstan;1568;1;431288;3429
2021-05-25;KZ;Kazakhstan;1860;4;433148;3433
2021-05-26;KZ;Kazakhstan;1956;0;435104;3433
2021-05-27;KZ;Kazakhstan;1827;2;436931;3435
2021-05-28;KZ;Kazakhstan;1688;0;438619;3435
2021-05-29;KZ;Kazakhstan;96;7;438715;3442
2021-05-30;KZ;Kazakhstan;3059;6;441774;3448
2021-05-31;KZ;Kazakhstan;1161;5;442935;3453
2021-06-01;KZ;Kazakhstan;1442;3;444377;3456
2021-06-02;KZ;Kazakhstan;1385;0;445762;3456
2021-06-03;KZ;Kazakhstan;1513;11;447275;3467
2021-06-04;KZ;Kazakhstan;1303;1;448578;3468
2021-06-05;KZ;Kazakhstan;1280;3;449858;3471
2021-06-06;KZ;Kazakhstan;1010;2;450868;3473
2021-06-07;KZ;Kazakhstan;773;6;451641;3479
2021-06-08;KZ;Kazakhstan;1119;3;452760;3482
2021-06-09;KZ;Kazakhstan;1215;2;453975;3484
2021-06-10;KZ;Kazakhstan;1190;0;455165;3484
2021-06-11;KZ;Kazakhstan;1181;3;456346;3487
2021-06-12;KZ;Kazakhstan;1058;0;457404;3487
2021-06-13;KZ;Kazakhstan;70;4;457474;3491
2021-06-14;KZ;Kazakhstan;1738;11;459212;3502
2021-06-15;KZ;Kazakhstan;1128;0;460340;3502
2021-06-16;KZ;Kazakhstan;1145;0;461485;3502
2021-06-17;KZ;Kazakhstan;1310;5;462795;3507
2021-06-18;KZ;Kazakhstan;0;0;462795;3507
2021-06-19;KZ;Kazakhstan;1215;2;464010;3509
2021-06-20;KZ;Kazakhstan;2115;1;466125;3510
2021-06-21;KZ;Kazakhstan;944;1;467069;3511
2021-06-22;KZ;Kazakhstan;1329;1;468398;3512
2021-06-23;KZ;Kazakhstan;1577;1;469975;3513
2021-06-24;KZ;Kazakhstan;1523;5;471498;3518
2021-06-25;KZ;Kazakhstan;1730;0;473228;3518
2021-06-26;KZ;Kazakhstan;54;3;473282;3521
2021-06-27;KZ;Kazakhstan;3458;3;476740;3524
2021-06-28;KZ;Kazakhstan;1323;3;478063;3527
2021-06-29;KZ;Kazakhstan;2099;0;480162;3527
2021-06-30;KZ;Kazakhstan;2524;3;482686;3530
2021-07-01;KZ;Kazakhstan;2666;3;485352;3533
2020-03-06;KE;Kenya;0;0;0;0
2020-03-07;KE;Kenya;0;0;0;0
2020-03-08;KE;Kenya;0;0;0;0
2020-03-09;KE;Kenya;0;0;0;0
2020-03-10;KE;Kenya;0;0;0;0
2020-03-11;KE;Kenya;0;0;0;0
2020-03-12;KE;Kenya;0;0;0;0
2020-03-13;KE;Kenya;1;0;1;0
2020-03-14;KE;Kenya;0;0;1;0
2020-03-15;KE;Kenya;2;0;3;0
2020-03-16;KE;Kenya;0;0;3;0
2020-03-17;KE;Kenya;0;0;3;0
2020-03-18;KE;Kenya;0;0;3;0
2020-03-19;KE;Kenya;4;0;7;0
2020-03-20;KE;Kenya;0;0;7;0
2020-03-21;KE;Kenya;0;0;7;0
2020-03-22;KE;Kenya;8;0;15;0
2020-03-23;KE;Kenya;1;0;16;0
2020-03-24;KE;Kenya;9;0;25;0
2020-03-25;KE;Kenya;3;0;28;0
2020-03-26;KE;Kenya;3;1;31;1
2020-03-27;KE;Kenya;0;0;31;1
2020-03-28;KE;Kenya;7;0;38;1
2020-03-29;KE;Kenya;4;0;42;1
2020-03-30;KE;Kenya;8;0;50;1
2020-03-31;KE;Kenya;9;0;59;1
2020-04-01;KE;Kenya;22;0;81;1
2020-04-02;KE;Kenya;29;2;110;3
2020-04-03;KE;Kenya;12;1;122;4
2020-04-04;KE;Kenya;4;0;126;4
2020-04-05;KE;Kenya;16;0;142;4
2020-04-06;KE;Kenya;16;2;158;6
2020-04-07;KE;Kenya;14;0;172;6
2020-04-08;KE;Kenya;7;0;179;6
2020-04-09;KE;Kenya;5;1;184;7
2020-04-10;KE;Kenya;5;0;189;7
2020-04-11;KE;Kenya;2;0;191;7
2020-04-12;KE;Kenya;6;1;197;8
2020-04-13;KE;Kenya;11;1;208;9
2020-04-14;KE;Kenya;8;0;216;9
2020-04-15;KE;Kenya;9;1;225;10
2020-04-16;KE;Kenya;9;1;234;11
2020-04-17;KE;Kenya;12;0;246;11
2020-04-18;KE;Kenya;16;1;262;12
2020-04-19;KE;Kenya;8;2;270;14
2020-04-20;KE;Kenya;11;0;281;14
2020-04-21;KE;Kenya;15;0;296;14
2020-04-22;KE;Kenya;7;0;303;14
2020-04-23;KE;Kenya;17;0;320;14
2020-04-24;KE;Kenya;16;0;336;14
2020-04-25;KE;Kenya;7;0;343;14
2020-04-26;KE;Kenya;12;0;355;14
2020-04-27;KE;Kenya;8;0;363;14
2020-04-28;KE;Kenya;11;0;374;14
2020-04-29;KE;Kenya;10;1;384;15
2020-04-30;KE;Kenya;12;2;396;17
2020-05-01;KE;Kenya;15;4;411;21
2020-05-02;KE;Kenya;24;1;435;22
2020-05-03;KE;Kenya;30;2;465;24
2020-05-04;KE;Kenya;25;0;490;24
2020-05-05;KE;Kenya;45;0;535;24
2020-05-06;KE;Kenya;47;2;582;26
2020-05-07;KE;Kenya;25;3;607;29
2020-05-08;KE;Kenya;14;0;621;29
2020-05-09;KE;Kenya;28;1;649;30
2020-05-10;KE;Kenya;23;2;672;32
2020-05-11;KE;Kenya;28;1;700;33
2020-05-12;KE;Kenya;15;3;715;36
2020-05-13;KE;Kenya;22;4;737;40
2020-05-14;KE;Kenya;21;2;758;42
2020-05-15;KE;Kenya;23;3;781;45
2020-05-16;KE;Kenya;49;5;830;50
2020-05-17;KE;Kenya;57;0;887;50
2020-05-18;KE;Kenya;25;0;912;50
2020-05-19;KE;Kenya;51;0;963;50
2020-05-20;KE;Kenya;66;0;1029;50
2020-05-21;KE;Kenya;80;0;1109;50
2020-05-22;KE;Kenya;52;0;1161;50
2020-05-23;KE;Kenya;31;0;1192;50
2020-05-24;KE;Kenya;22;1;1214;51
2020-05-25;KE;Kenya;72;1;1286;52
2020-05-26;KE;Kenya;62;0;1348;52
2020-05-27;KE;Kenya;123;3;1471;55
2020-05-28;KE;Kenya;147;3;1618;58
2020-05-29;KE;Kenya;127;4;1745;62
2020-05-30;KE;Kenya;143;1;1888;63
2020-05-31;KE;Kenya;74;1;1962;64
2020-06-01;KE;Kenya;59;5;2021;69
2020-06-02;KE;Kenya;72;2;2093;71
2020-06-03;KE;Kenya;123;3;2216;74
2020-06-04;KE;Kenya;124;4;2340;78
2020-06-05;KE;Kenya;134;1;2474;79
2020-06-06;KE;Kenya;126;4;2600;83
2020-06-07;KE;Kenya;167;1;2767;84
2020-06-08;KE;Kenya;105;1;2872;85
2020-06-09;KE;Kenya;117;3;2989;88
2020-06-10;KE;Kenya;105;1;3094;89
2020-06-11;KE;Kenya;121;3;3215;92
2020-06-12;KE;Kenya;90;4;3305;96
2020-06-13;KE;Kenya;152;4;3457;100
2020-06-14;KE;Kenya;137;3;3594;103
2020-06-15;KE;Kenya;133;1;3727;104
2020-06-16;KE;Kenya;133;1;3860;105
2020-06-17;KE;Kenya;184;2;4044;107
2020-06-18;KE;Kenya;213;10;4257;117
2020-06-19;KE;Kenya;117;2;4374;119
2020-06-20;KE;Kenya;104;2;4478;121
2020-06-21;KE;Kenya;260;2;4738;123
2020-06-22;KE;Kenya;59;2;4797;125
2020-06-23;KE;Kenya;155;3;4952;128
2020-06-24;KE;Kenya;254;2;5206;130
2020-06-25;KE;Kenya;178;2;5384;132
2020-06-26;KE;Kenya;149;5;5533;137
2020-06-27;KE;Kenya;278;4;5811;141
2020-06-28;KE;Kenya;259;2;6070;143
2020-06-29;KE;Kenya;120;1;6190;144
2020-06-30;KE;Kenya;176;4;6366;148
2020-07-01;KE;Kenya;307;1;6673;149
2020-07-02;KE;Kenya;268;3;6941;152
2020-07-03;KE;Kenya;247;2;7188;154
2020-07-04;KE;Kenya;389;5;7577;159
2020-07-05;KE;Kenya;309;1;7886;160
2020-07-06;KE;Kenya;181;4;8067;164
2020-07-07;KE;Kenya;183;3;8250;167
2020-07-08;KE;Kenya;278;2;8528;169
2020-07-09;KE;Kenya;447;4;8975;173
2020-07-10;KE;Kenya;473;8;9448;181
2020-07-11;KE;Kenya;278;3;9726;184
2020-07-12;KE;Kenya;379;1;10105;185
2020-07-13;KE;Kenya;189;12;10294;197
2020-07-14;KE;Kenya;497;5;10791;202
2020-07-15;KE;Kenya;461;7;11252;209
2020-07-16;KE;Kenya;421;8;11673;217
2020-07-17;KE;Kenya;389;5;12062;222
2020-07-18;KE;Kenya;688;3;12750;225
2020-07-19;KE;Kenya;603;9;13353;234
2020-07-20;KE;Kenya;418;4;13771;238
2020-07-21;KE;Kenya;397;12;14168;250
2020-07-22;KE;Kenya;637;10;14805;260
2020-07-23;KE;Kenya;796;3;15601;263
2020-07-24;KE;Kenya;667;11;16268;274
2020-07-25;KE;Kenya;375;4;16643;278
2020-07-26;KE;Kenya;960;2;17603;280
2020-07-27;KE;Kenya;372;5;17975;285
2020-07-28;KE;Kenya;606;14;18581;299
2020-07-29;KE;Kenya;544;12;19125;311
2020-07-30;KE;Kenya;788;14;19913;325
2020-07-31;KE;Kenya;723;16;20636;341
2020-08-01;KE;Kenya;727;23;21363;364
2020-08-02;KE;Kenya;690;5;22053;369
2020-08-03;KE;Kenya;544;13;22597;382
2020-08-04;KE;Kenya;605;6;23202;388
2020-08-05;KE;Kenya;671;3;23873;391
2020-08-06;KE;Kenya;538;8;24411;399
2020-08-07;KE;Kenya;727;14;25138;413
2020-08-08;KE;Kenya;699;5;25837;418
2020-08-09;KE;Kenya;599;2;26436;420
2020-08-10;KE;Kenya;492;3;26928;423
2020-08-11;KE;Kenya;497;15;27425;438
2020-08-12;KE;Kenya;679;18;28104;456
2020-08-13;KE;Kenya;650;4;28754;460
2020-08-14;KE;Kenya;580;5;29334;465
2020-08-15;KE;Kenya;515;7;29849;472
2020-08-16;KE;Kenya;271;2;30120;474
2020-08-17;KE;Kenya;245;8;30365;482
2020-08-18;KE;Kenya;271;5;30636;487
2020-08-19;KE;Kenya;379;19;31015;506
2020-08-20;KE;Kenya;426;10;31441;516
2020-08-21;KE;Kenya;322;16;31763;532
2020-08-22;KE;Kenya;355;10;32118;542
2020-08-23;KE;Kenya;246;6;32364;548
2020-08-24;KE;Kenya;193;6;32557;554
2020-08-25;KE;Kenya;246;5;32803;559
2020-08-26;KE;Kenya;213;5;33016;564
2020-08-27;KE;Kenya;373;3;33389;567
2020-08-28;KE;Kenya;241;0;33630;567
2020-08-29;KE;Kenya;164;5;33794;572
2020-08-30;KE;Kenya;263;2;34057;574
2020-08-31;KE;Kenya;144;3;34201;577
2020-09-01;KE;Kenya;114;0;34315;577
2020-09-02;KE;Kenya;178;4;34493;581
2020-09-03;KE;Kenya;212;4;34705;585
2020-09-04;KE;Kenya;179;4;34884;589
2020-09-05;KE;Kenya;136;5;35020;594
2020-09-06;KE;Kenya;83;3;35103;597
2020-09-07;KE;Kenya;102;2;35205;599
2020-09-08;KE;Kenya;151;0;35356;599
2020-09-09;KE;Kenya;104;8;35460;607
2020-09-10;KE;Kenya;143;5;35603;612
2020-09-11;KE;Kenya;190;4;35793;616
2020-09-12;KE;Kenya;176;3;35969;619
2020-09-13;KE;Kenya;188;3;36157;622
2020-09-14;KE;Kenya;48;2;36205;624
2020-09-15;KE;Kenya;96;10;36301;634
2020-09-16;KE;Kenya;0;0;36301;634
2020-09-17;KE;Kenya;275;8;36576;642
2020-09-18;KE;Kenya;148;4;36724;646
2020-09-19;KE;Kenya;105;0;36829;646
2020-09-20;KE;Kenya;152;2;36981;648
2020-09-21;KE;Kenya;98;2;37079;650
2020-09-22;KE;Kenya;139;9;37218;659
2020-09-23;KE;Kenya;130;5;37348;664
2020-09-24;KE;Kenya;141;5;37489;669
2020-09-25;KE;Kenya;218;13;37707;682
2020-09-26;KE;Kenya;164;7;37871;689
2020-09-27;KE;Kenya;244;2;38115;691
2020-09-28;KE;Kenya;53;9;38168;700
2020-09-29;KE;Kenya;210;7;38378;707
2020-09-30;KE;Kenya;151;4;38529;711
2020-10-01;KE;Kenya;184;0;38713;711
2020-10-02;KE;Kenya;210;14;38923;725
2020-10-03;KE;Kenya;261;3;39184;728
2020-10-04;KE;Kenya;243;3;39427;731
2020-10-05;KE;Kenya;22;4;39449;735
2020-10-06;KE;Kenya;137;8;39586;743
2020-10-07;KE;Kenya;321;5;39907;748
2020-10-08;KE;Kenya;271;3;40178;751
2020-10-09;KE;Kenya;442;4;40620;755
2020-10-10;KE;Kenya;538;5;41158;760
2020-10-11;KE;Kenya;388;6;41546;766
2020-10-12;KE;Kenya;73;11;41619;777
2020-10-13;KE;Kenya;318;10;41937;787
2020-10-14;KE;Kenya;604;10;42541;797
2020-10-15;KE;Kenya;602;8;43143;805
2020-10-16;KE;Kenya;437;8;43580;813
2020-10-17;KE;Kenya;616;12;44196;825
2020-10-18;KE;Kenya;685;7;44881;832
2020-10-19;KE;Kenya;195;7;45076;839
2020-10-20;KE;Kenya;571;3;45647;842
2020-10-21;KE;Kenya;497;16;46144;858
2020-10-22;KE;Kenya;1068;12;47212;870
2020-10-23;KE;Kenya;631;14;47843;884
2020-10-24;KE;Kenya;947;12;48790;896
2020-10-25;KE;Kenya;931;6;49721;902
2020-10-26;KE;Kenya;276;18;49997;920
2020-10-27;KE;Kenya;836;14;50833;934
2020-10-28;KE;Kenya;1018;0;51851;934
2020-10-29;KE;Kenya;761;30;52612;964
2020-10-30;KE;Kenya;1185;17;53797;981
2020-10-31;KE;Kenya;1395;0;55192;981
2020-11-01;KE;Kenya;685;32;55877;1013
2020-11-02;KE;Kenya;724;14;56601;1027
2020-11-03;KE;Kenya;492;12;57093;1039
2020-11-04;KE;Kenya;1494;12;58587;1051
2020-11-05;KE;Kenya;1008;21;59595;1072
2020-11-06;KE;Kenya;1109;21;60704;1093
2020-11-07;KE;Kenya;1065;10;61769;1103
2020-11-08;KE;Kenya;719;8;62488;1111
2020-11-09;KE;Kenya;756;19;63244;1130
2020-11-10;KE;Kenya;1344;24;64588;1154
2020-11-11;KE;Kenya;1216;26;65804;1180
2020-11-12;KE;Kenya;919;23;66723;1203
2020-11-13;KE;Kenya;1470;25;68193;1228
2020-11-14;KE;Kenya;1080;0;69273;1228
2020-11-15;KE;Kenya;972;41;70245;1269
2020-11-16;KE;Kenya;559;18;70804;1287
2020-11-17;KE;Kenya;925;15;71729;1302
2020-11-18;KE;Kenya;957;11;72686;1313
2020-11-19;KE;Kenya;1459;17;74145;1330
2020-11-20;KE;Kenya;1048;19;75193;1349
2020-11-21;KE;Kenya;1211;17;76404;1366
2020-11-22;KE;Kenya;968;14;77372;1380
2020-11-23;KE;Kenya;413;12;77785;1392
2020-11-24;KE;Kenya;727;17;78512;1409
2020-11-25;KE;Kenya;810;8;79322;1417
2020-11-26;KE;Kenya;780;10;80102;1427
2020-11-27;KE;Kenya;1554;14;81656;1441
2020-11-28;KE;Kenya;949;4;82605;1445
2020-11-29;KE;Kenya;711;7;83316;1452
2020-11-30;KE;Kenya;302;17;83618;1469
2020-12-01;KE;Kenya;551;5;84169;1474
2020-12-02;KE;Kenya;961;10;85130;1484
2020-12-03;KE;Kenya;1253;16;86383;1500
2020-12-04;KE;Kenya;866;6;87249;1506
2020-12-05;KE;Kenya;735;12;87984;1518
2020-12-06;KE;Kenya;396;8;88380;1526
2020-12-07;KE;Kenya;199;5;88579;1531
2020-12-08;KE;Kenya;521;14;89100;1545
2020-12-09;KE;Kenya;561;7;89661;1552
2020-12-10;KE;Kenya;644;16;90305;1568
2020-12-11;KE;Kenya;673;14;90978;1582
2020-12-12;KE;Kenya;548;4;91526;1586
2020-12-13;KE;Kenya;366;1;91892;1587
2020-12-14;KE;Kenya;163;6;92055;1593
2020-12-15;KE;Kenya;404;11;92459;1604
2020-12-16;KE;Kenya;394;10;92853;1614
2020-12-17;KE;Kenya;552;4;93405;1618
2020-12-18;KE;Kenya;356;11;93761;1629
2020-12-19;KE;Kenya;390;4;94151;1633
2020-12-20;KE;Kenya;349;6;94500;1639
2020-12-21;KE;Kenya;114;5;94614;1644
2020-12-22;KE;Kenya;154;3;94768;1647
2020-12-23;KE;Kenya;427;1;95195;1648
2020-12-24;KE;Kenya;236;4;95431;1652
2020-12-25;KE;Kenya;282;1;95713;1653
2020-12-26;KE;Kenya;130;2;95843;1655
2020-12-27;KE;Kenya;80;3;95923;1658
2020-12-28;KE;Kenya;69;6;95992;1664
2020-12-29;KE;Kenya;147;1;96139;1665
2020-12-30;KE;Kenya;112;2;96251;1667
2020-12-31;KE;Kenya;207;3;96458;1670
2021-01-01;KE;Kenya;156;11;96614;1681
2021-01-02;KE;Kenya;64;4;96678;1685
2021-01-03;KE;Kenya;124;0;96802;1685
2021-01-04;KE;Kenya;106;1;96908;1686
2021-01-05;KE;Kenya;219;4;97127;1690
2021-01-06;KE;Kenya;271;4;97398;1694
2021-01-07;KE;Kenya;335;8;97733;1702
2021-01-08;KE;Kenya;221;1;97954;1703
2021-01-09;KE;Kenya;230;1;98184;1704
2021-01-10;KE;Kenya;87;6;98271;1710
2021-01-11;KE;Kenya;63;3;98334;1713
2021-01-12;KE;Kenya;98;3;98432;1716
2021-01-13;KE;Kenya;123;4;98555;1720
2021-01-14;KE;Kenya;138;3;98693;1723
2021-01-15;KE;Kenya;166;3;98859;1726
2021-01-16;KE;Kenya;223;2;99082;1728
2021-01-17;KE;Kenya;80;3;99162;1731
2021-01-18;KE;Kenya;65;3;99227;1734
2021-01-19;KE;Kenya;81;0;99308;1734
2021-01-20;KE;Kenya;136;2;99444;1736
2021-01-21;KE;Kenya;186;3;99630;1739
2021-01-22;KE;Kenya;139;1;99769;1740
2021-01-23;KE;Kenya;129;0;99898;1740
2021-01-24;KE;Kenya;85;4;99983;1744
2021-01-25;KE;Kenya;69;0;100052;1744
2021-01-26;KE;Kenya;141;6;100193;1750
2021-01-27;KE;Kenya;130;1;100323;1751
2021-01-28;KE;Kenya;99;2;100422;1753
2021-01-29;KE;Kenya;141;0;100563;1753
2021-01-30;KE;Kenya;112;2;100675;1755
2021-01-31;KE;Kenya;98;8;100773;1763
2021-02-01;KE;Kenya;83;3;100856;1766
2021-02-02;KE;Kenya;153;0;101009;1766
2021-02-03;KE;Kenya;150;3;101159;1769
2021-02-04;KE;Kenya;180;4;101339;1773
2021-02-05;KE;Kenya;195;3;101534;1776
2021-02-06;KE;Kenya;156;0;101690;1776
2021-02-07;KE;Kenya;129;3;101819;1779
2021-02-08;KE;Kenya;125;7;101944;1786
2021-02-09;KE;Kenya;104;3;102048;1789
2021-02-10;KE;Kenya;173;2;102221;1791
2021-02-11;KE;Kenya;132;3;102353;1794
2021-02-12;KE;Kenya;260;0;102613;1794
2021-02-13;KE;Kenya;179;1;102792;1795
2021-02-14;KE;Kenya;75;0;102867;1795
2021-02-15;KE;Kenya;147;0;103014;1795
2021-02-16;KE;Kenya;174;2;103188;1797
2021-02-17;KE;Kenya;144;4;103332;1801
2021-02-18;KE;Kenya;283;6;103615;1807
2021-02-19;KE;Kenya;226;6;103841;1813
2021-02-20;KE;Kenya;152;4;103993;1817
2021-02-21;KE;Kenya;208;6;104201;1823
2021-02-22;KE;Kenya;105;4;104306;1827
2021-02-23;KE;Kenya;194;10;104500;1837
2021-02-24;KE;Kenya;280;2;104780;1839
2021-02-25;KE;Kenya;277;8;105057;1847
2021-02-26;KE;Kenya;410;6;105467;1853
2021-02-27;KE;Kenya;181;1;105648;1854
2021-02-28;KE;Kenya;325;2;105973;1856
2021-03-01;KE;Kenya;152;3;106125;1859
2021-03-02;KE;Kenya;345;4;106470;1863
2021-03-03;KE;Kenya;331;3;106801;1866
2021-03-04;KE;Kenya;528;4;107329;1870
2021-03-05;KE;Kenya;400;3;107729;1873
2021-03-06;KE;Kenya;633;1;108362;1874
2021-03-07;KE;Kenya;465;2;108827;1876
2021-03-08;KE;Kenya;337;3;109164;1879
2021-03-09;KE;Kenya;479;7;109643;1886
2021-03-10;KE;Kenya;713;12;110356;1898
2021-03-11;KE;Kenya;829;1;111185;1899
2021-03-12;KE;Kenya;750;2;111935;1901
2021-03-13;KE;Kenya;870;7;112805;1908
2021-03-14;KE;Kenya;431;5;113236;1913
2021-03-15;KE;Kenya;731;5;113967;1918
2021-03-16;KE;Kenya;1064;7;115031;1925
2021-03-17;KE;Kenya;1279;12;116310;1937
2021-03-18;KE;Kenya;1225;17;117535;1954
2021-03-19;KE;Kenya;1354;28;118889;1982
2021-03-20;KE;Kenya;1274;12;120163;1994
2021-03-21;KE;Kenya;747;17;120910;2011
2021-03-22;KE;Kenya;1130;12;122040;2023
2021-03-23;KE;Kenya;1127;25;123167;2048
2021-03-24;KE;Kenya;1540;18;124707;2066
2021-03-25;KE;Kenya;1463;26;126170;2092
2021-03-26;KE;Kenya;2008;6;128178;2098
2021-03-27;KE;Kenya;1152;6;129330;2104
2021-03-28;KE;Kenya;884;13;130214;2117
2021-03-29;KE;Kenya;902;18;131116;2135
2021-03-30;KE;Kenya;1530;12;132646;2147
2021-03-31;KE;Kenya;1412;6;134058;2153
2021-04-01;KE;Kenya;984;14;135042;2167
2021-04-02;KE;Kenya;1851;19;136893;2186
2021-04-03;KE;Kenya;1184;20;138077;2206
2021-04-04;KE;Kenya;911;18;138988;2224
2021-04-05;KE;Kenya;460;20;139448;2244
2021-04-06;KE;Kenya;394;14;139842;2258
2021-04-07;KE;Kenya;1523;18;141365;2276
2021-04-08;KE;Kenya;1698;16;143063;2292
2021-04-09;KE;Kenya;1091;17;144154;2309
2021-04-10;KE;Kenya;1030;21;145184;2330
2021-04-11;KE;Kenya;486;18;145670;2348
2021-04-12;KE;Kenya;486;20;146156;2368
2021-04-13;KE;Kenya;991;26;147147;2394
2021-04-14;KE;Kenya;981;26;148128;2420
2021-04-15;KE;Kenya;1091;4;149219;2424
2021-04-16;KE;Kenya;1041;19;150260;2443
2021-04-17;KE;Kenya;1027;20;151287;2463
2021-04-18;KE;Kenya;366;18;151653;2481
2021-04-19;KE;Kenya;241;20;151894;2501
2021-04-20;KE;Kenya;629;18;152523;2519
2021-04-21;KE;Kenya;965;21;153488;2540
2021-04-22;KE;Kenya;904;20;154392;2560
2021-04-23;KE;Kenya;773;23;155165;2583
2021-04-24;KE;Kenya;1153;20;156318;2603
2021-04-25;KE;Kenya;469;19;156787;2622
2021-04-26;KE;Kenya;194;21;156981;2643
2021-04-27;KE;Kenya;511;22;157492;2665
2021-04-28;KE;Kenya;834;23;158326;2688
2021-04-29;KE;Kenya;495;19;158821;2707
2021-04-30;KE;Kenya;497;17;159318;2724
2021-05-01;KE;Kenya;735;20;160053;2744
2021-05-02;KE;Kenya;369;19;160422;2763
2021-05-03;KE;Kenya;137;18;160559;2781
2021-05-04;KE;Kenya;345;24;160904;2805
2021-05-05;KE;Kenya;489;20;161393;2825
2021-05-06;KE;Kenya;705;25;162098;2850
2021-05-07;KE;Kenya;568;15;162666;2865
2021-05-08;KE;Kenya;572;18;163238;2883
2021-05-09;KE;Kenya;316;12;163554;2895
2021-05-10;KE;Kenya;66;12;163620;2907
2021-05-11;KE;Kenya;356;21;163976;2928
2021-05-12;KE;Kenya;410;22;164386;2950
2021-05-13;KE;Kenya;334;18;164720;2968
2021-05-14;KE;Kenya;392;8;165112;2976
2021-05-15;KE;Kenya;267;25;165379;3001
2021-05-16;KE;Kenya;86;2;165465;3003
2021-05-17;KE;Kenya;72;10;165537;3013
2021-05-18;KE;Kenya;469;8;166006;3021
2021-05-19;KE;Kenya;376;14;166382;3035
2021-05-20;KE;Kenya;494;5;166876;3040
2021-05-21;KE;Kenya;659;3;167535;3043
2021-05-22;KE;Kenya;573;6;168108;3049
2021-05-23;KE;Kenya;324;10;168432;3059
2021-05-24;KE;Kenya;111;14;168543;3073
2021-05-25;KE;Kenya;382;14;168925;3087
2021-05-26;KE;Kenya;431;10;169356;3097
2021-05-27;KE;Kenya;341;11;169697;3108
2021-05-28;KE;Kenya;344;16;170041;3124
2021-05-29;KE;Kenya;444;17;170485;3141
2021-05-30;KE;Kenya;162;16;170647;3157
2021-05-31;KE;Kenya;88;15;170735;3172
2021-06-01;KE;Kenya;349;16;171084;3188
2021-06-02;KE;Kenya;142;18;171226;3206
2021-06-03;KE;Kenya;432;17;171658;3223
2021-06-04;KE;Kenya;284;17;171942;3240
2021-06-05;KE;Kenya;383;24;172325;3264
2021-06-06;KE;Kenya;166;23;172491;3287
2021-06-07;KE;Kenya;148;21;172639;3308
2021-06-08;KE;Kenya;433;18;173072;3326
2021-06-09;KE;Kenya;589;19;173661;3345
2021-06-10;KE;Kenya;624;17;174285;3362
2021-06-11;KE;Kenya;488;16;174773;3378
2021-06-12;KE;Kenya;403;18;175176;3396
2021-06-13;KE;Kenya;161;14;175337;3410
2021-06-14;KE;Kenya;344;11;175681;3421
2021-06-15;KE;Kenya;456;7;176137;3428
2021-06-16;KE;Kenya;485;0;176622;3428
2021-06-17;KE;Kenya;660;6;177282;3434
2021-06-18;KE;Kenya;796;3;178078;3437
2021-06-19;KE;Kenya;714;10;178792;3447
2021-06-20;KE;Kenya;283;9;179075;3456
2021-06-21;KE;Kenya;218;5;179293;3461
2021-06-22;KE;Kenya;583;23;179876;3484
2021-06-23;KE;Kenya;622;30;180498;3514
2021-06-24;KE;Kenya;741;24;181239;3538
2021-06-25;KE;Kenya;646;18;181885;3556
2021-06-26;KE;Kenya;508;18;182393;3574
2021-06-27;KE;Kenya;204;21;182597;3595
2021-06-28;KE;Kenya;287;17;182884;3612
2021-06-29;KE;Kenya;719;9;183603;3621
2021-06-30;KE;Kenya;558;13;184161;3634
2021-07-01;KE;Kenya;376;6;184537;3640
2021-05-18;KI;Kiribati;1;0;1;0
2021-05-19;KI;Kiribati;0;0;1;0
2021-05-20;KI;Kiribati;0;0;1;0
2021-05-21;KI;Kiribati;1;0;2;0
2021-05-22;KI;Kiribati;0;0;2;0
2021-05-23;KI;Kiribati;0;0;2;0
2021-05-24;KI;Kiribati;0;0;2;0
2021-05-25;KI;Kiribati;0;0;2;0
2021-05-26;KI;Kiribati;0;0;2;0
2021-05-27;KI;Kiribati;0;0;2;0
2021-05-28;KI;Kiribati;0;0;2;0
2021-05-29;KI;Kiribati;0;0;2;0
2021-05-30;KI;Kiribati;0;0;2;0
2021-05-31;KI;Kiribati;0;0;2;0
2021-06-01;KI;Kiribati;0;0;2;0
2021-06-02;KI;Kiribati;0;0;2;0
2021-06-03;KI;Kiribati;0;0;2;0
2021-06-04;KI;Kiribati;0;0;2;0
2021-06-05;KI;Kiribati;0;0;2;0
2021-06-06;KI;Kiribati;0;0;2;0
2021-06-07;KI;Kiribati;0;0;2;0
2021-06-08;KI;Kiribati;0;0;2;0
2021-06-09;KI;Kiribati;0;0;2;0
2021-06-10;KI;Kiribati;0;0;2;0
2021-06-11;KI;Kiribati;0;0;2;0
2021-06-12;KI;Kiribati;0;0;2;0
2021-06-13;KI;Kiribati;0;0;2;0
2021-06-14;KI;Kiribati;0;0;2;0
2021-06-15;KI;Kiribati;0;0;2;0
2021-06-16;KI;Kiribati;0;0;2;0
2021-06-17;KI;Kiribati;0;0;2;0
2021-06-18;KI;Kiribati;0;0;2;0
2021-06-19;KI;Kiribati;0;0;2;0
2021-06-20;KI;Kiribati;0;0;2;0
2021-06-21;KI;Kiribati;0;0;2;0
2021-06-22;KI;Kiribati;0;0;2;0
2021-06-23;KI;Kiribati;0;0;2;0
2021-06-24;KI;Kiribati;0;0;2;0
2021-06-25;KI;Kiribati;0;0;2;0
2021-06-26;KI;Kiribati;0;0;2;0
2021-06-27;KI;Kiribati;0;0;2;0
2021-06-28;KI;Kiribati;0;0;2;0
2021-06-29;KI;Kiribati;0;0;2;0
2021-06-30;KI;Kiribati;0;0;2;0
2021-07-01;KI;Kiribati;0;0;2;0
2020-03-14;;Kosovo;2;0;2;0
2020-03-15;;Kosovo;3;0;5;0
2020-03-16;;Kosovo;8;0;13;0
2020-03-17;;Kosovo;3;0;16;0
2020-03-18;;Kosovo;3;0;19;0
2020-03-19;;Kosovo;1;0;20;0
2020-03-20;;Kosovo;1;0;21;0
2020-03-21;;Kosovo;3;0;24;0
2020-03-22;;Kosovo;7;0;31;0
2020-03-23;;Kosovo;2;1;33;1
2020-03-24;;Kosovo;28;0;61;1
2020-03-25;;Kosovo;2;0;63;1
2020-03-26;;Kosovo;8;0;71;1
2020-03-27;;Kosovo;15;0;86;1
2020-03-28;;Kosovo;2;0;88;1
2020-03-29;;Kosovo;3;0;91;1
2020-03-30;;Kosovo;3;0;94;1
2020-03-31;;Kosovo;12;0;106;1
2020-04-01;;Kosovo;6;0;112;1
2020-04-02;;Kosovo;13;0;125;1
2020-04-03;;Kosovo;1;0;126;1
2020-04-04;;Kosovo;9;0;135;1
2020-04-05;;Kosovo;5;0;140;1
2020-04-06;;Kosovo;5;0;145;1
2020-04-07;;Kosovo;20;2;165;3
2020-04-08;;Kosovo;19;2;184;5
2020-04-09;;Kosovo;40;1;224;6
2020-04-10;;Kosovo;3;1;227;7
2020-04-11;;Kosovo;23;0;250;7
2020-04-12;;Kosovo;33;0;283;7
2020-04-13;;Kosovo;79;0;362;7
2020-04-14;;Kosovo;15;1;377;8
2020-04-15;;Kosovo;10;0;387;8
2020-04-16;;Kosovo;36;1;423;9
2020-04-17;;Kosovo;26;2;449;11
2020-04-18;;Kosovo;31;1;480;12
2020-04-19;;Kosovo;30;0;510;12
2020-04-20;;Kosovo;51;0;561;12
2020-04-21;;Kosovo;37;3;598;15
2020-04-22;;Kosovo;6;3;604;18
2020-04-23;;Kosovo;26;0;630;18
2020-04-24;;Kosovo;39;1;669;19
2020-04-25;;Kosovo;34;0;703;19
2020-04-26;;Kosovo;28;1;731;20
2020-04-27;;Kosovo;32;1;763;21
2020-04-28;;Kosovo;17;1;780;22
2020-04-29;;Kosovo;10;0;790;22
2020-04-30;;Kosovo;9;0;799;22
2020-05-01;;Kosovo;7;0;806;22
2020-05-02;;Kosovo;7;0;813;22
2020-05-03;;Kosovo;10;0;823;22
2020-05-04;;Kosovo;28;0;851;22
2020-05-05;;Kosovo;4;4;855;26
2020-05-06;;Kosovo;1;0;856;26
2020-05-07;;Kosovo;4;0;860;26
2020-05-08;;Kosovo;1;1;861;27
2020-05-09;;Kosovo;1;1;862;28
2020-05-10;;Kosovo;8;0;870;28
2020-05-11;;Kosovo;14;0;884;28
2020-05-12;;Kosovo;11;0;895;28
2020-05-13;;Kosovo;24;1;919;29
2020-05-14;;Kosovo;8;0;927;29
2020-05-15;;Kosovo;18;0;945;29
2020-05-16;;Kosovo;10;0;955;29
2020-05-17;;Kosovo;23;0;978;29
2020-05-18;;Kosovo;7;0;985;29
2020-05-19;;Kosovo;3;0;988;29
2020-05-20;;Kosovo;1;0;989;29
2020-05-21;;Kosovo;14;0;1003;29
2020-05-22;;Kosovo;1;0;1004;29
2020-05-23;;Kosovo;21;0;1025;29
2020-05-24;;Kosovo;7;0;1032;29
2020-05-25;;Kosovo;6;1;1038;30
2020-05-26;;Kosovo;0;0;1038;30
2020-05-27;;Kosovo;9;0;1047;30
2020-05-28;;Kosovo;1;0;1048;30
2020-05-29;;Kosovo;4;0;1052;30
2020-05-30;;Kosovo;12;0;1064;30
2020-05-31;;Kosovo;6;0;1070;30
2020-06-01;;Kosovo;13;0;1083;30
2020-06-02;;Kosovo;27;0;1110;30
2020-06-03;;Kosovo;13;0;1123;30
2020-06-04;;Kosovo;19;0;1142;30
2020-06-05;;Kosovo;5;0;1147;30
2020-06-06;;Kosovo;11;0;1158;30
2020-06-07;;Kosovo;36;0;1194;30
2020-06-08;;Kosovo;40;1;1234;31
2020-06-09;;Kosovo;29;0;1263;31
2020-06-10;;Kosovo;6;0;1269;31
2020-06-11;;Kosovo;29;0;1298;31
2020-06-12;;Kosovo;28;0;1326;31
2020-06-13;;Kosovo;58;0;1384;31
2020-06-14;;Kosovo;53;1;1437;32
2020-06-15;;Kosovo;49;1;1486;33
2020-06-16;;Kosovo;129;0;1615;33
2020-06-17;;Kosovo;141;1;1756;34
2020-06-18;;Kosovo;77;0;1833;34
2020-06-19;;Kosovo;83;0;1916;34
2020-06-20;;Kosovo;82;0;1998;34
2020-06-21;;Kosovo;75;1;2073;35
2020-06-22;;Kosovo;96;1;2169;36
2020-06-23;;Kosovo;47;1;2216;37
2020-06-24;;Kosovo;52;1;2268;38
2020-06-25;;Kosovo;95;2;2363;40
2020-06-26;;Kosovo;69;2;2432;42
2020-06-27;;Kosovo;62;2;2494;44
2020-06-28;;Kosovo;96;4;2590;48
2020-06-29;;Kosovo;87;1;2677;49
2020-06-30;;Kosovo;122;0;2799;49
2020-07-01;;Kosovo;79;2;2878;51
2020-07-02;;Kosovo;113;3;2991;54
2020-07-03;;Kosovo;73;1;3064;55
2020-07-04;;Kosovo;114;3;3178;58
2020-07-05;;Kosovo;178;8;3356;66
2020-07-06;;Kosovo;152;9;3508;75
2020-07-07;;Kosovo;195;4;3703;79
2020-07-08;;Kosovo;183;3;3886;82
2020-07-09;;Kosovo;214;4;4100;86
2020-07-10;;Kosovo;207;8;4307;94
2020-07-11;;Kosovo;205;3;4512;97
2020-07-12;;Kosovo;203;4;4715;101
2020-07-13;;Kosovo;216;1;4931;102
2020-07-14;;Kosovo;187;6;5118;108
2020-07-15;;Kosovo;119;4;5237;112
2020-07-16;;Kosovo;132;6;5369;118
2020-07-17;;Kosovo;103;6;5472;124
2020-07-18;;Kosovo;145;6;5617;130
2020-07-19;;Kosovo;118;5;5735;135
2020-07-20;;Kosovo;142;4;5877;139
2020-07-21;;Kosovo;168;5;6045;144
2020-07-22;;Kosovo;241;6;6286;150
2020-07-23;;Kosovo;181;8;6467;158
2020-07-24;;Kosovo;213;6;6680;164
2020-07-25;;Kosovo;237;5;6917;169
2020-07-26;;Kosovo;220;8;7137;177
2020-07-27;;Kosovo;276;8;7413;185
2020-07-28;;Kosovo;239;7;7652;192
2020-07-29;;Kosovo;194;4;7846;196
2020-07-30;;Kosovo;258;16;8104;212
2020-07-31;;Kosovo;226;15;8330;227
2020-08-01;;Kosovo;224;9;8554;236
2020-08-02;;Kosovo;245;13;8799;249
2020-08-03;;Kosovo;250;7;9049;256
2020-08-04;;Kosovo;225;13;9274;269
2020-08-05;;Kosovo;218;15;9492;284
2020-08-06;;Kosovo;196;16;9688;300
2020-08-07;;Kosovo;181;3;9869;303
2020-08-08;;Kosovo;190;13;10059;316
2020-08-09;;Kosovo;188;12;10247;328
2020-08-10;;Kosovo;172;13;10419;341
2020-08-11;;Kosovo;171;13;10590;354
2020-08-12;;Kosovo;205;11;10795;365
2020-08-13;;Kosovo;193;8;10988;373
2020-08-14;;Kosovo;142;8;11130;381
2020-08-15;;Kosovo;145;9;11275;390
2020-08-16;;Kosovo;141;11;11416;401
2020-08-17;;Kosovo;129;9;11545;410
2020-08-18;;Kosovo;141;6;11686;416
2020-08-19;;Kosovo;162;9;11848;425
2020-08-20;;Kosovo;158;13;12006;438
2020-08-21;;Kosovo;162;10;12168;448
2020-08-22;;Kosovo;169;9;12337;457
2020-08-23;;Kosovo;111;10;12448;467
2020-08-24;;Kosovo;99;13;12547;480
2020-08-25;;Kosovo;136;8;12683;488
2020-08-26;;Kosovo;157;4;12840;492
2020-08-27;;Kosovo;141;6;12981;498
2020-08-28;;Kosovo;119;1;13100;499
2020-08-29;;Kosovo;115;9;13215;508
2020-08-30;;Kosovo;119;8;13334;516
2020-08-31;;Kosovo;120;9;13454;525
2020-09-01;;Kosovo;147;8;13601;533
2020-09-02;;Kosovo;112;6;13713;539
2020-09-03;;Kosovo;78;9;13791;548
2020-09-04;;Kosovo;119;3;13910;551
2020-09-05;;Kosovo;117;5;14027;556
2020-09-06;;Kosovo;92;7;14119;563
2020-09-07;;Kosovo;85;5;14204;568
2020-09-08;;Kosovo;97;0;14301;568
2020-09-09;;Kosovo;76;6;14377;574
2020-09-10;;Kosovo;69;7;14446;581
2020-09-11;;Kosovo;50;5;14496;586
2020-09-12;;Kosovo;70;3;14566;589
2020-09-13;;Kosovo;71;7;14637;596
2020-09-14;;Kosovo;55;4;14692;600
2020-09-15;;Kosovo;71;1;14763;601
2020-09-16;;Kosovo;76;3;14839;604
2020-09-17;;Kosovo;43;3;14882;607
2020-09-18;;Kosovo;57;4;14939;611
2020-09-19;;Kosovo;63;3;15002;614
2020-09-20;;Kosovo;61;0;15063;614
2020-09-21;;Kosovo;79;1;15142;615
2020-09-22;;Kosovo;66;0;15208;615
2020-09-23;;Kosovo;62;1;15270;616
2020-09-24;;Kosovo;63;0;15333;616
2020-09-25;;Kosovo;46;1;15379;617
2020-09-26;;Kosovo;46;2;15425;619
2020-09-27;;Kosovo;47;3;15472;622
2020-09-28;;Kosovo;48;3;15520;625
2020-09-29;;Kosovo;54;0;15574;625
2020-09-30;;Kosovo;46;0;15620;625
2020-10-01;;Kosovo;43;2;15663;627
2020-10-02;;Kosovo;42;0;15705;627
2020-10-03;;Kosovo;53;3;15758;630
2020-10-04;;Kosovo;56;0;15814;630
2020-10-05;;Kosovo;41;3;15855;633
2020-10-06;;Kosovo;34;2;15889;635
2020-10-07;;Kosovo;49;3;15938;638
2020-10-08;;Kosovo;33;0;15971;638
2020-10-09;;Kosovo;79;3;16050;641
2020-10-10;;Kosovo;80;4;16130;645
2020-10-11;;Kosovo;49;2;16179;647
2020-10-12;;Kosovo;68;1;16247;648
2020-10-13;;Kosovo;98;1;16345;649
2020-10-14;;Kosovo;80;1;16425;650
2020-10-15;;Kosovo;77;0;16502;650
2020-10-16;;Kosovo;104;2;16606;652
2020-10-17;;Kosovo;148;0;16754;652
2020-10-18;;Kosovo;137;1;16891;653
2020-10-19;;Kosovo;118;3;17009;656
2020-10-20;;Kosovo;130;1;17139;657
2020-10-21;;Kosovo;124;0;17263;657
2020-10-22;;Kosovo;159;0;17422;657
2020-10-23;;Kosovo;169;2;17591;659
2020-10-24;;Kosovo;166;2;17757;661
2020-10-25;;Kosovo;186;2;17943;663
2020-10-26;;Kosovo;0;0;17943;663
2020-10-27;;Kosovo;0;0;17943;663
2020-10-28;;Kosovo;683;10;18626;673
2020-10-29;;Kosovo;0;0;18626;673
2020-10-30;;Kosovo;702;5;19328;678
2020-10-31;;Kosovo;0;0;19328;678
2020-11-01;;Kosovo;0;0;19328;678
2020-11-02;;Kosovo;851;10;20179;688
2020-11-03;;Kosovo;820;17;20999;705
2020-11-04;;Kosovo;546;9;21545;714
2020-11-05;;Kosovo;661;6;22206;720
2020-11-06;;Kosovo;728;12;22934;732
2020-11-07;;Kosovo;0;0;22934;732
2020-11-08;;Kosovo;0;0;22934;732
2020-11-09;;Kosovo;1858;36;24792;768
2020-11-10;;Kosovo;596;5;25388;773
2020-11-11;;Kosovo;733;4;26121;777
2020-11-12;;Kosovo;767;8;26888;785
2020-11-13;;Kosovo;963;13;27851;798
2020-11-14;;Kosovo;0;0;27851;798
2020-11-15;;Kosovo;1266;24;29117;822
2020-11-16;;Kosovo;688;11;29805;833
2020-11-17;;Kosovo;0;0;29805;833
2020-11-18;;Kosovo;1410;27;31215;860
2020-11-19;;Kosovo;807;14;32022;874
2020-11-20;;Kosovo;855;11;32877;885
2020-11-21;;Kosovo;711;19;33588;904
2020-11-22;;Kosovo;707;10;34295;914
2020-11-23;;Kosovo;645;12;34940;926
2020-11-24;;Kosovo;609;13;35549;939
2020-11-25;;Kosovo;704;9;36253;948
2020-11-26;;Kosovo;775;15;37028;963
2020-11-27;;Kosovo;764;12;37792;975
2020-11-28;;Kosovo;639;14;38431;989
2020-11-29;;Kosovo;626;16;39057;1005
2020-11-30;;Kosovo;539;11;39596;1016
2020-12-01;;Kosovo;521;10;40117;1026
2020-12-02;;Kosovo;0;0;40117;1026
2020-12-03;;Kosovo;0;0;40117;1026
2020-12-04;;Kosovo;0;0;40117;1026
2020-12-05;;Kosovo;2220;61;42337;1087
2020-12-06;;Kosovo;468;19;42805;1106
2020-12-07;;Kosovo;519;14;43324;1120
2020-12-08;;Kosovo;557;17;43881;1137
2020-12-09;;Kosovo;561;11;44442;1148
2020-12-10;;Kosovo;562;13;45004;1161
2020-12-11;;Kosovo;590;13;45594;1174
2020-12-12;;Kosovo;524;12;46118;1186
2020-12-13;;Kosovo;462;12;46580;1198
2020-12-14;;Kosovo;329;5;46909;1203
2020-12-15;;Kosovo;294;17;47203;1220
2020-12-16;;Kosovo;296;5;47499;1225
2020-12-17;;Kosovo;0;0;47499;1225
2020-12-18;;Kosovo;838;15;48337;1240
2020-12-19;;Kosovo;345;8;48682;1248
2020-12-20;;Kosovo;223;8;48905;1256
2020-12-21;;Kosovo;264;6;49169;1262
2020-12-22;;Kosovo;0;0;49169;1262
2020-12-23;;Kosovo;271;12;49440;1274
2020-12-24;;Kosovo;0;0;49440;1274
2020-12-25;;Kosovo;695;24;50135;1298
2020-12-26;;Kosovo;270;7;50405;1305
2020-12-27;;Kosovo;215;4;50620;1309
2020-12-28;;Kosovo;181;8;50801;1317
2020-12-29;;Kosovo;109;8;50910;1325
2020-12-30;;Kosovo;0;0;50910;1325
2020-12-31;;Kosovo;234;7;51144;1332
2021-01-01;;Kosovo;358;4;51502;1336
2021-01-02;;Kosovo;0;0;51502;1336
2021-01-03;;Kosovo;463;8;51965;1344
2021-01-04;;Kosovo;0;0;51965;1344
2021-01-05;;Kosovo;368;11;52333;1355
2021-01-06;;Kosovo;0;0;52333;1355
2021-01-07;;Kosovo;610;8;52943;1363
2021-01-08;;Kosovo;321;5;53264;1368
2021-01-09;;Kosovo;0;0;53264;1368
2021-01-10;;Kosovo;512;9;53776;1377
2021-01-11;;Kosovo;206;6;53982;1383
2021-01-12;;Kosovo;279;4;54261;1387
2021-01-13;;Kosovo;299;1;54560;1388
2021-01-14;;Kosovo;279;4;54839;1392
2021-01-15;;Kosovo;296;7;55135;1399
2021-01-16;;Kosovo;0;0;55135;1399
2021-01-17;;Kosovo;716;11;55851;1410
2021-01-18;;Kosovo;0;0;55851;1410
2021-01-19;;Kosovo;267;1;56118;1411
2021-01-20;;Kosovo;294;9;56412;1420
2021-01-21;;Kosovo;616;13;57028;1433
2021-01-22;;Kosovo;289;14;57317;1447
2021-01-23;;Kosovo;0;0;57317;1447
2021-01-24;;Kosovo;0;0;57317;1447
2021-01-25;;Kosovo;1082;19;58399;1466
2021-01-26;;Kosovo;0;0;58399;1466
2021-01-27;;Kosovo;589;13;58988;1479
2021-01-28;;Kosovo;0;0;58988;1479
2021-01-29;;Kosovo;658;8;59646;1487
2021-01-30;;Kosovo;0;0;59646;1487
2021-01-31;;Kosovo;572;11;60218;1498
2021-02-01;;Kosovo;0;0;60218;1498
2021-02-02;;Kosovo;0;0;60218;1498
2021-02-03;;Kosovo;868;11;61086;1509
2021-02-04;;Kosovo;318;5;61404;1514
2021-02-05;;Kosovo;284;5;61688;1519
2021-02-06;;Kosovo;0;0;61688;1519
2021-02-07;;Kosovo;0;0;61688;1519
2021-02-08;;Kosovo;860;7;62548;1526
2021-02-09;;Kosovo;0;0;62548;1526
2021-02-10;;Kosovo;541;6;63089;1532
2021-02-11;;Kosovo;0;0;63089;1532
2021-02-12;;Kosovo;716;8;63805;1540
2021-02-13;;Kosovo;0;0;63805;1540
2021-02-14;;Kosovo;0;0;63805;1540
2021-02-15;;Kosovo;814;5;64619;1545
2021-02-16;;Kosovo;249;3;64868;1548
2021-02-17;;Kosovo;0;0;64868;1548
2021-02-18;;Kosovo;297;5;65165;1553
2021-02-19;;Kosovo;285;5;65450;1558
2021-02-20;;Kosovo;0;0;65450;1558
2021-02-21;;Kosovo;1030;14;66480;1572
2021-02-22;;Kosovo;0;0;66480;1572
2021-02-23;;Kosovo;260;3;66740;1575
2021-02-24;;Kosovo;829;7;67569;1582
2021-02-25;;Kosovo;437;5;68006;1587
2021-02-26;;Kosovo;445;5;68451;1592
2021-02-27;;Kosovo;0;0;68451;1592
2021-02-28;;Kosovo;0;0;68451;1592
2021-03-01;;Kosovo;0;0;68451;1592
2021-03-02;;Kosovo;1834;24;70285;1616
2021-03-03;;Kosovo;568;4;70853;1620
2021-03-04;;Kosovo;0;0;70853;1620
2021-03-05;;Kosovo;591;7;71444;1627
2021-03-06;;Kosovo;1156;13;72600;1640
2021-03-07;;Kosovo;0;0;72600;1640
2021-03-08;;Kosovo;1135;15;73735;1655
2021-03-09;;Kosovo;0;0;73735;1655
2021-03-10;;Kosovo;973;19;74708;1674
2021-03-11;;Kosovo;0;0;74708;1674
2021-03-12;;Kosovo;1362;14;76070;1688
2021-03-13;;Kosovo;0;0;76070;1688
2021-03-14;;Kosovo;0;0;76070;1688
2021-03-15;;Kosovo;1717;27;77787;1715
2021-03-16;;Kosovo;553;8;78340;1723
2021-03-17;;Kosovo;0;0;78340;1723
2021-03-18;;Kosovo;0;0;78340;1723
2021-03-19;;Kosovo;1955;29;80295;1752
2021-03-20;;Kosovo;0;0;80295;1752
2021-03-21;;Kosovo;0;0;80295;1752
2021-03-22;;Kosovo;0;0;80295;1752
2021-03-23;;Kosovo;0;0;80295;1752
2021-03-24;;Kosovo;3877;59;84172;1811
2021-03-25;;Kosovo;0;0;84172;1811
2021-03-26;;Kosovo;0;0;84172;1811
2021-03-27;;Kosovo;0;0;84172;1811
2021-03-28;;Kosovo;0;0;84172;1811
2021-03-29;;Kosovo;4257;41;88429;1852
2021-03-30;;Kosovo;752;14;89181;1866
2021-03-31;;Kosovo;0;0;89181;1866
2021-04-01;;Kosovo;1898;26;91079;1892
2021-04-02;;Kosovo;0;0;91079;1892
2021-04-03;;Kosovo;0;0;91079;1892
2021-04-04;;Kosovo;0;0;91079;1892
2021-04-05;;Kosovo;0;0;91079;1892
2021-04-06;;Kosovo;3251;50;94330;1942
2021-04-07;;Kosovo;685;14;95015;1956
2021-04-08;;Kosovo;871;12;95886;1968
2021-04-09;;Kosovo;0;0;95886;1968
2021-04-10;;Kosovo;0;0;95886;1968
2021-04-11;;Kosovo;0;0;95886;1968
2021-04-12;;Kosovo;0;0;95886;1968
2021-04-13;;Kosovo;2129;36;98015;2004
2021-04-14;;Kosovo;1195;26;99210;2030
2021-04-15;;Kosovo;0;0;99210;2030
2021-04-16;;Kosovo;1119;31;100329;2061
2021-04-17;;Kosovo;0;0;100329;2061
2021-04-18;;Kosovo;862;19;101191;2080
2021-04-19;;Kosovo;0;0;101191;2080
2021-04-20;;Kosovo;641;25;101832;2105
2021-04-21;;Kosovo;0;0;101832;2105
2021-04-22;;Kosovo;888;10;102720;2115
2021-04-23;;Kosovo;0;0;102720;2115
2021-04-24;;Kosovo;0;0;102720;2115
2021-04-25;;Kosovo;918;19;103638;2134
2021-04-26;;Kosovo;0;0;103638;2134
2021-04-27;;Kosovo;0;0;103638;2134
2021-04-28;;Kosovo;0;0;103638;2134
2021-04-29;;Kosovo;0;0;103638;2134
2021-04-30;;Kosovo;0;0;103638;2134
2021-05-01;;Kosovo;0;0;103638;2134
2021-05-02;;Kosovo;0;0;103638;2134
2021-05-03;;Kosovo;0;0;103638;2134
2021-05-04;;Kosovo;0;0;103638;2134
2021-05-05;;Kosovo;0;0;103638;2134
2021-05-06;;Kosovo;1976;69;105614;2203
2021-05-07;;Kosovo;170;4;105784;2207
2021-05-08;;Kosovo;0;0;105784;2207
2021-05-09;;Kosovo;0;0;105784;2207
2021-05-10;;Kosovo;0;0;105784;2207
2021-05-11;;Kosovo;346;11;106130;2218
2021-05-12;;Kosovo;113;4;106243;2222
2021-05-13;;Kosovo;0;0;106243;2222
2021-05-14;;Kosovo;0;0;106243;2222
2021-05-15;;Kosovo;0;0;106243;2222
2021-05-16;;Kosovo;263;8;106506;2230
2021-05-17;;Kosovo;25;1;106531;2231
2021-05-18;;Kosovo;0;0;106531;2231
2021-05-19;;Kosovo;126;9;106657;2240
2021-05-20;;Kosovo;55;2;106712;2242
2021-05-21;;Kosovo;58;2;106770;2244
2021-05-22;;Kosovo;0;0;106770;2244
2021-05-23;;Kosovo;0;0;106770;2244
2021-05-24;;Kosovo;0;0;106770;2244
2021-05-25;;Kosovo;91;2;106861;2246
2021-05-26;;Kosovo;44;0;106905;2246
2021-05-27;;Kosovo;23;1;106928;2247
2021-05-28;;Kosovo;18;0;106946;2247
2021-05-29;;Kosovo;0;0;106946;2247
2021-05-30;;Kosovo;51;1;106997;2248
2021-05-31;;Kosovo;5;0;107002;2248
2021-06-01;;Kosovo;19;0;107021;2248
2021-06-02;;Kosovo;18;0;107039;2248
2021-06-03;;Kosovo;12;0;107051;2248
2021-06-04;;Kosovo;7;1;107058;2249
2021-06-05;;Kosovo;0;0;107058;2249
2021-06-06;;Kosovo;0;0;107058;2249
2021-06-07;;Kosovo;41;1;107099;2250
2021-06-08;;Kosovo;0;0;107099;2250
2021-06-09;;Kosovo;26;2;107125;2252
2021-06-10;;Kosovo;0;0;107125;2252
2021-06-11;;Kosovo;0;0;107125;2252
2021-06-12;;Kosovo;0;0;107125;2252
2021-06-13;;Kosovo;45;3;107170;2255
2021-06-14;;Kosovo;5;0;107175;2255
2021-06-15;;Kosovo;0;0;107175;2255
2021-06-16;;Kosovo;17;0;107192;2255
2021-06-17;;Kosovo;0;0;107192;2255
2021-06-18;;Kosovo;0;0;107192;2255
2021-06-19;;Kosovo;0;0;107192;2255
2021-06-20;;Kosovo;0;0;107192;2255
2021-06-21;;Kosovo;55;1;107247;2256
2021-06-22;;Kosovo;0;0;107247;2256
2021-06-23;;Kosovo;0;0;107247;2256
2021-06-24;;Kosovo;52;4;107299;2260
2021-06-25;;Kosovo;0;0;107299;2260
2021-06-26;;Kosovo;0;0;107299;2260
2021-06-27;;Kosovo;0;0;107299;2260
2021-06-28;;Kosovo;32;2;107331;2262
2021-06-29;;Kosovo;4;0;107335;2262
2021-06-30;;Kosovo;423;0;107758;2262
2021-07-01;;Kosovo;10;0;107768;2262
2020-02-24;KW;Kuwait;1;0;1;0
2020-02-25;KW;Kuwait;10;0;11;0
2020-02-26;KW;Kuwait;15;0;26;0
2020-02-27;KW;Kuwait;17;0;43;0
2020-02-28;KW;Kuwait;2;0;45;0
2020-02-29;KW;Kuwait;0;0;45;0
2020-03-01;KW;Kuwait;0;0;45;0
2020-03-02;KW;Kuwait;11;0;56;0
2020-03-03;KW;Kuwait;0;0;56;0
2020-03-04;KW;Kuwait;0;0;56;0
2020-03-05;KW;Kuwait;2;0;58;0
2020-03-06;KW;Kuwait;0;0;58;0
2020-03-07;KW;Kuwait;3;0;61;0
2020-03-08;KW;Kuwait;3;0;64;0
2020-03-09;KW;Kuwait;0;0;64;0
2020-03-10;KW;Kuwait;5;0;69;0
2020-03-11;KW;Kuwait;3;0;72;0
2020-03-12;KW;Kuwait;8;0;80;0
2020-03-13;KW;Kuwait;0;0;80;0
2020-03-14;KW;Kuwait;24;0;104;0
2020-03-15;KW;Kuwait;8;0;112;0
2020-03-16;KW;Kuwait;11;0;123;0
2020-03-17;KW;Kuwait;7;0;130;0
2020-03-18;KW;Kuwait;12;0;142;0
2020-03-19;KW;Kuwait;6;0;148;0
2020-03-20;KW;Kuwait;11;0;159;0
2020-03-21;KW;Kuwait;17;0;176;0
2020-03-22;KW;Kuwait;12;0;188;0
2020-03-23;KW;Kuwait;1;0;189;0
2020-03-24;KW;Kuwait;2;0;191;0
2020-03-25;KW;Kuwait;4;0;195;0
2020-03-26;KW;Kuwait;13;0;208;0
2020-03-27;KW;Kuwait;17;0;225;0
2020-03-28;KW;Kuwait;10;0;235;0
2020-03-29;KW;Kuwait;20;0;255;0
2020-03-30;KW;Kuwait;11;0;266;0
2020-03-31;KW;Kuwait;23;0;289;0
2020-04-01;KW;Kuwait;28;0;317;0
2020-04-02;KW;Kuwait;25;0;342;0
2020-04-03;KW;Kuwait;75;0;417;0
2020-04-04;KW;Kuwait;62;1;479;1
2020-04-05;KW;Kuwait;77;0;556;1
2020-04-06;KW;Kuwait;109;0;665;1
2020-04-07;KW;Kuwait;78;0;743;1
2020-04-08;KW;Kuwait;112;0;855;1
2020-04-09;KW;Kuwait;55;0;910;1
2020-04-10;KW;Kuwait;83;0;993;1
2020-04-11;KW;Kuwait;161;0;1154;1
2020-04-12;KW;Kuwait;80;0;1234;1
2020-04-13;KW;Kuwait;66;1;1300;2
2020-04-14;KW;Kuwait;55;1;1355;3
2020-04-15;KW;Kuwait;50;0;1405;3
2020-04-16;KW;Kuwait;119;0;1524;3
2020-04-17;KW;Kuwait;134;2;1658;5
2020-04-18;KW;Kuwait;93;1;1751;6
2020-04-19;KW;Kuwait;164;1;1915;7
2020-04-20;KW;Kuwait;80;2;1995;9
2020-04-21;KW;Kuwait;85;2;2080;11
2020-04-22;KW;Kuwait;168;2;2248;13
2020-04-23;KW;Kuwait;151;1;2399;14
2020-04-24;KW;Kuwait;215;1;2614;15
2020-04-25;KW;Kuwait;278;4;2892;19
2020-04-26;KW;Kuwait;183;1;3075;20
2020-04-27;KW;Kuwait;213;2;3288;22
2020-04-28;KW;Kuwait;152;1;3440;23
2020-04-29;KW;Kuwait;300;1;3740;24
2020-04-30;KW;Kuwait;284;2;4024;26
2020-05-01;KW;Kuwait;353;4;4377;30
2020-05-02;KW;Kuwait;242;3;4619;33
2020-05-03;KW;Kuwait;364;5;4983;38
2020-05-04;KW;Kuwait;295;2;5278;40
2020-05-05;KW;Kuwait;526;0;5804;40
2020-05-06;KW;Kuwait;485;2;6289;42
2020-05-07;KW;Kuwait;278;2;6567;44
2020-05-08;KW;Kuwait;641;3;7208;47
2020-05-09;KW;Kuwait;415;2;7623;49
2020-05-10;KW;Kuwait;1065;9;8688;58
2020-05-11;KW;Kuwait;598;7;9286;65
2020-05-12;KW;Kuwait;991;10;10277;75
2020-05-13;KW;Kuwait;751;7;11028;82
2020-05-14;KW;Kuwait;947;6;11975;88
2020-05-15;KW;Kuwait;885;8;12860;96
2020-05-16;KW;Kuwait;942;11;13802;107
2020-05-17;KW;Kuwait;1048;5;14850;112
2020-05-18;KW;Kuwait;841;6;15691;118
2020-05-19;KW;Kuwait;1073;3;16764;121
2020-05-20;KW;Kuwait;804;3;17568;124
2020-05-21;KW;Kuwait;1041;5;18609;129
2020-05-22;KW;Kuwait;955;9;19564;138
2020-05-23;KW;Kuwait;900;10;20464;148
2020-05-24;KW;Kuwait;838;8;21302;156
2020-05-25;KW;Kuwait;665;9;21967;165
2020-05-26;KW;Kuwait;608;7;22575;172
2020-05-27;KW;Kuwait;692;3;23267;175
2020-05-28;KW;Kuwait;845;10;24112;185
2020-05-29;KW;Kuwait;1072;9;25184;194
2020-05-30;KW;Kuwait;1008;11;26192;205
2020-05-31;KW;Kuwait;851;7;27043;212
2020-06-01;KW;Kuwait;719;8;27762;220
2020-06-02;KW;Kuwait;887;6;28649;226
2020-06-03;KW;Kuwait;710;4;29359;230
2020-06-04;KW;Kuwait;562;6;29921;236
2020-06-05;KW;Kuwait;723;8;30644;244
2020-06-06;KW;Kuwait;487;10;31131;254
2020-06-07;KW;Kuwait;717;10;31848;264
2020-06-08;KW;Kuwait;662;5;32510;269
2020-06-09;KW;Kuwait;630;4;33140;273
2020-06-10;KW;Kuwait;683;2;33823;275
2020-06-11;KW;Kuwait;609;4;34432;279
2020-06-12;KW;Kuwait;520;6;34952;285
2020-06-13;KW;Kuwait;514;4;35466;289
2020-06-14;KW;Kuwait;454;7;35920;296
2020-06-15;KW;Kuwait;511;2;36431;298
2020-06-16;KW;Kuwait;527;5;36958;303
2020-06-17;KW;Kuwait;575;3;37533;306
2020-06-18;KW;Kuwait;541;2;38074;308
2020-06-19;KW;Kuwait;604;5;38678;313
2020-06-20;KW;Kuwait;467;6;39145;319
2020-06-21;KW;Kuwait;505;7;39650;326
2020-06-22;KW;Kuwait;641;4;40291;330
2020-06-23;KW;Kuwait;742;4;41033;334
2020-06-24;KW;Kuwait;846;3;41879;337
2020-06-25;KW;Kuwait;909;2;42788;339
2020-06-26;KW;Kuwait;915;2;43703;341
2020-06-27;KW;Kuwait;688;3;44391;344
2020-06-28;KW;Kuwait;551;4;44942;348
2020-06-29;KW;Kuwait;582;2;45524;350
2020-06-30;KW;Kuwait;671;4;46195;354
2020-07-01;KW;Kuwait;745;4;46940;358
2020-07-02;KW;Kuwait;919;1;47859;359
2020-07-03;KW;Kuwait;813;1;48672;360
2020-07-04;KW;Kuwait;631;5;49303;365
2020-07-05;KW;Kuwait;638;3;49941;368
2020-07-06;KW;Kuwait;703;5;50644;373
2020-07-07;KW;Kuwait;601;4;51245;377
2020-07-08;KW;Kuwait;762;2;52007;379
2020-07-09;KW;Kuwait;833;3;52840;382
2020-07-10;KW;Kuwait;740;1;53580;383
2020-07-11;KW;Kuwait;478;3;54058;386
2020-07-12;KW;Kuwait;836;4;54894;390
2020-07-13;KW;Kuwait;614;3;55508;393
2020-07-14;KW;Kuwait;666;3;56174;396
2020-07-15;KW;Kuwait;703;3;56877;399
2020-07-16;KW;Kuwait;791;3;57668;402
2020-07-17;KW;Kuwait;553;2;58221;404
2020-07-18;KW;Kuwait;683;3;58904;407
2020-07-19;KW;Kuwait;300;1;59204;408
2020-07-20;KW;Kuwait;559;0;59763;408
2020-07-21;KW;Kuwait;671;4;60434;412
2020-07-22;KW;Kuwait;751;5;61185;417
2020-07-23;KW;Kuwait;687;4;61872;421
2020-07-24;KW;Kuwait;753;4;62625;425
2020-07-25;KW;Kuwait;684;4;63309;429
2020-07-26;KW;Kuwait;464;4;63773;433
2020-07-27;KW;Kuwait;606;5;64379;438
2020-07-28;KW;Kuwait;770;4;65149;442
2020-07-29;KW;Kuwait;754;2;65903;444
2020-07-30;KW;Kuwait;626;1;66529;445
2020-07-31;KW;Kuwait;428;2;66957;447
2020-08-01;KW;Kuwait;491;6;67448;453
2020-08-02;KW;Kuwait;463;4;67911;457
2020-08-03;KW;Kuwait;388;4;68299;461
2020-08-04;KW;Kuwait;475;4;68774;465
2020-08-05;KW;Kuwait;651;3;69425;468
2020-08-06;KW;Kuwait;620;1;70045;469
2020-08-07;KW;Kuwait;682;2;70727;471
2020-08-08;KW;Kuwait;472;3;71199;474
2020-08-09;KW;Kuwait;514;4;71713;478
2020-08-10;KW;Kuwait;687;4;72400;482
2020-08-11;KW;Kuwait;668;4;73068;486
2020-08-12;KW;Kuwait;717;3;73785;489
2020-08-13;KW;Kuwait;701;0;74486;489
2020-08-14;KW;Kuwait;699;5;75185;494
2020-08-15;KW;Kuwait;512;4;75697;498
2020-08-16;KW;Kuwait;508;3;76205;501
2020-08-17;KW;Kuwait;622;1;76827;502
2020-08-18;KW;Kuwait;643;3;77470;505
2020-08-19;KW;Kuwait;675;2;78145;507
2020-08-20;KW;Kuwait;622;2;78767;509
2020-08-21;KW;Kuwait;502;2;79269;511
2020-08-22;KW;Kuwait;688;2;79957;513
2020-08-23;KW;Kuwait;571;2;80528;515
2020-08-24;KW;Kuwait;432;3;80960;518
2020-08-25;KW;Kuwait;613;1;81573;519
2020-08-26;KW;Kuwait;698;2;82271;521
2020-08-27;KW;Kuwait;674;1;82945;522
2020-08-28;KW;Kuwait;633;3;83578;525
2020-08-29;KW;Kuwait;646;3;84224;528
2020-08-30;KW;Kuwait;412;2;84636;530
2020-08-31;KW;Kuwait;473;1;85109;531
2020-09-01;KW;Kuwait;702;3;85811;534
2020-09-02;KW;Kuwait;667;1;86478;535
2020-09-03;KW;Kuwait;900;1;87378;536
2020-09-04;KW;Kuwait;865;1;88243;537
2020-09-05;KW;Kuwait;720;3;88963;540
2020-09-06;KW;Kuwait;619;4;89582;544
2020-09-07;KW;Kuwait;805;2;90387;546
2020-09-08;KW;Kuwait;857;2;91244;548
2020-09-09;KW;Kuwait;838;4;92082;552
2020-09-10;KW;Kuwait;740;4;92822;556
2020-09-11;KW;Kuwait;653;1;93475;557
2020-09-12;KW;Kuwait;736;1;94211;558
2020-09-13;KW;Kuwait;553;2;94764;560
2020-09-14;KW;Kuwait;708;3;95472;563
2020-09-15;KW;Kuwait;829;5;96301;568
2020-09-16;KW;Kuwait;698;3;96999;571
2020-09-17;KW;Kuwait;825;4;97824;575
2020-09-18;KW;Kuwait;704;5;98528;580
2020-09-19;KW;Kuwait;521;1;99049;581
2020-09-20;KW;Kuwait;385;3;99434;584
2020-09-21;KW;Kuwait;530;1;99964;585
2020-09-22;KW;Kuwait;719;3;100683;588
2020-09-23;KW;Kuwait;616;2;101299;590
2020-09-24;KW;Kuwait;552;2;101851;592
2020-09-25;KW;Kuwait;590;3;102441;595
2020-09-26;KW;Kuwait;758;2;103199;597
2020-09-27;KW;Kuwait;345;4;103544;601
2020-09-28;KW;Kuwait;437;4;103981;605
2020-09-29;KW;Kuwait;587;2;104568;607
2020-09-30;KW;Kuwait;614;3;105182;610
2020-10-01;KW;Kuwait;494;2;105676;612
2020-10-02;KW;Kuwait;411;3;106087;615
2020-10-03;KW;Kuwait;371;5;106458;620
2020-10-04;KW;Kuwait;567;4;107025;624
2020-10-05;KW;Kuwait;567;4;107592;628
2020-10-06;KW;Kuwait;676;4;108268;632
2020-10-07;KW;Kuwait;475;7;108743;639
2020-10-08;KW;Kuwait;698;3;109441;642
2020-10-09;KW;Kuwait;635;7;110076;649
2020-10-10;KW;Kuwait;492;6;110568;655
2020-10-11;KW;Kuwait;548;3;111116;658
2020-10-12;KW;Kuwait;777;6;111893;664
2020-10-13;KW;Kuwait;844;8;112737;672
2020-10-14;KW;Kuwait;532;4;113269;676
2020-10-15;KW;Kuwait;746;8;114015;684
2020-10-16;KW;Kuwait;729;6;114744;690
2020-10-17;KW;Kuwait;739;4;115483;694
2020-10-18;KW;Kuwait;663;7;116146;701
2020-10-19;KW;Kuwait;686;9;116832;710
2020-10-20;KW;Kuwait;886;4;117718;714
2020-10-21;KW;Kuwait;813;7;118531;721
2020-10-22;KW;Kuwait;889;9;119420;730
2020-10-23;KW;Kuwait;812;10;120232;740
2020-10-24;KW;Kuwait;695;4;120927;744
2020-10-25;KW;Kuwait;708;2;121635;746
2020-10-26;KW;Kuwait;682;3;122317;749
2020-10-27;KW;Kuwait;775;7;123092;756
2020-10-28;KW;Kuwait;814;7;123906;763
2020-10-29;KW;Kuwait;760;4;124666;767
2020-10-30;KW;Kuwait;671;6;125337;773
2020-10-31;KW;Kuwait;589;6;125926;779
2020-11-01;KW;Kuwait;608;3;126534;782
2020-11-02;KW;Kuwait;759;4;127293;786
2020-11-03;KW;Kuwait;787;3;128080;789
2020-11-04;KW;Kuwait;763;5;128843;794
2020-11-05;KW;Kuwait;795;5;129638;799
2020-11-06;KW;Kuwait;825;5;130463;804
2020-11-07;KW;Kuwait;742;4;131205;808
2020-11-08;KW;Kuwait;538;3;131743;811
2020-11-09;KW;Kuwait;735;5;132478;816
2020-11-10;KW;Kuwait;903;5;133381;821
2020-11-11;KW;Kuwait;778;5;134159;826
2020-11-12;KW;Kuwait;773;4;134932;830
2020-11-13;KW;Kuwait;718;3;135650;833
2020-11-14;KW;Kuwait;691;2;136341;835
2020-11-15;KW;Kuwait;499;3;136840;838
2020-11-16;KW;Kuwait;489;4;137329;842
2020-11-17;KW;Kuwait;556;6;137885;848
2020-11-18;KW;Kuwait;452;9;138337;857
2020-11-19;KW;Kuwait;485;2;138822;859
2020-11-20;KW;Kuwait;486;2;139308;861
2020-11-21;KW;Kuwait;426;2;139734;863
2020-11-22;KW;Kuwait;322;3;140056;866
2020-11-23;KW;Kuwait;337;2;140393;868
2020-11-24;KW;Kuwait;402;2;140795;870
2020-11-25;KW;Kuwait;422;1;141217;871
2020-11-26;KW;Kuwait;330;1;141547;872
2020-11-27;KW;Kuwait;329;2;141876;874
2020-11-28;KW;Kuwait;319;1;142195;875
2020-11-29;KW;Kuwait;231;3;142426;878
2020-11-30;KW;Kuwait;209;2;142635;880
2020-12-01;KW;Kuwait;357;1;142992;881
2020-12-02;KW;Kuwait;268;1;143260;882
2020-12-03;KW;Kuwait;314;2;143574;884
2020-12-04;KW;Kuwait;343;2;143917;886
2020-12-05;KW;Kuwait;247;3;144164;889
2020-12-06;KW;Kuwait;205;2;144369;891
2020-12-07;KW;Kuwait;230;6;144599;897
2020-12-08;KW;Kuwait;301;3;144900;900
2020-12-09;KW;Kuwait;304;5;145204;905
2020-12-10;KW;Kuwait;291;5;145495;910
2020-12-11;KW;Kuwait;294;0;145789;910
2020-12-12;KW;Kuwait;255;1;146044;911
2020-12-13;KW;Kuwait;174;0;146218;911
2020-12-14;KW;Kuwait;231;1;146449;912
2020-12-15;KW;Kuwait;261;1;146710;913
2020-12-16;KW;Kuwait;261;0;146971;913
2020-12-17;KW;Kuwait;221;0;147192;913
2020-12-18;KW;Kuwait;339;3;147531;916
2020-12-19;KW;Kuwait;244;2;147775;918
2020-12-20;KW;Kuwait;204;3;147979;921
2020-12-21;KW;Kuwait;230;1;148209;922
2020-12-22;KW;Kuwait;298;1;148507;923
2020-12-23;KW;Kuwait;266;1;148773;924
2020-12-24;KW;Kuwait;244;2;149017;926
2020-12-25;KW;Kuwait;260;0;149277;926
2020-12-26;KW;Kuwait;172;3;149449;929
2020-12-27;KW;Kuwait;204;2;149653;931
2020-12-28;KW;Kuwait;204;1;149857;932
2020-12-29;KW;Kuwait;236;0;150093;932
2020-12-30;KW;Kuwait;205;1;150298;933
2020-12-31;KW;Kuwait;286;1;150584;934
2021-01-01;KW;Kuwait;285;2;150869;936
2021-01-02;KW;Kuwait;205;1;151074;937
2021-01-03;KW;Kuwait;269;0;151343;937
2021-01-04;KW;Kuwait;372;1;151715;938
2021-01-05;KW;Kuwait;312;0;152027;938
2021-01-06;KW;Kuwait;411;0;152438;938
2021-01-07;KW;Kuwait;540;0;152978;938
2021-01-08;KW;Kuwait;495;2;153473;940
2021-01-09;KW;Kuwait;427;2;153900;942
2021-01-10;KW;Kuwait;414;1;154314;943
2021-01-11;KW;Kuwait;527;2;154841;945
2021-01-12;KW;Kuwait;494;1;155335;946
2021-01-13;KW;Kuwait;539;0;155874;946
2021-01-14;KW;Kuwait;560;0;156434;946
2021-01-15;KW;Kuwait;530;1;156964;947
2021-01-16;KW;Kuwait;435;0;157399;947
2021-01-17;KW;Kuwait;378;0;157777;947
2021-01-18;KW;Kuwait;467;1;158244;948
2021-01-19;KW;Kuwait;578;2;158822;950
2021-01-20;KW;Kuwait;442;1;159264;951
2021-01-21;KW;Kuwait;570;0;159834;951
2021-01-22;KW;Kuwait;533;1;160367;952
2021-01-23;KW;Kuwait;534;0;160901;952
2021-01-24;KW;Kuwait;384;0;161285;952
2021-01-25;KW;Kuwait;492;2;161777;954
2021-01-26;KW;Kuwait;505;3;162282;957
2021-01-27;KW;Kuwait;580;0;162862;957
2021-01-28;KW;Kuwait;588;1;163450;958
2021-01-29;KW;Kuwait;658;0;164108;958
2021-01-30;KW;Kuwait;514;1;164622;959
2021-01-31;KW;Kuwait;635;0;165257;959
2021-02-01;KW;Kuwait;586;0;165843;959
2021-02-02;KW;Kuwait;811;1;166654;960
2021-02-03;KW;Kuwait;756;1;167410;961
2021-02-04;KW;Kuwait;840;1;168250;962
2021-02-05;KW;Kuwait;940;2;169190;964
2021-02-06;KW;Kuwait;846;0;170036;964
2021-02-07;KW;Kuwait;962;2;170998;966
2021-02-08;KW;Kuwait;996;3;171994;969
2021-02-09;KW;Kuwait;1002;6;172996;975
2021-02-10;KW;Kuwait;987;5;173983;980
2021-02-11;KW;Kuwait;1048;5;175031;985
2021-02-12;KW;Kuwait;1021;7;176052;992
2021-02-13;KW;Kuwait;851;6;176903;998
2021-02-14;KW;Kuwait;798;5;177701;1003
2021-02-15;KW;Kuwait;823;6;178524;1009
2021-02-16;KW;Kuwait;964;5;179488;1014
2021-02-17;KW;Kuwait;1017;5;180505;1019
2021-02-18;KW;Kuwait;979;8;181484;1027
2021-02-19;KW;Kuwait;976;7;182460;1034
2021-02-20;KW;Kuwait;862;5;183322;1039
2021-02-21;KW;Kuwait;768;5;184090;1044
2021-02-22;KW;Kuwait;899;5;184989;1049
2021-02-23;KW;Kuwait;1015;8;186004;1057
2021-02-24;KW;Kuwait;1001;5;187005;1062
2021-02-25;KW;Kuwait;1019;5;188024;1067
2021-02-26;KW;Kuwait;1022;5;189046;1072
2021-02-27;KW;Kuwait;844;6;189890;1078
2021-02-28;KW;Kuwait;962;5;190852;1083
2021-03-01;KW;Kuwait;1179;2;192031;1085
2021-03-02;KW;Kuwait;1341;7;193372;1092
2021-03-03;KW;Kuwait;1409;5;194781;1097
2021-03-04;KW;Kuwait;1716;8;196497;1105
2021-03-05;KW;Kuwait;1613;8;198110;1113
2021-03-06;KW;Kuwait;1318;7;199428;1120
2021-03-07;KW;Kuwait;1144;7;200572;1127
2021-03-08;KW;Kuwait;1326;6;201898;1133
2021-03-09;KW;Kuwait;1157;8;203055;1141
2021-03-10;KW;Kuwait;1333;3;204388;1144
2021-03-11;KW;Kuwait;1505;4;205893;1148
2021-03-12;KW;Kuwait;1356;8;207249;1156
2021-03-13;KW;Kuwait;1211;9;208460;1165
2021-03-14;KW;Kuwait;1063;7;209523;1172
2021-03-15;KW;Kuwait;1332;7;210855;1179
2021-03-16;KW;Kuwait;1314;7;212169;1186
2021-03-17;KW;Kuwait;1504;8;213673;1194
2021-03-18;KW;Kuwait;1394;8;215067;1202
2021-03-19;KW;Kuwait;1519;8;216586;1210
2021-03-20;KW;Kuwait;1347;5;217933;1215
2021-03-21;KW;Kuwait;1192;11;219125;1226
2021-03-22;KW;Kuwait;1330;7;220455;1233
2021-03-23;KW;Kuwait;1288;13;221743;1246
2021-03-24;KW;Kuwait;1299;10;223042;1256
2021-03-25;KW;Kuwait;1390;2;224432;1258
2021-03-26;KW;Kuwait;1548;12;225980;1270
2021-03-27;KW;Kuwait;1198;9;227178;1279
2021-03-28;KW;Kuwait;1121;7;228299;1286
2021-03-29;KW;Kuwait;1251;12;229550;1298
2021-03-30;KW;Kuwait;1271;10;230821;1308
2021-03-31;KW;Kuwait;1282;5;232103;1313
2021-04-01;KW;Kuwait;1418;6;233521;1319
2021-04-02;KW;Kuwait;1233;8;234754;1327
2021-04-03;KW;Kuwait;1235;12;235989;1339
2021-04-04;KW;Kuwait;1203;14;237192;1353
2021-04-05;KW;Kuwait;1357;12;238549;1365
2021-04-06;KW;Kuwait;1403;8;239952;1373
2021-04-07;KW;Kuwait;1517;6;241469;1379
2021-04-08;KW;Kuwait;1379;4;242848;1383
2021-04-09;KW;Kuwait;1477;10;244325;1393
2021-04-10;KW;Kuwait;1379;10;245704;1403
2021-04-11;KW;Kuwait;1390;4;247094;1407
2021-04-12;KW;Kuwait;1635;5;248729;1412
2021-04-13;KW;Kuwait;1544;7;250273;1419
2021-04-14;KW;Kuwait;1402;4;251675;1423
2021-04-15;KW;Kuwait;1391;5;253066;1428
2021-04-16;KW;Kuwait;1406;8;254472;1436
2021-04-17;KW;Kuwait;1388;4;255860;1440
2021-04-18;KW;Kuwait;1127;8;256987;1448
2021-04-19;KW;Kuwait;1510;8;258497;1456
2021-04-20;KW;Kuwait;1371;12;259868;1468
2021-04-21;KW;Kuwait;1439;14;261307;1482
2021-04-22;KW;Kuwait;1459;11;262766;1493
2021-04-23;KW;Kuwait;1432;9;264198;1502
2021-04-24;KW;Kuwait;1206;9;265404;1511
2021-04-25;KW;Kuwait;1545;5;266949;1516
2021-04-26;KW;Kuwait;1286;11;268235;1527
2021-04-27;KW;Kuwait;1446;8;269681;1535
2021-04-28;KW;Kuwait;1464;11;271145;1546
2021-04-29;KW;Kuwait;1417;8;272562;1554
2021-04-30;KW;Kuwait;1429;9;273991;1563
2021-05-01;KW;Kuwait;1279;6;275270;1569
2021-05-02;KW;Kuwait;1316;9;276586;1578
2021-05-03;KW;Kuwait;1246;12;277832;1590
2021-05-04;KW;Kuwait;1253;11;279085;1601
2021-05-05;KW;Kuwait;1451;9;280536;1610
2021-05-06;KW;Kuwait;1236;11;281772;1621
2021-05-07;KW;Kuwait;1209;7;282981;1628
2021-05-08;KW;Kuwait;1095;7;284076;1635
2021-05-09;KW;Kuwait;992;10;285068;1645
2021-05-10;KW;Kuwait;978;7;286046;1652
2021-05-11;KW;Kuwait;1153;8;287199;1660
2021-05-12;KW;Kuwait;985;9;288184;1669
2021-05-13;KW;Kuwait;1059;5;289243;1674
2021-05-14;KW;Kuwait;763;7;290006;1681
2021-05-15;KW;Kuwait;795;6;290801;1687
2021-05-16;KW;Kuwait;828;6;291629;1693
2021-05-17;KW;Kuwait;861;3;292490;1696
2021-05-18;KW;Kuwait;1084;5;293574;1701
2021-05-19;KW;Kuwait;1119;2;294693;1703
2021-05-20;KW;Kuwait;1168;8;295861;1711
2021-05-21;KW;Kuwait;1345;8;297206;1719
2021-05-22;KW;Kuwait;1017;5;298223;1724
2021-05-23;KW;Kuwait;992;10;299215;1734
2021-05-24;KW;Kuwait;1240;7;300455;1741
2021-05-25;KW;Kuwait;1408;5;301863;1746
2021-05-26;KW;Kuwait;1176;5;303039;1751
2021-05-27;KW;Kuwait;1160;4;304199;1755
2021-05-28;KW;Kuwait;1384;5;305583;1760
2021-05-29;KW;Kuwait;1134;4;306717;1764
2021-05-30;KW;Kuwait;1095;7;307812;1771
2021-05-31;KW;Kuwait;1410;1;309222;1772
2021-06-01;KW;Kuwait;1279;3;310501;1775
2021-06-02;KW;Kuwait;1345;4;311846;1779
2021-06-03;KW;Kuwait;1443;4;313289;1783
2021-06-04;KW;Kuwait;1280;4;314569;1787
2021-06-05;KW;Kuwait;1331;7;315900;1794
2021-06-06;KW;Kuwait;1297;1;317197;1795
2021-06-07;KW;Kuwait;1479;3;318676;1798
2021-06-08;KW;Kuwait;1581;3;320257;1801
2021-06-09;KW;Kuwait;1391;5;321648;1806
2021-06-10;KW;Kuwait;1709;4;323357;1810
2021-06-11;KW;Kuwait;1657;3;325014;1813
2021-06-12;KW;Kuwait;1437;4;326451;1817
2021-06-13;KW;Kuwait;1512;3;327963;1820
2021-06-14;KW;Kuwait;1563;8;329526;1828
2021-06-15;KW;Kuwait;1487;3;331013;1831
2021-06-16;KW;Kuwait;1557;6;332570;1837
2021-06-17;KW;Kuwait;1646;5;334216;1842
2021-06-18;KW;Kuwait;1658;9;335874;1851
2021-06-19;KW;Kuwait;1497;11;337371;1862
2021-06-20;KW;Kuwait;1661;8;339032;1870
2021-06-21;KW;Kuwait;1935;7;340967;1877
2021-06-22;KW;Kuwait;1962;11;342929;1888
2021-06-23;KW;Kuwait;1870;6;344799;1894
2021-06-24;KW;Kuwait;1761;9;346560;1903
2021-06-25;KW;Kuwait;1702;10;348262;1913
2021-06-26;KW;Kuwait;1661;6;349923;1919
2021-06-27;KW;Kuwait;1558;14;351481;1933
2021-06-28;KW;Kuwait;1652;10;353133;1943
2021-06-29;KW;Kuwait;1718;18;354851;1961
2021-06-30;KW;Kuwait;1836;8;356687;1969
2021-07-01;KW;Kuwait;1824;10;358511;1979
2020-03-18;KG;Kyrgyzstan;3;0;3;0
2020-03-19;KG;Kyrgyzstan;0;0;3;0
2020-03-20;KG;Kyrgyzstan;3;0;6;0
2020-03-21;KG;Kyrgyzstan;8;0;14;0
2020-03-22;KG;Kyrgyzstan;0;0;14;0
2020-03-23;KG;Kyrgyzstan;2;0;16;0
2020-03-24;KG;Kyrgyzstan;26;0;42;0
2020-03-25;KG;Kyrgyzstan;2;0;44;0
2020-03-26;KG;Kyrgyzstan;0;0;44;0
2020-03-27;KG;Kyrgyzstan;14;0;58;0
2020-03-28;KG;Kyrgyzstan;0;0;58;0
2020-03-29;KG;Kyrgyzstan;26;0;84;0
2020-03-30;KG;Kyrgyzstan;10;0;94;0
2020-03-31;KG;Kyrgyzstan;13;0;107;0
2020-04-01;KG;Kyrgyzstan;4;0;111;0
2020-04-02;KG;Kyrgyzstan;5;0;116;0
2020-04-03;KG;Kyrgyzstan;14;1;130;1
2020-04-04;KG;Kyrgyzstan;14;0;144;1
2020-04-05;KG;Kyrgyzstan;3;0;147;1
2020-04-06;KG;Kyrgyzstan;69;3;216;4
2020-04-07;KG;Kyrgyzstan;12;0;228;4
2020-04-08;KG;Kyrgyzstan;42;0;270;4
2020-04-09;KG;Kyrgyzstan;10;0;280;4
2020-04-10;KG;Kyrgyzstan;18;1;298;5
2020-04-11;KG;Kyrgyzstan;41;0;339;5
2020-04-12;KG;Kyrgyzstan;38;0;377;5
2020-04-13;KG;Kyrgyzstan;42;0;419;5
2020-04-14;KG;Kyrgyzstan;11;0;430;5
2020-04-15;KG;Kyrgyzstan;19;0;449;5
2020-04-16;KG;Kyrgyzstan;17;0;466;5
2020-04-17;KG;Kyrgyzstan;23;0;489;5
2020-04-18;KG;Kyrgyzstan;17;0;506;5
2020-04-19;KG;Kyrgyzstan;48;0;554;5
2020-04-20;KG;Kyrgyzstan;14;2;568;7
2020-04-21;KG;Kyrgyzstan;22;0;590;7
2020-04-22;KG;Kyrgyzstan;22;0;612;7
2020-04-23;KG;Kyrgyzstan;19;1;631;8
2020-04-24;KG;Kyrgyzstan;34;0;665;8
2020-04-25;KG;Kyrgyzstan;0;0;665;8
2020-04-26;KG;Kyrgyzstan;17;0;682;8
2020-04-27;KG;Kyrgyzstan;13;0;695;8
2020-04-28;KG;Kyrgyzstan;13;0;708;8
2020-04-29;KG;Kyrgyzstan;21;0;729;8
2020-04-30;KG;Kyrgyzstan;17;0;746;8
2020-05-01;KG;Kyrgyzstan;10;0;756;8
2020-05-02;KG;Kyrgyzstan;13;0;769;8
2020-05-03;KG;Kyrgyzstan;26;2;795;10
2020-05-04;KG;Kyrgyzstan;35;0;830;10
2020-05-05;KG;Kyrgyzstan;13;1;843;11
2020-05-06;KG;Kyrgyzstan;28;1;871;12
2020-05-07;KG;Kyrgyzstan;24;0;895;12
2020-05-08;KG;Kyrgyzstan;11;0;906;12
2020-05-09;KG;Kyrgyzstan;25;0;931;12
2020-05-10;KG;Kyrgyzstan;71;0;1002;12
2020-05-11;KG;Kyrgyzstan;14;0;1016;12
2020-05-12;KG;Kyrgyzstan;21;0;1037;12
2020-05-13;KG;Kyrgyzstan;7;0;1044;12
2020-05-14;KG;Kyrgyzstan;38;0;1082;12
2020-05-15;KG;Kyrgyzstan;29;2;1111;14
2020-05-16;KG;Kyrgyzstan;6;0;1117;14
2020-05-17;KG;Kyrgyzstan;21;0;1138;14
2020-05-18;KG;Kyrgyzstan;78;0;1216;14
2020-05-19;KG;Kyrgyzstan;27;0;1243;14
2020-05-20;KG;Kyrgyzstan;27;0;1270;14
2020-05-21;KG;Kyrgyzstan;43;0;1313;14
2020-05-22;KG;Kyrgyzstan;37;0;1350;14
2020-05-23;KG;Kyrgyzstan;15;0;1365;14
2020-05-24;KG;Kyrgyzstan;38;0;1403;14
2020-05-25;KG;Kyrgyzstan;30;2;1433;16
2020-05-26;KG;Kyrgyzstan;35;0;1468;16
2020-05-27;KG;Kyrgyzstan;52;0;1520;16
2020-05-28;KG;Kyrgyzstan;74;0;1594;16
2020-05-29;KG;Kyrgyzstan;68;0;1662;16
2020-05-30;KG;Kyrgyzstan;60;0;1722;16
2020-05-31;KG;Kyrgyzstan;26;0;1748;16
2020-06-01;KG;Kyrgyzstan;69;0;1817;16
2020-06-02;KG;Kyrgyzstan;28;1;1845;17
2020-06-03;KG;Kyrgyzstan;26;3;1871;20
2020-06-04;KG;Kyrgyzstan;28;0;1899;20
2020-06-05;KG;Kyrgyzstan;37;2;1936;22
2020-06-06;KG;Kyrgyzstan;38;0;1974;22
2020-06-07;KG;Kyrgyzstan;33;0;2007;22
2020-06-08;KG;Kyrgyzstan;25;1;2032;23
2020-06-09;KG;Kyrgyzstan;23;1;2055;24
2020-06-10;KG;Kyrgyzstan;38;2;2093;26
2020-06-11;KG;Kyrgyzstan;73;0;2166;26
2020-06-12;KG;Kyrgyzstan;0;0;2166;26
2020-06-13;KG;Kyrgyzstan;41;1;2207;27
2020-06-14;KG;Kyrgyzstan;78;0;2285;27
2020-06-15;KG;Kyrgyzstan;187;1;2472;28
2020-06-16;KG;Kyrgyzstan;90;2;2562;30
2020-06-17;KG;Kyrgyzstan;95;1;2657;31
2020-06-18;KG;Kyrgyzstan;0;0;2657;31
2020-06-19;KG;Kyrgyzstan;132;1;2789;32
2020-06-20;KG;Kyrgyzstan;192;3;2981;35
2020-06-21;KG;Kyrgyzstan;375;5;3356;40
2020-06-22;KG;Kyrgyzstan;0;0;3356;40
2020-06-23;KG;Kyrgyzstan;370;2;3726;42
2020-06-24;KG;Kyrgyzstan;228;1;3954;43
2020-06-25;KG;Kyrgyzstan;250;0;4204;43
2020-06-26;KG;Kyrgyzstan;242;3;4446;46
2020-06-27;KG;Kyrgyzstan;67;0;4513;46
2020-06-28;KG;Kyrgyzstan;504;4;5017;50
2020-06-29;KG;Kyrgyzstan;279;7;5296;57
2020-06-30;KG;Kyrgyzstan;210;4;5506;61
2020-07-01;KG;Kyrgyzstan;755;5;6261;66
2020-07-02;KG;Kyrgyzstan;506;10;6767;76
2020-07-03;KG;Kyrgyzstan;111;0;6878;76
2020-07-04;KG;Kyrgyzstan;216;2;7094;78
2020-07-05;KG;Kyrgyzstan;283;10;7377;88
2020-07-06;KG;Kyrgyzstan;764;11;8141;99
2020-07-07;KG;Kyrgyzstan;138;8;8279;107
2020-07-08;KG;Kyrgyzstan;568;9;8847;116
2020-07-09;KG;Kyrgyzstan;511;6;9358;122
2020-07-10;KG;Kyrgyzstan;552;3;9910;125
2020-07-11;KG;Kyrgyzstan;500;4;10410;129
2020-07-12;KG;Kyrgyzstan;707;18;11117;147
2020-07-13;KG;Kyrgyzstan;327;2;11444;149
2020-07-14;KG;Kyrgyzstan;0;0;11444;149
2020-07-15;KG;Kyrgyzstan;838;16;12282;165
2020-07-16;KG;Kyrgyzstan;216;2;12498;167
2020-07-17;KG;Kyrgyzstan;603;6;13101;173
2020-07-18;KG;Kyrgyzstan;11505;727;24606;900
2020-07-19;KG;Kyrgyzstan;2537;137;27143;1037
2020-07-20;KG;Kyrgyzstan;0;0;27143;1037
2020-07-21;KG;Kyrgyzstan;1108;42;28251;1079
2020-07-22;KG;Kyrgyzstan;729;32;28980;1111
2020-07-23;KG;Kyrgyzstan;2267;100;31247;1211
2020-07-24;KG;Kyrgyzstan;0;0;31247;1211
2020-07-25;KG;Kyrgyzstan;877;38;32124;1249
2020-07-26;KG;Kyrgyzstan;689;28;32813;1277
2020-07-27;KG;Kyrgyzstan;483;24;33296;1301
2020-07-28;KG;Kyrgyzstan;548;28;33844;1329
2020-07-29;KG;Kyrgyzstan;748;18;34592;1347
2020-07-30;KG;Kyrgyzstan;631;17;35223;1364
2020-07-31;KG;Kyrgyzstan;582;14;35805;1378
2020-08-01;KG;Kyrgyzstan;494;19;36299;1397
2020-08-02;KG;Kyrgyzstan;420;12;36719;1409
2020-08-03;KG;Kyrgyzstan;410;11;37129;1420
2020-08-04;KG;Kyrgyzstan;412;7;37541;1427
2020-08-05;KG;Kyrgyzstan;569;11;38110;1438
2020-08-06;KG;Kyrgyzstan;549;9;38659;1447
2020-08-07;KG;Kyrgyzstan;503;4;39162;1451
2020-08-08;KG;Kyrgyzstan;409;8;39571;1459
2020-08-09;KG;Kyrgyzstan;348;9;39919;1468
2020-08-10;KG;Kyrgyzstan;166;6;40085;1474
2020-08-11;KG;Kyrgyzstan;370;4;40455;1478
2020-08-12;KG;Kyrgyzstan;304;6;40759;1484
2020-08-13;KG;Kyrgyzstan;310;3;41069;1487
2020-08-14;KG;Kyrgyzstan;304;4;41373;1491
2020-08-15;KG;Kyrgyzstan;272;2;41645;1493
2020-08-16;KG;Kyrgyzstan;211;2;41856;1495
2020-08-17;KG;Kyrgyzstan;135;1;41991;1496
2020-08-18;KG;Kyrgyzstan;155;2;42146;1498
2020-08-19;KG;Kyrgyzstan;179;0;42325;1498
2020-08-20;KG;Kyrgyzstan;182;0;42507;1498
2020-08-21;KG;Kyrgyzstan;196;-443;42703;1055
2020-08-22;KG;Kyrgyzstan;186;0;42889;1055
2020-08-23;KG;Kyrgyzstan;134;1;43023;1056
2020-08-24;KG;Kyrgyzstan;103;1;43126;1057
2020-08-25;KG;Kyrgyzstan;119;0;43245;1057
2020-08-26;KG;Kyrgyzstan;113;0;43358;1057
2020-08-27;KG;Kyrgyzstan;101;0;43459;1057
2020-08-28;KG;Kyrgyzstan;128;0;43587;1057
2020-08-29;KG;Kyrgyzstan;125;0;43712;1057
2020-08-30;KG;Kyrgyzstan;108;1;43820;1058
2020-08-31;KG;Kyrgyzstan;78;0;43898;1058
2020-09-01;KG;Kyrgyzstan;60;1;43958;1059
2020-09-02;KG;Kyrgyzstan;78;0;44036;1059
2020-09-03;KG;Kyrgyzstan;99;0;44135;1059
2020-09-04;KG;Kyrgyzstan;64;1;44199;1060
2020-09-05;KG;Kyrgyzstan;94;0;44293;1060
2020-09-06;KG;Kyrgyzstan;110;0;44403;1060
2020-09-07;KG;Kyrgyzstan;55;0;44458;1060
2020-09-08;KG;Kyrgyzstan;29;0;44487;1060
2020-09-09;KG;Kyrgyzstan;126;1;44613;1061
2020-09-10;KG;Kyrgyzstan;71;0;44684;1061
2020-09-11;KG;Kyrgyzstan;77;2;44761;1063
2020-09-12;KG;Kyrgyzstan;67;0;44828;1063
2020-09-13;KG;Kyrgyzstan;53;0;44881;1063
2020-09-14;KG;Kyrgyzstan;47;0;44928;1063
2020-09-15;KG;Kyrgyzstan;71;0;44999;1063
2020-09-16;KG;Kyrgyzstan;73;0;45072;1063
2020-09-17;KG;Kyrgyzstan;81;0;45153;1063
2020-09-18;KG;Kyrgyzstan;91;0;45244;1063
2020-09-19;KG;Kyrgyzstan;91;0;45335;1063
2020-09-20;KG;Kyrgyzstan;0;0;45335;1063
2020-09-21;KG;Kyrgyzstan;136;0;45471;1063
2020-09-22;KG;Kyrgyzstan;71;0;45542;1063
2020-09-23;KG;Kyrgyzstan;88;0;45630;1063
2020-09-24;KG;Kyrgyzstan;127;0;45757;1063
2020-09-25;KG;Kyrgyzstan;175;0;45932;1063
2020-09-26;KG;Kyrgyzstan;158;0;46090;1063
2020-09-27;KG;Kyrgyzstan;161;0;46251;1063
2020-09-28;KG;Kyrgyzstan;104;1;46355;1064
2020-09-29;KG;Kyrgyzstan;167;0;46522;1064
2020-09-30;KG;Kyrgyzstan;147;0;46669;1064
2020-10-01;KG;Kyrgyzstan;172;1;46841;1065
2020-10-02;KG;Kyrgyzstan;215;0;47056;1065
2020-10-03;KG;Kyrgyzstan;128;1;47184;1066
2020-10-04;KG;Kyrgyzstan;244;0;47428;1066
2020-10-05;KG;Kyrgyzstan;207;0;47635;1066
2020-10-06;KG;Kyrgyzstan;164;0;47799;1066
2020-10-07;KG;Kyrgyzstan;298;3;48097;1069
2020-10-08;KG;Kyrgyzstan;245;4;48342;1073
2020-10-09;KG;Kyrgyzstan;275;4;48617;1077
2020-10-10;KG;Kyrgyzstan;307;5;48924;1082
2020-10-11;KG;Kyrgyzstan;306;3;49230;1085
2020-10-12;KG;Kyrgyzstan;298;5;49528;1090
2020-10-13;KG;Kyrgyzstan;343;2;49871;1092
2020-10-14;KG;Kyrgyzstan;330;2;50201;1094
2020-10-15;KG;Kyrgyzstan;388;5;50589;1099
2020-10-16;KG;Kyrgyzstan;431;4;51020;1103
2020-10-17;KG;Kyrgyzstan;470;5;51490;1108
2020-10-18;KG;Kyrgyzstan;554;3;52044;1111
2020-10-19;KG;Kyrgyzstan;482;0;52526;1111
2020-10-20;KG;Kyrgyzstan;384;2;52910;1113
2020-10-21;KG;Kyrgyzstan;549;5;53459;1118
2020-10-22;KG;Kyrgyzstan;547;4;54006;1122
2020-10-23;KG;Kyrgyzstan;582;4;54588;1126
2020-10-24;KG;Kyrgyzstan;556;4;55144;1130
2020-10-25;KG;Kyrgyzstan;606;4;55750;1134
2020-10-26;KG;Kyrgyzstan;420;0;56170;1134
2020-10-27;KG;Kyrgyzstan;568;2;56738;1136
2020-10-28;KG;Kyrgyzstan;538;2;57276;1138
2020-10-29;KG;Kyrgyzstan;522;1;57798;1139
2020-10-30;KG;Kyrgyzstan;596;3;58394;1142
2020-10-31;KG;Kyrgyzstan;484;2;58878;1144
2020-11-01;KG;Kyrgyzstan;0;0;58878;1144
2020-11-02;KG;Kyrgyzstan;1001;11;59879;1155
2020-11-03;KG;Kyrgyzstan;895;8;60774;1163
2020-11-04;KG;Kyrgyzstan;535;4;61309;1167
2020-11-05;KG;Kyrgyzstan;0;0;61309;1167
2020-11-06;KG;Kyrgyzstan;439;3;61748;1170
2020-11-07;KG;Kyrgyzstan;556;2;62304;1172
2020-11-08;KG;Kyrgyzstan;515;5;62819;1177
2020-11-09;KG;Kyrgyzstan;571;5;63390;1182
2020-11-10;KG;Kyrgyzstan;970;6;64360;1188
2020-11-11;KG;Kyrgyzstan;0;0;64360;1188
2020-11-12;KG;Kyrgyzstan;527;5;64887;1193
2020-11-13;KG;Kyrgyzstan;567;2;65454;1195
2020-11-14;KG;Kyrgyzstan;499;1;65953;1196
2020-11-15;KG;Kyrgyzstan;1030;7;66983;1203
2020-11-16;KG;Kyrgyzstan;0;0;66983;1203
2020-11-17;KG;Kyrgyzstan;486;4;67469;1207
2020-11-18;KG;Kyrgyzstan;425;5;67894;1212
2020-11-19;KG;Kyrgyzstan;422;5;68316;1217
2020-11-20;KG;Kyrgyzstan;386;6;68702;1223
2020-11-21;KG;Kyrgyzstan;447;4;69149;1227
2020-11-22;KG;Kyrgyzstan;432;4;69581;1231
2020-11-23;KG;Kyrgyzstan;304;6;69885;1237
2020-11-24;KG;Kyrgyzstan;481;4;70366;1241
2020-11-25;KG;Kyrgyzstan;805;10;71171;1251
2020-11-26;KG;Kyrgyzstan;377;5;71548;1256
2020-11-27;KG;Kyrgyzstan;0;0;71548;1256
2020-11-28;KG;Kyrgyzstan;423;6;71971;1262
2020-11-29;KG;Kyrgyzstan;836;9;72807;1271
2020-11-30;KG;Kyrgyzstan;371;4;73178;1275
2020-12-01;KG;Kyrgyzstan;0;0;73178;1275
2020-12-02;KG;Kyrgyzstan;335;2;73513;1277
2020-12-03;KG;Kyrgyzstan;420;8;73933;1285
2020-12-04;KG;Kyrgyzstan;440;0;74373;1285
2020-12-05;KG;Kyrgyzstan;401;5;74774;1290
2020-12-06;KG;Kyrgyzstan;621;7;75395;1297
2020-12-07;KG;Kyrgyzstan;0;0;75395;1297
2020-12-08;KG;Kyrgyzstan;295;4;75690;1301
2020-12-09;KG;Kyrgyzstan;322;5;76012;1306
2020-12-10;KG;Kyrgyzstan;379;0;76391;1306
2020-12-11;KG;Kyrgyzstan;668;1;77059;1307
2020-12-12;KG;Kyrgyzstan;0;0;77059;1307
2020-12-13;KG;Kyrgyzstan;297;5;77356;1312
2020-12-14;KG;Kyrgyzstan;318;0;77674;1312
2020-12-15;KG;Kyrgyzstan;477;5;78151;1317
2020-12-16;KG;Kyrgyzstan;0;0;78151;1317
2020-12-17;KG;Kyrgyzstan;264;4;78415;1321
2020-12-18;KG;Kyrgyzstan;264;3;78679;1324
2020-12-19;KG;Kyrgyzstan;232;4;78911;1328
2020-12-20;KG;Kyrgyzstan;343;3;79254;1331
2020-12-21;KG;Kyrgyzstan;0;0;79254;1331
2020-12-22;KG;Kyrgyzstan;175;4;79429;1335
2020-12-23;KG;Kyrgyzstan;230;2;79659;1337
2020-12-24;KG;Kyrgyzstan;186;3;79845;1340
2020-12-25;KG;Kyrgyzstan;180;0;80025;1340
2020-12-26;KG;Kyrgyzstan;157;4;80182;1344
2020-12-27;KG;Kyrgyzstan;191;4;80373;1348
2020-12-28;KG;Kyrgyzstan;162;1;80535;1349
2020-12-29;KG;Kyrgyzstan;119;4;80654;1353
2020-12-30;KG;Kyrgyzstan;189;1;80843;1354
2020-12-31;KG;Kyrgyzstan;191;1;81034;1355
2021-01-01;KG;Kyrgyzstan;122;1;81156;1356
2021-01-02;KG;Kyrgyzstan;58;2;81214;1358
2021-01-03;KG;Kyrgyzstan;174;2;81388;1360
2021-01-04;KG;Kyrgyzstan;0;0;81388;1360
2021-01-05;KG;Kyrgyzstan;124;0;81512;1360
2021-01-06;KG;Kyrgyzstan;144;1;81656;1361
2021-01-07;KG;Kyrgyzstan;170;2;81826;1363
2021-01-08;KG;Kyrgyzstan;165;2;81991;1365
2021-01-09;KG;Kyrgyzstan;147;2;82138;1367
2021-01-10;KG;Kyrgyzstan;135;2;82273;1369
2021-01-11;KG;Kyrgyzstan;107;2;82380;1371
2021-01-12;KG;Kyrgyzstan;207;4;82587;1375
2021-01-13;KG;Kyrgyzstan;0;0;82587;1375
2021-01-14;KG;Kyrgyzstan;136;3;82723;1378
2021-01-15;KG;Kyrgyzstan;263;4;82986;1382
2021-01-16;KG;Kyrgyzstan;123;2;83109;1384
2021-01-17;KG;Kyrgyzstan;69;3;83178;1387
2021-01-18;KG;Kyrgyzstan;0;0;83178;1387
2021-01-19;KG;Kyrgyzstan;252;5;83430;1392
2021-01-20;KG;Kyrgyzstan;0;0;83430;1392
2021-01-21;KG;Kyrgyzstan;155;2;83585;1394
2021-01-22;KG;Kyrgyzstan;211;4;83796;1398
2021-01-23;KG;Kyrgyzstan;0;0;83796;1398
2021-01-24;KG;Kyrgyzstan;104;2;83900;1400
2021-01-25;KG;Kyrgyzstan;168;2;84068;1402
2021-01-26;KG;Kyrgyzstan;107;3;84175;1405
2021-01-27;KG;Kyrgyzstan;128;3;84303;1408
2021-01-28;KG;Kyrgyzstan;0;0;84303;1408
2021-01-29;KG;Kyrgyzstan;74;1;84377;1409
2021-01-30;KG;Kyrgyzstan;152;3;84529;1412
2021-01-31;KG;Kyrgyzstan;59;0;84588;1412
2021-02-01;KG;Kyrgyzstan;0;0;84588;1412
2021-02-02;KG;Kyrgyzstan;58;2;84646;1414
2021-02-03;KG;Kyrgyzstan;186;4;84832;1418
2021-02-04;KG;Kyrgyzstan;88;2;84920;1420
2021-02-05;KG;Kyrgyzstan;0;0;84920;1420
2021-02-06;KG;Kyrgyzstan;72;3;84992;1423
2021-02-07;KG;Kyrgyzstan;79;3;85071;1426
2021-02-08;KG;Kyrgyzstan;42;5;85113;1431
2021-02-09;KG;Kyrgyzstan;58;2;85171;1433
2021-02-10;KG;Kyrgyzstan;82;3;85253;1436
2021-02-11;KG;Kyrgyzstan;75;1;85328;1437
2021-02-12;KG;Kyrgyzstan;70;2;85398;1439
2021-02-13;KG;Kyrgyzstan;43;2;85441;1441
2021-02-14;KG;Kyrgyzstan;34;1;85475;1442
2021-02-15;KG;Kyrgyzstan;41;0;85516;1442
2021-02-16;KG;Kyrgyzstan;48;2;85564;1444
2021-02-17;KG;Kyrgyzstan;125;3;85689;1447
2021-02-18;KG;Kyrgyzstan;0;0;85689;1447
2021-02-19;KG;Kyrgyzstan;142;5;85831;1452
2021-02-20;KG;Kyrgyzstan;0;0;85831;1452
2021-02-21;KG;Kyrgyzstan;98;6;85929;1458
2021-02-22;KG;Kyrgyzstan;0;0;85929;1458
2021-02-23;KG;Kyrgyzstan;72;2;86001;1460
2021-02-24;KG;Kyrgyzstan;24;0;86025;1460
2021-02-25;KG;Kyrgyzstan;66;3;86091;1463
2021-02-26;KG;Kyrgyzstan;51;0;86142;1463
2021-02-27;KG;Kyrgyzstan;43;0;86185;1463
2021-02-28;KG;Kyrgyzstan;66;3;86251;1466
2021-03-01;KG;Kyrgyzstan;57;1;86308;1467
2021-03-02;KG;Kyrgyzstan;48;1;86356;1468
2021-03-03;KG;Kyrgyzstan;54;0;86410;1468
2021-03-04;KG;Kyrgyzstan;0;2;86410;1470
2021-03-05;KG;Kyrgyzstan;41;0;86451;1470
2021-03-06;KG;Kyrgyzstan;55;1;86506;1471
2021-03-07;KG;Kyrgyzstan;44;0;86550;1471
2021-03-08;KG;Kyrgyzstan;33;2;86583;1473
2021-03-09;KG;Kyrgyzstan;57;3;86640;1476
2021-03-10;KG;Kyrgyzstan;0;0;86640;1476
2021-03-11;KG;Kyrgyzstan;115;4;86755;1480
2021-03-12;KG;Kyrgyzstan;63;0;86818;1480
2021-03-13;KG;Kyrgyzstan;0;0;86818;1480
2021-03-14;KG;Kyrgyzstan;32;3;86850;1483
2021-03-15;KG;Kyrgyzstan;67;0;86917;1483
2021-03-16;KG;Kyrgyzstan;128;2;87045;1485
2021-03-17;KG;Kyrgyzstan;98;0;87143;1485
2021-03-18;KG;Kyrgyzstan;0;0;87143;1485
2021-03-19;KG;Kyrgyzstan;96;2;87239;1487
2021-03-20;KG;Kyrgyzstan;150;3;87389;1490
2021-03-21;KG;Kyrgyzstan;0;0;87389;1490
2021-03-22;KG;Kyrgyzstan;73;0;87462;1490
2021-03-23;KG;Kyrgyzstan;190;2;87652;1492
2021-03-24;KG;Kyrgyzstan;106;2;87758;1494
2021-03-25;KG;Kyrgyzstan;0;0;87758;1494
2021-03-26;KG;Kyrgyzstan;100;0;87858;1494
2021-03-27;KG;Kyrgyzstan;88;1;87946;1495
2021-03-28;KG;Kyrgyzstan;146;0;88092;1495
2021-03-29;KG;Kyrgyzstan;71;2;88163;1497
2021-03-30;KG;Kyrgyzstan;113;1;88276;1498
2021-03-31;KG;Kyrgyzstan;262;2;88538;1500
2021-04-01;KG;Kyrgyzstan;0;0;88538;1500
2021-04-02;KG;Kyrgyzstan;162;0;88700;1500
2021-04-03;KG;Kyrgyzstan;142;2;88842;1502
2021-04-04;KG;Kyrgyzstan;172;4;89014;1506
2021-04-05;KG;Kyrgyzstan;139;1;89153;1507
2021-04-06;KG;Kyrgyzstan;124;2;89277;1509
2021-04-07;KG;Kyrgyzstan;161;3;89438;1512
2021-04-08;KG;Kyrgyzstan;222;4;89660;1516
2021-04-09;KG;Kyrgyzstan;151;0;89811;1516
2021-04-10;KG;Kyrgyzstan;208;3;90019;1519
2021-04-11;KG;Kyrgyzstan;208;3;90227;1522
2021-04-12;KG;Kyrgyzstan;145;6;90372;1528
2021-04-13;KG;Kyrgyzstan;227;4;90599;1532
2021-04-14;KG;Kyrgyzstan;240;2;90839;1534
2021-04-15;KG;Kyrgyzstan;305;6;91144;1540
2021-04-16;KG;Kyrgyzstan;230;4;91374;1544
2021-04-17;KG;Kyrgyzstan;265;2;91639;1546
2021-04-18;KG;Kyrgyzstan;244;3;91883;1549
2021-04-19;KG;Kyrgyzstan;212;6;92095;1555
2021-04-20;KG;Kyrgyzstan;225;2;92320;1557
2021-04-21;KG;Kyrgyzstan;306;4;92626;1561
2021-04-22;KG;Kyrgyzstan;380;5;93006;1566
2021-04-23;KG;Kyrgyzstan;272;7;93278;1573
2021-04-24;KG;Kyrgyzstan;325;5;93603;1578
2021-04-25;KG;Kyrgyzstan;228;4;93831;1582
2021-04-26;KG;Kyrgyzstan;199;2;94030;1584
2021-04-27;KG;Kyrgyzstan;247;5;94277;1589
2021-04-28;KG;Kyrgyzstan;322;3;94599;1592
2021-04-29;KG;Kyrgyzstan;345;6;94944;1598
2021-04-30;KG;Kyrgyzstan;331;6;95275;1604
2021-05-01;KG;Kyrgyzstan;477;8;95752;1612
2021-05-02;KG;Kyrgyzstan;308;7;96060;1619
2021-05-03;KG;Kyrgyzstan;277;3;96337;1622
2021-05-04;KG;Kyrgyzstan;224;8;96561;1630
2021-05-05;KG;Kyrgyzstan;397;7;96958;1637
2021-05-06;KG;Kyrgyzstan;320;3;97278;1640
2021-05-07;KG;Kyrgyzstan;385;3;97663;1643
2021-05-08;KG;Kyrgyzstan;416;6;98079;1649
2021-05-09;KG;Kyrgyzstan;321;6;98400;1655
2021-05-10;KG;Kyrgyzstan;254;5;98654;1660
2021-05-11;KG;Kyrgyzstan;379;7;99033;1667
2021-05-12;KG;Kyrgyzstan;283;8;99316;1675
2021-05-13;KG;Kyrgyzstan;329;6;99645;1681
2021-05-14;KG;Kyrgyzstan;200;6;99845;1687
2021-05-15;KG;Kyrgyzstan;404;8;100249;1695
2021-05-16;KG;Kyrgyzstan;224;8;100473;1703
2021-05-17;KG;Kyrgyzstan;259;8;100732;1711
2021-05-18;KG;Kyrgyzstan;234;7;100966;1718
2021-05-19;KG;Kyrgyzstan;253;7;101219;1725
2021-05-20;KG;Kyrgyzstan;361;4;101580;1729
2021-05-21;KG;Kyrgyzstan;298;6;101878;1735
2021-05-22;KG;Kyrgyzstan;308;8;102186;1743
2021-05-23;KG;Kyrgyzstan;325;8;102511;1751
2021-05-24;KG;Kyrgyzstan;191;6;102702;1757
2021-05-25;KG;Kyrgyzstan;298;8;103000;1765
2021-05-26;KG;Kyrgyzstan;207;8;103207;1773
2021-05-27;KG;Kyrgyzstan;376;8;103583;1781
2021-05-28;KG;Kyrgyzstan;283;7;103866;1788
2021-05-29;KG;Kyrgyzstan;356;9;104222;1797
2021-05-30;KG;Kyrgyzstan;333;6;104555;1803
2021-05-31;KG;Kyrgyzstan;174;5;104729;1808
2021-06-01;KG;Kyrgyzstan;382;7;105111;1815
2021-06-02;KG;Kyrgyzstan;358;6;105469;1821
2021-06-03;KG;Kyrgyzstan;371;9;105840;1830
2021-06-04;KG;Kyrgyzstan;383;7;106223;1837
2021-06-05;KG;Kyrgyzstan;413;5;106636;1842
2021-06-06;KG;Kyrgyzstan;337;5;106973;1847
2021-06-07;KG;Kyrgyzstan;362;5;107335;1852
2021-06-08;KG;Kyrgyzstan;379;7;107714;1859
2021-06-09;KG;Kyrgyzstan;459;5;108173;1864
2021-06-10;KG;Kyrgyzstan;494;5;108667;1869
2021-06-11;KG;Kyrgyzstan;526;7;109193;1876
2021-06-12;KG;Kyrgyzstan;619;5;109812;1881
2021-06-13;KG;Kyrgyzstan;558;9;110370;1890
2021-06-14;KG;Kyrgyzstan;459;9;110829;1899
2021-06-15;KG;Kyrgyzstan;514;6;111343;1905
2021-06-16;KG;Kyrgyzstan;647;7;111990;1912
2021-06-17;KG;Kyrgyzstan;787;4;112777;1916
2021-06-18;KG;Kyrgyzstan;653;4;113430;1920
2021-06-19;KG;Kyrgyzstan;870;5;114300;1925
2021-06-20;KG;Kyrgyzstan;730;6;115030;1931
2021-06-21;KG;Kyrgyzstan;585;6;115615;1937
2021-06-22;KG;Kyrgyzstan;931;8;116546;1945
2021-06-23;KG;Kyrgyzstan;738;8;117284;1953
2021-06-24;KG;Kyrgyzstan;822;5;118106;1958
2021-06-25;KG;Kyrgyzstan;875;6;118981;1964
2021-06-26;KG;Kyrgyzstan;892;7;119873;1971
2021-06-27;KG;Kyrgyzstan;992;6;120865;1977
2021-06-28;KG;Kyrgyzstan;1081;5;121946;1982
2021-06-29;KG;Kyrgyzstan;1092;10;123038;1992
2021-06-30;KG;Kyrgyzstan;1965;8;125003;2000
2021-07-01;KG;Kyrgyzstan;1392;9;126395;2009
2020-03-24;LA;Laos;2;0;2;0
2020-03-25;LA;Laos;1;0;3;0
2020-03-26;LA;Laos;3;0;6;0
2020-03-27;LA;Laos;0;0;6;0
2020-03-28;LA;Laos;2;0;8;0
2020-03-29;LA;Laos;0;0;8;0
2020-03-30;LA;Laos;0;0;8;0
2020-03-31;LA;Laos;1;0;9;0
2020-04-01;LA;Laos;1;0;10;0
2020-04-02;LA;Laos;0;0;10;0
2020-04-03;LA;Laos;0;0;10;0
2020-04-04;LA;Laos;0;0;10;0
2020-04-05;LA;Laos;1;0;11;0
2020-04-06;LA;Laos;1;0;12;0
2020-04-07;LA;Laos;2;0;14;0
2020-04-08;LA;Laos;1;0;15;0
2020-04-09;LA;Laos;1;0;16;0
2020-04-10;LA;Laos;0;0;16;0
2020-04-11;LA;Laos;2;0;18;0
2020-04-12;LA;Laos;1;0;19;0
2020-04-13;LA;Laos;0;0;19;0
2020-04-14;LA;Laos;0;0;19;0
2020-04-15;LA;Laos;0;0;19;0
2020-04-16;LA;Laos;0;0;19;0
2020-04-17;LA;Laos;0;0;19;0
2020-04-18;LA;Laos;0;0;19;0
2020-04-19;LA;Laos;0;0;19;0
2020-04-20;LA;Laos;0;0;19;0
2020-04-21;LA;Laos;0;0;19;0
2020-04-22;LA;Laos;0;0;19;0
2020-04-23;LA;Laos;0;0;19;0
2020-04-24;LA;Laos;0;0;19;0
2020-04-25;LA;Laos;0;0;19;0
2020-04-26;LA;Laos;0;0;19;0
2020-04-27;LA;Laos;0;0;19;0
2020-04-28;LA;Laos;0;0;19;0
2020-04-29;LA;Laos;0;0;19;0
2020-04-30;LA;Laos;0;0;19;0
2020-05-01;LA;Laos;0;0;19;0
2020-05-02;LA;Laos;0;0;19;0
2020-05-03;LA;Laos;0;0;19;0
2020-05-04;LA;Laos;0;0;19;0
2020-05-05;LA;Laos;0;0;19;0
2020-05-06;LA;Laos;0;0;19;0
2020-05-07;LA;Laos;0;0;19;0
2020-05-08;LA;Laos;0;0;19;0
2020-05-09;LA;Laos;0;0;19;0
2020-05-10;LA;Laos;0;0;19;0
2020-05-11;LA;Laos;0;0;19;0
2020-05-12;LA;Laos;0;0;19;0
2020-05-13;LA;Laos;0;0;19;0
2020-05-14;LA;Laos;0;0;19;0
2020-05-15;LA;Laos;0;0;19;0
2020-05-16;LA;Laos;0;0;19;0
2020-05-17;LA;Laos;0;0;19;0
2020-05-18;LA;Laos;0;0;19;0
2020-05-19;LA;Laos;0;0;19;0
2020-05-20;LA;Laos;0;0;19;0
2020-05-21;LA;Laos;0;0;19;0
2020-05-22;LA;Laos;0;0;19;0
2020-05-23;LA;Laos;0;0;19;0
2020-05-24;LA;Laos;0;0;19;0
2020-05-25;LA;Laos;0;0;19;0
2020-05-26;LA;Laos;0;0;19;0
2020-05-27;LA;Laos;0;0;19;0
2020-05-28;LA;Laos;0;0;19;0
2020-05-29;LA;Laos;0;0;19;0
2020-05-30;LA;Laos;0;0;19;0
2020-05-31;LA;Laos;0;0;19;0
2020-06-01;LA;Laos;0;0;19;0
2020-06-02;LA;Laos;0;0;19;0
2020-06-03;LA;Laos;0;0;19;0
2020-06-04;LA;Laos;0;0;19;0
2020-06-05;LA;Laos;0;0;19;0
2020-06-06;LA;Laos;0;0;19;0
2020-06-07;LA;Laos;0;0;19;0
2020-06-08;LA;Laos;0;0;19;0
2020-06-09;LA;Laos;0;0;19;0
2020-06-10;LA;Laos;0;0;19;0
2020-06-11;LA;Laos;0;0;19;0
2020-06-12;LA;Laos;0;0;19;0
2020-06-13;LA;Laos;0;0;19;0
2020-06-14;LA;Laos;0;0;19;0
2020-06-15;LA;Laos;0;0;19;0
2020-06-16;LA;Laos;0;0;19;0
2020-06-17;LA;Laos;0;0;19;0
2020-06-18;LA;Laos;0;0;19;0
2020-06-19;LA;Laos;0;0;19;0
2020-06-20;LA;Laos;0;0;19;0
2020-06-21;LA;Laos;0;0;19;0
2020-06-22;LA;Laos;0;0;19;0
2020-06-23;LA;Laos;0;0;19;0
2020-06-24;LA;Laos;0;0;19;0
2020-06-25;LA;Laos;0;0;19;0
2020-06-26;LA;Laos;0;0;19;0
2020-06-27;LA;Laos;0;0;19;0
2020-06-28;LA;Laos;0;0;19;0
2020-06-29;LA;Laos;0;0;19;0
2020-06-30;LA;Laos;0;0;19;0
2020-07-01;LA;Laos;0;0;19;0
2020-07-02;LA;Laos;0;0;19;0
2020-07-03;LA;Laos;0;0;19;0
2020-07-04;LA;Laos;0;0;19;0
2020-07-05;LA;Laos;0;0;19;0
2020-07-06;LA;Laos;0;0;19;0
2020-07-07;LA;Laos;0;0;19;0
2020-07-08;LA;Laos;0;0;19;0
2020-07-09;LA;Laos;0;0;19;0
2020-07-10;LA;Laos;0;0;19;0
2020-07-11;LA;Laos;0;0;19;0
2020-07-12;LA;Laos;0;0;19;0
2020-07-13;LA;Laos;0;0;19;0
2020-07-14;LA;Laos;0;0;19;0
2020-07-15;LA;Laos;0;0;19;0
2020-07-16;LA;Laos;0;0;19;0
2020-07-17;LA;Laos;0;0;19;0
2020-07-18;LA;Laos;0;0;19;0
2020-07-19;LA;Laos;0;0;19;0
2020-07-20;LA;Laos;0;0;19;0
2020-07-21;LA;Laos;0;0;19;0
2020-07-22;LA;Laos;0;0;19;0
2020-07-23;LA;Laos;0;0;19;0
2020-07-24;LA;Laos;1;0;20;0
2020-07-25;LA;Laos;0;0;20;0
2020-07-26;LA;Laos;0;0;20;0
2020-07-27;LA;Laos;0;0;20;0
2020-07-28;LA;Laos;0;0;20;0
2020-07-29;LA;Laos;0;0;20;0
2020-07-30;LA;Laos;0;0;20;0
2020-07-31;LA;Laos;0;0;20;0
2020-08-01;LA;Laos;0;0;20;0
2020-08-02;LA;Laos;0;0;20;0
2020-08-03;LA;Laos;0;0;20;0
2020-08-04;LA;Laos;0;0;20;0
2020-08-05;LA;Laos;0;0;20;0
2020-08-06;LA;Laos;0;0;20;0
2020-08-07;LA;Laos;0;0;20;0
2020-08-08;LA;Laos;0;0;20;0
2020-08-09;LA;Laos;0;0;20;0
2020-08-10;LA;Laos;0;0;20;0
2020-08-11;LA;Laos;0;0;20;0
2020-08-12;LA;Laos;0;0;20;0
2020-08-13;LA;Laos;0;0;20;0
2020-08-14;LA;Laos;2;0;22;0
2020-08-15;LA;Laos;0;0;22;0
2020-08-16;LA;Laos;0;0;22;0
2020-08-17;LA;Laos;0;0;22;0
2020-08-18;LA;Laos;0;0;22;0
2020-08-19;LA;Laos;0;0;22;0
2020-08-20;LA;Laos;0;0;22;0
2020-08-21;LA;Laos;0;0;22;0
2020-08-22;LA;Laos;0;0;22;0
2020-08-23;LA;Laos;0;0;22;0
2020-08-24;LA;Laos;0;0;22;0
2020-08-25;LA;Laos;0;0;22;0
2020-08-26;LA;Laos;0;0;22;0
2020-08-27;LA;Laos;0;0;22;0
2020-08-28;LA;Laos;0;0;22;0
2020-08-29;LA;Laos;0;0;22;0
2020-08-30;LA;Laos;0;0;22;0
2020-08-31;LA;Laos;0;0;22;0
2020-09-01;LA;Laos;0;0;22;0
2020-09-02;LA;Laos;0;0;22;0
2020-09-03;LA;Laos;0;0;22;0
2020-09-04;LA;Laos;0;0;22;0
2020-09-05;LA;Laos;0;0;22;0
2020-09-06;LA;Laos;0;0;22;0
2020-09-07;LA;Laos;0;0;22;0
2020-09-08;LA;Laos;0;0;22;0
2020-09-09;LA;Laos;0;0;22;0
2020-09-10;LA;Laos;0;0;22;0
2020-09-11;LA;Laos;1;0;23;0
2020-09-12;LA;Laos;0;0;23;0
2020-09-13;LA;Laos;0;0;23;0
2020-09-14;LA;Laos;0;0;23;0
2020-09-15;LA;Laos;0;0;23;0
2020-09-16;LA;Laos;0;0;23;0
2020-09-17;LA;Laos;0;0;23;0
2020-09-18;LA;Laos;0;0;23;0
2020-09-19;LA;Laos;0;0;23;0
2020-09-20;LA;Laos;0;0;23;0
2020-09-21;LA;Laos;0;0;23;0
2020-09-22;LA;Laos;0;0;23;0
2020-09-23;LA;Laos;0;0;23;0
2020-09-24;LA;Laos;0;0;23;0
2020-09-25;LA;Laos;0;0;23;0
2020-09-26;LA;Laos;0;0;23;0
2020-09-27;LA;Laos;0;0;23;0
2020-09-28;LA;Laos;0;0;23;0
2020-09-29;LA;Laos;0;0;23;0
2020-09-30;LA;Laos;0;0;23;0
2020-10-01;LA;Laos;0;0;23;0
2020-10-02;LA;Laos;0;0;23;0
2020-10-03;LA;Laos;0;0;23;0
2020-10-04;LA;Laos;0;0;23;0
2020-10-05;LA;Laos;0;0;23;0
2020-10-06;LA;Laos;0;0;23;0
2020-10-07;LA;Laos;0;0;23;0
2020-10-08;LA;Laos;0;0;23;0
2020-10-09;LA;Laos;0;0;23;0
2020-10-10;LA;Laos;0;0;23;0
2020-10-11;LA;Laos;0;0;23;0
2020-10-12;LA;Laos;0;0;23;0
2020-10-13;LA;Laos;0;0;23;0
2020-10-14;LA;Laos;0;0;23;0
2020-10-15;LA;Laos;0;0;23;0
2020-10-16;LA;Laos;0;0;23;0
2020-10-17;LA;Laos;0;0;23;0
2020-10-18;LA;Laos;0;0;23;0
2020-10-19;LA;Laos;0;0;23;0
2020-10-20;LA;Laos;0;0;23;0
2020-10-21;LA;Laos;1;0;24;0
2020-10-22;LA;Laos;0;0;24;0
2020-10-23;LA;Laos;0;0;24;0
2020-10-24;LA;Laos;0;0;24;0
2020-10-25;LA;Laos;0;0;24;0
2020-10-26;LA;Laos;0;0;24;0
2020-10-27;LA;Laos;0;0;24;0
2020-10-28;LA;Laos;0;0;24;0
2020-10-29;LA;Laos;0;0;24;0
2020-10-30;LA;Laos;0;0;24;0
2020-10-31;LA;Laos;0;0;24;0
2020-11-01;LA;Laos;0;0;24;0
2020-11-02;LA;Laos;0;0;24;0
2020-11-03;LA;Laos;0;0;24;0
2020-11-04;LA;Laos;0;0;24;0
2020-11-05;LA;Laos;0;0;24;0
2020-11-06;LA;Laos;0;0;24;0
2020-11-07;LA;Laos;0;0;24;0
2020-11-08;LA;Laos;0;0;24;0
2020-11-09;LA;Laos;0;0;24;0
2020-11-10;LA;Laos;0;0;24;0
2020-11-11;LA;Laos;0;0;24;0
2020-11-12;LA;Laos;0;0;24;0
2020-11-13;LA;Laos;0;0;24;0
2020-11-14;LA;Laos;0;0;24;0
2020-11-15;LA;Laos;0;0;24;0
2020-11-16;LA;Laos;0;0;24;0
2020-11-17;LA;Laos;1;0;25;0
2020-11-18;LA;Laos;0;0;25;0
2020-11-19;LA;Laos;0;0;25;0
2020-11-20;LA;Laos;0;0;25;0
2020-11-21;LA;Laos;0;0;25;0
2020-11-22;LA;Laos;0;0;25;0
2020-11-23;LA;Laos;14;0;39;0
2020-11-24;LA;Laos;0;0;39;0
2020-11-25;LA;Laos;0;0;39;0
2020-11-26;LA;Laos;0;0;39;0
2020-11-27;LA;Laos;0;0;39;0
2020-11-28;LA;Laos;0;0;39;0
2020-11-29;LA;Laos;0;0;39;0
2020-11-30;LA;Laos;0;0;39;0
2020-12-01;LA;Laos;0;0;39;0
2020-12-02;LA;Laos;0;0;39;0
2020-12-03;LA;Laos;0;0;39;0
2020-12-04;LA;Laos;0;0;39;0
2020-12-05;LA;Laos;0;0;39;0
2020-12-06;LA;Laos;0;0;39;0
2020-12-07;LA;Laos;2;0;41;0
2020-12-08;LA;Laos;0;0;41;0
2020-12-09;LA;Laos;0;0;41;0
2020-12-10;LA;Laos;0;0;41;0
2020-12-11;LA;Laos;0;0;41;0
2020-12-12;LA;Laos;0;0;41;0
2020-12-13;LA;Laos;0;0;41;0
2020-12-14;LA;Laos;0;0;41;0
2020-12-15;LA;Laos;0;0;41;0
2020-12-16;LA;Laos;0;0;41;0
2020-12-17;LA;Laos;0;0;41;0
2020-12-18;LA;Laos;0;0;41;0
2020-12-19;LA;Laos;0;0;41;0
2020-12-20;LA;Laos;0;0;41;0
2020-12-21;LA;Laos;0;0;41;0
2020-12-22;LA;Laos;0;0;41;0
2020-12-23;LA;Laos;0;0;41;0
2020-12-24;LA;Laos;0;0;41;0
2020-12-25;LA;Laos;0;0;41;0
2020-12-26;LA;Laos;0;0;41;0
2020-12-27;LA;Laos;0;0;41;0
2020-12-28;LA;Laos;0;0;41;0
2020-12-29;LA;Laos;0;0;41;0
2020-12-30;LA;Laos;0;0;41;0
2020-12-31;LA;Laos;0;0;41;0
2021-01-01;LA;Laos;0;0;41;0
2021-01-02;LA;Laos;0;0;41;0
2021-01-03;LA;Laos;0;0;41;0
2021-01-04;LA;Laos;0;0;41;0
2021-01-05;LA;Laos;0;0;41;0
2021-01-06;LA;Laos;0;0;41;0
2021-01-07;LA;Laos;0;0;41;0
2021-01-08;LA;Laos;0;0;41;0
2021-01-09;LA;Laos;0;0;41;0
2021-01-10;LA;Laos;0;0;41;0
2021-01-11;LA;Laos;0;0;41;0
2021-01-12;LA;Laos;0;0;41;0
2021-01-13;LA;Laos;0;0;41;0
2021-01-14;LA;Laos;0;0;41;0
2021-01-15;LA;Laos;0;0;41;0
2021-01-16;LA;Laos;0;0;41;0
2021-01-17;LA;Laos;0;0;41;0
2021-01-18;LA;Laos;0;0;41;0
2021-01-19;LA;Laos;0;0;41;0
2021-01-20;LA;Laos;0;0;41;0
2021-01-21;LA;Laos;0;0;41;0
2021-01-22;LA;Laos;0;0;41;0
2021-01-23;LA;Laos;0;0;41;0
2021-01-24;LA;Laos;0;0;41;0
2021-01-25;LA;Laos;3;0;44;0
2021-01-26;LA;Laos;0;0;44;0
2021-01-27;LA;Laos;0;0;44;0
2021-01-28;LA;Laos;0;0;44;0
2021-01-29;LA;Laos;0;0;44;0
2021-01-30;LA;Laos;0;0;44;0
2021-01-31;LA;Laos;0;0;44;0
2021-02-01;LA;Laos;0;0;44;0
2021-02-02;LA;Laos;0;0;44;0
2021-02-03;LA;Laos;1;0;45;0
2021-02-04;LA;Laos;0;0;45;0
2021-02-05;LA;Laos;0;0;45;0
2021-02-06;LA;Laos;0;0;45;0
2021-02-07;LA;Laos;0;0;45;0
2021-02-08;LA;Laos;0;0;45;0
2021-02-09;LA;Laos;0;0;45;0
2021-02-10;LA;Laos;0;0;45;0
2021-02-11;LA;Laos;0;0;45;0
2021-02-12;LA;Laos;0;0;45;0
2021-02-13;LA;Laos;0;0;45;0
2021-02-14;LA;Laos;0;0;45;0
2021-02-15;LA;Laos;0;0;45;0
2021-02-16;LA;Laos;0;0;45;0
2021-02-17;LA;Laos;0;0;45;0
2021-02-18;LA;Laos;0;0;45;0
2021-02-19;LA;Laos;0;0;45;0
2021-02-20;LA;Laos;0;0;45;0
2021-02-21;LA;Laos;0;0;45;0
2021-02-22;LA;Laos;0;0;45;0
2021-02-23;LA;Laos;0;0;45;0
2021-02-24;LA;Laos;0;0;45;0
2021-02-25;LA;Laos;0;0;45;0
2021-02-26;LA;Laos;0;0;45;0
2021-02-27;LA;Laos;0;0;45;0
2021-02-28;LA;Laos;0;0;45;0
2021-03-01;LA;Laos;0;0;45;0
2021-03-02;LA;Laos;0;0;45;0
2021-03-03;LA;Laos;0;0;45;0
2021-03-04;LA;Laos;0;0;45;0
2021-03-05;LA;Laos;2;0;47;0
2021-03-06;LA;Laos;0;0;47;0
2021-03-07;LA;Laos;0;0;47;0
2021-03-08;LA;Laos;0;0;47;0
2021-03-09;LA;Laos;0;0;47;0
2021-03-10;LA;Laos;0;0;47;0
2021-03-11;LA;Laos;1;0;48;0
2021-03-12;LA;Laos;0;0;48;0
2021-03-13;LA;Laos;0;0;48;0
2021-03-14;LA;Laos;0;0;48;0
2021-03-15;LA;Laos;0;0;48;0
2021-03-16;LA;Laos;0;0;48;0
2021-03-17;LA;Laos;1;0;49;0
2021-03-18;LA;Laos;0;0;49;0
2021-03-19;LA;Laos;0;0;49;0
2021-03-20;LA;Laos;0;0;49;0
2021-03-21;LA;Laos;0;0;49;0
2021-03-22;LA;Laos;0;0;49;0
2021-03-23;LA;Laos;0;0;49;0
2021-03-24;LA;Laos;0;0;49;0
2021-03-25;LA;Laos;0;0;49;0
2021-03-26;LA;Laos;0;0;49;0
2021-03-27;LA;Laos;0;0;49;0
2021-03-28;LA;Laos;0;0;49;0
2021-03-29;LA;Laos;0;0;49;0
2021-03-30;LA;Laos;0;0;49;0
2021-03-31;LA;Laos;0;0;49;0
2021-04-01;LA;Laos;0;0;49;0
2021-04-02;LA;Laos;0;0;49;0
2021-04-03;LA;Laos;0;0;49;0
2021-04-04;LA;Laos;0;0;49;0
2021-04-05;LA;Laos;0;0;49;0
2021-04-06;LA;Laos;0;0;49;0
2021-04-07;LA;Laos;0;0;49;0
2021-04-08;LA;Laos;0;0;49;0
2021-04-09;LA;Laos;0;0;49;0
2021-04-10;LA;Laos;0;0;49;0
2021-04-11;LA;Laos;2;0;51;0
2021-04-12;LA;Laos;1;0;52;0
2021-04-13;LA;Laos;0;0;52;0
2021-04-14;LA;Laos;1;0;53;0
2021-04-15;LA;Laos;0;0;53;0
2021-04-16;LA;Laos;1;0;54;0
2021-04-17;LA;Laos;4;0;58;0
2021-04-18;LA;Laos;0;0;58;0
2021-04-19;LA;Laos;0;0;58;0
2021-04-20;LA;Laos;2;0;60;0
2021-04-21;LA;Laos;28;0;88;0
2021-04-22;LA;Laos;6;0;94;0
2021-04-23;LA;Laos;65;0;159;0
2021-04-24;LA;Laos;88;0;247;0
2021-04-25;LA;Laos;76;0;323;0
2021-04-26;LA;Laos;113;0;436;0
2021-04-27;LA;Laos;75;0;511;0
2021-04-28;LA;Laos;93;0;604;0
2021-04-29;LA;Laos;68;0;672;0
2021-04-30;LA;Laos;85;0;757;0
2021-05-01;LA;Laos;64;0;821;0
2021-05-02;LA;Laos;112;0;933;0
2021-05-03;LA;Laos;33;0;966;0
2021-05-04;LA;Laos;60;0;1026;0
2021-05-05;LA;Laos;46;0;1072;0
2021-05-06;LA;Laos;105;0;1177;0
2021-05-07;LA;Laos;28;0;1205;0
2021-05-08;LA;Laos;28;0;1233;0
2021-05-09;LA;Laos;69;1;1302;1
2021-05-10;LA;Laos;25;0;1327;1
2021-05-11;LA;Laos;35;0;1362;1
2021-05-12;LA;Laos;55;0;1417;1
2021-05-13;LA;Laos;65;0;1482;1
2021-05-14;LA;Laos;16;1;1498;2
2021-05-15;LA;Laos;72;0;1570;2
2021-05-16;LA;Laos;21;0;1591;2
2021-05-17;LA;Laos;47;0;1638;2
2021-05-18;LA;Laos;49;0;1687;2
2021-05-19;LA;Laos;50;0;1737;2
2021-05-20;LA;Laos;14;0;1751;2
2021-05-21;LA;Laos;12;0;1763;2
2021-05-22;LA;Laos;19;0;1782;2
2021-05-23;LA;Laos;19;0;1801;2
2021-05-24;LA;Laos;21;0;1822;2
2021-05-25;LA;Laos;56;0;1878;2
2021-05-26;LA;Laos;5;0;1883;2
2021-05-27;LA;Laos;12;0;1895;2
2021-05-28;LA;Laos;10;1;1905;3
2021-05-29;LA;Laos;3;0;1908;3
2021-05-30;LA;Laos;3;0;1911;3
2021-05-31;LA;Laos;1;0;1912;3
2021-06-01;LA;Laos;17;0;1929;3
2021-06-02;LA;Laos;5;0;1934;3
2021-06-03;LA;Laos;9;0;1943;3
2021-06-04;LA;Laos;9;0;1952;3
2021-06-05;LA;Laos;5;0;1957;3
2021-06-06;LA;Laos;6;0;1963;3
2021-06-07;LA;Laos;5;0;1968;3
2021-06-08;LA;Laos;2;0;1970;3
2021-06-09;LA;Laos;1;0;1971;3
2021-06-10;LA;Laos;4;0;1975;3
2021-06-11;LA;Laos;4;0;1979;3
2021-06-12;LA;Laos;11;0;1990;3
2021-06-13;LA;Laos;6;0;1996;3
2021-06-14;LA;Laos;14;0;2010;3
2021-06-15;LA;Laos;15;0;2025;3
2021-06-16;LA;Laos;8;0;2033;3
2021-06-17;LA;Laos;1;0;2034;3
2021-06-18;LA;Laos;13;0;2047;3
2021-06-19;LA;Laos;3;0;2050;3
2021-06-20;LA;Laos;3;0;2053;3
2021-06-21;LA;Laos;1;0;2054;3
2021-06-22;LA;Laos;13;0;2067;3
2021-06-23;LA;Laos;9;0;2076;3
2021-06-24;LA;Laos;4;0;2080;3
2021-06-25;LA;Laos;14;0;2094;3
2021-06-26;LA;Laos;6;0;2100;3
2021-06-27;LA;Laos;10;0;2110;3
2021-06-28;LA;Laos;0;0;2110;3
2021-06-29;LA;Laos;0;0;2110;3
2021-06-30;LA;Laos;11;0;2121;3
2021-07-01;LA;Laos;23;0;2144;3
2020-01-06;LV;Latvia;0;0;0;0
2020-01-18;LV;Latvia;0;0;0;0
2020-01-24;LV;Latvia;0;0;0;0
2020-02-02;LV;Latvia;0;0;0;0
2020-02-09;LV;Latvia;0;0;0;0
2020-02-15;LV;Latvia;0;0;0;0
2020-02-23;LV;Latvia;0;0;0;0
2020-02-29;LV;Latvia;0;0;0;0
2020-03-01;LV;Latvia;0;0;0;0
2020-03-02;LV;Latvia;1;0;1;0
2020-03-03;LV;Latvia;0;0;1;0
2020-03-04;LV;Latvia;0;0;1;0
2020-03-05;LV;Latvia;0;0;1;0
2020-03-06;LV;Latvia;0;0;1;0
2020-03-07;LV;Latvia;0;0;1;0
2020-03-08;LV;Latvia;1;0;2;0
2020-03-09;LV;Latvia;4;0;6;0
2020-03-10;LV;Latvia;2;0;8;0
2020-03-11;LV;Latvia;2;0;10;0
2020-03-12;LV;Latvia;0;0;10;0
2020-03-13;LV;Latvia;7;0;17;0
2020-03-14;LV;Latvia;9;0;26;0
2020-03-15;LV;Latvia;4;0;30;0
2020-03-16;LV;Latvia;4;0;34;0
2020-03-17;LV;Latvia;15;0;49;0
2020-03-18;LV;Latvia;22;0;71;0
2020-03-19;LV;Latvia;15;0;86;0
2020-03-20;LV;Latvia;25;0;111;0
2020-03-21;LV;Latvia;13;0;124;0
2020-03-22;LV;Latvia;15;0;139;0
2020-03-23;LV;Latvia;41;0;180;0
2020-03-24;LV;Latvia;17;0;197;0
2020-03-25;LV;Latvia;24;0;221;0
2020-03-26;LV;Latvia;23;0;244;0
2020-03-27;LV;Latvia;36;0;280;0
2020-03-28;LV;Latvia;25;0;305;0
2020-03-29;LV;Latvia;42;0;347;0
2020-03-30;LV;Latvia;29;0;376;0
2020-03-31;LV;Latvia;22;0;398;0
2020-04-01;LV;Latvia;48;0;446;0
2020-04-02;LV;Latvia;12;0;458;0
2020-04-03;LV;Latvia;35;1;493;1
2020-04-04;LV;Latvia;16;0;509;1
2020-04-05;LV;Latvia;24;0;533;1
2020-04-06;LV;Latvia;9;0;542;1
2020-04-07;LV;Latvia;6;1;548;2
2020-04-08;LV;Latvia;29;0;577;2
2020-04-09;LV;Latvia;12;1;589;3
2020-04-10;LV;Latvia;23;0;612;3
2020-04-11;LV;Latvia;18;0;630;3
2020-04-12;LV;Latvia;21;2;651;5
2020-04-13;LV;Latvia;4;0;655;5
2020-04-14;LV;Latvia;2;0;657;5
2020-04-15;LV;Latvia;9;0;666;5
2020-04-16;LV;Latvia;9;0;675;5
2020-04-17;LV;Latvia;7;0;682;5
2020-04-18;LV;Latvia;30;0;712;5
2020-04-19;LV;Latvia;15;0;727;5
2020-04-20;LV;Latvia;12;0;739;5
2020-04-21;LV;Latvia;9;4;748;9
2020-04-22;LV;Latvia;13;2;761;11
2020-04-23;LV;Latvia;17;0;778;11
2020-04-24;LV;Latvia;6;1;784;12
2020-04-25;LV;Latvia;20;0;804;12
2020-04-26;LV;Latvia;8;0;812;12
2020-04-27;LV;Latvia;6;1;818;13
2020-04-28;LV;Latvia;18;0;836;13
2020-04-29;LV;Latvia;13;2;849;15
2020-04-30;LV;Latvia;9;0;858;15
2020-05-01;LV;Latvia;12;1;870;16
2020-05-02;LV;Latvia;1;0;871;16
2020-05-03;LV;Latvia;8;0;879;16
2020-05-04;LV;Latvia;17;0;896;16
2020-05-05;LV;Latvia;0;1;896;17
2020-05-06;LV;Latvia;4;0;900;17
2020-05-07;LV;Latvia;9;1;909;18
2020-05-08;LV;Latvia;19;0;928;18
2020-05-09;LV;Latvia;2;0;930;18
2020-05-10;LV;Latvia;9;0;939;18
2020-05-11;LV;Latvia;7;0;946;18
2020-05-12;LV;Latvia;4;0;950;18
2020-05-13;LV;Latvia;1;1;951;19
2020-05-14;LV;Latvia;11;0;962;19
2020-05-15;LV;Latvia;8;0;970;19
2020-05-16;LV;Latvia;27;0;997;19
2020-05-17;LV;Latvia;11;0;1008;19
2020-05-18;LV;Latvia;1;0;1009;19
2020-05-19;LV;Latvia;3;2;1012;21
2020-05-20;LV;Latvia;4;0;1016;21
2020-05-21;LV;Latvia;9;1;1025;22
2020-05-22;LV;Latvia;5;0;1030;22
2020-05-23;LV;Latvia;16;0;1046;22
2020-05-24;LV;Latvia;1;0;1047;22
2020-05-25;LV;Latvia;2;0;1049;22
2020-05-26;LV;Latvia;4;0;1053;22
2020-05-27;LV;Latvia;4;1;1057;23
2020-05-28;LV;Latvia;4;1;1061;24
2020-05-29;LV;Latvia;3;0;1064;24
2020-05-30;LV;Latvia;1;0;1065;24
2020-05-31;LV;Latvia;1;0;1066;24
2020-06-01;LV;Latvia;0;0;1066;24
2020-06-02;LV;Latvia;5;0;1071;24
2020-06-03;LV;Latvia;8;0;1079;24
2020-06-04;LV;Latvia;3;1;1082;25
2020-06-05;LV;Latvia;3;0;1085;25
2020-06-06;LV;Latvia;1;0;1086;25
2020-06-07;LV;Latvia;2;0;1088;25
2020-06-08;LV;Latvia;0;1;1088;26
2020-06-09;LV;Latvia;1;0;1089;26
2020-06-10;LV;Latvia;3;0;1092;26
2020-06-11;LV;Latvia;2;0;1094;26
2020-06-12;LV;Latvia;2;1;1096;27
2020-06-13;LV;Latvia;1;1;1097;28
2020-06-14;LV;Latvia;0;0;1097;28
2020-06-15;LV;Latvia;0;0;1097;28
2020-06-16;LV;Latvia;1;0;1098;28
2020-06-17;LV;Latvia;6;2;1104;30
2020-06-18;LV;Latvia;4;0;1108;30
2020-06-19;LV;Latvia;2;0;1110;30
2020-06-20;LV;Latvia;1;0;1111;30
2020-06-21;LV;Latvia;0;0;1111;30
2020-06-22;LV;Latvia;0;0;1111;30
2020-06-23;LV;Latvia;0;0;1111;30
2020-06-24;LV;Latvia;0;0;1111;30
2020-06-25;LV;Latvia;0;0;1111;30
2020-06-26;LV;Latvia;1;0;1112;30
2020-06-27;LV;Latvia;3;0;1115;30
2020-06-28;LV;Latvia;1;0;1116;30
2020-06-29;LV;Latvia;1;0;1117;30
2020-06-30;LV;Latvia;1;0;1118;30
2020-07-01;LV;Latvia;3;0;1121;30
2020-07-02;LV;Latvia;1;0;1122;30
2020-07-03;LV;Latvia;0;0;1122;30
2020-07-04;LV;Latvia;1;0;1123;30
2020-07-05;LV;Latvia;1;0;1124;30
2020-07-06;LV;Latvia;3;0;1127;30
2020-07-07;LV;Latvia;7;0;1134;30
2020-07-08;LV;Latvia;7;0;1141;30
2020-07-09;LV;Latvia;13;0;1154;30
2020-07-10;LV;Latvia;11;0;1165;30
2020-07-11;LV;Latvia;8;0;1173;30
2020-07-12;LV;Latvia;0;0;1173;30
2020-07-13;LV;Latvia;1;1;1174;31
2020-07-14;LV;Latvia;0;0;1174;31
2020-07-15;LV;Latvia;4;0;1178;31
2020-07-16;LV;Latvia;1;0;1179;31
2020-07-17;LV;Latvia;6;0;1185;31
2020-07-18;LV;Latvia;4;0;1189;31
2020-07-19;LV;Latvia;3;0;1192;31
2020-07-20;LV;Latvia;0;0;1192;31
2020-07-21;LV;Latvia;1;0;1193;31
2020-07-22;LV;Latvia;4;0;1197;31
2020-07-23;LV;Latvia;6;0;1203;31
2020-07-24;LV;Latvia;2;0;1205;31
2020-07-25;LV;Latvia;1;0;1206;31
2020-07-26;LV;Latvia;13;0;1219;31
2020-07-27;LV;Latvia;0;0;1219;31
2020-07-28;LV;Latvia;1;0;1220;31
2020-07-29;LV;Latvia;4;0;1224;31
2020-07-30;LV;Latvia;4;0;1228;31
2020-07-31;LV;Latvia;3;1;1231;32
2020-08-01;LV;Latvia;7;0;1238;32
2020-08-02;LV;Latvia;5;0;1243;32
2020-08-03;LV;Latvia;3;0;1246;32
2020-08-04;LV;Latvia;3;0;1249;32
2020-08-05;LV;Latvia;8;0;1257;32
2020-08-06;LV;Latvia;18;0;1275;32
2020-08-07;LV;Latvia;6;0;1281;32
2020-08-08;LV;Latvia;7;0;1288;32
2020-08-09;LV;Latvia;2;0;1290;32
2020-08-10;LV;Latvia;0;0;1290;32
2020-08-11;LV;Latvia;3;0;1293;32
2020-08-12;LV;Latvia;10;0;1303;32
2020-08-13;LV;Latvia;4;0;1307;32
2020-08-14;LV;Latvia;1;0;1308;32
2020-08-15;LV;Latvia;7;0;1315;32
2020-08-16;LV;Latvia;7;0;1322;32
2020-08-17;LV;Latvia;1;0;1323;32
2020-08-18;LV;Latvia;0;1;1323;33
2020-08-19;LV;Latvia;3;0;1326;33
2020-08-20;LV;Latvia;1;0;1327;33
2020-08-21;LV;Latvia;3;0;1330;33
2020-08-22;LV;Latvia;3;0;1333;33
2020-08-23;LV;Latvia;4;0;1337;33
2020-08-24;LV;Latvia;0;0;1337;33
2020-08-25;LV;Latvia;5;0;1342;33
2020-08-26;LV;Latvia;18;0;1360;33
2020-08-27;LV;Latvia;6;1;1366;34
2020-08-28;LV;Latvia;9;0;1375;34
2020-08-29;LV;Latvia;6;0;1381;34
2020-08-30;LV;Latvia;12;0;1393;34
2020-08-31;LV;Latvia;3;0;1396;34
2020-09-01;LV;Latvia;8;0;1404;34
2020-09-02;LV;Latvia;2;0;1406;34
2020-09-03;LV;Latvia;4;0;1410;34
2020-09-04;LV;Latvia;6;1;1416;35
2020-09-05;LV;Latvia;9;0;1425;35
2020-09-06;LV;Latvia;3;0;1428;35
2020-09-07;LV;Latvia;1;0;1429;35
2020-09-08;LV;Latvia;3;0;1432;35
2020-09-09;LV;Latvia;11;0;1443;35
2020-09-10;LV;Latvia;5;0;1448;35
2020-09-11;LV;Latvia;11;0;1459;35
2020-09-12;LV;Latvia;5;0;1464;35
2020-09-13;LV;Latvia;10;0;1474;35
2020-09-14;LV;Latvia;3;0;1477;35
2020-09-15;LV;Latvia;5;0;1482;35
2020-09-16;LV;Latvia;4;0;1486;35
2020-09-17;LV;Latvia;8;1;1494;36
2020-09-18;LV;Latvia;4;0;1498;36
2020-09-19;LV;Latvia;17;0;1515;36
2020-09-20;LV;Latvia;10;0;1525;36
2020-09-21;LV;Latvia;1;0;1526;36
2020-09-22;LV;Latvia;34;0;1560;36
2020-09-23;LV;Latvia;12;0;1572;36
2020-09-24;LV;Latvia;22;0;1594;36
2020-09-25;LV;Latvia;31;0;1625;36
2020-09-26;LV;Latvia;29;0;1654;36
2020-09-27;LV;Latvia;22;0;1676;36
2020-09-28;LV;Latvia;21;0;1697;36
2020-09-29;LV;Latvia;32;1;1729;37
2020-09-30;LV;Latvia;95;0;1824;37
2020-10-01;LV;Latvia;44;0;1868;37
2020-10-02;LV;Latvia;77;1;1945;38
2020-10-03;LV;Latvia;74;0;2019;38
2020-10-04;LV;Latvia;67;0;2086;38
2020-10-05;LV;Latvia;40;1;2126;39
2020-10-06;LV;Latvia;68;1;2194;40
2020-10-07;LV;Latvia;67;0;2261;40
2020-10-08;LV;Latvia;109;0;2370;40
2020-10-09;LV;Latvia;137;0;2507;40
2020-10-10;LV;Latvia;89;0;2596;40
2020-10-11;LV;Latvia;74;0;2670;40
2020-10-12;LV;Latvia;95;0;2765;40
2020-10-13;LV;Latvia;75;1;2840;41
2020-10-14;LV;Latvia;102;0;2942;41
2020-10-15;LV;Latvia;114;0;3056;41
2020-10-16;LV;Latvia;148;1;3204;42
2020-10-17;LV;Latvia;188;1;3392;43
2020-10-18;LV;Latvia;58;1;3450;44
2020-10-19;LV;Latvia;44;0;3494;44
2020-10-20;LV;Latvia;115;3;3609;47
2020-10-21;LV;Latvia;188;0;3797;47
2020-10-22;LV;Latvia;161;2;3958;49
2020-10-23;LV;Latvia;250;1;4208;50
2020-10-24;LV;Latvia;259;4;4467;54
2020-10-25;LV;Latvia;211;2;4678;56
2020-10-26;LV;Latvia;79;4;4757;60
2020-10-27;LV;Latvia;136;3;4893;63
2020-10-28;LV;Latvia;251;0;5144;63
2020-10-29;LV;Latvia;251;1;5395;64
2020-10-30;LV;Latvia;284;5;5679;69
2020-10-31;LV;Latvia;215;2;5894;71
2020-11-01;LV;Latvia;242;3;6136;74
2020-11-02;LV;Latvia;132;3;6268;77
2020-11-03;LV;Latvia;171;2;6439;79
2020-11-04;LV;Latvia;313;6;6752;85
2020-11-05;LV;Latvia;367;3;7119;88
2020-11-06;LV;Latvia;357;7;7476;95
2020-11-07;LV;Latvia;404;1;7880;96
2020-11-08;LV;Latvia;215;3;8095;99
2020-11-09;LV;Latvia;92;2;8187;101
2020-11-10;LV;Latvia;208;2;8395;103
2020-11-11;LV;Latvia;453;2;8848;105
2020-11-12;LV;Latvia;533;2;9381;107
2020-11-13;LV;Latvia;455;9;9836;116
2020-11-14;LV;Latvia;395;5;10231;121
2020-11-15;LV;Latvia;316;2;10547;123
2020-11-16;LV;Latvia;89;3;10636;126
2020-11-17;LV;Latvia;278;6;10914;132
2020-11-18;LV;Latvia;442;5;11356;137
2020-11-19;LV;Latvia;366;4;11722;141
2020-11-20;LV;Latvia;380;5;12102;146
2020-11-21;LV;Latvia;642;7;12744;153
2020-11-22;LV;Latvia;376;0;13120;153
2020-11-23;LV;Latvia;116;9;13236;162
2020-11-24;LV;Latvia;457;13;13693;175
2020-11-25;LV;Latvia;580;9;14273;184
2020-11-26;LV;Latvia;898;4;15171;188
2020-11-27;LV;Latvia;637;2;15808;190
2020-11-28;LV;Latvia;753;3;16561;193
2020-11-29;LV;Latvia;414;4;16975;197
2020-11-30;LV;Latvia;100;9;17075;206
2020-12-01;LV;Latvia;612;4;17687;210
2020-12-02;LV;Latvia;690;14;18377;224
2020-12-03;LV;Latvia;930;11;19307;235
2020-12-04;LV;Latvia;686;7;19993;242
2020-12-05;LV;Latvia;794;11;20787;253
2020-12-06;LV;Latvia;526;9;21313;262
2020-12-07;LV;Latvia;207;10;21520;272
2020-12-08;LV;Latvia;584;16;22104;288
2020-12-09;LV;Latvia;712;5;22816;293
2020-12-10;LV;Latvia;890;11;23706;304
2020-12-11;LV;Latvia;680;15;24386;319
2020-12-12;LV;Latvia;660;5;25046;324
2020-12-13;LV;Latvia;629;25;25675;349
2020-12-14;LV;Latvia;210;3;25885;352
2020-12-15;LV;Latvia;587;5;26472;357
2020-12-16;LV;Latvia;1023;25;27495;382
2020-12-17;LV;Latvia;1040;12;28535;394
2020-12-18;LV;Latvia;892;15;29427;409
2020-12-19;LV;Latvia;870;18;30297;427
2020-12-20;LV;Latvia;643;12;30940;439
2020-12-21;LV;Latvia;395;4;31335;443
2020-12-22;LV;Latvia;1004;16;32339;459
2020-12-23;LV;Latvia;1145;20;33484;479
2020-12-24;LV;Latvia;1270;7;34754;486
2020-12-25;LV;Latvia;666;16;35420;502
2020-12-26;LV;Latvia;399;13;35819;515
2020-12-27;LV;Latvia;511;44;36330;559
2020-12-28;LV;Latvia;508;19;36838;578
2020-12-29;LV;Latvia;838;25;37676;603
2020-12-30;LV;Latvia;1367;23;39043;626
2020-12-31;LV;Latvia;1861;9;40904;635
2021-01-01;LV;Latvia;711;9;41615;644
2021-01-02;LV;Latvia;314;24;41929;668
2021-01-03;LV;Latvia;568;12;42497;680
2021-01-04;LV;Latvia;621;12;43118;692
2021-01-05;LV;Latvia;824;30;43942;722
2021-01-06;LV;Latvia;1229;32;45171;754
2021-01-07;LV;Latvia;1374;36;46545;790
2021-01-08;LV;Latvia;1237;11;47782;801
2021-01-09;LV;Latvia;1170;17;48952;818
2021-01-10;LV;Latvia;616;31;49568;849
2021-01-11;LV;Latvia;331;15;49899;864
2021-01-12;LV;Latvia;878;18;50777;882
2021-01-13;LV;Latvia;1255;27;52032;909
2021-01-14;LV;Latvia;950;11;52982;920
2021-01-15;LV;Latvia;1084;15;54066;935
2021-01-16;LV;Latvia;1031;26;55097;961
2021-01-17;LV;Latvia;567;17;55664;978
2021-01-18;LV;Latvia;244;5;55908;983
2021-01-19;LV;Latvia;812;29;56720;1012
2021-01-20;LV;Latvia;1088;20;57808;1032
2021-01-21;LV;Latvia;902;25;58710;1057
2021-01-22;LV;Latvia;876;19;59586;1076
2021-01-23;LV;Latvia;910;21;60496;1097
2021-01-24;LV;Latvia;512;14;61008;1111
2021-01-25;LV;Latvia;223;3;61231;1114
2021-01-26;LV;Latvia;693;12;61924;1126
2021-01-27;LV;Latvia;1103;12;63027;1138
2021-01-28;LV;Latvia;965;10;63992;1148
2021-01-29;LV;Latvia;931;18;64923;1166
2021-01-30;LV;Latvia;785;14;65708;1180
2021-01-31;LV;Latvia;533;15;66241;1195
2021-02-01;LV;Latvia;411;7;66652;1202
2021-02-02;LV;Latvia;775;17;67427;1219
2021-02-03;LV;Latvia;1231;31;68658;1250
2021-02-04;LV;Latvia;742;31;69400;1281
2021-02-05;LV;Latvia;876;28;70276;1309
2021-02-06;LV;Latvia;1044;18;71320;1327
2021-02-07;LV;Latvia;480;12;71800;1339
2021-02-08;LV;Latvia;288;8;72088;1347
2021-02-09;LV;Latvia;781;16;72869;1363
2021-02-10;LV;Latvia;990;32;73859;1395
2021-02-11;LV;Latvia;842;21;74701;1416
2021-02-12;LV;Latvia;808;15;75509;1431
2021-02-13;LV;Latvia;773;12;76282;1443
2021-02-14;LV;Latvia;424;8;76706;1451
2021-02-15;LV;Latvia;278;17;76984;1468
2021-02-16;LV;Latvia;713;18;77697;1486
2021-02-17;LV;Latvia;946;22;78643;1508
2021-02-18;LV;Latvia;708;13;79351;1521
2021-02-19;LV;Latvia;689;12;80040;1533
2021-02-20;LV;Latvia;1069;5;81109;1538
2021-02-21;LV;Latvia;410;4;81519;1542
2021-02-22;LV;Latvia;274;4;81793;1546
2021-02-23;LV;Latvia;669;24;82462;1570
2021-02-24;LV;Latvia;983;17;83445;1587
2021-02-25;LV;Latvia;813;6;84258;1593
2021-02-26;LV;Latvia;725;8;84983;1601
2021-02-27;LV;Latvia;827;13;85810;1614
2021-02-28;LV;Latvia;376;4;86186;1618
2021-03-01;LV;Latvia;272;3;86458;1621
2021-03-02;LV;Latvia;645;17;87103;1638
2021-03-03;LV;Latvia;919;16;88022;1654
2021-03-04;LV;Latvia;646;12;88668;1666
2021-03-05;LV;Latvia;746;14;89414;1680
2021-03-06;LV;Latvia;595;7;90009;1687
2021-03-07;LV;Latvia;322;8;90331;1695
2021-03-08;LV;Latvia;194;4;90525;1699
2021-03-09;LV;Latvia;472;6;90997;1705
2021-03-10;LV;Latvia;639;21;91636;1726
2021-03-11;LV;Latvia;638;11;92274;1737
2021-03-12;LV;Latvia;632;9;92906;1746
2021-03-13;LV;Latvia;578;11;93484;1757
2021-03-14;LV;Latvia;297;10;93781;1767
2021-03-15;LV;Latvia;178;2;93959;1769
2021-03-16;LV;Latvia;643;8;94602;1777
2021-03-17;LV;Latvia;818;12;95420;1789
2021-03-18;LV;Latvia;482;12;95902;1801
2021-03-19;LV;Latvia;622;10;96524;1811
2021-03-20;LV;Latvia;625;10;97149;1821
2021-03-21;LV;Latvia;260;5;97409;1826
2021-03-22;LV;Latvia;177;2;97586;1828
2021-03-23;LV;Latvia;508;12;98094;1840
2021-03-24;LV;Latvia;776;11;98870;1851
2021-03-25;LV;Latvia;606;13;99476;1864
2021-03-26;LV;Latvia;638;3;100114;1867
2021-03-27;LV;Latvia;602;5;100716;1872
2021-03-28;LV;Latvia;324;6;101040;1878
2021-03-29;LV;Latvia;167;5;101207;1883
2021-03-30;LV;Latvia;526;10;101733;1893
2021-03-31;LV;Latvia;630;6;102363;1899
2021-04-01;LV;Latvia;638;14;103001;1913
2021-04-02;LV;Latvia;587;9;103588;1922
2021-04-03;LV;Latvia;279;1;103867;1923
2021-04-04;LV;Latvia;238;8;104105;1931
2021-04-05;LV;Latvia;119;3;104224;1934
2021-04-06;LV;Latvia;309;3;104533;1937
2021-04-07;LV;Latvia;643;9;105176;1946
2021-04-08;LV;Latvia;740;17;105916;1963
2021-04-09;LV;Latvia;658;18;106574;1981
2021-04-10;LV;Latvia;666;5;107240;1986
2021-04-11;LV;Latvia;368;0;107608;1986
2021-04-12;LV;Latvia;210;4;107818;1990
2021-04-13;LV;Latvia;537;12;108355;2002
2021-04-14;LV;Latvia;733;17;109088;2019
2021-04-15;LV;Latvia;643;11;109731;2030
2021-04-16;LV;Latvia;612;12;110343;2042
2021-04-17;LV;Latvia;654;6;110997;2048
2021-04-18;LV;Latvia;337;5;111334;2053
2021-04-19;LV;Latvia;202;3;111536;2056
2021-04-20;LV;Latvia;688;15;112224;2071
2021-04-21;LV;Latvia;759;8;112983;2079
2021-04-22;LV;Latvia;578;9;113561;2088
2021-04-23;LV;Latvia;683;6;114244;2094
2021-04-24;LV;Latvia;711;7;114955;2101
2021-04-25;LV;Latvia;361;1;115316;2102
2021-04-26;LV;Latvia;220;4;115536;2106
2021-04-27;LV;Latvia;596;4;116132;2110
2021-04-28;LV;Latvia;967;8;117099;2118
2021-04-29;LV;Latvia;696;7;117795;2125
2021-04-30;LV;Latvia;763;6;118558;2131
2021-05-01;LV;Latvia;812;8;119370;2139
2021-05-02;LV;Latvia;380;5;119750;2144
2021-05-03;LV;Latvia;203;10;119953;2154
2021-05-04;LV;Latvia;425;5;120378;2159
2021-05-05;LV;Latvia;358;7;120736;2166
2021-05-06;LV;Latvia;773;12;121509;2178
2021-05-07;LV;Latvia;1036;19;122545;2197
2021-05-08;LV;Latvia;786;11;123331;2208
2021-05-09;LV;Latvia;632;4;123963;2212
2021-05-10;LV;Latvia;338;1;124301;2213
2021-05-11;LV;Latvia;659;4;124960;2217
2021-05-12;LV;Latvia;729;6;125689;2223
2021-05-13;LV;Latvia;689;17;126378;2240
2021-05-14;LV;Latvia;675;8;127053;2248
2021-05-15;LV;Latvia;544;9;127597;2257
2021-05-16;LV;Latvia;381;9;127978;2266
2021-05-17;LV;Latvia;147;3;128125;2269
2021-05-18;LV;Latvia;563;11;128688;2280
2021-05-19;LV;Latvia;609;18;129297;2298
2021-05-20;LV;Latvia;497;3;129794;2301
2021-05-21;LV;Latvia;477;8;130271;2309
2021-05-22;LV;Latvia;441;14;130712;2323
2021-05-23;LV;Latvia;233;3;130945;2326
2021-05-24;LV;Latvia;134;2;131079;2328
2021-05-25;LV;Latvia;435;14;131514;2342
2021-05-26;LV;Latvia;396;6;131910;2348
2021-05-27;LV;Latvia;348;7;132258;2355
2021-05-28;LV;Latvia;354;4;132612;2359
2021-05-29;LV;Latvia;306;11;132918;2370
2021-05-30;LV;Latvia;180;0;133098;2370
2021-05-31;LV;Latvia;101;6;133199;2376
2021-06-01;LV;Latvia;319;3;133518;2379
2021-06-02;LV;Latvia;348;7;133866;2386
2021-06-03;LV;Latvia;296;6;134162;2392
2021-06-04;LV;Latvia;259;10;134421;2402
2021-06-05;LV;Latvia;256;5;134677;2407
2021-06-06;LV;Latvia;135;6;134812;2413
2021-06-07;LV;Latvia;76;0;134888;2413
2021-06-08;LV;Latvia;256;10;135144;2423
2021-06-09;LV;Latvia;244;5;135388;2428
2021-06-10;LV;Latvia;196;15;135584;2443
2021-06-11;LV;Latvia;178;6;135762;2449
2021-06-12;LV;Latvia;178;2;135940;2451
2021-06-13;LV;Latvia;90;5;136030;2456
2021-06-14;LV;Latvia;74;0;136104;2456
2021-06-15;LV;Latvia;143;8;136247;2464
2021-06-16;LV;Latvia;156;11;136403;2475
2021-06-17;LV;Latvia;141;7;136544;2482
2021-06-18;LV;Latvia;108;3;136652;2485
2021-06-19;LV;Latvia;84;8;136736;2493
2021-06-20;LV;Latvia;74;3;136810;2496
2021-06-21;LV;Latvia;40;0;136850;2496
2021-06-22;LV;Latvia;125;1;136975;2497
2021-06-23;LV;Latvia;102;0;137077;2497
2021-06-24;LV;Latvia;33;3;137110;2500
2021-06-25;LV;Latvia;20;1;137130;2501
2021-06-26;LV;Latvia;39;2;137169;2503
2021-06-27;LV;Latvia;41;0;137210;2503
2021-06-28;LV;Latvia;30;0;137240;2503
2021-06-29;LV;Latvia;89;5;137329;2508
2021-06-30;LV;Latvia;100;5;137429;2513
2021-07-01;LV;Latvia;71;7;137500;2520
2020-02-21;LB;Lebanon;1;0;1;0
2020-02-22;LB;Lebanon;0;0;1;0
2020-02-23;LB;Lebanon;0;0;1;0
2020-02-24;LB;Lebanon;0;0;1;0
2020-02-25;LB;Lebanon;0;0;1;0
2020-02-26;LB;Lebanon;1;0;2;0
2020-02-27;LB;Lebanon;0;0;2;0
2020-02-28;LB;Lebanon;0;0;2;0
2020-02-29;LB;Lebanon;2;0;4;0
2020-03-01;LB;Lebanon;6;0;10;0
2020-03-02;LB;Lebanon;3;0;13;0
2020-03-03;LB;Lebanon;0;0;13;0
2020-03-04;LB;Lebanon;0;0;13;0
2020-03-05;LB;Lebanon;3;0;16;0
2020-03-06;LB;Lebanon;6;0;22;0
2020-03-07;LB;Lebanon;0;0;22;0
2020-03-08;LB;Lebanon;10;0;32;0
2020-03-09;LB;Lebanon;0;0;32;0
2020-03-10;LB;Lebanon;9;1;41;1
2020-03-11;LB;Lebanon;20;2;61;3
2020-03-12;LB;Lebanon;0;0;61;3
2020-03-13;LB;Lebanon;16;0;77;3
2020-03-14;LB;Lebanon;16;0;93;3
2020-03-15;LB;Lebanon;17;0;110;3
2020-03-16;LB;Lebanon;0;0;110;3
2020-03-17;LB;Lebanon;10;0;120;3
2020-03-18;LB;Lebanon;13;0;133;3
2020-03-19;LB;Lebanon;24;1;157;4
2020-03-20;LB;Lebanon;6;0;163;4
2020-03-21;LB;Lebanon;24;0;187;4
2020-03-22;LB;Lebanon;61;0;248;4
2020-03-23;LB;Lebanon;19;0;267;4
2020-03-24;LB;Lebanon;51;0;318;4
2020-03-25;LB;Lebanon;15;2;333;6
2020-03-26;LB;Lebanon;35;0;368;6
2020-03-27;LB;Lebanon;23;2;391;8
2020-03-28;LB;Lebanon;21;0;412;8
2020-03-29;LB;Lebanon;26;2;438;10
2020-03-30;LB;Lebanon;8;1;446;11
2020-03-31;LB;Lebanon;24;1;470;12
2020-04-01;LB;Lebanon;9;2;479;14
2020-04-02;LB;Lebanon;15;2;494;16
2020-04-03;LB;Lebanon;14;1;508;17
2020-04-04;LB;Lebanon;12;0;520;17
2020-04-05;LB;Lebanon;7;1;527;18
2020-04-06;LB;Lebanon;14;1;541;19
2020-04-07;LB;Lebanon;7;0;548;19
2020-04-08;LB;Lebanon;28;0;576;19
2020-04-09;LB;Lebanon;6;0;582;19
2020-04-10;LB;Lebanon;27;1;609;20
2020-04-11;LB;Lebanon;10;0;619;20
2020-04-12;LB;Lebanon;11;0;630;20
2020-04-13;LB;Lebanon;2;0;632;20
2020-04-14;LB;Lebanon;9;1;641;21
2020-04-15;LB;Lebanon;17;0;658;21
2020-04-16;LB;Lebanon;5;0;663;21
2020-04-17;LB;Lebanon;5;0;668;21
2020-04-18;LB;Lebanon;4;0;672;21
2020-04-19;LB;Lebanon;1;0;673;21
2020-04-20;LB;Lebanon;4;0;677;21
2020-04-21;LB;Lebanon;0;0;677;21
2020-04-22;LB;Lebanon;5;1;682;22
2020-04-23;LB;Lebanon;6;0;688;22
2020-04-24;LB;Lebanon;8;0;696;22
2020-04-25;LB;Lebanon;8;2;704;24
2020-04-26;LB;Lebanon;3;0;707;24
2020-04-27;LB;Lebanon;3;0;710;24
2020-04-28;LB;Lebanon;7;0;717;24
2020-04-29;LB;Lebanon;4;0;721;24
2020-04-30;LB;Lebanon;4;0;725;24
2020-05-01;LB;Lebanon;4;0;729;24
2020-05-02;LB;Lebanon;4;1;733;25
2020-05-03;LB;Lebanon;4;0;737;25
2020-05-04;LB;Lebanon;3;0;740;25
2020-05-05;LB;Lebanon;1;0;741;25
2020-05-06;LB;Lebanon;9;0;750;25
2020-05-07;LB;Lebanon;34;0;784;25
2020-05-08;LB;Lebanon;12;1;796;26
2020-05-09;LB;Lebanon;13;0;809;26
2020-05-10;LB;Lebanon;36;0;845;26
2020-05-11;LB;Lebanon;14;0;859;26
2020-05-12;LB;Lebanon;11;0;870;26
2020-05-13;LB;Lebanon;8;0;878;26
2020-05-14;LB;Lebanon;8;0;886;26
2020-05-15;LB;Lebanon;5;0;891;26
2020-05-16;LB;Lebanon;11;0;902;26
2020-05-17;LB;Lebanon;9;0;911;26
2020-05-18;LB;Lebanon;20;0;931;26
2020-05-19;LB;Lebanon;23;0;954;26
2020-05-20;LB;Lebanon;7;0;961;26
2020-05-21;LB;Lebanon;63;0;1024;26
2020-05-22;LB;Lebanon;62;0;1086;26
2020-05-23;LB;Lebanon;11;0;1097;26
2020-05-24;LB;Lebanon;17;0;1114;26
2020-05-25;LB;Lebanon;5;0;1119;26
2020-05-26;LB;Lebanon;21;0;1140;26
2020-05-27;LB;Lebanon;21;0;1161;26
2020-05-28;LB;Lebanon;7;0;1168;26
2020-05-29;LB;Lebanon;4;0;1172;26
2020-05-30;LB;Lebanon;19;0;1191;26
2020-05-31;LB;Lebanon;29;1;1220;27
2020-06-01;LB;Lebanon;13;0;1233;27
2020-06-02;LB;Lebanon;9;0;1242;27
2020-06-03;LB;Lebanon;14;0;1256;27
2020-06-04;LB;Lebanon;50;1;1306;28
2020-06-05;LB;Lebanon;6;0;1312;28
2020-06-06;LB;Lebanon;8;1;1320;29
2020-06-07;LB;Lebanon;11;1;1331;30
2020-06-08;LB;Lebanon;19;0;1350;30
2020-06-09;LB;Lebanon;18;0;1368;30
2020-06-10;LB;Lebanon;20;0;1388;30
2020-06-11;LB;Lebanon;14;1;1402;31
2020-06-12;LB;Lebanon;20;0;1422;31
2020-06-13;LB;Lebanon;20;1;1442;32
2020-06-14;LB;Lebanon;4;0;1446;32
2020-06-15;LB;Lebanon;18;0;1464;32
2020-06-16;LB;Lebanon;9;0;1473;32
2020-06-17;LB;Lebanon;16;0;1489;32
2020-06-18;LB;Lebanon;6;0;1495;32
2020-06-19;LB;Lebanon;15;0;1510;32
2020-06-20;LB;Lebanon;26;0;1536;32
2020-06-21;LB;Lebanon;51;0;1587;32
2020-06-22;LB;Lebanon;16;0;1603;32
2020-06-23;LB;Lebanon;19;0;1622;32
2020-06-24;LB;Lebanon;22;1;1644;33
2020-06-25;LB;Lebanon;18;0;1662;33
2020-06-26;LB;Lebanon;35;0;1697;33
2020-06-27;LB;Lebanon;22;0;1719;33
2020-06-28;LB;Lebanon;21;1;1740;34
2020-06-29;LB;Lebanon;5;0;1745;34
2020-06-30;LB;Lebanon;33;0;1778;34
2020-07-01;LB;Lebanon;10;0;1788;34
2020-07-02;LB;Lebanon;8;1;1796;35
2020-07-03;LB;Lebanon;34;0;1830;35
2020-07-04;LB;Lebanon;25;0;1855;35
2020-07-05;LB;Lebanon;18;1;1873;36
2020-07-06;LB;Lebanon;12;0;1885;36
2020-07-07;LB;Lebanon;22;0;1907;36
2020-07-08;LB;Lebanon;39;0;1946;36
2020-07-09;LB;Lebanon;65;0;2011;36
2020-07-10;LB;Lebanon;71;0;2082;36
2020-07-11;LB;Lebanon;86;0;2168;36
2020-07-12;LB;Lebanon;166;0;2334;36
2020-07-13;LB;Lebanon;85;0;2419;36
2020-07-14;LB;Lebanon;32;1;2451;37
2020-07-15;LB;Lebanon;91;1;2542;38
2020-07-16;LB;Lebanon;57;2;2599;40
2020-07-17;LB;Lebanon;101;0;2700;40
2020-07-18;LB;Lebanon;75;0;2775;40
2020-07-19;LB;Lebanon;84;0;2859;40
2020-07-20;LB;Lebanon;46;1;2905;41
2020-07-21;LB;Lebanon;75;0;2980;41
2020-07-22;LB;Lebanon;124;2;3104;43
2020-07-23;LB;Lebanon;156;0;3260;43
2020-07-24;LB;Lebanon;147;3;3407;46
2020-07-25;LB;Lebanon;175;1;3582;47
2020-07-26;LB;Lebanon;168;4;3750;51
2020-07-27;LB;Lebanon;132;0;3882;51
2020-07-28;LB;Lebanon;141;3;4023;54
2020-07-29;LB;Lebanon;182;1;4205;55
2020-07-30;LB;Lebanon;129;2;4334;57
2020-07-31;LB;Lebanon;221;4;4555;61
2020-08-01;LB;Lebanon;175;0;4730;61
2020-08-02;LB;Lebanon;155;1;4885;62
2020-08-03;LB;Lebanon;177;3;5062;65
2020-08-04;LB;Lebanon;0;0;5062;65
2020-08-05;LB;Lebanon;355;3;5417;68
2020-08-06;LB;Lebanon;255;2;5672;70
2020-08-07;LB;Lebanon;279;0;5951;70
2020-08-08;LB;Lebanon;272;8;6223;78
2020-08-09;LB;Lebanon;294;0;6517;78
2020-08-10;LB;Lebanon;295;2;6812;80
2020-08-11;LB;Lebanon;309;7;7121;87
2020-08-12;LB;Lebanon;292;2;7413;89
2020-08-13;LB;Lebanon;298;3;7711;92
2020-08-14;LB;Lebanon;334;2;8045;94
2020-08-15;LB;Lebanon;397;3;8442;97
2020-08-16;LB;Lebanon;439;6;8881;103
2020-08-17;LB;Lebanon;456;2;9337;105
2020-08-18;LB;Lebanon;421;2;9758;107
2020-08-19;LB;Lebanon;589;2;10347;109
2020-08-20;LB;Lebanon;605;4;10952;113
2020-08-21;LB;Lebanon;628;3;11580;116
2020-08-22;LB;Lebanon;611;5;12191;121
2020-08-23;LB;Lebanon;507;2;12698;123
2020-08-24;LB;Lebanon;457;3;13155;126
2020-08-25;LB;Lebanon;532;12;13687;138
2020-08-26;LB;Lebanon;561;1;14248;139
2020-08-27;LB;Lebanon;689;7;14937;146
2020-08-28;LB;Lebanon;676;2;15613;148
2020-08-29;LB;Lebanon;662;7;16275;155
2020-08-30;LB;Lebanon;595;5;16870;160
2020-08-31;LB;Lebanon;438;7;17308;167
2020-09-01;LB;Lebanon;469;4;17777;171
2020-09-02;LB;Lebanon;598;6;18375;177
2020-09-03;LB;Lebanon;588;2;18963;179
2020-09-04;LB;Lebanon;527;4;19490;183
2020-09-05;LB;Lebanon;521;4;20011;187
2020-09-06;LB;Lebanon;415;4;20426;191
2020-09-07;LB;Lebanon;400;9;20826;200
2020-09-08;LB;Lebanon;498;7;21324;207
2020-09-09;LB;Lebanon;553;5;21877;212
2020-09-10;LB;Lebanon;560;7;22437;219
2020-09-11;LB;Lebanon;546;10;22983;229
2020-09-12;LB;Lebanon;686;10;23669;239
2020-09-13;LB;Lebanon;641;2;24310;241
2020-09-14;LB;Lebanon;1091;5;25401;246
2020-09-15;LB;Lebanon;48;6;25449;252
2020-09-16;LB;Lebanon;634;7;26083;259
2020-09-17;LB;Lebanon;685;4;26768;263
2020-09-18;LB;Lebanon;750;18;27518;281
2020-09-19;LB;Lebanon;779;5;28297;286
2020-09-20;LB;Lebanon;1006;11;29303;297
2020-09-21;LB;Lebanon;684;10;29987;307
2020-09-22;LB;Lebanon;865;8;30852;315
2020-09-23;LB;Lebanon;940;13;31792;328
2020-09-24;LB;Lebanon;1027;1;32819;329
2020-09-25;LB;Lebanon;1143;4;33962;333
2020-09-26;LB;Lebanon;1280;7;35242;340
2020-09-27;LB;Lebanon;1012;7;36254;347
2020-09-28;LB;Lebanon;1018;4;37272;351
2020-09-29;LB;Lebanon;1105;10;38377;361
2020-09-30;LB;Lebanon;1257;6;39634;367
2020-10-01;LB;Lebanon;1248;7;40882;374
2020-10-02;LB;Lebanon;1291;12;42173;386
2020-10-03;LB;Lebanon;1321;12;43494;398
2020-10-04;LB;Lebanon;988;8;44482;406
2020-10-05;LB;Lebanon;1175;8;45657;414
2020-10-06;LB;Lebanon;1261;10;46918;424
2020-10-07;LB;Lebanon;1459;9;48377;433
2020-10-08;LB;Lebanon;1367;6;49744;439
2020-10-09;LB;Lebanon;1426;11;51170;450
2020-10-10;LB;Lebanon;1388;5;52558;455
2020-10-11;LB;Lebanon;1010;4;53568;459
2020-10-12;LB;Lebanon;1056;7;54624;466
2020-10-13;LB;Lebanon;1245;13;55869;479
2020-10-14;LB;Lebanon;1377;20;57246;499
2020-10-15;LB;Lebanon;1499;2;58745;501
2020-10-16;LB;Lebanon;1368;8;60113;509
2020-10-17;LB;Lebanon;1171;8;61284;517
2020-10-18;LB;Lebanon;1002;3;62286;520
2020-10-19;LB;Lebanon;658;6;62944;526
2020-10-20;LB;Lebanon;1392;5;64336;531
2020-10-21;LB;Lebanon;1241;5;65577;536
2020-10-22;LB;Lebanon;1450;16;67027;552
2020-10-23;LB;Lebanon;1452;7;68479;559
2020-10-24;LB;Lebanon;1427;3;69906;562
2020-10-25;LB;Lebanon;1484;3;71390;565
2020-10-26;LB;Lebanon;796;14;72186;579
2020-10-27;LB;Lebanon;1809;11;73995;590
2020-10-28;LB;Lebanon;1850;12;75845;602
2020-10-29;LB;Lebanon;1933;8;77778;610
2020-10-30;LB;Lebanon;1751;15;79529;625
2020-10-31;LB;Lebanon;1699;12;81228;637
2020-11-01;LB;Lebanon;1389;6;82617;643
2020-11-02;LB;Lebanon;1080;9;83697;652
2020-11-03;LB;Lebanon;1512;15;85209;667
2020-11-04;LB;Lebanon;1888;9;87097;676
2020-11-05;LB;Lebanon;2089;7;89186;683
2020-11-06;LB;Lebanon;2142;17;91328;700
2020-11-07;LB;Lebanon;1769;13;93097;713
2020-11-08;LB;Lebanon;1139;10;94236;723
2020-11-09;LB;Lebanon;1119;9;95355;732
2020-11-10;LB;Lebanon;1552;17;96907;749
2020-11-11;LB;Lebanon;1922;14;98829;763
2020-11-12;LB;Lebanon;1874;12;100703;775
2020-11-13;LB;Lebanon;1904;21;102607;796
2020-11-14;LB;Lebanon;1660;10;104267;806
2020-11-15;LB;Lebanon;1163;11;105430;817
2020-11-16;LB;Lebanon;1016;10;106446;827
2020-11-17;LB;Lebanon;1507;12;107953;839
2020-11-18;LB;Lebanon;2084;13;110037;852
2020-11-19;LB;Lebanon;1909;16;111946;868
2020-11-20;LB;Lebanon;1709;16;113655;884
2020-11-21;LB;Lebanon;1628;10;115283;894
2020-11-22;LB;Lebanon;1193;6;116476;900
2020-11-23;LB;Lebanon;1041;11;117517;911
2020-11-24;LB;Lebanon;1188;23;118705;934
2020-11-25;LB;Lebanon;1636;16;120341;950
2020-11-26;LB;Lebanon;1859;24;122200;974
2020-11-27;LB;Lebanon;1782;6;123982;980
2020-11-28;LB;Lebanon;1696;11;125678;991
2020-11-29;LB;Lebanon;1266;13;126944;1004
2020-11-30;LB;Lebanon;1000;14;127944;1018
2020-12-01;LB;Lebanon;1511;15;129455;1033
2020-12-02;LB;Lebanon;1842;22;131297;1055
2020-12-03;LB;Lebanon;1520;12;132817;1067
2020-12-04;LB;Lebanon;1478;11;134295;1078
2020-12-05;LB;Lebanon;0;0;134295;1078
2020-12-06;LB;Lebanon;2817;21;137112;1099
2020-12-07;LB;Lebanon;984;16;138096;1115
2020-12-08;LB;Lebanon;1039;21;139135;1136
2020-12-09;LB;Lebanon;1274;20;140409;1156
2020-12-10;LB;Lebanon;1778;14;142187;1170
2020-12-11;LB;Lebanon;1518;12;143705;1182
2020-12-12;LB;Lebanon;1540;8;145245;1190
2020-12-13;LB;Lebanon;1275;10;146520;1200
2020-12-14;LB;Lebanon;1093;10;147613;1210
2020-12-15;LB;Lebanon;1264;13;148877;1223
2020-12-16;LB;Lebanon;2056;11;150933;1234
2020-12-17;LB;Lebanon;2116;14;153049;1248
2020-12-18;LB;Lebanon;1895;11;154944;1259
2020-12-19;LB;Lebanon;1626;11;156570;1270
2020-12-20;LB;Lebanon;1534;11;158104;1281
2020-12-21;LB;Lebanon;1182;13;159286;1294
2020-12-22;LB;Lebanon;1693;17;160979;1311
2020-12-23;LB;Lebanon;2246;22;163225;1333
2020-12-24;LB;Lebanon;2708;20;165933;1353
2020-12-25;LB;Lebanon;2136;14;168069;1367
2020-12-26;LB;Lebanon;1403;12;169472;1379
2020-12-27;LB;Lebanon;1754;15;171226;1394
2020-12-28;LB;Lebanon;1594;15;172820;1409
2020-12-29;LB;Lebanon;2298;21;175118;1430
2020-12-30;LB;Lebanon;2878;26;177996;1456
2020-12-31;LB;Lebanon;3507;12;181503;1468
2021-01-01;LB;Lebanon;2385;11;183888;1479
2021-01-02;LB;Lebanon;2520;10;186408;1489
2021-01-03;LB;Lebanon;2870;10;189278;1499
2021-01-04;LB;Lebanon;2861;13;192139;1512
2021-01-05;LB;Lebanon;3620;17;195759;1529
2021-01-06;LB;Lebanon;4166;21;199925;1550
2021-01-07;LB;Lebanon;4774;16;204699;1566
2021-01-08;LB;Lebanon;5440;4;210139;1570
2021-01-09;LB;Lebanon;5414;20;215553;1590
2021-01-10;LB;Lebanon;3743;16;219296;1606
2021-01-11;LB;Lebanon;3095;23;222391;1629
2021-01-12;LB;Lebanon;4557;76;226948;1705
2021-01-13;LB;Lebanon;4988;35;231936;1740
2021-01-14;LB;Lebanon;5196;41;237132;1781
2021-01-15;LB;Lebanon;6154;44;243286;1825
2021-01-16;LB;Lebanon;5872;41;249158;1866
2021-01-17;LB;Lebanon;3654;40;252812;1906
2021-01-18;LB;Lebanon;3144;53;255956;1959
2021-01-19;LB;Lebanon;4359;61;260315;2020
2021-01-20;LB;Lebanon;4332;64;264647;2084
2021-01-21;LB;Lebanon;4594;67;269241;2151
2021-01-22;LB;Lebanon;3220;57;272461;2208
2021-01-23;LB;Lebanon;4126;62;276587;2270
2021-01-24;LB;Lebanon;3010;50;279597;2320
2021-01-25;LB;Lebanon;2652;54;282249;2374
2021-01-26;LB;Lebanon;3505;103;285754;2477
2021-01-27;LB;Lebanon;3906;76;289660;2553
2021-01-28;LB;Lebanon;3497;68;293157;2621
2021-01-29;LB;Lebanon;3125;59;296282;2680
2021-01-30;LB;Lebanon;2631;351;298913;3031
2021-01-31;LB;Lebanon;2139;51;301052;3082
2021-02-01;LB;Lebanon;2020;63;303072;3145
2021-02-02;LB;Lebanon;2770;81;305842;3226
2021-02-03;LB;Lebanon;3320;89;309162;3315
2021-02-04;LB;Lebanon;3107;82;312269;3397
2021-02-05;LB;Lebanon;3071;98;315340;3495
2021-02-06;LB;Lebanon;2496;67;317836;3562
2021-02-07;LB;Lebanon;2081;54;319917;3616
2021-02-08;LB;Lebanon;2063;61;321980;3677
2021-02-09;LB;Lebanon;2886;60;324866;3737
2021-02-10;LB;Lebanon;3157;66;328023;3803
2021-02-11;LB;Lebanon;3136;63;331159;3866
2021-02-12;LB;Lebanon;2934;49;334093;3915
2021-02-13;LB;Lebanon;2906;46;336999;3961
2021-02-14;LB;Lebanon;2130;32;339129;3993
2021-02-15;LB;Lebanon;1739;44;340868;4037
2021-02-16;LB;Lebanon;2733;55;343601;4092
2021-02-17;LB;Lebanon;2479;60;346080;4152
2021-02-18;LB;Lebanon;2730;54;348810;4206
2021-02-19;LB;Lebanon;2255;51;351065;4257
2021-02-20;LB;Lebanon;2306;40;353371;4297
2021-02-21;LB;Lebanon;1702;43;355073;4340
2021-02-22;LB;Lebanon;1541;47;356614;4387
2021-02-23;LB;Lebanon;2723;59;359337;4446
2021-02-24;LB;Lebanon;3513;62;362850;4508
2021-02-25;LB;Lebanon;3469;52;366319;4560
2021-02-26;LB;Lebanon;3373;50;369692;4610
2021-02-27;LB;Lebanon;3100;42;372792;4652
2021-02-28;LB;Lebanon;2258;40;375050;4692
2021-03-01;LB;Lebanon;1888;51;376938;4743
2021-03-02;LB;Lebanon;3098;62;380036;4805
2021-03-03;LB;Lebanon;3463;61;383499;4866
2021-03-04;LB;Lebanon;3369;53;386868;4919
2021-03-05;LB;Lebanon;3202;52;390070;4971
2021-03-06;LB;Lebanon;3158;42;393228;5013
2021-03-07;LB;Lebanon;2376;33;395604;5046
2021-03-08;LB;Lebanon;2283;43;397887;5089
2021-03-09;LB;Lebanon;3939;45;401826;5134
2021-03-10;LB;Lebanon;3581;46;405407;5180
2021-03-11;LB;Lebanon;3502;50;408909;5230
2021-03-12;LB;Lebanon;2930;48;411839;5278
2021-03-13;LB;Lebanon;3523;56;415362;5334
2021-03-14;LB;Lebanon;3086;46;418448;5380
2021-03-15;LB;Lebanon;1505;42;419953;5422
2021-03-16;LB;Lebanon;3480;52;423433;5474
2021-03-17;LB;Lebanon;3544;62;426977;5536
2021-03-18;LB;Lebanon;3757;73;430734;5609
2021-03-19;LB;Lebanon;3588;55;434322;5664
2021-03-20;LB;Lebanon;2253;51;436575;5715
2021-03-21;LB;Lebanon;2993;42;439568;5757
2021-03-22;LB;Lebanon;1446;51;441014;5808
2021-03-23;LB;Lebanon;3851;42;444865;5850
2021-03-24;LB;Lebanon;3856;53;448721;5903
2021-03-25;LB;Lebanon;3560;61;452281;5964
2021-03-26;LB;Lebanon;3100;49;455381;6013
2021-03-27;LB;Lebanon;2957;45;458338;6058
2021-03-28;LB;Lebanon;2724;38;461062;6096
2021-03-29;LB;Lebanon;1277;40;462339;6136
2021-03-30;LB;Lebanon;2668;48;465007;6184
2021-03-31;LB;Lebanon;3393;50;468400;6234
2021-04-01;LB;Lebanon;3562;52;471962;6286
2021-04-02;LB;Lebanon;2963;60;474925;6346
2021-04-03;LB;Lebanon;2188;33;477113;6379
2021-04-04;LB;Lebanon;2388;30;479501;6409
2021-04-05;LB;Lebanon;1001;34;480502;6443
2021-04-06;LB;Lebanon;2296;36;482798;6479
2021-04-07;LB;Lebanon;3120;33;485918;6512
2021-04-08;LB;Lebanon;3510;37;489428;6549
2021-04-09;LB;Lebanon;2500;43;491928;6592
2021-04-10;LB;Lebanon;2705;38;494633;6630
2021-04-11;LB;Lebanon;2213;31;496846;6661
2021-04-12;LB;Lebanon;1008;42;497854;6703
2021-04-13;LB;Lebanon;1985;35;499839;6738
2021-04-14;LB;Lebanon;2460;40;502299;6778
2021-04-15;LB;Lebanon;2501;31;504800;6809
2021-04-16;LB;Lebanon;2008;45;506808;6854
2021-04-17;LB;Lebanon;1695;32;508503;6886
2021-04-18;LB;Lebanon;1900;39;510403;6925
2021-04-19;LB;Lebanon;995;34;511398;6959
2021-04-20;LB;Lebanon;1608;36;513006;6995
2021-04-21;LB;Lebanon;2082;32;515088;7027
2021-04-22;LB;Lebanon;1512;30;516600;7057
2021-04-23;LB;Lebanon;1504;33;518104;7090
2021-04-24;LB;Lebanon;1511;28;519615;7118
2021-04-25;LB;Lebanon;1324;24;520939;7142
2021-04-26;LB;Lebanon;642;29;521581;7171
2021-04-27;LB;Lebanon;1182;26;522763;7197
2021-04-28;LB;Lebanon;1478;27;524241;7224
2021-04-29;LB;Lebanon;1336;25;525577;7249
2021-04-30;LB;Lebanon;1001;29;526578;7278
2021-05-01;LB;Lebanon;930;24;527508;7302
2021-05-02;LB;Lebanon;700;22;528208;7324
2021-05-03;LB;Lebanon;249;21;528457;7345
2021-05-04;LB;Lebanon;748;23;529205;7368
2021-05-05;LB;Lebanon;1012;22;530217;7390
2021-05-06;LB;Lebanon;1017;25;531234;7415
2021-05-07;LB;Lebanon;600;21;531834;7436
2021-05-08;LB;Lebanon;435;24;532269;7460
2021-05-09;LB;Lebanon;570;26;532839;7486
2021-05-10;LB;Lebanon;302;21;533141;7507
2021-05-11;LB;Lebanon;544;20;533685;7527
2021-05-12;LB;Lebanon;703;22;534388;7549
2021-05-13;LB;Lebanon;580;20;534968;7569
2021-05-14;LB;Lebanon;0;0;534968;7569
2021-05-15;LB;Lebanon;478;33;535446;7602
2021-05-16;LB;Lebanon;307;18;535753;7620
2021-05-17;LB;Lebanon;201;11;535954;7631
2021-05-18;LB;Lebanon;600;10;536554;7641
2021-05-19;LB;Lebanon;489;10;537043;7651
2021-05-20;LB;Lebanon;394;7;537437;7658
2021-05-21;LB;Lebanon;450;6;537887;7664
2021-05-22;LB;Lebanon;331;6;538218;7670
2021-05-23;LB;Lebanon;300;7;538518;7677
2021-05-24;LB;Lebanon;150;7;538668;7684
2021-05-25;LB;Lebanon;323;6;538991;7690
2021-05-26;LB;Lebanon;280;7;539271;7697
2021-05-27;LB;Lebanon;319;8;539590;7705
2021-05-28;LB;Lebanon;298;6;539888;7711
2021-05-29;LB;Lebanon;244;7;540132;7718
2021-05-30;LB;Lebanon;145;5;540277;7723
2021-05-31;LB;Lebanon;111;6;540388;7729
2021-06-01;LB;Lebanon;242;6;540630;7735
2021-06-02;LB;Lebanon;214;5;540844;7740
2021-06-03;LB;Lebanon;165;7;541009;7747
2021-06-04;LB;Lebanon;223;5;541232;7752
2021-06-05;LB;Lebanon;191;6;541423;7758
2021-06-06;LB;Lebanon;134;5;541557;7763
2021-06-07;LB;Lebanon;71;6;541628;7769
2021-06-08;LB;Lebanon;173;5;541801;7774
2021-06-09;LB;Lebanon;139;6;541940;7780
2021-06-10;LB;Lebanon;0;0;541940;7780
2021-06-11;LB;Lebanon;435;10;542375;7790
2021-06-12;LB;Lebanon;0;0;542375;7790
2021-06-13;LB;Lebanon;0;0;542375;7790
2021-06-14;LB;Lebanon;274;11;542649;7801
2021-06-15;LB;Lebanon;170;3;542819;7804
2021-06-16;LB;Lebanon;115;4;542934;7808
2021-06-17;LB;Lebanon;165;3;543099;7811
2021-06-18;LB;Lebanon;168;4;543267;7815
2021-06-19;LB;Lebanon;104;4;543371;7819
2021-06-20;LB;Lebanon;134;3;543505;7822
2021-06-21;LB;Lebanon;46;3;543551;7825
2021-06-22;LB;Lebanon;147;4;543698;7829
2021-06-23;LB;Lebanon;167;3;543865;7832
2021-06-24;LB;Lebanon;137;3;544002;7835
2021-06-25;LB;Lebanon;163;4;544165;7839
2021-06-26;LB;Lebanon;126;2;544291;7841
2021-06-27;LB;Lebanon;163;2;544454;7843
2021-06-28;LB;Lebanon;66;2;544520;7845
2021-06-29;LB;Lebanon;185;3;544705;7848
2021-06-30;LB;Lebanon;161;3;544866;7851
2021-07-01;LB;Lebanon;150;3;545016;7854
2020-05-13;LS;Lesotho;1;0;1;0
2020-05-14;LS;Lesotho;0;0;1;0
2020-05-15;LS;Lesotho;0;0;1;0
2020-05-16;LS;Lesotho;0;0;1;0
2020-05-17;LS;Lesotho;0;0;1;0
2020-05-18;LS;Lesotho;0;0;1;0
2020-05-19;LS;Lesotho;0;0;1;0
2020-05-20;LS;Lesotho;0;0;1;0
2020-05-21;LS;Lesotho;0;0;1;0
2020-05-22;LS;Lesotho;1;0;2;0
2020-05-23;LS;Lesotho;0;0;2;0
2020-05-24;LS;Lesotho;0;0;2;0
2020-05-25;LS;Lesotho;0;0;2;0
2020-05-26;LS;Lesotho;0;0;2;0
2020-05-27;LS;Lesotho;0;0;2;0
2020-05-28;LS;Lesotho;0;0;2;0
2020-05-29;LS;Lesotho;0;0;2;0
2020-05-30;LS;Lesotho;0;0;2;0
2020-05-31;LS;Lesotho;0;0;2;0
2020-06-01;LS;Lesotho;0;0;2;0
2020-06-02;LS;Lesotho;0;0;2;0
2020-06-03;LS;Lesotho;2;0;4;0
2020-06-04;LS;Lesotho;0;0;4;0
2020-06-05;LS;Lesotho;0;0;4;0
2020-06-06;LS;Lesotho;0;0;4;0
2020-06-07;LS;Lesotho;0;0;4;0
2020-06-08;LS;Lesotho;0;0;4;0
2020-06-09;LS;Lesotho;0;0;4;0
2020-06-10;LS;Lesotho;0;0;4;0
2020-06-11;LS;Lesotho;0;0;4;0
2020-06-12;LS;Lesotho;0;0;4;0
2020-06-13;LS;Lesotho;0;0;4;0
2020-06-14;LS;Lesotho;0;0;4;0
2020-06-15;LS;Lesotho;0;0;4;0
2020-06-16;LS;Lesotho;0;0;4;0
2020-06-17;LS;Lesotho;0;0;4;0
2020-06-18;LS;Lesotho;0;0;4;0
2020-06-19;LS;Lesotho;0;0;4;0
2020-06-20;LS;Lesotho;0;0;4;0
2020-06-21;LS;Lesotho;0;0;4;0
2020-06-22;LS;Lesotho;8;0;12;0
2020-06-23;LS;Lesotho;5;0;17;0
2020-06-24;LS;Lesotho;0;0;17;0
2020-06-25;LS;Lesotho;0;0;17;0
2020-06-26;LS;Lesotho;7;0;24;0
2020-06-27;LS;Lesotho;0;0;24;0
2020-06-28;LS;Lesotho;3;0;27;0
2020-06-29;LS;Lesotho;0;0;27;0
2020-06-30;LS;Lesotho;0;0;27;0
2020-07-01;LS;Lesotho;8;0;35;0
2020-07-02;LS;Lesotho;0;0;35;0
2020-07-03;LS;Lesotho;0;0;35;0
2020-07-04;LS;Lesotho;0;0;35;0
2020-07-05;LS;Lesotho;44;0;79;0
2020-07-06;LS;Lesotho;12;0;91;0
2020-07-07;LS;Lesotho;0;0;91;0
2020-07-08;LS;Lesotho;0;0;91;0
2020-07-09;LS;Lesotho;43;1;134;1
2020-07-10;LS;Lesotho;50;0;184;1
2020-07-11;LS;Lesotho;0;0;184;1
2020-07-12;LS;Lesotho;49;1;233;2
2020-07-13;LS;Lesotho;12;1;245;3
2020-07-14;LS;Lesotho;11;0;256;3
2020-07-15;LS;Lesotho;0;0;256;3
2020-07-16;LS;Lesotho;0;0;256;3
2020-07-17;LS;Lesotho;55;3;311;6
2020-07-18;LS;Lesotho;48;0;359;6
2020-07-19;LS;Lesotho;0;0;359;6
2020-07-20;LS;Lesotho;0;0;359;6
2020-07-21;LS;Lesotho;0;0;359;6
2020-07-22;LS;Lesotho;0;0;359;6
2020-07-23;LS;Lesotho;0;0;359;6
2020-07-24;LS;Lesotho;0;0;359;6
2020-07-25;LS;Lesotho;60;3;419;9
2020-07-26;LS;Lesotho;86;3;505;12
2020-07-27;LS;Lesotho;0;0;505;12
2020-07-28;LS;Lesotho;0;0;505;12
2020-07-29;LS;Lesotho;71;1;576;13
2020-07-30;LS;Lesotho;28;0;604;13
2020-07-31;LS;Lesotho;0;0;604;13
2020-08-01;LS;Lesotho;98;1;702;14
2020-08-02;LS;Lesotho;16;5;718;19
2020-08-03;LS;Lesotho;0;0;718;19
2020-08-04;LS;Lesotho;8;2;726;21
2020-08-05;LS;Lesotho;0;0;726;21
2020-08-06;LS;Lesotho;16;2;742;23
2020-08-07;LS;Lesotho;0;0;742;23
2020-08-08;LS;Lesotho;0;0;742;23
2020-08-09;LS;Lesotho;0;0;742;23
2020-08-10;LS;Lesotho;39;1;781;24
2020-08-11;LS;Lesotho;0;0;781;24
2020-08-12;LS;Lesotho;17;0;798;24
2020-08-13;LS;Lesotho;86;1;884;25
2020-08-14;LS;Lesotho;0;0;884;25
2020-08-15;LS;Lesotho;19;0;903;25
2020-08-16;LS;Lesotho;0;0;903;25
2020-08-17;LS;Lesotho;43;5;946;30
2020-08-18;LS;Lesotho;0;0;946;30
2020-08-19;LS;Lesotho;0;0;946;30
2020-08-20;LS;Lesotho;50;0;996;30
2020-08-21;LS;Lesotho;19;0;1015;30
2020-08-22;LS;Lesotho;0;0;1015;30
2020-08-23;LS;Lesotho;0;0;1015;30
2020-08-24;LS;Lesotho;0;0;1015;30
2020-08-25;LS;Lesotho;34;0;1049;30
2020-08-26;LS;Lesotho;2;1;1051;31
2020-08-27;LS;Lesotho;0;0;1051;31
2020-08-28;LS;Lesotho;0;0;1051;31
2020-08-29;LS;Lesotho;0;0;1051;31
2020-08-30;LS;Lesotho;34;0;1085;31
2020-08-31;LS;Lesotho;0;0;1085;31
2020-09-01;LS;Lesotho;0;0;1085;31
2020-09-02;LS;Lesotho;0;0;1085;31
2020-09-03;LS;Lesotho;0;0;1085;31
2020-09-04;LS;Lesotho;63;0;1148;31
2020-09-05;LS;Lesotho;0;0;1148;31
2020-09-06;LS;Lesotho;0;0;1148;31
2020-09-07;LS;Lesotho;0;0;1148;31
2020-09-08;LS;Lesotho;0;0;1148;31
2020-09-09;LS;Lesotho;16;0;1164;31
2020-09-10;LS;Lesotho;0;0;1164;31
2020-09-11;LS;Lesotho;81;2;1245;33
2020-09-12;LS;Lesotho;0;0;1245;33
2020-09-13;LS;Lesotho;0;0;1245;33
2020-09-14;LS;Lesotho;0;0;1245;33
2020-09-15;LS;Lesotho;82;0;1327;33
2020-09-16;LS;Lesotho;0;0;1327;33
2020-09-17;LS;Lesotho;0;0;1327;33
2020-09-18;LS;Lesotho;63;0;1390;33
2020-09-19;LS;Lesotho;0;0;1390;33
2020-09-20;LS;Lesotho;34;0;1424;33
2020-09-21;LS;Lesotho;0;0;1424;33
2020-09-22;LS;Lesotho;0;0;1424;33
2020-09-23;LS;Lesotho;83;2;1507;35
2020-09-24;LS;Lesotho;47;0;1554;35
2020-09-25;LS;Lesotho;4;0;1558;35
2020-09-26;LS;Lesotho;0;0;1558;35
2020-09-27;LS;Lesotho;0;0;1558;35
2020-09-28;LS;Lesotho;7;0;1565;35
2020-09-29;LS;Lesotho;11;0;1576;35
2020-09-30;LS;Lesotho;19;1;1595;36
2020-10-01;LS;Lesotho;44;2;1639;38
2020-10-02;LS;Lesotho;41;1;1680;39
2020-10-03;LS;Lesotho;0;0;1680;39
2020-10-04;LS;Lesotho;3;0;1683;39
2020-10-05;LS;Lesotho;0;0;1683;39
2020-10-06;LS;Lesotho;0;0;1683;39
2020-10-07;LS;Lesotho;84;1;1767;40
2020-10-08;LS;Lesotho;19;1;1786;41
2020-10-09;LS;Lesotho;14;1;1800;42
2020-10-10;LS;Lesotho;0;0;1800;42
2020-10-11;LS;Lesotho;5;0;1805;42
2020-10-12;LS;Lesotho;0;0;1805;42
2020-10-13;LS;Lesotho;17;0;1822;42
2020-10-14;LS;Lesotho;11;0;1833;42
2020-10-15;LS;Lesotho;0;0;1833;42
2020-10-16;LS;Lesotho;0;0;1833;42
2020-10-17;LS;Lesotho;0;0;1833;42
2020-10-18;LS;Lesotho;0;0;1833;42
2020-10-19;LS;Lesotho;0;0;1833;42
2020-10-20;LS;Lesotho;85;1;1918;43
2020-10-21;LS;Lesotho;0;0;1918;43
2020-10-22;LS;Lesotho;5;0;1923;43
2020-10-23;LS;Lesotho;11;0;1934;43
2020-10-24;LS;Lesotho;6;0;1940;43
2020-10-25;LS;Lesotho;0;0;1940;43
2020-10-26;LS;Lesotho;3;0;1943;43
2020-10-27;LS;Lesotho;4;0;1947;43
2020-10-28;LS;Lesotho;0;0;1947;43
2020-10-29;LS;Lesotho;0;0;1947;43
2020-10-30;LS;Lesotho;6;1;1953;44
2020-10-31;LS;Lesotho;0;0;1953;44
2020-11-01;LS;Lesotho;0;0;1953;44
2020-11-02;LS;Lesotho;8;0;1961;44
2020-11-03;LS;Lesotho;0;0;1961;44
2020-11-04;LS;Lesotho;2;0;1963;44
2020-11-05;LS;Lesotho;0;0;1963;44
2020-11-06;LS;Lesotho;4;0;1967;44
2020-11-07;LS;Lesotho;0;0;1967;44
2020-11-08;LS;Lesotho;0;0;1967;44
2020-11-09;LS;Lesotho;0;0;1967;44
2020-11-10;LS;Lesotho;59;0;2026;44
2020-11-11;LS;Lesotho;0;0;2026;44
2020-11-12;LS;Lesotho;0;0;2026;44
2020-11-13;LS;Lesotho;15;0;2041;44
2020-11-14;LS;Lesotho;0;0;2041;44
2020-11-15;LS;Lesotho;0;0;2041;44
2020-11-16;LS;Lesotho;0;0;2041;44
2020-11-17;LS;Lesotho;11;0;2052;44
2020-11-18;LS;Lesotho;6;0;2058;44
2020-11-19;LS;Lesotho;7;0;2065;44
2020-11-20;LS;Lesotho;1;0;2066;44
2020-11-21;LS;Lesotho;19;0;2085;44
2020-11-22;LS;Lesotho;1;0;2086;44
2020-11-23;LS;Lesotho;0;0;2086;44
2020-11-24;LS;Lesotho;6;0;2092;44
2020-11-25;LS;Lesotho;0;0;2092;44
2020-11-26;LS;Lesotho;17;0;2109;44
2020-11-27;LS;Lesotho;0;0;2109;44
2020-11-28;LS;Lesotho;0;0;2109;44
2020-11-29;LS;Lesotho;0;0;2109;44
2020-11-30;LS;Lesotho;0;0;2109;44
2020-12-01;LS;Lesotho;28;0;2137;44
2020-12-02;LS;Lesotho;5;0;2142;44
2020-12-03;LS;Lesotho;3;0;2145;44
2020-12-04;LS;Lesotho;5;0;2150;44
2020-12-05;LS;Lesotho;0;0;2150;44
2020-12-06;LS;Lesotho;0;0;2150;44
2020-12-07;LS;Lesotho;0;0;2150;44
2020-12-08;LS;Lesotho;0;0;2150;44
2020-12-09;LS;Lesotho;14;0;2164;44
2020-12-10;LS;Lesotho;14;0;2178;44
2020-12-11;LS;Lesotho;36;0;2214;44
2020-12-12;LS;Lesotho;36;0;2250;44
2020-12-13;LS;Lesotho;0;0;2250;44
2020-12-14;LS;Lesotho;27;0;2277;44
2020-12-15;LS;Lesotho;30;0;2307;44
2020-12-16;LS;Lesotho;58;2;2365;46
2020-12-17;LS;Lesotho;35;0;2400;46
2020-12-18;LS;Lesotho;146;2;2546;48
2020-12-19;LS;Lesotho;0;0;2546;48
2020-12-20;LS;Lesotho;0;0;2546;48
2020-12-21;LS;Lesotho;0;0;2546;48
2020-12-22;LS;Lesotho;0;0;2546;48
2020-12-23;LS;Lesotho;179;3;2725;51
2020-12-24;LS;Lesotho;0;0;2725;51
2020-12-25;LS;Lesotho;0;0;2725;51
2020-12-26;LS;Lesotho;0;0;2725;51
2020-12-27;LS;Lesotho;0;0;2725;51
2020-12-28;LS;Lesotho;231;0;2956;51
2020-12-29;LS;Lesotho;49;0;3005;51
2020-12-30;LS;Lesotho;89;0;3094;51
2020-12-31;LS;Lesotho;0;0;3094;51
2021-01-01;LS;Lesotho;112;0;3206;51
2021-01-02;LS;Lesotho;0;14;3206;65
2021-01-03;LS;Lesotho;0;0;3206;65
2021-01-04;LS;Lesotho;0;0;3206;65
2021-01-05;LS;Lesotho;0;0;3206;65
2021-01-06;LS;Lesotho;931;8;4137;73
2021-01-07;LS;Lesotho;214;3;4351;76
2021-01-08;LS;Lesotho;819;3;5170;79
2021-01-09;LS;Lesotho;33;5;5203;84
2021-01-10;LS;Lesotho;734;1;5937;85
2021-01-11;LS;Lesotho;0;0;5937;85
2021-01-12;LS;Lesotho;0;0;5937;85
2021-01-13;LS;Lesotho;304;2;6241;87
2021-01-14;LS;Lesotho;115;2;6356;89
2021-01-15;LS;Lesotho;15;4;6371;93
2021-01-16;LS;Lesotho;0;0;6371;93
2021-01-17;LS;Lesotho;0;0;6371;93
2021-01-18;LS;Lesotho;647;8;7018;101
2021-01-19;LS;Lesotho;0;0;7018;101
2021-01-20;LS;Lesotho;17;1;7035;102
2021-01-21;LS;Lesotho;469;1;7504;103
2021-01-22;LS;Lesotho;51;10;7555;113
2021-01-23;LS;Lesotho;101;10;7656;123
2021-01-24;LS;Lesotho;0;0;7656;123
2021-01-25;LS;Lesotho;388;11;8044;134
2021-01-26;LS;Lesotho;3;12;8047;146
2021-01-27;LS;Lesotho;0;0;8047;146
2021-01-28;LS;Lesotho;231;14;8278;160
2021-01-29;LS;Lesotho;332;3;8610;163
2021-01-30;LS;Lesotho;39;1;8649;164
2021-01-31;LS;Lesotho;15;8;8664;172
2021-02-01;LS;Lesotho;236;0;8900;172
2021-02-02;LS;Lesotho;0;0;8900;172
2021-02-03;LS;Lesotho;69;6;8969;178
2021-02-04;LS;Lesotho;0;0;8969;178
2021-02-05;LS;Lesotho;247;2;9216;180
2021-02-06;LS;Lesotho;164;3;9380;183
2021-02-07;LS;Lesotho;0;0;9380;183
2021-02-08;LS;Lesotho;0;0;9380;183
2021-02-09;LS;Lesotho;338;24;9718;207
2021-02-10;LS;Lesotho;86;3;9804;210
2021-02-11;LS;Lesotho;15;2;9819;212
2021-02-12;LS;Lesotho;33;13;9852;225
2021-02-13;LS;Lesotho;0;0;9852;225
2021-02-14;LS;Lesotho;113;5;9965;230
2021-02-15;LS;Lesotho;289;13;10254;243
2021-02-16;LS;Lesotho;96;11;10350;254
2021-02-17;LS;Lesotho;25;25;10375;279
2021-02-18;LS;Lesotho;80;6;10455;285
2021-02-19;LS;Lesotho;0;0;10455;285
2021-02-20;LS;Lesotho;6;0;10461;285
2021-02-21;LS;Lesotho;0;0;10461;285
2021-02-22;LS;Lesotho;5;3;10466;288
2021-02-23;LS;Lesotho;1;3;10467;291
2021-02-24;LS;Lesotho;0;0;10467;291
2021-02-25;LS;Lesotho;1;1;10468;292
2021-02-26;LS;Lesotho;23;0;10491;292
2021-02-27;LS;Lesotho;0;0;10491;292
2021-02-28;LS;Lesotho;0;0;10491;292
2021-03-01;LS;Lesotho;4;3;10495;295
2021-03-02;LS;Lesotho;2;0;10497;295
2021-03-03;LS;Lesotho;24;10;10521;305
2021-03-04;LS;Lesotho;1;2;10522;307
2021-03-05;LS;Lesotho;1;0;10523;307
2021-03-06;LS;Lesotho;0;0;10523;307
2021-03-07;LS;Lesotho;0;0;10523;307
2021-03-08;LS;Lesotho;0;1;10523;308
2021-03-09;LS;Lesotho;2;1;10525;309
2021-03-10;LS;Lesotho;0;0;10525;309
2021-03-11;LS;Lesotho;3;0;10528;309
2021-03-12;LS;Lesotho;0;0;10528;309
2021-03-13;LS;Lesotho;2;0;10530;309
2021-03-14;LS;Lesotho;0;0;10530;309
2021-03-15;LS;Lesotho;0;0;10530;309
2021-03-16;LS;Lesotho;0;0;10530;309
2021-03-17;LS;Lesotho;0;0;10530;309
2021-03-18;LS;Lesotho;0;0;10530;309
2021-03-19;LS;Lesotho;5;0;10535;309
2021-03-20;LS;Lesotho;0;0;10535;309
2021-03-21;LS;Lesotho;0;0;10535;309
2021-03-22;LS;Lesotho;3;0;10538;309
2021-03-23;LS;Lesotho;147;5;10685;314
2021-03-24;LS;Lesotho;1;1;10686;315
2021-03-25;LS;Lesotho;0;0;10686;315
2021-03-26;LS;Lesotho;0;0;10686;315
2021-03-27;LS;Lesotho;0;0;10686;315
2021-03-28;LS;Lesotho;0;0;10686;315
2021-03-29;LS;Lesotho;0;0;10686;315
2021-03-30;LS;Lesotho;0;0;10686;315
2021-03-31;LS;Lesotho;20;0;10706;315
2021-04-01;LS;Lesotho;0;0;10706;315
2021-04-02;LS;Lesotho;0;0;10706;315
2021-04-03;LS;Lesotho;1;0;10707;315
2021-04-04;LS;Lesotho;0;0;10707;315
2021-04-05;LS;Lesotho;0;0;10707;315
2021-04-06;LS;Lesotho;0;0;10707;315
2021-04-07;LS;Lesotho;0;0;10707;315
2021-04-08;LS;Lesotho;0;0;10707;315
2021-04-09;LS;Lesotho;0;0;10707;315
2021-04-10;LS;Lesotho;0;0;10707;315
2021-04-11;LS;Lesotho;0;0;10707;315
2021-04-12;LS;Lesotho;2;0;10709;315
2021-04-13;LS;Lesotho;0;0;10709;315
2021-04-14;LS;Lesotho;0;0;10709;315
2021-04-15;LS;Lesotho;0;0;10709;315
2021-04-16;LS;Lesotho;0;0;10709;315
2021-04-17;LS;Lesotho;0;0;10709;315
2021-04-18;LS;Lesotho;0;0;10709;315
2021-04-19;LS;Lesotho;11;1;10720;316
2021-04-20;LS;Lesotho;0;0;10720;316
2021-04-21;LS;Lesotho;0;0;10720;316
2021-04-22;LS;Lesotho;3;0;10723;316
2021-04-23;LS;Lesotho;0;0;10723;316
2021-04-24;LS;Lesotho;0;0;10723;316
2021-04-25;LS;Lesotho;5;0;10728;316
2021-04-26;LS;Lesotho;0;0;10728;316
2021-04-27;LS;Lesotho;0;0;10728;316
2021-04-28;LS;Lesotho;2;0;10730;316
2021-04-29;LS;Lesotho;1;0;10731;316
2021-04-30;LS;Lesotho;0;0;10731;316
2021-05-01;LS;Lesotho;0;0;10731;316
2021-05-02;LS;Lesotho;2;2;10733;318
2021-05-03;LS;Lesotho;0;0;10733;318
2021-05-04;LS;Lesotho;0;0;10733;318
2021-05-05;LS;Lesotho;16;1;10749;319
2021-05-06;LS;Lesotho;0;0;10749;319
2021-05-07;LS;Lesotho;12;0;10761;319
2021-05-08;LS;Lesotho;0;0;10761;319
2021-05-09;LS;Lesotho;12;0;10773;319
2021-05-10;LS;Lesotho;0;0;10773;319
2021-05-11;LS;Lesotho;0;0;10773;319
2021-05-12;LS;Lesotho;1;0;10774;319
2021-05-13;LS;Lesotho;4;1;10778;320
2021-05-14;LS;Lesotho;0;0;10778;320
2021-05-15;LS;Lesotho;4;0;10782;320
2021-05-16;LS;Lesotho;8;0;10790;320
2021-05-17;LS;Lesotho;0;0;10790;320
2021-05-18;LS;Lesotho;0;0;10790;320
2021-05-19;LS;Lesotho;16;0;10806;320
2021-05-20;LS;Lesotho;0;0;10806;320
2021-05-21;LS;Lesotho;0;0;10806;320
2021-05-22;LS;Lesotho;9;6;10815;326
2021-05-23;LS;Lesotho;7;0;10822;326
2021-05-24;LS;Lesotho;0;0;10822;326
2021-05-25;LS;Lesotho;0;0;10822;326
2021-05-26;LS;Lesotho;0;0;10822;326
2021-05-27;LS;Lesotho;2;0;10824;326
2021-05-28;LS;Lesotho;1;0;10825;326
2021-05-29;LS;Lesotho;0;0;10825;326
2021-05-30;LS;Lesotho;6;0;10831;326
2021-05-31;LS;Lesotho;0;0;10831;326
2021-06-01;LS;Lesotho;0;0;10831;326
2021-06-02;LS;Lesotho;0;0;10831;326
2021-06-03;LS;Lesotho;5;0;10836;326
2021-06-04;LS;Lesotho;1;0;10837;326
2021-06-05;LS;Lesotho;0;0;10837;326
2021-06-06;LS;Lesotho;0;0;10837;326
2021-06-07;LS;Lesotho;0;0;10837;326
2021-06-08;LS;Lesotho;2;0;10839;326
2021-06-09;LS;Lesotho;0;0;10839;326
2021-06-10;LS;Lesotho;7;0;10846;326
2021-06-11;LS;Lesotho;7;0;10853;326
2021-06-12;LS;Lesotho;6;0;10859;326
2021-06-13;LS;Lesotho;62;0;10921;326
2021-06-14;LS;Lesotho;2;0;10923;326
2021-06-15;LS;Lesotho;0;0;10923;326
2021-06-16;LS;Lesotho;27;0;10950;326
2021-06-17;LS;Lesotho;0;0;10950;326
2021-06-18;LS;Lesotho;60;1;11010;327
2021-06-19;LS;Lesotho;71;2;11081;329
2021-06-20;LS;Lesotho;0;0;11081;329
2021-06-21;LS;Lesotho;26;0;11107;329
2021-06-22;LS;Lesotho;21;0;11128;329
2021-06-23;LS;Lesotho;40;0;11168;329
2021-06-24;LS;Lesotho;0;0;11168;329
2021-06-25;LS;Lesotho;0;0;11168;329
2021-06-26;LS;Lesotho;71;0;11239;329
2021-06-27;LS;Lesotho;0;0;11239;329
2021-06-28;LS;Lesotho;0;0;11239;329
2021-06-29;LS;Lesotho;105;0;11344;329
2021-06-30;LS;Lesotho;0;0;11344;329
2021-07-01;LS;Lesotho;72;0;11416;329
2020-03-16;LR;Liberia;1;0;1;0
2020-03-17;LR;Liberia;0;0;1;0
2020-03-18;LR;Liberia;1;0;2;0
2020-03-19;LR;Liberia;0;0;2;0
2020-03-20;LR;Liberia;0;0;2;0
2020-03-21;LR;Liberia;1;0;3;0
2020-03-22;LR;Liberia;0;0;3;0
2020-03-23;LR;Liberia;0;0;3;0
2020-03-24;LR;Liberia;0;0;3;0
2020-03-25;LR;Liberia;0;0;3;0
2020-03-26;LR;Liberia;0;0;3;0
2020-03-27;LR;Liberia;0;0;3;0
2020-03-28;LR;Liberia;0;0;3;0
2020-03-29;LR;Liberia;0;0;3;0
2020-03-30;LR;Liberia;0;0;3;0
2020-03-31;LR;Liberia;0;0;3;0
2020-04-01;LR;Liberia;3;0;6;0
2020-04-02;LR;Liberia;0;0;6;0
2020-04-03;LR;Liberia;1;0;7;0
2020-04-04;LR;Liberia;3;1;10;1
2020-04-05;LR;Liberia;3;2;13;3
2020-04-06;LR;Liberia;1;0;14;3
2020-04-07;LR;Liberia;0;0;14;3
2020-04-08;LR;Liberia;17;1;31;4
2020-04-09;LR;Liberia;0;0;31;4
2020-04-10;LR;Liberia;6;1;37;5
2020-04-11;LR;Liberia;11;0;48;5
2020-04-12;LR;Liberia;2;0;50;5
2020-04-13;LR;Liberia;9;1;59;6
2020-04-14;LR;Liberia;0;0;59;6
2020-04-15;LR;Liberia;0;0;59;6
2020-04-16;LR;Liberia;0;0;59;6
2020-04-17;LR;Liberia;17;1;76;7
2020-04-18;LR;Liberia;0;0;76;7
2020-04-19;LR;Liberia;15;1;91;8
2020-04-20;LR;Liberia;8;0;99;8
2020-04-21;LR;Liberia;2;0;101;8
2020-04-22;LR;Liberia;0;0;101;8
2020-04-23;LR;Liberia;0;0;101;8
2020-04-24;LR;Liberia;16;0;117;8
2020-04-25;LR;Liberia;3;3;120;11
2020-04-26;LR;Liberia;4;1;124;12
2020-04-27;LR;Liberia;0;0;124;12
2020-04-28;LR;Liberia;17;4;141;16
2020-04-29;LR;Liberia;0;0;141;16
2020-04-30;LR;Liberia;0;0;141;16
2020-05-01;LR;Liberia;11;2;152;18
2020-05-02;LR;Liberia;2;0;154;18
2020-05-03;LR;Liberia;4;0;158;18
2020-05-04;LR;Liberia;8;0;166;18
2020-05-05;LR;Liberia;4;2;170;20
2020-05-06;LR;Liberia;8;0;178;20
2020-05-07;LR;Liberia;11;0;189;20
2020-05-08;LR;Liberia;10;0;199;20
2020-05-09;LR;Liberia;0;0;199;20
2020-05-10;LR;Liberia;0;0;199;20
2020-05-11;LR;Liberia;12;0;211;20
2020-05-12;LR;Liberia;0;0;211;20
2020-05-13;LR;Liberia;2;0;213;20
2020-05-14;LR;Liberia;2;0;215;20
2020-05-15;LR;Liberia;4;0;219;20
2020-05-16;LR;Liberia;4;0;223;20
2020-05-17;LR;Liberia;3;1;226;21
2020-05-18;LR;Liberia;3;1;229;22
2020-05-19;LR;Liberia;4;1;233;23
2020-05-20;LR;Liberia;5;0;238;23
2020-05-21;LR;Liberia;2;0;240;23
2020-05-22;LR;Liberia;9;1;249;24
2020-05-23;LR;Liberia;6;2;255;26
2020-05-24;LR;Liberia;10;0;265;26
2020-05-25;LR;Liberia;0;0;265;26
2020-05-26;LR;Liberia;1;0;266;26
2020-05-27;LR;Liberia;0;1;266;27
2020-05-28;LR;Liberia;3;0;269;27
2020-05-29;LR;Liberia;4;0;273;27
2020-05-30;LR;Liberia;7;0;280;27
2020-05-31;LR;Liberia;8;0;288;27
2020-06-01;LR;Liberia;8;0;296;27
2020-06-02;LR;Liberia;15;1;311;28
2020-06-03;LR;Liberia;5;0;316;28
2020-06-04;LR;Liberia;5;0;321;28
2020-06-05;LR;Liberia;13;2;334;30
2020-06-06;LR;Liberia;11;0;345;30
2020-06-07;LR;Liberia;14;0;359;30
2020-06-08;LR;Liberia;11;0;370;30
2020-06-09;LR;Liberia;13;1;383;31
2020-06-10;LR;Liberia;14;0;397;31
2020-06-11;LR;Liberia;13;0;410;31
2020-06-12;LR;Liberia;11;1;421;32
2020-06-13;LR;Liberia;25;0;446;32
2020-06-14;LR;Liberia;12;0;458;32
2020-06-15;LR;Liberia;40;1;498;33
2020-06-16;LR;Liberia;11;0;509;33
2020-06-17;LR;Liberia;7;0;516;33
2020-06-18;LR;Liberia;26;0;542;33
2020-06-19;LR;Liberia;39;0;581;33
2020-06-20;LR;Liberia;20;0;601;33
2020-06-21;LR;Liberia;25;1;626;34
2020-06-22;LR;Liberia;24;0;650;34
2020-06-23;LR;Liberia;2;0;652;34
2020-06-24;LR;Liberia;10;0;662;34
2020-06-25;LR;Liberia;19;0;681;34
2020-06-26;LR;Liberia;3;0;684;34
2020-06-27;LR;Liberia;45;0;729;34
2020-06-28;LR;Liberia;39;0;768;34
2020-06-29;LR;Liberia;2;2;770;36
2020-06-30;LR;Liberia;10;0;780;36
2020-07-01;LR;Liberia;24;1;804;37
2020-07-02;LR;Liberia;15;0;819;37
2020-07-03;LR;Liberia;14;0;833;37
2020-07-04;LR;Liberia;36;0;869;37
2020-07-05;LR;Liberia;5;0;874;37
2020-07-06;LR;Liberia;17;2;891;39
2020-07-07;LR;Liberia;26;2;917;41
2020-07-08;LR;Liberia;9;0;926;41
2020-07-09;LR;Liberia;31;1;957;42
2020-07-10;LR;Liberia;6;5;963;47
2020-07-11;LR;Liberia;35;0;998;47
2020-07-12;LR;Liberia;12;4;1010;51
2020-07-13;LR;Liberia;14;0;1024;51
2020-07-14;LR;Liberia;0;0;1024;51
2020-07-15;LR;Liberia;32;0;1056;51
2020-07-16;LR;Liberia;14;17;1070;68
2020-07-17;LR;Liberia;15;1;1085;69
2020-07-18;LR;Liberia;3;1;1088;70
2020-07-19;LR;Liberia;3;0;1091;70
2020-07-20;LR;Liberia;16;0;1107;70
2020-07-21;LR;Liberia;1;0;1108;70
2020-07-22;LR;Liberia;6;0;1114;70
2020-07-23;LR;Liberia;3;1;1117;71
2020-07-24;LR;Liberia;18;0;1135;71
2020-07-25;LR;Liberia;20;0;1155;71
2020-07-26;LR;Liberia;7;1;1162;72
2020-07-27;LR;Liberia;5;0;1167;72
2020-07-28;LR;Liberia;10;0;1177;72
2020-07-29;LR;Liberia;2;0;1179;72
2020-07-30;LR;Liberia;2;1;1181;73
2020-07-31;LR;Liberia;5;2;1186;75
2020-08-01;LR;Liberia;3;0;1189;75
2020-08-02;LR;Liberia;18;2;1207;77
2020-08-03;LR;Liberia;7;1;1214;78
2020-08-04;LR;Liberia;2;0;1216;78
2020-08-05;LR;Liberia;5;0;1221;78
2020-08-06;LR;Liberia;3;0;1224;78
2020-08-07;LR;Liberia;6;0;1230;78
2020-08-08;LR;Liberia;4;1;1234;79
2020-08-09;LR;Liberia;3;0;1237;79
2020-08-10;LR;Liberia;3;0;1240;79
2020-08-11;LR;Liberia;10;2;1250;81
2020-08-12;LR;Liberia;2;1;1252;82
2020-08-13;LR;Liberia;0;0;1252;82
2020-08-14;LR;Liberia;0;0;1252;82
2020-08-15;LR;Liberia;5;0;1257;82
2020-08-16;LR;Liberia;0;0;1257;82
2020-08-17;LR;Liberia;20;0;1277;82
2020-08-18;LR;Liberia;5;0;1282;82
2020-08-19;LR;Liberia;0;0;1282;82
2020-08-20;LR;Liberia;2;0;1284;82
2020-08-21;LR;Liberia;1;0;1285;82
2020-08-22;LR;Liberia;1;0;1286;82
2020-08-23;LR;Liberia;0;0;1286;82
2020-08-24;LR;Liberia;4;0;1290;82
2020-08-25;LR;Liberia;5;0;1295;82
2020-08-26;LR;Liberia;3;0;1298;82
2020-08-27;LR;Liberia;0;0;1298;82
2020-08-28;LR;Liberia;0;0;1298;82
2020-08-29;LR;Liberia;6;0;1304;82
2020-08-30;LR;Liberia;0;0;1304;82
2020-08-31;LR;Liberia;0;0;1304;82
2020-09-01;LR;Liberia;1;0;1305;82
2020-09-02;LR;Liberia;0;0;1305;82
2020-09-03;LR;Liberia;1;0;1306;82
2020-09-04;LR;Liberia;0;0;1306;82
2020-09-05;LR;Liberia;0;0;1306;82
2020-09-06;LR;Liberia;1;0;1307;82
2020-09-07;LR;Liberia;4;0;1311;82
2020-09-08;LR;Liberia;0;0;1311;82
2020-09-09;LR;Liberia;2;0;1313;82
2020-09-10;LR;Liberia;2;0;1315;82
2020-09-11;LR;Liberia;0;0;1315;82
2020-09-12;LR;Liberia;1;0;1316;82
2020-09-13;LR;Liberia;3;0;1319;82
2020-09-14;LR;Liberia;2;0;1321;82
2020-09-15;LR;Liberia;6;0;1327;82
2020-09-16;LR;Liberia;5;0;1332;82
2020-09-17;LR;Liberia;1;0;1333;82
2020-09-18;LR;Liberia;1;0;1334;82
2020-09-19;LR;Liberia;1;0;1335;82
2020-09-20;LR;Liberia;0;0;1335;82
2020-09-21;LR;Liberia;1;0;1336;82
2020-09-22;LR;Liberia;0;0;1336;82
2020-09-23;LR;Liberia;1;0;1337;82
2020-09-24;LR;Liberia;1;0;1338;82
2020-09-25;LR;Liberia;0;0;1338;82
2020-09-26;LR;Liberia;0;0;1338;82
2020-09-27;LR;Liberia;1;0;1339;82
2020-09-28;LR;Liberia;3;0;1342;82
2020-09-29;LR;Liberia;1;0;1343;82
2020-09-30;LR;Liberia;0;0;1343;82
2020-10-01;LR;Liberia;0;0;1343;82
2020-10-02;LR;Liberia;3;0;1346;82
2020-10-03;LR;Liberia;1;0;1347;82
2020-10-04;LR;Liberia;1;0;1348;82
2020-10-05;LR;Liberia;6;0;1354;82
2020-10-06;LR;Liberia;0;0;1354;82
2020-10-07;LR;Liberia;1;0;1355;82
2020-10-08;LR;Liberia;5;0;1360;82
2020-10-09;LR;Liberia;0;0;1360;82
2020-10-10;LR;Liberia;3;0;1363;82
2020-10-11;LR;Liberia;0;0;1363;82
2020-10-12;LR;Liberia;8;0;1371;82
2020-10-13;LR;Liberia;0;0;1371;82
2020-10-14;LR;Liberia;1;0;1372;82
2020-10-15;LR;Liberia;2;0;1374;82
2020-10-16;LR;Liberia;3;0;1377;82
2020-10-17;LR;Liberia;0;0;1377;82
2020-10-18;LR;Liberia;0;0;1377;82
2020-10-19;LR;Liberia;4;0;1381;82
2020-10-20;LR;Liberia;3;0;1384;82
2020-10-21;LR;Liberia;1;0;1385;82
2020-10-22;LR;Liberia;0;0;1385;82
2020-10-23;LR;Liberia;8;0;1393;82
2020-10-24;LR;Liberia;0;0;1393;82
2020-10-25;LR;Liberia;0;0;1393;82
2020-10-26;LR;Liberia;23;0;1416;82
2020-10-27;LR;Liberia;3;0;1419;82
2020-10-28;LR;Liberia;0;0;1419;82
2020-10-29;LR;Liberia;7;0;1426;82
2020-10-30;LR;Liberia;0;0;1426;82
2020-10-31;LR;Liberia;0;0;1426;82
2020-11-01;LR;Liberia;0;0;1426;82
2020-11-02;LR;Liberia;10;0;1436;82
2020-11-03;LR;Liberia;0;0;1436;82
2020-11-04;LR;Liberia;2;0;1438;82
2020-11-05;LR;Liberia;2;0;1440;82
2020-11-06;LR;Liberia;2;0;1442;82
2020-11-07;LR;Liberia;0;0;1442;82
2020-11-08;LR;Liberia;0;0;1442;82
2020-11-09;LR;Liberia;10;0;1452;82
2020-11-10;LR;Liberia;9;0;1461;82
2020-11-11;LR;Liberia;0;0;1461;82
2020-11-12;LR;Liberia;7;0;1468;82
2020-11-13;LR;Liberia;23;0;1491;82
2020-11-14;LR;Liberia;7;0;1498;82
2020-11-15;LR;Liberia;9;0;1507;82
2020-11-16;LR;Liberia;5;0;1512;82
2020-11-17;LR;Liberia;0;0;1512;82
2020-11-18;LR;Liberia;16;0;1528;82
2020-11-19;LR;Liberia;11;0;1539;82
2020-11-20;LR;Liberia;12;0;1551;82
2020-11-21;LR;Liberia;0;0;1551;82
2020-11-22;LR;Liberia;0;0;1551;82
2020-11-23;LR;Liberia;0;0;1551;82
2020-11-24;LR;Liberia;0;0;1551;82
2020-11-25;LR;Liberia;27;1;1578;83
2020-11-26;LR;Liberia;13;0;1591;83
2020-11-27;LR;Liberia;4;0;1595;83
2020-11-28;LR;Liberia;0;0;1595;83
2020-11-29;LR;Liberia;0;0;1595;83
2020-11-30;LR;Liberia;0;0;1595;83
2020-12-01;LR;Liberia;0;0;1595;83
2020-12-02;LR;Liberia;0;0;1595;83
2020-12-03;LR;Liberia;68;0;1663;83
2020-12-04;LR;Liberia;13;0;1676;83
2020-12-05;LR;Liberia;0;0;1676;83
2020-12-06;LR;Liberia;0;0;1676;83
2020-12-07;LR;Liberia;0;0;1676;83
2020-12-08;LR;Liberia;0;0;1676;83
2020-12-09;LR;Liberia;0;0;1676;83
2020-12-10;LR;Liberia;0;0;1676;83
2020-12-11;LR;Liberia;0;0;1676;83
2020-12-12;LR;Liberia;0;0;1676;83
2020-12-13;LR;Liberia;0;0;1676;83
2020-12-14;LR;Liberia;0;0;1676;83
2020-12-15;LR;Liberia;0;0;1676;83
2020-12-16;LR;Liberia;97;0;1773;83
2020-12-17;LR;Liberia;6;0;1779;83
2020-12-18;LR;Liberia;0;0;1779;83
2020-12-19;LR;Liberia;0;0;1779;83
2020-12-20;LR;Liberia;0;0;1779;83
2020-12-21;LR;Liberia;0;0;1779;83
2020-12-22;LR;Liberia;0;0;1779;83
2020-12-23;LR;Liberia;0;0;1779;83
2020-12-24;LR;Liberia;0;0;1779;83
2020-12-25;LR;Liberia;0;0;1779;83
2020-12-26;LR;Liberia;0;0;1779;83
2020-12-27;LR;Liberia;0;0;1779;83
2020-12-28;LR;Liberia;0;0;1779;83
2020-12-29;LR;Liberia;0;0;1779;83
2020-12-30;LR;Liberia;0;0;1779;83
2020-12-31;LR;Liberia;0;0;1779;83
2021-01-01;LR;Liberia;0;0;1779;83
2021-01-02;LR;Liberia;0;0;1779;83
2021-01-03;LR;Liberia;0;0;1779;83
2021-01-04;LR;Liberia;0;0;1779;83
2021-01-05;LR;Liberia;0;0;1779;83
2021-01-06;LR;Liberia;0;0;1779;83
2021-01-07;LR;Liberia;0;0;1779;83
2021-01-08;LR;Liberia;0;0;1779;83
2021-01-09;LR;Liberia;0;0;1779;83
2021-01-10;LR;Liberia;0;0;1779;83
2021-01-11;LR;Liberia;0;0;1779;83
2021-01-12;LR;Liberia;97;1;1876;84
2021-01-13;LR;Liberia;1;0;1877;84
2021-01-14;LR;Liberia;1;0;1878;84
2021-01-15;LR;Liberia;4;0;1882;84
2021-01-16;LR;Liberia;5;0;1887;84
2021-01-17;LR;Liberia;0;0;1887;84
2021-01-18;LR;Liberia;9;0;1896;84
2021-01-19;LR;Liberia;2;0;1898;84
2021-01-20;LR;Liberia;3;0;1901;84
2021-01-21;LR;Liberia;0;0;1901;84
2021-01-22;LR;Liberia;11;0;1912;84
2021-01-23;LR;Liberia;2;0;1914;84
2021-01-24;LR;Liberia;0;0;1914;84
2021-01-25;LR;Liberia;13;0;1927;84
2021-01-26;LR;Liberia;5;0;1932;84
2021-01-27;LR;Liberia;4;0;1936;84
2021-01-28;LR;Liberia;0;0;1936;84
2021-01-29;LR;Liberia;3;0;1939;84
2021-01-30;LR;Liberia;0;0;1939;84
2021-01-31;LR;Liberia;0;0;1939;84
2021-02-01;LR;Liberia;5;0;1944;84
2021-02-02;LR;Liberia;0;0;1944;84
2021-02-03;LR;Liberia;1;0;1945;84
2021-02-04;LR;Liberia;0;0;1945;84
2021-02-05;LR;Liberia;11;0;1956;84
2021-02-06;LR;Liberia;0;0;1956;84
2021-02-07;LR;Liberia;0;0;1956;84
2021-02-08;LR;Liberia;0;0;1956;84
2021-02-09;LR;Liberia;0;0;1956;84
2021-02-10;LR;Liberia;0;0;1956;84
2021-02-11;LR;Liberia;0;0;1956;84
2021-02-12;LR;Liberia;0;0;1956;84
2021-02-13;LR;Liberia;0;0;1956;84
2021-02-14;LR;Liberia;0;0;1956;84
2021-02-15;LR;Liberia;29;1;1985;85
2021-02-16;LR;Liberia;0;0;1985;85
2021-02-17;LR;Liberia;0;0;1985;85
2021-02-18;LR;Liberia;0;0;1985;85
2021-02-19;LR;Liberia;3;0;1988;85
2021-02-20;LR;Liberia;0;0;1988;85
2021-02-21;LR;Liberia;0;0;1988;85
2021-02-22;LR;Liberia;8;0;1996;85
2021-02-23;LR;Liberia;2;0;1998;85
2021-02-24;LR;Liberia;4;0;2002;85
2021-02-25;LR;Liberia;7;0;2009;85
2021-02-26;LR;Liberia;1;0;2010;85
2021-02-27;LR;Liberia;0;0;2010;85
2021-02-28;LR;Liberia;4;0;2014;85
2021-03-01;LR;Liberia;0;0;2014;85
2021-03-02;LR;Liberia;0;0;2014;85
2021-03-03;LR;Liberia;3;0;2017;85
2021-03-04;LR;Liberia;0;0;2017;85
2021-03-05;LR;Liberia;6;0;2023;85
2021-03-06;LR;Liberia;1;0;2024;85
2021-03-07;LR;Liberia;0;0;2024;85
2021-03-08;LR;Liberia;0;0;2024;85
2021-03-09;LR;Liberia;2;0;2026;85
2021-03-10;LR;Liberia;0;0;2026;85
2021-03-11;LR;Liberia;0;0;2026;85
2021-03-12;LR;Liberia;4;0;2030;85
2021-03-13;LR;Liberia;0;0;2030;85
2021-03-14;LR;Liberia;0;0;2030;85
2021-03-15;LR;Liberia;0;0;2030;85
2021-03-16;LR;Liberia;0;0;2030;85
2021-03-17;LR;Liberia;12;0;2042;85
2021-03-18;LR;Liberia;0;0;2042;85
2021-03-19;LR;Liberia;0;0;2042;85
2021-03-20;LR;Liberia;0;0;2042;85
2021-03-21;LR;Liberia;0;0;2042;85
2021-03-22;LR;Liberia;0;0;2042;85
2021-03-23;LR;Liberia;0;0;2042;85
2021-03-24;LR;Liberia;0;0;2042;85
2021-03-25;LR;Liberia;0;0;2042;85
2021-03-26;LR;Liberia;0;0;2042;85
2021-03-27;LR;Liberia;0;0;2042;85
2021-03-28;LR;Liberia;0;0;2042;85
2021-03-29;LR;Liberia;0;0;2042;85
2021-03-30;LR;Liberia;0;0;2042;85
2021-03-31;LR;Liberia;0;0;2042;85
2021-04-01;LR;Liberia;0;0;2042;85
2021-04-02;LR;Liberia;0;0;2042;85
2021-04-03;LR;Liberia;0;0;2042;85
2021-04-04;LR;Liberia;0;0;2042;85
2021-04-05;LR;Liberia;0;0;2042;85
2021-04-06;LR;Liberia;0;0;2042;85
2021-04-07;LR;Liberia;0;0;2042;85
2021-04-08;LR;Liberia;0;0;2042;85
2021-04-09;LR;Liberia;0;0;2042;85
2021-04-10;LR;Liberia;0;0;2042;85
2021-04-11;LR;Liberia;0;0;2042;85
2021-04-12;LR;Liberia;0;0;2042;85
2021-04-13;LR;Liberia;0;0;2042;85
2021-04-14;LR;Liberia;0;0;2042;85
2021-04-15;LR;Liberia;0;0;2042;85
2021-04-16;LR;Liberia;0;0;2042;85
2021-04-17;LR;Liberia;0;0;2042;85
2021-04-18;LR;Liberia;0;0;2042;85
2021-04-19;LR;Liberia;0;0;2042;85
2021-04-20;LR;Liberia;0;0;2042;85
2021-04-21;LR;Liberia;49;0;2091;85
2021-04-22;LR;Liberia;0;0;2091;85
2021-04-23;LR;Liberia;6;0;2097;85
2021-04-24;LR;Liberia;0;0;2097;85
2021-04-25;LR;Liberia;0;0;2097;85
2021-04-26;LR;Liberia;1;0;2098;85
2021-04-27;LR;Liberia;0;0;2098;85
2021-04-28;LR;Liberia;1;0;2099;85
2021-04-29;LR;Liberia;0;0;2099;85
2021-04-30;LR;Liberia;0;0;2099;85
2021-05-01;LR;Liberia;0;0;2099;85
2021-05-02;LR;Liberia;0;0;2099;85
2021-05-03;LR;Liberia;11;0;2110;85
2021-05-04;LR;Liberia;0;0;2110;85
2021-05-05;LR;Liberia;3;0;2113;85
2021-05-06;LR;Liberia;0;0;2113;85
2021-05-07;LR;Liberia;1;0;2114;85
2021-05-08;LR;Liberia;0;0;2114;85
2021-05-09;LR;Liberia;0;0;2114;85
2021-05-10;LR;Liberia;0;0;2114;85
2021-05-11;LR;Liberia;0;0;2114;85
2021-05-12;LR;Liberia;0;0;2114;85
2021-05-13;LR;Liberia;0;0;2114;85
2021-05-14;LR;Liberia;0;0;2114;85
2021-05-15;LR;Liberia;0;0;2114;85
2021-05-16;LR;Liberia;0;0;2114;85
2021-05-17;LR;Liberia;0;0;2114;85
2021-05-18;LR;Liberia;17;0;2131;85
2021-05-19;LR;Liberia;11;0;2142;85
2021-05-20;LR;Liberia;0;0;2142;85
2021-05-21;LR;Liberia;0;0;2142;85
2021-05-22;LR;Liberia;0;0;2142;85
2021-05-23;LR;Liberia;0;0;2142;85
2021-05-24;LR;Liberia;19;1;2161;86
2021-05-25;LR;Liberia;0;0;2161;86
2021-05-26;LR;Liberia;13;0;2174;86
2021-05-27;LR;Liberia;0;0;2174;86
2021-05-28;LR;Liberia;5;0;2179;86
2021-05-29;LR;Liberia;0;0;2179;86
2021-05-30;LR;Liberia;0;0;2179;86
2021-05-31;LR;Liberia;12;0;2191;86
2021-06-01;LR;Liberia;19;0;2210;86
2021-06-02;LR;Liberia;9;0;2219;86
2021-06-03;LR;Liberia;0;0;2219;86
2021-06-04;LR;Liberia;31;0;2250;86
2021-06-05;LR;Liberia;0;0;2250;86
2021-06-06;LR;Liberia;0;0;2250;86
2021-06-07;LR;Liberia;40;2;2290;88
2021-06-08;LR;Liberia;0;0;2290;88
2021-06-09;LR;Liberia;92;0;2382;88
2021-06-10;LR;Liberia;0;0;2382;88
2021-06-11;LR;Liberia;102;5;2484;93
2021-06-12;LR;Liberia;0;0;2484;93
2021-06-13;LR;Liberia;51;0;2535;93
2021-06-14;LR;Liberia;40;1;2575;94
2021-06-15;LR;Liberia;0;0;2575;94
2021-06-16;LR;Liberia;154;1;2729;95
2021-06-17;LR;Liberia;67;0;2796;95
2021-06-18;LR;Liberia;38;0;2834;95
2021-06-19;LR;Liberia;0;0;2834;95
2021-06-20;LR;Liberia;161;0;2995;95
2021-06-21;LR;Liberia;114;4;3109;99
2021-06-22;LR;Liberia;0;0;3109;99
2021-06-23;LR;Liberia;156;11;3265;110
2021-06-24;LR;Liberia;0;0;3265;110
2021-06-25;LR;Liberia;109;2;3374;112
2021-06-26;LR;Liberia;155;1;3529;113
2021-06-27;LR;Liberia;207;7;3736;120
2021-06-28;LR;Liberia;58;3;3794;123
2021-06-29;LR;Liberia;106;4;3900;127
2021-06-30;LR;Liberia;193;1;4093;128
2021-07-01;LR;Liberia;211;1;4304;129
2020-03-04;LY;Libya;0;0;0;0
2020-03-05;LY;Libya;0;0;0;0
2020-03-06;LY;Libya;0;0;0;0
2020-03-07;LY;Libya;0;0;0;0
2020-03-08;LY;Libya;0;0;0;0
2020-03-09;LY;Libya;0;0;0;0
2020-03-10;LY;Libya;0;0;0;0
2020-03-11;LY;Libya;0;0;0;0
2020-03-12;LY;Libya;0;0;0;0
2020-03-13;LY;Libya;0;0;0;0
2020-03-14;LY;Libya;0;0;0;0
2020-03-15;LY;Libya;0;0;0;0
2020-03-16;LY;Libya;0;0;0;0
2020-03-17;LY;Libya;0;0;0;0
2020-03-18;LY;Libya;0;0;0;0
2020-03-19;LY;Libya;0;0;0;0
2020-03-20;LY;Libya;0;0;0;0
2020-03-21;LY;Libya;0;0;0;0
2020-03-22;LY;Libya;0;0;0;0
2020-03-23;LY;Libya;0;0;0;0
2020-03-24;LY;Libya;1;0;1;0
2020-03-25;LY;Libya;0;0;1;0
2020-03-26;LY;Libya;0;0;1;0
2020-03-27;LY;Libya;0;0;1;0
2020-03-28;LY;Libya;2;0;3;0
2020-03-29;LY;Libya;5;0;8;0
2020-03-30;LY;Libya;0;0;8;0
2020-03-31;LY;Libya;2;0;10;0
2020-04-01;LY;Libya;0;0;10;0
2020-04-02;LY;Libya;1;1;11;1
2020-04-03;LY;Libya;0;0;11;1
2020-04-04;LY;Libya;7;0;18;1
2020-04-05;LY;Libya;0;0;18;1
2020-04-06;LY;Libya;1;0;19;1
2020-04-07;LY;Libya;1;0;20;1
2020-04-08;LY;Libya;1;0;21;1
2020-04-09;LY;Libya;3;0;24;1
2020-04-10;LY;Libya;0;0;24;1
2020-04-11;LY;Libya;0;0;24;1
2020-04-12;LY;Libya;1;0;25;1
2020-04-13;LY;Libya;1;0;26;1
2020-04-14;LY;Libya;9;0;35;1
2020-04-15;LY;Libya;13;0;48;1
2020-04-16;LY;Libya;1;0;49;1
2020-04-17;LY;Libya;0;0;49;1
2020-04-18;LY;Libya;0;0;49;1
2020-04-19;LY;Libya;2;0;51;1
2020-04-20;LY;Libya;0;0;51;1
2020-04-21;LY;Libya;0;0;51;1
2020-04-22;LY;Libya;8;0;59;1
2020-04-23;LY;Libya;1;1;60;2
2020-04-24;LY;Libya;1;0;61;2
2020-04-25;LY;Libya;0;0;61;2
2020-04-26;LY;Libya;0;0;61;2
2020-04-27;LY;Libya;0;0;61;2
2020-04-28;LY;Libya;0;0;61;2
2020-04-29;LY;Libya;0;0;61;2
2020-04-30;LY;Libya;0;1;61;3
2020-05-01;LY;Libya;2;0;63;3
2020-05-02;LY;Libya;0;0;63;3
2020-05-03;LY;Libya;0;0;63;3
2020-05-04;LY;Libya;0;0;63;3
2020-05-05;LY;Libya;0;0;63;3
2020-05-06;LY;Libya;1;0;64;3
2020-05-07;LY;Libya;0;0;64;3
2020-05-08;LY;Libya;0;0;64;3
2020-05-09;LY;Libya;0;0;64;3
2020-05-10;LY;Libya;0;0;64;3
2020-05-11;LY;Libya;0;0;64;3
2020-05-12;LY;Libya;0;0;64;3
2020-05-13;LY;Libya;0;0;64;3
2020-05-14;LY;Libya;0;0;64;3
2020-05-15;LY;Libya;0;0;64;3
2020-05-16;LY;Libya;1;0;65;3
2020-05-17;LY;Libya;0;0;65;3
2020-05-18;LY;Libya;0;0;65;3
2020-05-19;LY;Libya;3;0;68;3
2020-05-20;LY;Libya;1;0;69;3
2020-05-21;LY;Libya;2;0;71;3
2020-05-22;LY;Libya;1;0;72;3
2020-05-23;LY;Libya;3;0;75;3
2020-05-24;LY;Libya;0;0;75;3
2020-05-25;LY;Libya;0;0;75;3
2020-05-26;LY;Libya;2;0;77;3
2020-05-27;LY;Libya;22;1;99;4
2020-05-28;LY;Libya;6;1;105;5
2020-05-29;LY;Libya;13;0;118;5
2020-05-30;LY;Libya;12;0;130;5
2020-05-31;LY;Libya;26;0;156;5
2020-06-01;LY;Libya;12;0;168;5
2020-06-02;LY;Libya;14;0;182;5
2020-06-03;LY;Libya;14;0;196;5
2020-06-04;LY;Libya;13;0;209;5
2020-06-05;LY;Libya;30;0;239;5
2020-06-06;LY;Libya;17;0;256;5
2020-06-07;LY;Libya;0;0;256;5
2020-06-08;LY;Libya;76;0;332;5
2020-06-09;LY;Libya;27;0;359;5
2020-06-10;LY;Libya;19;0;378;5
2020-06-11;LY;Libya;15;0;393;5
2020-06-12;LY;Libya;16;1;409;6
2020-06-13;LY;Libya;9;2;418;8
2020-06-14;LY;Libya;36;2;454;10
2020-06-15;LY;Libya;13;0;467;10
2020-06-16;LY;Libya;17;0;484;10
2020-06-17;LY;Libya;16;0;500;10
2020-06-18;LY;Libya;10;0;510;10
2020-06-19;LY;Libya;10;0;520;10
2020-06-20;LY;Libya;24;0;544;10
2020-06-21;LY;Libya;27;0;571;10
2020-06-22;LY;Libya;24;0;595;10
2020-06-23;LY;Libya;44;7;639;17
2020-06-24;LY;Libya;31;1;670;18
2020-06-25;LY;Libya;28;0;698;18
2020-06-26;LY;Libya;15;0;713;18
2020-06-27;LY;Libya;14;0;727;18
2020-06-28;LY;Libya;35;3;762;21
2020-06-29;LY;Libya;40;2;802;23
2020-06-30;LY;Libya;22;1;824;24
2020-07-01;LY;Libya;50;1;874;25
2020-07-02;LY;Libya;17;1;891;26
2020-07-03;LY;Libya;27;1;918;27
2020-07-04;LY;Libya;71;0;989;27
2020-07-05;LY;Libya;57;5;1046;32
2020-07-06;LY;Libya;71;2;1117;34
2020-07-07;LY;Libya;65;1;1182;35
2020-07-08;LY;Libya;86;1;1268;36
2020-07-09;LY;Libya;74;2;1342;38
2020-07-10;LY;Libya;0;0;1342;38
2020-07-11;LY;Libya;47;0;1389;38
2020-07-12;LY;Libya;44;1;1433;39
2020-07-13;LY;Libya;79;1;1512;40
2020-07-14;LY;Libya;51;2;1563;42
2020-07-15;LY;Libya;26;1;1589;43
2020-07-16;LY;Libya;63;3;1652;46
2020-07-17;LY;Libya;52;1;1704;47
2020-07-18;LY;Libya;87;1;1791;48
2020-07-19;LY;Libya;75;0;1866;48
2020-07-20;LY;Libya;114;1;1980;49
2020-07-21;LY;Libya;108;1;2088;50
2020-07-22;LY;Libya;88;3;2176;53
2020-07-23;LY;Libya;138;3;2314;56
2020-07-24;LY;Libya;110;1;2424;57
2020-07-25;LY;Libya;123;1;2547;58
2020-07-26;LY;Libya;122;2;2669;60
2020-07-27;LY;Libya;158;4;2827;64
2020-07-28;LY;Libya;190;3;3017;67
2020-07-29;LY;Libya;205;9;3222;76
2020-07-30;LY;Libya;216;-3;3438;73
2020-07-31;LY;Libya;183;1;3621;74
2020-08-01;LY;Libya;70;6;3691;80
2020-08-02;LY;Libya;146;3;3837;83
2020-08-03;LY;Libya;226;10;4063;93
2020-08-04;LY;Libya;161;3;4224;96
2020-08-05;LY;Libya;251;3;4475;99
2020-08-06;LY;Libya;404;8;4879;107
2020-08-07;LY;Libya;200;1;5079;108
2020-08-08;LY;Libya;153;5;5232;113
2020-08-09;LY;Libya;219;6;5451;119
2020-08-10;LY;Libya;478;6;5929;125
2020-08-11;LY;Libya;373;7;6302;132
2020-08-12;LY;Libya;309;0;6611;132
2020-08-13;LY;Libya;439;3;7050;135
2020-08-14;LY;Libya;277;4;7327;139
2020-08-15;LY;Libya;411;6;7738;145
2020-08-16;LY;Libya;434;8;8172;153
2020-08-17;LY;Libya;407;4;8579;157
2020-08-18;LY;Libya;489;7;9068;164
2020-08-19;LY;Libya;395;5;9463;169
2020-08-20;LY;Libya;244;4;9707;173
2020-08-21;LY;Libya;414;7;10121;180
2020-08-22;LY;Libya;316;8;10437;188
2020-08-23;LY;Libya;0;0;10437;188
2020-08-24;LY;Libya;572;11;11009;199
2020-08-25;LY;Libya;272;4;11281;203
2020-08-26;LY;Libya;553;7;11834;210
2020-08-27;LY;Libya;440;9;12274;219
2020-08-28;LY;Libya;355;7;12629;226
2020-08-29;LY;Libya;329;5;12958;231
2020-08-30;LY;Libya;465;1;13423;232
2020-08-31;LY;Libya;543;5;13966;237
2020-09-01;LY;Libya;658;5;14624;242
2020-09-02;LY;Libya;532;8;15156;250
2020-09-03;LY;Libya;617;4;15773;254
2020-09-04;LY;Libya;672;8;16445;262
2020-09-05;LY;Libya;649;10;17094;272
2020-09-06;LY;Libya;655;13;17749;285
2020-09-07;LY;Libya;1085;11;18834;296
2020-09-08;LY;Libya;749;18;19583;314
2020-09-09;LY;Libya;879;10;20462;324
2020-09-10;LY;Libya;477;15;20939;339
2020-09-11;LY;Libya;969;13;21908;352
2020-09-12;LY;Libya;440;2;22348;354
2020-09-13;LY;Libya;433;8;22781;362
2020-09-14;LY;Libya;734;6;23515;368
2020-09-15;LY;Libya;629;15;24144;383
2020-09-16;LY;Libya;792;11;24936;394
2020-09-17;LY;Libya;886;15;25822;409
2020-09-18;LY;Libya;616;9;26438;418
2020-09-19;LY;Libya;796;18;27234;436
2020-09-20;LY;Libya;715;8;27949;444
2020-09-21;LY;Libya;847;6;28796;450
2020-09-22;LY;Libya;650;10;29446;460
2020-09-23;LY;Libya;651;9;30097;469
2020-09-24;LY;Libya;535;5;30632;474
2020-09-25;LY;Libya;658;17;31290;491
2020-09-26;LY;Libya;538;8;31828;499
2020-09-27;LY;Libya;536;21;32364;520
2020-09-28;LY;Libya;849;7;33213;527
2020-09-29;LY;Libya;801;13;34014;540
2020-09-30;LY;Libya;511;11;34525;551
2020-10-01;LY;Libya;683;8;35208;559
2020-10-02;LY;Libya;509;11;35717;570
2020-10-03;LY;Libya;370;8;36087;578
2020-10-04;LY;Libya;722;14;36809;592
2020-10-05;LY;Libya;628;4;37437;596
2020-10-06;LY;Libya;1031;6;38468;602
2020-10-07;LY;Libya;1045;6;39513;608
2020-10-08;LY;Libya;779;8;40292;616
2020-10-09;LY;Libya;1076;5;41368;621
2020-10-10;LY;Libya;318;2;41686;623
2020-10-11;LY;Libya;1026;8;42712;631
2020-10-12;LY;Libya;1109;13;43821;644
2020-10-13;LY;Libya;1164;12;44985;656
2020-10-14;LY;Libya;836;13;45821;669
2020-10-15;LY;Libya;855;12;46676;681
2020-10-16;LY;Libya;1169;18;47845;699
2020-10-17;LY;Libya;0;0;47845;699
2020-10-18;LY;Libya;945;26;48790;725
2020-10-19;LY;Libya;1159;7;49949;732
2020-10-20;LY;Libya;957;14;50906;746
2020-10-21;LY;Libya;719;19;51625;765
2020-10-22;LY;Libya;995;3;52620;768
2020-10-23;LY;Libya;764;6;53384;774
2020-10-24;LY;Libya;990;16;54374;790
2020-10-25;LY;Libya;1639;5;56013;795
2020-10-26;LY;Libya;1210;6;57223;801
2020-10-27;LY;Libya;752;11;57975;812
2020-10-28;LY;Libya;899;11;58874;823
2020-10-29;LY;Libya;782;8;59656;831
2020-10-30;LY;Libya;972;16;60628;847
2020-10-31;LY;Libya;467;10;61095;857
2020-11-01;LY;Libya;950;14;62045;871
2020-11-02;LY;Libya;862;9;62907;880
2020-11-03;LY;Libya;781;13;63688;893
2020-11-04;LY;Libya;899;7;64587;900
2020-11-05;LY;Libya;853;7;65440;907
2020-11-06;LY;Libya;1004;8;66444;915
2020-11-07;LY;Libya;595;5;67039;920
2020-11-08;LY;Libya;1078;9;68117;929
2020-11-09;LY;Libya;923;15;69040;944
2020-11-10;LY;Libya;970;13;70010;957
2020-11-11;LY;Libya;875;13;70885;970
2020-11-12;LY;Libya;919;15;71804;985
2020-11-13;LY;Libya;824;10;72628;995
2020-11-14;LY;Libya;0;0;72628;995
2020-11-15;LY;Libya;974;22;73602;1017
2020-11-16;LY;Libya;722;8;74324;1025
2020-11-17;LY;Libya;612;16;74936;1041
2020-11-18;LY;Libya;529;12;75465;1053
2020-11-19;LY;Libya;541;9;76006;1062
2020-11-20;LY;Libya;802;6;76808;1068
2020-11-21;LY;Libya;0;0;76808;1068
2020-11-22;LY;Libya;1015;21;77823;1089
2020-11-23;LY;Libya;650;13;78473;1102
2020-11-24;LY;Libya;707;8;79180;1110
2020-11-25;LY;Libya;617;15;79797;1125
2020-11-26;LY;Libya;610;15;80407;1140
2020-11-27;LY;Libya;866;13;81273;1153
2020-11-28;LY;Libya;0;0;81273;1153
2020-11-29;LY;Libya;1157;13;82430;1166
2020-11-30;LY;Libya;379;17;82809;1183
2020-12-01;LY;Libya;608;13;83417;1196
2020-12-02;LY;Libya;670;4;84087;1200
2020-12-03;LY;Libya;762;12;84849;1212
2020-12-04;LY;Libya;680;7;85529;1219
2020-12-05;LY;Libya;0;0;85529;1219
2020-12-06;LY;Libya;1051;12;86580;1231
2020-12-07;LY;Libya;517;12;87097;1243
2020-12-08;LY;Libya;889;12;87986;1255
2020-12-09;LY;Libya;536;6;88522;1261
2020-12-10;LY;Libya;661;12;89183;1273
2020-12-11;LY;Libya;697;5;89880;1278
2020-12-12;LY;Libya;0;0;89880;1278
2020-12-13;LY;Libya;899;21;90779;1299
2020-12-14;LY;Libya;578;15;91357;1314
2020-12-15;LY;Libya;660;5;92017;1319
2020-12-16;LY;Libya;560;5;92577;1324
2020-12-17;LY;Libya;706;13;93283;1337
2020-12-18;LY;Libya;489;9;93772;1346
2020-12-19;LY;Libya;0;0;93772;1346
2020-12-20;LY;Libya;788;7;94560;1353
2020-12-21;LY;Libya;640;16;95200;1369
2020-12-22;LY;Libya;506;16;95706;1385
2020-12-23;LY;Libya;640;8;96346;1393
2020-12-24;LY;Libya;846;6;97192;1399
2020-12-25;LY;Libya;461;16;97653;1415
2020-12-26;LY;Libya;0;0;97653;1415
2020-12-27;LY;Libya;728;21;98381;1436
2020-12-28;LY;Libya;532;4;98913;1440
2020-12-29;LY;Libya;437;4;99350;1444
2020-12-30;LY;Libya;585;15;99935;1459
2020-12-31;LY;Libya;342;19;100277;1478
2021-01-01;LY;Libya;467;9;100744;1487
2021-01-02;LY;Libya;0;0;100744;1487
2021-01-03;LY;Libya;670;23;101414;1510
2021-01-04;LY;Libya;561;16;101975;1526
2021-01-05;LY;Libya;481;10;102456;1536
2021-01-06;LY;Libya;424;10;102880;1546
2021-01-07;LY;Libya;635;12;103515;1558
2021-01-08;LY;Libya;487;10;104002;1568
2021-01-09;LY;Libya;0;0;104002;1568
2021-01-10;LY;Libya;743;13;104745;1581
2021-01-11;LY;Libya;633;8;105378;1589
2021-01-12;LY;Libya;652;33;106030;1622
2021-01-13;LY;Libya;640;7;106670;1629
2021-01-14;LY;Libya;764;16;107434;1645
2021-01-15;LY;Libya;583;6;108017;1651
2021-01-16;LY;Libya;0;0;108017;1651
2021-01-17;LY;Libya;1071;14;109088;1665
2021-01-18;LY;Libya;781;33;109869;1698
2021-01-19;LY;Libya;596;2;110465;1700
2021-01-20;LY;Libya;659;15;111124;1715
2021-01-21;LY;Libya;622;1;111746;1716
2021-01-22;LY;Libya;794;21;112540;1737
2021-01-23;LY;Libya;0;0;112540;1737
2021-01-24;LY;Libya;1148;26;113688;1763
2021-01-25;LY;Libya;741;19;114429;1782
2021-01-26;LY;Libya;870;7;115299;1789
2021-01-27;LY;Libya;765;13;116064;1802
2021-01-28;LY;Libya;715;30;116779;1832
2021-01-29;LY;Libya;871;10;117650;1842
2021-01-30;LY;Libya;0;0;117650;1842
2021-01-31;LY;Libya;981;35;118631;1877
2021-02-01;LY;Libya;771;6;119402;1883
2021-02-02;LY;Libya;1032;13;120434;1896
2021-02-03;LY;Libya;809;18;121243;1914
2021-02-04;LY;Libya;770;5;122013;1919
2021-02-05;LY;Libya;881;17;122894;1936
2021-02-06;LY;Libya;0;0;122894;1936
2021-02-07;LY;Libya;1132;17;124026;1953
2021-02-08;LY;Libya;856;21;124882;1974
2021-02-09;LY;Libya;679;8;125561;1982
2021-02-10;LY;Libya;467;7;126028;1989
2021-02-11;LY;Libya;333;20;126361;2009
2021-02-12;LY;Libya;520;5;126881;2014
2021-02-13;LY;Libya;0;0;126881;2014
2021-02-14;LY;Libya;473;4;127354;2018
2021-02-15;LY;Libya;351;24;127705;2042
2021-02-16;LY;Libya;331;9;128036;2051
2021-02-17;LY;Libya;312;5;128348;2056
2021-02-18;LY;Libya;392;5;128740;2061
2021-02-19;LY;Libya;585;27;129325;2088
2021-02-20;LY;Libya;0;0;129325;2088
2021-02-21;LY;Libya;472;26;129797;2114
2021-02-22;LY;Libya;415;2;130212;2116
2021-02-23;LY;Libya;489;9;130701;2125
2021-02-24;LY;Libya;561;26;131262;2151
2021-02-25;LY;Libya;571;5;131833;2156
2021-02-26;LY;Libya;625;18;132458;2174
2021-02-27;LY;Libya;0;0;132458;2174
2021-02-28;LY;Libya;880;5;133338;2179
2021-03-01;LY;Libya;789;31;134127;2210
2021-03-02;LY;Libya;840;6;134967;2216
2021-03-03;LY;Libya;618;3;135585;2219
2021-03-04;LY;Libya;1002;14;136587;2233
2021-03-05;LY;Libya;895;3;137482;2236
2021-03-06;LY;Libya;0;0;137482;2236
2021-03-07;LY;Libya;1158;37;138640;2273
2021-03-08;LY;Libya;1018;15;139658;2288
2021-03-09;LY;Libya;1030;9;140688;2297
2021-03-10;LY;Libya;910;33;141598;2330
2021-03-11;LY;Libya;1073;10;142671;2340
2021-03-12;LY;Libya;972;8;143643;2348
2021-03-13;LY;Libya;0;0;143643;2348
2021-03-14;LY;Libya;1350;38;144993;2386
2021-03-15;LY;Libya;1087;16;146080;2402
2021-03-16;LY;Libya;1041;4;147121;2406
2021-03-17;LY;Libya;1054;16;148175;2422
2021-03-18;LY;Libya;1032;13;149207;2435
2021-03-19;LY;Libya;1134;52;150341;2487
2021-03-20;LY;Libya;0;0;150341;2487
2021-03-21;LY;Libya;1264;19;151605;2506
2021-03-22;LY;Libya;905;7;152510;2513
2021-03-23;LY;Libya;901;51;153411;2564
2021-03-24;LY;Libya;909;18;154320;2582
2021-03-25;LY;Libya;912;9;155232;2591
2021-03-26;LY;Libya;884;11;156116;2602
2021-03-27;LY;Libya;0;0;156116;2602
2021-03-28;LY;Libya;733;16;156849;2618
2021-03-29;LY;Libya;696;35;157545;2653
2021-03-30;LY;Libya;706;5;158251;2658
2021-03-31;LY;Libya;706;9;158957;2667
2021-04-01;LY;Libya;1023;13;159980;2680
2021-04-02;LY;Libya;1108;4;161088;2684
2021-04-03;LY;Libya;0;0;161088;2684
2021-04-04;LY;Libya;1206;53;162294;2737
2021-04-05;LY;Libya;1148;20;163442;2757
2021-04-06;LY;Libya;876;8;164318;2765
2021-04-07;LY;Libya;969;7;165287;2772
2021-04-08;LY;Libya;869;27;166156;2799
2021-04-09;LY;Libya;732;8;166888;2807
2021-04-10;LY;Libya;0;0;166888;2807
2021-04-11;LY;Libya;937;16;167825;2823
2021-04-12;LY;Libya;851;5;168676;2828
2021-04-13;LY;Libya;828;2;169504;2830
2021-04-14;LY;Libya;541;4;170045;2834
2021-04-15;LY;Libya;513;39;170558;2873
2021-04-16;LY;Libya;573;9;171131;2882
2021-04-17;LY;Libya;0;0;171131;2882
2021-04-18;LY;Libya;749;14;171880;2896
2021-04-19;LY;Libya;584;12;172464;2908
2021-04-20;LY;Libya;625;11;173089;2919
2021-04-21;LY;Libya;594;5;173683;2924
2021-04-22;LY;Libya;533;12;174216;2936
2021-04-23;LY;Libya;536;11;174752;2947
2021-04-24;LY;Libya;0;0;174752;2947
2021-04-25;LY;Libya;534;49;175286;2996
2021-04-26;LY;Libya;467;9;175753;3005
2021-04-27;LY;Libya;501;5;176254;3010
2021-04-28;LY;Libya;447;9;176701;3019
2021-04-29;LY;Libya;371;4;177072;3023
2021-04-30;LY;Libya;436;6;177508;3029
2021-05-01;LY;Libya;0;0;177508;3029
2021-05-02;LY;Libya;363;10;177871;3039
2021-05-03;LY;Libya;464;8;178335;3047
2021-05-04;LY;Libya;337;2;178672;3049
2021-05-05;LY;Libya;255;9;178927;3058
2021-05-06;LY;Libya;266;1;179193;3059
2021-05-07;LY;Libya;504;4;179697;3063
2021-05-08;LY;Libya;0;0;179697;3063
2021-05-09;LY;Libya;273;7;179970;3070
2021-05-10;LY;Libya;256;2;180226;3072
2021-05-11;LY;Libya;466;5;180692;3077
2021-05-12;LY;Libya;253;5;180945;3082
2021-05-13;LY;Libya;234;3;181179;3085
2021-05-14;LY;Libya;0;0;181179;3085
2021-05-15;LY;Libya;0;0;181179;3085
2021-05-16;LY;Libya;231;3;181410;3088
2021-05-17;LY;Libya;304;4;181714;3092
2021-05-18;LY;Libya;298;5;182012;3097
2021-05-19;LY;Libya;338;0;182350;3097
2021-05-20;LY;Libya;299;5;182649;3102
2021-05-21;LY;Libya;250;3;182899;3105
2021-05-22;LY;Libya;0;0;182899;3105
2021-05-23;LY;Libya;412;6;183311;3111
2021-05-24;LY;Libya;281;1;183592;3112
2021-05-25;LY;Libya;340;2;183932;3114
2021-05-26;LY;Libya;219;1;184151;3115
2021-05-27;LY;Libya;321;0;184472;3115
2021-05-28;LY;Libya;343;1;184815;3116
2021-05-29;LY;Libya;0;0;184815;3116
2021-05-30;LY;Libya;366;9;185181;3125
2021-05-31;LY;Libya;595;1;185776;3126
2021-06-01;LY;Libya;296;1;186072;3127
2021-06-02;LY;Libya;251;4;186323;3131
2021-06-03;LY;Libya;244;1;186567;3132
2021-06-04;LY;Libya;386;5;186953;3137
2021-06-05;LY;Libya;0;0;186953;3137
2021-06-06;LY;Libya;328;6;187281;3143
2021-06-07;LY;Libya;404;3;187685;3146
2021-06-08;LY;Libya;243;3;187928;3149
2021-06-09;LY;Libya;229;3;188157;3152
2021-06-10;LY;Libya;229;3;188386;3155
2021-06-11;LY;Libya;376;3;188762;3158
2021-06-12;LY;Libya;0;0;188762;3158
2021-06-13;LY;Libya;297;3;189059;3161
2021-06-14;LY;Libya;225;4;189284;3165
2021-06-15;LY;Libya;271;1;189555;3166
2021-06-16;LY;Libya;333;0;189888;3166
2021-06-17;LY;Libya;258;4;190146;3170
2021-06-18;LY;Libya;280;3;190426;3173
2021-06-19;LY;Libya;0;0;190426;3173
2021-06-20;LY;Libya;322;1;190748;3174
2021-06-21;LY;Libya;290;4;191038;3178
2021-06-22;LY;Libya;215;3;191253;3181
2021-06-23;LY;Libya;223;2;191476;3183
2021-06-24;LY;Libya;184;2;191660;3185
2021-06-25;LY;Libya;469;0;192129;3185
2021-06-26;LY;Libya;0;0;192129;3185
2021-06-27;LY;Libya;341;2;192470;3187
2021-06-28;LY;Libya;316;4;192786;3191
2021-06-29;LY;Libya;452;0;193238;3191
2021-06-30;LY;Libya;236;2;193474;3193
2021-07-01;LY;Libya;431;5;193905;3198
2020-03-04;LI;Liechtenstein;1;0;1;0
2020-03-05;LI;Liechtenstein;0;0;1;0
2020-03-06;LI;Liechtenstein;0;0;1;0
2020-03-07;LI;Liechtenstein;0;0;1;0
2020-03-08;LI;Liechtenstein;0;0;1;0
2020-03-09;LI;Liechtenstein;0;0;1;0
2020-03-10;LI;Liechtenstein;0;0;1;0
2020-03-11;LI;Liechtenstein;0;0;1;0
2020-03-12;LI;Liechtenstein;0;0;1;0
2020-03-13;LI;Liechtenstein;0;0;1;0
2020-03-14;LI;Liechtenstein;3;0;4;0
2020-03-15;LI;Liechtenstein;0;0;4;0
2020-03-16;LI;Liechtenstein;0;0;4;0
2020-03-17;LI;Liechtenstein;3;0;7;0
2020-03-18;LI;Liechtenstein;21;0;28;0
2020-03-19;LI;Liechtenstein;0;0;28;0
2020-03-20;LI;Liechtenstein;0;0;28;0
2020-03-21;LI;Liechtenstein;9;0;37;0
2020-03-22;LI;Liechtenstein;0;0;37;0
2020-03-23;LI;Liechtenstein;14;0;51;0
2020-03-24;LI;Liechtenstein;0;0;51;0
2020-03-25;LI;Liechtenstein;0;0;51;0
2020-03-26;LI;Liechtenstein;5;0;56;0
2020-03-27;LI;Liechtenstein;0;0;56;0
2020-03-28;LI;Liechtenstein;0;0;56;0
2020-03-29;LI;Liechtenstein;0;0;56;0
2020-03-30;LI;Liechtenstein;6;0;62;0
2020-03-31;LI;Liechtenstein;6;0;68;0
2020-04-01;LI;Liechtenstein;0;0;68;0
2020-04-02;LI;Liechtenstein;7;0;75;0
2020-04-03;LI;Liechtenstein;1;0;76;0
2020-04-04;LI;Liechtenstein;1;1;77;1
2020-04-05;LI;Liechtenstein;0;0;77;1
2020-04-06;LI;Liechtenstein;0;0;77;1
2020-04-07;LI;Liechtenstein;1;0;78;1
2020-04-08;LI;Liechtenstein;0;0;78;1
2020-04-09;LI;Liechtenstein;0;0;78;1
2020-04-10;LI;Liechtenstein;1;0;79;1
2020-04-11;LI;Liechtenstein;0;0;79;1
2020-04-12;LI;Liechtenstein;0;0;79;1
2020-04-13;LI;Liechtenstein;0;0;79;1
2020-04-14;LI;Liechtenstein;0;0;79;1
2020-04-15;LI;Liechtenstein;0;0;79;1
2020-04-16;LI;Liechtenstein;0;0;79;1
2020-04-17;LI;Liechtenstein;0;0;79;1
2020-04-18;LI;Liechtenstein;0;0;79;1
2020-04-19;LI;Liechtenstein;2;0;81;1
2020-04-20;LI;Liechtenstein;0;0;81;1
2020-04-21;LI;Liechtenstein;0;0;81;1
2020-04-22;LI;Liechtenstein;0;0;81;1
2020-04-23;LI;Liechtenstein;0;0;81;1
2020-04-24;LI;Liechtenstein;0;0;81;1
2020-04-25;LI;Liechtenstein;0;0;81;1
2020-04-26;LI;Liechtenstein;1;0;82;1
2020-04-27;LI;Liechtenstein;0;0;82;1
2020-04-28;LI;Liechtenstein;0;0;82;1
2020-04-29;LI;Liechtenstein;0;0;82;1
2020-04-30;LI;Liechtenstein;0;0;82;1
2020-05-01;LI;Liechtenstein;0;0;82;1
2020-05-02;LI;Liechtenstein;0;0;82;1
2020-05-03;LI;Liechtenstein;0;0;82;1
2020-05-04;LI;Liechtenstein;0;0;82;1
2020-05-05;LI;Liechtenstein;0;0;82;1
2020-05-06;LI;Liechtenstein;0;0;82;1
2020-05-07;LI;Liechtenstein;0;0;82;1
2020-05-08;LI;Liechtenstein;0;0;82;1
2020-05-09;LI;Liechtenstein;0;0;82;1
2020-05-10;LI;Liechtenstein;0;0;82;1
2020-05-11;LI;Liechtenstein;0;0;82;1
2020-05-12;LI;Liechtenstein;0;0;82;1
2020-05-13;LI;Liechtenstein;0;0;82;1
2020-05-14;LI;Liechtenstein;0;0;82;1
2020-05-15;LI;Liechtenstein;0;0;82;1
2020-05-16;LI;Liechtenstein;0;0;82;1
2020-05-17;LI;Liechtenstein;0;0;82;1
2020-05-18;LI;Liechtenstein;0;0;82;1
2020-05-19;LI;Liechtenstein;0;0;82;1
2020-05-20;LI;Liechtenstein;0;0;82;1
2020-05-21;LI;Liechtenstein;0;0;82;1
2020-05-22;LI;Liechtenstein;0;0;82;1
2020-05-23;LI;Liechtenstein;0;0;82;1
2020-05-24;LI;Liechtenstein;0;0;82;1
2020-05-25;LI;Liechtenstein;0;0;82;1
2020-05-26;LI;Liechtenstein;0;0;82;1
2020-05-27;LI;Liechtenstein;0;0;82;1
2020-05-28;LI;Liechtenstein;0;0;82;1
2020-05-29;LI;Liechtenstein;0;0;82;1
2020-05-30;LI;Liechtenstein;0;0;82;1
2020-05-31;LI;Liechtenstein;0;0;82;1
2020-06-01;LI;Liechtenstein;0;0;82;1
2020-06-02;LI;Liechtenstein;0;0;82;1
2020-06-03;LI;Liechtenstein;0;0;82;1
2020-06-04;LI;Liechtenstein;0;0;82;1
2020-06-05;LI;Liechtenstein;0;0;82;1
2020-06-06;LI;Liechtenstein;0;0;82;1
2020-06-07;LI;Liechtenstein;0;0;82;1
2020-06-08;LI;Liechtenstein;0;0;82;1
2020-06-09;LI;Liechtenstein;0;0;82;1
2020-06-10;LI;Liechtenstein;0;0;82;1
2020-06-11;LI;Liechtenstein;0;0;82;1
2020-06-12;LI;Liechtenstein;0;0;82;1
2020-06-13;LI;Liechtenstein;0;0;82;1
2020-06-14;LI;Liechtenstein;0;0;82;1
2020-06-15;LI;Liechtenstein;0;0;82;1
2020-06-16;LI;Liechtenstein;0;0;82;1
2020-06-17;LI;Liechtenstein;0;0;82;1
2020-06-18;LI;Liechtenstein;0;0;82;1
2020-06-19;LI;Liechtenstein;0;0;82;1
2020-06-20;LI;Liechtenstein;0;0;82;1
2020-06-21;LI;Liechtenstein;0;0;82;1
2020-06-22;LI;Liechtenstein;0;0;82;1
2020-06-23;LI;Liechtenstein;0;0;82;1
2020-06-24;LI;Liechtenstein;0;0;82;1
2020-06-25;LI;Liechtenstein;0;0;82;1
2020-06-26;LI;Liechtenstein;0;0;82;1
2020-06-27;LI;Liechtenstein;0;0;82;1
2020-06-28;LI;Liechtenstein;0;0;82;1
2020-06-29;LI;Liechtenstein;0;0;82;1
2020-06-30;LI;Liechtenstein;0;0;82;1
2020-07-01;LI;Liechtenstein;0;0;82;1
2020-07-02;LI;Liechtenstein;1;0;83;1
2020-07-03;LI;Liechtenstein;0;0;83;1
2020-07-04;LI;Liechtenstein;0;0;83;1
2020-07-05;LI;Liechtenstein;0;0;83;1
2020-07-06;LI;Liechtenstein;1;0;84;1
2020-07-07;LI;Liechtenstein;0;0;84;1
2020-07-08;LI;Liechtenstein;0;0;84;1
2020-07-09;LI;Liechtenstein;0;0;84;1
2020-07-10;LI;Liechtenstein;0;0;84;1
2020-07-11;LI;Liechtenstein;0;0;84;1
2020-07-12;LI;Liechtenstein;0;0;84;1
2020-07-13;LI;Liechtenstein;0;0;84;1
2020-07-14;LI;Liechtenstein;0;0;84;1
2020-07-15;LI;Liechtenstein;0;0;84;1
2020-07-16;LI;Liechtenstein;0;0;84;1
2020-07-17;LI;Liechtenstein;1;0;85;1
2020-07-18;LI;Liechtenstein;1;0;86;1
2020-07-19;LI;Liechtenstein;0;0;86;1
2020-07-20;LI;Liechtenstein;0;0;86;1
2020-07-21;LI;Liechtenstein;0;0;86;1
2020-07-22;LI;Liechtenstein;0;0;86;1
2020-07-23;LI;Liechtenstein;0;0;86;1
2020-07-24;LI;Liechtenstein;0;0;86;1
2020-07-25;LI;Liechtenstein;0;0;86;1
2020-07-26;LI;Liechtenstein;0;0;86;1
2020-07-27;LI;Liechtenstein;0;0;86;1
2020-07-28;LI;Liechtenstein;1;0;87;1
2020-07-29;LI;Liechtenstein;1;0;88;1
2020-07-30;LI;Liechtenstein;0;0;88;1
2020-07-31;LI;Liechtenstein;0;0;88;1
2020-08-01;LI;Liechtenstein;0;0;88;1
2020-08-02;LI;Liechtenstein;1;0;89;1
2020-08-03;LI;Liechtenstein;0;0;89;1
2020-08-04;LI;Liechtenstein;0;0;89;1
2020-08-05;LI;Liechtenstein;0;0;89;1
2020-08-06;LI;Liechtenstein;0;0;89;1
2020-08-07;LI;Liechtenstein;0;0;89;1
2020-08-08;LI;Liechtenstein;0;0;89;1
2020-08-09;LI;Liechtenstein;0;0;89;1
2020-08-10;LI;Liechtenstein;0;0;89;1
2020-08-11;LI;Liechtenstein;0;0;89;1
2020-08-12;LI;Liechtenstein;1;0;90;1
2020-08-13;LI;Liechtenstein;0;0;90;1
2020-08-14;LI;Liechtenstein;1;0;91;1
2020-08-15;LI;Liechtenstein;0;0;91;1
2020-08-16;LI;Liechtenstein;0;0;91;1
2020-08-17;LI;Liechtenstein;3;0;94;1
2020-08-18;LI;Liechtenstein;3;0;97;1
2020-08-19;LI;Liechtenstein;1;0;98;1
2020-08-20;LI;Liechtenstein;1;0;99;1
2020-08-21;LI;Liechtenstein;0;0;99;1
2020-08-22;LI;Liechtenstein;0;0;99;1
2020-08-23;LI;Liechtenstein;0;0;99;1
2020-08-24;LI;Liechtenstein;1;0;100;1
2020-08-25;LI;Liechtenstein;2;0;102;1
2020-08-26;LI;Liechtenstein;0;0;102;1
2020-08-27;LI;Liechtenstein;3;0;105;1
2020-08-28;LI;Liechtenstein;1;0;106;1
2020-08-29;LI;Liechtenstein;1;0;107;1
2020-08-30;LI;Liechtenstein;0;0;107;1
2020-08-31;LI;Liechtenstein;0;0;107;1
2020-09-01;LI;Liechtenstein;0;0;107;1
2020-09-02;LI;Liechtenstein;0;0;107;1
2020-09-03;LI;Liechtenstein;0;0;107;1
2020-09-04;LI;Liechtenstein;0;0;107;1
2020-09-05;LI;Liechtenstein;0;0;107;1
2020-09-06;LI;Liechtenstein;0;0;107;1
2020-09-07;LI;Liechtenstein;0;0;107;1
2020-09-08;LI;Liechtenstein;0;0;107;1
2020-09-09;LI;Liechtenstein;1;0;108;1
2020-09-10;LI;Liechtenstein;1;0;109;1
2020-09-11;LI;Liechtenstein;0;0;109;1
2020-09-12;LI;Liechtenstein;2;0;111;1
2020-09-13;LI;Liechtenstein;0;0;111;1
2020-09-14;LI;Liechtenstein;0;0;111;1
2020-09-15;LI;Liechtenstein;0;0;111;1
2020-09-16;LI;Liechtenstein;0;0;111;1
2020-09-17;LI;Liechtenstein;1;0;112;1
2020-09-18;LI;Liechtenstein;0;0;112;1
2020-09-19;LI;Liechtenstein;1;0;113;1
2020-09-20;LI;Liechtenstein;0;0;113;1
2020-09-21;LI;Liechtenstein;1;0;114;1
2020-09-22;LI;Liechtenstein;1;0;115;1
2020-09-23;LI;Liechtenstein;1;0;116;1
2020-09-24;LI;Liechtenstein;0;0;116;1
2020-09-25;LI;Liechtenstein;1;0;117;1
2020-09-26;LI;Liechtenstein;0;0;117;1
2020-09-27;LI;Liechtenstein;0;0;117;1
2020-09-28;LI;Liechtenstein;0;0;117;1
2020-09-29;LI;Liechtenstein;1;0;118;1
2020-09-30;LI;Liechtenstein;0;0;118;1
2020-10-01;LI;Liechtenstein;1;0;119;1
2020-10-02;LI;Liechtenstein;1;0;120;1
2020-10-03;LI;Liechtenstein;3;0;123;1
2020-10-04;LI;Liechtenstein;3;0;126;1
2020-10-05;LI;Liechtenstein;1;0;127;1
2020-10-06;LI;Liechtenstein;3;0;130;1
2020-10-07;LI;Liechtenstein;1;0;131;1
2020-10-08;LI;Liechtenstein;4;0;135;1
2020-10-09;LI;Liechtenstein;4;0;139;1
2020-10-10;LI;Liechtenstein;3;0;142;1
2020-10-11;LI;Liechtenstein;2;0;144;1
2020-10-12;LI;Liechtenstein;4;0;148;1
2020-10-13;LI;Liechtenstein;15;0;163;1
2020-10-14;LI;Liechtenstein;11;0;174;1
2020-10-15;LI;Liechtenstein;9;0;183;1
2020-10-16;LI;Liechtenstein;9;0;192;1
2020-10-17;LI;Liechtenstein;25;0;217;1
2020-10-18;LI;Liechtenstein;7;0;224;1
2020-10-19;LI;Liechtenstein;0;0;224;1
2020-10-20;LI;Liechtenstein;11;0;235;1
2020-10-21;LI;Liechtenstein;17;0;252;1
2020-10-22;LI;Liechtenstein;30;0;282;1
2020-10-23;LI;Liechtenstein;42;0;324;1
2020-10-24;LI;Liechtenstein;16;0;340;1
2020-10-25;LI;Liechtenstein;25;0;365;1
2020-10-26;LI;Liechtenstein;37;0;402;1
2020-10-27;LI;Liechtenstein;26;0;428;1
2020-10-28;LI;Liechtenstein;22;0;450;1
2020-10-29;LI;Liechtenstein;26;0;476;1
2020-10-30;LI;Liechtenstein;37;1;513;2
2020-10-31;LI;Liechtenstein;20;1;533;3
2020-11-01;LI;Liechtenstein;18;0;551;3
2020-11-02;LI;Liechtenstein;47;0;598;3
2020-11-03;LI;Liechtenstein;33;0;631;3
2020-11-04;LI;Liechtenstein;28;0;659;3
2020-11-05;LI;Liechtenstein;33;0;692;3
2020-11-06;LI;Liechtenstein;49;0;741;3
2020-11-07;LI;Liechtenstein;24;0;765;3
2020-11-08;LI;Liechtenstein;23;0;788;3
2020-11-09;LI;Liechtenstein;13;1;801;4
2020-11-10;LI;Liechtenstein;45;0;846;4
2020-11-11;LI;Liechtenstein;31;0;877;4
2020-11-12;LI;Liechtenstein;28;0;905;4
2020-11-13;LI;Liechtenstein;23;1;928;5
2020-11-14;LI;Liechtenstein;42;0;970;5
2020-11-15;LI;Liechtenstein;15;0;985;5
2020-11-16;LI;Liechtenstein;4;2;989;7
2020-11-17;LI;Liechtenstein;13;1;1002;8
2020-11-18;LI;Liechtenstein;49;0;1051;8
2020-11-19;LI;Liechtenstein;21;0;1072;8
2020-11-20;LI;Liechtenstein;22;0;1094;8
2020-11-21;LI;Liechtenstein;15;0;1109;8
2020-11-22;LI;Liechtenstein;3;0;1112;8
2020-11-23;LI;Liechtenstein;44;4;1156;12
2020-11-24;LI;Liechtenstein;2;1;1158;13
2020-11-25;LI;Liechtenstein;25;1;1183;14
2020-11-26;LI;Liechtenstein;25;0;1208;14
2020-11-27;LI;Liechtenstein;23;1;1231;15
2020-11-28;LI;Liechtenstein;22;0;1253;15
2020-11-29;LI;Liechtenstein;0;0;1253;15
2020-11-30;LI;Liechtenstein;17;1;1270;16
2020-12-01;LI;Liechtenstein;16;0;1286;16
2020-12-02;LI;Liechtenstein;32;0;1318;16
2020-12-03;LI;Liechtenstein;21;1;1339;17
2020-12-04;LI;Liechtenstein;12;0;1351;17
2020-12-05;LI;Liechtenstein;27;0;1378;17
2020-12-06;LI;Liechtenstein;18;0;1396;17
2020-12-07;LI;Liechtenstein;1;2;1397;19
2020-12-08;LI;Liechtenstein;7;0;1404;19
2020-12-09;LI;Liechtenstein;28;0;1432;19
2020-12-10;LI;Liechtenstein;9;0;1441;19
2020-12-11;LI;Liechtenstein;25;1;1466;20
2020-12-12;LI;Liechtenstein;16;0;1482;20
2020-12-13;LI;Liechtenstein;32;0;1514;20
2020-12-14;LI;Liechtenstein;52;0;1566;20
2020-12-15;LI;Liechtenstein;13;1;1579;21
2020-12-16;LI;Liechtenstein;21;0;1600;21
2020-12-17;LI;Liechtenstein;35;0;1635;21
2020-12-18;LI;Liechtenstein;41;2;1676;23
2020-12-19;LI;Liechtenstein;35;2;1711;25
2020-12-20;LI;Liechtenstein;47;0;1758;25
2020-12-21;LI;Liechtenstein;26;2;1784;27
2020-12-22;LI;Liechtenstein;42;1;1826;28
2020-12-23;LI;Liechtenstein;32;2;1858;30
2020-12-24;LI;Liechtenstein;62;0;1920;30
2020-12-25;LI;Liechtenstein;60;0;1980;30
2020-12-26;LI;Liechtenstein;20;1;2000;31
2020-12-27;LI;Liechtenstein;18;0;2018;31
2020-12-28;LI;Liechtenstein;20;4;2038;35
2020-12-29;LI;Liechtenstein;31;3;2069;38
2020-12-30;LI;Liechtenstein;35;1;2104;39
2020-12-31;LI;Liechtenstein;32;0;2136;39
2021-01-01;LI;Liechtenstein;39;0;2175;39
2021-01-02;LI;Liechtenstein;27;0;2202;39
2021-01-03;LI;Liechtenstein;20;0;2222;39
2021-01-04;LI;Liechtenstein;2;2;2224;41
2021-01-05;LI;Liechtenstein;22;4;2246;45
2021-01-06;LI;Liechtenstein;49;3;2295;48
2021-01-07;LI;Liechtenstein;14;0;2309;48
2021-01-08;LI;Liechtenstein;2;0;2311;48
2021-01-09;LI;Liechtenstein;18;1;2329;49
2021-01-10;LI;Liechtenstein;11;0;2340;49
2021-01-11;LI;Liechtenstein;6;0;2346;49
2021-01-12;LI;Liechtenstein;9;0;2355;49
2021-01-13;LI;Liechtenstein;15;0;2370;49
2021-01-14;LI;Liechtenstein;5;0;2375;49
2021-01-15;LI;Liechtenstein;3;0;2378;49
2021-01-16;LI;Liechtenstein;5;0;2383;49
2021-01-17;LI;Liechtenstein;6;0;2389;49
2021-01-18;LI;Liechtenstein;6;1;2395;50
2021-01-19;LI;Liechtenstein;3;0;2398;50
2021-01-20;LI;Liechtenstein;7;0;2405;50
2021-01-21;LI;Liechtenstein;10;1;2415;51
2021-01-22;LI;Liechtenstein;17;1;2432;52
2021-01-23;LI;Liechtenstein;5;0;2437;52
2021-01-24;LI;Liechtenstein;4;0;2441;52
2021-01-25;LI;Liechtenstein;13;0;2454;52
2021-01-26;LI;Liechtenstein;1;0;2455;52
2021-01-27;LI;Liechtenstein;3;0;2458;52
2021-01-28;LI;Liechtenstein;17;0;2475;52
2021-01-29;LI;Liechtenstein;9;0;2484;52
2021-01-30;LI;Liechtenstein;9;0;2493;52
2021-01-31;LI;Liechtenstein;0;0;2493;52
2021-02-01;LI;Liechtenstein;4;0;2497;52
2021-02-02;LI;Liechtenstein;0;0;2497;52
2021-02-03;LI;Liechtenstein;12;0;2509;52
2021-02-04;LI;Liechtenstein;4;0;2513;52
2021-02-05;LI;Liechtenstein;5;0;2518;52
2021-02-06;LI;Liechtenstein;0;0;2518;52
2021-02-07;LI;Liechtenstein;5;0;2523;52
2021-02-08;LI;Liechtenstein;3;0;2526;52
2021-02-09;LI;Liechtenstein;1;0;2527;52
2021-02-10;LI;Liechtenstein;5;0;2532;52
2021-02-11;LI;Liechtenstein;2;0;2534;52
2021-02-12;LI;Liechtenstein;3;0;2537;52
2021-02-13;LI;Liechtenstein;1;0;2538;52
2021-02-14;LI;Liechtenstein;1;0;2539;52
2021-02-15;LI;Liechtenstein;1;1;2540;53
2021-02-16;LI;Liechtenstein;0;0;2540;53
2021-02-17;LI;Liechtenstein;0;1;2540;54
2021-02-18;LI;Liechtenstein;2;0;2542;54
2021-02-19;LI;Liechtenstein;1;0;2543;54
2021-02-20;LI;Liechtenstein;2;0;2545;54
2021-02-21;LI;Liechtenstein;1;0;2546;54
2021-02-22;LI;Liechtenstein;4;0;2550;54
2021-02-23;LI;Liechtenstein;3;0;2553;54
2021-02-24;LI;Liechtenstein;0;0;2553;54
2021-02-25;LI;Liechtenstein;5;0;2558;54
2021-02-26;LI;Liechtenstein;6;0;2564;54
2021-02-27;LI;Liechtenstein;2;0;2566;54
2021-02-28;LI;Liechtenstein;1;0;2567;54
2021-03-01;LI;Liechtenstein;8;0;2575;54
2021-03-02;LI;Liechtenstein;1;0;2576;54
2021-03-03;LI;Liechtenstein;1;0;2577;54
2021-03-04;LI;Liechtenstein;5;0;2582;54
2021-03-05;LI;Liechtenstein;6;0;2588;54
2021-03-06;LI;Liechtenstein;1;0;2589;54
2021-03-07;LI;Liechtenstein;1;0;2590;54
2021-03-08;LI;Liechtenstein;2;0;2592;54
2021-03-09;LI;Liechtenstein;2;1;2594;55
2021-03-10;LI;Liechtenstein;0;0;2594;55
2021-03-11;LI;Liechtenstein;2;0;2596;55
2021-03-12;LI;Liechtenstein;5;0;2601;55
2021-03-13;LI;Liechtenstein;1;0;2602;55
2021-03-14;LI;Liechtenstein;10;0;2612;55
2021-03-15;LI;Liechtenstein;0;0;2612;55
2021-03-16;LI;Liechtenstein;3;1;2615;56
2021-03-17;LI;Liechtenstein;1;0;2616;56
2021-03-18;LI;Liechtenstein;4;0;2620;56
2021-03-19;LI;Liechtenstein;2;0;2622;56
2021-03-20;LI;Liechtenstein;5;0;2627;56
2021-03-21;LI;Liechtenstein;1;0;2628;56
2021-03-22;LI;Liechtenstein;4;0;2632;56
2021-03-23;LI;Liechtenstein;2;0;2634;56
2021-03-24;LI;Liechtenstein;2;0;2636;56
2021-03-25;LI;Liechtenstein;6;0;2642;56
2021-03-26;LI;Liechtenstein;3;0;2645;56
2021-03-27;LI;Liechtenstein;4;0;2649;56
2021-03-28;LI;Liechtenstein;9;0;2658;56
2021-03-29;LI;Liechtenstein;6;0;2664;56
2021-03-30;LI;Liechtenstein;0;0;2664;56
2021-03-31;LI;Liechtenstein;6;0;2670;56
2021-04-01;LI;Liechtenstein;5;0;2675;56
2021-04-02;LI;Liechtenstein;3;0;2678;56
2021-04-03;LI;Liechtenstein;1;0;2679;56
2021-04-04;LI;Liechtenstein;6;0;2685;56
2021-04-05;LI;Liechtenstein;12;0;2697;56
2021-04-06;LI;Liechtenstein;0;0;2697;56
2021-04-07;LI;Liechtenstein;5;0;2702;56
2021-04-08;LI;Liechtenstein;12;0;2714;56
2021-04-09;LI;Liechtenstein;8;0;2722;56
2021-04-10;LI;Liechtenstein;16;0;2738;56
2021-04-11;LI;Liechtenstein;15;0;2753;56
2021-04-12;LI;Liechtenstein;1;0;2754;56
2021-04-13;LI;Liechtenstein;14;0;2768;56
2021-04-14;LI;Liechtenstein;2;0;2770;56
2021-04-15;LI;Liechtenstein;10;0;2780;56
2021-04-16;LI;Liechtenstein;10;0;2790;56
2021-04-17;LI;Liechtenstein;14;0;2804;56
2021-04-18;LI;Liechtenstein;9;0;2813;56
2021-04-19;LI;Liechtenstein;10;0;2823;56
2021-04-20;LI;Liechtenstein;13;0;2836;56
2021-04-21;LI;Liechtenstein;13;0;2849;56
2021-04-22;LI;Liechtenstein;2;1;2851;57
2021-04-23;LI;Liechtenstein;4;0;2855;57
2021-04-24;LI;Liechtenstein;11;0;2866;57
2021-04-25;LI;Liechtenstein;18;0;2884;57
2021-04-26;LI;Liechtenstein;1;0;2885;57
2021-04-27;LI;Liechtenstein;18;0;2903;57
2021-04-28;LI;Liechtenstein;5;0;2908;57
2021-04-29;LI;Liechtenstein;13;0;2921;57
2021-04-30;LI;Liechtenstein;5;0;2926;57
2021-05-01;LI;Liechtenstein;10;0;2936;57
2021-05-02;LI;Liechtenstein;4;0;2940;57
2021-05-03;LI;Liechtenstein;6;0;2946;57
2021-05-04;LI;Liechtenstein;2;0;2948;57
2021-05-05;LI;Liechtenstein;8;0;2956;57
2021-05-06;LI;Liechtenstein;5;0;2961;57
2021-05-07;LI;Liechtenstein;2;1;2963;58
2021-05-08;LI;Liechtenstein;4;0;2967;58
2021-05-09;LI;Liechtenstein;3;0;2970;58
2021-05-10;LI;Liechtenstein;4;0;2974;58
2021-05-11;LI;Liechtenstein;1;0;2975;58
2021-05-12;LI;Liechtenstein;3;0;2978;58
2021-05-13;LI;Liechtenstein;2;0;2980;58
2021-05-14;LI;Liechtenstein;1;0;2981;58
2021-05-15;LI;Liechtenstein;3;0;2984;58
2021-05-16;LI;Liechtenstein;1;0;2985;58
2021-05-17;LI;Liechtenstein;5;0;2990;58
2021-05-18;LI;Liechtenstein;2;0;2992;58
2021-05-19;LI;Liechtenstein;1;0;2993;58
2021-05-20;LI;Liechtenstein;1;0;2994;58
2021-05-21;LI;Liechtenstein;3;0;2997;58
2021-05-22;LI;Liechtenstein;1;0;2998;58
2021-05-23;LI;Liechtenstein;2;0;3000;58
2021-05-24;LI;Liechtenstein;0;0;3000;58
2021-05-25;LI;Liechtenstein;2;0;3002;58
2021-05-26;LI;Liechtenstein;0;0;3002;58
2021-05-27;LI;Liechtenstein;4;0;3006;58
2021-05-28;LI;Liechtenstein;0;0;3006;58
2021-05-29;LI;Liechtenstein;2;0;3008;58
2021-05-30;LI;Liechtenstein;0;0;3008;58
2021-05-31;LI;Liechtenstein;4;0;3012;58
2021-06-01;LI;Liechtenstein;0;0;3012;58
2021-06-02;LI;Liechtenstein;4;0;3016;58
2021-06-03;LI;Liechtenstein;1;0;3017;58
2021-06-04;LI;Liechtenstein;2;0;3019;58
2021-06-05;LI;Liechtenstein;1;0;3020;58
2021-06-06;LI;Liechtenstein;2;0;3022;58
2021-06-07;LI;Liechtenstein;0;0;3022;58
2021-06-08;LI;Liechtenstein;0;0;3022;58
2021-06-09;LI;Liechtenstein;0;0;3022;58
2021-06-10;LI;Liechtenstein;1;0;3023;58
2021-06-11;LI;Liechtenstein;1;1;3024;59
2021-06-12;LI;Liechtenstein;2;0;3026;59
2021-06-13;LI;Liechtenstein;0;0;3026;59
2021-06-14;LI;Liechtenstein;0;0;3026;59
2021-06-15;LI;Liechtenstein;0;0;3026;59
2021-06-16;LI;Liechtenstein;0;0;3026;59
2021-06-17;LI;Liechtenstein;0;0;3026;59
2021-06-18;LI;Liechtenstein;0;0;3026;59
2021-06-19;LI;Liechtenstein;0;0;3026;59
2021-06-20;LI;Liechtenstein;0;0;3026;59
2021-06-21;LI;Liechtenstein;2;0;3028;59
2021-06-22;LI;Liechtenstein;0;0;3028;59
2021-06-23;LI;Liechtenstein;2;0;3030;59
2021-06-24;LI;Liechtenstein;1;0;3031;59
2021-06-25;LI;Liechtenstein;1;0;3032;59
2021-06-26;LI;Liechtenstein;0;0;3032;59
2021-06-27;LI;Liechtenstein;0;0;3032;59
2021-06-28;LI;Liechtenstein;2;0;3034;59
2021-06-29;LI;Liechtenstein;0;0;3034;59
2021-06-30;LI;Liechtenstein;2;0;3036;59
2021-07-01;LI;Liechtenstein;3;0;3039;59
2020-02-29;LT;Lithuania;1;0;1;0
2020-03-01;LT;Lithuania;0;0;1;0
2020-03-02;LT;Lithuania;0;0;1;0
2020-03-03;LT;Lithuania;0;0;1;0
2020-03-04;LT;Lithuania;0;0;1;0
2020-03-05;LT;Lithuania;0;0;1;0
2020-03-06;LT;Lithuania;0;0;1;0
2020-03-07;LT;Lithuania;0;0;1;0
2020-03-08;LT;Lithuania;0;0;1;0
2020-03-09;LT;Lithuania;0;0;1;0
2020-03-10;LT;Lithuania;0;0;1;0
2020-03-11;LT;Lithuania;2;0;3;0
2020-03-12;LT;Lithuania;0;0;3;0
2020-03-13;LT;Lithuania;1;0;4;0
2020-03-14;LT;Lithuania;2;0;6;0
2020-03-15;LT;Lithuania;3;0;9;0
2020-03-16;LT;Lithuania;3;0;12;0
2020-03-17;LT;Lithuania;7;0;19;0
2020-03-18;LT;Lithuania;8;0;27;0
2020-03-19;LT;Lithuania;9;0;36;0
2020-03-20;LT;Lithuania;11;0;47;0
2020-03-21;LT;Lithuania;22;0;69;0
2020-03-22;LT;Lithuania;42;0;111;0
2020-03-23;LT;Lithuania;17;0;128;0
2020-03-24;LT;Lithuania;38;1;166;1
2020-03-25;LT;Lithuania;42;1;208;2
2020-03-26;LT;Lithuania;55;1;263;3
2020-03-27;LT;Lithuania;29;1;292;4
2020-03-28;LT;Lithuania;47;0;339;4
2020-03-29;LT;Lithuania;39;0;378;4
2020-03-30;LT;Lithuania;46;0;424;4
2020-03-31;LT;Lithuania;44;0;468;4
2020-04-01;LT;Lithuania;44;2;512;6
2020-04-02;LT;Lithuania;67;0;579;6
2020-04-03;LT;Lithuania;52;0;631;6
2020-04-04;LT;Lithuania;52;1;683;7
2020-04-05;LT;Lithuania;33;1;716;8
2020-04-06;LT;Lithuania;34;2;750;10
2020-04-07;LT;Lithuania;33;1;783;11
2020-04-08;LT;Lithuania;38;0;821;11
2020-04-09;LT;Lithuania;37;0;858;11
2020-04-10;LT;Lithuania;38;1;896;12
2020-04-11;LT;Lithuania;30;1;926;13
2020-04-12;LT;Lithuania;26;1;952;14
2020-04-13;LT;Lithuania;18;1;970;15
2020-04-14;LT;Lithuania;7;1;977;16
2020-04-15;LT;Lithuania;18;4;995;20
2020-04-16;LT;Lithuania;27;0;1022;20
2020-04-17;LT;Lithuania;28;1;1050;21
2020-04-18;LT;Lithuania;41;1;1091;22
2020-04-19;LT;Lithuania;62;1;1153;23
2020-04-20;LT;Lithuania;20;3;1173;26
2020-04-21;LT;Lithuania;53;0;1226;26
2020-04-22;LT;Lithuania;24;1;1250;27
2020-04-23;LT;Lithuania;22;0;1272;27
2020-04-24;LT;Lithuania;19;1;1291;28
2020-04-25;LT;Lithuania;10;1;1301;29
2020-04-26;LT;Lithuania;15;2;1316;31
2020-04-27;LT;Lithuania;12;1;1328;32
2020-04-28;LT;Lithuania;9;0;1337;32
2020-04-29;LT;Lithuania;27;0;1364;32
2020-04-30;LT;Lithuania;11;0;1375;32
2020-05-01;LT;Lithuania;14;0;1389;32
2020-05-02;LT;Lithuania;5;1;1394;33
2020-05-03;LT;Lithuania;5;0;1399;33
2020-05-04;LT;Lithuania;8;0;1407;33
2020-05-05;LT;Lithuania;3;0;1410;33
2020-05-06;LT;Lithuania;6;1;1416;34
2020-05-07;LT;Lithuania;5;1;1421;35
2020-05-08;LT;Lithuania;9;0;1430;35
2020-05-09;LT;Lithuania;29;0;1459;35
2020-05-10;LT;Lithuania;12;1;1471;36
2020-05-11;LT;Lithuania;8;0;1479;36
2020-05-12;LT;Lithuania;9;3;1488;39
2020-05-13;LT;Lithuania;14;0;1502;39
2020-05-14;LT;Lithuania;9;0;1511;39
2020-05-15;LT;Lithuania;10;2;1521;41
2020-05-16;LT;Lithuania;15;1;1536;42
2020-05-17;LT;Lithuania;9;1;1545;43
2020-05-18;LT;Lithuania;6;2;1551;45
2020-05-19;LT;Lithuania;8;0;1559;45
2020-05-20;LT;Lithuania;21;1;1580;46
2020-05-21;LT;Lithuania;12;0;1592;46
2020-05-22;LT;Lithuania;6;0;1598;46
2020-05-23;LT;Lithuania;14;1;1612;47
2020-05-24;LT;Lithuania;6;1;1618;48
2020-05-25;LT;Lithuania;10;1;1628;49
2020-05-26;LT;Lithuania;4;2;1632;51
2020-05-27;LT;Lithuania;8;0;1640;51
2020-05-28;LT;Lithuania;9;1;1649;52
2020-05-29;LT;Lithuania;5;0;1654;52
2020-05-30;LT;Lithuania;8;2;1662;54
2020-05-31;LT;Lithuania;5;0;1667;54
2020-06-01;LT;Lithuania;4;1;1671;55
2020-06-02;LT;Lithuania;5;0;1676;55
2020-06-03;LT;Lithuania;3;0;1679;55
2020-06-04;LT;Lithuania;5;0;1684;55
2020-06-05;LT;Lithuania;5;0;1689;55
2020-06-06;LT;Lithuania;11;0;1700;55
2020-06-07;LT;Lithuania;9;1;1709;56
2020-06-08;LT;Lithuania;7;2;1716;58
2020-06-09;LT;Lithuania;6;0;1722;58
2020-06-10;LT;Lithuania;6;0;1728;58
2020-06-11;LT;Lithuania;19;0;1747;58
2020-06-12;LT;Lithuania;4;1;1751;59
2020-06-13;LT;Lithuania;7;0;1758;59
2020-06-14;LT;Lithuania;5;0;1763;59
2020-06-15;LT;Lithuania;5;1;1768;60
2020-06-16;LT;Lithuania;3;0;1771;60
2020-06-17;LT;Lithuania;2;0;1773;60
2020-06-18;LT;Lithuania;6;0;1779;60
2020-06-19;LT;Lithuania;8;0;1787;60
2020-06-20;LT;Lithuania;3;0;1790;60
2020-06-21;LT;Lithuania;3;0;1793;60
2020-06-22;LT;Lithuania;3;0;1796;60
2020-06-23;LT;Lithuania;2;1;1798;61
2020-06-24;LT;Lithuania;1;0;1799;61
2020-06-25;LT;Lithuania;2;0;1801;61
2020-06-26;LT;Lithuania;2;0;1803;61
2020-06-27;LT;Lithuania;5;0;1808;61
2020-06-28;LT;Lithuania;2;0;1810;61
2020-06-29;LT;Lithuania;1;0;1811;61
2020-06-30;LT;Lithuania;1;0;1812;61
2020-07-01;LT;Lithuania;1;0;1813;61
2020-07-02;LT;Lithuania;7;1;1820;62
2020-07-03;LT;Lithuania;3;0;1823;62
2020-07-04;LT;Lithuania;3;0;1826;62
2020-07-05;LT;Lithuania;5;0;1831;62
2020-07-06;LT;Lithuania;5;0;1836;62
2020-07-07;LT;Lithuania;3;0;1839;62
2020-07-08;LT;Lithuania;10;0;1849;62
2020-07-09;LT;Lithuania;3;0;1852;62
2020-07-10;LT;Lithuania;4;0;1856;62
2020-07-11;LT;Lithuania;4;0;1860;62
2020-07-12;LT;Lithuania;4;0;1864;62
2020-07-13;LT;Lithuania;5;0;1869;62
2020-07-14;LT;Lithuania;1;0;1870;62
2020-07-15;LT;Lithuania;21;0;1891;62
2020-07-16;LT;Lithuania;6;0;1897;62
2020-07-17;LT;Lithuania;6;0;1903;62
2020-07-18;LT;Lithuania;7;1;1910;63
2020-07-19;LT;Lithuania;18;0;1928;63
2020-07-20;LT;Lithuania;14;0;1942;63
2020-07-21;LT;Lithuania;2;0;1944;63
2020-07-22;LT;Lithuania;2;0;1946;63
2020-07-23;LT;Lithuania;10;0;1956;63
2020-07-24;LT;Lithuania;26;0;1982;63
2020-07-25;LT;Lithuania;14;0;1996;63
2020-07-26;LT;Lithuania;7;0;2003;63
2020-07-27;LT;Lithuania;11;0;2014;63
2020-07-28;LT;Lithuania;8;0;2022;63
2020-07-29;LT;Lithuania;15;0;2037;63
2020-07-30;LT;Lithuania;19;0;2056;63
2020-07-31;LT;Lithuania;13;0;2069;63
2020-08-01;LT;Lithuania;18;0;2087;63
2020-08-02;LT;Lithuania;17;0;2104;63
2020-08-03;LT;Lithuania;10;0;2114;63
2020-08-04;LT;Lithuania;17;0;2131;63
2020-08-05;LT;Lithuania;10;1;2141;64
2020-08-06;LT;Lithuania;24;0;2165;64
2020-08-07;LT;Lithuania;24;0;2189;64
2020-08-08;LT;Lithuania;36;0;2225;64
2020-08-09;LT;Lithuania;22;0;2247;64
2020-08-10;LT;Lithuania;12;0;2259;64
2020-08-11;LT;Lithuania;18;0;2277;64
2020-08-12;LT;Lithuania;26;0;2303;64
2020-08-13;LT;Lithuania;21;0;2324;64
2020-08-14;LT;Lithuania;22;0;2346;64
2020-08-15;LT;Lithuania;33;0;2379;64
2020-08-16;LT;Lithuania;30;0;2409;64
2020-08-17;LT;Lithuania;21;0;2430;64
2020-08-18;LT;Lithuania;37;0;2467;64
2020-08-19;LT;Lithuania;22;0;2489;64
2020-08-20;LT;Lithuania;32;1;2521;65
2020-08-21;LT;Lithuania;37;1;2558;66
2020-08-22;LT;Lithuania;30;1;2588;67
2020-08-23;LT;Lithuania;41;0;2629;67
2020-08-24;LT;Lithuania;38;1;2667;68
2020-08-25;LT;Lithuania;21;0;2688;68
2020-08-26;LT;Lithuania;32;0;2720;68
2020-08-27;LT;Lithuania;36;0;2756;68
2020-08-28;LT;Lithuania;48;1;2804;69
2020-08-29;LT;Lithuania;29;0;2833;69
2020-08-30;LT;Lithuania;35;0;2868;69
2020-08-31;LT;Lithuania;32;0;2900;69
2020-09-01;LT;Lithuania;23;0;2923;69
2020-09-02;LT;Lithuania;29;0;2952;69
2020-09-03;LT;Lithuania;20;0;2972;69
2020-09-04;LT;Lithuania;26;0;2998;69
2020-09-05;LT;Lithuania;36;0;3034;69
2020-09-06;LT;Lithuania;43;0;3077;69
2020-09-07;LT;Lithuania;17;0;3094;69
2020-09-08;LT;Lithuania;32;0;3126;69
2020-09-09;LT;Lithuania;32;0;3158;69
2020-09-10;LT;Lithuania;36;0;3194;69
2020-09-11;LT;Lithuania;44;1;3238;70
2020-09-12;LT;Lithuania;53;0;3291;70
2020-09-13;LT;Lithuania;39;1;3330;71
2020-09-14;LT;Lithuania;51;0;3381;71
2020-09-15;LT;Lithuania;11;0;3392;71
2020-09-16;LT;Lithuania;45;0;3437;71
2020-09-17;LT;Lithuania;62;0;3499;71
2020-09-18;LT;Lithuania;61;0;3560;71
2020-09-19;LT;Lithuania;99;0;3659;71
2020-09-20;LT;Lithuania;80;0;3739;71
2020-09-21;LT;Lithuania;70;0;3809;71
2020-09-22;LT;Lithuania;45;0;3854;71
2020-09-23;LT;Lithuania;73;1;3927;72
2020-09-24;LT;Lithuania;138;2;4065;74
2020-09-25;LT;Lithuania;114;0;4179;74
2020-09-26;LT;Lithuania;111;0;4290;74
2020-09-27;LT;Lithuania;91;2;4381;76
2020-09-28;LT;Lithuania;104;1;4485;77
2020-09-29;LT;Lithuania;88;0;4573;77
2020-09-30;LT;Lithuania;115;0;4688;77
2020-10-01;LT;Lithuania;91;0;4779;77
2020-10-02;LT;Lithuania;171;1;4950;78
2020-10-03;LT;Lithuania;125;2;5075;80
2020-10-04;LT;Lithuania;105;1;5180;81
2020-10-05;LT;Lithuania;99;1;5279;82
2020-10-06;LT;Lithuania;80;2;5359;84
2020-10-07;LT;Lithuania;115;1;5474;85
2020-10-08;LT;Lithuania;142;1;5616;86
2020-10-09;LT;Lithuania;133;1;5749;87
2020-10-10;LT;Lithuania;204;0;5953;87
2020-10-11;LT;Lithuania;160;2;6113;89
2020-10-12;LT;Lithuania;126;0;6239;89
2020-10-13;LT;Lithuania;118;1;6357;90
2020-10-14;LT;Lithuania;137;4;6494;94
2020-10-15;LT;Lithuania;255;0;6749;94
2020-10-16;LT;Lithuania;281;3;7030;97
2020-10-17;LT;Lithuania;228;1;7258;98
2020-10-18;LT;Lithuania;253;2;7511;100
2020-10-19;LT;Lithuania;207;2;7718;102
2020-10-20;LT;Lithuania;203;3;7921;105
2020-10-21;LT;Lithuania;313;3;8234;108
2020-10-22;LT;Lithuania;427;4;8661;112
2020-10-23;LT;Lithuania;445;3;9106;115
2020-10-24;LT;Lithuania;480;1;9586;116
2020-10-25;LT;Lithuania;597;6;10183;122
2020-10-26;LT;Lithuania;765;2;10948;124
2020-10-27;LT;Lithuania;423;5;11371;129
2020-10-28;LT;Lithuania;771;5;12142;134
2020-10-29;LT;Lithuania;948;4;13090;138
2020-10-30;LT;Lithuania;725;6;13815;144
2020-10-31;LT;Lithuania;1000;8;14815;152
2020-11-01;LT;Lithuania;883;3;15698;155
2020-11-02;LT;Lithuania;834;4;16532;159
2020-11-03;LT;Lithuania;893;11;17425;170
2020-11-04;LT;Lithuania;653;6;18078;176
2020-11-05;LT;Lithuania;992;2;19070;178
2020-11-06;LT;Lithuania;1650;7;20720;185
2020-11-07;LT;Lithuania;1940;10;22660;195
2020-11-08;LT;Lithuania;1976;9;24636;204
2020-11-09;LT;Lithuania;1038;8;25674;212
2020-11-10;LT;Lithuania;1108;17;26782;229
2020-11-11;LT;Lithuania;1433;10;28215;239
2020-11-12;LT;Lithuania;1554;11;29769;250
2020-11-13;LT;Lithuania;2057;14;31826;264
2020-11-14;LT;Lithuania;1525;17;33351;281
2020-11-15;LT;Lithuania;1377;14;34728;295
2020-11-16;LT;Lithuania;1148;14;35876;309
2020-11-17;LT;Lithuania;966;20;36842;329
2020-11-18;LT;Lithuania;1941;21;38783;350
2020-11-19;LT;Lithuania;1669;23;40452;373
2020-11-20;LT;Lithuania;2269;19;42721;392
2020-11-21;LT;Lithuania;1978;20;44699;412
2020-11-22;LT;Lithuania;2309;27;47008;439
2020-11-23;LT;Lithuania;1189;20;48197;459
2020-11-24;LT;Lithuania;1171;18;49368;477
2020-11-25;LT;Lithuania;2288;22;51656;499
2020-11-26;LT;Lithuania;2099;27;53755;526
2020-11-27;LT;Lithuania;2330;23;56085;549
2020-11-28;LT;Lithuania;2126;22;58211;571
2020-11-29;LT;Lithuania;1965;22;60176;593
2020-11-30;LT;Lithuania;1135;27;61311;620
2020-12-01;LT;Lithuania;1200;21;62511;641
2020-12-02;LT;Lithuania;2110;34;64621;675
2020-12-03;LT;Lithuania;2460;19;67081;694
2020-12-04;LT;Lithuania;2519;38;69600;732
2020-12-05;LT;Lithuania;2863;34;72463;766
2020-12-06;LT;Lithuania;2217;24;74680;790
2020-12-07;LT;Lithuania;1391;44;76071;834
2020-12-08;LT;Lithuania;1405;25;77476;859
2020-12-09;LT;Lithuania;3139;27;80615;886
2020-12-10;LT;Lithuania;3344;17;83959;903
2020-12-11;LT;Lithuania;3107;35;87066;938
2020-12-12;LT;Lithuania;3346;47;90412;985
2020-12-13;LT;Lithuania;2843;54;93255;1039
2020-12-14;LT;Lithuania;1923;28;95178;1067
2020-12-15;LT;Lithuania;1516;45;96694;1112
2020-12-16;LT;Lithuania;3479;25;100173;1137
2020-12-17;LT;Lithuania;3225;43;103398;1180
2020-12-18;LT;Lithuania;3247;39;106645;1219
2020-12-19;LT;Lithuania;3344;46;109989;1265
2020-12-20;LT;Lithuania;2923;28;112912;1293
2020-12-21;LT;Lithuania;2135;46;115047;1339
2020-12-22;LT;Lithuania;2039;56;117086;1395
2020-12-23;LT;Lithuania;3804;35;120890;1430
2020-12-24;LT;Lithuania;3966;36;124856;1466
2020-12-25;LT;Lithuania;2691;44;127547;1510
2020-12-26;LT;Lithuania;2367;61;129914;1571
2020-12-27;LT;Lithuania;1687;42;131601;1613
2020-12-28;LT;Lithuania;1794;39;133395;1652
2020-12-29;LT;Lithuania;2108;43;135503;1695
2020-12-30;LT;Lithuania;3984;45;139487;1740
2020-12-31;LT;Lithuania;2468;56;141955;1796
2021-01-01;LT;Lithuania;3475;41;145430;1837
2021-01-02;LT;Lithuania;1507;51;146937;1888
2021-01-03;LT;Lithuania;1265;50;148202;1938
2021-01-04;LT;Lithuania;1377;37;149579;1975
2021-01-05;LT;Lithuania;1641;40;151220;2015
2021-01-06;LT;Lithuania;2787;34;154007;2049
2021-01-07;LT;Lithuania;2409;43;156416;2092
2021-01-08;LT;Lithuania;2058;41;158474;2133
2021-01-09;LT;Lithuania;1764;41;160238;2174
2021-01-10;LT;Lithuania;1503;29;161741;2203
2021-01-11;LT;Lithuania;774;43;162515;2246
2021-01-12;LT;Lithuania;1012;34;163527;2280
2021-01-13;LT;Lithuania;1764;37;165291;2317
2021-01-14;LT;Lithuania;1445;33;166736;2350
2021-01-15;LT;Lithuania;1224;35;167960;2385
2021-01-16;LT;Lithuania;1234;34;169194;2419
2021-01-17;LT;Lithuania;842;31;170036;2450
2021-01-18;LT;Lithuania;477;26;170513;2476
2021-01-19;LT;Lithuania;867;22;171380;2498
2021-01-20;LT;Lithuania;1232;25;172612;2523
2021-01-21;LT;Lithuania;1277;38;173889;2561
2021-01-22;LT;Lithuania;1033;36;174922;2597
2021-01-23;LT;Lithuania;1007;34;175929;2631
2021-01-24;LT;Lithuania;773;23;176702;2654
2021-01-25;LT;Lithuania;541;20;177243;2674
2021-01-26;LT;Lithuania;691;17;177934;2691
2021-01-27;LT;Lithuania;1283;29;179217;2720
2021-01-28;LT;Lithuania;943;29;180160;2749
2021-01-29;LT;Lithuania;859;17;181019;2766
2021-01-30;LT;Lithuania;721;25;181740;2791
2021-01-31;LT;Lithuania;803;17;182543;2808
2021-02-01;LT;Lithuania;355;22;182898;2830
2021-02-02;LT;Lithuania;546;17;183444;2847
2021-02-03;LT;Lithuania;764;20;184208;2867
2021-02-04;LT;Lithuania;740;18;184948;2885
2021-02-05;LT;Lithuania;653;23;185601;2908
2021-02-06;LT;Lithuania;677;19;186278;2927
2021-02-07;LT;Lithuania;492;10;186770;2937
2021-02-08;LT;Lithuania;269;18;187039;2955
2021-02-09;LT;Lithuania;382;17;187421;2972
2021-02-10;LT;Lithuania;570;16;187991;2988
2021-02-11;LT;Lithuania;1067;25;189058;3013
2021-02-12;LT;Lithuania;607;25;189665;3038
2021-02-13;LT;Lithuania;576;19;190241;3057
2021-02-14;LT;Lithuania;483;13;190724;3070
2021-02-15;LT;Lithuania;213;10;190937;3080
2021-02-16;LT;Lithuania;327;15;191264;3095
2021-02-17;LT;Lithuania;557;18;191821;3113
2021-02-18;LT;Lithuania;372;16;192193;3129
2021-02-19;LT;Lithuania;793;16;192986;3145
2021-02-20;LT;Lithuania;576;17;193562;3162
2021-02-21;LT;Lithuania;489;9;194051;3171
2021-02-22;LT;Lithuania;282;7;194333;3178
2021-02-23;LT;Lithuania;500;11;194833;3189
2021-02-24;LT;Lithuania;648;11;195481;3200
2021-02-25;LT;Lithuania;568;9;196049;3209
2021-02-26;LT;Lithuania;641;16;196690;3225
2021-02-27;LT;Lithuania;653;9;197343;3234
2021-02-28;LT;Lithuania;1802;10;199145;3244
2021-03-01;LT;Lithuania;253;9;199398;3253
2021-03-02;LT;Lithuania;427;10;199825;3263
2021-03-03;LT;Lithuania;526;18;200351;3281
2021-03-04;LT;Lithuania;547;13;200898;3294
2021-03-05;LT;Lithuania;437;9;201335;3303
2021-03-06;LT;Lithuania;464;18;201799;3321
2021-03-07;LT;Lithuania;415;7;202214;3328
2021-03-08;LT;Lithuania;216;8;202430;3336
2021-03-09;LT;Lithuania;470;5;202900;3341
2021-03-10;LT;Lithuania;486;10;203386;3351
2021-03-11;LT;Lithuania;606;12;203992;3363
2021-03-12;LT;Lithuania;364;10;204356;3373
2021-03-13;LT;Lithuania;598;16;204954;3389
2021-03-14;LT;Lithuania;431;7;205385;3396
2021-03-15;LT;Lithuania;259;14;205644;3410
2021-03-16;LT;Lithuania;646;6;206290;3416
2021-03-17;LT;Lithuania;599;11;206889;3427
2021-03-18;LT;Lithuania;580;15;207469;3442
2021-03-19;LT;Lithuania;579;10;208048;3452
2021-03-20;LT;Lithuania;602;12;208650;3464
2021-03-21;LT;Lithuania;361;12;209011;3476
2021-03-22;LT;Lithuania;329;10;209340;3486
2021-03-23;LT;Lithuania;862;15;210202;3501
2021-03-24;LT;Lithuania;809;9;211011;3510
2021-03-25;LT;Lithuania;793;11;211804;3521
2021-03-26;LT;Lithuania;872;8;212676;3529
2021-03-27;LT;Lithuania;771;10;213447;3539
2021-03-28;LT;Lithuania;494;12;213941;3551
2021-03-29;LT;Lithuania;424;9;214365;3560
2021-03-30;LT;Lithuania;851;6;215216;3566
2021-03-31;LT;Lithuania;903;8;216119;3574
2021-04-01;LT;Lithuania;886;9;217005;3583
2021-04-02;LT;Lithuania;860;11;217865;3594
2021-04-03;LT;Lithuania;1013;8;218878;3602
2021-04-04;LT;Lithuania;729;8;219607;3610
2021-04-05;LT;Lithuania;605;5;220212;3615
2021-04-06;LT;Lithuania;688;8;220900;3623
2021-04-07;LT;Lithuania;1120;12;222020;3635
2021-04-08;LT;Lithuania;1107;12;223127;3647
2021-04-09;LT;Lithuania;1182;13;224309;3660
2021-04-10;LT;Lithuania;999;11;225308;3671
2021-04-11;LT;Lithuania;865;16;226173;3687
2021-04-12;LT;Lithuania;610;10;226783;3697
2021-04-13;LT;Lithuania;1106;16;227889;3713
2021-04-14;LT;Lithuania;1371;5;229260;3718
2021-04-15;LT;Lithuania;1202;12;230462;3730
2021-04-16;LT;Lithuania;1139;9;231601;3739
2021-04-17;LT;Lithuania;1228;12;232829;3751
2021-04-18;LT;Lithuania;802;9;233631;3760
2021-04-19;LT;Lithuania;601;10;234232;3770
2021-04-20;LT;Lithuania;1151;15;235383;3785
2021-04-21;LT;Lithuania;1150;17;236533;3802
2021-04-22;LT;Lithuania;1417;16;237950;3818
2021-04-23;LT;Lithuania;1313;15;239263;3833
2021-04-24;LT;Lithuania;1259;8;240522;3841
2021-04-25;LT;Lithuania;775;7;241297;3848
2021-04-26;LT;Lithuania;575;9;241872;3857
2021-04-27;LT;Lithuania;1054;20;242926;3877
2021-04-28;LT;Lithuania;1629;23;244555;3900
2021-04-29;LT;Lithuania;1341;16;245896;3916
2021-04-30;LT;Lithuania;1373;7;247269;3923
2021-05-01;LT;Lithuania;1386;14;248655;3937
2021-05-02;LT;Lithuania;1025;13;249680;3950
2021-05-03;LT;Lithuania;657;6;250337;3956
2021-05-04;LT;Lithuania;1113;20;251450;3976
2021-05-05;LT;Lithuania;1249;17;252699;3993
2021-05-06;LT;Lithuania;1392;7;254091;4000
2021-05-07;LT;Lithuania;1293;19;255384;4019
2021-05-08;LT;Lithuania;1522;5;256906;4024
2021-05-09;LT;Lithuania;921;10;257827;4034
2021-05-10;LT;Lithuania;796;11;258623;4045
2021-05-11;LT;Lithuania;1239;8;259862;4053
2021-05-12;LT;Lithuania;1266;6;261128;4059
2021-05-13;LT;Lithuania;1207;12;262335;4071
2021-05-14;LT;Lithuania;1140;13;263475;4084
2021-05-15;LT;Lithuania;1249;4;264724;4088
2021-05-16;LT;Lithuania;812;15;265536;4103
2021-05-17;LT;Lithuania;527;9;266063;4112
2021-05-18;LT;Lithuania;732;14;266795;4126
2021-05-19;LT;Lithuania;974;10;267769;4136
2021-05-20;LT;Lithuania;915;19;268684;4155
2021-05-21;LT;Lithuania;679;6;269363;4161
2021-05-22;LT;Lithuania;1013;12;270376;4173
2021-05-23;LT;Lithuania;473;12;270849;4185
2021-05-24;LT;Lithuania;281;10;271130;4195
2021-05-25;LT;Lithuania;552;14;271682;4209
2021-05-26;LT;Lithuania;549;11;272231;4220
2021-05-27;LT;Lithuania;595;9;272826;4229
2021-05-28;LT;Lithuania;520;6;273346;4235
2021-05-29;LT;Lithuania;520;10;273866;4245
2021-05-30;LT;Lithuania;333;12;274199;4257
2021-05-31;LT;Lithuania;184;9;274383;4266
2021-06-01;LT;Lithuania;393;10;274776;4276
2021-06-02;LT;Lithuania;422;7;275198;4283
2021-06-03;LT;Lithuania;347;6;275545;4289
2021-06-04;LT;Lithuania;370;8;275915;4297
2021-06-05;LT;Lithuania;341;5;276256;4302
2021-06-06;LT;Lithuania;197;5;276453;4307
2021-06-07;LT;Lithuania;90;2;276543;4309
2021-06-08;LT;Lithuania;216;8;276759;4317
2021-06-09;LT;Lithuania;243;3;277002;4320
2021-06-10;LT;Lithuania;220;7;277222;4327
2021-06-11;LT;Lithuania;157;3;277379;4330
2021-06-12;LT;Lithuania;244;5;277623;4335
2021-06-13;LT;Lithuania;123;4;277746;4339
2021-06-14;LT;Lithuania;66;3;277812;4342
2021-06-15;LT;Lithuania;130;6;277942;4348
2021-06-16;LT;Lithuania;130;4;278072;4352
2021-06-17;LT;Lithuania;105;5;278177;4357
2021-06-18;LT;Lithuania;77;3;278254;4360
2021-06-19;LT;Lithuania;74;4;278328;4364
2021-06-20;LT;Lithuania;51;2;278379;4366
2021-06-21;LT;Lithuania;28;1;278407;4367
2021-06-22;LT;Lithuania;59;4;278466;4371
2021-06-23;LT;Lithuania;60;0;278526;4371
2021-06-24;LT;Lithuania;64;4;278590;4375
2021-06-25;LT;Lithuania;18;3;278608;4378
2021-06-26;LT;Lithuania;47;1;278655;4379
2021-06-27;LT;Lithuania;19;1;278674;4380
2021-06-28;LT;Lithuania;15;1;278689;4381
2021-06-29;LT;Lithuania;37;0;278726;4381
2021-06-30;LT;Lithuania;43;2;278769;4383
2021-07-01;LT;Lithuania;40;1;278809;4384
2020-02-24;LU;Luxembourg;0;0;0;0
2020-02-25;LU;Luxembourg;0;0;0;0
2020-02-26;LU;Luxembourg;0;0;0;0
2020-02-27;LU;Luxembourg;0;0;0;0
2020-02-28;LU;Luxembourg;0;0;0;0
2020-02-29;LU;Luxembourg;1;0;1;0
2020-03-01;LU;Luxembourg;0;0;1;0
2020-03-02;LU;Luxembourg;0;0;1;0
2020-03-03;LU;Luxembourg;0;0;1;0
2020-03-04;LU;Luxembourg;0;0;1;0
2020-03-05;LU;Luxembourg;0;0;1;0
2020-03-06;LU;Luxembourg;1;0;2;0
2020-03-07;LU;Luxembourg;0;0;2;0
2020-03-08;LU;Luxembourg;1;0;3;0
2020-03-09;LU;Luxembourg;0;0;3;0
2020-03-10;LU;Luxembourg;2;0;5;0
2020-03-11;LU;Luxembourg;2;0;7;0
2020-03-12;LU;Luxembourg;12;0;19;0
2020-03-13;LU;Luxembourg;15;0;34;0
2020-03-14;LU;Luxembourg;17;1;51;1
2020-03-15;LU;Luxembourg;8;0;59;1
2020-03-16;LU;Luxembourg;18;0;77;1
2020-03-17;LU;Luxembourg;63;0;140;1
2020-03-18;LU;Luxembourg;63;1;203;2
2020-03-19;LU;Luxembourg;132;2;335;4
2020-03-20;LU;Luxembourg;149;0;484;4
2020-03-21;LU;Luxembourg;186;4;670;8
2020-03-22;LU;Luxembourg;128;0;798;8
2020-03-23;LU;Luxembourg;77;0;875;8
2020-03-24;LU;Luxembourg;224;0;1099;8
2020-03-25;LU;Luxembourg;234;0;1333;8
2020-03-26;LU;Luxembourg;120;1;1453;9
2020-03-27;LU;Luxembourg;152;6;1605;15
2020-03-28;LU;Luxembourg;226;3;1831;18
2020-03-29;LU;Luxembourg;119;3;1950;21
2020-03-30;LU;Luxembourg;38;1;1988;22
2020-03-31;LU;Luxembourg;190;1;2178;23
2020-04-01;LU;Luxembourg;141;6;2319;29
2020-04-02;LU;Luxembourg;168;1;2487;30
2020-04-03;LU;Luxembourg;125;1;2612;31
2020-04-04;LU;Luxembourg;117;0;2729;31
2020-04-05;LU;Luxembourg;75;5;2804;36
2020-04-06;LU;Luxembourg;39;5;2843;41
2020-04-07;LU;Luxembourg;127;3;2970;44
2020-04-08;LU;Luxembourg;64;2;3034;46
2020-04-09;LU;Luxembourg;81;6;3115;52
2020-04-10;LU;Luxembourg;108;2;3223;54
2020-04-11;LU;Luxembourg;47;8;3270;62
2020-04-12;LU;Luxembourg;11;4;3281;66
2020-04-13;LU;Luxembourg;11;3;3292;69
2020-04-14;LU;Luxembourg;15;-2;3307;67
2020-04-15;LU;Luxembourg;66;2;3373;69
2020-04-16;LU;Luxembourg;71;0;3444;69
2020-04-17;LU;Luxembourg;36;3;3480;72
2020-04-18;LU;Luxembourg;57;0;3537;72
2020-04-19;LU;Luxembourg;13;1;3550;73
2020-04-20;LU;Luxembourg;8;2;3558;75
2020-04-21;LU;Luxembourg;60;3;3618;78
2020-04-22;LU;Luxembourg;36;2;3654;80
2020-04-23;LU;Luxembourg;11;3;3665;83
2020-04-24;LU;Luxembourg;30;2;3695;85
2020-04-25;LU;Luxembourg;16;0;3711;85
2020-04-26;LU;Luxembourg;12;3;3723;88
2020-04-27;LU;Luxembourg;6;0;3729;88
2020-04-28;LU;Luxembourg;12;1;3741;89
2020-04-29;LU;Luxembourg;28;0;3769;89
2020-04-30;LU;Luxembourg;15;1;3784;90
2020-05-01;LU;Luxembourg;18;2;3802;92
2020-05-02;LU;Luxembourg;10;0;3812;92
2020-05-03;LU;Luxembourg;12;4;3824;96
2020-05-04;LU;Luxembourg;4;0;3828;96
2020-05-05;LU;Luxembourg;12;0;3840;96
2020-05-06;LU;Luxembourg;11;2;3851;98
2020-05-07;LU;Luxembourg;8;2;3859;100
2020-05-08;LU;Luxembourg;12;0;3871;100
2020-05-09;LU;Luxembourg;6;1;3877;101
2020-05-10;LU;Luxembourg;9;0;3886;101
2020-05-11;LU;Luxembourg;2;0;3888;101
2020-05-12;LU;Luxembourg;6;1;3894;102
2020-05-13;LU;Luxembourg;10;1;3904;103
2020-05-14;LU;Luxembourg;11;0;3915;103
2020-05-15;LU;Luxembourg;8;1;3923;104
2020-05-16;LU;Luxembourg;7;0;3930;104
2020-05-17;LU;Luxembourg;15;3;3945;107
2020-05-18;LU;Luxembourg;2;0;3947;107
2020-05-19;LU;Luxembourg;11;2;3958;109
2020-05-20;LU;Luxembourg;13;0;3971;109
2020-05-21;LU;Luxembourg;9;0;3980;109
2020-05-22;LU;Luxembourg;1;0;3981;109
2020-05-23;LU;Luxembourg;9;0;3990;109
2020-05-24;LU;Luxembourg;2;1;3992;110
2020-05-25;LU;Luxembourg;1;0;3993;110
2020-05-26;LU;Luxembourg;2;0;3995;110
2020-05-27;LU;Luxembourg;6;0;4001;110
2020-05-28;LU;Luxembourg;7;0;4008;110
2020-05-29;LU;Luxembourg;4;0;4012;110
2020-05-30;LU;Luxembourg;4;0;4016;110
2020-05-31;LU;Luxembourg;2;0;4018;110
2020-06-01;LU;Luxembourg;1;0;4019;110
2020-06-02;LU;Luxembourg;1;0;4020;110
2020-06-03;LU;Luxembourg;4;0;4024;110
2020-06-04;LU;Luxembourg;3;0;4027;110
2020-06-05;LU;Luxembourg;5;0;4032;110
2020-06-06;LU;Luxembourg;3;0;4035;110
2020-06-07;LU;Luxembourg;4;0;4039;110
2020-06-08;LU;Luxembourg;1;0;4040;110
2020-06-09;LU;Luxembourg;6;0;4046;110
2020-06-10;LU;Luxembourg;3;0;4049;110
2020-06-11;LU;Luxembourg;3;0;4052;110
2020-06-12;LU;Luxembourg;3;0;4055;110
2020-06-13;LU;Luxembourg;8;0;4063;110
2020-06-14;LU;Luxembourg;7;0;4070;110
2020-06-15;LU;Luxembourg;2;0;4072;110
2020-06-16;LU;Luxembourg;3;0;4075;110
2020-06-17;LU;Luxembourg;10;0;4085;110
2020-06-18;LU;Luxembourg;6;0;4091;110
2020-06-19;LU;Luxembourg;8;0;4099;110
2020-06-20;LU;Luxembourg;6;0;4105;110
2020-06-21;LU;Luxembourg;15;0;4120;110
2020-06-22;LU;Luxembourg;1;0;4121;110
2020-06-23;LU;Luxembourg;12;0;4133;110
2020-06-24;LU;Luxembourg;7;0;4140;110
2020-06-25;LU;Luxembourg;11;0;4151;110
2020-06-26;LU;Luxembourg;22;0;4173;110
2020-06-27;LU;Luxembourg;44;0;4217;110
2020-06-28;LU;Luxembourg;25;0;4242;110
2020-06-29;LU;Luxembourg;14;0;4256;110
2020-06-30;LU;Luxembourg;43;0;4299;110
2020-07-01;LU;Luxembourg;46;0;4345;110
2020-07-02;LU;Luxembourg;50;0;4395;110
2020-07-03;LU;Luxembourg;52;0;4447;110
2020-07-04;LU;Luxembourg;29;0;4476;110
2020-07-05;LU;Luxembourg;46;0;4522;110
2020-07-06;LU;Luxembourg;20;0;4542;110
2020-07-07;LU;Luxembourg;61;0;4603;110
2020-07-08;LU;Luxembourg;47;0;4650;110
2020-07-09;LU;Luxembourg;69;0;4719;110
2020-07-10;LU;Luxembourg;58;0;4777;110
2020-07-11;LU;Luxembourg;65;0;4842;110
2020-07-12;LU;Luxembourg;83;1;4925;111
2020-07-13;LU;Luxembourg;31;0;4956;111
2020-07-14;LU;Luxembourg;100;0;5056;111
2020-07-15;LU;Luxembourg;66;0;5122;111
2020-07-16;LU;Luxembourg;163;0;5285;111
2020-07-17;LU;Luxembourg;124;0;5409;111
2020-07-18;LU;Luxembourg;74;0;5483;111
2020-07-19;LU;Luxembourg;122;0;5605;111
2020-07-20;LU;Luxembourg;34;0;5639;111
2020-07-21;LU;Luxembourg;86;0;5725;111
2020-07-22;LU;Luxembourg;129;0;5854;111
2020-07-23;LU;Luxembourg;98;1;5952;112
2020-07-24;LU;Luxembourg;104;0;6056;112
2020-07-25;LU;Luxembourg;133;0;6189;112
2020-07-26;LU;Luxembourg;83;0;6272;112
2020-07-27;LU;Luxembourg;49;0;6321;112
2020-07-28;LU;Luxembourg;54;1;6375;113
2020-07-29;LU;Luxembourg;158;1;6533;114
2020-07-30;LU;Luxembourg;83;0;6616;114
2020-07-31;LU;Luxembourg;79;0;6695;114
2020-08-01;LU;Luxembourg;98;2;6793;116
2020-08-02;LU;Luxembourg;62;1;6855;117
2020-08-03;LU;Luxembourg;9;1;6864;118
2020-08-04;LU;Luxembourg;53;0;6917;118
2020-08-05;LU;Luxembourg;90;0;7007;118
2020-08-06;LU;Luxembourg;66;1;7073;119
2020-08-07;LU;Luxembourg;40;0;7113;119
2020-08-08;LU;Luxembourg;56;1;7169;120
2020-08-09;LU;Luxembourg;36;0;7205;120
2020-08-10;LU;Luxembourg;11;1;7216;121
2020-08-11;LU;Luxembourg;26;1;7242;122
2020-08-12;LU;Luxembourg;58;0;7300;122
2020-08-13;LU;Luxembourg;68;0;7368;122
2020-08-14;LU;Luxembourg;37;0;7405;122
2020-08-15;LU;Luxembourg;34;1;7439;123
2020-08-16;LU;Luxembourg;19;0;7458;123
2020-08-17;LU;Luxembourg;11;1;7469;124
2020-08-18;LU;Luxembourg;30;0;7499;124
2020-08-19;LU;Luxembourg;67;0;7566;124
2020-08-20;LU;Luxembourg;71;0;7637;124
2020-08-21;LU;Luxembourg;67;0;7704;124
2020-08-22;LU;Luxembourg;58;0;7762;124
2020-08-23;LU;Luxembourg;13;0;7775;124
2020-08-24;LU;Luxembourg;19;0;7794;124
2020-08-25;LU;Luxembourg;44;0;7838;124
2020-08-26;LU;Luxembourg;90;0;7928;124
2020-08-27;LU;Luxembourg;0;0;7928;124
2020-08-28;LU;Luxembourg;-1348;0;6580;124
2020-08-29;LU;Luxembourg;45;0;6625;124
2020-08-30;LU;Luxembourg;0;0;6625;124
2020-08-31;LU;Luxembourg;0;0;6625;124
2020-09-01;LU;Luxembourg;0;0;6625;124
2020-09-02;LU;Luxembourg;120;0;6745;124
2020-09-03;LU;Luxembourg;66;0;6811;124
2020-09-04;LU;Luxembourg;43;0;6854;124
2020-09-05;LU;Luxembourg;42;0;6896;124
2020-09-06;LU;Luxembourg;54;0;6950;124
2020-09-07;LU;Luxembourg;10;0;6960;124
2020-09-08;LU;Luxembourg;14;0;6974;124
2020-09-09;LU;Luxembourg;49;0;7023;124
2020-09-10;LU;Luxembourg;65;0;7088;124
2020-09-11;LU;Luxembourg;0;0;7088;124
2020-09-12;LU;Luxembourg;71;0;7159;124
2020-09-13;LU;Luxembourg;0;0;7159;124
2020-09-14;LU;Luxembourg;85;0;7244;124
2020-09-15;LU;Luxembourg;40;0;7284;124
2020-09-16;LU;Luxembourg;110;0;7394;124
2020-09-17;LU;Luxembourg;147;0;7541;124
2020-09-18;LU;Luxembourg;177;0;7718;124
2020-09-19;LU;Luxembourg;0;0;7718;124
2020-09-20;LU;Luxembourg;0;0;7718;124
2020-09-21;LU;Luxembourg;198;0;7916;124
2020-09-22;LU;Luxembourg;100;0;8016;124
2020-09-23;LU;Luxembourg;74;0;8090;124
2020-09-24;LU;Luxembourg;68;0;8158;124
2020-09-25;LU;Luxembourg;75;0;8233;124
2020-09-26;LU;Luxembourg;0;0;8233;124
2020-09-27;LU;Luxembourg;0;0;8233;124
2020-09-28;LU;Luxembourg;143;0;8376;124
2020-09-29;LU;Luxembourg;55;0;8431;124
2020-09-30;LU;Luxembourg;78;0;8509;124
2020-10-01;LU;Luxembourg;86;1;8595;125
2020-10-02;LU;Luxembourg;114;0;8709;125
2020-10-03;LU;Luxembourg;0;0;8709;125
2020-10-04;LU;Luxembourg;0;0;8709;125
2020-10-05;LU;Luxembourg;216;2;8925;127
2020-10-06;LU;Luxembourg;54;1;8979;128
2020-10-07;LU;Luxembourg;140;0;9119;128
2020-10-08;LU;Luxembourg;100;1;9219;129
2020-10-09;LU;Luxembourg;141;1;9360;130
2020-10-10;LU;Luxembourg;154;1;9514;131
2020-10-11;LU;Luxembourg;208;1;9722;132
2020-10-12;LU;Luxembourg;9;1;9731;133
2020-10-13;LU;Luxembourg;109;0;9840;133
2020-10-14;LU;Luxembourg;190;0;10030;133
2020-10-15;LU;Luxembourg;214;0;10244;133
2020-10-16;LU;Luxembourg;227;0;10471;133
2020-10-17;LU;Luxembourg;0;0;10471;133
2020-10-18;LU;Luxembourg;417;0;10888;133
2020-10-19;LU;Luxembourg;122;2;11010;135
2020-10-20;LU;Luxembourg;231;1;11241;136
2020-10-21;LU;Luxembourg;430;2;11671;138
2020-10-22;LU;Luxembourg;662;2;12333;140
2020-10-23;LU;Luxembourg;518;1;12851;141
2020-10-24;LU;Luxembourg;0;0;12851;141
2020-10-25;LU;Luxembourg;0;0;12851;141
2020-10-26;LU;Luxembourg;1548;6;14399;147
2020-10-27;LU;Luxembourg;485;0;14884;147
2020-10-28;LU;Luxembourg;775;0;15659;147
2020-10-29;LU;Luxembourg;697;3;16356;150
2020-10-30;LU;Luxembourg;778;2;17134;152
2020-10-31;LU;Luxembourg;0;0;17134;152
2020-11-01;LU;Luxembourg;0;0;17134;152
2020-11-02;LU;Luxembourg;1967;8;19101;160
2020-11-03;LU;Luxembourg;533;7;19634;167
2020-11-04;LU;Luxembourg;710;4;20344;171
2020-11-05;LU;Luxembourg;803;6;21147;177
2020-11-06;LU;Luxembourg;659;3;21806;180
2020-11-07;LU;Luxembourg;0;0;21806;180
2020-11-08;LU;Luxembourg;0;0;21806;180
2020-11-09;LU;Luxembourg;1421;13;23227;193
2020-11-10;LU;Luxembourg;483;5;23710;198
2020-11-11;LU;Luxembourg;0;0;23710;198
2020-11-12;LU;Luxembourg;1508;13;25218;211
2020-11-13;LU;Luxembourg;713;8;25931;219
2020-11-14;LU;Luxembourg;0;0;25931;219
2020-11-15;LU;Luxembourg;0;0;25931;219
2020-11-16;LU;Luxembourg;1325;17;27256;236
2020-11-17;LU;Luxembourg;425;4;27681;240
2020-11-18;LU;Luxembourg;892;8;28573;248
2020-11-19;LU;Luxembourg;670;6;29243;254
2020-11-20;LU;Luxembourg;519;6;29762;260
2020-11-21;LU;Luxembourg;0;0;29762;260
2020-11-22;LU;Luxembourg;0;0;29762;260
2020-11-23;LU;Luxembourg;1349;13;31111;273
2020-11-24;LU;Luxembourg;373;10;31484;283
2020-11-25;LU;Luxembourg;616;5;32100;288
2020-11-26;LU;Luxembourg;773;6;32873;294
2020-11-27;LU;Luxembourg;536;6;33409;300
2020-11-28;LU;Luxembourg;0;0;33409;300
2020-11-29;LU;Luxembourg;0;0;33409;300
2020-11-30;LU;Luxembourg;1269;21;34678;321
2020-12-01;LU;Luxembourg;451;9;35129;330
2020-12-02;LU;Luxembourg;673;4;35802;334
2020-12-03;LU;Luxembourg;627;5;36429;339
2020-12-04;LU;Luxembourg;588;6;37017;345
2020-12-05;LU;Luxembourg;0;0;37017;345
2020-12-06;LU;Luxembourg;0;0;37017;345
2020-12-07;LU;Luxembourg;1459;15;38476;360
2020-12-08;LU;Luxembourg;0;0;38476;360
2020-12-09;LU;Luxembourg;0;0;38476;360
2020-12-10;LU;Luxembourg;1561;24;40037;384
2020-12-11;LU;Luxembourg;718;8;40755;392
2020-12-12;LU;Luxembourg;0;0;40755;392
2020-12-13;LU;Luxembourg;0;0;40755;392
2020-12-14;LU;Luxembourg;1145;18;41900;410
2020-12-15;LU;Luxembourg;350;8;42250;418
2020-12-16;LU;Luxembourg;595;3;42845;421
2020-12-17;LU;Luxembourg;434;7;43279;428
2020-12-18;LU;Luxembourg;449;6;43728;434
2020-12-19;LU;Luxembourg;0;0;43728;434
2020-12-20;LU;Luxembourg;0;0;43728;434
2020-12-21;LU;Luxembourg;854;16;44582;450
2020-12-22;LU;Luxembourg;227;3;44809;453
2020-12-23;LU;Luxembourg;400;5;45209;458
2020-12-24;LU;Luxembourg;0;0;45209;458
2020-12-25;LU;Luxembourg;0;0;45209;458
2020-12-26;LU;Luxembourg;0;0;45209;458
2020-12-27;LU;Luxembourg;0;0;45209;458
2020-12-28;LU;Luxembourg;640;29;45849;487
2020-12-29;LU;Luxembourg;239;2;46088;489
2020-12-30;LU;Luxembourg;327;6;46415;495
2020-12-31;LU;Luxembourg;0;0;46415;495
2021-01-01;LU;Luxembourg;0;0;46415;495
2021-01-02;LU;Luxembourg;0;0;46415;495
2021-01-03;LU;Luxembourg;0;0;46415;495
2021-01-04;LU;Luxembourg;571;13;46986;508
2021-01-05;LU;Luxembourg;163;6;47149;514
2021-01-06;LU;Luxembourg;281;3;47430;517
2021-01-07;LU;Luxembourg;162;4;47592;521
2021-01-08;LU;Luxembourg;152;6;47744;527
2021-01-09;LU;Luxembourg;0;0;47744;527
2021-01-10;LU;Luxembourg;0;0;47744;527
2021-01-11;LU;Luxembourg;283;8;48027;535
2021-01-12;LU;Luxembourg;154;3;48181;538
2021-01-13;LU;Luxembourg;191;4;48372;542
2021-01-14;LU;Luxembourg;114;3;48486;545
2021-01-15;LU;Luxembourg;144;4;48630;549
2021-01-16;LU;Luxembourg;0;0;48630;549
2021-01-17;LU;Luxembourg;0;0;48630;549
2021-01-18;LU;Luxembourg;260;8;48890;557
2021-01-19;LU;Luxembourg;85;3;48975;560
2021-01-20;LU;Luxembourg;229;2;49204;562
2021-01-21;LU;Luxembourg;115;0;49319;562
2021-01-22;LU;Luxembourg;119;0;49438;562
2021-01-23;LU;Luxembourg;0;0;49438;562
2021-01-24;LU;Luxembourg;0;0;49438;562
2021-01-25;LU;Luxembourg;295;4;49733;566
2021-01-26;LU;Luxembourg;119;4;49852;570
2021-01-27;LU;Luxembourg;237;1;50089;571
2021-01-28;LU;Luxembourg;139;3;50228;574
2021-01-29;LU;Luxembourg;160;3;50388;577
2021-01-30;LU;Luxembourg;0;0;50388;577
2021-01-31;LU;Luxembourg;0;0;50388;577
2021-02-01;LU;Luxembourg;345;7;50733;584
2021-02-02;LU;Luxembourg;190;2;50923;586
2021-02-03;LU;Luxembourg;205;1;51128;587
2021-02-04;LU;Luxembourg;202;1;51330;588
2021-02-05;LU;Luxembourg;182;2;51512;590
2021-02-06;LU;Luxembourg;0;0;51512;590
2021-02-07;LU;Luxembourg;0;0;51512;590
2021-02-08;LU;Luxembourg;367;7;51879;597
2021-02-09;LU;Luxembourg;143;3;52022;600
2021-02-10;LU;Luxembourg;225;2;52247;602
2021-02-11;LU;Luxembourg;145;2;52392;604
2021-02-12;LU;Luxembourg;147;2;52539;606
2021-02-13;LU;Luxembourg;0;0;52539;606
2021-02-14;LU;Luxembourg;0;0;52539;606
2021-02-15;LU;Luxembourg;384;5;52923;611
2021-02-16;LU;Luxembourg;139;1;53062;612
2021-02-17;LU;Luxembourg;267;4;53329;616
2021-02-18;LU;Luxembourg;233;3;53562;619
2021-02-19;LU;Luxembourg;220;3;53782;622
2021-02-20;LU;Luxembourg;0;0;53782;622
2021-02-21;LU;Luxembourg;0;0;53782;622
2021-02-22;LU;Luxembourg;390;6;54172;628
2021-02-23;LU;Luxembourg;182;1;54354;629
2021-02-24;LU;Luxembourg;324;3;54678;632
2021-02-25;LU;Luxembourg;193;2;54871;634
2021-02-26;LU;Luxembourg;239;3;55110;637
2021-02-27;LU;Luxembourg;0;0;55110;637
2021-02-28;LU;Luxembourg;0;0;55110;637
2021-03-01;LU;Luxembourg;370;2;55480;639
2021-03-02;LU;Luxembourg;152;2;55632;641
2021-03-03;LU;Luxembourg;270;2;55902;643
2021-03-04;LU;Luxembourg;208;4;56110;647
2021-03-05;LU;Luxembourg;186;5;56296;652
2021-03-06;LU;Luxembourg;0;0;56296;652
2021-03-07;LU;Luxembourg;0;0;56296;652
2021-03-08;LU;Luxembourg;381;11;56677;663
2021-03-09;LU;Luxembourg;145;5;56822;668
2021-03-10;LU;Luxembourg;234;5;57056;673
2021-03-11;LU;Luxembourg;265;2;57321;675
2021-03-12;LU;Luxembourg;182;6;57503;681
2021-03-13;LU;Luxembourg;0;0;57503;681
2021-03-14;LU;Luxembourg;0;0;57503;681
2021-03-15;LU;Luxembourg;423;12;57926;693
2021-03-16;LU;Luxembourg;185;4;58111;697
2021-03-17;LU;Luxembourg;297;7;58408;704
2021-03-18;LU;Luxembourg;266;1;58674;705
2021-03-19;LU;Luxembourg;281;9;58955;714
2021-03-20;LU;Luxembourg;0;0;58955;714
2021-03-21;LU;Luxembourg;0;0;58955;714
2021-03-22;LU;Luxembourg;542;5;59497;719
2021-03-23;LU;Luxembourg;165;7;59662;726
2021-03-24;LU;Luxembourg;245;2;59907;728
2021-03-25;LU;Luxembourg;298;8;60205;736
2021-03-26;LU;Luxembourg;260;2;60465;738
2021-03-27;LU;Luxembourg;0;0;60465;738
2021-03-28;LU;Luxembourg;0;0;60465;738
2021-03-29;LU;Luxembourg;608;3;61073;741
2021-03-30;LU;Luxembourg;182;2;61255;743
2021-03-31;LU;Luxembourg;387;3;61642;746
2021-04-01;LU;Luxembourg;239;3;61881;749
2021-04-02;LU;Luxembourg;224;1;62105;750
2021-04-03;LU;Luxembourg;0;0;62105;750
2021-04-04;LU;Luxembourg;0;0;62105;750
2021-04-05;LU;Luxembourg;0;0;62105;750
2021-04-06;LU;Luxembourg;520;11;62625;761
2021-04-07;LU;Luxembourg;168;1;62793;762
2021-04-08;LU;Luxembourg;387;0;63180;762
2021-04-09;LU;Luxembourg;287;1;63467;763
2021-04-10;LU;Luxembourg;0;0;63467;763
2021-04-11;LU;Luxembourg;0;0;63467;763
2021-04-12;LU;Luxembourg;413;9;63880;772
2021-04-13;LU;Luxembourg;182;5;64062;777
2021-04-14;LU;Luxembourg;272;7;64334;784
2021-04-15;LU;Luxembourg;215;1;64549;785
2021-04-16;LU;Luxembourg;197;0;64746;785
2021-04-17;LU;Luxembourg;0;0;64746;785
2021-04-18;LU;Luxembourg;0;0;64746;785
2021-04-19;LU;Luxembourg;398;1;65144;786
2021-04-20;LU;Luxembourg;175;0;65319;786
2021-04-21;LU;Luxembourg;285;2;65604;788
2021-04-22;LU;Luxembourg;209;2;65813;790
2021-04-23;LU;Luxembourg;194;0;66007;790
2021-04-24;LU;Luxembourg;0;0;66007;790
2021-04-25;LU;Luxembourg;0;0;66007;790
2021-04-26;LU;Luxembourg;367;1;66374;791
2021-04-27;LU;Luxembourg;220;0;66594;791
2021-04-28;LU;Luxembourg;232;1;66826;792
2021-04-29;LU;Luxembourg;219;2;67045;794
2021-04-30;LU;Luxembourg;160;2;67205;796
2021-05-01;LU;Luxembourg;0;0;67205;796
2021-05-02;LU;Luxembourg;0;0;67205;796
2021-05-03;LU;Luxembourg;290;4;67495;800
2021-05-04;LU;Luxembourg;147;0;67642;800
2021-05-05;LU;Luxembourg;208;0;67850;800
2021-05-06;LU;Luxembourg;170;1;68020;801
2021-05-07;LU;Luxembourg;133;0;68153;801
2021-05-08;LU;Luxembourg;0;0;68153;801
2021-05-09;LU;Luxembourg;0;0;68153;801
2021-05-10;LU;Luxembourg;278;3;68431;804
2021-05-11;LU;Luxembourg;121;2;68552;806
2021-05-12;LU;Luxembourg;196;0;68748;806
2021-05-13;LU;Luxembourg;0;0;68748;806
2021-05-14;LU;Luxembourg;174;0;68922;806
2021-05-15;LU;Luxembourg;0;0;68922;806
2021-05-16;LU;Luxembourg;0;0;68922;806
2021-05-17;LU;Luxembourg;268;2;69190;808
2021-05-18;LU;Luxembourg;49;0;69239;808
2021-05-19;LU;Luxembourg;159;0;69398;808
2021-05-20;LU;Luxembourg;67;1;69465;809
2021-05-21;LU;Luxembourg;80;1;69545;810
2021-05-22;LU;Luxembourg;0;0;69545;810
2021-05-23;LU;Luxembourg;0;0;69545;810
2021-05-24;LU;Luxembourg;0;0;69545;810
2021-05-25;LU;Luxembourg;34;2;69579;812
2021-05-26;LU;Luxembourg;90;0;69669;812
2021-05-27;LU;Luxembourg;80;1;69749;813
2021-05-28;LU;Luxembourg;81;1;69830;814
2021-05-29;LU;Luxembourg;0;0;69830;814
2021-05-30;LU;Luxembourg;0;0;69830;814
2021-05-31;LU;Luxembourg;102;1;69932;815
2021-06-01;LU;Luxembourg;51;2;69983;817
2021-06-02;LU;Luxembourg;44;1;70027;818
2021-06-03;LU;Luxembourg;61;0;70088;818
2021-06-04;LU;Luxembourg;94;0;70182;818
2021-06-05;LU;Luxembourg;0;0;70182;818
2021-06-06;LU;Luxembourg;0;0;70182;818
2021-06-07;LU;Luxembourg;74;0;70256;818
2021-06-08;LU;Luxembourg;35;0;70291;818
2021-06-09;LU;Luxembourg;52;0;70343;818
2021-06-10;LU;Luxembourg;40;0;70383;818
2021-06-11;LU;Luxembourg;23;0;70406;818
2021-06-12;LU;Luxembourg;0;0;70406;818
2021-06-13;LU;Luxembourg;0;0;70406;818
2021-06-14;LU;Luxembourg;39;0;70445;818
2021-06-15;LU;Luxembourg;21;0;70466;818
2021-06-16;LU;Luxembourg;19;0;70485;818
2021-06-17;LU;Luxembourg;18;0;70503;818
2021-06-18;LU;Luxembourg;13;0;70516;818
2021-06-19;LU;Luxembourg;0;0;70516;818
2021-06-20;LU;Luxembourg;0;0;70516;818
2021-06-21;LU;Luxembourg;19;0;70535;818
2021-06-22;LU;Luxembourg;12;0;70547;818
2021-06-23;LU;Luxembourg;0;0;70547;818
2021-06-24;LU;Luxembourg;39;0;70586;818
2021-06-25;LU;Luxembourg;14;0;70600;818
2021-06-26;LU;Luxembourg;0;0;70600;818
2021-06-27;LU;Luxembourg;0;0;70600;818
2021-06-28;LU;Luxembourg;42;0;70642;818
2021-06-29;LU;Luxembourg;53;0;70695;818
2021-06-30;LU;Luxembourg;92;0;70787;818
2021-07-01;LU;Luxembourg;108;0;70895;818
2021-02-08;MO;Macao;0;0;0;0
2021-02-09;MO;Macao;0;0;0;0
2021-02-10;MO;Macao;0;0;0;0
2021-02-11;MO;Macao;0;0;0;0
2021-02-12;MO;Macao;0;0;0;0
2021-02-13;MO;Macao;0;0;0;0
2021-02-14;MO;Macao;0;0;0;0
2021-02-15;MO;Macao;0;0;0;0
2021-02-16;MO;Macao;0;0;0;0
2021-02-17;MO;Macao;0;0;0;0
2021-02-18;MO;Macao;0;0;0;0
2021-02-19;MO;Macao;0;0;0;0
2021-02-20;MO;Macao;0;0;0;0
2021-02-21;MO;Macao;0;0;0;0
2021-02-22;MO;Macao;0;0;0;0
2021-02-23;MO;Macao;0;0;0;0
2021-02-24;MO;Macao;0;0;0;0
2021-02-25;MO;Macao;0;0;0;0
2021-02-26;MO;Macao;0;0;0;0
2021-02-27;MO;Macao;0;0;0;0
2021-02-28;MO;Macao;0;0;0;0
2021-03-01;MO;Macao;0;0;0;0
2021-03-02;MO;Macao;0;0;0;0
2021-03-03;MO;Macao;0;0;0;0
2021-03-04;MO;Macao;0;0;0;0
2021-03-05;MO;Macao;0;0;0;0
2021-03-06;MO;Macao;0;0;0;0
2021-03-07;MO;Macao;0;0;0;0
2021-03-08;MO;Macao;0;0;0;0
2021-03-09;MO;Macao;0;0;0;0
2021-03-10;MO;Macao;0;0;0;0
2021-03-11;MO;Macao;0;0;0;0
2021-03-12;MO;Macao;0;0;0;0
2021-03-13;MO;Macao;0;0;0;0
2021-03-14;MO;Macao;0;0;0;0
2021-03-15;MO;Macao;0;0;0;0
2021-03-16;MO;Macao;0;0;0;0
2021-03-17;MO;Macao;0;0;0;0
2021-03-18;MO;Macao;0;0;0;0
2021-03-19;MO;Macao;0;0;0;0
2021-03-20;MO;Macao;0;0;0;0
2021-03-21;MO;Macao;0;0;0;0
2021-03-22;MO;Macao;0;0;0;0
2021-03-23;MO;Macao;0;0;0;0
2021-03-24;MO;Macao;0;0;0;0
2021-03-25;MO;Macao;0;0;0;0
2021-03-26;MO;Macao;0;0;0;0
2021-03-27;MO;Macao;0;0;0;0
2021-03-28;MO;Macao;0;0;0;0
2021-03-29;MO;Macao;0;0;0;0
2021-03-30;MO;Macao;0;0;0;0
2021-03-31;MO;Macao;0;0;0;0
2021-04-01;MO;Macao;0;0;0;0
2021-04-02;MO;Macao;0;0;0;0
2021-04-03;MO;Macao;0;0;0;0
2021-04-04;MO;Macao;0;0;0;0
2021-04-05;MO;Macao;0;0;0;0
2021-04-06;MO;Macao;0;0;0;0
2021-04-07;MO;Macao;0;0;0;0
2021-04-08;MO;Macao;0;0;0;0
2021-04-09;MO;Macao;0;0;0;0
2021-04-10;MO;Macao;0;0;0;0
2021-04-11;MO;Macao;0;0;0;0
2021-04-12;MO;Macao;0;0;0;0
2021-04-13;MO;Macao;0;0;0;0
2021-04-14;MO;Macao;0;0;0;0
2021-04-15;MO;Macao;0;0;0;0
2021-04-16;MO;Macao;0;0;0;0
2021-04-17;MO;Macao;0;0;0;0
2021-04-18;MO;Macao;0;0;0;0
2021-04-19;MO;Macao;0;0;0;0
2021-04-20;MO;Macao;0;0;0;0
2021-04-21;MO;Macao;0;0;0;0
2021-04-22;MO;Macao;0;0;0;0
2021-04-23;MO;Macao;0;0;0;0
2021-04-24;MO;Macao;0;0;0;0
2021-04-25;MO;Macao;0;0;0;0
2021-04-26;MO;Macao;0;0;0;0
2021-04-27;MO;Macao;0;0;0;0
2021-04-28;MO;Macao;0;0;0;0
2021-04-29;MO;Macao;0;0;0;0
2021-04-30;MO;Macao;0;0;0;0
2021-05-01;MO;Macao;0;0;0;0
2021-05-02;MO;Macao;0;0;0;0
2021-05-03;MO;Macao;0;0;0;0
2021-05-04;MO;Macao;0;0;0;0
2021-05-05;MO;Macao;0;0;0;0
2021-05-06;MO;Macao;0;0;0;0
2021-05-07;MO;Macao;0;0;0;0
2021-05-08;MO;Macao;0;0;0;0
2021-05-09;MO;Macao;0;0;0;0
2021-05-10;MO;Macao;0;0;0;0
2021-05-11;MO;Macao;0;0;0;0
2021-05-12;MO;Macao;0;0;0;0
2021-05-13;MO;Macao;0;0;0;0
2021-05-14;MO;Macao;0;0;0;0
2021-05-15;MO;Macao;0;0;0;0
2021-05-16;MO;Macao;0;0;0;0
2021-05-17;MO;Macao;0;0;0;0
2021-05-18;MO;Macao;0;0;0;0
2021-05-19;MO;Macao;0;0;0;0
2021-05-20;MO;Macao;0;0;0;0
2021-05-21;MO;Macao;0;0;0;0
2021-05-22;MO;Macao;0;0;0;0
2021-05-23;MO;Macao;0;0;0;0
2021-05-24;MO;Macao;0;0;0;0
2021-05-25;MO;Macao;0;0;0;0
2021-05-26;MO;Macao;0;0;0;0
2021-05-27;MO;Macao;0;0;0;0
2021-05-28;MO;Macao;0;0;0;0
2021-05-29;MO;Macao;0;0;0;0
2021-05-30;MO;Macao;0;0;0;0
2021-05-31;MO;Macao;0;0;0;0
2021-06-01;MO;Macao;0;0;0;0
2021-06-02;MO;Macao;0;0;0;0
2021-06-03;MO;Macao;0;0;0;0
2021-06-04;MO;Macao;0;0;0;0
2021-06-05;MO;Macao;0;0;0;0
2021-06-06;MO;Macao;0;0;0;0
2021-06-07;MO;Macao;0;0;0;0
2021-06-08;MO;Macao;0;0;0;0
2021-06-09;MO;Macao;0;0;0;0
2021-06-10;MO;Macao;0;0;0;0
2021-06-11;MO;Macao;0;0;0;0
2021-06-12;MO;Macao;0;0;0;0
2021-06-13;MO;Macao;0;0;0;0
2021-06-14;MO;Macao;0;0;0;0
2021-06-15;MO;Macao;0;0;0;0
2021-06-16;MO;Macao;0;0;0;0
2021-06-17;MO;Macao;0;0;0;0
2021-06-18;MO;Macao;0;0;0;0
2021-06-19;MO;Macao;0;0;0;0
2021-06-20;MO;Macao;0;0;0;0
2021-06-21;MO;Macao;0;0;0;0
2021-06-22;MO;Macao;0;0;0;0
2021-06-23;MO;Macao;0;0;0;0
2021-06-24;MO;Macao;0;0;0;0
2021-06-25;MO;Macao;0;0;0;0
2021-06-26;MO;Macao;0;0;0;0
2021-06-27;MO;Macao;0;0;0;0
2021-06-28;MO;Macao;0;0;0;0
2021-06-29;MO;Macao;0;0;0;0
2021-06-30;MO;Macao;0;0;0;0
2021-07-01;MO;Macao;0;0;0;0
2020-03-20;MG;Madagascar;3;0;3;0
2020-03-21;MG;Madagascar;0;0;3;0
2020-03-22;MG;Madagascar;0;0;3;0
2020-03-23;MG;Madagascar;9;0;12;0
2020-03-24;MG;Madagascar;5;0;17;0
2020-03-25;MG;Madagascar;2;0;19;0
2020-03-26;MG;Madagascar;4;0;23;0
2020-03-27;MG;Madagascar;3;0;26;0
2020-03-28;MG;Madagascar;0;0;26;0
2020-03-29;MG;Madagascar;13;0;39;0
2020-03-30;MG;Madagascar;4;0;43;0
2020-03-31;MG;Madagascar;14;0;57;0
2020-04-01;MG;Madagascar;0;0;57;0
2020-04-02;MG;Madagascar;2;0;59;0
2020-04-03;MG;Madagascar;11;0;70;0
2020-04-04;MG;Madagascar;0;0;70;0
2020-04-05;MG;Madagascar;2;0;72;0
2020-04-06;MG;Madagascar;10;0;82;0
2020-04-07;MG;Madagascar;6;0;88;0
2020-04-08;MG;Madagascar;5;0;93;0
2020-04-09;MG;Madagascar;0;0;93;0
2020-04-10;MG;Madagascar;0;0;93;0
2020-04-11;MG;Madagascar;9;0;102;0
2020-04-12;MG;Madagascar;4;0;106;0
2020-04-13;MG;Madagascar;0;0;106;0
2020-04-14;MG;Madagascar;2;0;108;0
2020-04-15;MG;Madagascar;2;0;110;0
2020-04-16;MG;Madagascar;1;0;111;0
2020-04-17;MG;Madagascar;6;0;117;0
2020-04-18;MG;Madagascar;3;0;120;0
2020-04-19;MG;Madagascar;1;0;121;0
2020-04-20;MG;Madagascar;0;0;121;0
2020-04-21;MG;Madagascar;0;0;121;0
2020-04-22;MG;Madagascar;0;0;121;0
2020-04-23;MG;Madagascar;0;0;121;0
2020-04-24;MG;Madagascar;1;0;122;0
2020-04-25;MG;Madagascar;1;0;123;0
2020-04-26;MG;Madagascar;1;0;124;0
2020-04-27;MG;Madagascar;4;0;128;0
2020-04-28;MG;Madagascar;0;0;128;0
2020-04-29;MG;Madagascar;0;0;128;0
2020-04-30;MG;Madagascar;0;0;128;0
2020-05-01;MG;Madagascar;4;0;132;0
2020-05-02;MG;Madagascar;3;0;135;0
2020-05-03;MG;Madagascar;14;0;149;0
2020-05-04;MG;Madagascar;0;0;149;0
2020-05-05;MG;Madagascar;2;0;151;0
2020-05-06;MG;Madagascar;7;0;158;0
2020-05-07;MG;Madagascar;35;0;193;0
2020-05-08;MG;Madagascar;0;0;193;0
2020-05-09;MG;Madagascar;0;0;193;0
2020-05-10;MG;Madagascar;0;0;193;0
2020-05-11;MG;Madagascar;-7;0;186;0
2020-05-12;MG;Madagascar;0;0;186;0
2020-05-13;MG;Madagascar;26;0;212;0
2020-05-14;MG;Madagascar;18;0;230;0
2020-05-15;MG;Madagascar;8;0;238;0
2020-05-16;MG;Madagascar;45;0;283;0
2020-05-17;MG;Madagascar;21;1;304;1
2020-05-18;MG;Madagascar;18;0;322;1
2020-05-19;MG;Madagascar;4;1;326;2
2020-05-20;MG;Madagascar;45;0;371;2
2020-05-21;MG;Madagascar;34;0;405;2
2020-05-22;MG;Madagascar;43;0;448;2
2020-05-23;MG;Madagascar;40;0;488;2
2020-05-24;MG;Madagascar;39;0;527;2
2020-05-25;MG;Madagascar;15;0;542;2
2020-05-26;MG;Madagascar;44;0;586;2
2020-05-27;MG;Madagascar;26;0;612;2
2020-05-28;MG;Madagascar;44;0;656;2
2020-05-29;MG;Madagascar;42;3;698;5
2020-05-30;MG;Madagascar;60;1;758;6
2020-05-31;MG;Madagascar;13;0;771;6
2020-06-01;MG;Madagascar;55;0;826;6
2020-06-02;MG;Madagascar;19;0;845;6
2020-06-03;MG;Madagascar;63;0;908;6
2020-06-04;MG;Madagascar;49;1;957;7
2020-06-05;MG;Madagascar;18;0;975;7
2020-06-06;MG;Madagascar;51;1;1026;8
2020-06-07;MG;Madagascar;26;1;1052;9
2020-06-08;MG;Madagascar;42;0;1094;9
2020-06-09;MG;Madagascar;44;0;1138;9
2020-06-10;MG;Madagascar;24;1;1162;10
2020-06-11;MG;Madagascar;41;0;1203;10
2020-06-12;MG;Madagascar;37;0;1240;10
2020-06-13;MG;Madagascar;12;0;1252;10
2020-06-14;MG;Madagascar;20;0;1272;10
2020-06-15;MG;Madagascar;18;0;1290;10
2020-06-16;MG;Madagascar;27;2;1317;12
2020-06-17;MG;Madagascar;61;0;1378;12
2020-06-18;MG;Madagascar;25;1;1403;13
2020-06-19;MG;Madagascar;40;0;1443;13
2020-06-20;MG;Madagascar;60;0;1503;13
2020-06-21;MG;Madagascar;93;1;1596;14
2020-06-22;MG;Madagascar;44;1;1640;15
2020-06-23;MG;Madagascar;84;0;1724;15
2020-06-24;MG;Madagascar;63;1;1787;16
2020-06-25;MG;Madagascar;42;0;1829;16
2020-06-26;MG;Madagascar;93;0;1922;16
2020-06-27;MG;Madagascar;83;0;2005;16
2020-06-28;MG;Madagascar;73;2;2078;18
2020-06-29;MG;Madagascar;60;2;2138;20
2020-06-30;MG;Madagascar;76;0;2214;20
2020-07-01;MG;Madagascar;89;2;2303;22
2020-07-02;MG;Madagascar;100;2;2403;24
2020-07-03;MG;Madagascar;109;2;2512;26
2020-07-04;MG;Madagascar;216;3;2728;29
2020-07-05;MG;Madagascar;213;3;2941;32
2020-07-06;MG;Madagascar;309;1;3250;33
2020-07-07;MG;Madagascar;222;0;3472;33
2020-07-08;MG;Madagascar;101;0;3573;33
2020-07-09;MG;Madagascar;209;0;3782;33
2020-07-10;MG;Madagascar;361;1;4143;34
2020-07-11;MG;Madagascar;435;0;4578;34
2020-07-12;MG;Madagascar;289;1;4867;35
2020-07-13;MG;Madagascar;213;2;5080;37
2020-07-14;MG;Madagascar;263;2;5343;39
2020-07-15;MG;Madagascar;262;4;5605;43
2020-07-16;MG;Madagascar;484;10;6089;53
2020-07-17;MG;Madagascar;378;1;6467;54
2020-07-18;MG;Madagascar;382;1;6849;55
2020-07-19;MG;Madagascar;200;4;7049;59
2020-07-20;MG;Madagascar;104;3;7153;62
2020-07-21;MG;Madagascar;395;3;7548;65
2020-07-22;MG;Madagascar;614;4;8162;69
2020-07-23;MG;Madagascar;219;1;8381;70
2020-07-24;MG;Madagascar;360;6;8741;76
2020-07-25;MG;Madagascar;125;2;8866;78
2020-07-26;MG;Madagascar;429;7;9295;85
2020-07-27;MG;Madagascar;395;6;9690;91
2020-07-28;MG;Madagascar;414;2;10104;93
2020-07-29;MG;Madagascar;213;6;10317;99
2020-07-30;MG;Madagascar;431;6;10748;105
2020-07-31;MG;Madagascar;120;1;10868;106
2020-08-01;MG;Madagascar;405;1;11273;107
2020-08-02;MG;Madagascar;255;7;11528;114
2020-08-03;MG;Madagascar;132;4;11660;118
2020-08-04;MG;Madagascar;235;5;11895;123
2020-08-05;MG;Madagascar;327;4;12222;127
2020-08-06;MG;Madagascar;304;7;12526;134
2020-08-07;MG;Madagascar;182;1;12708;135
2020-08-08;MG;Madagascar;214;6;12922;141
2020-08-09;MG;Madagascar;164;7;13086;148
2020-08-10;MG;Madagascar;116;3;13202;151
2020-08-11;MG;Madagascar;115;1;13317;152
2020-08-12;MG;Madagascar;80;4;13397;156
2020-08-13;MG;Madagascar;125;6;13522;162
2020-08-14;MG;Madagascar;121;2;13643;164
2020-08-15;MG;Madagascar;81;2;13724;166
2020-08-16;MG;Madagascar;103;4;13827;170
2020-08-17;MG;Madagascar;59;1;13886;171
2020-08-18;MG;Madagascar;123;2;14009;173
2020-08-19;MG;Madagascar;65;0;14074;173
2020-08-20;MG;Madagascar;80;4;14154;177
2020-08-21;MG;Madagascar;64;1;14218;178
2020-08-22;MG;Madagascar;59;0;14277;178
2020-08-23;MG;Madagascar;50;0;14327;178
2020-08-24;MG;Madagascar;75;0;14402;178
2020-08-25;MG;Madagascar;73;0;14475;178
2020-08-26;MG;Madagascar;79;3;14554;181
2020-08-27;MG;Madagascar;38;3;14592;184
2020-08-28;MG;Madagascar;104;3;14696;187
2020-08-29;MG;Madagascar;95;3;14791;190
2020-08-30;MG;Madagascar;52;1;14843;191
2020-08-31;MG;Madagascar;20;1;14863;192
2020-09-01;MG;Madagascar;94;3;14957;195
2020-09-02;MG;Madagascar;66;1;15023;196
2020-09-03;MG;Madagascar;83;1;15106;197
2020-09-04;MG;Madagascar;81;1;15187;198
2020-09-05;MG;Madagascar;82;1;15269;199
2020-09-06;MG;Madagascar;50;1;15319;200
2020-09-07;MG;Madagascar;33;2;15352;202
2020-09-08;MG;Madagascar;83;4;15435;206
2020-09-09;MG;Madagascar;85;0;15520;206
2020-09-10;MG;Madagascar;104;2;15624;208
2020-09-11;MG;Madagascar;45;1;15669;209
2020-09-12;MG;Madagascar;68;1;15737;210
2020-09-13;MG;Madagascar;20;1;15757;211
2020-09-14;MG;Madagascar;12;2;15769;213
2020-09-15;MG;Madagascar;34;1;15803;214
2020-09-16;MG;Madagascar;68;1;15871;215
2020-09-17;MG;Madagascar;54;1;15925;216
2020-09-18;MG;Madagascar;46;1;15971;217
2020-09-19;MG;Madagascar;49;2;16020;219
2020-09-20;MG;Madagascar;33;4;16053;223
2020-09-21;MG;Madagascar;20;2;16073;225
2020-09-22;MG;Madagascar;63;1;16136;226
2020-09-23;MG;Madagascar;31;0;16167;226
2020-09-24;MG;Madagascar;24;1;16191;227
2020-09-25;MG;Madagascar;30;1;16221;228
2020-09-26;MG;Madagascar;36;1;16257;229
2020-09-27;MG;Madagascar;28;0;16285;229
2020-09-28;MG;Madagascar;63;0;16348;229
2020-09-29;MG;Madagascar;29;0;16377;229
2020-09-30;MG;Madagascar;31;1;16408;230
2020-10-01;MG;Madagascar;46;2;16454;232
2020-10-02;MG;Madagascar;39;0;16493;232
2020-10-03;MG;Madagascar;36;0;16529;232
2020-10-04;MG;Madagascar;29;0;16558;232
2020-10-05;MG;Madagascar;12;1;16570;233
2020-10-06;MG;Madagascar;30;1;16600;234
2020-10-07;MG;Madagascar;33;1;16633;235
2020-10-08;MG;Madagascar;21;0;16654;235
2020-10-09;MG;Madagascar;22;2;16676;237
2020-10-10;MG;Madagascar;26;0;16702;237
2020-10-11;MG;Madagascar;16;0;16718;237
2020-10-12;MG;Madagascar;8;0;16726;237
2020-10-13;MG;Madagascar;28;0;16754;237
2020-10-14;MG;Madagascar;0;0;16754;237
2020-10-15;MG;Madagascar;0;0;16754;237
2020-10-16;MG;Madagascar;0;0;16754;237
2020-10-17;MG;Madagascar;56;1;16810;238
2020-10-18;MG;Madagascar;0;0;16810;238
2020-10-19;MG;Madagascar;0;0;16810;238
2020-10-20;MG;Madagascar;0;0;16810;238
2020-10-21;MG;Madagascar;0;0;16810;238
2020-10-22;MG;Madagascar;0;0;16810;238
2020-10-23;MG;Madagascar;0;0;16810;238
2020-10-24;MG;Madagascar;158;6;16968;244
2020-10-25;MG;Madagascar;0;0;16968;244
2020-10-26;MG;Madagascar;0;0;16968;244
2020-10-27;MG;Madagascar;0;0;16968;244
2020-10-28;MG;Madagascar;0;0;16968;244
2020-10-29;MG;Madagascar;0;0;16968;244
2020-10-30;MG;Madagascar;0;0;16968;244
2020-10-31;MG;Madagascar;143;0;17111;244
2020-11-01;MG;Madagascar;0;0;17111;244
2020-11-02;MG;Madagascar;0;0;17111;244
2020-11-03;MG;Madagascar;0;0;17111;244
2020-11-04;MG;Madagascar;0;0;17111;244
2020-11-05;MG;Madagascar;0;0;17111;244
2020-11-06;MG;Madagascar;0;0;17111;244
2020-11-07;MG;Madagascar;0;0;17111;244
2020-11-08;MG;Madagascar;112;5;17223;249
2020-11-09;MG;Madagascar;0;0;17223;249
2020-11-10;MG;Madagascar;0;0;17223;249
2020-11-11;MG;Madagascar;0;0;17223;249
2020-11-12;MG;Madagascar;0;0;17223;249
2020-11-13;MG;Madagascar;0;0;17223;249
2020-11-14;MG;Madagascar;0;0;17223;249
2020-11-15;MG;Madagascar;87;1;17310;250
2020-11-16;MG;Madagascar;0;0;17310;250
2020-11-17;MG;Madagascar;0;0;17310;250
2020-11-18;MG;Madagascar;0;0;17310;250
2020-11-19;MG;Madagascar;0;0;17310;250
2020-11-20;MG;Madagascar;0;0;17310;250
2020-11-21;MG;Madagascar;0;0;17310;250
2020-11-22;MG;Madagascar;31;1;17341;251
2020-11-23;MG;Madagascar;0;0;17341;251
2020-11-24;MG;Madagascar;0;0;17341;251
2020-11-25;MG;Madagascar;0;0;17341;251
2020-11-26;MG;Madagascar;0;0;17341;251
2020-11-27;MG;Madagascar;0;0;17341;251
2020-11-28;MG;Madagascar;0;0;17341;251
2020-11-29;MG;Madagascar;0;0;17341;251
2020-11-30;MG;Madagascar;0;0;17341;251
2020-12-01;MG;Madagascar;0;0;17341;251
2020-12-02;MG;Madagascar;0;0;17341;251
2020-12-03;MG;Madagascar;0;4;17341;255
2020-12-04;MG;Madagascar;0;0;17341;255
2020-12-05;MG;Madagascar;132;0;17473;255
2020-12-06;MG;Madagascar;0;0;17473;255
2020-12-07;MG;Madagascar;0;0;17473;255
2020-12-08;MG;Madagascar;0;0;17473;255
2020-12-09;MG;Madagascar;0;0;17473;255
2020-12-10;MG;Madagascar;0;0;17473;255
2020-12-11;MG;Madagascar;0;0;17473;255
2020-12-12;MG;Madagascar;114;4;17587;259
2020-12-13;MG;Madagascar;0;0;17587;259
2020-12-14;MG;Madagascar;0;0;17587;259
2020-12-15;MG;Madagascar;0;0;17587;259
2020-12-16;MG;Madagascar;0;0;17587;259
2020-12-17;MG;Madagascar;0;0;17587;259
2020-12-18;MG;Madagascar;0;0;17587;259
2020-12-19;MG;Madagascar;0;0;17587;259
2020-12-20;MG;Madagascar;46;1;17633;260
2020-12-21;MG;Madagascar;0;0;17633;260
2020-12-22;MG;Madagascar;0;0;17633;260
2020-12-23;MG;Madagascar;0;0;17633;260
2020-12-24;MG;Madagascar;0;0;17633;260
2020-12-25;MG;Madagascar;0;0;17633;260
2020-12-26;MG;Madagascar;0;0;17633;260
2020-12-27;MG;Madagascar;81;1;17714;261
2020-12-28;MG;Madagascar;0;0;17714;261
2020-12-29;MG;Madagascar;0;0;17714;261
2020-12-30;MG;Madagascar;0;0;17714;261
2020-12-31;MG;Madagascar;0;0;17714;261
2021-01-01;MG;Madagascar;0;0;17714;261
2021-01-02;MG;Madagascar;53;1;17767;262
2021-01-03;MG;Madagascar;0;0;17767;262
2021-01-04;MG;Madagascar;0;0;17767;262
2021-01-05;MG;Madagascar;0;0;17767;262
2021-01-06;MG;Madagascar;0;0;17767;262
2021-01-07;MG;Madagascar;0;0;17767;262
2021-01-08;MG;Madagascar;0;0;17767;262
2021-01-09;MG;Madagascar;0;0;17767;262
2021-01-10;MG;Madagascar;234;5;18001;267
2021-01-11;MG;Madagascar;0;0;18001;267
2021-01-12;MG;Madagascar;0;0;18001;267
2021-01-13;MG;Madagascar;0;0;18001;267
2021-01-14;MG;Madagascar;0;0;18001;267
2021-01-15;MG;Madagascar;0;0;18001;267
2021-01-16;MG;Madagascar;0;0;18001;267
2021-01-17;MG;Madagascar;300;6;18301;273
2021-01-18;MG;Madagascar;0;0;18301;273
2021-01-19;MG;Madagascar;0;0;18301;273
2021-01-20;MG;Madagascar;0;0;18301;273
2021-01-21;MG;Madagascar;0;0;18301;273
2021-01-22;MG;Madagascar;0;0;18301;273
2021-01-23;MG;Madagascar;0;0;18301;273
2021-01-24;MG;Madagascar;442;6;18743;279
2021-01-25;MG;Madagascar;0;0;18743;279
2021-01-26;MG;Madagascar;0;0;18743;279
2021-01-27;MG;Madagascar;0;0;18743;279
2021-01-28;MG;Madagascar;0;0;18743;279
2021-01-29;MG;Madagascar;0;0;18743;279
2021-01-30;MG;Madagascar;0;0;18743;279
2021-01-31;MG;Madagascar;322;2;19065;281
2021-02-01;MG;Madagascar;0;0;19065;281
2021-02-02;MG;Madagascar;0;0;19065;281
2021-02-03;MG;Madagascar;0;0;19065;281
2021-02-04;MG;Madagascar;0;0;19065;281
2021-02-05;MG;Madagascar;0;0;19065;281
2021-02-06;MG;Madagascar;0;0;19065;281
2021-02-07;MG;Madagascar;295;4;19360;285
2021-02-08;MG;Madagascar;0;0;19360;285
2021-02-09;MG;Madagascar;0;0;19360;285
2021-02-10;MG;Madagascar;0;0;19360;285
2021-02-11;MG;Madagascar;0;0;19360;285
2021-02-12;MG;Madagascar;0;0;19360;285
2021-02-13;MG;Madagascar;0;0;19360;285
2021-02-14;MG;Madagascar;238;7;19598;292
2021-02-15;MG;Madagascar;0;0;19598;292
2021-02-16;MG;Madagascar;0;0;19598;292
2021-02-17;MG;Madagascar;0;0;19598;292
2021-02-18;MG;Madagascar;0;0;19598;292
2021-02-19;MG;Madagascar;0;0;19598;292
2021-02-20;MG;Madagascar;0;0;19598;292
2021-02-21;MG;Madagascar;233;5;19831;297
2021-02-22;MG;Madagascar;0;0;19831;297
2021-02-23;MG;Madagascar;0;0;19831;297
2021-02-24;MG;Madagascar;0;0;19831;297
2021-02-25;MG;Madagascar;0;0;19831;297
2021-02-26;MG;Madagascar;0;0;19831;297
2021-02-27;MG;Madagascar;0;0;19831;297
2021-02-28;MG;Madagascar;0;0;19831;297
2021-03-01;MG;Madagascar;0;0;19831;297
2021-03-02;MG;Madagascar;0;0;19831;297
2021-03-03;MG;Madagascar;0;0;19831;297
2021-03-04;MG;Madagascar;0;0;19831;297
2021-03-05;MG;Madagascar;0;0;19831;297
2021-03-06;MG;Madagascar;324;3;20155;300
2021-03-07;MG;Madagascar;0;0;20155;300
2021-03-08;MG;Madagascar;0;0;20155;300
2021-03-09;MG;Madagascar;0;0;20155;300
2021-03-10;MG;Madagascar;0;0;20155;300
2021-03-11;MG;Madagascar;0;0;20155;300
2021-03-12;MG;Madagascar;0;0;20155;300
2021-03-13;MG;Madagascar;1201;26;21356;326
2021-03-14;MG;Madagascar;0;0;21356;326
2021-03-15;MG;Madagascar;231;8;21587;334
2021-03-16;MG;Madagascar;101;1;21688;335
2021-03-17;MG;Madagascar;138;2;21826;337
2021-03-18;MG;Madagascar;173;1;21999;338
2021-03-19;MG;Madagascar;114;2;22113;340
2021-03-20;MG;Madagascar;162;5;22275;345
2021-03-21;MG;Madagascar;209;6;22484;351
2021-03-22;MG;Madagascar;132;4;22616;355
2021-03-23;MG;Madagascar;66;6;22682;361
2021-03-24;MG;Madagascar;162;2;22844;363
2021-03-25;MG;Madagascar;196;6;23040;369
2021-03-26;MG;Madagascar;190;9;23230;378
2021-03-27;MG;Madagascar;194;3;23424;381
2021-03-28;MG;Madagascar;161;6;23585;387
2021-03-29;MG;Madagascar;384;7;23969;394
2021-03-30;MG;Madagascar;295;9;24264;403
2021-03-31;MG;Madagascar;162;15;24426;418
2021-04-01;MG;Madagascar;270;15;24696;433
2021-04-02;MG;Madagascar;272;11;24968;444
2021-04-03;MG;Madagascar;294;5;25262;449
2021-04-04;MG;Madagascar;310;5;25572;454
2021-04-05;MG;Madagascar;137;5;25709;459
2021-04-06;MG;Madagascar;165;3;25874;462
2021-04-07;MG;Madagascar;253;7;26127;469
2021-04-08;MG;Madagascar;348;6;26475;475
2021-04-09;MG;Madagascar;559;11;27034;486
2021-04-10;MG;Madagascar;514;7;27548;493
2021-04-11;MG;Madagascar;515;7;28063;500
2021-04-12;MG;Madagascar;478;6;28541;506
2021-04-13;MG;Madagascar;224;6;28765;512
2021-04-14;MG;Madagascar;583;8;29348;520
2021-04-15;MG;Madagascar;859;7;30207;527
2021-04-16;MG;Madagascar;832;4;31039;531
2021-04-17;MG;Madagascar;578;7;31617;538
2021-04-18;MG;Madagascar;588;4;32205;542
2021-04-19;MG;Madagascar;593;10;32798;552
2021-04-20;MG;Madagascar;404;11;33202;563
2021-04-21;MG;Madagascar;390;6;33592;569
2021-04-22;MG;Madagascar;477;10;34069;579
2021-04-23;MG;Madagascar;706;9;34775;588
2021-04-24;MG;Madagascar;487;5;35262;593
2021-04-25;MG;Madagascar;484;6;35746;599
2021-04-26;MG;Madagascar;299;6;36045;605
2021-04-27;MG;Madagascar;145;9;36190;614
2021-04-28;MG;Madagascar;320;17;36510;631
2021-04-29;MG;Madagascar;186;6;36696;637
2021-04-30;MG;Madagascar;318;6;37014;643
2021-05-01;MG;Madagascar;282;11;37296;654
2021-05-02;MG;Madagascar;334;12;37630;666
2021-05-03;MG;Madagascar;121;11;37751;677
2021-05-04;MG;Madagascar;238;5;37989;682
2021-05-05;MG;Madagascar;127;8;38116;690
2021-05-06;MG;Madagascar;221;5;38337;695
2021-05-07;MG;Madagascar;304;6;38641;701
2021-05-08;MG;Madagascar;233;15;38874;716
2021-05-09;MG;Madagascar;138;6;39012;722
2021-05-10;MG;Madagascar;150;7;39162;729
2021-05-11;MG;Madagascar;189;3;39351;732
2021-05-12;MG;Madagascar;159;6;39510;738
2021-05-13;MG;Madagascar;249;7;39759;745
2021-05-14;MG;Madagascar;129;3;39888;748
2021-05-15;MG;Madagascar;117;6;40005;754
2021-05-16;MG;Madagascar;136;9;40141;763
2021-05-17;MG;Madagascar;63;8;40204;771
2021-05-18;MG;Madagascar;122;3;40326;774
2021-05-19;MG;Madagascar;59;3;40385;777
2021-05-20;MG;Madagascar;134;6;40519;783
2021-05-21;MG;Madagascar;173;3;40692;786
2021-05-22;MG;Madagascar;88;7;40780;793
2021-05-23;MG;Madagascar;96;7;40876;800
2021-05-24;MG;Madagascar;78;6;40954;806
2021-05-25;MG;Madagascar;45;4;40999;810
2021-05-26;MG;Madagascar;62;7;41061;817
2021-05-27;MG;Madagascar;41;5;41102;822
2021-05-28;MG;Madagascar;82;5;41184;827
2021-05-29;MG;Madagascar;50;2;41234;829
2021-05-30;MG;Madagascar;32;6;41266;835
2021-05-31;MG;Madagascar;76;4;41342;839
2021-06-01;MG;Madagascar;24;2;41366;841
2021-06-02;MG;Madagascar;53;5;41419;846
2021-06-03;MG;Madagascar;69;4;41488;850
2021-06-04;MG;Madagascar;52;7;41540;857
2021-06-05;MG;Madagascar;91;2;41631;859
2021-06-06;MG;Madagascar;59;2;41690;861
2021-06-07;MG;Madagascar;52;5;41742;866
2021-06-08;MG;Madagascar;16;5;41758;871
2021-06-09;MG;Madagascar;28;3;41786;874
2021-06-10;MG;Madagascar;54;1;41840;875
2021-06-11;MG;Madagascar;29;4;41869;879
2021-06-12;MG;Madagascar;25;3;41894;882
2021-06-13;MG;Madagascar;39;5;41933;887
2021-06-14;MG;Madagascar;15;2;41948;889
2021-06-15;MG;Madagascar;18;2;41966;891
2021-06-16;MG;Madagascar;32;1;41998;892
2021-06-17;MG;Madagascar;36;0;42034;892
2021-06-18;MG;Madagascar;42;3;42076;895
2021-06-19;MG;Madagascar;11;1;42087;896
2021-06-20;MG;Madagascar;36;5;42123;901
2021-06-21;MG;Madagascar;14;2;42137;903
2021-06-22;MG;Madagascar;0;0;42137;903
2021-06-23;MG;Madagascar;24;2;42161;905
2021-06-24;MG;Madagascar;5;0;42166;905
2021-06-25;MG;Madagascar;28;1;42194;906
2021-06-26;MG;Madagascar;0;0;42194;906
2021-06-27;MG;Madagascar;0;0;42194;906
2021-06-28;MG;Madagascar;0;3;42194;909
2021-06-29;MG;Madagascar;13;2;42207;911
2021-06-30;MG;Madagascar;9;2;42216;913
2021-07-01;MG;Madagascar;31;2;42247;915
2020-03-29;MW;Malawi;0;0;0;0
2020-03-30;MW;Malawi;0;0;0;0
2020-03-31;MW;Malawi;0;0;0;0
2020-04-01;MW;Malawi;0;0;0;0
2020-04-02;MW;Malawi;3;0;3;0
2020-04-03;MW;Malawi;0;0;3;0
2020-04-04;MW;Malawi;1;0;4;0
2020-04-05;MW;Malawi;0;0;4;0
2020-04-06;MW;Malawi;1;0;5;0
2020-04-07;MW;Malawi;3;1;8;1
2020-04-08;MW;Malawi;0;0;8;1
2020-04-09;MW;Malawi;0;0;8;1
2020-04-10;MW;Malawi;1;0;9;1
2020-04-11;MW;Malawi;3;1;12;2
2020-04-12;MW;Malawi;1;0;13;2
2020-04-13;MW;Malawi;3;0;16;2
2020-04-14;MW;Malawi;0;0;16;2
2020-04-15;MW;Malawi;0;0;16;2
2020-04-16;MW;Malawi;0;0;16;2
2020-04-17;MW;Malawi;1;0;17;2
2020-04-18;MW;Malawi;0;0;17;2
2020-04-19;MW;Malawi;0;0;17;2
2020-04-20;MW;Malawi;0;0;17;2
2020-04-21;MW;Malawi;1;0;18;2
2020-04-22;MW;Malawi;5;1;23;3
2020-04-23;MW;Malawi;10;0;33;3
2020-04-24;MW;Malawi;0;0;33;3
2020-04-25;MW;Malawi;0;0;33;3
2020-04-26;MW;Malawi;1;0;34;3
2020-04-27;MW;Malawi;2;0;36;3
2020-04-28;MW;Malawi;0;0;36;3
2020-04-29;MW;Malawi;0;0;36;3
2020-04-30;MW;Malawi;1;0;37;3
2020-05-01;MW;Malawi;0;0;37;3
2020-05-02;MW;Malawi;1;0;38;3
2020-05-03;MW;Malawi;1;0;39;3
2020-05-04;MW;Malawi;2;0;41;3
2020-05-05;MW;Malawi;0;0;41;3
2020-05-06;MW;Malawi;2;0;43;3
2020-05-07;MW;Malawi;0;0;43;3
2020-05-08;MW;Malawi;0;0;43;3
2020-05-09;MW;Malawi;13;0;56;3
2020-05-10;MW;Malawi;0;0;56;3
2020-05-11;MW;Malawi;1;0;57;3
2020-05-12;MW;Malawi;0;0;57;3
2020-05-13;MW;Malawi;6;0;63;3
2020-05-14;MW;Malawi;0;0;63;3
2020-05-15;MW;Malawi;0;0;63;3
2020-05-16;MW;Malawi;2;0;65;3
2020-05-17;MW;Malawi;5;0;70;3
2020-05-18;MW;Malawi;0;0;70;3
2020-05-19;MW;Malawi;0;0;70;3
2020-05-20;MW;Malawi;1;0;71;3
2020-05-21;MW;Malawi;1;0;72;3
2020-05-22;MW;Malawi;10;0;82;3
2020-05-23;MW;Malawi;0;0;82;3
2020-05-24;MW;Malawi;1;1;83;4
2020-05-25;MW;Malawi;18;0;101;4
2020-05-26;MW;Malawi;0;0;101;4
2020-05-27;MW;Malawi;0;0;101;4
2020-05-28;MW;Malawi;102;0;203;4
2020-05-29;MW;Malawi;70;0;273;4
2020-05-30;MW;Malawi;6;0;279;4
2020-05-31;MW;Malawi;5;0;284;4
2020-06-01;MW;Malawi;52;0;336;4
2020-06-02;MW;Malawi;22;0;358;4
2020-06-03;MW;Malawi;11;0;369;4
2020-06-04;MW;Malawi;24;0;393;4
2020-06-05;MW;Malawi;16;0;409;4
2020-06-06;MW;Malawi;0;0;409;4
2020-06-07;MW;Malawi;29;0;438;4
2020-06-08;MW;Malawi;5;0;443;4
2020-06-09;MW;Malawi;12;0;455;4
2020-06-10;MW;Malawi;0;0;455;4
2020-06-11;MW;Malawi;26;0;481;4
2020-06-12;MW;Malawi;0;0;481;4
2020-06-13;MW;Malawi;48;1;529;5
2020-06-14;MW;Malawi;18;1;547;6
2020-06-15;MW;Malawi;8;0;555;6
2020-06-16;MW;Malawi;9;0;564;6
2020-06-17;MW;Malawi;8;0;572;6
2020-06-18;MW;Malawi;20;2;592;8
2020-06-19;MW;Malawi;28;0;620;8
2020-06-20;MW;Malawi;0;0;620;8
2020-06-21;MW;Malawi;110;3;730;11
2020-06-22;MW;Malawi;19;0;749;11
2020-06-23;MW;Malawi;54;0;803;11
2020-06-24;MW;Malawi;138;0;941;11
2020-06-25;MW;Malawi;19;1;960;12
2020-06-26;MW;Malawi;45;1;1005;13
2020-06-27;MW;Malawi;33;0;1038;13
2020-06-28;MW;Malawi;108;0;1146;13
2020-06-29;MW;Malawi;6;0;1152;13
2020-06-30;MW;Malawi;72;1;1224;14
2020-07-01;MW;Malawi;41;2;1265;16
2020-07-02;MW;Malawi;77;0;1342;16
2020-07-03;MW;Malawi;156;0;1498;16
2020-07-04;MW;Malawi;115;1;1613;17
2020-07-05;MW;Malawi;0;0;1613;17
2020-07-06;MW;Malawi;129;2;1742;19
2020-07-07;MW;Malawi;76;0;1818;19
2020-07-08;MW;Malawi;46;5;1864;24
2020-07-09;MW;Malawi;78;1;1942;25
2020-07-10;MW;Malawi;127;6;2069;31
2020-07-11;MW;Malawi;192;2;2261;33
2020-07-12;MW;Malawi;103;5;2364;38
2020-07-13;MW;Malawi;66;1;2430;39
2020-07-14;MW;Malawi;67;1;2497;40
2020-07-15;MW;Malawi;117;3;2614;43
2020-07-16;MW;Malawi;98;8;2712;51
2020-07-17;MW;Malawi;93;4;2805;55
2020-07-18;MW;Malawi;5;0;2810;55
2020-07-19;MW;Malawi;97;4;2907;59
2020-07-20;MW;Malawi;85;3;2992;62
2020-07-21;MW;Malawi;53;2;3045;64
2020-07-22;MW;Malawi;257;12;3302;76
2020-07-23;MW;Malawi;0;0;3302;76
2020-07-24;MW;Malawi;151;11;3453;87
2020-07-25;MW;Malawi;0;0;3453;87
2020-07-26;MW;Malawi;187;12;3640;99
2020-07-27;MW;Malawi;24;0;3664;99
2020-07-28;MW;Malawi;45;4;3709;103
2020-07-29;MW;Malawi;29;0;3738;103
2020-07-30;MW;Malawi;120;4;3858;107
2020-07-31;MW;Malawi;220;7;4078;114
2020-08-01;MW;Malawi;108;6;4186;120
2020-08-02;MW;Malawi;45;3;4231;123
2020-08-03;MW;Malawi;41;0;4272;123
2020-08-04;MW;Malawi;89;5;4361;128
2020-08-05;MW;Malawi;65;8;4426;136
2020-08-06;MW;Malawi;65;1;4491;137
2020-08-07;MW;Malawi;84;0;4575;137
2020-08-08;MW;Malawi;49;6;4624;143
2020-08-09;MW;Malawi;34;3;4658;146
2020-08-10;MW;Malawi;16;0;4674;146
2020-08-11;MW;Malawi;40;6;4714;152
2020-08-12;MW;Malawi;38;0;4752;152
2020-08-13;MW;Malawi;160;1;4912;153
2020-08-14;MW;Malawi;76;3;4988;156
2020-08-15;MW;Malawi;38;1;5026;157
2020-08-16;MW;Malawi;46;4;5072;161
2020-08-17;MW;Malawi;53;1;5125;162
2020-08-18;MW;Malawi;68;1;5193;163
2020-08-19;MW;Malawi;47;1;5240;164
2020-08-20;MW;Malawi;42;1;5282;165
2020-08-21;MW;Malawi;40;1;5322;166
2020-08-22;MW;Malawi;60;2;5382;168
2020-08-23;MW;Malawi;32;0;5414;168
2020-08-24;MW;Malawi;5;1;5419;169
2020-08-25;MW;Malawi;4;1;5423;170
2020-08-26;MW;Malawi;51;3;5474;173
2020-08-27;MW;Malawi;22;0;5496;173
2020-08-28;MW;Malawi;27;1;5523;174
2020-08-29;MW;Malawi;5;0;5528;174
2020-08-30;MW;Malawi;8;0;5536;174
2020-08-31;MW;Malawi;30;1;5566;175
2020-09-01;MW;Malawi;10;0;5576;175
2020-09-02;MW;Malawi;3;0;5579;175
2020-09-03;MW;Malawi;14;0;5593;175
2020-09-04;MW;Malawi;15;0;5608;175
2020-09-05;MW;Malawi;3;0;5611;175
2020-09-06;MW;Malawi;3;0;5614;175
2020-09-07;MW;Malawi;7;1;5621;176
2020-09-08;MW;Malawi;9;0;5630;176
2020-09-09;MW;Malawi;23;0;5653;176
2020-09-10;MW;Malawi;2;0;5655;176
2020-09-11;MW;Malawi;14;1;5669;177
2020-09-12;MW;Malawi;9;0;5678;177
2020-09-13;MW;Malawi;12;0;5690;177
2020-09-14;MW;Malawi;7;1;5697;178
2020-09-15;MW;Malawi;4;0;5701;178
2020-09-16;MW;Malawi;3;0;5704;178
2020-09-17;MW;Malawi;7;1;5711;179
2020-09-18;MW;Malawi;5;0;5716;179
2020-09-19;MW;Malawi;2;0;5718;179
2020-09-20;MW;Malawi;13;0;5731;179
2020-09-21;MW;Malawi;2;0;5733;179
2020-09-22;MW;Malawi;6;0;5739;179
2020-09-23;MW;Malawi;7;0;5746;179
2020-09-24;MW;Malawi;1;0;5747;179
2020-09-25;MW;Malawi;17;0;5764;179
2020-09-26;MW;Malawi;2;0;5766;179
2020-09-27;MW;Malawi;2;0;5768;179
2020-09-28;MW;Malawi;2;0;5770;179
2020-09-29;MW;Malawi;2;0;5772;179
2020-09-30;MW;Malawi;1;0;5773;179
2020-10-01;MW;Malawi;6;0;5779;179
2020-10-02;MW;Malawi;4;0;5783;179
2020-10-03;MW;Malawi;0;0;5783;179
2020-10-04;MW;Malawi;3;0;5786;179
2020-10-05;MW;Malawi;8;1;5794;180
2020-10-06;MW;Malawi;2;0;5796;180
2020-10-07;MW;Malawi;7;0;5803;180
2020-10-08;MW;Malawi;6;0;5809;180
2020-10-09;MW;Malawi;4;0;5813;180
2020-10-10;MW;Malawi;8;0;5821;180
2020-10-11;MW;Malawi;0;0;5821;180
2020-10-12;MW;Malawi;3;0;5824;180
2020-10-13;MW;Malawi;3;1;5827;181
2020-10-14;MW;Malawi;2;0;5829;181
2020-10-15;MW;Malawi;7;0;5836;181
2020-10-16;MW;Malawi;6;0;5842;181
2020-10-17;MW;Malawi;10;0;5852;181
2020-10-18;MW;Malawi;5;0;5857;181
2020-10-19;MW;Malawi;3;0;5860;181
2020-10-20;MW;Malawi;1;1;5861;182
2020-10-21;MW;Malawi;3;1;5864;183
2020-10-22;MW;Malawi;10;0;5874;183
2020-10-23;MW;Malawi;11;0;5885;183
2020-10-24;MW;Malawi;2;0;5887;183
2020-10-25;MW;Malawi;3;0;5890;183
2020-10-26;MW;Malawi;4;0;5894;183
2020-10-27;MW;Malawi;3;0;5897;183
2020-10-28;MW;Malawi;7;1;5904;184
2020-10-29;MW;Malawi;12;0;5916;184
2020-10-30;MW;Malawi;7;0;5923;184
2020-10-31;MW;Malawi;7;0;5930;184
2020-11-01;MW;Malawi;2;0;5932;184
2020-11-02;MW;Malawi;1;0;5933;184
2020-11-03;MW;Malawi;1;0;5934;184
2020-11-04;MW;Malawi;0;0;5934;184
2020-11-05;MW;Malawi;6;0;5940;184
2020-11-06;MW;Malawi;2;0;5942;184
2020-11-07;MW;Malawi;6;0;5948;184
2020-11-08;MW;Malawi;3;0;5951;184
2020-11-09;MW;Malawi;2;1;5953;185
2020-11-10;MW;Malawi;0;0;5953;185
2020-11-11;MW;Malawi;2;0;5955;185
2020-11-12;MW;Malawi;3;0;5958;185
2020-11-13;MW;Malawi;4;0;5962;185
2020-11-14;MW;Malawi;2;0;5964;185
2020-11-15;MW;Malawi;1;0;5965;185
2020-11-16;MW;Malawi;6;0;5971;185
2020-11-17;MW;Malawi;0;0;5971;185
2020-11-18;MW;Malawi;28;0;5999;185
2020-11-19;MW;Malawi;3;0;6002;185
2020-11-20;MW;Malawi;1;0;6003;185
2020-11-21;MW;Malawi;0;0;6003;185
2020-11-22;MW;Malawi;0;0;6003;185
2020-11-23;MW;Malawi;6;0;6009;185
2020-11-24;MW;Malawi;8;0;6017;185
2020-11-25;MW;Malawi;1;0;6018;185
2020-11-26;MW;Malawi;2;0;6020;185
2020-11-27;MW;Malawi;4;0;6024;185
2020-11-28;MW;Malawi;1;0;6025;185
2020-11-29;MW;Malawi;0;0;6025;185
2020-11-30;MW;Malawi;3;0;6028;185
2020-12-01;MW;Malawi;0;0;6028;185
2020-12-02;MW;Malawi;12;0;6040;185
2020-12-03;MW;Malawi;3;0;6043;185
2020-12-04;MW;Malawi;4;0;6047;185
2020-12-05;MW;Malawi;2;0;6049;185
2020-12-06;MW;Malawi;2;0;6051;185
2020-12-07;MW;Malawi;0;0;6051;185
2020-12-08;MW;Malawi;0;1;6051;186
2020-12-09;MW;Malawi;0;0;6051;186
2020-12-10;MW;Malawi;0;0;6051;186
2020-12-11;MW;Malawi;4;0;6055;186
2020-12-12;MW;Malawi;8;0;6063;186
2020-12-13;MW;Malawi;3;1;6066;187
2020-12-14;MW;Malawi;4;0;6070;187
2020-12-15;MW;Malawi;10;0;6080;187
2020-12-16;MW;Malawi;11;0;6091;187
2020-12-17;MW;Malawi;47;0;6138;187
2020-12-18;MW;Malawi;10;0;6148;187
2020-12-19;MW;Malawi;5;0;6153;187
2020-12-20;MW;Malawi;8;0;6161;187
2020-12-21;MW;Malawi;41;0;6202;187
2020-12-22;MW;Malawi;46;0;6248;187
2020-12-23;MW;Malawi;13;0;6261;187
2020-12-24;MW;Malawi;16;0;6277;187
2020-12-25;MW;Malawi;62;0;6339;187
2020-12-26;MW;Malawi;4;1;6343;188
2020-12-27;MW;Malawi;11;0;6354;188
2020-12-28;MW;Malawi;23;0;6377;188
2020-12-29;MW;Malawi;11;0;6388;188
2020-12-30;MW;Malawi;83;1;6471;189
2020-12-31;MW;Malawi;112;0;6583;189
2021-01-01;MW;Malawi;101;2;6684;191
2021-01-02;MW;Malawi;28;1;6712;192
2021-01-03;MW;Malawi;132;3;6844;195
2021-01-04;MW;Malawi;91;1;6935;196
2021-01-05;MW;Malawi;175;3;7110;199
2021-01-06;MW;Malawi;227;0;7337;199
2021-01-07;MW;Malawi;274;4;7611;203
2021-01-08;MW;Malawi;314;5;7925;208
2021-01-09;MW;Malawi;381;12;8306;220
2021-01-10;MW;Malawi;269;5;8575;225
2021-01-11;MW;Malawi;452;10;9027;235
2021-01-12;MW;Malawi;0;0;9027;235
2021-01-13;MW;Malawi;373;19;9400;254
2021-01-14;MW;Malawi;591;21;9991;275
2021-01-15;MW;Malawi;1232;16;11223;291
2021-01-16;MW;Malawi;562;9;11785;300
2021-01-17;MW;Malawi;685;14;12470;314
2021-01-18;MW;Malawi;557;7;13027;321
2021-01-19;MW;Malawi;853;15;13880;336
2021-01-20;MW;Malawi;971;17;14851;353
2021-01-21;MW;Malawi;1198;43;16049;396
2021-01-22;MW;Malawi;1316;49;17365;445
2021-01-23;MW;Malawi;1074;25;18439;470
2021-01-24;MW;Malawi;956;38;19395;508
2021-01-25;MW;Malawi;592;10;19987;518
2021-01-26;MW;Malawi;843;22;20830;540
2021-01-27;MW;Malawi;830;15;21660;555
2021-01-28;MW;Malawi;644;73;22304;628
2021-01-29;MW;Malawi;716;15;23020;643
2021-01-30;MW;Malawi;477;44;23497;687
2021-01-31;MW;Malawi;466;15;23963;702
2021-02-01;MW;Malawi;402;10;24365;712
2021-02-02;MW;Malawi;538;14;24903;726
2021-02-03;MW;Malawi;546;35;25449;761
2021-02-04;MW;Malawi;435;18;25884;779
2021-02-05;MW;Malawi;476;0;26360;779
2021-02-06;MW;Malawi;515;58;26875;837
2021-02-07;MW;Malawi;320;19;27195;856
2021-02-08;MW;Malawi;227;18;27422;874
2021-02-09;MW;Malawi;300;9;27722;883
2021-02-10;MW;Malawi;328;17;28050;900
2021-02-11;MW;Malawi;220;14;28270;914
2021-02-12;MW;Malawi;360;12;28630;926
2021-02-13;MW;Malawi;246;11;28876;937
2021-02-14;MW;Malawi;159;15;29035;952
2021-02-15;MW;Malawi;146;6;29181;958
2021-02-16;MW;Malawi;240;10;29421;968
2021-02-17;MW;Malawi;213;8;29634;976
2021-02-18;MW;Malawi;203;8;29837;984
2021-02-19;MW;Malawi;440;13;30277;997
2021-02-20;MW;Malawi;251;7;30528;1004
2021-02-21;MW;Malawi;214;9;30742;1013
2021-02-22;MW;Malawi;200;8;30942;1021
2021-02-23;MW;Malawi;164;3;31106;1024
2021-02-24;MW;Malawi;189;5;31295;1029
2021-02-25;MW;Malawi;207;4;31502;1033
2021-02-26;MW;Malawi;173;4;31675;1037
2021-02-27;MW;Malawi;123;4;31798;1041
2021-02-28;MW;Malawi;147;3;31945;1044
2021-03-01;MW;Malawi;63;4;32008;1048
2021-03-02;MW;Malawi;140;5;32148;1053
2021-03-03;MW;Malawi;81;3;32229;1056
2021-03-04;MW;Malawi;54;2;32283;1058
2021-03-05;MW;Malawi;0;0;32283;1058
2021-03-06;MW;Malawi;115;9;32398;1067
2021-03-07;MW;Malawi;44;2;32442;1069
2021-03-08;MW;Malawi;27;1;32469;1070
2021-03-09;MW;Malawi;59;4;32528;1074
2021-03-10;MW;Malawi;86;3;32614;1077
2021-03-11;MW;Malawi;59;1;32673;1078
2021-03-12;MW;Malawi;73;1;32746;1079
2021-03-13;MW;Malawi;43;3;32789;1082
2021-03-14;MW;Malawi;0;0;32789;1082
2021-03-15;MW;Malawi;75;2;32864;1084
2021-03-16;MW;Malawi;30;4;32894;1088
2021-03-17;MW;Malawi;76;0;32970;1088
2021-03-18;MW;Malawi;75;3;33045;1091
2021-03-19;MW;Malawi;129;1;33174;1092
2021-03-20;MW;Malawi;42;1;33216;1093
2021-03-21;MW;Malawi;21;3;33237;1096
2021-03-22;MW;Malawi;33;2;33270;1098
2021-03-23;MW;Malawi;53;1;33323;1099
2021-03-24;MW;Malawi;31;6;33354;1105
2021-03-25;MW;Malawi;33;3;33387;1108
2021-03-26;MW;Malawi;28;4;33415;1112
2021-03-27;MW;Malawi;43;1;33458;1113
2021-03-28;MW;Malawi;23;1;33481;1114
2021-03-29;MW;Malawi;24;0;33505;1114
2021-03-30;MW;Malawi;20;2;33525;1116
2021-03-31;MW;Malawi;26;1;33551;1117
2021-04-01;MW;Malawi;33;1;33584;1118
2021-04-02;MW;Malawi;55;1;33639;1119
2021-04-03;MW;Malawi;8;1;33647;1120
2021-04-04;MW;Malawi;14;3;33661;1123
2021-04-05;MW;Malawi;12;1;33673;1124
2021-04-06;MW;Malawi;12;0;33685;1124
2021-04-07;MW;Malawi;33;1;33718;1125
2021-04-08;MW;Malawi;20;0;33738;1125
2021-04-09;MW;Malawi;41;1;33779;1126
2021-04-10;MW;Malawi;26;1;33805;1127
2021-04-11;MW;Malawi;22;1;33827;1128
2021-04-12;MW;Malawi;32;4;33859;1132
2021-04-13;MW;Malawi;13;1;33872;1133
2021-04-14;MW;Malawi;19;1;33891;1134
2021-04-15;MW;Malawi;11;0;33902;1134
2021-04-16;MW;Malawi;17;2;33919;1136
2021-04-17;MW;Malawi;0;0;33919;1136
2021-04-18;MW;Malawi;22;2;33941;1138
2021-04-19;MW;Malawi;18;1;33959;1139
2021-04-20;MW;Malawi;9;3;33968;1142
2021-04-21;MW;Malawi;7;0;33975;1142
2021-04-22;MW;Malawi;14;3;33989;1145
2021-04-23;MW;Malawi;0;0;33989;1145
2021-04-24;MW;Malawi;22;2;34011;1147
2021-04-25;MW;Malawi;5;0;34016;1147
2021-04-26;MW;Malawi;5;0;34021;1147
2021-04-27;MW;Malawi;10;0;34031;1147
2021-04-28;MW;Malawi;21;0;34052;1147
2021-04-29;MW;Malawi;10;1;34062;1148
2021-04-30;MW;Malawi;16;0;34078;1148
2021-05-01;MW;Malawi;17;0;34095;1148
2021-05-02;MW;Malawi;1;0;34096;1148
2021-05-03;MW;Malawi;3;0;34099;1148
2021-05-04;MW;Malawi;24;1;34123;1149
2021-05-05;MW;Malawi;20;2;34143;1151
2021-05-06;MW;Malawi;8;1;34151;1152
2021-05-07;MW;Malawi;7;0;34158;1152
2021-05-08;MW;Malawi;8;1;34166;1153
2021-05-09;MW;Malawi;5;0;34171;1153
2021-05-10;MW;Malawi;9;0;34180;1153
2021-05-11;MW;Malawi;3;0;34183;1153
2021-05-12;MW;Malawi;0;0;34183;1153
2021-05-13;MW;Malawi;17;0;34200;1153
2021-05-14;MW;Malawi;0;0;34200;1153
2021-05-15;MW;Malawi;10;0;34210;1153
2021-05-16;MW;Malawi;4;0;34214;1153
2021-05-17;MW;Malawi;2;0;34216;1153
2021-05-18;MW;Malawi;15;0;34231;1153
2021-05-19;MW;Malawi;7;0;34238;1153
2021-05-20;MW;Malawi;13;0;34251;1153
2021-05-21;MW;Malawi;10;0;34261;1153
2021-05-22;MW;Malawi;13;0;34274;1153
2021-05-23;MW;Malawi;10;0;34284;1153
2021-05-24;MW;Malawi;9;1;34293;1154
2021-05-25;MW;Malawi;2;0;34295;1154
2021-05-26;MW;Malawi;9;0;34304;1154
2021-05-27;MW;Malawi;0;0;34304;1154
2021-05-28;MW;Malawi;19;0;34323;1154
2021-05-29;MW;Malawi;6;0;34329;1154
2021-05-30;MW;Malawi;6;1;34335;1155
2021-05-31;MW;Malawi;3;0;34338;1155
2021-06-01;MW;Malawi;8;1;34346;1156
2021-06-02;MW;Malawi;14;0;34360;1156
2021-06-03;MW;Malawi;5;0;34365;1156
2021-06-04;MW;Malawi;6;0;34371;1156
2021-06-05;MW;Malawi;13;0;34384;1156
2021-06-06;MW;Malawi;6;1;34390;1157
2021-06-07;MW;Malawi;13;0;34403;1157
2021-06-08;MW;Malawi;7;1;34410;1158
2021-06-09;MW;Malawi;22;0;34432;1158
2021-06-10;MW;Malawi;15;0;34447;1158
2021-06-11;MW;Malawi;23;0;34470;1158
2021-06-12;MW;Malawi;15;1;34485;1159
2021-06-13;MW;Malawi;0;0;34485;1159
2021-06-14;MW;Malawi;79;0;34564;1159
2021-06-15;MW;Malawi;24;3;34588;1162
2021-06-16;MW;Malawi;62;1;34650;1163
2021-06-17;MW;Malawi;52;1;34702;1164
2021-06-18;MW;Malawi;79;2;34781;1166
2021-06-19;MW;Malawi;51;2;34832;1168
2021-06-20;MW;Malawi;36;0;34868;1168
2021-06-21;MW;Malawi;46;3;34914;1171
2021-06-22;MW;Malawi;82;2;34996;1173
2021-06-23;MW;Malawi;119;4;35115;1177
2021-06-24;MW;Malawi;104;1;35219;1178
2021-06-25;MW;Malawi;169;1;35388;1179
2021-06-26;MW;Malawi;166;2;35554;1181
2021-06-27;MW;Malawi;75;1;35629;1182
2021-06-28;MW;Malawi;80;5;35709;1187
2021-06-29;MW;Malawi;188;7;35897;1194
2021-06-30;MW;Malawi;229;2;36126;1196
2021-07-01;MW;Malawi;233;3;36359;1199
2020-01-25;MY;Malaysia;3;0;3;0
2020-01-26;MY;Malaysia;1;0;4;0
2020-01-27;MY;Malaysia;0;0;4;0
2020-01-28;MY;Malaysia;0;0;4;0
2020-01-29;MY;Malaysia;3;0;7;0
2020-01-30;MY;Malaysia;1;0;8;0
2020-01-31;MY;Malaysia;0;0;8;0
2020-02-01;MY;Malaysia;0;0;8;0
2020-02-02;MY;Malaysia;0;0;8;0
2020-02-03;MY;Malaysia;0;0;8;0
2020-02-04;MY;Malaysia;2;0;10;0
2020-02-05;MY;Malaysia;2;0;12;0
2020-02-06;MY;Malaysia;0;0;12;0
2020-02-07;MY;Malaysia;0;0;12;0
2020-02-08;MY;Malaysia;4;0;16;0
2020-02-09;MY;Malaysia;0;0;16;0
2020-02-10;MY;Malaysia;2;0;18;0
2020-02-11;MY;Malaysia;0;0;18;0
2020-02-12;MY;Malaysia;0;0;18;0
2020-02-13;MY;Malaysia;1;0;19;0
2020-02-14;MY;Malaysia;0;0;19;0
2020-02-15;MY;Malaysia;3;0;22;0
2020-02-16;MY;Malaysia;0;0;22;0
2020-02-17;MY;Malaysia;0;0;22;0
2020-02-18;MY;Malaysia;0;0;22;0
2020-02-19;MY;Malaysia;0;0;22;0
2020-02-20;MY;Malaysia;0;0;22;0
2020-02-21;MY;Malaysia;0;0;22;0
2020-02-22;MY;Malaysia;0;0;22;0
2020-02-23;MY;Malaysia;0;0;22;0
2020-02-24;MY;Malaysia;0;0;22;0
2020-02-25;MY;Malaysia;0;0;22;0
2020-02-26;MY;Malaysia;0;0;22;0
2020-02-27;MY;Malaysia;1;0;23;0
2020-02-28;MY;Malaysia;0;0;23;0
2020-02-29;MY;Malaysia;2;0;25;0
2020-03-01;MY;Malaysia;4;0;29;0
2020-03-02;MY;Malaysia;0;0;29;0
2020-03-03;MY;Malaysia;7;0;36;0
2020-03-04;MY;Malaysia;14;0;50;0
2020-03-05;MY;Malaysia;0;0;50;0
2020-03-06;MY;Malaysia;33;0;83;0
2020-03-07;MY;Malaysia;10;0;93;0
2020-03-08;MY;Malaysia;6;0;99;0
2020-03-09;MY;Malaysia;18;0;117;0
2020-03-10;MY;Malaysia;12;0;129;0
2020-03-11;MY;Malaysia;20;0;149;0
2020-03-12;MY;Malaysia;0;0;149;0
2020-03-13;MY;Malaysia;48;0;197;0
2020-03-14;MY;Malaysia;41;0;238;0
2020-03-15;MY;Malaysia;190;0;428;0
2020-03-16;MY;Malaysia;138;0;566;0
2020-03-17;MY;Malaysia;107;2;673;2
2020-03-18;MY;Malaysia;117;0;790;2
2020-03-19;MY;Malaysia;110;0;900;2
2020-03-20;MY;Malaysia;130;1;1030;3
2020-03-21;MY;Malaysia;153;1;1183;4
2020-03-22;MY;Malaysia;123;6;1306;10
2020-03-23;MY;Malaysia;212;4;1518;14
2020-03-24;MY;Malaysia;106;2;1624;16
2020-03-25;MY;Malaysia;172;4;1796;20
2020-03-26;MY;Malaysia;235;3;2031;23
2020-03-27;MY;Malaysia;130;3;2161;26
2020-03-28;MY;Malaysia;159;1;2320;27
2020-03-29;MY;Malaysia;150;8;2470;35
2020-03-30;MY;Malaysia;156;2;2626;37
2020-03-31;MY;Malaysia;140;6;2766;43
2020-04-01;MY;Malaysia;142;2;2908;45
2020-04-02;MY;Malaysia;208;5;3116;50
2020-04-03;MY;Malaysia;217;3;3333;53
2020-04-04;MY;Malaysia;150;4;3483;57
2020-04-05;MY;Malaysia;179;4;3662;61
2020-04-06;MY;Malaysia;131;1;3793;62
2020-04-07;MY;Malaysia;170;1;3963;63
2020-04-08;MY;Malaysia;156;2;4119;65
2020-04-09;MY;Malaysia;109;2;4228;67
2020-04-10;MY;Malaysia;118;3;4346;70
2020-04-11;MY;Malaysia;184;3;4530;73
2020-04-12;MY;Malaysia;153;3;4683;76
2020-04-13;MY;Malaysia;134;1;4817;77
2020-04-14;MY;Malaysia;170;5;4987;82
2020-04-15;MY;Malaysia;85;1;5072;83
2020-04-16;MY;Malaysia;110;1;5182;84
2020-04-17;MY;Malaysia;69;2;5251;86
2020-04-18;MY;Malaysia;54;2;5305;88
2020-04-19;MY;Malaysia;84;1;5389;89
2020-04-20;MY;Malaysia;36;0;5425;89
2020-04-21;MY;Malaysia;57;3;5482;92
2020-04-22;MY;Malaysia;50;1;5532;93
2020-04-23;MY;Malaysia;71;2;5603;95
2020-04-24;MY;Malaysia;88;1;5691;96
2020-04-25;MY;Malaysia;51;2;5742;98
2020-04-26;MY;Malaysia;38;0;5780;98
2020-04-27;MY;Malaysia;40;1;5820;99
2020-04-28;MY;Malaysia;31;1;5851;100
2020-04-29;MY;Malaysia;94;0;5945;100
2020-04-30;MY;Malaysia;57;2;6002;102
2020-05-01;MY;Malaysia;69;1;6071;103
2020-05-02;MY;Malaysia;105;0;6176;103
2020-05-03;MY;Malaysia;122;2;6298;105
2020-05-04;MY;Malaysia;55;0;6353;105
2020-05-05;MY;Malaysia;30;1;6383;106
2020-05-06;MY;Malaysia;45;1;6428;107
2020-05-07;MY;Malaysia;39;0;6467;107
2020-05-08;MY;Malaysia;68;0;6535;107
2020-05-09;MY;Malaysia;54;1;6589;108
2020-05-10;MY;Malaysia;67;0;6656;108
2020-05-11;MY;Malaysia;70;1;6726;109
2020-05-12;MY;Malaysia;16;0;6742;109
2020-05-13;MY;Malaysia;37;2;6779;111
2020-05-14;MY;Malaysia;40;1;6819;112
2020-05-15;MY;Malaysia;36;0;6855;112
2020-05-16;MY;Malaysia;17;1;6872;113
2020-05-17;MY;Malaysia;22;0;6894;113
2020-05-18;MY;Malaysia;47;0;6941;113
2020-05-19;MY;Malaysia;37;1;6978;114
2020-05-20;MY;Malaysia;31;0;7009;114
2020-05-21;MY;Malaysia;50;0;7059;114
2020-05-22;MY;Malaysia;78;1;7137;115
2020-05-23;MY;Malaysia;48;0;7185;115
2020-05-24;MY;Malaysia;60;0;7245;115
2020-05-25;MY;Malaysia;172;0;7417;115
2020-05-26;MY;Malaysia;187;0;7604;115
2020-05-27;MY;Malaysia;15;0;7619;115
2020-05-28;MY;Malaysia;10;0;7629;115
2020-05-29;MY;Malaysia;103;0;7732;115
2020-05-30;MY;Malaysia;30;0;7762;115
2020-05-31;MY;Malaysia;57;0;7819;115
2020-06-01;MY;Malaysia;38;0;7857;115
2020-06-02;MY;Malaysia;20;0;7877;115
2020-06-03;MY;Malaysia;93;0;7970;115
2020-06-04;MY;Malaysia;277;0;8247;115
2020-06-05;MY;Malaysia;19;1;8266;116
2020-06-06;MY;Malaysia;37;1;8303;117
2020-06-07;MY;Malaysia;19;0;8322;117
2020-06-08;MY;Malaysia;7;0;8329;117
2020-06-09;MY;Malaysia;7;0;8336;117
2020-06-10;MY;Malaysia;2;1;8338;118
2020-06-11;MY;Malaysia;31;0;8369;118
2020-06-12;MY;Malaysia;33;1;8402;119
2020-06-13;MY;Malaysia;43;1;8445;120
2020-06-14;MY;Malaysia;8;1;8453;121
2020-06-15;MY;Malaysia;41;0;8494;121
2020-06-16;MY;Malaysia;11;0;8505;121
2020-06-17;MY;Malaysia;10;0;8515;121
2020-06-18;MY;Malaysia;14;0;8529;121
2020-06-19;MY;Malaysia;6;0;8535;121
2020-06-20;MY;Malaysia;21;0;8556;121
2020-06-21;MY;Malaysia;16;0;8572;121
2020-06-22;MY;Malaysia;15;0;8587;121
2020-06-23;MY;Malaysia;3;0;8590;121
2020-06-24;MY;Malaysia;6;0;8596;121
2020-06-25;MY;Malaysia;4;0;8600;121
2020-06-26;MY;Malaysia;6;0;8606;121
2020-06-27;MY;Malaysia;10;0;8616;121
2020-06-28;MY;Malaysia;18;0;8634;121
2020-06-29;MY;Malaysia;3;0;8637;121
2020-06-30;MY;Malaysia;2;0;8639;121
2020-07-01;MY;Malaysia;1;0;8640;121
2020-07-02;MY;Malaysia;3;0;8643;121
2020-07-03;MY;Malaysia;5;0;8648;121
2020-07-04;MY;Malaysia;10;0;8658;121
2020-07-05;MY;Malaysia;5;0;8663;121
2020-07-06;MY;Malaysia;5;0;8668;121
2020-07-07;MY;Malaysia;6;0;8674;121
2020-07-08;MY;Malaysia;3;0;8677;121
2020-07-09;MY;Malaysia;6;0;8683;121
2020-07-10;MY;Malaysia;13;0;8696;121
2020-07-11;MY;Malaysia;8;1;8704;122
2020-07-12;MY;Malaysia;14;0;8718;122
2020-07-13;MY;Malaysia;7;0;8725;122
2020-07-14;MY;Malaysia;4;0;8729;122
2020-07-15;MY;Malaysia;5;0;8734;122
2020-07-16;MY;Malaysia;3;0;8737;122
2020-07-17;MY;Malaysia;18;0;8755;122
2020-07-18;MY;Malaysia;9;0;8764;122
2020-07-19;MY;Malaysia;15;1;8779;123
2020-07-20;MY;Malaysia;21;0;8800;123
2020-07-21;MY;Malaysia;15;0;8815;123
2020-07-22;MY;Malaysia;16;0;8831;123
2020-07-23;MY;Malaysia;9;0;8840;123
2020-07-24;MY;Malaysia;21;0;8861;123
2020-07-25;MY;Malaysia;23;0;8884;123
2020-07-26;MY;Malaysia;13;1;8897;124
2020-07-27;MY;Malaysia;7;0;8904;124
2020-07-28;MY;Malaysia;39;0;8943;124
2020-07-29;MY;Malaysia;13;0;8956;124
2020-07-30;MY;Malaysia;8;0;8964;124
2020-07-31;MY;Malaysia;12;1;8976;125
2020-08-01;MY;Malaysia;9;0;8985;125
2020-08-02;MY;Malaysia;14;0;8999;125
2020-08-03;MY;Malaysia;2;0;9001;125
2020-08-04;MY;Malaysia;1;0;9002;125
2020-08-05;MY;Malaysia;21;0;9023;125
2020-08-06;MY;Malaysia;15;0;9038;125
2020-08-07;MY;Malaysia;25;0;9063;125
2020-08-08;MY;Malaysia;7;0;9070;125
2020-08-09;MY;Malaysia;13;0;9083;125
2020-08-10;MY;Malaysia;11;0;9094;125
2020-08-11;MY;Malaysia;9;0;9103;125
2020-08-12;MY;Malaysia;11;0;9114;125
2020-08-13;MY;Malaysia;15;0;9129;125
2020-08-14;MY;Malaysia;20;0;9149;125
2020-08-15;MY;Malaysia;26;0;9175;125
2020-08-16;MY;Malaysia;25;0;9200;125
2020-08-17;MY;Malaysia;12;0;9212;125
2020-08-18;MY;Malaysia;7;0;9219;125
2020-08-19;MY;Malaysia;16;0;9235;125
2020-08-20;MY;Malaysia;5;0;9240;125
2020-08-21;MY;Malaysia;9;0;9249;125
2020-08-22;MY;Malaysia;8;0;9257;125
2020-08-23;MY;Malaysia;10;0;9267;125
2020-08-24;MY;Malaysia;7;0;9274;125
2020-08-25;MY;Malaysia;11;0;9285;125
2020-08-26;MY;Malaysia;6;0;9291;125
2020-08-27;MY;Malaysia;5;0;9296;125
2020-08-28;MY;Malaysia;10;0;9306;125
2020-08-29;MY;Malaysia;11;0;9317;125
2020-08-30;MY;Malaysia;17;1;9334;126
2020-08-31;MY;Malaysia;6;1;9340;127
2020-09-01;MY;Malaysia;14;1;9354;128
2020-09-02;MY;Malaysia;6;0;9360;128
2020-09-03;MY;Malaysia;14;0;9374;128
2020-09-04;MY;Malaysia;11;0;9385;128
2020-09-05;MY;Malaysia;6;0;9391;128
2020-09-06;MY;Malaysia;6;0;9397;128
2020-09-07;MY;Malaysia;62;0;9459;128
2020-09-08;MY;Malaysia;100;0;9559;128
2020-09-09;MY;Malaysia;24;0;9583;128
2020-09-10;MY;Malaysia;45;0;9628;128
2020-09-11;MY;Malaysia;182;0;9810;128
2020-09-12;MY;Malaysia;58;0;9868;128
2020-09-13;MY;Malaysia;47;0;9915;128
2020-09-14;MY;Malaysia;31;0;9946;128
2020-09-15;MY;Malaysia;23;0;9969;128
2020-09-16;MY;Malaysia;62;0;10031;128
2020-09-17;MY;Malaysia;21;0;10052;128
2020-09-18;MY;Malaysia;95;1;10147;129
2020-09-19;MY;Malaysia;20;1;10167;130
2020-09-20;MY;Malaysia;52;0;10219;130
2020-09-21;MY;Malaysia;57;0;10276;130
2020-09-22;MY;Malaysia;82;0;10358;130
2020-09-23;MY;Malaysia;147;3;10505;133
2020-09-24;MY;Malaysia;71;0;10576;133
2020-09-25;MY;Malaysia;111;0;10687;133
2020-09-26;MY;Malaysia;82;0;10769;133
2020-09-27;MY;Malaysia;150;1;10919;134
2020-09-28;MY;Malaysia;115;0;11034;134
2020-09-29;MY;Malaysia;101;0;11135;134
2020-09-30;MY;Malaysia;89;2;11224;136
2020-10-01;MY;Malaysia;260;0;11484;136
2020-10-02;MY;Malaysia;287;0;11771;136
2020-10-03;MY;Malaysia;317;1;12088;137
2020-10-04;MY;Malaysia;293;0;12381;137
2020-10-05;MY;Malaysia;432;0;12813;137
2020-10-06;MY;Malaysia;691;4;13504;141
2020-10-07;MY;Malaysia;489;0;13993;141
2020-10-08;MY;Malaysia;375;5;14368;146
2020-10-09;MY;Malaysia;354;6;14722;152
2020-10-10;MY;Malaysia;374;3;15096;155
2020-10-11;MY;Malaysia;561;2;15657;157
2020-10-12;MY;Malaysia;563;2;16220;159
2020-10-13;MY;Malaysia;660;4;16880;163
2020-10-14;MY;Malaysia;660;4;17540;167
2020-10-15;MY;Malaysia;589;3;18129;170
2020-10-16;MY;Malaysia;629;6;18758;176
2020-10-17;MY;Malaysia;869;4;19627;180
2020-10-18;MY;Malaysia;871;7;20498;187
2020-10-19;MY;Malaysia;865;3;21363;190
2020-10-20;MY;Malaysia;862;3;22225;193
2020-10-21;MY;Malaysia;732;6;22957;199
2020-10-22;MY;Malaysia;847;5;23804;204
2020-10-23;MY;Malaysia;710;10;24514;214
2020-10-24;MY;Malaysia;1228;7;25742;221
2020-10-25;MY;Malaysia;823;8;26565;229
2020-10-26;MY;Malaysia;1240;7;27805;236
2020-10-27;MY;Malaysia;835;2;28640;238
2020-10-28;MY;Malaysia;801;8;29441;246
2020-10-29;MY;Malaysia;649;0;30090;246
2020-10-30;MY;Malaysia;799;3;30889;249
2020-10-31;MY;Malaysia;659;0;31548;249
2020-11-01;MY;Malaysia;957;0;32505;249
2020-11-02;MY;Malaysia;834;2;33339;251
2020-11-03;MY;Malaysia;1054;12;34393;263
2020-11-04;MY;Malaysia;1032;8;35425;271
2020-11-05;MY;Malaysia;1009;6;36434;277
2020-11-06;MY;Malaysia;1755;2;38189;279
2020-11-07;MY;Malaysia;1168;3;39357;282
2020-11-08;MY;Malaysia;852;4;40209;286
2020-11-09;MY;Malaysia;972;8;41181;294
2020-11-10;MY;Malaysia;869;6;42050;300
2020-11-11;MY;Malaysia;822;2;42872;302
2020-11-12;MY;Malaysia;919;1;43791;303
2020-11-13;MY;Malaysia;1304;1;45095;304
2020-11-14;MY;Malaysia;1114;2;46209;306
2020-11-15;MY;Malaysia;1208;3;47417;309
2020-11-16;MY;Malaysia;1103;4;48520;313
2020-11-17;MY;Malaysia;1210;5;49730;318
2020-11-18;MY;Malaysia;660;4;50390;322
2020-11-19;MY;Malaysia;1290;4;51680;326
2020-11-20;MY;Malaysia;958;3;52638;329
2020-11-21;MY;Malaysia;1041;3;53679;332
2020-11-22;MY;Malaysia;1096;3;54775;335
2020-11-23;MY;Malaysia;1884;2;56659;337
2020-11-24;MY;Malaysia;2188;4;58847;341
2020-11-25;MY;Malaysia;970;4;59817;345
2020-11-26;MY;Malaysia;935;3;60752;348
2020-11-27;MY;Malaysia;1109;2;61861;350
2020-11-28;MY;Malaysia;1315;4;63176;354
2020-11-29;MY;Malaysia;1309;3;64485;357
2020-11-30;MY;Malaysia;1212;3;65697;360
2020-12-01;MY;Malaysia;1472;3;67169;363
2020-12-02;MY;Malaysia;851;2;68020;365
2020-12-03;MY;Malaysia;1075;11;69095;376
2020-12-04;MY;Malaysia;1141;0;70236;376
2020-12-05;MY;Malaysia;1123;4;71359;380
2020-12-06;MY;Malaysia;1335;2;72694;382
2020-12-07;MY;Malaysia;1600;2;74294;384
2020-12-08;MY;Malaysia;1012;4;75306;388
2020-12-09;MY;Malaysia;959;5;76265;393
2020-12-10;MY;Malaysia;2234;3;78499;396
2020-12-11;MY;Malaysia;1810;6;80309;402
2020-12-12;MY;Malaysia;1937;9;82246;411
2020-12-13;MY;Malaysia;1229;4;83475;415
2020-12-14;MY;Malaysia;1371;4;84846;419
2020-12-15;MY;Malaysia;1772;3;86618;422
2020-12-16;MY;Malaysia;1295;7;87913;429
2020-12-17;MY;Malaysia;1220;3;89133;432
2020-12-18;MY;Malaysia;1683;0;90816;432
2020-12-19;MY;Malaysia;1153;1;91969;433
2020-12-20;MY;Malaysia;1340;4;93309;437
2020-12-21;MY;Malaysia;2018;1;95327;438
2020-12-22;MY;Malaysia;2062;1;97389;439
2020-12-23;MY;Malaysia;1348;5;98737;444
2020-12-24;MY;Malaysia;1581;2;100318;446
2020-12-25;MY;Malaysia;1247;3;101565;449
2020-12-26;MY;Malaysia;2335;2;103900;451
2020-12-27;MY;Malaysia;1196;1;105096;452
2020-12-28;MY;Malaysia;1594;3;106690;455
2020-12-29;MY;Malaysia;1925;2;108615;457
2020-12-30;MY;Malaysia;1870;6;110485;463
2020-12-31;MY;Malaysia;2525;8;113010;471
2021-01-01;MY;Malaysia;2068;3;115078;474
2021-01-02;MY;Malaysia;2295;9;117373;483
2021-01-03;MY;Malaysia;1704;11;119077;494
2021-01-04;MY;Malaysia;1741;7;120818;501
2021-01-05;MY;Malaysia;2027;8;122845;509
2021-01-06;MY;Malaysia;2593;4;125438;513
2021-01-07;MY;Malaysia;3027;8;128465;521
2021-01-08;MY;Malaysia;2643;16;131108;537
2021-01-09;MY;Malaysia;2451;5;133559;542
2021-01-10;MY;Malaysia;2433;9;135992;551
2021-01-11;MY;Malaysia;2232;4;138224;555
2021-01-12;MY;Malaysia;3309;4;141533;559
2021-01-13;MY;Malaysia;2985;4;144518;563
2021-01-14;MY;Malaysia;3337;15;147855;578
2021-01-15;MY;Malaysia;3211;8;151066;586
2021-01-16;MY;Malaysia;4029;8;155095;594
2021-01-17;MY;Malaysia;3339;7;158434;601
2021-01-18;MY;Malaysia;3306;4;161740;605
2021-01-19;MY;Malaysia;3631;14;165371;619
2021-01-20;MY;Malaysia;4008;11;169379;630
2021-01-21;MY;Malaysia;3170;12;172549;642
2021-01-22;MY;Malaysia;3631;18;176180;660
2021-01-23;MY;Malaysia;4275;7;180455;667
2021-01-24;MY;Malaysia;3346;11;183801;678
2021-01-25;MY;Malaysia;3048;11;186849;689
2021-01-26;MY;Malaysia;3585;11;190434;700
2021-01-27;MY;Malaysia;3680;7;194114;707
2021-01-28;MY;Malaysia;4094;10;198208;717
2021-01-29;MY;Malaysia;5725;16;203933;733
2021-01-30;MY;Malaysia;5728;13;209661;746
2021-01-31;MY;Malaysia;5298;14;214959;760
2021-02-01;MY;Malaysia;4214;10;219173;770
2021-02-02;MY;Malaysia;3455;21;222628;791
2021-02-03;MY;Malaysia;4284;18;226912;809
2021-02-04;MY;Malaysia;4571;17;231483;826
2021-02-05;MY;Malaysia;3391;19;234874;845
2021-02-06;MY;Malaysia;3847;12;238721;857
2021-02-07;MY;Malaysia;3731;15;242452;872
2021-02-08;MY;Malaysia;3100;24;245552;896
2021-02-09;MY;Malaysia;2764;13;248316;909
2021-02-10;MY;Malaysia;3288;14;251604;923
2021-02-11;MY;Malaysia;3384;13;254988;936
2021-02-12;MY;Malaysia;3318;17;258306;953
2021-02-13;MY;Malaysia;3499;5;261805;958
2021-02-14;MY;Malaysia;2464;7;264269;965
2021-02-15;MY;Malaysia;2176;10;266445;975
2021-02-16;MY;Malaysia;2720;8;269165;983
2021-02-17;MY;Malaysia;2998;22;272163;1005
2021-02-18;MY;Malaysia;2712;25;274875;1030
2021-02-19;MY;Malaysia;2936;13;277811;1043
2021-02-20;MY;Malaysia;2461;8;280272;1051
2021-02-21;MY;Malaysia;3297;5;283569;1056
2021-02-22;MY;Malaysia;2192;6;285761;1062
2021-02-23;MY;Malaysia;2468;14;288229;1076
2021-02-24;MY;Malaysia;3545;12;291774;1088
2021-02-25;MY;Malaysia;1924;12;293698;1100
2021-02-26;MY;Malaysia;2253;11;295951;1111
2021-02-27;MY;Malaysia;2364;10;298315;1121
2021-02-28;MY;Malaysia;2437;9;300752;1130
2021-03-01;MY;Malaysia;1828;5;302580;1135
2021-03-02;MY;Malaysia;1555;6;304135;1141
2021-03-03;MY;Malaysia;1745;7;305880;1148
2021-03-04;MY;Malaysia;2063;5;307943;1153
2021-03-05;MY;Malaysia;2154;6;310097;1159
2021-03-06;MY;Malaysia;1680;7;311777;1166
2021-03-07;MY;Malaysia;1683;3;313460;1169
2021-03-08;MY;Malaysia;1529;8;314989;1177
2021-03-09;MY;Malaysia;1280;9;316269;1186
2021-03-10;MY;Malaysia;1448;5;317717;1191
2021-03-11;MY;Malaysia;1647;9;319364;1200
2021-03-12;MY;Malaysia;1575;3;320939;1203
2021-03-13;MY;Malaysia;1470;3;322409;1206
2021-03-14;MY;Malaysia;1354;4;323763;1210
2021-03-15;MY;Malaysia;1208;3;324971;1213
2021-03-16;MY;Malaysia;1063;5;326034;1218
2021-03-17;MY;Malaysia;1219;2;327253;1220
2021-03-18;MY;Malaysia;1213;3;328466;1223
2021-03-19;MY;Malaysia;1576;2;330042;1225
2021-03-20;MY;Malaysia;1671;4;331713;1229
2021-03-21;MY;Malaysia;1327;4;333040;1233
2021-03-22;MY;Malaysia;1116;5;334156;1238
2021-03-23;MY;Malaysia;1384;6;335540;1244
2021-03-24;MY;Malaysia;1268;2;336808;1246
2021-03-25;MY;Malaysia;1360;2;338168;1248
2021-03-26;MY;Malaysia;1275;1;339443;1249
2021-03-27;MY;Malaysia;1199;2;340642;1251
2021-03-28;MY;Malaysia;1302;4;341944;1255
2021-03-29;MY;Malaysia;941;5;342885;1260
2021-03-30;MY;Malaysia;1133;5;344018;1265
2021-03-31;MY;Malaysia;1482;7;345500;1272
2021-04-01;MY;Malaysia;1178;6;346678;1278
2021-04-02;MY;Malaysia;1294;5;347972;1283
2021-04-03;MY;Malaysia;1638;3;349610;1286
2021-04-04;MY;Malaysia;1349;2;350959;1288
2021-04-05;MY;Malaysia;1070;7;352029;1295
2021-04-06;MY;Malaysia;1300;5;353329;1300
2021-04-07;MY;Malaysia;1139;4;354468;1304
2021-04-08;MY;Malaysia;1285;4;355753;1308
2021-04-09;MY;Malaysia;1854;5;357607;1313
2021-04-10;MY;Malaysia;1510;8;359117;1321
2021-04-11;MY;Malaysia;1739;8;360856;1329
2021-04-12;MY;Malaysia;1317;4;362173;1333
2021-04-13;MY;Malaysia;1767;12;363940;1345
2021-04-14;MY;Malaysia;1889;8;365829;1353
2021-04-15;MY;Malaysia;2148;10;367977;1363
2021-04-16;MY;Malaysia;2551;2;370528;1365
2021-04-17;MY;Malaysia;2331;5;372859;1370
2021-04-18;MY;Malaysia;2195;8;375054;1378
2021-04-19;MY;Malaysia;2078;8;377132;1386
2021-04-20;MY;Malaysia;2341;3;379473;1389
2021-04-21;MY;Malaysia;2340;11;381813;1400
2021-04-22;MY;Malaysia;2875;7;384688;1407
2021-04-23;MY;Malaysia;2847;8;387535;1415
2021-04-24;MY;Malaysia;2717;11;390252;1426
2021-04-25;MY;Malaysia;2690;10;392942;1436
2021-04-26;MY;Malaysia;2776;13;395718;1449
2021-04-27;MY;Malaysia;2733;13;398451;1462
2021-04-28;MY;Malaysia;3142;15;401593;1477
2021-04-29;MY;Malaysia;3332;15;404925;1492
2021-04-30;MY;Malaysia;3788;14;408713;1506
2021-05-01;MY;Malaysia;2881;15;411594;1521
2021-05-02;MY;Malaysia;3418;12;415012;1533
2021-05-03;MY;Malaysia;2500;18;417512;1551
2021-05-04;MY;Malaysia;3120;23;420632;1574
2021-05-05;MY;Malaysia;3744;17;424376;1591
2021-05-06;MY;Malaysia;3551;19;427927;1610
2021-05-07;MY;Malaysia;4498;22;432425;1632
2021-05-08;MY;Malaysia;4519;25;436944;1657
2021-05-09;MY;Malaysia;3733;26;440677;1683
2021-05-10;MY;Malaysia;3807;17;444484;1700
2021-05-11;MY;Malaysia;3973;22;448457;1722
2021-05-12;MY;Malaysia;4765;39;453222;1761
2021-05-13;MY;Malaysia;4855;27;458077;1788
2021-05-14;MY;Malaysia;4113;34;462190;1822
2021-05-15;MY;Malaysia;4140;44;466330;1866
2021-05-16;MY;Malaysia;3780;36;470110;1902
2021-05-17;MY;Malaysia;4446;45;474556;1947
2021-05-18;MY;Malaysia;4865;47;479421;1994
2021-05-19;MY;Malaysia;6075;46;485496;2040
2021-05-20;MY;Malaysia;6806;59;492302;2099
2021-05-21;MY;Malaysia;6493;50;498795;2149
2021-05-22;MY;Malaysia;6320;50;505115;2199
2021-05-23;MY;Malaysia;6976;49;512091;2248
2021-05-24;MY;Malaysia;6509;61;518600;2309
2021-05-25;MY;Malaysia;7289;60;525889;2369
2021-05-26;MY;Malaysia;7478;63;533367;2432
2021-05-27;MY;Malaysia;7857;59;541224;2491
2021-05-28;MY;Malaysia;8290;61;549514;2552
2021-05-29;MY;Malaysia;9020;98;558534;2650
2021-05-30;MY;Malaysia;6999;79;565533;2729
2021-05-31;MY;Malaysia;6824;67;572357;2796
2021-06-01;MY;Malaysia;7105;71;579462;2867
2021-06-02;MY;Malaysia;7703;126;587165;2993
2021-06-03;MY;Malaysia;8209;103;595374;3096
2021-06-04;MY;Malaysia;7748;86;603122;3182
2021-06-05;MY;Malaysia;7452;109;610574;3291
2021-06-06;MY;Malaysia;6241;87;616815;3378
2021-06-07;MY;Malaysia;5271;82;622086;3460
2021-06-08;MY;Malaysia;5566;76;627652;3536
2021-06-09;MY;Malaysia;6239;75;633891;3611
2021-06-10;MY;Malaysia;5671;73;639562;3684
2021-06-11;MY;Malaysia;6849;84;646411;3768
2021-06-12;MY;Malaysia;5793;76;652204;3844
2021-06-13;MY;Malaysia;5304;64;657508;3908
2021-06-14;MY;Malaysia;4949;60;662457;3968
2021-06-15;MY;Malaysia;5419;101;667876;4069
2021-06-16;MY;Malaysia;5150;73;673026;4142
2021-06-17;MY;Malaysia;5738;60;678764;4202
2021-06-18;MY;Malaysia;6440;74;685204;4276
2021-06-19;MY;Malaysia;5911;72;691115;4348
2021-06-20;MY;Malaysia;5293;60;696408;4408
2021-06-21;MY;Malaysia;4611;69;701019;4477
2021-06-22;MY;Malaysia;4743;77;705762;4554
2021-06-23;MY;Malaysia;5244;83;711006;4637
2021-06-24;MY;Malaysia;5841;84;716847;4721
2021-06-25;MY;Malaysia;5812;82;722659;4803
2021-06-26;MY;Malaysia;5803;81;728462;4884
2021-06-27;MY;Malaysia;5586;60;734048;4944
2021-06-28;MY;Malaysia;5218;57;739266;5001
2021-06-29;MY;Malaysia;6437;107;745703;5108
2021-06-30;MY;Malaysia;6276;62;751979;5170
2021-07-01;MY;Malaysia;6988;84;758967;5254
2020-03-08;MV;Maldives;4;0;4;0
2020-03-09;MV;Maldives;0;0;4;0
2020-03-10;MV;Maldives;2;0;6;0
2020-03-11;MV;Maldives;2;0;8;0
2020-03-12;MV;Maldives;0;0;8;0
2020-03-13;MV;Maldives;1;0;9;0
2020-03-14;MV;Maldives;1;0;10;0
2020-03-15;MV;Maldives;3;0;13;0
2020-03-16;MV;Maldives;0;0;13;0
2020-03-17;MV;Maldives;0;0;13;0
2020-03-18;MV;Maldives;0;0;13;0
2020-03-19;MV;Maldives;0;0;13;0
2020-03-20;MV;Maldives;0;0;13;0
2020-03-21;MV;Maldives;0;0;13;0
2020-03-22;MV;Maldives;0;0;13;0
2020-03-23;MV;Maldives;0;0;13;0
2020-03-24;MV;Maldives;0;0;13;0
2020-03-25;MV;Maldives;0;0;13;0
2020-03-26;MV;Maldives;0;0;13;0
2020-03-27;MV;Maldives;3;0;16;0
2020-03-28;MV;Maldives;0;0;16;0
2020-03-29;MV;Maldives;1;0;17;0
2020-03-30;MV;Maldives;0;0;17;0
2020-03-31;MV;Maldives;1;0;18;0
2020-04-01;MV;Maldives;1;0;19;0
2020-04-02;MV;Maldives;0;0;19;0
2020-04-03;MV;Maldives;0;0;19;0
2020-04-04;MV;Maldives;0;0;19;0
2020-04-05;MV;Maldives;0;0;19;0
2020-04-06;MV;Maldives;0;0;19;0
2020-04-07;MV;Maldives;0;0;19;0
2020-04-08;MV;Maldives;0;0;19;0
2020-04-09;MV;Maldives;0;0;19;0
2020-04-10;MV;Maldives;0;0;19;0
2020-04-11;MV;Maldives;0;0;19;0
2020-04-12;MV;Maldives;1;0;20;0
2020-04-13;MV;Maldives;0;0;20;0
2020-04-14;MV;Maldives;0;0;20;0
2020-04-15;MV;Maldives;2;0;22;0
2020-04-16;MV;Maldives;3;0;25;0
2020-04-17;MV;Maldives;3;0;28;0
2020-04-18;MV;Maldives;7;0;35;0
2020-04-19;MV;Maldives;17;0;52;0
2020-04-20;MV;Maldives;17;0;69;0
2020-04-21;MV;Maldives;14;0;83;0
2020-04-22;MV;Maldives;3;0;86;0
2020-04-23;MV;Maldives;22;0;108;0
2020-04-24;MV;Maldives;21;0;129;0
2020-04-25;MV;Maldives;48;0;177;0
2020-04-26;MV;Maldives;37;0;214;0
2020-04-27;MV;Maldives;12;0;226;0
2020-04-28;MV;Maldives;24;0;250;0
2020-04-29;MV;Maldives;28;1;278;1
2020-04-30;MV;Maldives;190;0;468;1
2020-05-01;MV;Maldives;23;0;491;1
2020-05-02;MV;Maldives;28;0;519;1
2020-05-03;MV;Maldives;8;0;527;1
2020-05-04;MV;Maldives;14;0;541;1
2020-05-05;MV;Maldives;32;1;573;2
2020-05-06;MV;Maldives;44;0;617;2
2020-05-07;MV;Maldives;31;1;648;3
2020-05-08;MV;Maldives;96;0;744;3
2020-05-09;MV;Maldives;46;0;790;3
2020-05-10;MV;Maldives;45;0;835;3
2020-05-11;MV;Maldives;62;0;897;3
2020-05-12;MV;Maldives;7;0;904;3
2020-05-13;MV;Maldives;51;1;955;4
2020-05-14;MV;Maldives;27;0;982;4
2020-05-15;MV;Maldives;49;0;1031;4
2020-05-16;MV;Maldives;47;0;1078;4
2020-05-17;MV;Maldives;16;0;1094;4
2020-05-18;MV;Maldives;12;0;1106;4
2020-05-19;MV;Maldives;37;0;1143;4
2020-05-20;MV;Maldives;43;0;1186;4
2020-05-21;MV;Maldives;30;0;1216;4
2020-05-22;MV;Maldives;58;0;1274;4
2020-05-23;MV;Maldives;39;0;1313;4
2020-05-24;MV;Maldives;58;0;1371;4
2020-05-25;MV;Maldives;24;0;1395;4
2020-05-26;MV;Maldives;43;1;1438;5
2020-05-27;MV;Maldives;19;0;1457;5
2020-05-28;MV;Maldives;56;0;1513;5
2020-05-29;MV;Maldives;78;0;1591;5
2020-05-30;MV;Maldives;81;0;1672;5
2020-05-31;MV;Maldives;101;0;1773;5
2020-06-01;MV;Maldives;56;1;1829;6
2020-06-02;MV;Maldives;12;1;1841;7
2020-06-03;MV;Maldives;9;0;1850;7
2020-06-04;MV;Maldives;22;0;1872;7
2020-06-05;MV;Maldives;11;0;1883;7
2020-06-06;MV;Maldives;18;1;1901;8
2020-06-07;MV;Maldives;2;0;1903;8
2020-06-08;MV;Maldives;13;0;1916;8
2020-06-09;MV;Maldives;26;0;1942;8
2020-06-10;MV;Maldives;20;0;1962;8
2020-06-11;MV;Maldives;14;0;1976;8
2020-06-12;MV;Maldives;27;0;2003;8
2020-06-13;MV;Maldives;10;0;2013;8
2020-06-14;MV;Maldives;22;0;2035;8
2020-06-15;MV;Maldives;30;0;2065;8
2020-06-16;MV;Maldives;29;0;2094;8
2020-06-17;MV;Maldives;26;0;2120;8
2020-06-18;MV;Maldives;17;0;2137;8
2020-06-19;MV;Maldives;13;0;2150;8
2020-06-20;MV;Maldives;37;0;2187;8
2020-06-21;MV;Maldives;16;0;2203;8
2020-06-22;MV;Maldives;14;0;2217;8
2020-06-23;MV;Maldives;21;0;2238;8
2020-06-24;MV;Maldives;23;0;2261;8
2020-06-25;MV;Maldives;16;0;2277;8
2020-06-26;MV;Maldives;6;0;2283;8
2020-06-27;MV;Maldives;22;0;2305;8
2020-06-28;MV;Maldives;19;0;2324;8
2020-06-29;MV;Maldives;13;0;2337;8
2020-06-30;MV;Maldives;24;1;2361;9
2020-07-01;MV;Maldives;21;0;2382;9
2020-07-02;MV;Maldives;18;1;2400;10
2020-07-03;MV;Maldives;10;0;2410;10
2020-07-04;MV;Maldives;25;0;2435;10
2020-07-05;MV;Maldives;33;1;2468;11
2020-07-06;MV;Maldives;23;1;2491;12
2020-07-07;MV;Maldives;10;0;2501;12
2020-07-08;MV;Maldives;16;1;2517;13
2020-07-09;MV;Maldives;36;0;2553;13
2020-07-10;MV;Maldives;64;0;2617;13
2020-07-11;MV;Maldives;47;0;2664;13
2020-07-12;MV;Maldives;67;0;2731;13
2020-07-13;MV;Maldives;31;0;2762;13
2020-07-14;MV;Maldives;39;1;2801;14
2020-07-15;MV;Maldives;30;0;2831;14
2020-07-16;MV;Maldives;68;1;2899;15
2020-07-17;MV;Maldives;14;0;2913;15
2020-07-18;MV;Maldives;17;0;2930;15
2020-07-19;MV;Maldives;36;0;2966;15
2020-07-20;MV;Maldives;33;0;2999;15
2020-07-21;MV;Maldives;45;0;3044;15
2020-07-22;MV;Maldives;59;0;3103;15
2020-07-23;MV;Maldives;17;0;3120;15
2020-07-24;MV;Maldives;55;0;3175;15
2020-07-25;MV;Maldives;77;0;3252;15
2020-07-26;MV;Maldives;50;0;3302;15
2020-07-27;MV;Maldives;67;0;3369;15
2020-07-28;MV;Maldives;137;0;3506;15
2020-07-29;MV;Maldives;61;0;3567;15
2020-07-30;MV;Maldives;152;1;3719;16
2020-07-31;MV;Maldives;74;0;3793;16
2020-08-01;MV;Maldives;156;1;3949;17
2020-08-02;MV;Maldives;215;1;4164;18
2020-08-03;MV;Maldives;129;0;4293;18
2020-08-04;MV;Maldives;153;1;4446;19
2020-08-05;MV;Maldives;148;0;4594;19
2020-08-06;MV;Maldives;86;0;4680;19
2020-08-07;MV;Maldives;89;0;4769;19
2020-08-08;MV;Maldives;129;0;4898;19
2020-08-09;MV;Maldives;143;0;5041;19
2020-08-10;MV;Maldives;116;0;5157;19
2020-08-11;MV;Maldives;66;1;5223;20
2020-08-12;MV;Maldives;143;1;5366;21
2020-08-13;MV;Maldives;128;0;5494;21
2020-08-14;MV;Maldives;78;1;5572;22
2020-08-15;MV;Maldives;107;0;5679;22
2020-08-16;MV;Maldives;106;0;5785;22
2020-08-17;MV;Maldives;124;1;5909;23
2020-08-18;MV;Maldives;170;1;6079;24
2020-08-19;MV;Maldives;146;0;6225;24
2020-08-20;MV;Maldives;145;0;6370;24
2020-08-21;MV;Maldives;194;2;6564;26
2020-08-22;MV;Maldives;96;0;6660;26
2020-08-23;MV;Maldives;119;0;6779;26
2020-08-24;MV;Maldives;133;1;6912;27
2020-08-25;MV;Maldives;135;1;7047;28
2020-08-26;MV;Maldives;178;0;7225;28
2020-08-27;MV;Maldives;104;0;7329;28
2020-08-28;MV;Maldives;140;0;7469;28
2020-08-29;MV;Maldives;109;0;7578;28
2020-08-30;MV;Maldives;89;0;7667;28
2020-08-31;MV;Maldives;137;0;7804;28
2020-09-01;MV;Maldives;199;1;8003;29
2020-09-02;MV;Maldives;137;0;8140;29
2020-09-03;MV;Maldives;141;0;8281;29
2020-09-04;MV;Maldives;80;0;8361;29
2020-09-05;MV;Maldives;125;0;8486;29
2020-09-06;MV;Maldives;98;0;8584;29
2020-09-07;MV;Maldives;83;0;8667;29
2020-09-08;MV;Maldives;74;0;8741;29
2020-09-09;MV;Maldives;93;2;8834;31
2020-09-10;MV;Maldives;66;0;8900;31
2020-09-11;MV;Maldives;90;0;8990;31
2020-09-12;MV;Maldives;62;0;9052;31
2020-09-13;MV;Maldives;121;1;9173;32
2020-09-14;MV;Maldives;70;1;9243;33
2020-09-15;MV;Maldives;85;0;9328;33
2020-09-16;MV;Maldives;99;0;9427;33
2020-09-17;MV;Maldives;67;0;9494;33
2020-09-18;MV;Maldives;74;0;9568;33
2020-09-19;MV;Maldives;81;0;9649;33
2020-09-20;MV;Maldives;75;0;9724;33
2020-09-21;MV;Maldives;46;1;9770;34
2020-09-22;MV;Maldives;48;0;9818;34
2020-09-23;MV;Maldives;67;0;9885;34
2020-09-24;MV;Maldives;54;0;9939;34
2020-09-25;MV;Maldives;75;0;10014;34
2020-09-26;MV;Maldives;31;0;10045;34
2020-09-27;MV;Maldives;53;0;10098;34
2020-09-28;MV;Maldives;59;0;10157;34
2020-09-29;MV;Maldives;37;0;10194;34
2020-09-30;MV;Maldives;97;0;10291;34
2020-10-01;MV;Maldives;63;0;10354;34
2020-10-02;MV;Maldives;44;0;10398;34
2020-10-03;MV;Maldives;67;0;10465;34
2020-10-04;MV;Maldives;65;0;10530;34
2020-10-05;MV;Maldives;37;0;10567;34
2020-10-06;MV;Maldives;54;0;10621;34
2020-10-07;MV;Maldives;35;0;10656;34
2020-10-08;MV;Maldives;86;0;10742;34
2020-10-09;MV;Maldives;66;0;10808;34
2020-10-10;MV;Maldives;51;0;10859;34
2020-10-11;MV;Maldives;35;1;10894;35
2020-10-12;MV;Maldives;49;0;10943;35
2020-10-13;MV;Maldives;50;0;10993;35
2020-10-14;MV;Maldives;69;0;11062;35
2020-10-15;MV;Maldives;51;0;11113;35
2020-10-16;MV;Maldives;41;0;11154;35
2020-10-17;MV;Maldives;24;1;11178;36
2020-10-18;MV;Maldives;32;1;11210;37
2020-10-19;MV;Maldives;22;0;11232;37
2020-10-20;MV;Maldives;39;0;11271;37
2020-10-21;MV;Maldives;45;0;11316;37
2020-10-22;MV;Maldives;42;0;11358;37
2020-10-23;MV;Maldives;33;0;11391;37
2020-10-24;MV;Maldives;30;0;11421;37
2020-10-25;MV;Maldives;84;0;11505;37
2020-10-26;MV;Maldives;27;0;11532;37
2020-10-27;MV;Maldives;35;0;11567;37
2020-10-28;MV;Maldives;24;0;11591;37
2020-10-29;MV;Maldives;25;0;11616;37
2020-10-30;MV;Maldives;27;0;11643;37
2020-10-31;MV;Maldives;16;1;11659;38
2020-11-01;MV;Maldives;42;0;11701;38
2020-11-02;MV;Maldives;36;0;11737;38
2020-11-03;MV;Maldives;59;0;11796;38
2020-11-04;MV;Maldives;26;0;11822;38
2020-11-05;MV;Maldives;71;0;11893;38
2020-11-06;MV;Maldives;39;1;11932;39
2020-11-07;MV;Maldives;30;0;11962;39
2020-11-08;MV;Maldives;24;0;11986;39
2020-11-09;MV;Maldives;23;1;12009;40
2020-11-10;MV;Maldives;21;1;12030;41
2020-11-11;MV;Maldives;29;0;12059;41
2020-11-12;MV;Maldives;26;0;12085;41
2020-11-13;MV;Maldives;27;0;12112;41
2020-11-14;MV;Maldives;42;1;12154;42
2020-11-15;MV;Maldives;50;1;12204;43
2020-11-16;MV;Maldives;110;1;12314;44
2020-11-17;MV;Maldives;41;1;12355;45
2020-11-18;MV;Maldives;29;0;12384;45
2020-11-19;MV;Maldives;68;0;12452;45
2020-11-20;MV;Maldives;94;0;12546;45
2020-11-21;MV;Maldives;32;0;12578;45
2020-11-22;MV;Maldives;30;1;12608;46
2020-11-23;MV;Maldives;150;0;12758;46
2020-11-24;MV;Maldives;52;0;12810;46
2020-11-25;MV;Maldives;44;0;12854;46
2020-11-26;MV;Maldives;35;0;12889;46
2020-11-27;MV;Maldives;44;0;12933;46
2020-11-28;MV;Maldives;14;0;12947;46
2020-11-29;MV;Maldives;47;0;12994;46
2020-11-30;MV;Maldives;17;0;13011;46
2020-12-01;MV;Maldives;38;1;13049;47
2020-12-02;MV;Maldives;21;0;13070;47
2020-12-03;MV;Maldives;36;0;13106;47
2020-12-04;MV;Maldives;37;0;13143;47
2020-12-05;MV;Maldives;16;0;13159;47
2020-12-06;MV;Maldives;39;0;13198;47
2020-12-07;MV;Maldives;15;0;13213;47
2020-12-08;MV;Maldives;35;0;13248;47
2020-12-09;MV;Maldives;26;0;13274;47
2020-12-10;MV;Maldives;34;0;13308;47
2020-12-11;MV;Maldives;18;1;13326;48
2020-12-12;MV;Maldives;22;0;13348;48
2020-12-13;MV;Maldives;20;0;13368;48
2020-12-14;MV;Maldives;11;0;13379;48
2020-12-15;MV;Maldives;13;0;13392;48
2020-12-16;MV;Maldives;10;0;13402;48
2020-12-17;MV;Maldives;16;0;13418;48
2020-12-18;MV;Maldives;26;0;13444;48
2020-12-19;MV;Maldives;30;0;13474;48
2020-12-20;MV;Maldives;19;0;13493;48
2020-12-21;MV;Maldives;8;0;13501;48
2020-12-22;MV;Maldives;23;0;13524;48
2020-12-23;MV;Maldives;13;0;13537;48
2020-12-24;MV;Maldives;21;0;13558;48
2020-12-25;MV;Maldives;25;0;13583;48
2020-12-26;MV;Maldives;35;0;13618;48
2020-12-27;MV;Maldives;26;0;13644;48
2020-12-28;MV;Maldives;16;0;13660;48
2020-12-29;MV;Maldives;31;0;13691;48
2020-12-30;MV;Maldives;47;0;13738;48
2020-12-31;MV;Maldives;19;0;13757;48
2021-01-01;MV;Maldives;47;0;13804;48
2021-01-02;MV;Maldives;30;0;13834;48
2021-01-03;MV;Maldives;33;0;13867;48
2021-01-04;MV;Maldives;26;0;13893;48
2021-01-05;MV;Maldives;37;0;13930;48
2021-01-06;MV;Maldives;37;0;13967;48
2021-01-07;MV;Maldives;21;1;13988;49
2021-01-08;MV;Maldives;52;0;14040;49
2021-01-09;MV;Maldives;25;0;14065;49
2021-01-10;MV;Maldives;44;0;14109;49
2021-01-11;MV;Maldives;50;0;14159;49
2021-01-12;MV;Maldives;59;0;14218;49
2021-01-13;MV;Maldives;59;0;14277;49
2021-01-14;MV;Maldives;48;0;14325;49
2021-01-15;MV;Maldives;50;0;14375;49
2021-01-16;MV;Maldives;51;0;14426;49
2021-01-17;MV;Maldives;87;0;14513;49
2021-01-18;MV;Maldives;69;0;14582;49
2021-01-19;MV;Maldives;51;0;14633;49
2021-01-20;MV;Maldives;79;0;14712;49
2021-01-21;MV;Maldives;53;1;14765;50
2021-01-22;MV;Maldives;65;0;14830;50
2021-01-23;MV;Maldives;55;0;14885;50
2021-01-24;MV;Maldives;108;1;14993;51
2021-01-25;MV;Maldives;109;0;15102;51
2021-01-26;MV;Maldives;145;0;15247;51
2021-01-27;MV;Maldives;143;0;15390;51
2021-01-28;MV;Maldives;106;0;15496;51
2021-01-29;MV;Maldives;118;0;15614;51
2021-01-30;MV;Maldives;122;0;15736;51
2021-01-31;MV;Maldives;105;1;15841;52
2021-02-01;MV;Maldives;215;0;16056;52
2021-02-02;MV;Maldives;99;0;16155;52
2021-02-03;MV;Maldives;121;1;16276;53
2021-02-04;MV;Maldives;134;1;16410;54
2021-02-05;MV;Maldives;137;0;16547;54
2021-02-06;MV;Maldives;109;0;16656;54
2021-02-07;MV;Maldives;127;1;16783;55
2021-02-08;MV;Maldives;126;0;16909;55
2021-02-09;MV;Maldives;192;1;17101;56
2021-02-10;MV;Maldives;100;0;17201;56
2021-02-11;MV;Maldives;186;0;17387;56
2021-02-12;MV;Maldives;120;1;17507;57
2021-02-13;MV;Maldives;209;1;17716;58
2021-02-14;MV;Maldives;112;0;17828;58
2021-02-15;MV;Maldives;125;0;17953;58
2021-02-16;MV;Maldives;129;0;18082;58
2021-02-17;MV;Maldives;142;0;18224;58
2021-02-18;MV;Maldives;116;0;18340;58
2021-02-19;MV;Maldives;127;0;18467;58
2021-02-20;MV;Maldives;145;2;18612;60
2021-02-21;MV;Maldives;157;0;18769;60
2021-02-22;MV;Maldives;161;0;18930;60
2021-02-23;MV;Maldives;108;0;19038;60
2021-02-24;MV;Maldives;124;0;19162;60
2021-02-25;MV;Maldives;184;0;19346;60
2021-02-26;MV;Maldives;133;0;19479;60
2021-02-27;MV;Maldives;118;1;19597;61
2021-02-28;MV;Maldives;196;1;19793;62
2021-03-01;MV;Maldives;186;0;19979;62
2021-03-02;MV;Maldives;165;0;20144;62
2021-03-03;MV;Maldives;136;1;20280;63
2021-03-04;MV;Maldives;167;1;20447;64
2021-03-05;MV;Maldives;118;0;20565;64
2021-03-06;MV;Maldives;98;0;20663;64
2021-03-07;MV;Maldives;131;0;20794;64
2021-03-08;MV;Maldives;125;0;20919;64
2021-03-09;MV;Maldives;115;0;21034;64
2021-03-10;MV;Maldives;110;0;21144;64
2021-03-11;MV;Maldives;124;0;21268;64
2021-03-12;MV;Maldives;114;0;21382;64
2021-03-13;MV;Maldives;94;0;21476;64
2021-03-14;MV;Maldives;96;0;21572;64
2021-03-15;MV;Maldives;94;0;21666;64
2021-03-16;MV;Maldives;153;0;21819;64
2021-03-17;MV;Maldives;142;0;21961;64
2021-03-18;MV;Maldives;186;0;22147;64
2021-03-19;MV;Maldives;145;1;22292;65
2021-03-20;MV;Maldives;81;0;22373;65
2021-03-21;MV;Maldives;140;1;22513;66
2021-03-22;MV;Maldives;149;0;22662;66
2021-03-23;MV;Maldives;128;0;22790;66
2021-03-24;MV;Maldives;139;0;22929;66
2021-03-25;MV;Maldives;162;0;23091;66
2021-03-26;MV;Maldives;146;0;23237;66
2021-03-27;MV;Maldives;166;0;23403;66
2021-03-28;MV;Maldives;121;0;23524;66
2021-03-29;MV;Maldives;147;0;23671;66
2021-03-30;MV;Maldives;167;0;23838;66
2021-03-31;MV;Maldives;241;1;24079;67
2021-04-01;MV;Maldives;300;0;24379;67
2021-04-02;MV;Maldives;169;0;24548;67
2021-04-03;MV;Maldives;103;0;24651;67
2021-04-04;MV;Maldives;132;0;24783;67
2021-04-05;MV;Maldives;125;0;24908;67
2021-04-06;MV;Maldives;145;0;25053;67
2021-04-07;MV;Maldives;138;0;25191;67
2021-04-08;MV;Maldives;113;0;25304;67
2021-04-09;MV;Maldives;132;0;25436;67
2021-04-10;MV;Maldives;88;0;25524;67
2021-04-11;MV;Maldives;93;0;25617;67
2021-04-12;MV;Maldives;84;0;25701;67
2021-04-13;MV;Maldives;58;0;25759;67
2021-04-14;MV;Maldives;85;0;25844;67
2021-04-15;MV;Maldives;95;0;25939;67
2021-04-16;MV;Maldives;82;1;26021;68
2021-04-17;MV;Maldives;124;1;26145;69
2021-04-18;MV;Maldives;203;1;26348;70
2021-04-19;MV;Maldives;157;0;26505;70
2021-04-20;MV;Maldives;162;1;26667;71
2021-04-21;MV;Maldives;253;0;26920;71
2021-04-22;MV;Maldives;164;0;27084;71
2021-04-23;MV;Maldives;319;0;27403;71
2021-04-24;MV;Maldives;218;0;27621;71
2021-04-25;MV;Maldives;253;0;27874;71
2021-04-26;MV;Maldives;328;0;28202;71
2021-04-27;MV;Maldives;386;0;28588;71
2021-04-28;MV;Maldives;464;1;29052;72
2021-04-29;MV;Maldives;318;1;29370;73
2021-04-30;MV;Maldives;465;0;29835;73
2021-05-01;MV;Maldives;402;0;30237;73
2021-05-02;MV;Maldives;508;1;30745;74
2021-05-03;MV;Maldives;585;0;31330;74
2021-05-04;MV;Maldives;601;0;31931;74
2021-05-05;MV;Maldives;734;0;32665;74
2021-05-06;MV;Maldives;703;3;33368;77
2021-05-07;MV;Maldives;766;5;34134;82
2021-05-08;MV;Maldives;590;1;34724;83
2021-05-09;MV;Maldives;1091;1;35815;84
2021-05-10;MV;Maldives;1204;3;37019;87
2021-05-11;MV;Maldives;1501;0;38520;87
2021-05-12;MV;Maldives;1572;0;40092;87
2021-05-13;MV;Maldives;1216;0;41308;87
2021-05-14;MV;Maldives;1467;5;42775;92
2021-05-15;MV;Maldives;1007;2;43782;94
2021-05-16;MV;Maldives;741;3;44523;97
2021-05-17;MV;Maldives;1433;4;45956;101
2021-05-18;MV;Maldives;1465;4;47421;105
2021-05-19;MV;Maldives;1187;7;48608;112
2021-05-20;MV;Maldives;2194;2;50802;114
2021-05-21;MV;Maldives;1603;6;52405;120
2021-05-22;MV;Maldives;1960;3;54365;123
2021-05-23;MV;Maldives;1559;6;55924;129
2021-05-24;MV;Maldives;1417;10;57341;139
2021-05-25;MV;Maldives;1004;5;58345;144
2021-05-26;MV;Maldives;1299;3;59644;147
2021-05-27;MV;Maldives;1299;4;60943;151
2021-05-28;MV;Maldives;901;4;61844;155
2021-05-29;MV;Maldives;1062;2;62906;157
2021-05-30;MV;Maldives;780;1;63686;158
2021-05-31;MV;Maldives;710;2;64396;160
2021-06-01;MV;Maldives;768;9;65164;169
2021-06-02;MV;Maldives;704;2;65868;171
2021-06-03;MV;Maldives;648;2;66516;173
2021-06-04;MV;Maldives;432;4;66948;177
2021-06-05;MV;Maldives;590;5;67538;182
2021-06-06;MV;Maldives;412;3;67950;185
2021-06-07;MV;Maldives;552;2;68502;187
2021-06-08;MV;Maldives;370;2;68872;189
2021-06-09;MV;Maldives;341;2;69213;191
2021-06-10;MV;Maldives;323;0;69536;191
2021-06-11;MV;Maldives;295;1;69831;192
2021-06-12;MV;Maldives;246;3;70077;195
2021-06-13;MV;Maldives;224;2;70301;197
2021-06-14;MV;Maldives;372;1;70673;198
2021-06-15;MV;Maldives;224;0;70897;198
2021-06-16;MV;Maldives;241;2;71138;200
2021-06-17;MV;Maldives;218;1;71356;201
2021-06-18;MV;Maldives;142;2;71498;203
2021-06-19;MV;Maldives;211;2;71709;205
2021-06-20;MV;Maldives;187;1;71896;206
2021-06-21;MV;Maldives;253;0;72149;206
2021-06-22;MV;Maldives;145;1;72294;207
2021-06-23;MV;Maldives;172;0;72466;207
2021-06-24;MV;Maldives;212;0;72678;207
2021-06-25;MV;Maldives;266;2;72944;209
2021-06-26;MV;Maldives;150;0;73094;209
2021-06-27;MV;Maldives;233;0;73327;209
2021-06-28;MV;Maldives;155;0;73482;209
2021-06-29;MV;Maldives;178;1;73660;210
2021-06-30;MV;Maldives;138;0;73798;210
2021-07-01;MV;Maldives;133;3;73931;213
2020-03-25;ML;Mali;2;0;2;0
2020-03-26;ML;Mali;2;0;4;0
2020-03-27;ML;Mali;7;0;11;0
2020-03-28;ML;Mali;7;0;18;0
2020-03-29;ML;Mali;0;1;18;1
2020-03-30;ML;Mali;7;1;25;2
2020-03-31;ML;Mali;3;0;28;2
2020-04-01;ML;Mali;3;1;31;3
2020-04-02;ML;Mali;5;0;36;3
2020-04-03;ML;Mali;3;0;39;3
2020-04-04;ML;Mali;2;0;41;3
2020-04-05;ML;Mali;4;2;45;5
2020-04-06;ML;Mali;2;0;47;5
2020-04-07;ML;Mali;9;0;56;5
2020-04-08;ML;Mali;3;2;59;7
2020-04-09;ML;Mali;15;0;74;7
2020-04-10;ML;Mali;13;0;87;7
2020-04-11;ML;Mali;0;0;87;7
2020-04-12;ML;Mali;18;2;105;9
2020-04-13;ML;Mali;18;1;123;10
2020-04-14;ML;Mali;21;3;144;13
2020-04-15;ML;Mali;4;0;148;13
2020-04-16;ML;Mali;23;0;171;13
2020-04-17;ML;Mali;0;0;171;13
2020-04-18;ML;Mali;45;0;216;13
2020-04-19;ML;Mali;8;1;224;14
2020-04-20;ML;Mali;22;0;246;14
2020-04-21;ML;Mali;12;0;258;14
2020-04-22;ML;Mali;35;3;293;17
2020-04-23;ML;Mali;16;4;309;21
2020-04-24;ML;Mali;16;0;325;21
2020-04-25;ML;Mali;45;0;370;21
2020-04-26;ML;Mali;19;2;389;23
2020-04-27;ML;Mali;19;0;408;23
2020-04-28;ML;Mali;16;1;424;24
2020-04-29;ML;Mali;58;1;482;25
2020-04-30;ML;Mali;8;1;490;26
2020-05-01;ML;Mali;18;0;508;26
2020-05-02;ML;Mali;36;0;544;26
2020-05-03;ML;Mali;19;1;563;27
2020-05-04;ML;Mali;17;2;580;29
2020-05-05;ML;Mali;32;3;612;32
2020-05-06;ML;Mali;19;0;631;32
2020-05-07;ML;Mali;19;0;650;32
2020-05-08;ML;Mali;18;3;668;35
2020-05-09;ML;Mali;24;2;692;37
2020-05-10;ML;Mali;12;1;704;38
2020-05-11;ML;Mali;8;1;712;39
2020-05-12;ML;Mali;18;1;730;40
2020-05-13;ML;Mali;28;4;758;44
2020-05-14;ML;Mali;21;2;779;46
2020-05-15;ML;Mali;27;0;806;46
2020-05-16;ML;Mali;29;2;835;48
2020-05-17;ML;Mali;25;4;860;52
2020-05-18;ML;Mali;14;0;874;52
2020-05-19;ML;Mali;27;1;901;53
2020-05-20;ML;Mali;30;2;931;55
2020-05-21;ML;Mali;16;5;947;60
2020-05-22;ML;Mali;22;2;969;62
2020-05-23;ML;Mali;46;1;1015;63
2020-05-24;ML;Mali;15;2;1030;65
2020-05-25;ML;Mali;29;2;1059;67
2020-05-26;ML;Mali;18;3;1077;70
2020-05-27;ML;Mali;39;0;1116;70
2020-05-28;ML;Mali;78;2;1194;72
2020-05-29;ML;Mali;32;1;1226;73
2020-05-30;ML;Mali;24;3;1250;76
2020-05-31;ML;Mali;15;1;1265;77
2020-06-01;ML;Mali;50;1;1315;78
2020-06-02;ML;Mali;36;0;1351;78
2020-06-03;ML;Mali;35;1;1386;79
2020-06-04;ML;Mali;75;6;1461;85
2020-06-05;ML;Mali;24;2;1485;87
2020-06-06;ML;Mali;38;3;1523;90
2020-06-07;ML;Mali;10;0;1533;90
2020-06-08;ML;Mali;14;2;1547;92
2020-06-09;ML;Mali;39;2;1586;94
2020-06-10;ML;Mali;81;2;1667;96
2020-06-11;ML;Mali;55;1;1722;97
2020-06-12;ML;Mali;30;4;1752;101
2020-06-13;ML;Mali;24;3;1776;104
2020-06-14;ML;Mali;33;0;1809;104
2020-06-15;ML;Mali;51;0;1860;104
2020-06-16;ML;Mali;25;0;1885;104
2020-06-17;ML;Mali;5;3;1890;107
2020-06-18;ML;Mali;16;0;1906;107
2020-06-19;ML;Mali;17;1;1923;108
2020-06-20;ML;Mali;10;1;1933;109
2020-06-21;ML;Mali;0;0;1933;109
2020-06-22;ML;Mali;28;2;1961;111
2020-06-23;ML;Mali;17;0;1978;111
2020-06-24;ML;Mali;27;1;2005;112
2020-06-25;ML;Mali;34;1;2039;113
2020-06-26;ML;Mali;21;0;2060;113
2020-06-27;ML;Mali;58;0;2118;113
2020-06-28;ML;Mali;29;1;2147;114
2020-06-29;ML;Mali;26;1;2173;115
2020-06-30;ML;Mali;8;1;2181;116
2020-07-01;ML;Mali;21;0;2202;116
2020-07-02;ML;Mali;58;1;2260;117
2020-07-03;ML;Mali;25;0;2285;117
2020-07-04;ML;Mali;18;1;2303;118
2020-07-05;ML;Mali;27;1;2330;119
2020-07-06;ML;Mali;1;0;2331;119
2020-07-07;ML;Mali;17;0;2348;119
2020-07-08;ML;Mali;10;1;2358;120
2020-07-09;ML;Mali;12;0;2370;120
2020-07-10;ML;Mali;34;1;2404;121
2020-07-11;ML;Mali;2;0;2406;121
2020-07-12;ML;Mali;5;0;2411;121
2020-07-13;ML;Mali;1;0;2412;121
2020-07-14;ML;Mali;11;0;2423;121
2020-07-15;ML;Mali;10;0;2433;121
2020-07-16;ML;Mali;7;0;2440;121
2020-07-17;ML;Mali;27;0;2467;121
2020-07-18;ML;Mali;5;0;2472;121
2020-07-19;ML;Mali;3;0;2475;121
2020-07-20;ML;Mali;0;0;2475;121
2020-07-21;ML;Mali;2;1;2477;122
2020-07-22;ML;Mali;17;1;2494;123
2020-07-23;ML;Mali;0;0;2494;123
2020-07-24;ML;Mali;9;0;2503;123
2020-07-25;ML;Mali;0;0;2503;123
2020-07-26;ML;Mali;7;0;2510;123
2020-07-27;ML;Mali;3;1;2513;124
2020-07-28;ML;Mali;7;0;2520;124
2020-07-29;ML;Mali;1;0;2521;124
2020-07-30;ML;Mali;1;0;2522;124
2020-07-31;ML;Mali;13;0;2535;124
2020-08-01;ML;Mali;0;0;2535;124
2020-08-02;ML;Mali;6;0;2541;124
2020-08-03;ML;Mali;2;0;2543;124
2020-08-04;ML;Mali;0;0;2543;124
2020-08-05;ML;Mali;3;0;2546;124
2020-08-06;ML;Mali;6;0;2552;124
2020-08-07;ML;Mali;9;1;2561;125
2020-08-08;ML;Mali;4;0;2565;125
2020-08-09;ML;Mali;2;0;2567;125
2020-08-10;ML;Mali;6;0;2573;125
2020-08-11;ML;Mali;4;0;2577;125
2020-08-12;ML;Mali;5;0;2582;125
2020-08-13;ML;Mali;15;0;2597;125
2020-08-14;ML;Mali;0;0;2597;125
2020-08-15;ML;Mali;17;0;2614;125
2020-08-16;ML;Mali;26;0;2640;125
2020-08-17;ML;Mali;0;0;2640;125
2020-08-18;ML;Mali;26;0;2666;125
2020-08-19;ML;Mali;1;0;2667;125
2020-08-20;ML;Mali;0;0;2667;125
2020-08-21;ML;Mali;21;0;2688;125
2020-08-22;ML;Mali;11;0;2699;125
2020-08-23;ML;Mali;6;0;2705;125
2020-08-24;ML;Mali;3;0;2708;125
2020-08-25;ML;Mali;5;0;2713;125
2020-08-26;ML;Mali;4;1;2717;126
2020-08-27;ML;Mali;13;0;2730;126
2020-08-28;ML;Mali;6;0;2736;126
2020-08-29;ML;Mali;21;0;2757;126
2020-08-30;ML;Mali;16;0;2773;126
2020-08-31;ML;Mali;3;0;2776;126
2020-09-01;ML;Mali;1;0;2777;126
2020-09-02;ML;Mali;25;0;2802;126
2020-09-03;ML;Mali;5;0;2807;126
2020-09-04;ML;Mali;7;0;2814;126
2020-09-05;ML;Mali;19;0;2833;126
2020-09-06;ML;Mali;9;1;2842;127
2020-09-07;ML;Mali;28;0;2870;127
2020-09-08;ML;Mali;12;0;2882;127
2020-09-09;ML;Mali;16;1;2898;128
2020-09-10;ML;Mali;11;0;2909;128
2020-09-11;ML;Mali;3;0;2912;128
2020-09-12;ML;Mali;4;0;2916;128
2020-09-13;ML;Mali;8;0;2924;128
2020-09-14;ML;Mali;11;0;2935;128
2020-09-15;ML;Mali;5;0;2940;128
2020-09-16;ML;Mali;26;0;2966;128
2020-09-17;ML;Mali;0;0;2966;128
2020-09-18;ML;Mali;25;0;2991;128
2020-09-19;ML;Mali;15;0;3006;128
2020-09-20;ML;Mali;7;0;3013;128
2020-09-21;ML;Mali;11;0;3024;128
2020-09-22;ML;Mali;6;1;3030;129
2020-09-23;ML;Mali;4;1;3034;130
2020-09-24;ML;Mali;7;0;3041;130
2020-09-25;ML;Mali;23;0;3064;130
2020-09-26;ML;Mali;16;0;3080;130
2020-09-27;ML;Mali;6;0;3086;130
2020-09-28;ML;Mali;4;0;3090;130
2020-09-29;ML;Mali;11;1;3101;131
2020-09-30;ML;Mali;17;0;3118;131
2020-10-01;ML;Mali;13;0;3131;131
2020-10-02;ML;Mali;25;0;3156;131
2020-10-03;ML;Mali;14;0;3170;131
2020-10-04;ML;Mali;14;0;3184;131
2020-10-05;ML;Mali;5;0;3189;131
2020-10-06;ML;Mali;6;0;3195;131
2020-10-07;ML;Mali;15;0;3210;131
2020-10-08;ML;Mali;25;0;3235;131
2020-10-09;ML;Mali;13;0;3248;131
2020-10-10;ML;Mali;25;1;3273;132
2020-10-11;ML;Mali;13;0;3286;132
2020-10-12;ML;Mali;10;0;3296;132
2020-10-13;ML;Mali;1;0;3297;132
2020-10-14;ML;Mali;55;0;3352;132
2020-10-15;ML;Mali;16;0;3368;132
2020-10-16;ML;Mali;10;0;3378;132
2020-10-17;ML;Mali;1;0;3379;132
2020-10-18;ML;Mali;9;0;3388;132
2020-10-19;ML;Mali;19;0;3407;132
2020-10-20;ML;Mali;4;0;3411;132
2020-10-21;ML;Mali;17;0;3428;132
2020-10-22;ML;Mali;12;0;3440;132
2020-10-23;ML;Mali;4;0;3444;132
2020-10-24;ML;Mali;28;0;3472;132
2020-10-25;ML;Mali;18;0;3490;132
2020-10-26;ML;Mali;9;1;3499;133
2020-10-27;ML;Mali;16;3;3515;136
2020-10-28;ML;Mali;15;0;3530;136
2020-10-29;ML;Mali;7;0;3537;136
2020-10-30;ML;Mali;8;0;3545;136
2020-10-31;ML;Mali;9;0;3554;136
2020-11-01;ML;Mali;11;0;3565;136
2020-11-02;ML;Mali;8;0;3573;136
2020-11-03;ML;Mali;11;0;3584;136
2020-11-04;ML;Mali;25;1;3609;137
2020-11-05;ML;Mali;24;0;3633;137
2020-11-06;ML;Mali;24;0;3657;137
2020-11-07;ML;Mali;19;0;3676;137
2020-11-08;ML;Mali;30;0;3706;137
2020-11-09;ML;Mali;6;0;3712;137
2020-11-10;ML;Mali;33;0;3745;137
2020-11-11;ML;Mali;8;1;3753;138
2020-11-12;ML;Mali;39;0;3792;138
2020-11-13;ML;Mali;14;1;3806;139
2020-11-14;ML;Mali;62;0;3868;139
2020-11-15;ML;Mali;32;2;3900;141
2020-11-16;ML;Mali;48;0;3948;141
2020-11-17;ML;Mali;32;0;3980;141
2020-11-18;ML;Mali;53;0;4033;141
2020-11-19;ML;Mali;60;1;4093;142
2020-11-20;ML;Mali;76;1;4169;143
2020-11-21;ML;Mali;37;0;4206;143
2020-11-22;ML;Mali;49;2;4255;145
2020-11-23;ML;Mali;71;1;4326;146
2020-11-24;ML;Mali;91;2;4417;148
2020-11-25;ML;Mali;44;0;4461;148
2020-11-26;ML;Mali;44;0;4505;148
2020-11-27;ML;Mali;62;1;4567;149
2020-11-28;ML;Mali;92;0;4659;149
2020-11-29;ML;Mali;29;3;4688;152
2020-11-30;ML;Mali;22;4;4710;156
2020-12-01;ML;Mali;52;4;4762;160
2020-12-02;ML;Mali;75;1;4837;161
2020-12-03;ML;Mali;43;1;4880;162
2020-12-04;ML;Mali;58;1;4938;163
2020-12-05;ML;Mali;124;0;5062;163
2020-12-06;ML;Mali;73;1;5135;164
2020-12-07;ML;Mali;155;11;5290;175
2020-12-08;ML;Mali;152;5;5442;180
2020-12-09;ML;Mali;27;1;5469;181
2020-12-10;ML;Mali;107;3;5576;184
2020-12-11;ML;Mali;73;1;5649;185
2020-12-12;ML;Mali;72;4;5721;189
2020-12-13;ML;Mali;93;5;5814;194
2020-12-14;ML;Mali;22;7;5836;201
2020-12-15;ML;Mali;42;4;5878;205
2020-12-16;ML;Mali;91;4;5969;209
2020-12-17;ML;Mali;80;2;6049;211
2020-12-18;ML;Mali;71;4;6120;215
2020-12-19;ML;Mali;44;5;6164;220
2020-12-20;ML;Mali;27;2;6191;222
2020-12-21;ML;Mali;41;3;6232;225
2020-12-22;ML;Mali;59;0;6291;225
2020-12-23;ML;Mali;56;4;6347;229
2020-12-24;ML;Mali;94;6;6441;235
2020-12-25;ML;Mali;47;10;6488;245
2020-12-26;ML;Mali;86;4;6574;249
2020-12-27;ML;Mali;55;4;6629;253
2020-12-28;ML;Mali;74;3;6703;256
2020-12-29;ML;Mali;93;6;6796;262
2020-12-30;ML;Mali;233;7;7029;269
2020-12-31;ML;Mali;61;0;7090;269
2021-01-01;ML;Mali;113;2;7203;271
2021-01-02;ML;Mali;23;5;7226;276
2021-01-03;ML;Mali;27;2;7253;278
2021-01-04;ML;Mali;7;1;7260;279
2021-01-05;ML;Mali;89;5;7349;284
2021-01-06;ML;Mali;46;1;7395;285
2021-01-07;ML;Mali;32;1;7427;286
2021-01-08;ML;Mali;85;4;7512;290
2021-01-09;ML;Mali;53;5;7565;295
2021-01-10;ML;Mali;35;3;7600;298
2021-01-11;ML;Mali;64;1;7664;299
2021-01-12;ML;Mali;23;4;7687;303
2021-01-13;ML;Mali;51;0;7738;303
2021-01-14;ML;Mali;21;2;7759;305
2021-01-15;ML;Mali;41;3;7800;308
2021-01-16;ML;Mali;23;0;7823;308
2021-01-17;ML;Mali;16;2;7839;310
2021-01-18;ML;Mali;16;1;7855;311
2021-01-19;ML;Mali;25;6;7880;317
2021-01-20;ML;Mali;17;1;7897;318
2021-01-21;ML;Mali;14;2;7911;320
2021-01-22;ML;Mali;26;1;7937;321
2021-01-23;ML;Mali;28;2;7965;323
2021-01-24;ML;Mali;18;0;7983;323
2021-01-25;ML;Mali;12;1;7995;324
2021-01-26;ML;Mali;11;3;8006;327
2021-01-27;ML;Mali;31;0;8037;327
2021-01-28;ML;Mali;19;1;8056;328
2021-01-29;ML;Mali;7;1;8063;329
2021-01-30;ML;Mali;6;1;8069;330
2021-01-31;ML;Mali;22;0;8091;330
2021-02-01;ML;Mali;9;0;8100;330
2021-02-02;ML;Mali;11;3;8111;333
2021-02-03;ML;Mali;8;0;8119;333
2021-02-04;ML;Mali;11;0;8130;333
2021-02-05;ML;Mali;15;3;8145;336
2021-02-06;ML;Mali;15;2;8160;338
2021-02-07;ML;Mali;16;0;8176;338
2021-02-08;ML;Mali;5;1;8181;339
2021-02-09;ML;Mali;11;0;8192;339
2021-02-10;ML;Mali;11;0;8203;339
2021-02-11;ML;Mali;15;1;8218;340
2021-02-12;ML;Mali;4;0;8222;340
2021-02-13;ML;Mali;4;2;8226;342
2021-02-14;ML;Mali;3;0;8229;342
2021-02-15;ML;Mali;6;0;8235;342
2021-02-16;ML;Mali;6;0;8241;342
2021-02-17;ML;Mali;15;0;8256;342
2021-02-18;ML;Mali;0;0;8256;342
2021-02-19;ML;Mali;4;2;8260;344
2021-02-20;ML;Mali;32;3;8292;347
2021-02-21;ML;Mali;7;1;8299;348
2021-02-22;ML;Mali;7;0;8306;348
2021-02-23;ML;Mali;18;0;8324;348
2021-02-24;ML;Mali;8;0;8332;348
2021-02-25;ML;Mali;17;1;8349;349
2021-02-26;ML;Mali;9;1;8358;350
2021-02-27;ML;Mali;7;2;8365;352
2021-02-28;ML;Mali;11;1;8376;353
2021-03-01;ML;Mali;14;2;8390;355
2021-03-02;ML;Mali;30;0;8420;355
2021-03-03;ML;Mali;26;2;8446;357
2021-03-04;ML;Mali;24;0;8470;357
2021-03-05;ML;Mali;39;1;8509;358
2021-03-06;ML;Mali;51;0;8560;358
2021-03-07;ML;Mali;20;0;8580;358
2021-03-08;ML;Mali;33;0;8613;358
2021-03-09;ML;Mali;0;0;8613;358
2021-03-10;ML;Mali;97;0;8710;358
2021-03-11;ML;Mali;72;1;8782;359
2021-03-12;ML;Mali;31;1;8813;360
2021-03-13;ML;Mali;49;0;8862;360
2021-03-14;ML;Mali;51;0;8913;360
2021-03-15;ML;Mali;20;3;8933;363
2021-03-16;ML;Mali;85;1;9018;364
2021-03-17;ML;Mali;48;1;9066;365
2021-03-18;ML;Mali;52;1;9118;366
2021-03-19;ML;Mali;73;1;9191;367
2021-03-20;ML;Mali;79;0;9270;367
2021-03-21;ML;Mali;60;1;9330;368
2021-03-22;ML;Mali;50;3;9380;371
2021-03-23;ML;Mali;94;1;9474;372
2021-03-24;ML;Mali;103;0;9577;372
2021-03-25;ML;Mali;70;3;9647;375
2021-03-26;ML;Mali;72;1;9719;376
2021-03-27;ML;Mali;54;0;9773;376
2021-03-28;ML;Mali;98;3;9871;379
2021-03-29;ML;Mali;50;5;9921;384
2021-03-30;ML;Mali;77;0;9998;384
2021-03-31;ML;Mali;44;1;10042;385
2021-04-01;ML;Mali;157;1;10199;386
2021-04-02;ML;Mali;86;4;10285;390
2021-04-03;ML;Mali;147;1;10432;391
2021-04-04;ML;Mali;148;1;10580;392
2021-04-05;ML;Mali;40;1;10620;393
2021-04-06;ML;Mali;138;3;10758;396
2021-04-07;ML;Mali;83;4;10841;400
2021-04-08;ML;Mali;413;2;11254;402
2021-04-09;ML;Mali;139;2;11393;404
2021-04-10;ML;Mali;312;1;11705;405
2021-04-11;ML;Mali;139;3;11844;408
2021-04-12;ML;Mali;158;6;12002;414
2021-04-13;ML;Mali;177;3;12179;417
2021-04-14;ML;Mali;288;2;12467;419
2021-04-15;ML;Mali;239;2;12706;421
2021-04-16;ML;Mali;129;5;12835;426
2021-04-17;ML;Mali;145;3;12980;429
2021-04-18;ML;Mali;90;4;13070;433
2021-04-19;ML;Mali;75;8;13145;441
2021-04-20;ML;Mali;101;3;13246;444
2021-04-21;ML;Mali;90;7;13336;451
2021-04-22;ML;Mali;84;5;13420;456
2021-04-23;ML;Mali;84;4;13504;460
2021-04-24;ML;Mali;56;2;13560;462
2021-04-25;ML;Mali;67;5;13627;467
2021-04-26;ML;Mali;31;7;13658;474
2021-04-27;ML;Mali;64;2;13722;476
2021-04-28;ML;Mali;58;1;13780;477
2021-04-29;ML;Mali;35;4;13815;481
2021-04-30;ML;Mali;43;3;13858;484
2021-05-01;ML;Mali;38;1;13896;485
2021-05-02;ML;Mali;19;4;13915;489
2021-05-03;ML;Mali;22;2;13937;491
2021-05-04;ML;Mali;32;1;13969;492
2021-05-05;ML;Mali;29;1;13998;493
2021-05-06;ML;Mali;31;0;14029;493
2021-05-07;ML;Mali;30;4;14059;497
2021-05-08;ML;Mali;23;2;14082;499
2021-05-09;ML;Mali;26;1;14108;500
2021-05-10;ML;Mali;7;2;14115;502
2021-05-11;ML;Mali;18;4;14133;506
2021-05-12;ML;Mali;16;1;14149;507
2021-05-13;ML;Mali;0;1;14149;508
2021-05-14;ML;Mali;14;2;14163;510
2021-05-15;ML;Mali;13;1;14176;511
2021-05-16;ML;Mali;14;0;14190;511
2021-05-17;ML;Mali;4;0;14194;511
2021-05-18;ML;Mali;13;0;14207;511
2021-05-19;ML;Mali;14;1;14221;512
2021-05-20;ML;Mali;5;0;14226;512
2021-05-21;ML;Mali;10;0;14236;512
2021-05-22;ML;Mali;4;1;14240;513
2021-05-23;ML;Mali;1;1;14241;514
2021-05-24;ML;Mali;3;0;14244;514
2021-05-25;ML;Mali;8;0;14252;514
2021-05-26;ML;Mali;4;0;14256;514
2021-05-27;ML;Mali;3;0;14259;514
2021-05-28;ML;Mali;3;2;14262;516
2021-05-29;ML;Mali;3;1;14265;517
2021-05-30;ML;Mali;0;0;14265;517
2021-05-31;ML;Mali;2;0;14267;517
2021-06-01;ML;Mali;4;0;14271;517
2021-06-02;ML;Mali;10;0;14281;517
2021-06-03;ML;Mali;0;0;14281;517
2021-06-04;ML;Mali;6;0;14287;517
2021-06-05;ML;Mali;9;1;14296;518
2021-06-06;ML;Mali;2;1;14298;519
2021-06-07;ML;Mali;4;0;14302;519
2021-06-08;ML;Mali;22;1;14324;520
2021-06-09;ML;Mali;4;1;14328;521
2021-06-10;ML;Mali;1;0;14329;521
2021-06-11;ML;Mali;7;2;14336;523
2021-06-12;ML;Mali;13;0;14349;523
2021-06-13;ML;Mali;1;0;14350;523
2021-06-14;ML;Mali;2;0;14352;523
2021-06-15;ML;Mali;4;0;14356;523
2021-06-16;ML;Mali;3;0;14359;523
2021-06-17;ML;Mali;5;0;14364;523
2021-06-18;ML;Mali;11;1;14375;524
2021-06-19;ML;Mali;5;0;14380;524
2021-06-20;ML;Mali;1;0;14381;524
2021-06-21;ML;Mali;4;0;14385;524
2021-06-22;ML;Mali;0;0;14385;524
2021-06-23;ML;Mali;6;1;14391;525
2021-06-24;ML;Mali;5;0;14396;525
2021-06-25;ML;Mali;8;0;14404;525
2021-06-26;ML;Mali;10;0;14414;525
2021-06-27;ML;Mali;3;0;14417;525
2021-06-28;ML;Mali;2;0;14419;525
2021-06-29;ML;Mali;3;0;14422;525
2021-06-30;ML;Mali;4;0;14426;525
2021-07-01;ML;Mali;2;0;14428;525
2020-02-06;MT;Malta;0;0;0;0
2020-02-07;MT;Malta;0;0;0;0
2020-02-08;MT;Malta;0;0;0;0
2020-02-09;MT;Malta;0;0;0;0
2020-02-10;MT;Malta;0;0;0;0
2020-02-11;MT;Malta;0;0;0;0
2020-02-12;MT;Malta;0;0;0;0
2020-02-13;MT;Malta;0;0;0;0
2020-02-14;MT;Malta;0;0;0;0
2020-02-15;MT;Malta;0;0;0;0
2020-02-16;MT;Malta;0;0;0;0
2020-02-17;MT;Malta;0;0;0;0
2020-02-18;MT;Malta;0;0;0;0
2020-02-19;MT;Malta;0;0;0;0
2020-02-20;MT;Malta;0;0;0;0
2020-02-21;MT;Malta;0;0;0;0
2020-02-22;MT;Malta;0;0;0;0
2020-02-23;MT;Malta;0;0;0;0
2020-02-24;MT;Malta;0;0;0;0
2020-02-25;MT;Malta;0;0;0;0
2020-02-26;MT;Malta;0;0;0;0
2020-02-27;MT;Malta;0;0;0;0
2020-02-28;MT;Malta;0;0;0;0
2020-02-29;MT;Malta;0;0;0;0
2020-03-01;MT;Malta;0;0;0;0
2020-03-02;MT;Malta;0;0;0;0
2020-03-03;MT;Malta;0;0;0;0
2020-03-04;MT;Malta;0;0;0;0
2020-03-05;MT;Malta;0;0;0;0
2020-03-06;MT;Malta;0;0;0;0
2020-03-07;MT;Malta;3;0;3;0
2020-03-08;MT;Malta;0;0;3;0
2020-03-09;MT;Malta;0;0;3;0
2020-03-10;MT;Malta;2;0;5;0
2020-03-11;MT;Malta;1;0;6;0
2020-03-12;MT;Malta;0;0;6;0
2020-03-13;MT;Malta;6;0;12;0
2020-03-14;MT;Malta;6;0;18;0
2020-03-15;MT;Malta;3;0;21;0
2020-03-16;MT;Malta;9;0;30;0
2020-03-17;MT;Malta;8;0;38;0
2020-03-18;MT;Malta;0;0;38;0
2020-03-19;MT;Malta;15;0;53;0
2020-03-20;MT;Malta;11;0;64;0
2020-03-21;MT;Malta;9;0;73;0
2020-03-22;MT;Malta;17;0;90;0
2020-03-23;MT;Malta;17;0;107;0
2020-03-24;MT;Malta;3;0;110;0
2020-03-25;MT;Malta;19;0;129;0
2020-03-26;MT;Malta;5;0;134;0
2020-03-27;MT;Malta;5;0;139;0
2020-03-28;MT;Malta;10;0;149;0
2020-03-29;MT;Malta;2;0;151;0
2020-03-30;MT;Malta;5;0;156;0
2020-03-31;MT;Malta;13;0;169;0
2020-04-01;MT;Malta;19;0;188;0
2020-04-02;MT;Malta;8;0;196;0
2020-04-03;MT;Malta;6;0;202;0
2020-04-04;MT;Malta;11;0;213;0
2020-04-05;MT;Malta;14;0;227;0
2020-04-06;MT;Malta;14;0;241;0
2020-04-07;MT;Malta;52;0;293;0
2020-04-08;MT;Malta;6;1;299;1
2020-04-09;MT;Malta;38;1;337;2
2020-04-10;MT;Malta;13;0;350;2
2020-04-11;MT;Malta;20;1;370;3
2020-04-12;MT;Malta;8;0;378;3
2020-04-13;MT;Malta;6;0;384;3
2020-04-14;MT;Malta;9;0;393;3
2020-04-15;MT;Malta;6;0;399;3
2020-04-16;MT;Malta;13;0;412;3
2020-04-17;MT;Malta;10;0;422;3
2020-04-18;MT;Malta;4;0;426;3
2020-04-19;MT;Malta;1;0;427;3
2020-04-20;MT;Malta;4;0;431;3
2020-04-21;MT;Malta;12;0;443;3
2020-04-22;MT;Malta;1;0;444;3
2020-04-23;MT;Malta;1;0;445;3
2020-04-24;MT;Malta;2;0;447;3
2020-04-25;MT;Malta;1;1;448;4
2020-04-26;MT;Malta;0;0;448;4
2020-04-27;MT;Malta;2;0;450;4
2020-04-28;MT;Malta;8;0;458;4
2020-04-29;MT;Malta;5;0;463;4
2020-04-30;MT;Malta;2;0;465;4
2020-05-01;MT;Malta;2;0;467;4
2020-05-02;MT;Malta;1;0;468;4
2020-05-03;MT;Malta;9;0;477;4
2020-05-04;MT;Malta;3;0;480;4
2020-05-05;MT;Malta;2;1;482;5
2020-05-06;MT;Malta;2;0;484;5
2020-05-07;MT;Malta;2;0;486;5
2020-05-08;MT;Malta;3;0;489;5
2020-05-09;MT;Malta;1;0;490;5
2020-05-10;MT;Malta;6;0;496;5
2020-05-11;MT;Malta;7;0;503;5
2020-05-12;MT;Malta;3;0;506;5
2020-05-13;MT;Malta;2;1;508;6
2020-05-14;MT;Malta;14;0;522;6
2020-05-15;MT;Malta;10;0;532;6
2020-05-16;MT;Malta;14;0;546;6
2020-05-17;MT;Malta;7;0;553;6
2020-05-18;MT;Malta;5;0;558;6
2020-05-19;MT;Malta;11;0;569;6
2020-05-20;MT;Malta;15;0;584;6
2020-05-21;MT;Malta;15;0;599;6
2020-05-22;MT;Malta;1;0;600;6
2020-05-23;MT;Malta;9;0;609;6
2020-05-24;MT;Malta;1;0;610;6
2020-05-25;MT;Malta;1;0;611;6
2020-05-26;MT;Malta;0;0;611;6
2020-05-27;MT;Malta;1;1;612;7
2020-05-28;MT;Malta;4;0;616;7
2020-05-29;MT;Malta;0;2;616;9
2020-05-30;MT;Malta;2;0;618;9
2020-05-31;MT;Malta;0;0;618;9
2020-06-01;MT;Malta;1;0;619;9
2020-06-02;MT;Malta;1;0;620;9
2020-06-03;MT;Malta;2;0;622;9
2020-06-04;MT;Malta;0;0;622;9
2020-06-05;MT;Malta;3;0;625;9
2020-06-06;MT;Malta;2;0;627;9
2020-06-07;MT;Malta;2;0;629;9
2020-06-08;MT;Malta;1;0;630;9
2020-06-09;MT;Malta;2;0;632;9
2020-06-10;MT;Malta;3;0;635;9
2020-06-11;MT;Malta;5;0;640;9
2020-06-12;MT;Malta;5;0;645;9
2020-06-13;MT;Malta;1;0;646;9
2020-06-14;MT;Malta;3;0;649;9
2020-06-15;MT;Malta;1;0;650;9
2020-06-16;MT;Malta;6;0;656;9
2020-06-17;MT;Malta;6;0;662;9
2020-06-18;MT;Malta;1;0;663;9
2020-06-19;MT;Malta;0;0;663;9
2020-06-20;MT;Malta;1;0;664;9
2020-06-21;MT;Malta;1;0;665;9
2020-06-22;MT;Malta;0;0;665;9
2020-06-23;MT;Malta;0;0;665;9
2020-06-24;MT;Malta;0;0;665;9
2020-06-25;MT;Malta;3;0;668;9
2020-06-26;MT;Malta;2;0;670;9
2020-06-27;MT;Malta;0;0;670;9
2020-06-28;MT;Malta;0;0;670;9
2020-06-29;MT;Malta;0;0;670;9
2020-06-30;MT;Malta;0;0;670;9
2020-07-01;MT;Malta;1;0;671;9
2020-07-02;MT;Malta;0;0;671;9
2020-07-03;MT;Malta;1;0;672;9
2020-07-04;MT;Malta;0;0;672;9
2020-07-05;MT;Malta;0;0;672;9
2020-07-06;MT;Malta;0;0;672;9
2020-07-07;MT;Malta;1;0;673;9
2020-07-08;MT;Malta;0;0;673;9
2020-07-09;MT;Malta;1;0;674;9
2020-07-10;MT;Malta;0;0;674;9
2020-07-11;MT;Malta;0;0;674;9
2020-07-12;MT;Malta;0;0;674;9
2020-07-13;MT;Malta;0;0;674;9
2020-07-14;MT;Malta;0;0;674;9
2020-07-15;MT;Malta;0;0;674;9
2020-07-16;MT;Malta;0;0;674;9
2020-07-17;MT;Malta;0;0;674;9
2020-07-18;MT;Malta;1;0;675;9
2020-07-19;MT;Malta;2;0;677;9
2020-07-20;MT;Malta;0;0;677;9
2020-07-21;MT;Malta;0;0;677;9
2020-07-22;MT;Malta;2;0;679;9
2020-07-23;MT;Malta;1;0;680;9
2020-07-24;MT;Malta;6;0;686;9
2020-07-25;MT;Malta;0;0;686;9
2020-07-26;MT;Malta;14;0;700;9
2020-07-27;MT;Malta;1;0;701;9
2020-07-28;MT;Malta;7;0;708;9
2020-07-29;MT;Malta;12;0;720;9
2020-07-30;MT;Malta;94;0;814;9
2020-07-31;MT;Malta;10;0;824;9
2020-08-01;MT;Malta;21;0;845;9
2020-08-02;MT;Malta;15;0;860;9
2020-08-03;MT;Malta;14;0;874;9
2020-08-04;MT;Malta;16;0;890;9
2020-08-05;MT;Malta;36;0;926;9
2020-08-06;MT;Malta;20;0;946;9
2020-08-07;MT;Malta;49;0;995;9
2020-08-08;MT;Malta;40;0;1035;9
2020-08-09;MT;Malta;54;0;1089;9
2020-08-10;MT;Malta;23;0;1112;9
2020-08-11;MT;Malta;29;0;1141;9
2020-08-12;MT;Malta;49;0;1190;9
2020-08-13;MT;Malta;55;0;1245;9
2020-08-14;MT;Malta;31;0;1276;9
2020-08-15;MT;Malta;72;0;1348;9
2020-08-16;MT;Malta;-42;0;1306;9
2020-08-17;MT;Malta;69;0;1375;9
2020-08-18;MT;Malta;48;0;1423;9
2020-08-19;MT;Malta;47;0;1470;9
2020-08-20;MT;Malta;40;0;1510;9
2020-08-21;MT;Malta;36;1;1546;10
2020-08-22;MT;Malta;31;0;1577;10
2020-08-23;MT;Malta;35;0;1612;10
2020-08-24;MT;Malta;55;0;1667;10
2020-08-25;MT;Malta;38;0;1705;10
2020-08-26;MT;Malta;46;0;1751;10
2020-08-27;MT;Malta;37;0;1788;10
2020-08-28;MT;Malta;32;0;1820;10
2020-08-29;MT;Malta;27;0;1847;10
2020-08-30;MT;Malta;15;2;1862;12
2020-08-31;MT;Malta;21;0;1883;12
2020-09-01;MT;Malta;26;0;1909;12
2020-09-02;MT;Malta;22;1;1931;13
2020-09-03;MT;Malta;34;0;1965;13
2020-09-04;MT;Malta;19;0;1984;13
2020-09-05;MT;Malta;30;1;2014;14
2020-09-06;MT;Malta;25;0;2039;14
2020-09-07;MT;Malta;37;0;2076;14
2020-09-08;MT;Malta;23;0;2099;14
2020-09-09;MT;Malta;63;0;2162;14
2020-09-10;MT;Malta;42;0;2204;14
2020-09-11;MT;Malta;43;1;2247;15
2020-09-12;MT;Malta;27;0;2274;15
2020-09-13;MT;Malta;78;0;2352;15
2020-09-14;MT;Malta;53;1;2405;16
2020-09-15;MT;Malta;49;0;2454;16
2020-09-16;MT;Malta;106;0;2560;16
2020-09-17;MT;Malta;35;0;2595;16
2020-09-18;MT;Malta;39;1;2634;17
2020-09-19;MT;Malta;65;2;2699;19
2020-09-20;MT;Malta;32;1;2731;20
2020-09-21;MT;Malta;45;3;2776;23
2020-09-22;MT;Malta;38;0;2814;23
2020-09-23;MT;Malta;42;2;2856;25
2020-09-24;MT;Malta;42;2;2898;27
2020-09-25;MT;Malta;31;2;2929;29
2020-09-26;MT;Malta;29;2;2958;31
2020-09-27;MT;Malta;21;0;2979;31
2020-09-28;MT;Malta;27;1;3006;32
2020-09-29;MT;Malta;29;2;3035;34
2020-09-30;MT;Malta;23;1;3058;35
2020-10-01;MT;Malta;37;0;3095;35
2020-10-02;MT;Malta;44;2;3139;37
2020-10-03;MT;Malta;65;1;3204;38
2020-10-04;MT;Malta;66;1;3270;39
2020-10-05;MT;Malta;57;0;3327;39
2020-10-06;MT;Malta;47;1;3374;40
2020-10-07;MT;Malta;68;1;3442;41
2020-10-08;MT;Malta;64;0;3506;41
2020-10-09;MT;Malta;75;0;3581;41
2020-10-10;MT;Malta;100;0;3681;41
2020-10-11;MT;Malta;95;0;3776;41
2020-10-12;MT;Malta;68;2;3844;43
2020-10-13;MT;Malta;93;1;3937;44
2020-10-14;MT;Malta;111;0;4048;44
2020-10-15;MT;Malta;112;1;4160;45
2020-10-16;MT;Malta;122;0;4282;45
2020-10-17;MT;Malta;204;0;4486;45
2020-10-18;MT;Malta;142;0;4628;45
2020-10-19;MT;Malta;109;0;4737;45
2020-10-20;MT;Malta;134;1;4871;46
2020-10-21;MT;Malta;155;0;5026;46
2020-10-22;MT;Malta;111;3;5137;49
2020-10-23;MT;Malta;121;0;5258;49
2020-10-24;MT;Malta;115;1;5373;50
2020-10-25;MT;Malta;125;1;5498;51
2020-10-26;MT;Malta;80;2;5578;53
2020-10-27;MT;Malta;107;2;5685;55
2020-10-28;MT;Malta;75;1;5760;56
2020-10-29;MT;Malta;106;3;5866;59
2020-10-30;MT;Malta;76;2;5942;61
2020-10-31;MT;Malta;100;1;6042;62
2020-11-01;MT;Malta;140;2;6182;64
2020-11-02;MT;Malta;218;2;6400;66
2020-11-03;MT;Malta;106;-2;6506;64
2020-11-04;MT;Malta;84;1;6590;65
2020-11-05;MT;Malta;174;5;6764;70
2020-11-06;MT;Malta;129;3;6893;73
2020-11-07;MT;Malta;146;1;7039;74
2020-11-08;MT;Malta;102;2;7141;76
2020-11-09;MT;Malta;102;2;7243;78
2020-11-10;MT;Malta;153;3;7396;81
2020-11-11;MT;Malta;141;7;7537;88
2020-11-12;MT;Malta;109;0;7646;88
2020-11-13;MT;Malta;150;4;7796;92
2020-11-14;MT;Malta;121;3;7917;95
2020-11-15;MT;Malta;117;2;8034;97
2020-11-16;MT;Malta;103;1;8137;98
2020-11-17;MT;Malta;110;3;8247;101
2020-11-18;MT;Malta;173;2;8420;103
2020-11-19;MT;Malta;140;1;8560;104
2020-11-20;MT;Malta;121;4;8681;108
2020-11-21;MT;Malta;141;3;8822;111
2020-11-22;MT;Malta;102;0;8924;111
2020-11-23;MT;Malta;80;2;9004;113
2020-11-24;MT;Malta;133;4;9137;117
2020-11-25;MT;Malta;116;5;9253;122
2020-11-26;MT;Malta;152;3;9405;125
2020-11-27;MT;Malta;96;3;9501;128
2020-11-28;MT;Malta;108;4;9609;132
2020-11-29;MT;Malta;143;1;9752;133
2020-11-30;MT;Malta;121;4;9873;137
2020-12-01;MT;Malta;102;4;9975;141
2020-12-02;MT;Malta;126;5;10101;146
2020-12-03;MT;Malta;96;2;10197;148
2020-12-04;MT;Malta;123;1;10320;149
2020-12-05;MT;Malta;103;0;10423;149
2020-12-06;MT;Malta;97;2;10520;151
2020-12-07;MT;Malta;139;4;10659;155
2020-12-08;MT;Malta;40;2;10699;157
2020-12-09;MT;Malta;79;3;10778;160
2020-12-10;MT;Malta;106;4;10884;164
2020-12-11;MT;Malta;96;2;10980;166
2020-12-12;MT;Malta;121;0;11101;166
2020-12-13;MT;Malta;52;3;11153;169
2020-12-14;MT;Malta;101;5;11254;174
2020-12-15;MT;Malta;49;3;11303;177
2020-12-16;MT;Malta;112;3;11415;180
2020-12-17;MT;Malta;60;2;11475;182
2020-12-18;MT;Malta;94;1;11569;183
2020-12-19;MT;Malta;52;4;11621;187
2020-12-20;MT;Malta;93;3;11714;190
2020-12-21;MT;Malta;88;4;11802;194
2020-12-22;MT;Malta;108;2;11910;196
2020-12-23;MT;Malta;82;5;11992;201
2020-12-24;MT;Malta;70;2;12062;203
2020-12-25;MT;Malta;50;0;12112;203
2020-12-26;MT;Malta;129;3;12241;206
2020-12-27;MT;Malta;84;4;12325;210
2020-12-28;MT;Malta;101;5;12426;215
2020-12-29;MT;Malta;115;0;12541;215
2020-12-30;MT;Malta;124;1;12665;216
2020-12-31;MT;Malta;109;3;12774;219
2021-01-01;MT;Malta;135;0;12909;219
2021-01-02;MT;Malta;88;1;12997;220
2021-01-03;MT;Malta;85;0;13082;220
2021-01-04;MT;Malta;148;2;13230;222
2021-01-05;MT;Malta;158;4;13388;226
2021-01-06;MT;Malta;224;1;13612;227
2021-01-07;MT;Malta;164;1;13776;228
2021-01-08;MT;Malta;191;2;13967;230
2021-01-09;MT;Malta;245;2;14212;232
2021-01-10;MT;Malta;184;1;14396;233
2021-01-11;MT;Malta;133;0;14529;233
2021-01-12;MT;Malta;240;1;14769;234
2021-01-13;MT;Malta;189;0;14958;234
2021-01-14;MT;Malta;121;1;15079;235
2021-01-15;MT;Malta;193;1;15272;236
2021-01-16;MT;Malta;175;2;15447;238
2021-01-17;MT;Malta;141;1;15588;239
2021-01-18;MT;Malta;154;2;15742;241
2021-01-19;MT;Malta;200;1;15942;242
2021-01-20;MT;Malta;187;2;16129;244
2021-01-21;MT;Malta;151;1;16280;245
2021-01-22;MT;Malta;143;3;16423;248
2021-01-23;MT;Malta;119;2;16542;250
2021-01-24;MT;Malta;116;1;16658;251
2021-01-25;MT;Malta;203;2;16861;253
2021-01-26;MT;Malta;138;2;16999;255
2021-01-27;MT;Malta;193;3;17192;258
2021-01-28;MT;Malta;208;3;17400;261
2021-01-29;MT;Malta;185;3;17585;264
2021-01-30;MT;Malta;136;1;17721;265
2021-01-31;MT;Malta;182;2;17903;267
2021-02-01;MT;Malta;124;2;18027;269
2021-02-02;MT;Malta;141;1;18168;270
2021-02-03;MT;Malta;138;3;18306;273
2021-02-04;MT;Malta;79;0;18385;273
2021-02-05;MT;Malta;57;4;18442;277
2021-02-06;MT;Malta;134;2;18576;279
2021-02-07;MT;Malta;100;3;18676;282
2021-02-08;MT;Malta;137;0;18813;282
2021-02-09;MT;Malta;202;2;19015;284
2021-02-10;MT;Malta;167;2;19182;286
2021-02-11;MT;Malta;151;0;19333;286
2021-02-12;MT;Malta;164;2;19497;288
2021-02-13;MT;Malta;154;2;19651;290
2021-02-14;MT;Malta;138;3;19789;293
2021-02-15;MT;Malta;156;2;19945;295
2021-02-16;MT;Malta;102;2;20047;297
2021-02-17;MT;Malta;199;1;20246;298
2021-02-18;MT;Malta;163;3;20409;301
2021-02-19;MT;Malta;154;0;20563;301
2021-02-20;MT;Malta;199;2;20762;303
2021-02-21;MT;Malta;130;1;20892;304
2021-02-22;MT;Malta;193;1;21085;305
2021-02-23;MT;Malta;221;1;21306;306
2021-02-24;MT;Malta;226;2;21532;308
2021-02-25;MT;Malta;192;3;21724;311
2021-02-26;MT;Malta;258;2;21982;313
2021-02-27;MT;Malta;237;0;22219;313
2021-02-28;MT;Malta;263;2;22482;315
2021-03-01;MT;Malta;175;1;22657;316
2021-03-02;MT;Malta;336;3;22993;319
2021-03-03;MT;Malta;233;2;23226;321
2021-03-04;MT;Malta;362;4;23588;325
2021-03-05;MT;Malta;283;3;23871;328
2021-03-06;MT;Malta;345;1;24216;329
2021-03-07;MT;Malta;182;5;24398;334
2021-03-08;MT;Malta;201;0;24599;334
2021-03-09;MT;Malta;248;1;24847;335
2021-03-10;MT;Malta;510;2;25357;337
2021-03-11;MT;Malta;283;4;25640;341
2021-03-12;MT;Malta;329;5;25969;346
2021-03-13;MT;Malta;298;4;26267;350
2021-03-14;MT;Malta;268;1;26535;351
2021-03-15;MT;Malta;213;3;26748;354
2021-03-16;MT;Malta;313;3;27061;357
2021-03-17;MT;Malta;211;4;27272;361
2021-03-18;MT;Malta;243;2;27515;363
2021-03-19;MT;Malta;179;1;27694;364
2021-03-20;MT;Malta;210;5;27904;369
2021-03-21;MT;Malta;224;3;28128;372
2021-03-22;MT;Malta;191;1;28319;373
2021-03-23;MT;Malta;90;2;28409;375
2021-03-24;MT;Malta;101;2;28510;377
2021-03-25;MT;Malta;102;1;28612;378
2021-03-26;MT;Malta;103;4;28715;382
2021-03-27;MT;Malta;93;3;28808;385
2021-03-28;MT;Malta;67;2;28875;387
2021-03-29;MT;Malta;63;1;28938;388
2021-03-30;MT;Malta;55;2;28993;390
2021-03-31;MT;Malta;40;2;29033;392
2021-04-01;MT;Malta;52;2;29085;394
2021-04-02;MT;Malta;42;1;29127;395
2021-04-03;MT;Malta;62;2;29189;397
2021-04-04;MT;Malta;34;1;29223;398
2021-04-05;MT;Malta;56;1;29279;399
2021-04-06;MT;Malta;64;0;29343;399
2021-04-07;MT;Malta;65;1;29408;400
2021-04-08;MT;Malta;55;1;29463;401
2021-04-09;MT;Malta;48;0;29511;401
2021-04-10;MT;Malta;37;1;29548;402
2021-04-11;MT;Malta;66;0;29614;402
2021-04-12;MT;Malta;47;0;29661;402
2021-04-13;MT;Malta;59;1;29720;403
2021-04-14;MT;Malta;58;0;29778;403
2021-04-15;MT;Malta;55;0;29833;403
2021-04-16;MT;Malta;27;2;29860;405
2021-04-17;MT;Malta;67;4;29927;409
2021-04-18;MT;Malta;39;0;29966;409
2021-04-19;MT;Malta;60;0;30026;409
2021-04-20;MT;Malta;13;2;30039;411
2021-04-21;MT;Malta;24;0;30063;411
2021-04-22;MT;Malta;33;0;30096;411
2021-04-23;MT;Malta;33;1;30129;412
2021-04-24;MT;Malta;20;0;30149;412
2021-04-25;MT;Malta;25;1;30174;413
2021-04-26;MT;Malta;15;0;30189;413
2021-04-27;MT;Malta;45;0;30234;413
2021-04-28;MT;Malta;15;0;30249;413
2021-04-29;MT;Malta;27;0;30276;413
2021-04-30;MT;Malta;16;0;30292;413
2021-05-01;MT;Malta;15;2;30307;415
2021-05-02;MT;Malta;12;1;30319;416
2021-05-03;MT;Malta;35;0;30354;416
2021-05-04;MT;Malta;27;0;30381;416
2021-05-05;MT;Malta;30;0;30411;416
2021-05-06;MT;Malta;9;0;30420;416
2021-05-07;MT;Malta;12;1;30432;417
2021-05-08;MT;Malta;6;0;30438;417
2021-05-09;MT;Malta;9;0;30447;417
2021-05-10;MT;Malta;11;0;30458;417
2021-05-11;MT;Malta;6;0;30464;417
2021-05-12;MT;Malta;5;0;30469;417
2021-05-13;MT;Malta;4;0;30473;417
2021-05-14;MT;Malta;1;0;30474;417
2021-05-15;MT;Malta;4;0;30478;417
2021-05-16;MT;Malta;2;0;30480;417
2021-05-17;MT;Malta;4;0;30484;417
2021-05-18;MT;Malta;2;0;30486;417
2021-05-19;MT;Malta;3;0;30489;417
2021-05-20;MT;Malta;2;0;30491;417
2021-05-21;MT;Malta;6;0;30497;417
2021-05-22;MT;Malta;2;0;30499;417
2021-05-23;MT;Malta;5;0;30504;417
2021-05-24;MT;Malta;2;0;30506;417
2021-05-25;MT;Malta;3;1;30509;418
2021-05-26;MT;Malta;7;1;30516;419
2021-05-27;MT;Malta;4;0;30520;419
2021-05-28;MT;Malta;6;0;30526;419
2021-05-29;MT;Malta;3;0;30529;419
2021-05-30;MT;Malta;4;0;30533;419
2021-05-31;MT;Malta;2;0;30535;419
2021-06-01;MT;Malta;8;0;30543;419
2021-06-02;MT;Malta;10;0;30553;419
2021-06-03;MT;Malta;4;0;30557;419
2021-06-04;MT;Malta;2;0;30559;419
2021-06-05;MT;Malta;9;0;30568;419
2021-06-06;MT;Malta;3;0;30571;419
2021-06-07;MT;Malta;0;0;30571;419
2021-06-08;MT;Malta;1;0;30572;419
2021-06-09;MT;Malta;1;0;30573;419
2021-06-10;MT;Malta;4;0;30577;419
2021-06-11;MT;Malta;2;0;30579;419
2021-06-12;MT;Malta;2;0;30581;419
2021-06-13;MT;Malta;0;0;30581;419
2021-06-14;MT;Malta;1;0;30582;419
2021-06-15;MT;Malta;0;0;30582;419
2021-06-16;MT;Malta;3;0;30585;419
2021-06-17;MT;Malta;0;0;30585;419
2021-06-18;MT;Malta;3;1;30588;420
2021-06-19;MT;Malta;0;0;30588;420
2021-06-20;MT;Malta;1;0;30589;420
2021-06-21;MT;Malta;1;0;30590;420
2021-06-22;MT;Malta;5;0;30595;420
2021-06-23;MT;Malta;0;0;30595;420
2021-06-24;MT;Malta;3;0;30598;420
2021-06-25;MT;Malta;5;0;30603;420
2021-06-26;MT;Malta;3;0;30606;420
2021-06-27;MT;Malta;0;0;30606;420
2021-06-28;MT;Malta;6;0;30612;420
2021-06-29;MT;Malta;6;0;30618;420
2021-06-30;MT;Malta;5;0;30623;420
2021-07-01;MT;Malta;4;0;30627;420
2020-10-28;MH;Marshall Islands;2;0;2;0
2020-10-29;MH;Marshall Islands;0;0;2;0
2020-10-30;MH;Marshall Islands;0;0;2;0
2020-10-31;MH;Marshall Islands;0;0;2;0
2020-11-01;MH;Marshall Islands;0;0;2;0
2020-11-02;MH;Marshall Islands;0;0;2;0
2020-11-03;MH;Marshall Islands;0;0;2;0
2020-11-04;MH;Marshall Islands;0;0;2;0
2020-11-05;MH;Marshall Islands;-1;0;1;0
2020-11-06;MH;Marshall Islands;0;0;1;0
2020-11-07;MH;Marshall Islands;0;0;1;0
2020-11-08;MH;Marshall Islands;0;0;1;0
2020-11-09;MH;Marshall Islands;0;0;1;0
2020-11-10;MH;Marshall Islands;0;0;1;0
2020-11-11;MH;Marshall Islands;0;0;1;0
2020-11-12;MH;Marshall Islands;0;0;1;0
2020-11-13;MH;Marshall Islands;0;0;1;0
2020-11-14;MH;Marshall Islands;0;0;1;0
2020-11-15;MH;Marshall Islands;0;0;1;0
2020-11-16;MH;Marshall Islands;0;0;1;0
2020-11-17;MH;Marshall Islands;3;0;4;0
2020-11-18;MH;Marshall Islands;0;0;4;0
2020-11-19;MH;Marshall Islands;0;0;4;0
2020-11-20;MH;Marshall Islands;0;0;4;0
2020-11-21;MH;Marshall Islands;0;0;4;0
2020-11-22;MH;Marshall Islands;0;0;4;0
2020-11-23;MH;Marshall Islands;0;0;4;0
2020-11-24;MH;Marshall Islands;0;0;4;0
2020-11-25;MH;Marshall Islands;0;0;4;0
2020-11-26;MH;Marshall Islands;0;0;4;0
2020-11-27;MH;Marshall Islands;0;0;4;0
2020-11-28;MH;Marshall Islands;0;0;4;0
2020-11-29;MH;Marshall Islands;0;0;4;0
2020-11-30;MH;Marshall Islands;0;0;4;0
2020-12-01;MH;Marshall Islands;0;0;4;0
2020-12-02;MH;Marshall Islands;0;0;4;0
2020-12-03;MH;Marshall Islands;0;0;4;0
2020-12-04;MH;Marshall Islands;0;0;4;0
2020-12-05;MH;Marshall Islands;0;0;4;0
2020-12-06;MH;Marshall Islands;0;0;4;0
2020-12-07;MH;Marshall Islands;0;0;4;0
2020-12-08;MH;Marshall Islands;0;0;4;0
2020-12-09;MH;Marshall Islands;0;0;4;0
2020-12-10;MH;Marshall Islands;0;0;4;0
2020-12-11;MH;Marshall Islands;0;0;4;0
2020-12-12;MH;Marshall Islands;0;0;4;0
2020-12-13;MH;Marshall Islands;0;0;4;0
2020-12-14;MH;Marshall Islands;0;0;4;0
2020-12-15;MH;Marshall Islands;0;0;4;0
2020-12-16;MH;Marshall Islands;0;0;4;0
2020-12-17;MH;Marshall Islands;0;0;4;0
2020-12-18;MH;Marshall Islands;0;0;4;0
2020-12-19;MH;Marshall Islands;0;0;4;0
2020-12-20;MH;Marshall Islands;0;0;4;0
2020-12-21;MH;Marshall Islands;0;0;4;0
2020-12-22;MH;Marshall Islands;0;0;4;0
2020-12-23;MH;Marshall Islands;0;0;4;0
2020-12-24;MH;Marshall Islands;0;0;4;0
2020-12-25;MH;Marshall Islands;0;0;4;0
2020-12-26;MH;Marshall Islands;0;0;4;0
2020-12-27;MH;Marshall Islands;0;0;4;0
2020-12-28;MH;Marshall Islands;0;0;4;0
2020-12-29;MH;Marshall Islands;0;0;4;0
2020-12-30;MH;Marshall Islands;0;0;4;0
2020-12-31;MH;Marshall Islands;0;0;4;0
2021-01-01;MH;Marshall Islands;0;0;4;0
2021-01-02;MH;Marshall Islands;0;0;4;0
2021-01-03;MH;Marshall Islands;0;0;4;0
2021-01-04;MH;Marshall Islands;0;0;4;0
2021-01-05;MH;Marshall Islands;0;0;4;0
2021-01-06;MH;Marshall Islands;0;0;4;0
2021-01-07;MH;Marshall Islands;0;0;4;0
2021-01-08;MH;Marshall Islands;0;0;4;0
2021-01-09;MH;Marshall Islands;0;0;4;0
2021-01-10;MH;Marshall Islands;0;0;4;0
2021-01-11;MH;Marshall Islands;0;0;4;0
2021-01-12;MH;Marshall Islands;0;0;4;0
2021-01-13;MH;Marshall Islands;0;0;4;0
2021-01-14;MH;Marshall Islands;0;0;4;0
2021-01-15;MH;Marshall Islands;0;0;4;0
2021-01-16;MH;Marshall Islands;0;0;4;0
2021-01-17;MH;Marshall Islands;0;0;4;0
2021-01-18;MH;Marshall Islands;0;0;4;0
2021-01-19;MH;Marshall Islands;0;0;4;0
2021-01-20;MH;Marshall Islands;0;0;4;0
2021-01-21;MH;Marshall Islands;0;0;4;0
2021-01-22;MH;Marshall Islands;0;0;4;0
2021-01-23;MH;Marshall Islands;0;0;4;0
2021-01-24;MH;Marshall Islands;0;0;4;0
2021-01-25;MH;Marshall Islands;0;0;4;0
2021-01-26;MH;Marshall Islands;0;0;4;0
2021-01-27;MH;Marshall Islands;0;0;4;0
2021-01-28;MH;Marshall Islands;0;0;4;0
2021-01-29;MH;Marshall Islands;0;0;4;0
2021-01-30;MH;Marshall Islands;0;0;4;0
2021-01-31;MH;Marshall Islands;0;0;4;0
2021-02-01;MH;Marshall Islands;0;0;4;0
2021-02-02;MH;Marshall Islands;0;0;4;0
2021-02-03;MH;Marshall Islands;0;0;4;0
2021-02-04;MH;Marshall Islands;0;0;4;0
2021-02-05;MH;Marshall Islands;0;0;4;0
2021-02-06;MH;Marshall Islands;0;0;4;0
2021-02-07;MH;Marshall Islands;0;0;4;0
2021-02-08;MH;Marshall Islands;0;0;4;0
2021-02-09;MH;Marshall Islands;0;0;4;0
2021-02-10;MH;Marshall Islands;0;0;4;0
2021-02-11;MH;Marshall Islands;0;0;4;0
2021-02-12;MH;Marshall Islands;0;0;4;0
2021-02-13;MH;Marshall Islands;0;0;4;0
2021-02-14;MH;Marshall Islands;0;0;4;0
2021-02-15;MH;Marshall Islands;0;0;4;0
2021-02-16;MH;Marshall Islands;0;0;4;0
2021-02-17;MH;Marshall Islands;0;0;4;0
2021-02-18;MH;Marshall Islands;0;0;4;0
2021-02-19;MH;Marshall Islands;0;0;4;0
2021-02-20;MH;Marshall Islands;0;0;4;0
2021-02-21;MH;Marshall Islands;0;0;4;0
2021-02-22;MH;Marshall Islands;0;0;4;0
2021-02-23;MH;Marshall Islands;0;0;4;0
2021-02-24;MH;Marshall Islands;0;0;4;0
2021-02-25;MH;Marshall Islands;0;0;4;0
2021-02-26;MH;Marshall Islands;0;0;4;0
2021-02-27;MH;Marshall Islands;0;0;4;0
2021-02-28;MH;Marshall Islands;0;0;4;0
2021-03-01;MH;Marshall Islands;0;0;4;0
2021-03-02;MH;Marshall Islands;0;0;4;0
2021-03-03;MH;Marshall Islands;0;0;4;0
2021-03-04;MH;Marshall Islands;0;0;4;0
2021-03-05;MH;Marshall Islands;0;0;4;0
2021-03-06;MH;Marshall Islands;0;0;4;0
2021-03-07;MH;Marshall Islands;0;0;4;0
2021-03-08;MH;Marshall Islands;0;0;4;0
2021-03-09;MH;Marshall Islands;0;0;4;0
2021-03-10;MH;Marshall Islands;0;0;4;0
2021-03-11;MH;Marshall Islands;0;0;4;0
2021-03-12;MH;Marshall Islands;0;0;4;0
2021-03-13;MH;Marshall Islands;0;0;4;0
2021-03-14;MH;Marshall Islands;0;0;4;0
2021-03-15;MH;Marshall Islands;0;0;4;0
2021-03-16;MH;Marshall Islands;0;0;4;0
2021-03-17;MH;Marshall Islands;0;0;4;0
2021-03-18;MH;Marshall Islands;0;0;4;0
2021-03-19;MH;Marshall Islands;0;0;4;0
2021-03-20;MH;Marshall Islands;0;0;4;0
2021-03-21;MH;Marshall Islands;0;0;4;0
2021-03-22;MH;Marshall Islands;0;0;4;0
2021-03-23;MH;Marshall Islands;0;0;4;0
2021-03-24;MH;Marshall Islands;0;0;4;0
2021-03-25;MH;Marshall Islands;0;0;4;0
2021-03-26;MH;Marshall Islands;0;0;4;0
2021-03-27;MH;Marshall Islands;0;0;4;0
2021-03-28;MH;Marshall Islands;0;0;4;0
2021-03-29;MH;Marshall Islands;0;0;4;0
2021-03-30;MH;Marshall Islands;0;0;4;0
2021-03-31;MH;Marshall Islands;0;0;4;0
2021-04-01;MH;Marshall Islands;0;0;4;0
2021-04-02;MH;Marshall Islands;0;0;4;0
2021-04-03;MH;Marshall Islands;0;0;4;0
2021-04-04;MH;Marshall Islands;0;0;4;0
2021-04-05;MH;Marshall Islands;0;0;4;0
2021-04-06;MH;Marshall Islands;0;0;4;0
2021-04-07;MH;Marshall Islands;0;0;4;0
2021-04-08;MH;Marshall Islands;0;0;4;0
2021-04-09;MH;Marshall Islands;0;0;4;0
2021-04-10;MH;Marshall Islands;0;0;4;0
2021-04-11;MH;Marshall Islands;0;0;4;0
2021-04-12;MH;Marshall Islands;0;0;4;0
2021-04-13;MH;Marshall Islands;0;0;4;0
2021-04-14;MH;Marshall Islands;0;0;4;0
2021-04-15;MH;Marshall Islands;0;0;4;0
2021-04-16;MH;Marshall Islands;0;0;4;0
2021-04-17;MH;Marshall Islands;0;0;4;0
2021-04-18;MH;Marshall Islands;0;0;4;0
2021-04-19;MH;Marshall Islands;0;0;4;0
2021-04-20;MH;Marshall Islands;0;0;4;0
2021-04-21;MH;Marshall Islands;0;0;4;0
2021-04-22;MH;Marshall Islands;0;0;4;0
2021-04-23;MH;Marshall Islands;0;0;4;0
2021-04-24;MH;Marshall Islands;0;0;4;0
2021-04-25;MH;Marshall Islands;0;0;4;0
2021-04-26;MH;Marshall Islands;0;0;4;0
2021-04-27;MH;Marshall Islands;0;0;4;0
2021-04-28;MH;Marshall Islands;0;0;4;0
2021-04-29;MH;Marshall Islands;0;0;4;0
2021-04-30;MH;Marshall Islands;0;0;4;0
2021-05-01;MH;Marshall Islands;0;0;4;0
2021-05-02;MH;Marshall Islands;0;0;4;0
2021-05-03;MH;Marshall Islands;0;0;4;0
2021-05-04;MH;Marshall Islands;0;0;4;0
2021-05-05;MH;Marshall Islands;0;0;4;0
2021-05-06;MH;Marshall Islands;0;0;4;0
2021-05-07;MH;Marshall Islands;0;0;4;0
2021-05-08;MH;Marshall Islands;0;0;4;0
2021-05-09;MH;Marshall Islands;0;0;4;0
2021-05-10;MH;Marshall Islands;0;0;4;0
2021-05-11;MH;Marshall Islands;0;0;4;0
2021-05-12;MH;Marshall Islands;0;0;4;0
2021-05-13;MH;Marshall Islands;0;0;4;0
2021-05-14;MH;Marshall Islands;0;0;4;0
2021-05-15;MH;Marshall Islands;0;0;4;0
2021-05-16;MH;Marshall Islands;0;0;4;0
2021-05-17;MH;Marshall Islands;0;0;4;0
2021-05-18;MH;Marshall Islands;0;0;4;0
2021-05-19;MH;Marshall Islands;0;0;4;0
2021-05-20;MH;Marshall Islands;0;0;4;0
2021-05-21;MH;Marshall Islands;0;0;4;0
2021-05-22;MH;Marshall Islands;0;0;4;0
2021-05-23;MH;Marshall Islands;0;0;4;0
2021-05-24;MH;Marshall Islands;0;0;4;0
2021-05-25;MH;Marshall Islands;0;0;4;0
2021-05-26;MH;Marshall Islands;0;0;4;0
2021-05-27;MH;Marshall Islands;0;0;4;0
2021-05-28;MH;Marshall Islands;0;0;4;0
2021-05-29;MH;Marshall Islands;0;0;4;0
2021-05-30;MH;Marshall Islands;0;0;4;0
2021-05-31;MH;Marshall Islands;0;0;4;0
2021-06-01;MH;Marshall Islands;0;0;4;0
2021-06-02;MH;Marshall Islands;0;0;4;0
2021-06-03;MH;Marshall Islands;0;0;4;0
2021-06-04;MH;Marshall Islands;0;0;4;0
2021-06-05;MH;Marshall Islands;0;0;4;0
2021-06-06;MH;Marshall Islands;0;0;4;0
2021-06-07;MH;Marshall Islands;0;0;4;0
2021-06-08;MH;Marshall Islands;0;0;4;0
2021-06-09;MH;Marshall Islands;0;0;4;0
2021-06-10;MH;Marshall Islands;0;0;4;0
2021-06-11;MH;Marshall Islands;0;0;4;0
2021-06-12;MH;Marshall Islands;0;0;4;0
2021-06-13;MH;Marshall Islands;0;0;4;0
2021-06-14;MH;Marshall Islands;0;0;4;0
2021-06-15;MH;Marshall Islands;0;0;4;0
2021-06-16;MH;Marshall Islands;0;0;4;0
2021-06-17;MH;Marshall Islands;0;0;4;0
2021-06-18;MH;Marshall Islands;0;0;4;0
2021-06-19;MH;Marshall Islands;0;0;4;0
2021-06-20;MH;Marshall Islands;0;0;4;0
2021-06-21;MH;Marshall Islands;0;0;4;0
2021-06-22;MH;Marshall Islands;0;0;4;0
2021-06-23;MH;Marshall Islands;0;0;4;0
2021-06-24;MH;Marshall Islands;0;0;4;0
2021-06-25;MH;Marshall Islands;0;0;4;0
2021-06-26;MH;Marshall Islands;0;0;4;0
2021-06-27;MH;Marshall Islands;0;0;4;0
2021-06-28;MH;Marshall Islands;0;0;4;0
2021-06-29;MH;Marshall Islands;0;0;4;0
2021-06-30;MH;Marshall Islands;0;0;4;0
2021-07-01;MH;Marshall Islands;0;0;4;0
2020-03-14;MR;Mauritania;1;0;1;0
2020-03-15;MR;Mauritania;0;0;1;0
2020-03-16;MR;Mauritania;0;0;1;0
2020-03-17;MR;Mauritania;0;0;1;0
2020-03-18;MR;Mauritania;0;0;1;0
2020-03-19;MR;Mauritania;1;0;2;0
2020-03-20;MR;Mauritania;0;0;2;0
2020-03-21;MR;Mauritania;0;0;2;0
2020-03-22;MR;Mauritania;0;0;2;0
2020-03-23;MR;Mauritania;0;0;2;0
2020-03-24;MR;Mauritania;0;0;2;0
2020-03-25;MR;Mauritania;0;0;2;0
2020-03-26;MR;Mauritania;1;0;3;0
2020-03-27;MR;Mauritania;0;0;3;0
2020-03-28;MR;Mauritania;2;0;5;0
2020-03-29;MR;Mauritania;0;0;5;0
2020-03-30;MR;Mauritania;0;1;5;1
2020-03-31;MR;Mauritania;1;0;6;1
2020-04-01;MR;Mauritania;0;0;6;1
2020-04-02;MR;Mauritania;0;0;6;1
2020-04-03;MR;Mauritania;0;0;6;1
2020-04-04;MR;Mauritania;0;0;6;1
2020-04-05;MR;Mauritania;0;0;6;1
2020-04-06;MR;Mauritania;0;0;6;1
2020-04-07;MR;Mauritania;0;0;6;1
2020-04-08;MR;Mauritania;0;0;6;1
2020-04-09;MR;Mauritania;1;0;7;1
2020-04-10;MR;Mauritania;0;0;7;1
2020-04-11;MR;Mauritania;0;0;7;1
2020-04-12;MR;Mauritania;0;0;7;1
2020-04-13;MR;Mauritania;0;0;7;1
2020-04-14;MR;Mauritania;0;0;7;1
2020-04-15;MR;Mauritania;0;0;7;1
2020-04-16;MR;Mauritania;0;0;7;1
2020-04-17;MR;Mauritania;0;0;7;1
2020-04-18;MR;Mauritania;0;0;7;1
2020-04-19;MR;Mauritania;0;0;7;1
2020-04-20;MR;Mauritania;0;0;7;1
2020-04-21;MR;Mauritania;0;0;7;1
2020-04-22;MR;Mauritania;0;0;7;1
2020-04-23;MR;Mauritania;0;0;7;1
2020-04-24;MR;Mauritania;0;0;7;1
2020-04-25;MR;Mauritania;0;0;7;1
2020-04-26;MR;Mauritania;0;0;7;1
2020-04-27;MR;Mauritania;0;0;7;1
2020-04-28;MR;Mauritania;0;0;7;1
2020-04-29;MR;Mauritania;1;0;8;1
2020-04-30;MR;Mauritania;0;0;8;1
2020-05-01;MR;Mauritania;0;0;8;1
2020-05-02;MR;Mauritania;0;0;8;1
2020-05-03;MR;Mauritania;0;0;8;1
2020-05-04;MR;Mauritania;0;0;8;1
2020-05-05;MR;Mauritania;0;0;8;1
2020-05-06;MR;Mauritania;0;0;8;1
2020-05-07;MR;Mauritania;0;0;8;1
2020-05-08;MR;Mauritania;0;0;8;1
2020-05-09;MR;Mauritania;0;0;8;1
2020-05-10;MR;Mauritania;0;0;8;1
2020-05-11;MR;Mauritania;0;0;8;1
2020-05-12;MR;Mauritania;1;0;9;1
2020-05-13;MR;Mauritania;6;1;15;2
2020-05-14;MR;Mauritania;5;0;20;2
2020-05-15;MR;Mauritania;9;1;29;3
2020-05-16;MR;Mauritania;11;1;40;4
2020-05-17;MR;Mauritania;22;0;62;4
2020-05-18;MR;Mauritania;19;0;81;4
2020-05-19;MR;Mauritania;50;0;131;4
2020-05-20;MR;Mauritania;10;0;141;4
2020-05-21;MR;Mauritania;32;1;173;5
2020-05-22;MR;Mauritania;27;1;200;6
2020-05-23;MR;Mauritania;27;0;227;6
2020-05-24;MR;Mauritania;10;0;237;6
2020-05-25;MR;Mauritania;25;3;262;9
2020-05-26;MR;Mauritania;6;4;268;13
2020-05-27;MR;Mauritania;24;3;292;16
2020-05-28;MR;Mauritania;54;3;346;19
2020-05-29;MR;Mauritania;77;1;423;20
2020-05-30;MR;Mauritania;60;0;483;20
2020-05-31;MR;Mauritania;47;3;530;23
2020-06-01;MR;Mauritania;58;0;588;23
2020-06-02;MR;Mauritania;80;8;668;31
2020-06-03;MR;Mauritania;77;3;745;34
2020-06-04;MR;Mauritania;39;5;784;39
2020-06-05;MR;Mauritania;99;4;883;43
2020-06-06;MR;Mauritania;64;6;947;49
2020-06-07;MR;Mauritania;102;6;1049;55
2020-06-08;MR;Mauritania;55;4;1104;59
2020-06-09;MR;Mauritania;58;2;1162;61
2020-06-10;MR;Mauritania;121;10;1283;71
2020-06-11;MR;Mauritania;156;3;1439;74
2020-06-12;MR;Mauritania;133;7;1572;81
2020-06-13;MR;Mauritania;110;2;1682;83
2020-06-14;MR;Mauritania;101;4;1783;87
2020-06-15;MR;Mauritania;104;4;1887;91
2020-06-16;MR;Mauritania;170;2;2057;93
2020-06-17;MR;Mauritania;166;2;2223;95
2020-06-18;MR;Mauritania;201;2;2424;97
2020-06-19;MR;Mauritania;197;5;2621;102
2020-06-20;MR;Mauritania;192;6;2813;108
2020-06-21;MR;Mauritania;171;3;2984;111
2020-06-22;MR;Mauritania;137;1;3121;112
2020-06-23;MR;Mauritania;171;2;3292;114
2020-06-24;MR;Mauritania;227;2;3519;116
2020-06-25;MR;Mauritania;220;3;3739;119
2020-06-26;MR;Mauritania;168;1;3907;120
2020-06-27;MR;Mauritania;118;1;4025;121
2020-06-28;MR;Mauritania;124;5;4149;126
2020-06-29;MR;Mauritania;88;2;4237;128
2020-06-30;MR;Mauritania;126;1;4363;129
2020-07-01;MR;Mauritania;109;0;4472;129
2020-07-02;MR;Mauritania;134;0;4606;129
2020-07-03;MR;Mauritania;99;0;4705;129
2020-07-04;MR;Mauritania;122;0;4827;129
2020-07-05;MR;Mauritania;52;1;4879;130
2020-07-06;MR;Mauritania;69;3;4948;133
2020-07-07;MR;Mauritania;76;2;5024;135
2020-07-08;MR;Mauritania;63;4;5087;139
2020-07-09;MR;Mauritania;39;5;5126;144
2020-07-10;MR;Mauritania;77;2;5203;146
2020-07-11;MR;Mauritania;72;1;5275;147
2020-07-12;MR;Mauritania;80;0;5355;147
2020-07-13;MR;Mauritania;91;0;5446;147
2020-07-14;MR;Mauritania;72;0;5518;147
2020-07-15;MR;Mauritania;46;2;5564;149
2020-07-16;MR;Mauritania;95;1;5659;150
2020-07-17;MR;Mauritania;51;1;5710;151
2020-07-18;MR;Mauritania;103;2;5813;153
2020-07-19;MR;Mauritania;60;2;5873;155
2020-07-20;MR;Mauritania;50;0;5923;155
2020-07-21;MR;Mauritania;62;0;5985;155
2020-07-22;MR;Mauritania;42;0;6027;155
2020-07-23;MR;Mauritania;40;1;6067;156
2020-07-24;MR;Mauritania;49;0;6116;156
2020-07-25;MR;Mauritania;35;0;6151;156
2020-07-26;MR;Mauritania;20;0;6171;156
2020-07-27;MR;Mauritania;37;0;6208;156
2020-07-28;MR;Mauritania;41;0;6249;156
2020-07-29;MR;Mauritania;24;0;6273;156
2020-07-30;MR;Mauritania;22;1;6295;157
2020-07-31;MR;Mauritania;15;0;6310;157
2020-08-01;MR;Mauritania;9;0;6319;157
2020-08-02;MR;Mauritania;4;0;6323;157
2020-08-03;MR;Mauritania;59;0;6382;157
2020-08-04;MR;Mauritania;36;0;6418;157
2020-08-05;MR;Mauritania;26;0;6444;157
2020-08-06;MR;Mauritania;0;0;6444;157
2020-08-07;MR;Mauritania;54;0;6498;157
2020-08-08;MR;Mauritania;12;0;6510;157
2020-08-09;MR;Mauritania;13;0;6523;157
2020-08-10;MR;Mauritania;32;0;6555;157
2020-08-11;MR;Mauritania;43;0;6598;157
2020-08-12;MR;Mauritania;24;0;6622;157
2020-08-13;MR;Mauritania;31;0;6653;157
2020-08-14;MR;Mauritania;23;0;6676;157
2020-08-15;MR;Mauritania;17;0;6693;157
2020-08-16;MR;Mauritania;8;0;6701;157
2020-08-17;MR;Mauritania;61;0;6762;157
2020-08-18;MR;Mauritania;27;0;6789;157
2020-08-19;MR;Mauritania;40;1;6829;158
2020-08-20;MR;Mauritania;19;0;6848;158
2020-08-21;MR;Mauritania;37;0;6885;158
2020-08-22;MR;Mauritania;9;0;6894;158
2020-08-23;MR;Mauritania;11;0;6905;158
2020-08-24;MR;Mauritania;23;0;6928;158
2020-08-25;MR;Mauritania;32;0;6960;158
2020-08-26;MR;Mauritania;17;0;6977;158
2020-08-27;MR;Mauritania;16;0;6993;158
2020-08-28;MR;Mauritania;19;0;7012;158
2020-08-29;MR;Mauritania;0;0;7012;158
2020-08-30;MR;Mauritania;4;1;7016;159
2020-08-31;MR;Mauritania;32;0;7048;159
2020-09-01;MR;Mauritania;27;0;7075;159
2020-09-02;MR;Mauritania;14;1;7089;160
2020-09-03;MR;Mauritania;17;0;7106;160
2020-09-04;MR;Mauritania;20;0;7126;160
2020-09-05;MR;Mauritania;8;0;7134;160
2020-09-06;MR;Mauritania;8;0;7142;160
2020-09-07;MR;Mauritania;23;0;7165;160
2020-09-08;MR;Mauritania;0;0;7165;160
2020-09-09;MR;Mauritania;26;1;7191;161
2020-09-10;MR;Mauritania;31;0;7222;161
2020-09-11;MR;Mauritania;44;0;7266;161
2020-09-12;MR;Mauritania;8;0;7274;161
2020-09-13;MR;Mauritania;2;0;7276;161
2020-09-14;MR;Mauritania;19;0;7295;161
2020-09-15;MR;Mauritania;24;0;7319;161
2020-09-16;MR;Mauritania;13;0;7332;161
2020-09-17;MR;Mauritania;14;0;7346;161
2020-09-18;MR;Mauritania;15;0;7361;161
2020-09-19;MR;Mauritania;4;0;7365;161
2020-09-20;MR;Mauritania;3;0;7368;161
2020-09-21;MR;Mauritania;16;0;7384;161
2020-09-22;MR;Mauritania;19;0;7403;161
2020-09-23;MR;Mauritania;22;0;7425;161
2020-09-24;MR;Mauritania;8;0;7433;161
2020-09-25;MR;Mauritania;24;0;7457;161
2020-09-26;MR;Mauritania;5;0;7462;161
2020-09-27;MR;Mauritania;2;0;7464;161
2020-09-28;MR;Mauritania;10;0;7474;161
2020-09-29;MR;Mauritania;14;0;7488;161
2020-09-30;MR;Mauritania;14;0;7502;161
2020-10-01;MR;Mauritania;3;0;7505;161
2020-10-02;MR;Mauritania;6;1;7511;162
2020-10-03;MR;Mauritania;6;0;7517;162
2020-10-04;MR;Mauritania;3;0;7520;162
2020-10-05;MR;Mauritania;3;0;7523;162
2020-10-06;MR;Mauritania;6;0;7529;162
2020-10-07;MR;Mauritania;6;0;7535;162
2020-10-08;MR;Mauritania;5;0;7540;162
2020-10-09;MR;Mauritania;8;1;7548;163
2020-10-10;MR;Mauritania;2;0;7550;163
2020-10-11;MR;Mauritania;0;0;7550;163
2020-10-12;MR;Mauritania;4;0;7554;163
2020-10-13;MR;Mauritania;11;0;7565;163
2020-10-14;MR;Mauritania;7;0;7572;163
2020-10-15;MR;Mauritania;13;0;7585;163
2020-10-16;MR;Mauritania;18;0;7603;163
2020-10-17;MR;Mauritania;4;0;7607;163
2020-10-18;MR;Mauritania;1;0;7608;163
2020-10-19;MR;Mauritania;13;0;7621;163
2020-10-20;MR;Mauritania;13;0;7634;163
2020-10-21;MR;Mauritania;4;0;7638;163
2020-10-22;MR;Mauritania;12;0;7650;163
2020-10-23;MR;Mauritania;12;0;7662;163
2020-10-24;MR;Mauritania;1;0;7663;163
2020-10-25;MR;Mauritania;1;0;7664;163
2020-10-26;MR;Mauritania;13;0;7677;163
2020-10-27;MR;Mauritania;3;0;7680;163
2020-10-28;MR;Mauritania;8;0;7688;163
2020-10-29;MR;Mauritania;12;0;7700;163
2020-10-30;MR;Mauritania;0;0;7700;163
2020-10-31;MR;Mauritania;3;0;7703;163
2020-11-01;MR;Mauritania;1;0;7704;163
2020-11-02;MR;Mauritania;0;0;7704;163
2020-11-03;MR;Mauritania;20;1;7724;164
2020-11-04;MR;Mauritania;20;0;7744;164
2020-11-05;MR;Mauritania;33;1;7777;165
2020-11-06;MR;Mauritania;27;0;7804;165
2020-11-07;MR;Mauritania;10;0;7814;165
2020-11-08;MR;Mauritania;6;0;7820;165
2020-11-09;MR;Mauritania;13;0;7833;165
2020-11-10;MR;Mauritania;15;0;7848;165
2020-11-11;MR;Mauritania;37;0;7885;165
2020-11-12;MR;Mauritania;15;0;7900;165
2020-11-13;MR;Mauritania;32;0;7932;165
2020-11-14;MR;Mauritania;16;0;7948;165
2020-11-15;MR;Mauritania;4;0;7952;165
2020-11-16;MR;Mauritania;27;0;7979;165
2020-11-17;MR;Mauritania;15;0;7994;165
2020-11-18;MR;Mauritania;16;2;8010;167
2020-11-19;MR;Mauritania;24;1;8034;168
2020-11-20;MR;Mauritania;41;1;8075;169
2020-11-21;MR;Mauritania;21;0;8096;169
2020-11-22;MR;Mauritania;32;0;8128;169
2020-11-23;MR;Mauritania;39;0;8167;169
2020-11-24;MR;Mauritania;26;0;8193;169
2020-11-25;MR;Mauritania;53;2;8246;171
2020-11-26;MR;Mauritania;42;0;8288;171
2020-11-27;MR;Mauritania;136;1;8424;172
2020-11-28;MR;Mauritania;34;0;8458;172
2020-11-29;MR;Mauritania;89;3;8547;175
2020-11-30;MR;Mauritania;54;2;8601;177
2020-12-01;MR;Mauritania;109;0;8710;177
2020-12-02;MR;Mauritania;153;2;8863;179
2020-12-03;MR;Mauritania;142;2;9005;181
2020-12-04;MR;Mauritania;176;1;9181;182
2020-12-05;MR;Mauritania;178;2;9359;184
2020-12-06;MR;Mauritania;157;4;9516;188
2020-12-07;MR;Mauritania;163;6;9679;194
2020-12-08;MR;Mauritania;197;3;9876;197
2020-12-09;MR;Mauritania;229;5;10105;202
2020-12-10;MR;Mauritania;163;8;10268;210
2020-12-11;MR;Mauritania;233;0;10501;210
2020-12-12;MR;Mauritania;279;12;10780;222
2020-12-13;MR;Mauritania;191;3;10971;225
2020-12-14;MR;Mauritania;164;3;11135;228
2020-12-15;MR;Mauritania;296;8;11431;236
2020-12-16;MR;Mauritania;198;8;11629;244
2020-12-17;MR;Mauritania;176;10;11805;254
2020-12-18;MR;Mauritania;241;10;12046;264
2020-12-19;MR;Mauritania;232;9;12278;273
2020-12-20;MR;Mauritania;140;8;12418;281
2020-12-21;MR;Mauritania;149;5;12567;286
2020-12-22;MR;Mauritania;178;4;12745;290
2020-12-23;MR;Mauritania;199;7;12944;297
2020-12-24;MR;Mauritania;174;4;13118;301
2020-12-25;MR;Mauritania;146;13;13264;314
2020-12-26;MR;Mauritania;252;7;13516;321
2020-12-27;MR;Mauritania;126;3;13642;324
2020-12-28;MR;Mauritania;136;6;13778;330
2020-12-29;MR;Mauritania;211;4;13989;334
2020-12-30;MR;Mauritania;202;5;14191;339
2020-12-31;MR;Mauritania;173;8;14364;347
2021-01-01;MR;Mauritania;217;2;14581;349
2021-01-02;MR;Mauritania;96;4;14677;353
2021-01-03;MR;Mauritania;117;5;14794;358
2021-01-04;MR;Mauritania;81;2;14875;360
2021-01-05;MR;Mauritania;106;7;14981;367
2021-01-06;MR;Mauritania;130;6;15111;373
2021-01-07;MR;Mauritania;103;5;15214;378
2021-01-08;MR;Mauritania;138;4;15352;382
2021-01-09;MR;Mauritania;77;1;15429;383
2021-01-10;MR;Mauritania;83;1;15512;384
2021-01-11;MR;Mauritania;99;3;15611;387
2021-01-12;MR;Mauritania;96;5;15707;392
2021-01-13;MR;Mauritania;87;3;15794;395
2021-01-14;MR;Mauritania;99;1;15893;396
2021-01-15;MR;Mauritania;70;4;15963;400
2021-01-16;MR;Mauritania;36;1;15999;401
2021-01-17;MR;Mauritania;40;1;16039;402
2021-01-18;MR;Mauritania;42;1;16081;403
2021-01-19;MR;Mauritania;66;2;16147;405
2021-01-20;MR;Mauritania;65;2;16212;407
2021-01-21;MR;Mauritania;54;3;16266;410
2021-01-22;MR;Mauritania;56;3;16322;413
2021-01-23;MR;Mauritania;35;3;16357;416
2021-01-24;MR;Mauritania;40;0;16397;416
2021-01-25;MR;Mauritania;24;1;16421;417
2021-01-26;MR;Mauritania;39;1;16460;418
2021-01-27;MR;Mauritania;46;1;16506;419
2021-01-28;MR;Mauritania;37;2;16543;421
2021-01-29;MR;Mauritania;33;0;16576;421
2021-01-30;MR;Mauritania;32;1;16608;422
2021-01-31;MR;Mauritania;27;0;16635;422
2021-02-01;MR;Mauritania;27;0;16662;422
2021-02-02;MR;Mauritania;27;1;16689;423
2021-02-03;MR;Mauritania;31;1;16720;424
2021-02-04;MR;Mauritania;20;1;16740;425
2021-02-05;MR;Mauritania;37;0;16777;425
2021-02-06;MR;Mauritania;15;0;16792;425
2021-02-07;MR;Mauritania;15;1;16807;426
2021-02-08;MR;Mauritania;20;1;16827;427
2021-02-09;MR;Mauritania;41;0;16868;427
2021-02-10;MR;Mauritania;34;0;16902;427
2021-02-11;MR;Mauritania;23;0;16925;427
2021-02-12;MR;Mauritania;29;0;16954;427
2021-02-13;MR;Mauritania;11;1;16965;428
2021-02-14;MR;Mauritania;9;2;16974;430
2021-02-15;MR;Mauritania;22;0;16996;430
2021-02-16;MR;Mauritania;20;1;17016;431
2021-02-17;MR;Mauritania;25;1;17041;432
2021-02-18;MR;Mauritania;17;1;17058;433
2021-02-19;MR;Mauritania;13;0;17071;433
2021-02-20;MR;Mauritania;12;1;17083;434
2021-02-21;MR;Mauritania;12;0;17095;434
2021-02-22;MR;Mauritania;15;1;17110;435
2021-02-23;MR;Mauritania;20;2;17130;437
2021-02-24;MR;Mauritania;28;2;17158;439
2021-02-25;MR;Mauritania;21;0;17179;439
2021-02-26;MR;Mauritania;8;0;17187;439
2021-02-27;MR;Mauritania;9;1;17196;440
2021-02-28;MR;Mauritania;11;1;17207;441
2021-03-01;MR;Mauritania;10;0;17217;441
2021-03-02;MR;Mauritania;18;0;17235;441
2021-03-03;MR;Mauritania;17;1;17252;442
2021-03-04;MR;Mauritania;15;0;17267;442
2021-03-05;MR;Mauritania;18;0;17285;442
2021-03-06;MR;Mauritania;24;0;17309;442
2021-03-07;MR;Mauritania;13;0;17322;442
2021-03-08;MR;Mauritania;18;0;17340;442
2021-03-09;MR;Mauritania;25;0;17365;442
2021-03-10;MR;Mauritania;20;0;17385;442
2021-03-11;MR;Mauritania;9;0;17394;442
2021-03-12;MR;Mauritania;16;0;17410;442
2021-03-13;MR;Mauritania;14;1;17424;443
2021-03-14;MR;Mauritania;14;1;17438;444
2021-03-15;MR;Mauritania;19;0;17457;444
2021-03-16;MR;Mauritania;30;0;17487;444
2021-03-17;MR;Mauritania;34;1;17521;445
2021-03-18;MR;Mauritania;21;0;17542;445
2021-03-19;MR;Mauritania;28;1;17570;446
2021-03-20;MR;Mauritania;17;0;17587;446
2021-03-21;MR;Mauritania;14;0;17601;446
2021-03-22;MR;Mauritania;29;1;17630;447
2021-03-23;MR;Mauritania;28;0;17658;447
2021-03-24;MR;Mauritania;32;0;17690;447
2021-03-25;MR;Mauritania;22;0;17712;447
2021-03-26;MR;Mauritania;33;1;17745;448
2021-03-27;MR;Mauritania;11;0;17756;448
2021-03-28;MR;Mauritania;15;0;17771;448
2021-03-29;MR;Mauritania;25;1;17796;449
2021-03-30;MR;Mauritania;28;0;17824;449
2021-03-31;MR;Mauritania;23;0;17847;449
2021-04-01;MR;Mauritania;31;0;17878;449
2021-04-02;MR;Mauritania;26;0;17904;449
2021-04-03;MR;Mauritania;13;0;17917;449
2021-04-04;MR;Mauritania;10;0;17927;449
2021-04-05;MR;Mauritania;12;0;17939;449
2021-04-06;MR;Mauritania;16;1;17955;450
2021-04-07;MR;Mauritania;19;0;17974;450
2021-04-08;MR;Mauritania;21;0;17995;450
2021-04-09;MR;Mauritania;10;0;18005;450
2021-04-10;MR;Mauritania;7;0;18012;450
2021-04-11;MR;Mauritania;10;0;18022;450
2021-04-12;MR;Mauritania;13;0;18035;450
2021-04-13;MR;Mauritania;17;1;18052;451
2021-04-14;MR;Mauritania;14;1;18066;452
2021-04-15;MR;Mauritania;6;0;18072;452
2021-04-16;MR;Mauritania;31;0;18103;452
2021-04-17;MR;Mauritania;18;0;18121;452
2021-04-18;MR;Mauritania;8;1;18129;453
2021-04-19;MR;Mauritania;13;1;18142;454
2021-04-20;MR;Mauritania;14;0;18156;454
2021-04-21;MR;Mauritania;19;0;18175;454
2021-04-22;MR;Mauritania;17;0;18192;454
2021-04-23;MR;Mauritania;15;0;18207;454
2021-04-24;MR;Mauritania;33;0;18240;454
2021-04-25;MR;Mauritania;17;0;18257;454
2021-04-26;MR;Mauritania;25;1;18282;455
2021-04-27;MR;Mauritania;32;0;18314;455
2021-04-28;MR;Mauritania;32;0;18346;455
2021-04-29;MR;Mauritania;31;0;18377;455
2021-04-30;MR;Mauritania;25;0;18402;455
2021-05-01;MR;Mauritania;27;0;18429;455
2021-05-02;MR;Mauritania;19;0;18448;455
2021-05-03;MR;Mauritania;28;0;18476;455
2021-05-04;MR;Mauritania;27;0;18503;455
2021-05-05;MR;Mauritania;39;1;18542;456
2021-05-06;MR;Mauritania;34;0;18576;456
2021-05-07;MR;Mauritania;37;0;18613;456
2021-05-08;MR;Mauritania;23;0;18636;456
2021-05-09;MR;Mauritania;31;0;18667;456
2021-05-10;MR;Mauritania;24;0;18691;456
2021-05-11;MR;Mauritania;0;0;18691;456
2021-05-12;MR;Mauritania;54;1;18745;457
2021-05-13;MR;Mauritania;22;0;18767;457
2021-05-14;MR;Mauritania;14;0;18781;457
2021-05-15;MR;Mauritania;25;0;18806;457
2021-05-16;MR;Mauritania;22;0;18828;457
2021-05-17;MR;Mauritania;30;0;18858;457
2021-05-18;MR;Mauritania;47;0;18905;457
2021-05-19;MR;Mauritania;52;0;18957;457
2021-05-20;MR;Mauritania;54;0;19011;457
2021-05-21;MR;Mauritania;38;1;19049;458
2021-05-22;MR;Mauritania;65;0;19114;458
2021-05-23;MR;Mauritania;35;0;19149;458
2021-05-24;MR;Mauritania;46;2;19195;460
2021-05-25;MR;Mauritania;56;0;19251;460
2021-05-26;MR;Mauritania;36;1;19287;461
2021-05-27;MR;Mauritania;57;1;19344;462
2021-05-28;MR;Mauritania;63;0;19407;462
2021-05-29;MR;Mauritania;56;1;19463;463
2021-05-30;MR;Mauritania;31;0;19494;463
2021-05-31;MR;Mauritania;53;0;19547;463
2021-06-01;MR;Mauritania;51;0;19598;463
2021-06-02;MR;Mauritania;52;1;19650;464
2021-06-03;MR;Mauritania;45;0;19695;464
2021-06-04;MR;Mauritania;57;2;19752;466
2021-06-05;MR;Mauritania;33;0;19785;466
2021-06-06;MR;Mauritania;32;2;19817;468
2021-06-07;MR;Mauritania;36;2;19853;470
2021-06-08;MR;Mauritania;42;0;19895;470
2021-06-09;MR;Mauritania;28;0;19923;470
2021-06-10;MR;Mauritania;36;2;19959;472
2021-06-11;MR;Mauritania;46;1;20005;473
2021-06-12;MR;Mauritania;35;2;20040;475
2021-06-13;MR;Mauritania;33;0;20073;475
2021-06-14;MR;Mauritania;36;1;20109;476
2021-06-15;MR;Mauritania;42;1;20151;477
2021-06-16;MR;Mauritania;48;2;20199;479
2021-06-17;MR;Mauritania;54;1;20253;480
2021-06-18;MR;Mauritania;35;0;20288;480
2021-06-19;MR;Mauritania;26;0;20314;480
2021-06-20;MR;Mauritania;22;1;20336;481
2021-06-21;MR;Mauritania;29;0;20365;481
2021-06-22;MR;Mauritania;50;1;20415;482
2021-06-23;MR;Mauritania;58;1;20473;483
2021-06-24;MR;Mauritania;39;0;20512;483
2021-06-25;MR;Mauritania;56;3;20568;486
2021-06-26;MR;Mauritania;36;0;20604;486
2021-06-27;MR;Mauritania;31;0;20635;486
2021-06-28;MR;Mauritania;41;1;20676;487
2021-06-29;MR;Mauritania;71;0;20747;487
2021-06-30;MR;Mauritania;61;2;20808;489
2021-07-01;MR;Mauritania;86;0;20894;489
2020-03-18;MU;Mauritius;3;0;3;0
2020-03-19;MU;Mauritius;0;0;3;0
2020-03-20;MU;Mauritius;9;0;12;0
2020-03-21;MU;Mauritius;2;1;14;1
2020-03-22;MU;Mauritius;14;1;28;2
2020-03-23;MU;Mauritius;8;0;36;2
2020-03-24;MU;Mauritius;6;0;42;2
2020-03-25;MU;Mauritius;6;0;48;2
2020-03-26;MU;Mauritius;33;0;81;2
2020-03-27;MU;Mauritius;13;0;94;2
2020-03-28;MU;Mauritius;8;0;102;2
2020-03-29;MU;Mauritius;5;1;107;3
2020-03-30;MU;Mauritius;21;0;128;3
2020-03-31;MU;Mauritius;15;2;143;5
2020-04-01;MU;Mauritius;18;1;161;6
2020-04-02;MU;Mauritius;8;1;169;7
2020-04-03;MU;Mauritius;17;0;186;7
2020-04-04;MU;Mauritius;10;0;196;7
2020-04-05;MU;Mauritius;31;0;227;7
2020-04-06;MU;Mauritius;17;0;244;7
2020-04-07;MU;Mauritius;24;0;268;7
2020-04-08;MU;Mauritius;5;0;273;7
2020-04-09;MU;Mauritius;41;0;314;7
2020-04-10;MU;Mauritius;4;2;318;9
2020-04-11;MU;Mauritius;1;0;319;9
2020-04-12;MU;Mauritius;5;0;324;9
2020-04-13;MU;Mauritius;0;0;324;9
2020-04-14;MU;Mauritius;0;0;324;9
2020-04-15;MU;Mauritius;0;0;324;9
2020-04-16;MU;Mauritius;0;0;324;9
2020-04-17;MU;Mauritius;0;0;324;9
2020-04-18;MU;Mauritius;1;0;325;9
2020-04-19;MU;Mauritius;3;0;328;9
2020-04-20;MU;Mauritius;0;0;328;9
2020-04-21;MU;Mauritius;0;0;328;9
2020-04-22;MU;Mauritius;1;0;329;9
2020-04-23;MU;Mauritius;2;0;331;9
2020-04-24;MU;Mauritius;0;0;331;9
2020-04-25;MU;Mauritius;0;0;331;9
2020-04-26;MU;Mauritius;1;0;332;9
2020-04-27;MU;Mauritius;2;1;334;10
2020-04-28;MU;Mauritius;0;0;334;10
2020-04-29;MU;Mauritius;-2;0;332;10
2020-04-30;MU;Mauritius;0;0;332;10
2020-05-01;MU;Mauritius;0;0;332;10
2020-05-02;MU;Mauritius;0;0;332;10
2020-05-03;MU;Mauritius;0;0;332;10
2020-05-04;MU;Mauritius;0;0;332;10
2020-05-05;MU;Mauritius;0;0;332;10
2020-05-06;MU;Mauritius;0;0;332;10
2020-05-07;MU;Mauritius;0;0;332;10
2020-05-08;MU;Mauritius;0;0;332;10
2020-05-09;MU;Mauritius;0;0;332;10
2020-05-10;MU;Mauritius;0;0;332;10
2020-05-11;MU;Mauritius;0;0;332;10
2020-05-12;MU;Mauritius;0;0;332;10
2020-05-13;MU;Mauritius;0;0;332;10
2020-05-14;MU;Mauritius;0;0;332;10
2020-05-15;MU;Mauritius;0;0;332;10
2020-05-16;MU;Mauritius;0;0;332;10
2020-05-17;MU;Mauritius;0;0;332;10
2020-05-18;MU;Mauritius;0;0;332;10
2020-05-19;MU;Mauritius;0;0;332;10
2020-05-20;MU;Mauritius;0;0;332;10
2020-05-21;MU;Mauritius;0;0;332;10
2020-05-22;MU;Mauritius;0;0;332;10
2020-05-23;MU;Mauritius;0;0;332;10
2020-05-24;MU;Mauritius;2;0;334;10
2020-05-25;MU;Mauritius;0;0;334;10
2020-05-26;MU;Mauritius;0;0;334;10
2020-05-27;MU;Mauritius;0;0;334;10
2020-05-28;MU;Mauritius;0;0;334;10
2020-05-29;MU;Mauritius;1;0;335;10
2020-05-30;MU;Mauritius;0;0;335;10
2020-05-31;MU;Mauritius;0;0;335;10
2020-06-01;MU;Mauritius;0;0;335;10
2020-06-02;MU;Mauritius;0;0;335;10
2020-06-03;MU;Mauritius;0;0;335;10
2020-06-04;MU;Mauritius;0;0;335;10
2020-06-05;MU;Mauritius;2;0;337;10
2020-06-06;MU;Mauritius;0;0;337;10
2020-06-07;MU;Mauritius;0;0;337;10
2020-06-08;MU;Mauritius;0;0;337;10
2020-06-09;MU;Mauritius;0;0;337;10
2020-06-10;MU;Mauritius;0;0;337;10
2020-06-11;MU;Mauritius;0;0;337;10
2020-06-12;MU;Mauritius;0;0;337;10
2020-06-13;MU;Mauritius;0;0;337;10
2020-06-14;MU;Mauritius;0;0;337;10
2020-06-15;MU;Mauritius;0;0;337;10
2020-06-16;MU;Mauritius;0;0;337;10
2020-06-17;MU;Mauritius;0;0;337;10
2020-06-18;MU;Mauritius;0;0;337;10
2020-06-19;MU;Mauritius;0;0;337;10
2020-06-20;MU;Mauritius;0;0;337;10
2020-06-21;MU;Mauritius;0;0;337;10
2020-06-22;MU;Mauritius;3;0;340;10
2020-06-23;MU;Mauritius;0;0;340;10
2020-06-24;MU;Mauritius;1;0;341;10
2020-06-25;MU;Mauritius;0;0;341;10
2020-06-26;MU;Mauritius;0;0;341;10
2020-06-27;MU;Mauritius;0;0;341;10
2020-06-28;MU;Mauritius;0;0;341;10
2020-06-29;MU;Mauritius;0;0;341;10
2020-06-30;MU;Mauritius;0;0;341;10
2020-07-01;MU;Mauritius;0;0;341;10
2020-07-02;MU;Mauritius;0;0;341;10
2020-07-03;MU;Mauritius;0;0;341;10
2020-07-04;MU;Mauritius;0;0;341;10
2020-07-05;MU;Mauritius;0;0;341;10
2020-07-06;MU;Mauritius;1;0;342;10
2020-07-07;MU;Mauritius;0;0;342;10
2020-07-08;MU;Mauritius;0;0;342;10
2020-07-09;MU;Mauritius;0;0;342;10
2020-07-10;MU;Mauritius;0;0;342;10
2020-07-11;MU;Mauritius;0;0;342;10
2020-07-12;MU;Mauritius;0;0;342;10
2020-07-13;MU;Mauritius;0;0;342;10
2020-07-14;MU;Mauritius;0;0;342;10
2020-07-15;MU;Mauritius;1;0;343;10
2020-07-16;MU;Mauritius;0;0;343;10
2020-07-17;MU;Mauritius;0;0;343;10
2020-07-18;MU;Mauritius;0;0;343;10
2020-07-19;MU;Mauritius;0;0;343;10
2020-07-20;MU;Mauritius;0;0;343;10
2020-07-21;MU;Mauritius;0;0;343;10
2020-07-22;MU;Mauritius;0;0;343;10
2020-07-23;MU;Mauritius;0;0;343;10
2020-07-24;MU;Mauritius;1;0;344;10
2020-07-25;MU;Mauritius;0;0;344;10
2020-07-26;MU;Mauritius;0;0;344;10
2020-07-27;MU;Mauritius;0;0;344;10
2020-07-28;MU;Mauritius;0;0;344;10
2020-07-29;MU;Mauritius;0;0;344;10
2020-07-30;MU;Mauritius;0;0;344;10
2020-07-31;MU;Mauritius;0;0;344;10
2020-08-01;MU;Mauritius;0;0;344;10
2020-08-02;MU;Mauritius;0;0;344;10
2020-08-03;MU;Mauritius;0;0;344;10
2020-08-04;MU;Mauritius;0;0;344;10
2020-08-05;MU;Mauritius;0;0;344;10
2020-08-06;MU;Mauritius;0;0;344;10
2020-08-07;MU;Mauritius;0;0;344;10
2020-08-08;MU;Mauritius;0;0;344;10
2020-08-09;MU;Mauritius;0;0;344;10
2020-08-10;MU;Mauritius;0;0;344;10
2020-08-11;MU;Mauritius;0;0;344;10
2020-08-12;MU;Mauritius;0;0;344;10
2020-08-13;MU;Mauritius;0;0;344;10
2020-08-14;MU;Mauritius;1;0;345;10
2020-08-15;MU;Mauritius;1;0;346;10
2020-08-16;MU;Mauritius;0;0;346;10
2020-08-17;MU;Mauritius;0;0;346;10
2020-08-18;MU;Mauritius;0;0;346;10
2020-08-19;MU;Mauritius;0;0;346;10
2020-08-20;MU;Mauritius;0;0;346;10
2020-08-21;MU;Mauritius;0;0;346;10
2020-08-22;MU;Mauritius;0;0;346;10
2020-08-23;MU;Mauritius;0;0;346;10
2020-08-24;MU;Mauritius;1;0;347;10
2020-08-25;MU;Mauritius;1;0;348;10
2020-08-26;MU;Mauritius;0;0;348;10
2020-08-27;MU;Mauritius;7;0;355;10
2020-08-28;MU;Mauritius;0;0;355;10
2020-08-29;MU;Mauritius;0;0;355;10
2020-08-30;MU;Mauritius;0;0;355;10
2020-08-31;MU;Mauritius;1;0;356;10
2020-09-01;MU;Mauritius;0;0;356;10
2020-09-02;MU;Mauritius;0;0;356;10
2020-09-03;MU;Mauritius;0;0;356;10
2020-09-04;MU;Mauritius;0;0;356;10
2020-09-05;MU;Mauritius;0;0;356;10
2020-09-06;MU;Mauritius;0;0;356;10
2020-09-07;MU;Mauritius;0;0;356;10
2020-09-08;MU;Mauritius;5;0;361;10
2020-09-09;MU;Mauritius;0;0;361;10
2020-09-10;MU;Mauritius;0;0;361;10
2020-09-11;MU;Mauritius;0;0;361;10
2020-09-12;MU;Mauritius;0;0;361;10
2020-09-13;MU;Mauritius;0;0;361;10
2020-09-14;MU;Mauritius;0;0;361;10
2020-09-15;MU;Mauritius;4;0;365;10
2020-09-16;MU;Mauritius;0;0;365;10
2020-09-17;MU;Mauritius;1;0;366;10
2020-09-18;MU;Mauritius;0;0;366;10
2020-09-19;MU;Mauritius;0;0;366;10
2020-09-20;MU;Mauritius;0;0;366;10
2020-09-21;MU;Mauritius;0;0;366;10
2020-09-22;MU;Mauritius;1;0;367;10
2020-09-23;MU;Mauritius;0;0;367;10
2020-09-24;MU;Mauritius;0;0;367;10
2020-09-25;MU;Mauritius;0;0;367;10
2020-09-26;MU;Mauritius;0;0;367;10
2020-09-27;MU;Mauritius;0;0;367;10
2020-09-28;MU;Mauritius;0;0;367;10
2020-09-29;MU;Mauritius;0;0;367;10
2020-09-30;MU;Mauritius;14;0;381;10
2020-10-01;MU;Mauritius;0;0;381;10
2020-10-02;MU;Mauritius;4;0;385;10
2020-10-03;MU;Mauritius;0;0;385;10
2020-10-04;MU;Mauritius;0;0;385;10
2020-10-05;MU;Mauritius;2;0;387;10
2020-10-06;MU;Mauritius;8;0;395;10
2020-10-07;MU;Mauritius;0;0;395;10
2020-10-08;MU;Mauritius;0;0;395;10
2020-10-09;MU;Mauritius;0;0;395;10
2020-10-10;MU;Mauritius;0;0;395;10
2020-10-11;MU;Mauritius;0;0;395;10
2020-10-12;MU;Mauritius;9;0;404;10
2020-10-13;MU;Mauritius;3;0;407;10
2020-10-14;MU;Mauritius;0;0;407;10
2020-10-15;MU;Mauritius;8;0;415;10
2020-10-16;MU;Mauritius;2;0;417;10
2020-10-17;MU;Mauritius;0;0;417;10
2020-10-18;MU;Mauritius;0;0;417;10
2020-10-19;MU;Mauritius;2;0;419;10
2020-10-20;MU;Mauritius;0;0;419;10
2020-10-21;MU;Mauritius;0;0;419;10
2020-10-22;MU;Mauritius;6;0;425;10
2020-10-23;MU;Mauritius;10;0;435;10
2020-10-24;MU;Mauritius;0;0;435;10
2020-10-25;MU;Mauritius;0;0;435;10
2020-10-26;MU;Mauritius;4;0;439;10
2020-10-27;MU;Mauritius;0;0;439;10
2020-10-28;MU;Mauritius;0;0;439;10
2020-10-29;MU;Mauritius;0;0;439;10
2020-10-30;MU;Mauritius;2;0;441;10
2020-10-31;MU;Mauritius;0;0;441;10
2020-11-01;MU;Mauritius;5;0;446;10
2020-11-02;MU;Mauritius;5;0;451;10
2020-11-03;MU;Mauritius;0;0;451;10
2020-11-04;MU;Mauritius;1;0;452;10
2020-11-05;MU;Mauritius;1;0;453;10
2020-11-06;MU;Mauritius;0;0;453;10
2020-11-07;MU;Mauritius;0;0;453;10
2020-11-08;MU;Mauritius;0;0;453;10
2020-11-09;MU;Mauritius;0;0;453;10
2020-11-10;MU;Mauritius;0;0;453;10
2020-11-11;MU;Mauritius;0;0;453;10
2020-11-12;MU;Mauritius;15;0;468;10
2020-11-13;MU;Mauritius;2;0;470;10
2020-11-14;MU;Mauritius;0;0;470;10
2020-11-15;MU;Mauritius;8;0;478;10
2020-11-16;MU;Mauritius;13;0;491;10
2020-11-17;MU;Mauritius;0;0;491;10
2020-11-18;MU;Mauritius;3;0;494;10
2020-11-19;MU;Mauritius;0;0;494;10
2020-11-20;MU;Mauritius;0;0;494;10
2020-11-21;MU;Mauritius;0;0;494;10
2020-11-22;MU;Mauritius;0;0;494;10
2020-11-23;MU;Mauritius;0;0;494;10
2020-11-24;MU;Mauritius;0;0;494;10
2020-11-25;MU;Mauritius;3;0;497;10
2020-11-26;MU;Mauritius;1;0;498;10
2020-11-27;MU;Mauritius;3;0;501;10
2020-11-28;MU;Mauritius;0;0;501;10
2020-11-29;MU;Mauritius;0;0;501;10
2020-11-30;MU;Mauritius;3;0;504;10
2020-12-01;MU;Mauritius;1;0;505;10
2020-12-02;MU;Mauritius;3;0;508;10
2020-12-03;MU;Mauritius;0;0;508;10
2020-12-04;MU;Mauritius;0;0;508;10
2020-12-05;MU;Mauritius;0;0;508;10
2020-12-06;MU;Mauritius;0;0;508;10
2020-12-07;MU;Mauritius;3;0;511;10
2020-12-08;MU;Mauritius;4;0;515;10
2020-12-09;MU;Mauritius;0;0;515;10
2020-12-10;MU;Mauritius;0;0;515;10
2020-12-11;MU;Mauritius;0;0;515;10
2020-12-12;MU;Mauritius;0;0;515;10
2020-12-13;MU;Mauritius;0;0;515;10
2020-12-14;MU;Mauritius;8;0;523;10
2020-12-15;MU;Mauritius;1;0;524;10
2020-12-16;MU;Mauritius;0;0;524;10
2020-12-17;MU;Mauritius;0;0;524;10
2020-12-18;MU;Mauritius;0;0;524;10
2020-12-19;MU;Mauritius;0;0;524;10
2020-12-20;MU;Mauritius;0;0;524;10
2020-12-21;MU;Mauritius;0;0;524;10
2020-12-22;MU;Mauritius;2;0;526;10
2020-12-23;MU;Mauritius;1;0;527;10
2020-12-24;MU;Mauritius;0;0;527;10
2020-12-25;MU;Mauritius;0;0;527;10
2020-12-26;MU;Mauritius;0;0;527;10
2020-12-27;MU;Mauritius;0;0;527;10
2020-12-28;MU;Mauritius;0;0;527;10
2020-12-29;MU;Mauritius;0;0;527;10
2020-12-30;MU;Mauritius;0;0;527;10
2020-12-31;MU;Mauritius;0;0;527;10
2021-01-01;MU;Mauritius;0;0;527;10
2021-01-02;MU;Mauritius;0;0;527;10
2021-01-03;MU;Mauritius;0;0;527;10
2021-01-04;MU;Mauritius;4;0;531;10
2021-01-05;MU;Mauritius;0;0;531;10
2021-01-06;MU;Mauritius;8;0;539;10
2021-01-07;MU;Mauritius;0;0;539;10
2021-01-08;MU;Mauritius;0;0;539;10
2021-01-09;MU;Mauritius;0;0;539;10
2021-01-10;MU;Mauritius;0;0;539;10
2021-01-11;MU;Mauritius;6;0;545;10
2021-01-12;MU;Mauritius;1;0;546;10
2021-01-13;MU;Mauritius;1;0;547;10
2021-01-14;MU;Mauritius;0;0;547;10
2021-01-15;MU;Mauritius;0;0;547;10
2021-01-16;MU;Mauritius;0;0;547;10
2021-01-17;MU;Mauritius;0;0;547;10
2021-01-18;MU;Mauritius;9;0;556;10
2021-01-19;MU;Mauritius;0;0;556;10
2021-01-20;MU;Mauritius;0;0;556;10
2021-01-21;MU;Mauritius;0;0;556;10
2021-01-22;MU;Mauritius;0;0;556;10
2021-01-23;MU;Mauritius;0;0;556;10
2021-01-24;MU;Mauritius;0;0;556;10
2021-01-25;MU;Mauritius;12;0;568;10
2021-01-26;MU;Mauritius;0;0;568;10
2021-01-27;MU;Mauritius;1;0;569;10
2021-01-28;MU;Mauritius;0;0;569;10
2021-01-29;MU;Mauritius;0;0;569;10
2021-01-30;MU;Mauritius;0;0;569;10
2021-01-31;MU;Mauritius;0;0;569;10
2021-02-01;MU;Mauritius;13;0;582;10
2021-02-02;MU;Mauritius;1;0;583;10
2021-02-03;MU;Mauritius;1;0;584;10
2021-02-04;MU;Mauritius;0;0;584;10
2021-02-05;MU;Mauritius;0;0;584;10
2021-02-06;MU;Mauritius;0;0;584;10
2021-02-07;MU;Mauritius;0;0;584;10
2021-02-08;MU;Mauritius;9;0;593;10
2021-02-09;MU;Mauritius;1;0;594;10
2021-02-10;MU;Mauritius;1;0;595;10
2021-02-11;MU;Mauritius;0;0;595;10
2021-02-12;MU;Mauritius;0;0;595;10
2021-02-13;MU;Mauritius;0;0;595;10
2021-02-14;MU;Mauritius;0;0;595;10
2021-02-15;MU;Mauritius;6;0;601;10
2021-02-16;MU;Mauritius;2;0;603;10
2021-02-17;MU;Mauritius;0;0;603;10
2021-02-18;MU;Mauritius;0;0;603;10
2021-02-19;MU;Mauritius;0;0;603;10
2021-02-20;MU;Mauritius;0;0;603;10
2021-02-21;MU;Mauritius;0;0;603;10
2021-02-22;MU;Mauritius;0;0;603;10
2021-02-23;MU;Mauritius;7;0;610;10
2021-02-24;MU;Mauritius;0;0;610;10
2021-02-25;MU;Mauritius;0;0;610;10
2021-02-26;MU;Mauritius;0;0;610;10
2021-02-27;MU;Mauritius;0;0;610;10
2021-02-28;MU;Mauritius;0;0;610;10
2021-03-01;MU;Mauritius;9;0;619;10
2021-03-02;MU;Mauritius;0;0;619;10
2021-03-03;MU;Mauritius;0;0;619;10
2021-03-04;MU;Mauritius;1;0;620;10
2021-03-05;MU;Mauritius;5;0;625;10
2021-03-06;MU;Mauritius;14;0;639;10
2021-03-07;MU;Mauritius;2;0;641;10
2021-03-08;MU;Mauritius;0;0;641;10
2021-03-09;MU;Mauritius;0;0;641;10
2021-03-10;MU;Mauritius;0;0;641;10
2021-03-11;MU;Mauritius;23;0;664;10
2021-03-12;MU;Mauritius;47;0;711;10
2021-03-13;MU;Mauritius;28;0;739;10
2021-03-14;MU;Mauritius;3;0;742;10
2021-03-15;MU;Mauritius;5;0;747;10
2021-03-16;MU;Mauritius;11;0;758;10
2021-03-17;MU;Mauritius;4;0;762;10
2021-03-18;MU;Mauritius;6;0;768;10
2021-03-19;MU;Mauritius;25;0;793;10
2021-03-20;MU;Mauritius;3;0;796;10
2021-03-21;MU;Mauritius;9;0;805;10
2021-03-22;MU;Mauritius;4;0;809;10
2021-03-23;MU;Mauritius;17;0;826;10
2021-03-24;MU;Mauritius;24;0;850;10
2021-03-25;MU;Mauritius;3;0;853;10
2021-03-26;MU;Mauritius;18;0;871;10
2021-03-27;MU;Mauritius;0;0;871;10
2021-03-28;MU;Mauritius;62;0;933;10
2021-03-29;MU;Mauritius;25;0;958;10
2021-03-30;MU;Mauritius;38;0;996;10
2021-03-31;MU;Mauritius;32;2;1028;12
2021-04-01;MU;Mauritius;11;0;1039;12
2021-04-02;MU;Mauritius;56;0;1095;12
2021-04-03;MU;Mauritius;9;0;1104;12
2021-04-04;MU;Mauritius;8;0;1112;12
2021-04-05;MU;Mauritius;9;0;1121;12
2021-04-06;MU;Mauritius;9;0;1130;12
2021-04-07;MU;Mauritius;37;0;1167;12
2021-04-08;MU;Mauritius;4;0;1171;12
2021-04-09;MU;Mauritius;12;0;1183;12
2021-04-10;MU;Mauritius;7;0;1190;12
2021-04-11;MU;Mauritius;2;0;1192;12
2021-04-12;MU;Mauritius;1;3;1193;15
2021-04-13;MU;Mauritius;5;0;1198;15
2021-04-14;MU;Mauritius;3;0;1201;15
2021-04-15;MU;Mauritius;1;0;1202;15
2021-04-16;MU;Mauritius;0;0;1202;15
2021-04-17;MU;Mauritius;1;0;1203;15
2021-04-18;MU;Mauritius;0;0;1203;15
2021-04-19;MU;Mauritius;0;0;1203;15
2021-04-20;MU;Mauritius;0;0;1203;15
2021-04-21;MU;Mauritius;1;0;1204;15
2021-04-22;MU;Mauritius;1;1;1205;16
2021-04-23;MU;Mauritius;0;0;1205;16
2021-04-24;MU;Mauritius;1;0;1206;16
2021-04-25;MU;Mauritius;0;0;1206;16
2021-04-26;MU;Mauritius;0;1;1206;17
2021-04-27;MU;Mauritius;0;0;1206;17
2021-04-28;MU;Mauritius;1;0;1207;17
2021-04-29;MU;Mauritius;1;0;1208;17
2021-04-30;MU;Mauritius;1;0;1209;17
2021-05-01;MU;Mauritius;2;0;1211;17
2021-05-02;MU;Mauritius;0;0;1211;17
2021-05-03;MU;Mauritius;0;0;1211;17
2021-05-04;MU;Mauritius;3;0;1214;17
2021-05-05;MU;Mauritius;2;0;1216;17
2021-05-06;MU;Mauritius;0;0;1216;17
2021-05-07;MU;Mauritius;10;0;1226;17
2021-05-08;MU;Mauritius;14;0;1240;17
2021-05-09;MU;Mauritius;6;0;1246;17
2021-05-10;MU;Mauritius;10;0;1256;17
2021-05-11;MU;Mauritius;1;0;1257;17
2021-05-12;MU;Mauritius;9;0;1266;17
2021-05-13;MU;Mauritius;8;0;1274;17
2021-05-14;MU;Mauritius;3;0;1277;17
2021-05-15;MU;Mauritius;3;0;1280;17
2021-05-16;MU;Mauritius;2;0;1282;17
2021-05-17;MU;Mauritius;5;0;1287;17
2021-05-18;MU;Mauritius;1;0;1288;17
2021-05-19;MU;Mauritius;0;0;1288;17
2021-05-20;MU;Mauritius;0;0;1288;17
2021-05-21;MU;Mauritius;4;0;1292;17
2021-05-22;MU;Mauritius;1;0;1293;17
2021-05-23;MU;Mauritius;0;0;1293;17
2021-05-24;MU;Mauritius;3;0;1296;17
2021-05-25;MU;Mauritius;15;0;1311;17
2021-05-26;MU;Mauritius;21;0;1332;17
2021-05-27;MU;Mauritius;9;0;1341;17
2021-05-28;MU;Mauritius;15;0;1356;17
2021-05-29;MU;Mauritius;7;0;1363;17
2021-05-30;MU;Mauritius;4;1;1367;18
2021-05-31;MU;Mauritius;8;0;1375;18
2021-06-01;MU;Mauritius;24;0;1399;18
2021-06-02;MU;Mauritius;19;0;1418;18
2021-06-03;MU;Mauritius;3;0;1421;18
2021-06-04;MU;Mauritius;0;0;1421;18
2021-06-05;MU;Mauritius;0;0;1421;18
2021-06-06;MU;Mauritius;37;0;1458;18
2021-06-07;MU;Mauritius;0;0;1458;18
2021-06-08;MU;Mauritius;0;0;1458;18
2021-06-09;MU;Mauritius;38;0;1496;18
2021-06-10;MU;Mauritius;0;0;1496;18
2021-06-11;MU;Mauritius;68;0;1564;18
2021-06-12;MU;Mauritius;2;0;1566;18
2021-06-13;MU;Mauritius;107;0;1673;18
2021-06-14;MU;Mauritius;28;0;1701;18
2021-06-15;MU;Mauritius;0;0;1701;18
2021-06-16;MU;Mauritius;0;0;1701;18
2021-06-17;MU;Mauritius;0;0;1701;18
2021-06-18;MU;Mauritius;0;0;1701;18
2021-06-19;MU;Mauritius;0;0;1701;18
2021-06-20;MU;Mauritius;0;0;1701;18
2021-06-21;MU;Mauritius;0;0;1701;18
2021-06-22;MU;Mauritius;0;0;1701;18
2021-06-23;MU;Mauritius;78;0;1779;18
2021-06-24;MU;Mauritius;0;0;1779;18
2021-06-25;MU;Mauritius;0;0;1779;18
2021-06-26;MU;Mauritius;54;0;1833;18
2021-06-27;MU;Mauritius;0;0;1833;18
2021-06-28;MU;Mauritius;0;0;1833;18
2021-06-29;MU;Mauritius;0;0;1833;18
2021-06-30;MU;Mauritius;0;0;1833;18
2021-07-01;MU;Mauritius;25;0;1858;18
2020-01-01;MX;Mexico;0;0;0;0
2020-01-02;MX;Mexico;0;0;0;0
2020-01-03;MX;Mexico;0;0;0;0
2020-01-04;MX;Mexico;0;0;0;0
2020-01-05;MX;Mexico;0;0;0;0
2020-01-06;MX;Mexico;0;0;0;0
2020-01-07;MX;Mexico;0;0;0;0
2020-01-08;MX;Mexico;0;0;0;0
2020-01-09;MX;Mexico;0;0;0;0
2020-01-10;MX;Mexico;0;0;0;0
2020-01-11;MX;Mexico;0;0;0;0
2020-01-12;MX;Mexico;0;0;0;0
2020-01-13;MX;Mexico;0;0;0;0
2020-01-14;MX;Mexico;0;0;0;0
2020-01-15;MX;Mexico;0;0;0;0
2020-01-16;MX;Mexico;0;0;0;0
2020-01-17;MX;Mexico;0;0;0;0
2020-01-18;MX;Mexico;0;0;0;0
2020-01-19;MX;Mexico;0;0;0;0
2020-01-20;MX;Mexico;0;0;0;0
2020-01-21;MX;Mexico;0;0;0;0
2020-01-22;MX;Mexico;0;0;0;0
2020-01-23;MX;Mexico;0;0;0;0
2020-01-24;MX;Mexico;0;0;0;0
2020-01-25;MX;Mexico;0;0;0;0
2020-01-26;MX;Mexico;0;0;0;0
2020-01-27;MX;Mexico;0;0;0;0
2020-01-28;MX;Mexico;0;0;0;0
2020-01-29;MX;Mexico;0;0;0;0
2020-01-30;MX;Mexico;0;0;0;0
2020-01-31;MX;Mexico;0;0;0;0
2020-02-01;MX;Mexico;0;0;0;0
2020-02-02;MX;Mexico;0;0;0;0
2020-02-03;MX;Mexico;0;0;0;0
2020-02-04;MX;Mexico;0;0;0;0
2020-02-05;MX;Mexico;0;0;0;0
2020-02-06;MX;Mexico;0;0;0;0
2020-02-07;MX;Mexico;0;0;0;0
2020-02-08;MX;Mexico;0;0;0;0
2020-02-09;MX;Mexico;0;0;0;0
2020-02-10;MX;Mexico;0;0;0;0
2020-02-11;MX;Mexico;0;0;0;0
2020-02-12;MX;Mexico;0;0;0;0
2020-02-13;MX;Mexico;0;0;0;0
2020-02-14;MX;Mexico;0;0;0;0
2020-02-15;MX;Mexico;0;0;0;0
2020-02-16;MX;Mexico;0;0;0;0
2020-02-17;MX;Mexico;0;0;0;0
2020-02-18;MX;Mexico;0;0;0;0
2020-02-19;MX;Mexico;0;0;0;0
2020-02-20;MX;Mexico;0;0;0;0
2020-02-21;MX;Mexico;0;0;0;0
2020-02-22;MX;Mexico;0;0;0;0
2020-02-23;MX;Mexico;0;0;0;0
2020-02-24;MX;Mexico;0;0;0;0
2020-02-25;MX;Mexico;0;0;0;0
2020-02-26;MX;Mexico;0;0;0;0
2020-02-27;MX;Mexico;0;0;0;0
2020-02-28;MX;Mexico;1;0;1;0
2020-02-29;MX;Mexico;3;0;4;0
2020-03-01;MX;Mexico;1;0;5;0
2020-03-02;MX;Mexico;0;0;5;0
2020-03-03;MX;Mexico;0;0;5;0
2020-03-04;MX;Mexico;0;0;5;0
2020-03-05;MX;Mexico;0;0;5;0
2020-03-06;MX;Mexico;1;0;6;0
2020-03-07;MX;Mexico;0;0;6;0
2020-03-08;MX;Mexico;1;0;7;0
2020-03-09;MX;Mexico;0;0;7;0
2020-03-10;MX;Mexico;0;0;7;0
2020-03-11;MX;Mexico;1;0;8;0
2020-03-12;MX;Mexico;4;0;12;0
2020-03-13;MX;Mexico;14;0;26;0
2020-03-14;MX;Mexico;15;0;41;0
2020-03-15;MX;Mexico;12;0;53;0
2020-03-16;MX;Mexico;29;0;82;0
2020-03-17;MX;Mexico;11;0;93;0
2020-03-18;MX;Mexico;25;0;118;0
2020-03-19;MX;Mexico;46;1;164;1
2020-03-20;MX;Mexico;39;1;203;2
2020-03-21;MX;Mexico;48;0;251;2
2020-03-22;MX;Mexico;65;1;316;3
2020-03-23;MX;Mexico;51;1;367;4
2020-03-24;MX;Mexico;38;1;405;5
2020-03-25;MX;Mexico;70;1;475;6
2020-03-26;MX;Mexico;110;2;585;8
2020-03-27;MX;Mexico;132;4;717;12
2020-03-28;MX;Mexico;131;4;848;16
2020-03-29;MX;Mexico;145;4;993;20
2020-03-30;MX;Mexico;101;8;1094;28
2020-03-31;MX;Mexico;121;1;1215;29
2020-04-01;MX;Mexico;163;8;1378;37
2020-04-02;MX;Mexico;132;13;1510;50
2020-04-03;MX;Mexico;178;10;1688;60
2020-04-04;MX;Mexico;202;19;1890;79
2020-04-05;MX;Mexico;253;15;2143;94
2020-04-06;MX;Mexico;296;31;2439;125
2020-04-07;MX;Mexico;346;16;2785;141
2020-04-08;MX;Mexico;396;33;3181;174
2020-04-09;MX;Mexico;260;20;3441;194
2020-04-10;MX;Mexico;403;39;3844;233
2020-04-11;MX;Mexico;375;40;4219;273
2020-04-12;MX;Mexico;442;23;4661;296
2020-04-13;MX;Mexico;353;36;5014;332
2020-04-14;MX;Mexico;385;74;5399;406
2020-04-15;MX;Mexico;448;43;5847;449
2020-04-16;MX;Mexico;450;37;6297;486
2020-04-17;MX;Mexico;578;60;6875;546
2020-04-18;MX;Mexico;622;104;7497;650
2020-04-19;MX;Mexico;764;36;8261;686
2020-04-20;MX;Mexico;511;26;8772;712
2020-04-21;MX;Mexico;729;145;9501;857
2020-04-22;MX;Mexico;1043;113;10544;970
2020-04-23;MX;Mexico;1089;99;11633;1069
2020-04-24;MX;Mexico;1239;152;12872;1221
2020-04-25;MX;Mexico;970;84;13842;1305
2020-04-26;MX;Mexico;835;46;14677;1351
2020-04-27;MX;Mexico;852;83;15529;1434
2020-04-28;MX;Mexico;1223;135;16752;1569
2020-04-29;MX;Mexico;1047;163;17799;1732
2020-04-30;MX;Mexico;1425;127;19224;1859
2020-05-01;MX;Mexico;1515;113;20739;1972
2020-05-02;MX;Mexico;1349;89;22088;2061
2020-05-03;MX;Mexico;1383;93;23471;2154
2020-05-04;MX;Mexico;1434;117;24905;2271
2020-05-05;MX;Mexico;1120;236;26025;2507
2020-05-06;MX;Mexico;1609;197;27634;2704
2020-05-07;MX;Mexico;1982;257;29616;2961
2020-05-08;MX;Mexico;1906;199;31522;3160
2020-05-09;MX;Mexico;1938;193;33460;3353
2020-05-10;MX;Mexico;1562;112;35022;3465
2020-05-11;MX;Mexico;1305;108;36327;3573
2020-05-12;MX;Mexico;1997;353;38324;3926
2020-05-13;MX;Mexico;1862;294;40186;4220
2020-05-14;MX;Mexico;2409;257;42595;4477
2020-05-15;MX;Mexico;2437;290;45032;4767
2020-05-16;MX;Mexico;2112;278;47144;5045
2020-05-17;MX;Mexico;2075;132;49219;5177
2020-05-18;MX;Mexico;2414;155;51633;5332
2020-05-19;MX;Mexico;2713;334;54346;5666
2020-05-20;MX;Mexico;2248;424;56594;6090
2020-05-21;MX;Mexico;2973;420;59567;6510
2020-05-22;MX;Mexico;2960;479;62527;6989
2020-05-23;MX;Mexico;3329;190;65856;7179
2020-05-24;MX;Mexico;2764;215;68620;7394
2020-05-25;MX;Mexico;2485;239;71105;7633
2020-05-26;MX;Mexico;3455;501;74560;8134
2020-05-27;MX;Mexico;3463;463;78023;8597
2020-05-28;MX;Mexico;3377;447;81400;9044
2020-05-29;MX;Mexico;3227;371;84627;9415
2020-05-30;MX;Mexico;2885;364;87512;9779
2020-05-31;MX;Mexico;3152;151;90664;9930
2020-06-01;MX;Mexico;2771;237;93435;10167
2020-06-02;MX;Mexico;3891;470;97326;10637
2020-06-03;MX;Mexico;3912;1092;101238;11729
2020-06-04;MX;Mexico;4442;816;105680;12545
2020-06-05;MX;Mexico;4346;625;110026;13170
2020-06-06;MX;Mexico;3593;341;113619;13511
2020-06-07;MX;Mexico;3484;188;117103;13699
2020-06-08;MX;Mexico;2999;354;120102;14053
2020-06-09;MX;Mexico;4199;596;124301;14649
2020-06-10;MX;Mexico;4883;708;129184;15357
2020-06-11;MX;Mexico;4790;587;133974;15944
2020-06-12;MX;Mexico;5222;504;139196;16448
2020-06-13;MX;Mexico;3494;424;142690;16872
2020-06-14;MX;Mexico;4147;269;146837;17141
2020-06-15;MX;Mexico;3427;439;150264;17580
2020-06-16;MX;Mexico;4599;730;154863;18310
2020-06-17;MX;Mexico;4930;770;159793;19080
2020-06-18;MX;Mexico;5662;667;165455;19747
2020-06-19;MX;Mexico;5030;647;170485;20394
2020-06-20;MX;Mexico;4717;387;175202;20781
2020-06-21;MX;Mexico;5343;1044;180545;21825
2020-06-22;MX;Mexico;4577;759;185122;22584
2020-06-23;MX;Mexico;6288;793;191410;23377
2020-06-24;MX;Mexico;5437;947;196847;24324
2020-06-25;MX;Mexico;6104;736;202951;25060
2020-06-26;MX;Mexico;5441;719;208392;25779
2020-06-27;MX;Mexico;4410;602;212802;26381
2020-06-28;MX;Mexico;4050;267;216852;26648
2020-06-29;MX;Mexico;3805;473;220657;27121
2020-06-30;MX;Mexico;5432;648;226089;27769
2020-07-01;MX;Mexico;5681;741;231770;28510
2020-07-02;MX;Mexico;6741;679;238511;29189
2020-07-03;MX;Mexico;6740;654;245251;29843
2020-07-04;MX;Mexico;6914;523;252165;30366
2020-07-05;MX;Mexico;4683;273;256848;30639
2020-07-06;MX;Mexico;4902;480;261750;31119
2020-07-07;MX;Mexico;6258;895;268008;32014
2020-07-08;MX;Mexico;6995;782;275003;32796
2020-07-09;MX;Mexico;7280;730;282283;33526
2020-07-10;MX;Mexico;6891;665;289174;34191
2020-07-11;MX;Mexico;6094;539;295268;34730
2020-07-12;MX;Mexico;4482;276;299750;35006
2020-07-13;MX;Mexico;4685;485;304435;35491
2020-07-14;MX;Mexico;7051;836;311486;36327
2020-07-15;MX;Mexico;6149;579;317635;36906
2020-07-16;MX;Mexico;6406;668;324041;37574
2020-07-17;MX;Mexico;7257;736;331298;38310
2020-07-18;MX;Mexico;7615;578;338913;38888
2020-07-19;MX;Mexico;5311;296;344224;39184
2020-07-20;MX;Mexico;5172;301;349396;39485
2020-07-21;MX;Mexico;6859;915;356255;40400
2020-07-22;MX;Mexico;6019;790;362274;41190
2020-07-23;MX;Mexico;8438;718;370712;41908
2020-07-24;MX;Mexico;7573;737;378285;42645
2020-07-25;MX;Mexico;6751;729;385036;43374
2020-07-26;MX;Mexico;5480;306;390516;43680
2020-07-27;MX;Mexico;4973;342;395489;44022
2020-07-28;MX;Mexico;7208;854;402697;44876
2020-07-29;MX;Mexico;5752;485;408449;45361
2020-07-30;MX;Mexico;7730;639;416179;46000
2020-07-31;MX;Mexico;8458;688;424637;46688
2020-08-01;MX;Mexico;9556;784;434193;47472
2020-08-02;MX;Mexico;4853;274;439046;47746
2020-08-03;MX;Mexico;4767;266;443813;48012
2020-08-04;MX;Mexico;6148;857;449961;48869
2020-08-05;MX;Mexico;6139;829;456100;49698
2020-08-06;MX;Mexico;6590;819;462690;50517
2020-08-07;MX;Mexico;6717;794;469407;51311
2020-08-08;MX;Mexico;6495;695;475902;52006
2020-08-09;MX;Mexico;4376;292;480278;52298
2020-08-10;MX;Mexico;5558;705;485836;53003
2020-08-11;MX;Mexico;6686;926;492522;53929
2020-08-12;MX;Mexico;5858;737;498380;54666
2020-08-13;MX;Mexico;7371;627;505751;55293
2020-08-14;MX;Mexico;5618;615;511369;55908
2020-08-15;MX;Mexico;6345;635;517714;56543
2020-08-16;MX;Mexico;4448;214;522162;56757
2020-08-17;MX;Mexico;3571;266;525733;57023
2020-08-18;MX;Mexico;5506;751;531239;57774
2020-08-19;MX;Mexico;5792;707;537031;58481
2020-08-20;MX;Mexico;6775;625;543806;59106
2020-08-21;MX;Mexico;5928;504;549734;59610
2020-08-22;MX;Mexico;6482;644;556216;60254
2020-08-23;MX;Mexico;3948;226;560164;60480
2020-08-24;MX;Mexico;3541;320;563705;60800
2020-08-25;MX;Mexico;4916;650;568621;61450
2020-08-26;MX;Mexico;5267;626;573888;62076
2020-08-27;MX;Mexico;6026;518;579914;62594
2020-08-28;MX;Mexico;5824;552;585738;63146
2020-08-29;MX;Mexico;5974;673;591712;63819
2020-08-30;MX;Mexico;4129;339;595841;64158
2020-08-31;MX;Mexico;3719;256;599560;64414
2020-09-01;MX;Mexico;6476;827;606036;65241
2020-09-02;MX;Mexico;4921;575;610957;65816
2020-09-03;MX;Mexico;5937;513;616894;66329
2020-09-04;MX;Mexico;6196;522;623090;66851
2020-09-05;MX;Mexico;6319;475;629409;67326
2020-09-06;MX;Mexico;4614;232;634023;67558
2020-09-07;MX;Mexico;3486;223;637509;67781
2020-09-08;MX;Mexico;5351;703;642860;68484
2020-09-09;MX;Mexico;4461;565;647321;69049
2020-09-10;MX;Mexico;5043;600;652364;69649
2020-09-11;MX;Mexico;5935;534;658299;70183
2020-09-12;MX;Mexico;5674;421;663973;70604
2020-09-13;MX;Mexico;4408;217;668381;70821
2020-09-14;MX;Mexico;3335;228;671716;71049
2020-09-15;MX;Mexico;4771;629;676487;71678
2020-09-16;MX;Mexico;4444;300;680931;71978
2020-09-17;MX;Mexico;3182;201;684113;72179
2020-09-18;MX;Mexico;4841;624;688954;72803
2020-09-19;MX;Mexico;5167;455;694121;73258
2020-09-20;MX;Mexico;3542;235;697663;73493
2020-09-21;MX;Mexico;2917;204;700580;73697
2020-09-22;MX;Mexico;4683;651;705263;74348
2020-09-23;MX;Mexico;4786;601;710049;74949
2020-09-24;MX;Mexico;5408;490;715457;75439
2020-09-25;MX;Mexico;5401;405;720858;75844
2020-09-26;MX;Mexico;5573;399;726431;76243
2020-09-27;MX;Mexico;3886;187;730317;76430
2020-09-28;MX;Mexico;3400;173;733717;76603
2020-09-29;MX;Mexico;4446;560;738163;77163
2020-09-30;MX;Mexico;5053;483;743216;77646
2020-10-01;MX;Mexico;5099;432;748315;78078
2020-10-02;MX;Mexico;4775;414;753090;78492
2020-10-03;MX;Mexico;4863;388;757953;78880
2020-10-04;MX;Mexico;3712;208;761665;79088
2020-10-05;MX;Mexico;28115;2789;789780;81877
2020-10-06;MX;Mexico;4828;471;794608;82348
2020-10-07;MX;Mexico;4580;378;799188;82726
2020-10-08;MX;Mexico;5300;370;804488;83096
2020-10-09;MX;Mexico;5532;401;810020;83497
2020-10-10;MX;Mexico;4308;145;814328;83642
2020-10-11;MX;Mexico;3175;139;817503;83781
2020-10-12;MX;Mexico;3542;164;821045;83945
2020-10-13;MX;Mexico;4295;475;825340;84420
2020-10-14;MX;Mexico;4056;478;829396;84898
2020-10-15;MX;Mexico;5514;387;834910;85285
2020-10-16;MX;Mexico;6751;419;841661;85704
2020-10-17;MX;Mexico;5447;355;847108;86059
2020-10-18;MX;Mexico;4119;108;851227;86167
2020-10-19;MX;Mexico;3699;171;854926;86338
2020-10-20;MX;Mexico;5788;555;860714;86893
2020-10-21;MX;Mexico;6845;522;867559;87415
2020-10-22;MX;Mexico;6612;0;874171;87415
2020-10-23;MX;Mexico;6604;897;880775;88312
2020-10-24;MX;Mexico;6025;431;886800;88743
2020-10-25;MX;Mexico;4360;181;891160;88924
2020-10-26;MX;Mexico;4166;247;895326;89171
2020-10-27;MX;Mexico;5942;643;901268;89814
2020-10-28;MX;Mexico;5595;495;906863;90309
2020-10-29;MX;Mexico;5948;464;912811;90773
2020-10-30;MX;Mexico;6000;516;918811;91289
2020-10-31;MX;Mexico;6151;464;924962;91753
2020-11-01;MX;Mexico;4430;142;929392;91895
2020-11-02;MX;Mexico;3763;205;933155;92100
2020-11-03;MX;Mexico;5250;493;938405;92593
2020-11-04;MX;Mexico;5225;635;943630;93228
2020-11-05;MX;Mexico;5567;544;949197;93772
2020-11-06;MX;Mexico;5931;551;955128;94323
2020-11-07;MX;Mexico;6810;485;961938;94808
2020-11-08;MX;Mexico;5887;219;967825;95027
2020-11-09;MX;Mexico;4960;198;972785;95225
2020-11-10;MX;Mexico;5746;617;978531;95842
2020-11-11;MX;Mexico;7646;588;986177;96430
2020-11-12;MX;Mexico;5658;626;991835;97056
2020-11-13;MX;Mexico;5558;568;997393;97624
2020-11-14;MX;Mexico;5860;635;1003253;98259
2020-11-15;MX;Mexico;3269;283;1006522;98542
2020-11-16;MX;Mexico;2874;319;1009396;98861
2020-11-17;MX;Mexico;1757;165;1011153;99026
2020-11-18;MX;Mexico;3918;502;1015071;99528
2020-11-19;MX;Mexico;4472;576;1019543;100104
2020-11-20;MX;Mexico;6426;719;1025969;100823
2020-11-21;MX;Mexico;6719;550;1032688;101373
2020-11-22;MX;Mexico;9187;303;1041875;101676
2020-11-23;MX;Mexico;7483;250;1049358;101926
2020-11-24;MX;Mexico;10794;813;1060152;102739
2020-11-25;MX;Mexico;10335;858;1070487;103597
2020-11-26;MX;Mexico;8107;645;1078594;104242
2020-11-27;MX;Mexico;12081;631;1090675;104873
2020-11-28;MX;Mexico;10728;586;1101403;105459
2020-11-29;MX;Mexico;5668;196;1107071;105655
2020-11-30;MX;Mexico;6472;285;1113543;105940
2020-12-01;MX;Mexico;8819;825;1122362;106765
2020-12-02;MX;Mexico;11251;800;1133613;107565
2020-12-03;MX;Mexico;11030;608;1144643;108173
2020-12-04;MX;Mexico;12127;690;1156770;108863
2020-12-05;MX;Mexico;11625;593;1168395;109456
2020-12-06;MX;Mexico;7455;261;1175850;109717
2020-12-07;MX;Mexico;6399;357;1182249;110074
2020-12-08;MX;Mexico;11006;800;1193255;110874
2020-12-09;MX;Mexico;11974;781;1205229;111655
2020-12-10;MX;Mexico;11897;671;1217126;112326
2020-12-11;MX;Mexico;12253;693;1229379;113019
2020-12-12;MX;Mexico;12057;685;1241436;113704
2020-12-13;MX;Mexico;8608;249;1250044;113953
2020-12-14;MX;Mexico;5930;345;1255974;114298
2020-12-15;MX;Mexico;11228;801;1267202;115099
2020-12-16;MX;Mexico;10297;670;1277499;115769
2020-12-17;MX;Mexico;11799;718;1289298;116487
2020-12-18;MX;Mexico;12248;762;1301546;117249
2020-12-19;MX;Mexico;12129;627;1313675;117876
2020-12-20;MX;Mexico;6870;326;1320545;118202
2020-12-21;MX;Mexico;5370;396;1325915;118598
2020-12-22;MX;Mexico;12511;897;1338426;119495
2020-12-23;MX;Mexico;11653;816;1350079;120311
2020-12-24;MX;Mexico;12485;861;1362564;121172
2020-12-25;MX;Mexico;9679;665;1372243;121837
2020-12-26;MX;Mexico;4974;189;1377217;122026
2020-12-27;MX;Mexico;6217;400;1383434;122426
2020-12-28;MX;Mexico;5996;429;1389430;122855
2020-12-29;MX;Mexico;12099;990;1401529;123845
2020-12-30;MX;Mexico;12406;1052;1413935;124897
2020-12-31;MX;Mexico;12159;910;1426094;125807
2021-01-01;MX;Mexico;11091;700;1437185;126507
2021-01-02;MX;Mexico;6359;344;1443544;126851
2021-01-03;MX;Mexico;5211;362;1448755;127213
2021-01-04;MX;Mexico;6464;544;1455219;127757
2021-01-05;MX;Mexico;11271;1065;1466490;128822
2021-01-06;MX;Mexico;13345;1165;1479835;129987
2021-01-07;MX;Mexico;13734;1044;1493569;131031
2021-01-08;MX;Mexico;14362;1038;1507931;132069
2021-01-09;MX;Mexico;16105;1135;1524036;133204
2021-01-10;MX;Mexico;10003;502;1534039;133706
2021-01-11;MX;Mexico;7594;662;1541633;134368
2021-01-12;MX;Mexico;14395;1314;1556028;135682
2021-01-13;MX;Mexico;15873;1235;1571901;136917
2021-01-14;MX;Mexico;16468;999;1588369;137916
2021-01-15;MX;Mexico;21366;1106;1609735;139022
2021-01-16;MX;Mexico;20523;1219;1630258;140241
2021-01-17;MX;Mexico;11170;463;1641428;140704
2021-01-18;MX;Mexico;8074;544;1649502;141248
2021-01-19;MX;Mexico;18894;1584;1668396;142832
2021-01-20;MX;Mexico;20548;1539;1688944;144371
2021-01-21;MX;Mexico;22339;1803;1711283;146174
2021-01-22;MX;Mexico;21007;1440;1732290;147614
2021-01-23;MX;Mexico;20057;1470;1752347;149084
2021-01-24;MX;Mexico;10872;530;1763219;149614
2021-01-25;MX;Mexico;8521;659;1771740;150273
2021-01-26;MX;Mexico;17165;1743;1788905;152016
2021-01-27;MX;Mexico;17944;1623;1806849;153639
2021-01-28;MX;Mexico;18670;1506;1825519;155145
2021-01-29;MX;Mexico;16374;1434;1841893;156579
2021-01-30;MX;Mexico;15337;1495;1857230;158074
2021-01-31;MX;Mexico;7030;462;1864260;158536
2021-02-01;MX;Mexico;5448;564;1869708;159100
2021-02-02;MX;Mexico;4384;433;1874092;159533
2021-02-03;MX;Mexico;12153;1707;1886245;161240
2021-02-04;MX;Mexico;0;0;1886245;161240
2021-02-05;MX;Mexico;26626;3050;1912871;164290
2021-02-06;MX;Mexico;13209;1496;1926080;165786
2021-02-07;MX;Mexico;6065;414;1932145;166200
2021-02-08;MX;Mexico;3868;531;1936013;166731
2021-02-09;MX;Mexico;10738;1701;1946751;168432
2021-02-10;MX;Mexico;11138;1328;1957889;169760
2021-02-11;MX;Mexico;10677;1474;1968566;171234
2021-02-12;MX;Mexico;10388;1323;1978954;172557
2021-02-13;MX;Mexico;9741;1214;1988695;173771
2021-02-14;MX;Mexico;4099;436;1992794;174207
2021-02-15;MX;Mexico;3098;450;1995892;174657
2021-02-16;MX;Mexico;8683;1329;2004575;175986
2021-02-17;MX;Mexico;8988;1075;2013563;177061
2021-02-18;MX;Mexico;9099;1047;2022662;178108
2021-02-19;MX;Mexico;7829;857;2030491;178965
2021-02-20;MX;Mexico;7785;832;2038276;179797
2021-02-21;MX;Mexico;3104;310;2041380;180107
2021-02-22;MX;Mexico;2252;429;2043632;180536
2021-02-23;MX;Mexico;8634;1273;2052266;181809
2021-02-24;MX;Mexico;8642;1006;2060908;182815
2021-02-25;MX;Mexico;8462;877;2069370;183692
2021-02-26;MX;Mexico;7512;782;2076882;184474
2021-02-27;MX;Mexico;7246;783;2084128;185257
2021-02-28;MX;Mexico;2810;458;2086938;185715
2021-03-01;MX;Mexico;2343;437;2089281;186152
2021-03-02;MX;Mexico;7913;1035;2097194;187187
2021-03-03;MX;Mexico;7793;857;2104987;188044
2021-03-04;MX;Mexico;7521;822;2112508;188866
2021-03-05;MX;Mexico;6797;712;2119305;189578
2021-03-06;MX;Mexico;6561;779;2125866;190357
2021-03-07;MX;Mexico;2734;247;2128600;190604
2021-03-08;MX;Mexico;1877;319;2130477;190923
2021-03-09;MX;Mexico;7407;866;2137884;191789
2021-03-10;MX;Mexico;6602;702;2144486;192491
2021-03-11;MX;Mexico;6469;661;2150955;193152
2021-03-12;MX;Mexico;6816;699;2157771;193851
2021-03-13;MX;Mexico;6104;639;2163875;194490
2021-03-14;MX;Mexico;2415;220;2166290;194710
2021-03-15;MX;Mexico;1439;234;2167729;194944
2021-03-16;MX;Mexico;1278;175;2169007;195119
2021-03-17;MX;Mexico;6455;789;2175462;195908
2021-03-18;MX;Mexico;6726;698;2182188;196606
2021-03-19;MX;Mexico;5722;613;2187910;197219
2021-03-20;MX;Mexico;5729;608;2193639;197827
2021-03-21;MX;Mexico;2133;209;2195772;198036
2021-03-22;MX;Mexico;1388;203;2197160;198239
2021-03-23;MX;Mexico;5881;809;2203041;199048
2021-03-24;MX;Mexico;5714;579;2208755;199627
2021-03-25;MX;Mexico;5787;584;2214542;200211
2021-03-26;MX;Mexico;5303;651;2219845;200862
2021-03-27;MX;Mexico;5059;567;2224904;201429
2021-03-28;MX;Mexico;1646;194;2226550;201623
2021-03-29;MX;Mexico;1293;209;2227843;201832
2021-03-30;MX;Mexico;5067;801;2232910;202633
2021-03-31;MX;Mexico;5977;577;2238887;203210
2021-04-01;MX;Mexico;5381;454;2244268;203664
2021-04-02;MX;Mexico;3089;190;2247357;203854
2021-04-03;MX;Mexico;1838;157;2249195;204011
2021-04-04;MX;Mexico;1263;136;2250458;204147
2021-04-05;MX;Mexico;1247;252;2251705;204399
2021-04-06;MX;Mexico;4804;586;2256509;204985
2021-04-07;MX;Mexico;5370;613;2261879;205598
2021-04-08;MX;Mexico;5140;548;2267019;206146
2021-04-09;MX;Mexico;5045;874;2272064;207020
2021-04-10;MX;Mexico;6356;2192;2278420;209212
2021-04-11;MX;Mexico;1793;126;2280213;209338
2021-04-12;MX;Mexico;1627;364;2281840;209702
2021-04-13;MX;Mexico;4512;580;2286352;210282
2021-04-14;MX;Mexico;4894;530;2291246;210812
2021-04-15;MX;Mexico;4189;401;2295435;211213
2021-04-16;MX;Mexico;4504;480;2299939;211693
2021-04-17;MX;Mexico;4157;535;2304096;212228
2021-04-18;MX;Mexico;1506;111;2305602;212339
2021-04-19;MX;Mexico;1308;127;2306910;212466
2021-04-20;MX;Mexico;4262;582;2311172;213048
2021-04-21;MX;Mexico;4639;549;2315811;213597
2021-04-22;MX;Mexico;3708;498;2319519;214095
2021-04-23;MX;Mexico;3911;409;2323430;214504
2021-04-24;MX;Mexico;3308;349;2326738;214853
2021-04-25;MX;Mexico;1653;94;2328391;214947
2021-04-26;MX;Mexico;1143;166;2329534;215113
2021-04-27;MX;Mexico;3592;434;2333126;215547
2021-04-28;MX;Mexico;3818;371;2336944;215918
2021-04-29;MX;Mexico;3990;529;2340934;216447
2021-04-30;MX;Mexico;3821;460;2344755;216907
2021-05-01;MX;Mexico;3025;261;2347780;217168
2021-05-02;MX;Mexico;1093;65;2348873;217233
2021-05-03;MX;Mexico;1027;112;2349900;217345
2021-05-04;MX;Mexico;3064;395;2352964;217740
2021-05-05;MX;Mexico;3021;267;2355985;218007
2021-05-06;MX;Mexico;2846;166;2358831;218173
2021-05-07;MX;Mexico;3043;484;2361874;218657
2021-05-08;MX;Mexico;2743;271;2364617;218928
2021-05-09;MX;Mexico;1175;57;2365792;218985
2021-05-10;MX;Mexico;704;104;2366496;219089
2021-05-11;MX;Mexico;1897;234;2368393;219323
2021-05-12;MX;Mexico;3090;267;2371483;219590
2021-05-13;MX;Mexico;3632;311;2375115;219901
2021-05-14;MX;Mexico;2880;258;2377995;220159
2021-05-15;MX;Mexico;2695;225;2380690;220384
2021-05-16;MX;Mexico;1233;53;2381923;220437
2021-05-17;MX;Mexico;822;56;2382745;220493
2021-05-18;MX;Mexico;2767;253;2385512;220746
2021-05-19;MX;Mexico;2000;104;2387512;220850
2021-05-20;MX;Mexico;2628;230;2390140;221080
2021-05-21;MX;Mexico;2604;176;2392744;221256
2021-05-22;MX;Mexico;2586;341;2395330;221597
2021-05-23;MX;Mexico;1274;50;2396604;221647
2021-05-24;MX;Mexico;703;48;2397307;221695
2021-05-25;MX;Mexico;2483;265;2399790;221960
2021-05-26;MX;Mexico;2932;272;2402722;222232
2021-05-27;MX;Mexico;3050;429;2405772;222661
2021-05-28;MX;Mexico;3006;411;2408778;223072
2021-05-29;MX;Mexico;2725;383;2411503;223455
2021-05-30;MX;Mexico;1307;52;2412810;223507
2021-05-31;MX;Mexico;932;61;2413742;223568
2021-06-01;MX;Mexico;6917;4272;2420659;227840
2021-06-02;MX;Mexico;3269;306;2423928;228146
2021-06-03;MX;Mexico;2894;216;2426822;228362
2021-06-04;MX;Mexico;2809;206;2429631;228568
2021-06-05;MX;Mexico;2071;190;2431702;228758
2021-06-06;MX;Mexico;1979;46;2433681;228804
2021-06-07;MX;Mexico;881;34;2434562;228838
2021-06-08;MX;Mexico;3449;262;2438011;229100
2021-06-09;MX;Mexico;3855;253;2441866;229353
2021-06-10;MX;Mexico;3672;227;2445538;229580
2021-06-11;MX;Mexico;3282;243;2448820;229823
2021-06-12;MX;Mexico;3649;274;2452469;230097
2021-06-13;MX;Mexico;1707;53;2454176;230150
2021-06-14;MX;Mexico;1175;37;2455351;230187
2021-06-15;MX;Mexico;4250;241;2459601;230428
2021-06-16;MX;Mexico;3789;196;2463390;230624
2021-06-17;MX;Mexico;4253;168;2467643;230792
2021-06-18;MX;Mexico;4098;167;2471741;230959
2021-06-19;MX;Mexico;0;0;2471741;230959
2021-06-20;MX;Mexico;5542;228;2477283;231187
2021-06-21;MX;Mexico;1268;57;2478551;231244
2021-06-22;MX;Mexico;4233;261;2482784;231505
2021-06-23;MX;Mexico;4963;342;2487747;231847
2021-06-24;MX;Mexico;5340;221;2493087;232068
2021-06-25;MX;Mexico;5270;278;2498357;232346
2021-06-26;MX;Mexico;5051;175;2503408;232521
2021-06-27;MX;Mexico;2384;43;2505792;232564
2021-06-28;MX;Mexico;1661;44;2507453;232608
2021-06-29;MX;Mexico;5711;195;2513164;232803
2021-06-30;MX;Mexico;6105;244;2519269;233047
2021-07-01;MX;Mexico;6081;201;2525350;233248
2021-01-21;FM;Micronesia (country);1;0;1;0
2021-01-22;FM;Micronesia (country);0;0;1;0
2021-01-23;FM;Micronesia (country);0;0;1;0
2021-01-24;FM;Micronesia (country);0;0;1;0
2021-01-25;FM;Micronesia (country);0;0;1;0
2021-01-26;FM;Micronesia (country);0;0;1;0
2021-01-27;FM;Micronesia (country);0;0;1;0
2021-01-28;FM;Micronesia (country);0;0;1;0
2021-01-29;FM;Micronesia (country);0;0;1;0
2021-01-30;FM;Micronesia (country);0;0;1;0
2021-01-31;FM;Micronesia (country);0;0;1;0
2021-02-01;FM;Micronesia (country);0;0;1;0
2021-02-02;FM;Micronesia (country);0;0;1;0
2021-02-03;FM;Micronesia (country);0;0;1;0
2021-02-04;FM;Micronesia (country);0;0;1;0
2021-02-05;FM;Micronesia (country);0;0;1;0
2021-02-06;FM;Micronesia (country);0;0;1;0
2021-02-07;FM;Micronesia (country);0;0;1;0
2021-02-08;FM;Micronesia (country);0;0;1;0
2021-02-09;FM;Micronesia (country);0;0;1;0
2021-02-10;FM;Micronesia (country);0;0;1;0
2021-02-11;FM;Micronesia (country);0;0;1;0
2021-02-12;FM;Micronesia (country);0;0;1;0
2021-02-13;FM;Micronesia (country);0;0;1;0
2021-02-14;FM;Micronesia (country);0;0;1;0
2021-02-15;FM;Micronesia (country);0;0;1;0
2021-02-16;FM;Micronesia (country);0;0;1;0
2021-02-17;FM;Micronesia (country);0;0;1;0
2021-02-18;FM;Micronesia (country);0;0;1;0
2021-02-19;FM;Micronesia (country);0;0;1;0
2021-02-20;FM;Micronesia (country);0;0;1;0
2021-02-21;FM;Micronesia (country);0;0;1;0
2021-02-22;FM;Micronesia (country);0;0;1;0
2021-02-23;FM;Micronesia (country);0;0;1;0
2021-02-24;FM;Micronesia (country);0;0;1;0
2021-02-25;FM;Micronesia (country);0;0;1;0
2021-02-26;FM;Micronesia (country);0;0;1;0
2021-02-27;FM;Micronesia (country);0;0;1;0
2021-02-28;FM;Micronesia (country);0;0;1;0
2021-03-01;FM;Micronesia (country);0;0;1;0
2021-03-02;FM;Micronesia (country);0;0;1;0
2021-03-03;FM;Micronesia (country);0;0;1;0
2021-03-04;FM;Micronesia (country);0;0;1;0
2021-03-05;FM;Micronesia (country);0;0;1;0
2021-03-06;FM;Micronesia (country);0;0;1;0
2021-03-07;FM;Micronesia (country);0;0;1;0
2021-03-08;FM;Micronesia (country);0;0;1;0
2021-03-09;FM;Micronesia (country);0;0;1;0
2021-03-10;FM;Micronesia (country);0;0;1;0
2021-03-11;FM;Micronesia (country);0;0;1;0
2021-03-12;FM;Micronesia (country);0;0;1;0
2021-03-13;FM;Micronesia (country);0;0;1;0
2021-03-14;FM;Micronesia (country);0;0;1;0
2021-03-15;FM;Micronesia (country);0;0;1;0
2021-03-16;FM;Micronesia (country);0;0;1;0
2021-03-17;FM;Micronesia (country);0;0;1;0
2021-03-18;FM;Micronesia (country);0;0;1;0
2021-03-19;FM;Micronesia (country);0;0;1;0
2021-03-20;FM;Micronesia (country);0;0;1;0
2021-03-21;FM;Micronesia (country);0;0;1;0
2021-03-22;FM;Micronesia (country);0;0;1;0
2021-03-23;FM;Micronesia (country);0;0;1;0
2021-03-24;FM;Micronesia (country);0;0;1;0
2021-03-25;FM;Micronesia (country);0;0;1;0
2021-03-26;FM;Micronesia (country);0;0;1;0
2021-03-27;FM;Micronesia (country);0;0;1;0
2021-03-28;FM;Micronesia (country);0;0;1;0
2021-03-29;FM;Micronesia (country);0;0;1;0
2021-03-30;FM;Micronesia (country);0;0;1;0
2021-03-31;FM;Micronesia (country);0;0;1;0
2021-04-01;FM;Micronesia (country);0;0;1;0
2021-04-02;FM;Micronesia (country);0;0;1;0
2021-04-03;FM;Micronesia (country);0;0;1;0
2021-04-04;FM;Micronesia (country);0;0;1;0
2021-04-05;FM;Micronesia (country);0;0;1;0
2021-04-06;FM;Micronesia (country);0;0;1;0
2021-04-07;FM;Micronesia (country);0;0;1;0
2021-04-08;FM;Micronesia (country);0;0;1;0
2021-04-09;FM;Micronesia (country);0;0;1;0
2021-04-10;FM;Micronesia (country);0;0;1;0
2021-04-11;FM;Micronesia (country);0;0;1;0
2021-04-12;FM;Micronesia (country);0;0;1;0
2021-04-13;FM;Micronesia (country);0;0;1;0
2021-04-14;FM;Micronesia (country);0;0;1;0
2021-04-15;FM;Micronesia (country);0;0;1;0
2021-04-16;FM;Micronesia (country);0;0;1;0
2021-04-17;FM;Micronesia (country);0;0;1;0
2021-04-18;FM;Micronesia (country);0;0;1;0
2021-04-19;FM;Micronesia (country);0;0;1;0
2021-04-20;FM;Micronesia (country);0;0;1;0
2021-04-21;FM;Micronesia (country);0;0;1;0
2021-04-22;FM;Micronesia (country);0;0;1;0
2021-04-23;FM;Micronesia (country);0;0;1;0
2021-04-24;FM;Micronesia (country);0;0;1;0
2021-04-25;FM;Micronesia (country);0;0;1;0
2021-04-26;FM;Micronesia (country);0;0;1;0
2021-04-27;FM;Micronesia (country);0;0;1;0
2021-04-28;FM;Micronesia (country);0;0;1;0
2021-04-29;FM;Micronesia (country);0;0;1;0
2021-04-30;FM;Micronesia (country);0;0;1;0
2021-05-01;FM;Micronesia (country);0;0;1;0
2021-05-02;FM;Micronesia (country);0;0;1;0
2021-05-03;FM;Micronesia (country);0;0;1;0
2021-05-04;FM;Micronesia (country);0;0;1;0
2021-05-05;FM;Micronesia (country);0;0;1;0
2021-05-06;FM;Micronesia (country);0;0;1;0
2021-05-07;FM;Micronesia (country);0;0;1;0
2021-05-08;FM;Micronesia (country);0;0;1;0
2021-05-09;FM;Micronesia (country);0;0;1;0
2021-05-10;FM;Micronesia (country);0;0;1;0
2021-05-11;FM;Micronesia (country);0;0;1;0
2021-05-12;FM;Micronesia (country);0;0;1;0
2021-05-13;FM;Micronesia (country);0;0;1;0
2021-05-14;FM;Micronesia (country);0;0;1;0
2021-05-15;FM;Micronesia (country);0;0;1;0
2021-05-16;FM;Micronesia (country);0;0;1;0
2021-05-17;FM;Micronesia (country);0;0;1;0
2021-05-18;FM;Micronesia (country);0;0;1;0
2021-05-19;FM;Micronesia (country);0;0;1;0
2021-05-20;FM;Micronesia (country);0;0;1;0
2021-05-21;FM;Micronesia (country);0;0;1;0
2021-05-22;FM;Micronesia (country);0;0;1;0
2021-05-23;FM;Micronesia (country);0;0;1;0
2021-05-24;FM;Micronesia (country);0;0;1;0
2021-05-25;FM;Micronesia (country);0;0;1;0
2021-05-26;FM;Micronesia (country);0;0;1;0
2021-05-27;FM;Micronesia (country);0;0;1;0
2021-05-28;FM;Micronesia (country);0;0;1;0
2021-05-29;FM;Micronesia (country);0;0;1;0
2021-05-30;FM;Micronesia (country);0;0;1;0
2021-05-31;FM;Micronesia (country);0;0;1;0
2021-06-01;FM;Micronesia (country);0;0;1;0
2021-06-02;FM;Micronesia (country);0;0;1;0
2021-06-03;FM;Micronesia (country);0;0;1;0
2021-06-04;FM;Micronesia (country);0;0;1;0
2021-06-05;FM;Micronesia (country);0;0;1;0
2021-06-06;FM;Micronesia (country);0;0;1;0
2021-06-07;FM;Micronesia (country);0;0;1;0
2021-06-08;FM;Micronesia (country);0;0;1;0
2021-06-09;FM;Micronesia (country);0;0;1;0
2021-06-10;FM;Micronesia (country);0;0;1;0
2021-06-11;FM;Micronesia (country);0;0;1;0
2021-06-12;FM;Micronesia (country);0;0;1;0
2021-06-13;FM;Micronesia (country);0;0;1;0
2021-06-14;FM;Micronesia (country);0;0;1;0
2021-06-15;FM;Micronesia (country);0;0;1;0
2021-06-16;FM;Micronesia (country);0;0;1;0
2021-06-17;FM;Micronesia (country);0;0;1;0
2021-06-18;FM;Micronesia (country);0;0;1;0
2021-06-19;FM;Micronesia (country);0;0;1;0
2021-06-20;FM;Micronesia (country);0;0;1;0
2021-06-21;FM;Micronesia (country);0;0;1;0
2021-06-22;FM;Micronesia (country);0;0;1;0
2021-06-23;FM;Micronesia (country);0;0;1;0
2021-06-24;FM;Micronesia (country);0;0;1;0
2021-06-25;FM;Micronesia (country);0;0;1;0
2021-06-26;FM;Micronesia (country);0;0;1;0
2021-06-27;FM;Micronesia (country);0;0;1;0
2021-06-28;FM;Micronesia (country);0;0;1;0
2021-06-29;FM;Micronesia (country);0;0;1;0
2021-06-30;FM;Micronesia (country);0;0;1;0
2021-07-01;FM;Micronesia (country);0;0;1;0
2020-03-08;MD;Moldova;1;0;1;0
2020-03-09;MD;Moldova;0;0;1;0
2020-03-10;MD;Moldova;2;0;3;0
2020-03-11;MD;Moldova;0;0;3;0
2020-03-12;MD;Moldova;0;0;3;0
2020-03-13;MD;Moldova;3;0;6;0
2020-03-14;MD;Moldova;6;0;12;0
2020-03-15;MD;Moldova;11;0;23;0
2020-03-16;MD;Moldova;0;0;23;0
2020-03-17;MD;Moldova;7;0;30;0
2020-03-18;MD;Moldova;0;1;30;1
2020-03-19;MD;Moldova;19;0;49;1
2020-03-20;MD;Moldova;17;0;66;1
2020-03-21;MD;Moldova;14;0;80;1
2020-03-22;MD;Moldova;14;0;94;1
2020-03-23;MD;Moldova;15;0;109;1
2020-03-24;MD;Moldova;16;0;125;1
2020-03-25;MD;Moldova;24;0;149;1
2020-03-26;MD;Moldova;28;0;177;1
2020-03-27;MD;Moldova;22;1;199;2
2020-03-28;MD;Moldova;32;0;231;2
2020-03-29;MD;Moldova;32;0;263;2
2020-03-30;MD;Moldova;35;0;298;2
2020-03-31;MD;Moldova;55;2;353;4
2020-04-01;MD;Moldova;70;1;423;5
2020-04-02;MD;Moldova;82;1;505;6
2020-04-03;MD;Moldova;86;2;591;8
2020-04-04;MD;Moldova;161;4;752;12
2020-04-05;MD;Moldova;112;3;864;15
2020-04-06;MD;Moldova;101;4;965;19
2020-04-07;MD;Moldova;91;3;1056;22
2020-04-08;MD;Moldova;118;5;1174;27
2020-04-09;MD;Moldova;115;2;1289;29
2020-04-10;MD;Moldova;149;0;1438;29
2020-04-11;MD;Moldova;122;1;1560;30
2020-04-12;MD;Moldova;102;1;1662;31
2020-04-13;MD;Moldova;50;4;1712;35
2020-04-14;MD;Moldova;222;5;1934;40
2020-04-15;MD;Moldova;115;6;2049;46
2020-04-16;MD;Moldova;105;8;2154;54
2020-04-17;MD;Moldova;110;2;2264;56
2020-04-18;MD;Moldova;114;1;2378;57
2020-04-19;MD;Moldova;94;10;2472;67
2020-04-20;MD;Moldova;76;3;2548;70
2020-04-21;MD;Moldova;66;2;2614;72
2020-04-22;MD;Moldova;164;3;2778;75
2020-04-23;MD;Moldova;148;5;2926;80
2020-04-24;MD;Moldova;184;4;3110;84
2020-04-25;MD;Moldova;194;10;3304;94
2020-04-26;MD;Moldova;104;2;3408;96
2020-04-27;MD;Moldova;73;6;3481;102
2020-04-28;MD;Moldova;157;1;3638;103
2020-04-29;MD;Moldova;133;8;3771;111
2020-04-30;MD;Moldova;126;5;3897;116
2020-05-01;MD;Moldova;83;6;3980;122
2020-05-02;MD;Moldova;72;2;4052;124
2020-05-03;MD;Moldova;69;1;4121;125
2020-05-04;MD;Moldova;127;7;4248;132
2020-05-05;MD;Moldova;115;4;4363;136
2020-05-06;MD;Moldova;113;7;4476;143
2020-05-07;MD;Moldova;129;2;4605;145
2020-05-08;MD;Moldova;123;5;4728;150
2020-05-09;MD;Moldova;139;11;4867;161
2020-05-10;MD;Moldova;60;8;4927;169
2020-05-11;MD;Moldova;68;6;4995;175
2020-05-12;MD;Moldova;159;7;5154;182
2020-05-13;MD;Moldova;252;3;5406;185
2020-05-14;MD;Moldova;147;9;5553;194
2020-05-15;MD;Moldova;192;8;5745;202
2020-05-16;MD;Moldova;189;5;5934;207
2020-05-17;MD;Moldova;126;4;6060;211
2020-05-18;MD;Moldova;78;6;6138;217
2020-05-19;MD;Moldova;202;4;6340;221
2020-05-20;MD;Moldova;213;7;6553;228
2020-05-21;MD;Moldova;151;5;6704;233
2020-05-22;MD;Moldova;143;4;6847;237
2020-05-23;MD;Moldova;147;5;6994;242
2020-05-24;MD;Moldova;99;8;7093;250
2020-05-25;MD;Moldova;54;11;7147;261
2020-05-26;MD;Moldova;158;6;7305;267
2020-05-27;MD;Moldova;232;7;7537;274
2020-05-28;MD;Moldova;188;8;7725;282
2020-05-29;MD;Moldova;171;6;7896;288
2020-05-30;MD;Moldova;202;3;8098;291
2020-05-31;MD;Moldova;153;4;8251;295
2020-06-01;MD;Moldova;109;10;8360;305
2020-06-02;MD;Moldova;188;2;8548;307
2020-06-03;MD;Moldova;247;3;8795;310
2020-06-04;MD;Moldova;223;5;9018;315
2020-06-05;MD;Moldova;229;8;9247;323
2020-06-06;MD;Moldova;264;8;9511;331
2020-06-07;MD;Moldova;189;10;9700;341
2020-06-08;MD;Moldova;107;12;9807;353
2020-06-09;MD;Moldova;218;12;10025;365
2020-06-10;MD;Moldova;296;6;10321;371
2020-06-11;MD;Moldova;406;4;10727;375
2020-06-12;MD;Moldova;366;10;11093;385
2020-06-13;MD;Moldova;366;13;11459;398
2020-06-14;MD;Moldova;281;8;11740;406
2020-06-15;MD;Moldova;139;5;11879;411
2020-06-16;MD;Moldova;375;12;12254;423
2020-06-17;MD;Moldova;478;10;12732;433
2020-06-18;MD;Moldova;374;11;13106;444
2020-06-19;MD;Moldova;450;6;13556;450
2020-06-20;MD;Moldova;397;14;13953;464
2020-06-21;MD;Moldova;247;9;14200;473
2020-06-22;MD;Moldova;163;7;14363;480
2020-06-23;MD;Moldova;351;10;14714;490
2020-06-24;MD;Moldova;364;5;15078;495
2020-06-25;MD;Moldova;375;7;15453;502
2020-06-26;MD;Moldova;323;13;15776;515
2020-06-27;MD;Moldova;304;6;16080;521
2020-06-28;MD;Moldova;170;9;16250;530
2020-06-29;MD;Moldova;107;6;16357;536
2020-06-30;MD;Moldova;256;9;16613;545
2020-07-01;MD;Moldova;285;4;16898;549
2020-07-02;MD;Moldova;252;11;17150;560
2020-07-03;MD;Moldova;295;12;17445;572
2020-07-04;MD;Moldova;227;8;17672;580
2020-07-05;MD;Moldova;142;5;17814;585
2020-07-06;MD;Moldova;92;7;17906;592
2020-07-07;MD;Moldova;235;11;18141;603
2020-07-08;MD;Moldova;330;11;18471;614
2020-07-09;MD;Moldova;195;10;18666;624
2020-07-10;MD;Moldova;258;11;18924;635
2020-07-11;MD;Moldova;284;5;19208;640
2020-07-12;MD;Moldova;174;2;19382;642
2020-07-13;MD;Moldova;57;7;19439;649
2020-07-14;MD;Moldova;269;6;19708;655
2020-07-15;MD;Moldova;332;4;20040;659
2020-07-16;MD;Moldova;224;7;20264;666
2020-07-17;MD;Moldova;230;9;20494;675
2020-07-18;MD;Moldova;300;5;20794;680
2020-07-19;MD;Moldova;186;4;20980;684
2020-07-20;MD;Moldova;135;11;21115;695
2020-07-21;MD;Moldova;327;12;21442;707
2020-07-22;MD;Moldova;356;5;21798;712
2020-07-23;MD;Moldova;307;7;22105;719
2020-07-24;MD;Moldova;378;7;22483;726
2020-07-25;MD;Moldova;345;6;22828;732
2020-07-26;MD;Moldova;206;3;23034;735
2020-07-27;MD;Moldova;120;13;23154;748
2020-07-28;MD;Moldova;367;5;23521;753
2020-07-29;MD;Moldova;426;6;23947;759
2020-07-30;MD;Moldova;396;12;24343;771
2020-07-31;MD;Moldova;390;7;24733;778
2020-08-01;MD;Moldova;380;10;25113;788
2020-08-02;MD;Moldova;249;3;25362;791
2020-08-03;MD;Moldova;120;9;25482;800
2020-08-04;MD;Moldova;332;10;25814;810
2020-08-05;MD;Moldova;408;13;26222;823
2020-08-06;MD;Moldova;406;5;26628;828
2020-08-07;MD;Moldova;362;7;26990;835
2020-08-08;MD;Moldova;453;6;27443;841
2020-08-09;MD;Moldova;217;4;27660;845
2020-08-10;MD;Moldova;181;5;27841;850
2020-08-11;MD;Moldova;382;7;28223;857
2020-08-12;MD;Moldova;474;6;28697;863
2020-08-13;MD;Moldova;390;15;29087;878
2020-08-14;MD;Moldova;396;6;29483;884
2020-08-15;MD;Moldova;422;11;29905;895
2020-08-16;MD;Moldova;278;1;30183;896
2020-08-17;MD;Moldova;194;12;30377;908
2020-08-18;MD;Moldova;412;0;30789;908
2020-08-19;MD;Moldova;626;6;31415;914
2020-08-20;MD;Moldova;522;7;31937;921
2020-08-21;MD;Moldova;547;8;32484;929
2020-08-22;MD;Moldova;588;6;33072;935
2020-08-23;MD;Moldova;406;5;33478;940
2020-08-24;MD;Moldova;350;5;33828;945
2020-08-25;MD;Moldova;530;15;34358;960
2020-08-26;MD;Moldova;624;7;34982;967
2020-08-27;MD;Moldova;564;10;35546;977
2020-08-28;MD;Moldova;358;4;35904;981
2020-08-29;MD;Moldova;500;9;36404;990
2020-08-30;MD;Moldova;296;2;36700;992
2020-08-31;MD;Moldova;220;3;36920;995
2020-09-01;MD;Moldova;288;13;37208;1008
2020-09-02;MD;Moldova;532;16;37740;1024
2020-09-03;MD;Moldova;632;12;38372;1036
2020-09-04;MD;Moldova;534;11;38906;1047
2020-09-05;MD;Moldova;567;16;39473;1063
2020-09-06;MD;Moldova;324;0;39797;1063
2020-09-07;MD;Moldova;258;11;40055;1074
2020-09-08;MD;Moldova;501;13;40556;1087
2020-09-09;MD;Moldova;588;9;41144;1096
2020-09-10;MD;Moldova;560;10;41704;1106
2020-09-11;MD;Moldova;479;8;42183;1114
2020-09-12;MD;Moldova;531;3;42714;1117
2020-09-13;MD;Moldova;264;6;42978;1123
2020-09-14;MD;Moldova;229;6;43207;1129
2020-09-15;MD;Moldova;527;14;43734;1143
2020-09-16;MD;Moldova;627;16;44361;1159
2020-09-17;MD;Moldova;622;11;44983;1170
2020-09-18;MD;Moldova;665;16;45648;1186
2020-09-19;MD;Moldova;688;15;46336;1201
2020-09-20;MD;Moldova;260;2;46596;1203
2020-09-21;MD;Moldova;200;8;46796;1211
2020-09-22;MD;Moldova;650;19;47446;1230
2020-09-23;MD;Moldova;786;14;48232;1244
2020-09-24;MD;Moldova;721;8;48953;1252
2020-09-25;MD;Moldova;713;12;49666;1264
2020-09-26;MD;Moldova;868;15;50534;1279
2020-09-27;MD;Moldova;341;8;50875;1287
2020-09-28;MD;Moldova;319;14;51194;1301
2020-09-29;MD;Moldova;835;9;52029;1310
2020-09-30;MD;Moldova;1013;10;53042;1320
2020-10-01;MD;Moldova;1022;16;54064;1336
2020-10-02;MD;Moldova;952;8;55016;1344
2020-10-03;MD;Moldova;872;9;55888;1353
2020-10-04;MD;Moldova;691;13;56579;1366
2020-10-05;MD;Moldova;322;9;56901;1375
2020-10-06;MD;Moldova;831;14;57732;1389
2020-10-07;MD;Moldova;1062;17;58794;1406
2020-10-08;MD;Moldova;1121;18;59915;1424
2020-10-09;MD;Moldova;918;18;60833;1442
2020-10-10;MD;Moldova;929;16;61762;1458
2020-10-11;MD;Moldova;389;3;62151;1461
2020-10-12;MD;Moldova;467;17;62618;1478
2020-10-13;MD;Moldova;657;17;63275;1495
2020-10-14;MD;Moldova;1149;19;64424;1514
2020-10-15;MD;Moldova;652;16;65076;1530
2020-10-16;MD;Moldova;784;19;65860;1549
2020-10-17;MD;Moldova;792;20;66652;1569
2020-10-18;MD;Moldova;398;15;67050;1584
2020-10-19;MD;Moldova;252;16;67302;1600
2020-10-20;MD;Moldova;656;17;67958;1617
2020-10-21;MD;Moldova;833;13;68791;1630
2020-10-22;MD;Moldova;777;11;69568;1641
2020-10-23;MD;Moldova;688;13;70256;1654
2020-10-24;MD;Moldova;833;15;71089;1669
2020-10-25;MD;Moldova;414;16;71503;1685
2020-10-26;MD;Moldova;308;15;71811;1700
2020-10-27;MD;Moldova;649;10;72460;1710
2020-10-28;MD;Moldova;861;19;73321;1729
2020-10-29;MD;Moldova;912;18;74233;1747
2020-10-30;MD;Moldova;968;19;75201;1766
2020-10-31;MD;Moldova;839;19;76040;1785
2020-11-01;MD;Moldova;542;15;76582;1800
2020-11-02;MD;Moldova;195;18;76777;1818
2020-11-03;MD;Moldova;710;20;77487;1838
2020-11-04;MD;Moldova;1020;13;78507;1851
2020-11-05;MD;Moldova;1059;15;79566;1866
2020-11-06;MD;Moldova;935;16;80501;1882
2020-11-07;MD;Moldova;1174;9;81675;1891
2020-11-08;MD;Moldova;671;2;82346;1893
2020-11-09;MD;Moldova;331;19;82677;1912
2020-11-10;MD;Moldova;915;18;83592;1930
2020-11-11;MD;Moldova;1115;20;84707;1950
2020-11-12;MD;Moldova;1331;19;86038;1969
2020-11-13;MD;Moldova;1323;18;87361;1987
2020-11-14;MD;Moldova;1411;19;88772;2006
2020-11-15;MD;Moldova;507;13;89279;2019
2020-11-16;MD;Moldova;564;16;89843;2035
2020-11-17;MD;Moldova;1069;19;90912;2054
2020-11-18;MD;Moldova;1607;18;92519;2072
2020-11-19;MD;Moldova;1442;19;93961;2091
2020-11-20;MD;Moldova;1422;20;95383;2111
2020-11-21;MD;Moldova;1306;19;96689;2130
2020-11-22;MD;Moldova;1252;19;97941;2149
2020-11-23;MD;Moldova;477;20;98418;2169
2020-11-24;MD;Moldova;1215;19;99633;2188
2020-11-25;MD;Moldova;1570;21;101203;2209
2020-11-26;MD;Moldova;1691;20;102894;2229
2020-11-27;MD;Moldova;1246;21;104140;2250
2020-11-28;MD;Moldova;1712;19;105852;2269
2020-11-29;MD;Moldova;1165;21;107017;2290
2020-11-30;MD;Moldova;347;14;107364;2304
2020-12-01;MD;Moldova;1499;19;108863;2323
2020-12-02;MD;Moldova;1717;20;110580;2343
2020-12-03;MD;Moldova;1727;20;112307;2363
2020-12-04;MD;Moldova;1522;21;113829;2384
2020-12-05;MD;Moldova;1728;19;115557;2403
2020-12-06;MD;Moldova;808;16;116365;2419
2020-12-07;MD;Moldova;1130;19;117495;2438
2020-12-08;MD;Moldova;1709;22;119204;2460
2020-12-09;MD;Moldova;1766;21;120970;2481
2020-12-10;MD;Moldova;1715;19;122685;2500
2020-12-11;MD;Moldova;1579;21;124264;2521
2020-12-12;MD;Moldova;1459;26;125723;2547
2020-12-13;MD;Moldova;795;25;126518;2572
2020-12-14;MD;Moldova;735;26;127253;2598
2020-12-15;MD;Moldova;1403;27;128656;2625
2020-12-16;MD;Moldova;1673;25;130329;2650
2020-12-17;MD;Moldova;1590;24;131919;2674
2020-12-18;MD;Moldova;1441;26;133360;2700
2020-12-19;MD;Moldova;1218;27;134578;2727
2020-12-20;MD;Moldova;629;25;135207;2752
2020-12-21;MD;Moldova;703;25;135910;2777
2020-12-22;MD;Moldova;1021;26;136931;2803
2020-12-23;MD;Moldova;1282;22;138213;2825
2020-12-24;MD;Moldova;1222;23;139435;2848
2020-12-25;MD;Moldova;815;23;140250;2871
2020-12-26;MD;Moldova;746;12;140996;2883
2020-12-27;MD;Moldova;359;8;141355;2891
2020-12-28;MD;Moldova;569;18;141924;2909
2020-12-29;MD;Moldova;927;25;142851;2934
2020-12-30;MD;Moldova;990;26;143841;2960
2020-12-31;MD;Moldova;977;25;144818;2985
2021-01-01;MD;Moldova;440;19;145258;3004
2021-01-02;MD;Moldova;436;16;145694;3020
2021-01-03;MD;Moldova;179;17;145873;3037
2021-01-04;MD;Moldova;436;17;146309;3054
2021-01-05;MD;Moldova;612;16;146921;3070
2021-01-06;MD;Moldova;950;18;147871;3088
2021-01-07;MD;Moldova;423;18;148294;3106
2021-01-08;MD;Moldova;375;16;148669;3122
2021-01-09;MD;Moldova;424;8;149093;3130
2021-01-10;MD;Moldova;298;9;149391;3139
2021-01-11;MD;Moldova;271;17;149662;3156
2021-01-12;MD;Moldova;476;20;150138;3176
2021-01-13;MD;Moldova;808;17;150946;3193
2021-01-14;MD;Moldova;741;18;151687;3211
2021-01-15;MD;Moldova;576;17;152263;3228
2021-01-16;MD;Moldova;377;17;152640;3245
2021-01-17;MD;Moldova;214;5;152854;3250
2021-01-18;MD;Moldova;258;17;153112;3267
2021-01-19;MD;Moldova;394;15;153506;3282
2021-01-20;MD;Moldova;612;17;154118;3299
2021-01-21;MD;Moldova;670;16;154788;3315
2021-01-22;MD;Moldova;514;17;155302;3332
2021-01-23;MD;Moldova;635;15;155937;3347
2021-01-24;MD;Moldova;265;14;156202;3361
2021-01-25;MD;Moldova;224;7;156426;3368
2021-01-26;MD;Moldova;546;13;156972;3381
2021-01-27;MD;Moldova;654;15;157626;3396
2021-01-28;MD;Moldova;683;17;158309;3413
2021-01-29;MD;Moldova;551;11;158860;3424
2021-01-30;MD;Moldova;653;10;159513;3434
2021-01-31;MD;Moldova;291;4;159804;3438
2021-02-01;MD;Moldova;282;8;160086;3446
2021-02-02;MD;Moldova;639;16;160725;3462
2021-02-03;MD;Moldova;917;18;161642;3480
2021-02-04;MD;Moldova;982;17;162624;3497
2021-02-05;MD;Moldova;776;18;163400;3515
2021-02-06;MD;Moldova;843;15;164243;3530
2021-02-07;MD;Moldova;326;13;164569;3543
2021-02-08;MD;Moldova;289;14;164858;3557
2021-02-09;MD;Moldova;805;16;165663;3573
2021-02-10;MD;Moldova;890;16;166553;3589
2021-02-11;MD;Moldova;993;18;167546;3607
2021-02-12;MD;Moldova;1280;19;168826;3626
2021-02-13;MD;Moldova;979;14;169805;3640
2021-02-14;MD;Moldova;381;11;170186;3651
2021-02-15;MD;Moldova;363;10;170549;3661
2021-02-16;MD;Moldova;965;17;171514;3678
2021-02-17;MD;Moldova;1301;19;172815;3697
2021-02-18;MD;Moldova;1340;20;174155;3717
2021-02-19;MD;Moldova;1028;22;175183;3739
2021-02-20;MD;Moldova;1062;21;176245;3760
2021-02-21;MD;Moldova;507;20;176752;3780
2021-02-22;MD;Moldova;655;19;177407;3799
2021-02-23;MD;Moldova;1133;24;178540;3823
2021-02-24;MD;Moldova;1610;23;180150;3846
2021-02-25;MD;Moldova;1736;25;181886;3871
2021-02-26;MD;Moldova;1452;28;183338;3899
2021-02-27;MD;Moldova;1518;25;184856;3924
2021-02-28;MD;Moldova;597;25;185453;3949
2021-03-01;MD;Moldova;994;26;186447;3975
2021-03-02;MD;Moldova;1400;27;187847;4002
2021-03-03;MD;Moldova;1550;24;189397;4026
2021-03-04;MD;Moldova;1800;23;191197;4049
2021-03-05;MD;Moldova;1788;22;192985;4071
2021-03-06;MD;Moldova;1620;20;194605;4091
2021-03-07;MD;Moldova;647;20;195252;4111
2021-03-08;MD;Moldova;350;18;195602;4129
2021-03-09;MD;Moldova;873;21;196475;4150
2021-03-10;MD;Moldova;1753;33;198228;4183
2021-03-11;MD;Moldova;1896;37;200124;4220
2021-03-12;MD;Moldova;1785;38;201909;4258
2021-03-13;MD;Moldova;1801;36;203710;4294
2021-03-14;MD;Moldova;753;36;204463;4330
2021-03-15;MD;Moldova;861;39;205324;4369
2021-03-16;MD;Moldova;1688;33;207012;4402
2021-03-17;MD;Moldova;1916;34;208928;4436
2021-03-18;MD;Moldova;1797;36;210725;4472
2021-03-19;MD;Moldova;1843;29;212568;4501
2021-03-20;MD;Moldova;1635;30;214203;4531
2021-03-21;MD;Moldova;831;28;215034;4559
2021-03-22;MD;Moldova;1060;31;216094;4590
2021-03-23;MD;Moldova;1621;33;217715;4623
2021-03-24;MD;Moldova;2273;38;219988;4661
2021-03-25;MD;Moldova;2132;41;222120;4702
2021-03-26;MD;Moldova;1866;43;223986;4745
2021-03-27;MD;Moldova;1674;40;225660;4785
2021-03-28;MD;Moldova;861;42;226521;4827
2021-03-29;MD;Moldova;932;42;227453;4869
2021-03-30;MD;Moldova;917;46;228370;4915
2021-03-31;MD;Moldova;1871;45;230241;4960
2021-04-01;MD;Moldova;1515;43;231756;5003
2021-04-02;MD;Moldova;1380;45;233136;5048
2021-04-03;MD;Moldova;1258;44;234394;5092
2021-04-04;MD;Moldova;693;44;235087;5136
2021-04-05;MD;Moldova;703;42;235790;5178
2021-04-06;MD;Moldova;773;46;236563;5224
2021-04-07;MD;Moldova;1155;44;237718;5268
2021-04-08;MD;Moldova;1428;39;239146;5307
2021-04-09;MD;Moldova;910;32;240056;5339
2021-04-10;MD;Moldova;830;30;240886;5369
2021-04-11;MD;Moldova;331;19;241217;5388
2021-04-12;MD;Moldova;603;21;241820;5409
2021-04-13;MD;Moldova;544;29;242364;5438
2021-04-14;MD;Moldova;1001;28;243365;5466
2021-04-15;MD;Moldova;812;27;244177;5493
2021-04-16;MD;Moldova;689;28;244866;5521
2021-04-17;MD;Moldova;628;27;245494;5548
2021-04-18;MD;Moldova;403;23;245897;5571
2021-04-19;MD;Moldova;341;20;246238;5591
2021-04-20;MD;Moldova;453;25;246691;5616
2021-04-21;MD;Moldova;700;27;247391;5643
2021-04-22;MD;Moldova;618;25;248009;5668
2021-04-23;MD;Moldova;509;23;248518;5691
2021-04-24;MD;Moldova;380;18;248898;5709
2021-04-25;MD;Moldova;241;21;249139;5730
2021-04-26;MD;Moldova;246;15;249385;5745
2021-04-27;MD;Moldova;329;17;249714;5762
2021-04-28;MD;Moldova;424;18;250138;5780
2021-04-29;MD;Moldova;370;15;250508;5795
2021-04-30;MD;Moldova;329;17;250837;5812
2021-05-01;MD;Moldova;323;14;251160;5826
2021-05-02;MD;Moldova;175;12;251335;5838
2021-05-03;MD;Moldova;43;12;251378;5850
2021-05-04;MD;Moldova;126;19;251504;5869
2021-05-05;MD;Moldova;316;23;251820;5892
2021-05-06;MD;Moldova;333;20;252153;5912
2021-05-07;MD;Moldova;260;17;252413;5929
2021-05-08;MD;Moldova;191;14;252604;5943
2021-05-09;MD;Moldova;145;9;252749;5952
2021-05-10;MD;Moldova;49;6;252798;5958
2021-05-11;MD;Moldova;151;12;252949;5970
2021-05-12;MD;Moldova;224;11;253173;5981
2021-05-13;MD;Moldova;213;14;253386;5995
2021-05-14;MD;Moldova;181;11;253567;6006
2021-05-15;MD;Moldova;169;10;253736;6016
2021-05-16;MD;Moldova;109;11;253845;6027
2021-05-17;MD;Moldova;109;7;253954;6034
2021-05-18;MD;Moldova;121;9;254075;6043
2021-05-19;MD;Moldova;138;10;254213;6053
2021-05-20;MD;Moldova;166;8;254379;6061
2021-05-21;MD;Moldova;120;6;254499;6067
2021-05-22;MD;Moldova;102;5;254601;6072
2021-05-23;MD;Moldova;75;3;254676;6075
2021-05-24;MD;Moldova;65;5;254741;6080
2021-05-25;MD;Moldova;73;4;254814;6084
2021-05-26;MD;Moldova;94;4;254908;6088
2021-05-27;MD;Moldova;77;5;254985;6093
2021-05-28;MD;Moldova;75;4;255060;6097
2021-05-29;MD;Moldova;45;3;255105;6100
2021-05-30;MD;Moldova;40;4;255145;6104
2021-05-31;MD;Moldova;41;3;255186;6107
2021-06-01;MD;Moldova;55;7;255241;6114
2021-06-02;MD;Moldova;44;6;255285;6120
2021-06-03;MD;Moldova;69;5;255354;6125
2021-06-04;MD;Moldova;48;4;255402;6129
2021-06-05;MD;Moldova;30;3;255432;6132
2021-06-06;MD;Moldova;21;2;255453;6134
2021-06-07;MD;Moldova;48;3;255501;6137
2021-06-08;MD;Moldova;40;4;255541;6141
2021-06-09;MD;Moldova;60;4;255601;6145
2021-06-10;MD;Moldova;60;2;255661;6147
2021-06-11;MD;Moldova;54;2;255715;6149
2021-06-12;MD;Moldova;43;3;255758;6152
2021-06-13;MD;Moldova;39;2;255797;6154
2021-06-14;MD;Moldova;33;0;255830;6154
2021-06-15;MD;Moldova;48;2;255878;6156
2021-06-16;MD;Moldova;59;3;255937;6159
2021-06-17;MD;Moldova;57;3;255994;6162
2021-06-18;MD;Moldova;60;3;256054;6165
2021-06-19;MD;Moldova;49;3;256103;6168
2021-06-20;MD;Moldova;37;2;256140;6170
2021-06-21;MD;Moldova;47;3;256187;6173
2021-06-22;MD;Moldova;45;2;256232;6175
2021-06-23;MD;Moldova;92;3;256324;6178
2021-06-24;MD;Moldova;63;2;256387;6180
2021-06-25;MD;Moldova;88;2;256475;6182
2021-06-26;MD;Moldova;52;1;256527;6183
2021-06-27;MD;Moldova;32;1;256559;6184
2021-06-28;MD;Moldova;55;3;256614;6187
2021-06-29;MD;Moldova;55;4;256669;6191
2021-06-30;MD;Moldova;65;3;256734;6194
2021-07-01;MD;Moldova;82;0;256816;6194
2020-02-29;MC;Monaco;1;0;1;0
2020-03-01;MC;Monaco;0;0;1;0
2020-03-02;MC;Monaco;0;0;1;0
2020-03-03;MC;Monaco;0;0;1;0
2020-03-04;MC;Monaco;0;0;1;0
2020-03-05;MC;Monaco;0;0;1;0
2020-03-06;MC;Monaco;0;0;1;0
2020-03-07;MC;Monaco;0;0;1;0
2020-03-08;MC;Monaco;0;0;1;0
2020-03-09;MC;Monaco;0;0;1;0
2020-03-10;MC;Monaco;0;0;1;0
2020-03-11;MC;Monaco;0;0;1;0
2020-03-12;MC;Monaco;1;0;2;0
2020-03-13;MC;Monaco;0;0;2;0
2020-03-14;MC;Monaco;0;0;2;0
2020-03-15;MC;Monaco;0;0;2;0
2020-03-16;MC;Monaco;5;0;7;0
2020-03-17;MC;Monaco;0;0;7;0
2020-03-18;MC;Monaco;0;0;7;0
2020-03-19;MC;Monaco;0;0;7;0
2020-03-20;MC;Monaco;4;0;11;0
2020-03-21;MC;Monaco;0;0;11;0
2020-03-22;MC;Monaco;12;0;23;0
2020-03-23;MC;Monaco;0;0;23;0
2020-03-24;MC;Monaco;0;0;23;0
2020-03-25;MC;Monaco;8;0;31;0
2020-03-26;MC;Monaco;2;0;33;0
2020-03-27;MC;Monaco;9;0;42;0
2020-03-28;MC;Monaco;0;0;42;0
2020-03-29;MC;Monaco;4;1;46;1
2020-03-30;MC;Monaco;3;0;49;1
2020-03-31;MC;Monaco;3;0;52;1
2020-04-01;MC;Monaco;3;0;55;1
2020-04-02;MC;Monaco;5;0;60;1
2020-04-03;MC;Monaco;4;0;64;1
2020-04-04;MC;Monaco;2;0;66;1
2020-04-05;MC;Monaco;7;0;73;1
2020-04-06;MC;Monaco;4;0;77;1
2020-04-07;MC;Monaco;2;0;79;1
2020-04-08;MC;Monaco;2;0;81;1
2020-04-09;MC;Monaco;3;0;84;1
2020-04-10;MC;Monaco;6;0;90;1
2020-04-11;MC;Monaco;2;0;92;1
2020-04-12;MC;Monaco;1;0;93;1
2020-04-13;MC;Monaco;0;0;93;1
2020-04-14;MC;Monaco;0;0;93;1
2020-04-15;MC;Monaco;0;2;93;3
2020-04-16;MC;Monaco;0;0;93;3
2020-04-17;MC;Monaco;1;0;94;3
2020-04-18;MC;Monaco;0;0;94;3
2020-04-19;MC;Monaco;0;0;94;3
2020-04-20;MC;Monaco;0;0;94;3
2020-04-21;MC;Monaco;0;0;94;3
2020-04-22;MC;Monaco;0;0;94;3
2020-04-23;MC;Monaco;0;1;94;4
2020-04-24;MC;Monaco;0;0;94;4
2020-04-25;MC;Monaco;0;0;94;4
2020-04-26;MC;Monaco;0;0;94;4
2020-04-27;MC;Monaco;1;0;95;4
2020-04-28;MC;Monaco;0;0;95;4
2020-04-29;MC;Monaco;0;0;95;4
2020-04-30;MC;Monaco;0;0;95;4
2020-05-01;MC;Monaco;0;0;95;4
2020-05-02;MC;Monaco;0;0;95;4
2020-05-03;MC;Monaco;0;0;95;4
2020-05-04;MC;Monaco;0;0;95;4
2020-05-05;MC;Monaco;0;0;95;4
2020-05-06;MC;Monaco;0;0;95;4
2020-05-07;MC;Monaco;0;0;95;4
2020-05-08;MC;Monaco;0;0;95;4
2020-05-09;MC;Monaco;1;0;96;4
2020-05-10;MC;Monaco;0;0;96;4
2020-05-11;MC;Monaco;0;0;96;4
2020-05-12;MC;Monaco;0;0;96;4
2020-05-13;MC;Monaco;0;0;96;4
2020-05-14;MC;Monaco;0;0;96;4
2020-05-15;MC;Monaco;0;0;96;4
2020-05-16;MC;Monaco;0;0;96;4
2020-05-17;MC;Monaco;0;0;96;4
2020-05-18;MC;Monaco;1;0;97;4
2020-05-19;MC;Monaco;0;0;97;4
2020-05-20;MC;Monaco;0;0;97;4
2020-05-21;MC;Monaco;0;0;97;4
2020-05-22;MC;Monaco;0;0;97;4
2020-05-23;MC;Monaco;1;0;98;4
2020-05-24;MC;Monaco;0;0;98;4
2020-05-25;MC;Monaco;0;0;98;4
2020-05-26;MC;Monaco;0;0;98;4
2020-05-27;MC;Monaco;0;0;98;4
2020-05-28;MC;Monaco;0;0;98;4
2020-05-29;MC;Monaco;0;0;98;4
2020-05-30;MC;Monaco;1;0;99;4
2020-05-31;MC;Monaco;0;0;99;4
2020-06-01;MC;Monaco;0;0;99;4
2020-06-02;MC;Monaco;0;0;99;4
2020-06-03;MC;Monaco;0;0;99;4
2020-06-04;MC;Monaco;0;0;99;4
2020-06-05;MC;Monaco;0;0;99;4
2020-06-06;MC;Monaco;0;0;99;4
2020-06-07;MC;Monaco;0;0;99;4
2020-06-08;MC;Monaco;0;0;99;4
2020-06-09;MC;Monaco;0;0;99;4
2020-06-10;MC;Monaco;0;0;99;4
2020-06-11;MC;Monaco;0;0;99;4
2020-06-12;MC;Monaco;0;0;99;4
2020-06-13;MC;Monaco;0;0;99;4
2020-06-14;MC;Monaco;0;0;99;4
2020-06-15;MC;Monaco;0;0;99;4
2020-06-16;MC;Monaco;0;0;99;4
2020-06-17;MC;Monaco;0;0;99;4
2020-06-18;MC;Monaco;0;0;99;4
2020-06-19;MC;Monaco;0;0;99;4
2020-06-20;MC;Monaco;0;0;99;4
2020-06-21;MC;Monaco;1;0;100;4
2020-06-22;MC;Monaco;1;0;101;4
2020-06-23;MC;Monaco;0;0;101;4
2020-06-24;MC;Monaco;1;0;102;4
2020-06-25;MC;Monaco;0;0;102;4
2020-06-26;MC;Monaco;0;0;102;4
2020-06-27;MC;Monaco;1;0;103;4
2020-06-28;MC;Monaco;0;0;103;4
2020-06-29;MC;Monaco;0;0;103;4
2020-06-30;MC;Monaco;0;0;103;4
2020-07-01;MC;Monaco;0;0;103;4
2020-07-02;MC;Monaco;3;0;106;4
2020-07-03;MC;Monaco;0;0;106;4
2020-07-04;MC;Monaco;0;0;106;4
2020-07-05;MC;Monaco;2;0;108;4
2020-07-06;MC;Monaco;0;0;108;4
2020-07-07;MC;Monaco;0;0;108;4
2020-07-08;MC;Monaco;0;0;108;4
2020-07-09;MC;Monaco;0;0;108;4
2020-07-10;MC;Monaco;0;0;108;4
2020-07-11;MC;Monaco;1;0;109;4
2020-07-12;MC;Monaco;0;0;109;4
2020-07-13;MC;Monaco;0;0;109;4
2020-07-14;MC;Monaco;0;0;109;4
2020-07-15;MC;Monaco;0;0;109;4
2020-07-16;MC;Monaco;0;0;109;4
2020-07-17;MC;Monaco;0;0;109;4
2020-07-18;MC;Monaco;0;0;109;4
2020-07-19;MC;Monaco;0;0;109;4
2020-07-20;MC;Monaco;0;0;109;4
2020-07-21;MC;Monaco;2;0;111;4
2020-07-22;MC;Monaco;1;0;112;4
2020-07-23;MC;Monaco;2;0;114;4
2020-07-24;MC;Monaco;2;0;116;4
2020-07-25;MC;Monaco;0;0;116;4
2020-07-26;MC;Monaco;0;0;116;4
2020-07-27;MC;Monaco;0;0;116;4
2020-07-28;MC;Monaco;1;0;117;4
2020-07-29;MC;Monaco;3;0;120;4
2020-07-30;MC;Monaco;0;0;120;4
2020-07-31;MC;Monaco;0;0;120;4
2020-08-01;MC;Monaco;0;0;120;4
2020-08-02;MC;Monaco;0;0;120;4
2020-08-03;MC;Monaco;1;0;121;4
2020-08-04;MC;Monaco;2;0;123;4
2020-08-05;MC;Monaco;2;0;125;4
2020-08-06;MC;Monaco;0;0;125;4
2020-08-07;MC;Monaco;3;0;128;4
2020-08-08;MC;Monaco;3;0;131;4
2020-08-09;MC;Monaco;2;0;133;4
2020-08-10;MC;Monaco;0;0;133;4
2020-08-11;MC;Monaco;5;0;138;4
2020-08-12;MC;Monaco;3;0;141;4
2020-08-13;MC;Monaco;3;0;144;4
2020-08-14;MC;Monaco;2;0;146;4
2020-08-15;MC;Monaco;0;0;146;4
2020-08-16;MC;Monaco;0;0;146;4
2020-08-17;MC;Monaco;2;0;148;4
2020-08-18;MC;Monaco;0;0;148;4
2020-08-19;MC;Monaco;0;0;148;4
2020-08-20;MC;Monaco;2;0;150;4
2020-08-21;MC;Monaco;4;0;154;4
2020-08-22;MC;Monaco;0;0;154;4
2020-08-23;MC;Monaco;0;0;154;4
2020-08-24;MC;Monaco;0;0;154;4
2020-08-25;MC;Monaco;0;0;154;4
2020-08-26;MC;Monaco;0;0;154;4
2020-08-27;MC;Monaco;0;0;154;4
2020-08-28;MC;Monaco;0;0;154;4
2020-08-29;MC;Monaco;0;0;154;4
2020-08-30;MC;Monaco;0;0;154;4
2020-08-31;MC;Monaco;0;0;154;4
2020-09-01;MC;Monaco;0;0;154;4
2020-09-02;MC;Monaco;-12;-3;142;1
2020-09-03;MC;Monaco;1;0;143;1
2020-09-04;MC;Monaco;4;0;147;1
2020-09-05;MC;Monaco;0;0;147;1
2020-09-06;MC;Monaco;0;0;147;1
2020-09-07;MC;Monaco;6;0;153;1
2020-09-08;MC;Monaco;3;0;156;1
2020-09-09;MC;Monaco;5;0;161;1
2020-09-10;MC;Monaco;4;0;165;1
2020-09-11;MC;Monaco;3;0;168;1
2020-09-12;MC;Monaco;1;0;169;1
2020-09-13;MC;Monaco;2;0;171;1
2020-09-14;MC;Monaco;6;0;177;1
2020-09-15;MC;Monaco;1;0;178;1
2020-09-16;MC;Monaco;3;0;181;1
2020-09-17;MC;Monaco;5;0;186;1
2020-09-18;MC;Monaco;5;0;191;1
2020-09-19;MC;Monaco;1;0;192;1
2020-09-20;MC;Monaco;1;0;193;1
2020-09-21;MC;Monaco;2;0;195;1
2020-09-22;MC;Monaco;2;0;197;1
2020-09-23;MC;Monaco;2;0;199;1
2020-09-24;MC;Monaco;6;0;205;1
2020-09-25;MC;Monaco;3;1;208;2
2020-09-26;MC;Monaco;2;0;210;2
2020-09-27;MC;Monaco;0;0;210;2
2020-09-28;MC;Monaco;2;0;212;2
2020-09-29;MC;Monaco;2;0;214;2
2020-09-30;MC;Monaco;4;0;218;2
2020-10-01;MC;Monaco;1;0;219;2
2020-10-02;MC;Monaco;2;0;221;2
2020-10-03;MC;Monaco;1;0;222;2
2020-10-04;MC;Monaco;0;0;222;2
2020-10-05;MC;Monaco;1;0;223;2
2020-10-06;MC;Monaco;1;0;224;2
2020-10-07;MC;Monaco;3;0;227;2
2020-10-08;MC;Monaco;2;0;229;2
2020-10-09;MC;Monaco;4;0;233;2
2020-10-10;MC;Monaco;0;0;233;2
2020-10-11;MC;Monaco;1;0;234;2
2020-10-12;MC;Monaco;2;0;236;2
2020-10-13;MC;Monaco;5;0;241;2
2020-10-14;MC;Monaco;7;0;248;2
2020-10-15;MC;Monaco;5;0;253;2
2020-10-16;MC;Monaco;2;0;255;2
2020-10-17;MC;Monaco;5;0;260;2
2020-10-18;MC;Monaco;5;0;265;2
2020-10-19;MC;Monaco;3;0;268;2
2020-10-20;MC;Monaco;3;0;271;2
2020-10-21;MC;Monaco;2;0;273;2
2020-10-22;MC;Monaco;8;0;281;2
2020-10-23;MC;Monaco;14;0;295;2
2020-10-24;MC;Monaco;1;0;296;2
2020-10-25;MC;Monaco;10;0;306;2
2020-10-26;MC;Monaco;4;0;310;2
2020-10-27;MC;Monaco;10;0;320;2
2020-10-28;MC;Monaco;17;0;337;2
2020-10-29;MC;Monaco;10;0;347;2
2020-10-30;MC;Monaco;8;0;355;2
2020-10-31;MC;Monaco;4;0;359;2
2020-11-01;MC;Monaco;7;0;366;2
2020-11-02;MC;Monaco;9;0;375;2
2020-11-03;MC;Monaco;22;0;397;2
2020-11-04;MC;Monaco;15;0;412;2
2020-11-05;MC;Monaco;18;0;430;2
2020-11-06;MC;Monaco;24;0;454;2
2020-11-07;MC;Monaco;29;0;483;2
2020-11-08;MC;Monaco;3;0;486;2
2020-11-09;MC;Monaco;4;0;490;2
2020-11-10;MC;Monaco;22;0;512;2
2020-11-11;MC;Monaco;12;0;524;2
2020-11-12;MC;Monaco;8;0;532;2
2020-11-13;MC;Monaco;8;0;540;2
2020-11-14;MC;Monaco;5;0;545;2
2020-11-15;MC;Monaco;3;0;548;2
2020-11-16;MC;Monaco;4;0;552;2
2020-11-17;MC;Monaco;5;1;557;3
2020-11-18;MC;Monaco;8;0;565;3
2020-11-19;MC;Monaco;8;0;573;3
2020-11-20;MC;Monaco;4;0;577;3
2020-11-21;MC;Monaco;4;0;581;3
2020-11-22;MC;Monaco;1;0;582;3
2020-11-23;MC;Monaco;1;0;583;3
2020-11-24;MC;Monaco;4;0;587;3
2020-11-25;MC;Monaco;7;0;594;3
2020-11-26;MC;Monaco;6;0;600;3
2020-11-27;MC;Monaco;3;0;603;3
2020-11-28;MC;Monaco;4;0;607;3
2020-11-29;MC;Monaco;1;0;608;3
2020-11-30;MC;Monaco;1;0;609;3
2020-12-01;MC;Monaco;8;0;617;3
2020-12-02;MC;Monaco;4;0;621;3
2020-12-03;MC;Monaco;9;0;630;3
2020-12-04;MC;Monaco;0;0;630;3
2020-12-05;MC;Monaco;7;0;637;3
2020-12-06;MC;Monaco;1;0;638;3
2020-12-07;MC;Monaco;3;0;641;3
2020-12-08;MC;Monaco;7;0;648;3
2020-12-09;MC;Monaco;7;0;655;3
2020-12-10;MC;Monaco;2;0;657;3
2020-12-11;MC;Monaco;2;0;659;3
2020-12-12;MC;Monaco;9;0;668;3
2020-12-13;MC;Monaco;0;0;668;3
2020-12-14;MC;Monaco;3;0;671;3
2020-12-15;MC;Monaco;7;0;678;3
2020-12-16;MC;Monaco;7;0;685;3
2020-12-17;MC;Monaco;15;0;700;3
2020-12-18;MC;Monaco;15;0;715;3
2020-12-19;MC;Monaco;8;0;723;3
2020-12-20;MC;Monaco;5;0;728;3
2020-12-21;MC;Monaco;14;0;742;3
2020-12-22;MC;Monaco;14;0;756;3
2020-12-23;MC;Monaco;11;0;767;3
2020-12-24;MC;Monaco;16;0;783;3
2020-12-25;MC;Monaco;6;0;789;3
2020-12-26;MC;Monaco;8;0;797;3
2020-12-27;MC;Monaco;0;0;797;3
2020-12-28;MC;Monaco;4;0;801;3
2020-12-29;MC;Monaco;26;0;827;3
2020-12-30;MC;Monaco;26;0;853;3
2020-12-31;MC;Monaco;22;0;875;3
2021-01-01;MC;Monaco;10;0;885;3
2021-01-02;MC;Monaco;16;0;901;3
2021-01-03;MC;Monaco;6;0;907;3
2021-01-04;MC;Monaco;10;0;917;3
2021-01-05;MC;Monaco;30;0;947;3
2021-01-06;MC;Monaco;31;0;978;3
2021-01-07;MC;Monaco;40;0;1018;3
2021-01-08;MC;Monaco;23;1;1041;4
2021-01-09;MC;Monaco;12;0;1053;4
2021-01-10;MC;Monaco;4;0;1057;4
2021-01-11;MC;Monaco;13;0;1070;4
2021-01-12;MC;Monaco;22;3;1092;7
2021-01-13;MC;Monaco;36;0;1128;7
2021-01-14;MC;Monaco;17;0;1145;7
2021-01-15;MC;Monaco;24;0;1169;7
2021-01-16;MC;Monaco;25;0;1194;7
2021-01-17;MC;Monaco;11;0;1205;7
2021-01-18;MC;Monaco;7;0;1212;7
2021-01-19;MC;Monaco;28;2;1240;9
2021-01-20;MC;Monaco;22;0;1262;9
2021-01-21;MC;Monaco;25;0;1287;9
2021-01-22;MC;Monaco;24;0;1311;9
2021-01-23;MC;Monaco;34;0;1345;9
2021-01-24;MC;Monaco;12;0;1357;9
2021-01-25;MC;Monaco;11;0;1368;9
2021-01-26;MC;Monaco;31;0;1399;9
2021-01-27;MC;Monaco;14;1;1413;10
2021-01-28;MC;Monaco;17;1;1430;11
2021-01-29;MC;Monaco;0;0;1430;11
2021-01-30;MC;Monaco;45;0;1475;11
2021-01-31;MC;Monaco;14;2;1489;13
2021-02-01;MC;Monaco;10;1;1499;14
2021-02-02;MC;Monaco;44;3;1543;17
2021-02-03;MC;Monaco;29;1;1572;18
2021-02-04;MC;Monaco;24;0;1596;18
2021-02-05;MC;Monaco;29;1;1625;19
2021-02-06;MC;Monaco;22;0;1647;19
2021-02-07;MC;Monaco;8;0;1655;19
2021-02-08;MC;Monaco;10;0;1665;19
2021-02-09;MC;Monaco;30;0;1695;19
2021-02-10;MC;Monaco;22;0;1717;19
2021-02-11;MC;Monaco;18;0;1735;19
2021-02-12;MC;Monaco;17;2;1752;21
2021-02-13;MC;Monaco;3;0;1755;21
2021-02-14;MC;Monaco;5;0;1760;21
2021-02-15;MC;Monaco;14;0;1774;21
2021-02-16;MC;Monaco;13;0;1787;21
2021-02-17;MC;Monaco;29;1;1816;22
2021-02-18;MC;Monaco;19;0;1835;22
2021-02-19;MC;Monaco;9;0;1844;22
2021-02-20;MC;Monaco;18;0;1862;22
2021-02-21;MC;Monaco;8;0;1870;22
2021-02-22;MC;Monaco;15;0;1885;22
2021-02-23;MC;Monaco;19;1;1904;23
2021-02-24;MC;Monaco;12;0;1916;23
2021-02-25;MC;Monaco;16;0;1932;23
2021-02-26;MC;Monaco;10;0;1942;23
2021-02-27;MC;Monaco;11;1;1953;24
2021-02-28;MC;Monaco;3;0;1956;24
2021-03-01;MC;Monaco;9;0;1965;24
2021-03-02;MC;Monaco;0;1;1965;25
2021-03-03;MC;Monaco;16;1;1981;26
2021-03-04;MC;Monaco;16;0;1997;26
2021-03-05;MC;Monaco;12;0;2009;26
2021-03-06;MC;Monaco;10;0;2019;26
2021-03-07;MC;Monaco;4;0;2023;26
2021-03-08;MC;Monaco;5;0;2028;26
2021-03-09;MC;Monaco;20;0;2048;26
2021-03-10;MC;Monaco;14;0;2062;26
2021-03-11;MC;Monaco;13;0;2075;26
2021-03-12;MC;Monaco;22;1;2097;27
2021-03-13;MC;Monaco;9;0;2106;27
2021-03-14;MC;Monaco;1;0;2107;27
2021-03-15;MC;Monaco;13;0;2120;27
2021-03-16;MC;Monaco;15;0;2135;27
2021-03-17;MC;Monaco;6;0;2141;27
2021-03-18;MC;Monaco;8;0;2149;27
2021-03-19;MC;Monaco;15;0;2164;27
2021-03-20;MC;Monaco;9;0;2173;27
2021-03-21;MC;Monaco;0;0;2173;27
2021-03-22;MC;Monaco;9;0;2182;27
2021-03-23;MC;Monaco;17;0;2199;27
2021-03-24;MC;Monaco;11;1;2210;28
2021-03-25;MC;Monaco;17;0;2227;28
2021-03-26;MC;Monaco;21;0;2248;28
2021-03-27;MC;Monaco;6;0;2254;28
2021-03-28;MC;Monaco;5;0;2259;28
2021-03-29;MC;Monaco;6;0;2265;28
2021-03-30;MC;Monaco;17;0;2282;28
2021-03-31;MC;Monaco;6;0;2288;28
2021-04-01;MC;Monaco;17;0;2305;28
2021-04-02;MC;Monaco;15;0;2320;28
2021-04-03;MC;Monaco;6;1;2326;29
2021-04-04;MC;Monaco;3;0;2329;29
2021-04-05;MC;Monaco;5;1;2334;30
2021-04-06;MC;Monaco;11;0;2345;30
2021-04-07;MC;Monaco;8;0;2353;30
2021-04-08;MC;Monaco;11;0;2364;30
2021-04-09;MC;Monaco;5;1;2369;31
2021-04-10;MC;Monaco;5;0;2374;31
2021-04-11;MC;Monaco;1;0;2375;31
2021-04-12;MC;Monaco;2;0;2377;31
2021-04-13;MC;Monaco;1;0;2378;31
2021-04-14;MC;Monaco;6;0;2384;31
2021-04-15;MC;Monaco;3;0;2387;31
2021-04-16;MC;Monaco;4;0;2391;31
2021-04-17;MC;Monaco;4;0;2395;31
2021-04-18;MC;Monaco;4;0;2399;31
2021-04-19;MC;Monaco;5;0;2404;31
2021-04-20;MC;Monaco;9;0;2413;31
2021-04-21;MC;Monaco;9;0;2422;31
2021-04-22;MC;Monaco;1;0;2423;31
2021-04-23;MC;Monaco;3;0;2426;31
2021-04-24;MC;Monaco;3;0;2429;31
2021-04-25;MC;Monaco;3;1;2432;32
2021-04-26;MC;Monaco;7;0;2439;32
2021-04-27;MC;Monaco;3;0;2442;32
2021-04-28;MC;Monaco;5;0;2447;32
2021-04-29;MC;Monaco;5;0;2452;32
2021-04-30;MC;Monaco;2;0;2454;32
2021-05-01;MC;Monaco;3;0;2457;32
2021-05-02;MC;Monaco;0;0;2457;32
2021-05-03;MC;Monaco;8;0;2465;32
2021-05-04;MC;Monaco;3;0;2468;32
2021-05-05;MC;Monaco;3;0;2471;32
2021-05-06;MC;Monaco;4;0;2475;32
2021-05-07;MC;Monaco;2;0;2477;32
2021-05-08;MC;Monaco;2;0;2479;32
2021-05-09;MC;Monaco;0;0;2479;32
2021-05-10;MC;Monaco;2;0;2481;32
2021-05-11;MC;Monaco;5;0;2486;32
2021-05-12;MC;Monaco;1;0;2487;32
2021-05-13;MC;Monaco;3;0;2490;32
2021-05-14;MC;Monaco;0;0;2490;32
2021-05-15;MC;Monaco;3;0;2493;32
2021-05-16;MC;Monaco;0;0;2493;32
2021-05-17;MC;Monaco;1;0;2494;32
2021-05-18;MC;Monaco;1;0;2495;32
2021-05-19;MC;Monaco;2;0;2497;32
2021-05-20;MC;Monaco;2;0;2499;32
2021-05-21;MC;Monaco;1;0;2500;32
2021-05-22;MC;Monaco;1;0;2501;32
2021-05-23;MC;Monaco;0;0;2501;32
2021-05-24;MC;Monaco;0;0;2501;32
2021-05-25;MC;Monaco;1;0;2502;32
2021-05-26;MC;Monaco;1;0;2503;32
2021-05-27;MC;Monaco;0;0;2503;32
2021-05-28;MC;Monaco;0;0;2503;32
2021-05-29;MC;Monaco;0;0;2503;32
2021-05-30;MC;Monaco;1;0;2504;32
2021-05-31;MC;Monaco;0;0;2504;32
2021-06-01;MC;Monaco;2;1;2506;33
2021-06-02;MC;Monaco;2;0;2508;33
2021-06-03;MC;Monaco;0;0;2508;33
2021-06-04;MC;Monaco;0;0;2508;33
2021-06-05;MC;Monaco;0;0;2508;33
2021-06-06;MC;Monaco;0;0;2508;33
2021-06-07;MC;Monaco;0;0;2508;33
2021-06-08;MC;Monaco;3;0;2511;33
2021-06-09;MC;Monaco;3;0;2514;33
2021-06-10;MC;Monaco;2;0;2516;33
2021-06-11;MC;Monaco;4;0;2520;33
2021-06-12;MC;Monaco;4;0;2524;33
2021-06-13;MC;Monaco;1;0;2525;33
2021-06-14;MC;Monaco;1;0;2526;33
2021-06-15;MC;Monaco;6;0;2532;33
2021-06-16;MC;Monaco;7;0;2539;33
2021-06-17;MC;Monaco;6;0;2545;33
2021-06-18;MC;Monaco;2;0;2547;33
2021-06-19;MC;Monaco;1;0;2548;33
2021-06-20;MC;Monaco;0;0;2548;33
2021-06-21;MC;Monaco;1;0;2549;33
2021-06-22;MC;Monaco;5;0;2554;33
2021-06-23;MC;Monaco;3;0;2557;33
2021-06-24;MC;Monaco;5;0;2562;33
2021-06-25;MC;Monaco;8;0;2570;33
2021-06-26;MC;Monaco;0;0;2570;33
2021-06-27;MC;Monaco;1;0;2571;33
2021-06-28;MC;Monaco;4;0;2575;33
2021-06-29;MC;Monaco;1;0;2576;33
2021-06-30;MC;Monaco;1;0;2577;33
2021-07-01;MC;Monaco;3;0;2580;33
2020-03-10;MN;Mongolia;1;0;1;0
2020-03-11;MN;Mongolia;0;0;1;0
2020-03-12;MN;Mongolia;0;0;1;0
2020-03-13;MN;Mongolia;0;0;1;0
2020-03-14;MN;Mongolia;0;0;1;0
2020-03-15;MN;Mongolia;0;0;1;0
2020-03-16;MN;Mongolia;0;0;1;0
2020-03-17;MN;Mongolia;4;0;5;0
2020-03-18;MN;Mongolia;1;0;6;0
2020-03-19;MN;Mongolia;0;0;6;0
2020-03-20;MN;Mongolia;0;0;6;0
2020-03-21;MN;Mongolia;4;0;10;0
2020-03-22;MN;Mongolia;0;0;10;0
2020-03-23;MN;Mongolia;0;0;10;0
2020-03-24;MN;Mongolia;0;0;10;0
2020-03-25;MN;Mongolia;0;0;10;0
2020-03-26;MN;Mongolia;1;0;11;0
2020-03-27;MN;Mongolia;0;0;11;0
2020-03-28;MN;Mongolia;1;0;12;0
2020-03-29;MN;Mongolia;0;0;12;0
2020-03-30;MN;Mongolia;0;0;12;0
2020-03-31;MN;Mongolia;0;0;12;0
2020-04-01;MN;Mongolia;2;0;14;0
2020-04-02;MN;Mongolia;0;0;14;0
2020-04-03;MN;Mongolia;0;0;14;0
2020-04-04;MN;Mongolia;0;0;14;0
2020-04-05;MN;Mongolia;0;0;14;0
2020-04-06;MN;Mongolia;1;0;15;0
2020-04-07;MN;Mongolia;0;0;15;0
2020-04-08;MN;Mongolia;1;0;16;0
2020-04-09;MN;Mongolia;0;0;16;0
2020-04-10;MN;Mongolia;0;0;16;0
2020-04-11;MN;Mongolia;0;0;16;0
2020-04-12;MN;Mongolia;0;0;16;0
2020-04-13;MN;Mongolia;1;0;17;0
2020-04-14;MN;Mongolia;13;0;30;0
2020-04-15;MN;Mongolia;0;0;30;0
2020-04-16;MN;Mongolia;1;0;31;0
2020-04-17;MN;Mongolia;0;0;31;0
2020-04-18;MN;Mongolia;0;0;31;0
2020-04-19;MN;Mongolia;1;0;32;0
2020-04-20;MN;Mongolia;1;0;33;0
2020-04-21;MN;Mongolia;1;0;34;0
2020-04-22;MN;Mongolia;1;0;35;0
2020-04-23;MN;Mongolia;1;0;36;0
2020-04-24;MN;Mongolia;1;0;37;0
2020-04-25;MN;Mongolia;0;0;37;0
2020-04-26;MN;Mongolia;1;0;38;0
2020-04-27;MN;Mongolia;0;0;38;0
2020-04-28;MN;Mongolia;0;0;38;0
2020-04-29;MN;Mongolia;0;0;38;0
2020-04-30;MN;Mongolia;0;0;38;0
2020-05-01;MN;Mongolia;0;0;38;0
2020-05-02;MN;Mongolia;1;0;39;0
2020-05-03;MN;Mongolia;0;0;39;0
2020-05-04;MN;Mongolia;1;0;40;0
2020-05-05;MN;Mongolia;1;0;41;0
2020-05-06;MN;Mongolia;0;0;41;0
2020-05-07;MN;Mongolia;0;0;41;0
2020-05-08;MN;Mongolia;1;0;42;0
2020-05-09;MN;Mongolia;0;0;42;0
2020-05-10;MN;Mongolia;0;0;42;0
2020-05-11;MN;Mongolia;0;0;42;0
2020-05-12;MN;Mongolia;0;0;42;0
2020-05-13;MN;Mongolia;0;0;42;0
2020-05-14;MN;Mongolia;56;0;98;0
2020-05-15;MN;Mongolia;0;0;98;0
2020-05-16;MN;Mongolia;37;0;135;0
2020-05-17;MN;Mongolia;1;0;136;0
2020-05-18;MN;Mongolia;4;0;140;0
2020-05-19;MN;Mongolia;0;0;140;0
2020-05-20;MN;Mongolia;0;0;140;0
2020-05-21;MN;Mongolia;0;0;140;0
2020-05-22;MN;Mongolia;1;0;141;0
2020-05-23;MN;Mongolia;0;0;141;0
2020-05-24;MN;Mongolia;0;0;141;0
2020-05-25;MN;Mongolia;0;0;141;0
2020-05-26;MN;Mongolia;0;0;141;0
2020-05-27;MN;Mongolia;7;0;148;0
2020-05-28;MN;Mongolia;13;0;161;0
2020-05-29;MN;Mongolia;18;0;179;0
2020-05-30;MN;Mongolia;0;0;179;0
2020-05-31;MN;Mongolia;0;0;179;0
2020-06-01;MN;Mongolia;6;0;185;0
2020-06-02;MN;Mongolia;0;0;185;0
2020-06-03;MN;Mongolia;0;0;185;0
2020-06-04;MN;Mongolia;1;0;186;0
2020-06-05;MN;Mongolia;5;0;191;0
2020-06-06;MN;Mongolia;2;0;193;0
2020-06-07;MN;Mongolia;0;0;193;0
2020-06-08;MN;Mongolia;1;0;194;0
2020-06-09;MN;Mongolia;0;0;194;0
2020-06-10;MN;Mongolia;0;0;194;0
2020-06-11;MN;Mongolia;3;0;197;0
2020-06-12;MN;Mongolia;0;0;197;0
2020-06-13;MN;Mongolia;0;0;197;0
2020-06-14;MN;Mongolia;0;0;197;0
2020-06-15;MN;Mongolia;0;0;197;0
2020-06-16;MN;Mongolia;0;0;197;0
2020-06-17;MN;Mongolia;4;0;201;0
2020-06-18;MN;Mongolia;3;0;204;0
2020-06-19;MN;Mongolia;0;0;204;0
2020-06-20;MN;Mongolia;2;0;206;0
2020-06-21;MN;Mongolia;7;0;213;0
2020-06-22;MN;Mongolia;2;0;215;0
2020-06-23;MN;Mongolia;0;0;215;0
2020-06-24;MN;Mongolia;1;0;216;0
2020-06-25;MN;Mongolia;3;0;219;0
2020-06-26;MN;Mongolia;0;0;219;0
2020-06-27;MN;Mongolia;0;0;219;0
2020-06-28;MN;Mongolia;1;0;220;0
2020-06-29;MN;Mongolia;0;0;220;0
2020-06-30;MN;Mongolia;0;0;220;0
2020-07-01;MN;Mongolia;0;0;220;0
2020-07-02;MN;Mongolia;0;0;220;0
2020-07-03;MN;Mongolia;0;0;220;0
2020-07-04;MN;Mongolia;0;0;220;0
2020-07-05;MN;Mongolia;0;0;220;0
2020-07-06;MN;Mongolia;5;0;225;0
2020-07-07;MN;Mongolia;2;0;227;0
2020-07-08;MN;Mongolia;0;0;227;0
2020-07-09;MN;Mongolia;0;0;227;0
2020-07-10;MN;Mongolia;0;0;227;0
2020-07-11;MN;Mongolia;3;0;230;0
2020-07-12;MN;Mongolia;0;0;230;0
2020-07-13;MN;Mongolia;13;0;243;0
2020-07-14;MN;Mongolia;18;0;261;0
2020-07-15;MN;Mongolia;0;0;261;0
2020-07-16;MN;Mongolia;1;0;262;0
2020-07-17;MN;Mongolia;25;0;287;0
2020-07-18;MN;Mongolia;0;0;287;0
2020-07-19;MN;Mongolia;0;0;287;0
2020-07-20;MN;Mongolia;0;0;287;0
2020-07-21;MN;Mongolia;0;0;287;0
2020-07-22;MN;Mongolia;0;0;287;0
2020-07-23;MN;Mongolia;1;0;288;0
2020-07-24;MN;Mongolia;0;0;288;0
2020-07-25;MN;Mongolia;0;0;288;0
2020-07-26;MN;Mongolia;0;0;288;0
2020-07-27;MN;Mongolia;1;0;289;0
2020-07-28;MN;Mongolia;2;0;291;0
2020-07-29;MN;Mongolia;0;0;291;0
2020-07-30;MN;Mongolia;0;0;291;0
2020-07-31;MN;Mongolia;0;0;291;0
2020-08-01;MN;Mongolia;2;0;293;0
2020-08-02;MN;Mongolia;0;0;293;0
2020-08-03;MN;Mongolia;0;0;293;0
2020-08-04;MN;Mongolia;0;0;293;0
2020-08-05;MN;Mongolia;0;0;293;0
2020-08-06;MN;Mongolia;0;0;293;0
2020-08-07;MN;Mongolia;0;0;293;0
2020-08-08;MN;Mongolia;0;0;293;0
2020-08-09;MN;Mongolia;0;0;293;0
2020-08-10;MN;Mongolia;0;0;293;0
2020-08-11;MN;Mongolia;0;0;293;0
2020-08-12;MN;Mongolia;4;0;297;0
2020-08-13;MN;Mongolia;0;0;297;0
2020-08-14;MN;Mongolia;1;0;298;0
2020-08-15;MN;Mongolia;0;0;298;0
2020-08-16;MN;Mongolia;0;0;298;0
2020-08-17;MN;Mongolia;0;0;298;0
2020-08-18;MN;Mongolia;0;0;298;0
2020-08-19;MN;Mongolia;0;0;298;0
2020-08-20;MN;Mongolia;0;0;298;0
2020-08-21;MN;Mongolia;0;0;298;0
2020-08-22;MN;Mongolia;0;0;298;0
2020-08-23;MN;Mongolia;0;0;298;0
2020-08-24;MN;Mongolia;0;0;298;0
2020-08-25;MN;Mongolia;2;0;300;0
2020-08-26;MN;Mongolia;1;0;301;0
2020-08-27;MN;Mongolia;0;0;301;0
2020-08-28;MN;Mongolia;0;0;301;0
2020-08-29;MN;Mongolia;0;0;301;0
2020-08-30;MN;Mongolia;0;0;301;0
2020-08-31;MN;Mongolia;3;0;304;0
2020-09-01;MN;Mongolia;2;0;306;0
2020-09-02;MN;Mongolia;0;0;306;0
2020-09-03;MN;Mongolia;4;0;310;0
2020-09-04;MN;Mongolia;0;0;310;0
2020-09-05;MN;Mongolia;0;0;310;0
2020-09-06;MN;Mongolia;0;0;310;0
2020-09-07;MN;Mongolia;0;0;310;0
2020-09-08;MN;Mongolia;0;0;310;0
2020-09-09;MN;Mongolia;0;0;310;0
2020-09-10;MN;Mongolia;1;0;311;0
2020-09-11;MN;Mongolia;0;0;311;0
2020-09-12;MN;Mongolia;0;0;311;0
2020-09-13;MN;Mongolia;0;0;311;0
2020-09-14;MN;Mongolia;0;0;311;0
2020-09-15;MN;Mongolia;0;0;311;0
2020-09-16;MN;Mongolia;0;0;311;0
2020-09-17;MN;Mongolia;0;0;311;0
2020-09-18;MN;Mongolia;0;0;311;0
2020-09-19;MN;Mongolia;1;0;312;0
2020-09-20;MN;Mongolia;0;0;312;0
2020-09-21;MN;Mongolia;1;0;313;0
2020-09-22;MN;Mongolia;0;0;313;0
2020-09-23;MN;Mongolia;0;0;313;0
2020-09-24;MN;Mongolia;0;0;313;0
2020-09-25;MN;Mongolia;0;0;313;0
2020-09-26;MN;Mongolia;0;0;313;0
2020-09-27;MN;Mongolia;0;0;313;0
2020-09-28;MN;Mongolia;0;0;313;0
2020-09-29;MN;Mongolia;0;0;313;0
2020-09-30;MN;Mongolia;0;0;313;0
2020-10-01;MN;Mongolia;0;0;313;0
2020-10-02;MN;Mongolia;0;0;313;0
2020-10-03;MN;Mongolia;0;0;313;0
2020-10-04;MN;Mongolia;1;0;314;0
2020-10-05;MN;Mongolia;1;0;315;0
2020-10-06;MN;Mongolia;0;0;315;0
2020-10-07;MN;Mongolia;0;0;315;0
2020-10-08;MN;Mongolia;0;0;315;0
2020-10-09;MN;Mongolia;0;0;315;0
2020-10-10;MN;Mongolia;0;0;315;0
2020-10-11;MN;Mongolia;3;0;318;0
2020-10-12;MN;Mongolia;2;0;320;0
2020-10-13;MN;Mongolia;0;0;320;0
2020-10-14;MN;Mongolia;0;0;320;0
2020-10-15;MN;Mongolia;0;0;320;0
2020-10-16;MN;Mongolia;0;0;320;0
2020-10-17;MN;Mongolia;0;0;320;0
2020-10-18;MN;Mongolia;4;0;324;0
2020-10-19;MN;Mongolia;2;0;326;0
2020-10-20;MN;Mongolia;1;0;327;0
2020-10-21;MN;Mongolia;1;0;328;0
2020-10-22;MN;Mongolia;0;0;328;0
2020-10-23;MN;Mongolia;0;0;328;0
2020-10-24;MN;Mongolia;10;0;338;0
2020-10-25;MN;Mongolia;1;0;339;0
2020-10-26;MN;Mongolia;1;0;340;0
2020-10-27;MN;Mongolia;0;0;340;0
2020-10-28;MN;Mongolia;0;0;340;0
2020-10-29;MN;Mongolia;0;0;340;0
2020-10-30;MN;Mongolia;6;0;346;0
2020-10-31;MN;Mongolia;0;0;346;0
2020-11-01;MN;Mongolia;3;0;349;0
2020-11-02;MN;Mongolia;1;0;350;0
2020-11-03;MN;Mongolia;2;0;352;0
2020-11-04;MN;Mongolia;1;0;353;0
2020-11-05;MN;Mongolia;3;0;356;0
2020-11-06;MN;Mongolia;1;0;357;0
2020-11-07;MN;Mongolia;0;0;357;0
2020-11-08;MN;Mongolia;5;0;362;0
2020-11-09;MN;Mongolia;6;0;368;0
2020-11-10;MN;Mongolia;14;0;382;0
2020-11-11;MN;Mongolia;24;0;406;0
2020-11-12;MN;Mongolia;6;0;412;0
2020-11-13;MN;Mongolia;4;0;416;0
2020-11-14;MN;Mongolia;12;0;428;0
2020-11-15;MN;Mongolia;3;0;431;0
2020-11-16;MN;Mongolia;3;0;434;0
2020-11-17;MN;Mongolia;21;0;455;0
2020-11-18;MN;Mongolia;50;0;505;0
2020-11-19;MN;Mongolia;50;0;555;0
2020-11-20;MN;Mongolia;23;0;578;0
2020-11-21;MN;Mongolia;30;0;608;0
2020-11-22;MN;Mongolia;32;0;640;0
2020-11-23;MN;Mongolia;32;0;672;0
2020-11-24;MN;Mongolia;27;0;699;0
2020-11-25;MN;Mongolia;13;0;712;0
2020-11-26;MN;Mongolia;26;0;738;0
2020-11-27;MN;Mongolia;22;0;760;0
2020-11-28;MN;Mongolia;24;0;784;0
2020-11-29;MN;Mongolia;7;0;791;0
2020-11-30;MN;Mongolia;10;0;801;0
2020-12-01;MN;Mongolia;11;0;812;0
2020-12-02;MN;Mongolia;7;0;819;0
2020-12-03;MN;Mongolia;12;0;831;0
2020-12-04;MN;Mongolia;11;0;842;0
2020-12-05;MN;Mongolia;7;0;849;0
2020-12-06;MN;Mongolia;38;0;887;0
2020-12-07;MN;Mongolia;1;0;888;0
2020-12-08;MN;Mongolia;5;0;893;0
2020-12-09;MN;Mongolia;5;0;898;0
2020-12-10;MN;Mongolia;7;0;905;0
2020-12-11;MN;Mongolia;1;0;906;0
2020-12-12;MN;Mongolia;1;0;907;0
2020-12-13;MN;Mongolia;5;0;912;0
2020-12-14;MN;Mongolia;5;0;917;0
2020-12-15;MN;Mongolia;1;0;918;0
2020-12-16;MN;Mongolia;5;0;923;0
2020-12-17;MN;Mongolia;18;0;941;0
2020-12-18;MN;Mongolia;12;0;953;0
2020-12-19;MN;Mongolia;8;0;961;0
2020-12-20;MN;Mongolia;32;0;993;0
2020-12-21;MN;Mongolia;13;0;1006;0
2020-12-22;MN;Mongolia;57;0;1063;0
2020-12-23;MN;Mongolia;6;0;1069;0
2020-12-24;MN;Mongolia;6;0;1075;0
2020-12-25;MN;Mongolia;7;0;1082;0
2020-12-26;MN;Mongolia;39;0;1121;0
2020-12-27;MN;Mongolia;16;0;1137;0
2020-12-28;MN;Mongolia;38;0;1175;0
2020-12-29;MN;Mongolia;20;1;1195;1
2020-12-30;MN;Mongolia;20;0;1215;1
2020-12-31;MN;Mongolia;5;0;1220;1
2021-01-01;MN;Mongolia;22;0;1242;1
2021-01-02;MN;Mongolia;21;0;1263;1
2021-01-03;MN;Mongolia;23;0;1286;1
2021-01-04;MN;Mongolia;22;0;1308;1
2021-01-05;MN;Mongolia;0;0;1308;1
2021-01-06;MN;Mongolia;0;0;1308;1
2021-01-07;MN;Mongolia;87;1;1395;2
2021-01-08;MN;Mongolia;13;0;1408;2
2021-01-09;MN;Mongolia;21;0;1429;2
2021-01-10;MN;Mongolia;13;0;1442;2
2021-01-11;MN;Mongolia;14;0;1456;2
2021-01-12;MN;Mongolia;13;0;1469;2
2021-01-13;MN;Mongolia;10;0;1479;2
2021-01-14;MN;Mongolia;12;0;1491;2
2021-01-15;MN;Mongolia;21;0;1512;2
2021-01-16;MN;Mongolia;5;0;1517;2
2021-01-17;MN;Mongolia;9;0;1526;2
2021-01-18;MN;Mongolia;10;0;1536;2
2021-01-19;MN;Mongolia;32;0;1568;2
2021-01-20;MN;Mongolia;16;0;1584;2
2021-01-21;MN;Mongolia;8;0;1592;2
2021-01-22;MN;Mongolia;19;0;1611;2
2021-01-23;MN;Mongolia;16;0;1627;2
2021-01-24;MN;Mongolia;16;0;1643;2
2021-01-25;MN;Mongolia;13;0;1656;2
2021-01-26;MN;Mongolia;11;0;1667;2
2021-01-27;MN;Mongolia;25;0;1692;2
2021-01-28;MN;Mongolia;18;0;1710;2
2021-01-29;MN;Mongolia;32;0;1742;2
2021-01-30;MN;Mongolia;37;0;1779;2
2021-01-31;MN;Mongolia;35;0;1814;2
2021-02-01;MN;Mongolia;18;0;1832;2
2021-02-02;MN;Mongolia;27;0;1859;2
2021-02-03;MN;Mongolia;31;0;1890;2
2021-02-04;MN;Mongolia;38;0;1928;2
2021-02-05;MN;Mongolia;61;0;1989;2
2021-02-06;MN;Mongolia;34;0;2023;2
2021-02-07;MN;Mongolia;50;0;2073;2
2021-02-08;MN;Mongolia;47;0;2120;2
2021-02-09;MN;Mongolia;54;0;2174;2
2021-02-10;MN;Mongolia;33;0;2207;2
2021-02-11;MN;Mongolia;40;0;2247;2
2021-02-12;MN;Mongolia;46;0;2293;2
2021-02-13;MN;Mongolia;58;0;2351;2
2021-02-14;MN;Mongolia;32;0;2383;2
2021-02-15;MN;Mongolia;33;0;2416;2
2021-02-16;MN;Mongolia;28;0;2444;2
2021-02-17;MN;Mongolia;49;0;2493;2
2021-02-18;MN;Mongolia;58;0;2551;2
2021-02-19;MN;Mongolia;35;0;2586;2
2021-02-20;MN;Mongolia;52;0;2638;2
2021-02-21;MN;Mongolia;55;0;2693;2
2021-02-22;MN;Mongolia;30;0;2723;2
2021-02-23;MN;Mongolia;32;0;2755;2
2021-02-24;MN;Mongolia;46;0;2801;2
2021-02-25;MN;Mongolia;30;0;2831;2
2021-02-26;MN;Mongolia;35;0;2866;2
2021-02-27;MN;Mongolia;41;0;2907;2
2021-02-28;MN;Mongolia;45;0;2952;2
2021-03-01;MN;Mongolia;48;0;3000;2
2021-03-02;MN;Mongolia;32;0;3032;2
2021-03-03;MN;Mongolia;44;0;3076;2
2021-03-04;MN;Mongolia;77;0;3153;2
2021-03-05;MN;Mongolia;8;0;3161;2
2021-03-06;MN;Mongolia;67;0;3228;2
2021-03-07;MN;Mongolia;108;0;3336;2
2021-03-08;MN;Mongolia;36;1;3372;3
2021-03-09;MN;Mongolia;109;0;3481;3
2021-03-10;MN;Mongolia;0;0;3481;3
2021-03-11;MN;Mongolia;183;1;3664;4
2021-03-12;MN;Mongolia;169;0;3833;4
2021-03-13;MN;Mongolia;128;0;3961;4
2021-03-14;MN;Mongolia;122;0;4083;4
2021-03-15;MN;Mongolia;127;0;4210;4
2021-03-16;MN;Mongolia;130;0;4340;4
2021-03-17;MN;Mongolia;158;0;4498;4
2021-03-18;MN;Mongolia;160;0;4658;4
2021-03-19;MN;Mongolia;148;0;4806;4
2021-03-20;MN;Mongolia;0;0;4806;4
2021-03-21;MN;Mongolia;380;1;5186;5
2021-03-22;MN;Mongolia;206;0;5392;5
2021-03-23;MN;Mongolia;218;0;5610;5
2021-03-24;MN;Mongolia;285;0;5895;5
2021-03-25;MN;Mongolia;437;0;6332;5
2021-03-26;MN;Mongolia;361;0;6693;5
2021-03-27;MN;Mongolia;0;0;6693;5
2021-03-28;MN;Mongolia;896;1;7589;6
2021-03-29;MN;Mongolia;481;0;8070;6
2021-03-30;MN;Mongolia;377;0;8447;6
2021-03-31;MN;Mongolia;394;2;8841;8
2021-04-01;MN;Mongolia;0;0;8841;8
2021-04-02;MN;Mongolia;757;2;9598;10
2021-04-03;MN;Mongolia;0;0;9598;10
2021-04-04;MN;Mongolia;1222;1;10820;11
2021-04-05;MN;Mongolia;831;2;11651;13
2021-04-06;MN;Mongolia;0;0;11651;13
2021-04-07;MN;Mongolia;575;4;12226;17
2021-04-08;MN;Mongolia;1268;2;13494;19
2021-04-09;MN;Mongolia;689;1;14183;20
2021-04-10;MN;Mongolia;0;0;14183;20
2021-04-11;MN;Mongolia;831;2;15014;22
2021-04-12;MN;Mongolia;1589;5;16603;27
2021-04-13;MN;Mongolia;1220;2;17823;29
2021-04-14;MN;Mongolia;742;2;18565;31
2021-04-15;MN;Mongolia;0;0;18565;31
2021-04-16;MN;Mongolia;1107;6;19672;37
2021-04-17;MN;Mongolia;2323;7;21995;44
2021-04-18;MN;Mongolia;889;5;22884;49
2021-04-19;MN;Mongolia;1311;2;24195;51
2021-04-20;MN;Mongolia;1169;5;25364;56
2021-04-21;MN;Mongolia;0;0;25364;56
2021-04-22;MN;Mongolia;1328;5;26692;61
2021-04-23;MN;Mongolia;2527;13;29219;74
2021-04-24;MN;Mongolia;1264;4;30483;78
2021-04-25;MN;Mongolia;856;2;31339;80
2021-04-26;MN;Mongolia;0;0;31339;80
2021-04-27;MN;Mongolia;1098;8;32437;88
2021-04-28;MN;Mongolia;1171;9;33608;97
2021-04-29;MN;Mongolia;2371;13;35979;110
2021-04-30;MN;Mongolia;1306;5;37285;115
2021-05-01;MN;Mongolia;0;0;37285;115
2021-05-02;MN;Mongolia;2096;4;39381;119
2021-05-03;MN;Mongolia;1015;7;40396;126
2021-05-04;MN;Mongolia;1128;4;41524;130
2021-05-05;MN;Mongolia;0;0;41524;130
2021-05-06;MN;Mongolia;1677;23;43201;153
2021-05-07;MN;Mongolia;815;7;44016;160
2021-05-08;MN;Mongolia;804;2;44820;162
2021-05-09;MN;Mongolia;639;8;45459;170
2021-05-10;MN;Mongolia;477;9;45936;179
2021-05-11;MN;Mongolia;512;5;46448;184
2021-05-12;MN;Mongolia;585;9;47033;193
2021-05-13;MN;Mongolia;515;7;47548;200
2021-05-14;MN;Mongolia;553;5;48101;205
2021-05-15;MN;Mongolia;541;2;48642;207
2021-05-16;MN;Mongolia;533;7;49175;214
2021-05-17;MN;Mongolia;349;7;49524;221
2021-05-18;MN;Mongolia;575;6;50099;227
2021-05-19;MN;Mongolia;519;8;50618;235
2021-05-20;MN;Mongolia;629;5;51247;240
2021-05-21;MN;Mongolia;684;4;51931;244
2021-05-22;MN;Mongolia;539;4;52470;248
2021-05-23;MN;Mongolia;630;5;53100;253
2021-05-24;MN;Mongolia;634;2;53734;255
2021-05-25;MN;Mongolia;680;2;54414;257
2021-05-26;MN;Mongolia;653;2;55067;259
2021-05-27;MN;Mongolia;785;4;55852;263
2021-05-28;MN;Mongolia;769;5;56621;268
2021-05-29;MN;Mongolia;0;0;56621;268
2021-05-30;MN;Mongolia;891;4;57512;272
2021-05-31;MN;Mongolia;927;4;58439;276
2021-06-01;MN;Mongolia;1933;10;60372;286
2021-06-02;MN;Mongolia;0;0;60372;286
2021-06-03;MN;Mongolia;2213;15;62585;301
2021-06-04;MN;Mongolia;1393;6;63978;307
2021-06-05;MN;Mongolia;0;0;63978;307
2021-06-06;MN;Mongolia;2465;6;66443;313
2021-06-07;MN;Mongolia;1267;5;67710;318
2021-06-08;MN;Mongolia;0;0;67710;318
2021-06-09;MN;Mongolia;1312;6;69022;324
2021-06-10;MN;Mongolia;1460;10;70482;334
2021-06-11;MN;Mongolia;1622;8;72104;342
2021-06-12;MN;Mongolia;1792;9;73896;351
2021-06-13;MN;Mongolia;2188;14;76084;365
2021-06-14;MN;Mongolia;2263;4;78347;369
2021-06-15;MN;Mongolia;4781;20;83128;389
2021-06-16;MN;Mongolia;2642;11;85770;400
2021-06-17;MN;Mongolia;2746;11;88516;411
2021-06-18;MN;Mongolia;2635;14;91151;425
2021-06-19;MN;Mongolia;0;0;91151;425
2021-06-20;MN;Mongolia;2400;11;93551;436
2021-06-21;MN;Mongolia;4499;23;98050;459
2021-06-22;MN;Mongolia;0;0;98050;459
2021-06-23;MN;Mongolia;4579;23;102629;482
2021-06-24;MN;Mongolia;2271;11;104900;493
2021-06-25;MN;Mongolia;2362;12;107262;505
2021-06-26;MN;Mongolia;2432;13;109694;518
2021-06-27;MN;Mongolia;1811;15;111505;533
2021-06-28;MN;Mongolia;0;0;111505;533
2021-06-29;MN;Mongolia;1727;15;113232;548
2021-06-30;MN;Mongolia;2246;15;115478;563
2021-07-01;MN;Mongolia;4861;29;120339;592
2020-03-17;ME;Montenegro;2;0;2;0
2020-03-18;ME;Montenegro;0;0;2;0
2020-03-19;ME;Montenegro;1;0;3;0
2020-03-20;ME;Montenegro;11;0;14;0
2020-03-21;ME;Montenegro;0;0;14;0
2020-03-22;ME;Montenegro;7;0;21;0
2020-03-23;ME;Montenegro;6;1;27;1
2020-03-24;ME;Montenegro;20;0;47;1
2020-03-25;ME;Montenegro;5;0;52;1
2020-03-26;ME;Montenegro;17;0;69;1
2020-03-27;ME;Montenegro;13;0;82;1
2020-03-28;ME;Montenegro;2;0;84;1
2020-03-29;ME;Montenegro;1;0;85;1
2020-03-30;ME;Montenegro;6;0;91;1
2020-03-31;ME;Montenegro;18;1;109;2
2020-04-01;ME;Montenegro;14;0;123;2
2020-04-02;ME;Montenegro;21;0;144;2
2020-04-03;ME;Montenegro;30;0;174;2
2020-04-04;ME;Montenegro;27;0;201;2
2020-04-05;ME;Montenegro;13;0;214;2
2020-04-06;ME;Montenegro;19;0;233;2
2020-04-07;ME;Montenegro;8;0;241;2
2020-04-08;ME;Montenegro;7;0;248;2
2020-04-09;ME;Montenegro;4;0;252;2
2020-04-10;ME;Montenegro;3;0;255;2
2020-04-11;ME;Montenegro;8;0;263;2
2020-04-12;ME;Montenegro;9;1;272;3
2020-04-13;ME;Montenegro;2;0;274;3
2020-04-14;ME;Montenegro;9;1;283;4
2020-04-15;ME;Montenegro;5;0;288;4
2020-04-16;ME;Montenegro;15;0;303;4
2020-04-17;ME;Montenegro;0;1;303;5
2020-04-18;ME;Montenegro;4;0;307;5
2020-04-19;ME;Montenegro;1;0;308;5
2020-04-20;ME;Montenegro;4;0;312;5
2020-04-21;ME;Montenegro;1;0;313;5
2020-04-22;ME;Montenegro;2;0;315;5
2020-04-23;ME;Montenegro;1;0;316;5
2020-04-24;ME;Montenegro;3;1;319;6
2020-04-25;ME;Montenegro;1;0;320;6
2020-04-26;ME;Montenegro;1;1;321;7
2020-04-27;ME;Montenegro;0;0;321;7
2020-04-28;ME;Montenegro;0;0;321;7
2020-04-29;ME;Montenegro;1;0;322;7
2020-04-30;ME;Montenegro;0;0;322;7
2020-05-01;ME;Montenegro;0;0;322;7
2020-05-02;ME;Montenegro;0;1;322;8
2020-05-03;ME;Montenegro;0;0;322;8
2020-05-04;ME;Montenegro;1;0;323;8
2020-05-05;ME;Montenegro;1;0;324;8
2020-05-06;ME;Montenegro;0;0;324;8
2020-05-07;ME;Montenegro;0;0;324;8
2020-05-08;ME;Montenegro;0;0;324;8
2020-05-09;ME;Montenegro;0;0;324;8
2020-05-10;ME;Montenegro;0;1;324;9
2020-05-11;ME;Montenegro;0;0;324;9
2020-05-12;ME;Montenegro;0;0;324;9
2020-05-13;ME;Montenegro;0;0;324;9
2020-05-14;ME;Montenegro;0;0;324;9
2020-05-15;ME;Montenegro;0;0;324;9
2020-05-16;ME;Montenegro;0;0;324;9
2020-05-17;ME;Montenegro;0;0;324;9
2020-05-18;ME;Montenegro;0;0;324;9
2020-05-19;ME;Montenegro;0;0;324;9
2020-05-20;ME;Montenegro;0;0;324;9
2020-05-21;ME;Montenegro;0;0;324;9
2020-05-22;ME;Montenegro;0;0;324;9
2020-05-23;ME;Montenegro;0;0;324;9
2020-05-24;ME;Montenegro;0;0;324;9
2020-05-25;ME;Montenegro;0;0;324;9
2020-05-26;ME;Montenegro;0;0;324;9
2020-05-27;ME;Montenegro;0;0;324;9
2020-05-28;ME;Montenegro;0;0;324;9
2020-05-29;ME;Montenegro;0;0;324;9
2020-05-30;ME;Montenegro;0;0;324;9
2020-05-31;ME;Montenegro;0;0;324;9
2020-06-01;ME;Montenegro;0;0;324;9
2020-06-02;ME;Montenegro;0;0;324;9
2020-06-03;ME;Montenegro;0;0;324;9
2020-06-04;ME;Montenegro;0;0;324;9
2020-06-05;ME;Montenegro;0;0;324;9
2020-06-06;ME;Montenegro;0;0;324;9
2020-06-07;ME;Montenegro;0;0;324;9
2020-06-08;ME;Montenegro;0;0;324;9
2020-06-09;ME;Montenegro;0;0;324;9
2020-06-10;ME;Montenegro;0;0;324;9
2020-06-11;ME;Montenegro;0;0;324;9
2020-06-12;ME;Montenegro;0;0;324;9
2020-06-13;ME;Montenegro;0;0;324;9
2020-06-14;ME;Montenegro;1;0;325;9
2020-06-15;ME;Montenegro;1;0;326;9
2020-06-16;ME;Montenegro;0;0;326;9
2020-06-17;ME;Montenegro;7;0;333;9
2020-06-18;ME;Montenegro;4;0;337;9
2020-06-19;ME;Montenegro;18;0;355;9
2020-06-20;ME;Montenegro;4;0;359;9
2020-06-21;ME;Montenegro;3;0;362;9
2020-06-22;ME;Montenegro;5;0;367;9
2020-06-23;ME;Montenegro;11;0;378;9
2020-06-24;ME;Montenegro;11;0;389;9
2020-06-25;ME;Montenegro;25;0;414;9
2020-06-26;ME;Montenegro;25;0;439;9
2020-06-27;ME;Montenegro;30;0;469;9
2020-06-28;ME;Montenegro;12;2;481;11
2020-06-29;ME;Montenegro;20;0;501;11
2020-06-30;ME;Montenegro;47;1;548;12
2020-07-01;ME;Montenegro;28;0;576;12
2020-07-02;ME;Montenegro;40;0;616;12
2020-07-03;ME;Montenegro;47;1;663;13
2020-07-04;ME;Montenegro;57;1;720;14
2020-07-05;ME;Montenegro;61;0;781;14
2020-07-06;ME;Montenegro;60;0;841;14
2020-07-07;ME;Montenegro;66;3;907;17
2020-07-08;ME;Montenegro;53;0;960;17
2020-07-09;ME;Montenegro;59;2;1019;19
2020-07-10;ME;Montenegro;0;0;1019;19
2020-07-11;ME;Montenegro;145;4;1164;23
2020-07-12;ME;Montenegro;57;0;1221;23
2020-07-13;ME;Montenegro;66;1;1287;24
2020-07-14;ME;Montenegro;0;0;1287;24
2020-07-15;ME;Montenegro;0;0;1287;24
2020-07-16;ME;Montenegro;0;0;1287;24
2020-07-17;ME;Montenegro;678;2;1965;26
2020-07-18;ME;Montenegro;107;4;2072;30
2020-07-19;ME;Montenegro;116;2;2188;32
2020-07-20;ME;Montenegro;0;0;2188;32
2020-07-21;ME;Montenegro;193;3;2381;35
2020-07-22;ME;Montenegro;91;4;2472;39
2020-07-23;ME;Montenegro;97;1;2569;40
2020-07-24;ME;Montenegro;96;3;2665;43
2020-07-25;ME;Montenegro;82;0;2747;43
2020-07-26;ME;Montenegro;52;0;2799;43
2020-07-27;ME;Montenegro;94;2;2893;45
2020-07-28;ME;Montenegro;56;0;2949;45
2020-07-29;ME;Montenegro;67;2;3016;47
2020-07-30;ME;Montenegro;0;0;3016;47
2020-07-31;ME;Montenegro;57;1;3073;48
2020-08-01;ME;Montenegro;125;2;3198;50
2020-08-02;ME;Montenegro;60;1;3258;51
2020-08-03;ME;Montenegro;43;1;3301;52
2020-08-04;ME;Montenegro;60;1;3361;53
2020-08-05;ME;Montenegro;50;4;3411;57
2020-08-06;ME;Montenegro;69;3;3480;60
2020-08-07;ME;Montenegro;69;1;3549;61
2020-08-08;ME;Montenegro;39;1;3588;62
2020-08-09;ME;Montenegro;30;2;3618;64
2020-08-10;ME;Montenegro;78;4;3696;68
2020-08-11;ME;Montenegro;52;3;3748;71
2020-08-12;ME;Montenegro;65;2;3813;73
2020-08-13;ME;Montenegro;44;0;3857;73
2020-08-14;ME;Montenegro;73;0;3930;73
2020-08-15;ME;Montenegro;30;2;3960;75
2020-08-16;ME;Montenegro;75;2;4035;77
2020-08-17;ME;Montenegro;50;3;4085;80
2020-08-18;ME;Montenegro;47;0;4132;80
2020-08-19;ME;Montenegro;42;0;4174;80
2020-08-20;ME;Montenegro;55;1;4229;81
2020-08-21;ME;Montenegro;48;1;4277;82
2020-08-22;ME;Montenegro;36;2;4313;84
2020-08-23;ME;Montenegro;30;0;4343;84
2020-08-24;ME;Montenegro;35;0;4378;84
2020-08-25;ME;Montenegro;66;3;4444;87
2020-08-26;ME;Montenegro;55;1;4499;88
2020-08-27;ME;Montenegro;59;1;4558;89
2020-08-28;ME;Montenegro;105;3;4663;92
2020-08-29;ME;Montenegro;64;1;4727;93
2020-08-30;ME;Montenegro;63;5;4790;98
2020-08-31;ME;Montenegro;45;2;4835;100
2020-09-01;ME;Montenegro;82;2;4917;102
2020-09-02;ME;Montenegro;102;2;5019;104
2020-09-03;ME;Montenegro;146;0;5165;104
2020-09-04;ME;Montenegro;110;2;5275;106
2020-09-05;ME;Montenegro;147;1;5422;107
2020-09-06;ME;Montenegro;131;1;5553;108
2020-09-07;ME;Montenegro;106;1;5659;109
2020-09-08;ME;Montenegro;216;3;5875;112
2020-09-09;ME;Montenegro;219;2;6094;114
2020-09-10;ME;Montenegro;128;0;6222;114
2020-09-11;ME;Montenegro;163;1;6385;115
2020-09-12;ME;Montenegro;145;3;6530;118
2020-09-13;ME;Montenegro;182;2;6712;120
2020-09-14;ME;Montenegro;188;1;6900;121
2020-09-15;ME;Montenegro;161;2;7061;123
2020-09-16;ME;Montenegro;230;3;7291;126
2020-09-17;ME;Montenegro;212;3;7503;129
2020-09-18;ME;Montenegro;208;4;7711;133
2020-09-19;ME;Montenegro;187;1;7898;134
2020-09-20;ME;Montenegro;714;2;8612;136
2020-09-21;ME;Montenegro;230;2;8842;138
2020-09-22;ME;Montenegro;296;8;9138;146
2020-09-23;ME;Montenegro;290;5;9428;151
2020-09-24;ME;Montenegro;289;3;9717;154
2020-09-25;ME;Montenegro;245;1;9962;155
2020-09-26;ME;Montenegro;235;3;10197;158
2020-09-27;ME;Montenegro;116;0;10313;158
2020-09-28;ME;Montenegro;128;5;10441;163
2020-09-29;ME;Montenegro;134;1;10575;164
2020-09-30;ME;Montenegro;197;5;10772;169
2020-10-01;ME;Montenegro;215;1;10987;170
2020-10-02;ME;Montenegro;703;2;11690;172
2020-10-03;ME;Montenegro;244;2;11934;174
2020-10-04;ME;Montenegro;193;5;12127;179
2020-10-05;ME;Montenegro;232;3;12359;182
2020-10-06;ME;Montenegro;225;6;12584;188
2020-10-07;ME;Montenegro;210;2;12794;190
2020-10-08;ME;Montenegro;210;1;13004;191
2020-10-09;ME;Montenegro;344;3;13348;194
2020-10-10;ME;Montenegro;293;4;13641;198
2020-10-11;ME;Montenegro;228;4;13869;202
2020-10-12;ME;Montenegro;181;9;14050;211
2020-10-13;ME;Montenegro;218;2;14268;213
2020-10-14;ME;Montenegro;193;4;14461;217
2020-10-15;ME;Montenegro;211;4;14672;221
2020-10-16;ME;Montenegro;609;7;15281;228
2020-10-17;ME;Montenegro;146;3;15427;231
2020-10-18;ME;Montenegro;188;5;15615;236
2020-10-19;ME;Montenegro;145;4;15760;240
2020-10-20;ME;Montenegro;132;7;15892;247
2020-10-21;ME;Montenegro;177;3;16069;250
2020-10-22;ME;Montenegro;190;3;16259;253
2020-10-23;ME;Montenegro;177;2;16436;255
2020-10-24;ME;Montenegro;193;8;16629;263
2020-10-25;ME;Montenegro;168;3;16797;266
2020-10-26;ME;Montenegro;112;4;16909;270
2020-10-27;ME;Montenegro;182;5;17091;275
2020-10-28;ME;Montenegro;301;7;17392;282
2020-10-29;ME;Montenegro;354;8;17746;290
2020-10-30;ME;Montenegro;320;4;18066;294
2020-10-31;ME;Montenegro;275;7;18341;301
2020-11-01;ME;Montenegro;373;12;18714;313
2020-11-02;ME;Montenegro;496;7;19210;320
2020-11-03;ME;Montenegro;767;2;19977;322
2020-11-04;ME;Montenegro;874;4;20851;326
2020-11-05;ME;Montenegro;682;2;21533;328
2020-11-06;ME;Montenegro;546;0;22079;328
2020-11-07;ME;Montenegro;300;5;22379;333
2020-11-08;ME;Montenegro;426;4;22805;337
2020-11-09;ME;Montenegro;803;5;23608;342
2020-11-10;ME;Montenegro;546;7;24154;349
2020-11-11;ME;Montenegro;711;7;24865;356
2020-11-12;ME;Montenegro;644;8;25509;364
2020-11-13;ME;Montenegro;600;13;26109;377
2020-11-14;ME;Montenegro;577;8;26686;385
2020-11-15;ME;Montenegro;491;6;27177;391
2020-11-16;ME;Montenegro;596;5;27773;396
2020-11-17;ME;Montenegro;619;9;28392;405
2020-11-18;ME;Montenegro;639;9;29031;414
2020-11-19;ME;Montenegro;546;6;29577;420
2020-11-20;ME;Montenegro;502;9;30079;429
2020-11-21;ME;Montenegro;574;5;30653;434
2020-11-22;ME;Montenegro;409;5;31062;439
2020-11-23;ME;Montenegro;556;5;31618;444
2020-11-24;ME;Montenegro;570;6;32188;450
2020-11-25;ME;Montenegro;620;9;32808;459
2020-11-26;ME;Montenegro;508;10;33316;469
2020-11-27;ME;Montenegro;520;5;33836;474
2020-11-28;ME;Montenegro;618;7;34454;481
2020-11-29;ME;Montenegro;427;6;34881;487
2020-11-30;ME;Montenegro;384;12;35265;499
2020-12-01;ME;Montenegro;584;5;35849;504
2020-12-02;ME;Montenegro;502;6;36351;510
2020-12-03;ME;Montenegro;581;6;36932;516
2020-12-04;ME;Montenegro;535;6;37467;522
2020-12-05;ME;Montenegro;412;8;37879;530
2020-12-06;ME;Montenegro;367;3;38246;533
2020-12-07;ME;Montenegro;316;10;38562;543
2020-12-08;ME;Montenegro;591;6;39153;549
2020-12-09;ME;Montenegro;454;7;39607;556
2020-12-10;ME;Montenegro;558;10;40165;566
2020-12-11;ME;Montenegro;381;3;40546;569
2020-12-12;ME;Montenegro;402;9;40948;578
2020-12-13;ME;Montenegro;478;4;41426;582
2020-12-14;ME;Montenegro;377;3;41803;585
2020-12-15;ME;Montenegro;345;12;42148;597
2020-12-16;ME;Montenegro;415;13;42563;610
2020-12-17;ME;Montenegro;432;4;42995;614
2020-12-18;ME;Montenegro;395;6;43390;620
2020-12-19;ME;Montenegro;319;4;43709;624
2020-12-20;ME;Montenegro;246;2;43955;626
2020-12-21;ME;Montenegro;329;4;44284;630
2020-12-22;ME;Montenegro;258;7;44542;637
2020-12-23;ME;Montenegro;520;2;45062;639
2020-12-24;ME;Montenegro;361;9;45423;648
2020-12-25;ME;Montenegro;522;4;45945;652
2020-12-26;ME;Montenegro;382;6;46327;658
2020-12-27;ME;Montenegro;367;8;46694;666
2020-12-28;ME;Montenegro;275;9;46969;675
2020-12-29;ME;Montenegro;435;2;47404;677
2020-12-30;ME;Montenegro;378;4;47782;681
2020-12-31;ME;Montenegro;465;1;48247;682
2021-01-01;ME;Montenegro;342;2;48589;684
2021-01-02;ME;Montenegro;267;0;48856;684
2021-01-03;ME;Montenegro;339;5;49195;689
2021-01-04;ME;Montenegro;435;3;49630;692
2021-01-05;ME;Montenegro;424;7;50054;699
2021-01-06;ME;Montenegro;643;6;50697;705
2021-01-07;ME;Montenegro;463;7;51160;712
2021-01-08;ME;Montenegro;436;6;51596;718
2021-01-09;ME;Montenegro;403;3;51999;721
2021-01-10;ME;Montenegro;432;4;52431;725
2021-01-11;ME;Montenegro;388;4;52819;729
2021-01-12;ME;Montenegro;519;1;53338;730
2021-01-13;ME;Montenegro;502;7;53840;737
2021-01-14;ME;Montenegro;476;3;54316;740
2021-01-15;ME;Montenegro;414;1;54730;741
2021-01-16;ME;Montenegro;406;2;55136;743
2021-01-17;ME;Montenegro;357;2;55493;745
2021-01-18;ME;Montenegro;310;1;55803;746
2021-01-19;ME;Montenegro;425;3;56228;749
2021-01-20;ME;Montenegro;351;9;56579;758
2021-01-21;ME;Montenegro;419;4;56998;762
2021-01-22;ME;Montenegro;484;3;57482;765
2021-01-23;ME;Montenegro;447;1;57929;766
2021-01-24;ME;Montenegro;387;2;58316;768
2021-01-25;ME;Montenegro;381;2;58697;770
2021-01-26;ME;Montenegro;565;7;59262;777
2021-01-27;ME;Montenegro;563;6;59825;783
2021-01-28;ME;Montenegro;463;7;60288;790
2021-01-29;ME;Montenegro;539;10;60827;800
2021-01-30;ME;Montenegro;375;2;61202;802
2021-01-31;ME;Montenegro;457;3;61659;805
2021-02-01;ME;Montenegro;313;6;61972;811
2021-02-02;ME;Montenegro;504;7;62476;818
2021-02-03;ME;Montenegro;642;7;63118;825
2021-02-04;ME;Montenegro;515;1;63633;826
2021-02-05;ME;Montenegro;535;5;64168;831
2021-02-06;ME;Montenegro;571;5;64739;836
2021-02-07;ME;Montenegro;488;2;65227;838
2021-02-08;ME;Montenegro;430;4;65657;842
2021-02-09;ME;Montenegro;577;10;66234;852
2021-02-10;ME;Montenegro;623;9;66857;861
2021-02-11;ME;Montenegro;584;8;67441;869
2021-02-12;ME;Montenegro;563;11;68004;880
2021-02-13;ME;Montenegro;472;2;68476;882
2021-02-14;ME;Montenegro;445;8;68921;890
2021-02-15;ME;Montenegro;373;9;69294;899
2021-02-16;ME;Montenegro;476;11;69770;910
2021-02-17;ME;Montenegro;404;6;70174;916
2021-02-18;ME;Montenegro;484;10;70658;926
2021-02-19;ME;Montenegro;454;6;71112;932
2021-02-20;ME;Montenegro;481;7;71593;939
2021-02-21;ME;Montenegro;402;11;71995;950
2021-02-22;ME;Montenegro;400;7;72395;957
2021-02-23;ME;Montenegro;574;12;72969;969
2021-02-24;ME;Montenegro;643;7;73612;976
2021-02-25;ME;Montenegro;571;11;74183;987
2021-02-26;ME;Montenegro;606;7;74789;994
2021-02-27;ME;Montenegro;543;5;75332;999
2021-02-28;ME;Montenegro;502;4;75834;1003
2021-03-01;ME;Montenegro;449;12;76283;1015
2021-03-02;ME;Montenegro;585;8;76868;1023
2021-03-03;ME;Montenegro;625;8;77493;1031
2021-03-04;ME;Montenegro;567;8;78060;1039
2021-03-05;ME;Montenegro;574;9;78634;1048
2021-03-06;ME;Montenegro;603;11;79237;1059
2021-03-07;ME;Montenegro;537;8;79774;1067
2021-03-08;ME;Montenegro;417;18;80191;1085
2021-03-09;ME;Montenegro;612;7;80803;1092
2021-03-10;ME;Montenegro;654;8;81457;1100
2021-03-11;ME;Montenegro;572;13;82029;1113
2021-03-12;ME;Montenegro;581;4;82610;1117
2021-03-13;ME;Montenegro;555;5;83165;1122
2021-03-14;ME;Montenegro;528;7;83693;1129
2021-03-15;ME;Montenegro;470;7;84163;1136
2021-03-16;ME;Montenegro;537;15;84700;1151
2021-03-17;ME;Montenegro;553;18;85253;1169
2021-03-18;ME;Montenegro;521;9;85774;1178
2021-03-19;ME;Montenegro;508;6;86282;1184
2021-03-20;ME;Montenegro;500;10;86782;1194
2021-03-21;ME;Montenegro;430;5;87212;1199
2021-03-22;ME;Montenegro;426;9;87638;1208
2021-03-23;ME;Montenegro;478;12;88116;1220
2021-03-24;ME;Montenegro;434;4;88550;1224
2021-03-25;ME;Montenegro;441;6;88991;1230
2021-03-26;ME;Montenegro;372;4;89363;1234
2021-03-27;ME;Montenegro;369;7;89732;1241
2021-03-28;ME;Montenegro;351;4;90083;1245
2021-03-29;ME;Montenegro;335;11;90418;1256
2021-03-30;ME;Montenegro;414;10;90832;1266
2021-03-31;ME;Montenegro;386;8;91218;1274
2021-04-01;ME;Montenegro;355;12;91573;1286
2021-04-02;ME;Montenegro;333;10;91906;1296
2021-04-03;ME;Montenegro;316;7;92222;1303
2021-04-04;ME;Montenegro;297;2;92519;1305
2021-04-05;ME;Montenegro;221;12;92740;1317
2021-04-06;ME;Montenegro;290;9;93030;1326
2021-04-07;ME;Montenegro;279;8;93309;1334
2021-04-08;ME;Montenegro;257;11;93566;1345
2021-04-09;ME;Montenegro;237;9;93803;1354
2021-04-10;ME;Montenegro;232;11;94035;1365
2021-04-11;ME;Montenegro;234;8;94269;1373
2021-04-12;ME;Montenegro;150;8;94419;1381
2021-04-13;ME;Montenegro;224;10;94643;1391
2021-04-14;ME;Montenegro;216;14;94859;1405
2021-04-15;ME;Montenegro;183;7;95042;1412
2021-04-16;ME;Montenegro;163;9;95205;1421
2021-04-17;ME;Montenegro;172;6;95377;1427
2021-04-18;ME;Montenegro;174;2;95551;1429
2021-04-19;ME;Montenegro;144;9;95695;1438
2021-04-20;ME;Montenegro;199;3;95894;1441
2021-04-21;ME;Montenegro;154;3;96048;1444
2021-04-22;ME;Montenegro;139;7;96187;1451
2021-04-23;ME;Montenegro;161;6;96348;1457
2021-04-24;ME;Montenegro;151;6;96499;1463
2021-04-25;ME;Montenegro;161;2;96660;1465
2021-04-26;ME;Montenegro;119;8;96779;1473
2021-04-27;ME;Montenegro;151;5;96930;1478
2021-04-28;ME;Montenegro;150;7;97080;1485
2021-04-29;ME;Montenegro;177;7;97257;1492
2021-04-30;ME;Montenegro;132;3;97389;1495
2021-05-01;ME;Montenegro;128;7;97517;1502
2021-05-02;ME;Montenegro;102;3;97619;1505
2021-05-03;ME;Montenegro;99;5;97718;1510
2021-05-04;ME;Montenegro;95;6;97813;1516
2021-05-05;ME;Montenegro;117;5;97930;1521
2021-05-06;ME;Montenegro;112;5;98042;1526
2021-05-07;ME;Montenegro;100;7;98142;1533
2021-05-08;ME;Montenegro;95;3;98237;1536
2021-05-09;ME;Montenegro;66;4;98303;1540
2021-05-10;ME;Montenegro;62;4;98365;1544
2021-05-11;ME;Montenegro;84;1;98449;1545
2021-05-12;ME;Montenegro;97;3;98546;1548
2021-05-13;ME;Montenegro;73;3;98619;1551
2021-05-14;ME;Montenegro;84;5;98703;1556
2021-05-15;ME;Montenegro;75;4;98778;1560
2021-05-16;ME;Montenegro;74;1;98852;1561
2021-05-17;ME;Montenegro;46;1;98898;1562
2021-05-18;ME;Montenegro;73;2;98971;1564
2021-05-19;ME;Montenegro;60;2;99031;1566
2021-05-20;ME;Montenegro;67;3;99098;1569
2021-05-21;ME;Montenegro;55;3;99153;1572
2021-05-22;ME;Montenegro;50;0;99203;1572
2021-05-23;ME;Montenegro;45;2;99248;1574
2021-05-24;ME;Montenegro;43;0;99291;1574
2021-05-25;ME;Montenegro;67;3;99358;1577
2021-05-26;ME;Montenegro;67;1;99425;1578
2021-05-27;ME;Montenegro;52;0;99477;1578
2021-05-28;ME;Montenegro;41;2;99518;1580
2021-05-29;ME;Montenegro;48;3;99566;1583
2021-05-30;ME;Montenegro;39;0;99605;1583
2021-05-31;ME;Montenegro;18;1;99623;1584
2021-06-01;ME;Montenegro;29;1;99652;1585
2021-06-02;ME;Montenegro;31;2;99683;1587
2021-06-03;ME;Montenegro;34;0;99717;1587
2021-06-04;ME;Montenegro;41;4;99758;1591
2021-06-05;ME;Montenegro;33;0;99791;1591
2021-06-06;ME;Montenegro;21;1;99812;1592
2021-06-07;ME;Montenegro;22;2;99834;1594
2021-06-08;ME;Montenegro;14;2;99848;1596
2021-06-09;ME;Montenegro;19;0;99867;1596
2021-06-10;ME;Montenegro;23;0;99890;1596
2021-06-11;ME;Montenegro;24;1;99914;1597
2021-06-12;ME;Montenegro;14;1;99928;1598
2021-06-13;ME;Montenegro;28;3;99956;1601
2021-06-14;ME;Montenegro;8;1;99964;1602
2021-06-15;ME;Montenegro;24;0;99988;1602
2021-06-16;ME;Montenegro;13;1;100001;1603
2021-06-17;ME;Montenegro;19;1;100020;1604
2021-06-18;ME;Montenegro;16;1;100036;1605
2021-06-19;ME;Montenegro;19;0;100055;1605
2021-06-20;ME;Montenegro;20;0;100075;1605
2021-06-21;ME;Montenegro;17;0;100092;1605
2021-06-22;ME;Montenegro;12;1;100104;1606
2021-06-23;ME;Montenegro;13;2;100117;1608
2021-06-24;ME;Montenegro;14;1;100131;1609
2021-06-25;ME;Montenegro;14;0;100145;1609
2021-06-26;ME;Montenegro;23;0;100168;1609
2021-06-27;ME;Montenegro;22;0;100190;1609
2021-06-28;ME;Montenegro;14;0;100204;1609
2021-06-29;ME;Montenegro;26;1;100230;1610
2021-06-30;ME;Montenegro;22;3;100252;1613
2021-07-01;ME;Montenegro;20;0;100272;1613
2021-02-08;MS;Montserrat;0;0;0;0
2021-02-09;MS;Montserrat;0;0;0;0
2021-02-10;MS;Montserrat;0;0;0;0
2021-02-11;MS;Montserrat;0;0;0;0
2021-02-12;MS;Montserrat;0;0;0;0
2021-02-13;MS;Montserrat;0;0;0;0
2021-02-14;MS;Montserrat;0;0;0;0
2021-02-15;MS;Montserrat;0;0;0;0
2021-02-16;MS;Montserrat;0;0;0;0
2021-02-17;MS;Montserrat;0;0;0;0
2021-02-18;MS;Montserrat;0;0;0;0
2021-02-19;MS;Montserrat;0;0;0;0
2021-02-20;MS;Montserrat;0;0;0;0
2021-02-21;MS;Montserrat;0;0;0;0
2021-02-22;MS;Montserrat;0;0;0;0
2021-02-23;MS;Montserrat;0;0;0;0
2021-02-24;MS;Montserrat;0;0;0;0
2021-02-25;MS;Montserrat;0;0;0;0
2021-02-26;MS;Montserrat;0;0;0;0
2021-02-27;MS;Montserrat;0;0;0;0
2021-02-28;MS;Montserrat;0;0;0;0
2021-03-01;MS;Montserrat;0;0;0;0
2021-03-02;MS;Montserrat;0;0;0;0
2021-03-03;MS;Montserrat;0;0;0;0
2021-03-04;MS;Montserrat;0;0;0;0
2021-03-05;MS;Montserrat;0;0;0;0
2021-03-06;MS;Montserrat;0;0;0;0
2021-03-07;MS;Montserrat;0;0;0;0
2021-03-08;MS;Montserrat;0;0;0;0
2021-03-09;MS;Montserrat;0;0;0;0
2021-03-10;MS;Montserrat;0;0;0;0
2021-03-11;MS;Montserrat;0;0;0;0
2021-03-12;MS;Montserrat;0;0;0;0
2021-03-13;MS;Montserrat;0;0;0;0
2021-03-14;MS;Montserrat;0;0;0;0
2021-03-15;MS;Montserrat;0;0;0;0
2021-03-16;MS;Montserrat;0;0;0;0
2021-03-17;MS;Montserrat;0;0;0;0
2021-03-18;MS;Montserrat;0;0;0;0
2021-03-19;MS;Montserrat;0;0;0;0
2021-03-20;MS;Montserrat;0;0;0;0
2021-03-21;MS;Montserrat;0;0;0;0
2021-03-22;MS;Montserrat;0;0;0;0
2021-03-23;MS;Montserrat;0;0;0;0
2021-03-24;MS;Montserrat;0;0;0;0
2021-03-25;MS;Montserrat;0;0;0;0
2021-03-26;MS;Montserrat;0;0;0;0
2021-03-27;MS;Montserrat;0;0;0;0
2021-03-28;MS;Montserrat;0;0;0;0
2021-03-29;MS;Montserrat;0;0;0;0
2021-03-30;MS;Montserrat;0;0;0;0
2021-03-31;MS;Montserrat;0;0;0;0
2021-04-01;MS;Montserrat;0;0;0;0
2021-04-02;MS;Montserrat;0;0;0;0
2021-04-03;MS;Montserrat;0;0;0;0
2021-04-04;MS;Montserrat;0;0;0;0
2021-04-05;MS;Montserrat;0;0;0;0
2021-04-06;MS;Montserrat;0;0;0;0
2021-04-07;MS;Montserrat;0;0;0;0
2021-04-08;MS;Montserrat;0;0;0;0
2021-04-09;MS;Montserrat;0;0;0;0
2021-04-10;MS;Montserrat;0;0;0;0
2021-04-11;MS;Montserrat;0;0;0;0
2021-04-12;MS;Montserrat;0;0;0;0
2021-04-13;MS;Montserrat;0;0;0;0
2021-04-14;MS;Montserrat;0;0;0;0
2021-04-15;MS;Montserrat;0;0;0;0
2021-04-16;MS;Montserrat;0;0;0;0
2021-04-17;MS;Montserrat;0;0;0;0
2021-04-18;MS;Montserrat;0;0;0;0
2021-04-19;MS;Montserrat;0;0;0;0
2021-04-20;MS;Montserrat;0;0;0;0
2021-04-21;MS;Montserrat;0;0;0;0
2021-04-22;MS;Montserrat;0;0;0;0
2021-04-23;MS;Montserrat;0;0;0;0
2021-04-24;MS;Montserrat;0;0;0;0
2021-04-25;MS;Montserrat;0;0;0;0
2021-04-26;MS;Montserrat;0;0;0;0
2021-04-27;MS;Montserrat;0;0;0;0
2021-04-28;MS;Montserrat;0;0;0;0
2021-04-29;MS;Montserrat;0;0;0;0
2021-04-30;MS;Montserrat;0;0;0;0
2021-05-01;MS;Montserrat;0;0;0;0
2021-05-02;MS;Montserrat;0;0;0;0
2021-05-03;MS;Montserrat;0;0;0;0
2021-05-04;MS;Montserrat;0;0;0;0
2021-05-05;MS;Montserrat;0;0;0;0
2021-05-06;MS;Montserrat;0;0;0;0
2021-05-07;MS;Montserrat;0;0;0;0
2021-05-08;MS;Montserrat;0;0;0;0
2021-05-09;MS;Montserrat;0;0;0;0
2021-05-10;MS;Montserrat;0;0;0;0
2021-05-11;MS;Montserrat;0;0;0;0
2021-05-12;MS;Montserrat;0;0;0;0
2021-05-13;MS;Montserrat;0;0;0;0
2021-05-14;MS;Montserrat;0;0;0;0
2021-05-15;MS;Montserrat;0;0;0;0
2021-05-16;MS;Montserrat;0;0;0;0
2021-05-17;MS;Montserrat;0;0;0;0
2021-05-18;MS;Montserrat;0;0;0;0
2021-05-19;MS;Montserrat;0;0;0;0
2021-05-20;MS;Montserrat;0;0;0;0
2021-05-21;MS;Montserrat;0;0;0;0
2021-05-22;MS;Montserrat;0;0;0;0
2021-05-23;MS;Montserrat;0;0;0;0
2021-05-24;MS;Montserrat;0;0;0;0
2021-05-25;MS;Montserrat;0;0;0;0
2021-05-26;MS;Montserrat;0;0;0;0
2021-05-27;MS;Montserrat;0;0;0;0
2021-05-28;MS;Montserrat;0;0;0;0
2021-05-29;MS;Montserrat;0;0;0;0
2021-05-30;MS;Montserrat;0;0;0;0
2021-05-31;MS;Montserrat;0;0;0;0
2021-06-01;MS;Montserrat;0;0;0;0
2021-06-02;MS;Montserrat;0;0;0;0
2021-06-03;MS;Montserrat;0;0;0;0
2021-06-04;MS;Montserrat;0;0;0;0
2021-06-05;MS;Montserrat;0;0;0;0
2021-06-06;MS;Montserrat;0;0;0;0
2021-06-07;MS;Montserrat;0;0;0;0
2021-06-08;MS;Montserrat;0;0;0;0
2021-06-09;MS;Montserrat;0;0;0;0
2021-06-10;MS;Montserrat;0;0;0;0
2021-06-11;MS;Montserrat;0;0;0;0
2021-06-12;MS;Montserrat;0;0;0;0
2021-06-13;MS;Montserrat;0;0;0;0
2021-06-14;MS;Montserrat;0;0;0;0
2021-06-15;MS;Montserrat;0;0;0;0
2021-06-16;MS;Montserrat;0;0;0;0
2021-06-17;MS;Montserrat;0;0;0;0
2021-06-18;MS;Montserrat;0;0;0;0
2021-06-19;MS;Montserrat;0;0;0;0
2021-06-20;MS;Montserrat;0;0;0;0
2021-06-21;MS;Montserrat;0;0;0;0
2021-06-22;MS;Montserrat;0;0;0;0
2021-06-23;MS;Montserrat;0;0;0;0
2021-06-24;MS;Montserrat;0;0;0;0
2021-06-25;MS;Montserrat;0;0;0;0
2020-02-07;MA;Morocco;0;0;0;0
2020-02-08;MA;Morocco;0;0;0;0
2020-02-09;MA;Morocco;0;0;0;0
2020-02-10;MA;Morocco;0;0;0;0
2020-02-11;MA;Morocco;0;0;0;0
2020-02-12;MA;Morocco;0;0;0;0
2020-02-13;MA;Morocco;0;0;0;0
2020-02-14;MA;Morocco;0;0;0;0
2020-02-15;MA;Morocco;0;0;0;0
2020-02-16;MA;Morocco;0;0;0;0
2020-02-17;MA;Morocco;0;0;0;0
2020-02-18;MA;Morocco;0;0;0;0
2020-02-19;MA;Morocco;0;0;0;0
2020-02-20;MA;Morocco;0;0;0;0
2020-02-21;MA;Morocco;0;0;0;0
2020-02-22;MA;Morocco;0;0;0;0
2020-02-23;MA;Morocco;0;0;0;0
2020-02-24;MA;Morocco;0;0;0;0
2020-02-25;MA;Morocco;0;0;0;0
2020-02-26;MA;Morocco;0;0;0;0
2020-02-27;MA;Morocco;0;0;0;0
2020-02-28;MA;Morocco;0;0;0;0
2020-02-29;MA;Morocco;0;0;0;0
2020-03-01;MA;Morocco;0;0;0;0
2020-03-02;MA;Morocco;1;0;1;0
2020-03-03;MA;Morocco;0;0;1;0
2020-03-04;MA;Morocco;0;0;1;0
2020-03-05;MA;Morocco;1;0;2;0
2020-03-06;MA;Morocco;0;0;2;0
2020-03-07;MA;Morocco;0;0;2;0
2020-03-08;MA;Morocco;0;0;2;0
2020-03-09;MA;Morocco;0;0;2;0
2020-03-10;MA;Morocco;1;1;3;1
2020-03-11;MA;Morocco;2;0;5;1
2020-03-12;MA;Morocco;1;0;6;1
2020-03-13;MA;Morocco;1;0;7;1
2020-03-14;MA;Morocco;10;0;17;1
2020-03-15;MA;Morocco;11;0;28;1
2020-03-16;MA;Morocco;1;0;29;1
2020-03-17;MA;Morocco;9;1;38;2
2020-03-18;MA;Morocco;11;0;49;2
2020-03-19;MA;Morocco;14;0;63;2
2020-03-20;MA;Morocco;14;1;77;3
2020-03-21;MA;Morocco;19;0;96;3
2020-03-22;MA;Morocco;19;1;115;4
2020-03-23;MA;Morocco;28;0;143;4
2020-03-24;MA;Morocco;27;1;170;5
2020-03-25;MA;Morocco;55;1;225;6
2020-03-26;MA;Morocco;50;5;275;11
2020-03-27;MA;Morocco;70;12;345;23
2020-03-28;MA;Morocco;57;2;402;25
2020-03-29;MA;Morocco;77;1;479;26
2020-03-30;MA;Morocco;77;7;556;33
2020-03-31;MA;Morocco;61;3;617;36
2020-04-01;MA;Morocco;37;3;654;39
2020-04-02;MA;Morocco;54;5;708;44
2020-04-03;MA;Morocco;83;4;791;48
2020-04-04;MA;Morocco;128;11;919;59
2020-04-05;MA;Morocco;102;11;1021;70
2020-04-06;MA;Morocco;99;10;1120;80
2020-04-07;MA;Morocco;64;10;1184;90
2020-04-08;MA;Morocco;91;3;1275;93
2020-04-09;MA;Morocco;99;4;1374;97
2020-04-10;MA;Morocco;74;10;1448;107
2020-04-11;MA;Morocco;97;4;1545;111
2020-04-12;MA;Morocco;116;7;1661;118
2020-04-13;MA;Morocco;102;8;1763;126
2020-04-14;MA;Morocco;125;0;1888;126
2020-04-15;MA;Morocco;136;1;2024;127
2020-04-16;MA;Morocco;259;3;2283;130
2020-04-17;MA;Morocco;281;5;2564;135
2020-04-18;MA;Morocco;121;2;2685;137
2020-04-19;MA;Morocco;170;4;2855;141
2020-04-20;MA;Morocco;191;2;3046;143
2020-04-21;MA;Morocco;163;2;3209;145
2020-04-22;MA;Morocco;237;4;3446;149
2020-04-23;MA;Morocco;122;6;3568;155
2020-04-24;MA;Morocco;190;3;3758;158
2020-04-25;MA;Morocco;139;1;3897;159
2020-04-26;MA;Morocco;168;2;4065;161
2020-04-27;MA;Morocco;55;1;4120;162
2020-04-28;MA;Morocco;132;3;4252;165
2020-04-29;MA;Morocco;69;3;4321;168
2020-04-30;MA;Morocco;102;2;4423;170
2020-05-01;MA;Morocco;146;1;4569;171
2020-05-02;MA;Morocco;160;2;4729;173
2020-05-03;MA;Morocco;174;1;4903;174
2020-05-04;MA;Morocco;150;5;5053;179
2020-05-05;MA;Morocco;166;2;5219;181
2020-05-06;MA;Morocco;189;2;5408;183
2020-05-07;MA;Morocco;140;0;5548;183
2020-05-08;MA;Morocco;163;3;5711;186
2020-05-09;MA;Morocco;199;0;5910;186
2020-05-10;MA;Morocco;153;2;6063;188
2020-05-11;MA;Morocco;218;0;6281;188
2020-05-12;MA;Morocco;137;0;6418;188
2020-05-13;MA;Morocco;94;0;6512;188
2020-05-14;MA;Morocco;95;2;6607;190
2020-05-15;MA;Morocco;45;0;6652;190
2020-05-16;MA;Morocco;89;2;6741;192
2020-05-17;MA;Morocco;129;0;6870;192
2020-05-18;MA;Morocco;82;0;6952;192
2020-05-19;MA;Morocco;71;1;7023;193
2020-05-20;MA;Morocco;110;1;7133;194
2020-05-21;MA;Morocco;78;2;7211;196
2020-05-22;MA;Morocco;121;1;7332;197
2020-05-23;MA;Morocco;74;1;7406;198
2020-05-24;MA;Morocco;27;1;7433;199
2020-05-25;MA;Morocco;99;1;7532;200
2020-05-26;MA;Morocco;45;2;7577;202
2020-05-27;MA;Morocco;24;0;7601;202
2020-05-28;MA;Morocco;42;0;7643;202
2020-05-29;MA;Morocco;71;0;7714;202
2020-05-30;MA;Morocco;66;2;7780;204
2020-05-31;MA;Morocco;27;1;7807;205
2020-06-01;MA;Morocco;26;0;7833;205
2020-06-02;MA;Morocco;33;1;7866;206
2020-06-03;MA;Morocco;56;0;7922;206
2020-06-04;MA;Morocco;81;2;8003;208
2020-06-05;MA;Morocco;68;0;8071;208
2020-06-06;MA;Morocco;80;0;8151;208
2020-06-07;MA;Morocco;73;0;8224;208
2020-06-08;MA;Morocco;78;0;8302;208
2020-06-09;MA;Morocco;135;2;8437;210
2020-06-10;MA;Morocco;71;1;8508;211
2020-06-11;MA;Morocco;29;0;8537;211
2020-06-12;MA;Morocco;73;1;8610;212
2020-06-13;MA;Morocco;82;0;8692;212
2020-06-14;MA;Morocco;101;0;8793;212
2020-06-15;MA;Morocco;92;0;8885;212
2020-06-16;MA;Morocco;46;0;8931;212
2020-06-17;MA;Morocco;66;1;8997;213
2020-06-18;MA;Morocco;77;0;9074;213
2020-06-19;MA;Morocco;539;0;9613;213
2020-06-20;MA;Morocco;226;0;9839;213
2020-06-21;MA;Morocco;138;1;9977;214
2020-06-22;MA;Morocco;195;0;10172;214
2020-06-23;MA;Morocco;172;0;10344;214
2020-06-24;MA;Morocco;563;2;10907;216
2020-06-25;MA;Morocco;431;1;11338;217
2020-06-26;MA;Morocco;295;1;11633;218
2020-06-27;MA;Morocco;244;2;11877;220
2020-06-28;MA;Morocco;175;1;12052;221
2020-06-29;MA;Morocco;238;4;12290;225
2020-06-30;MA;Morocco;243;3;12533;228
2020-07-01;MA;Morocco;103;0;12636;228
2020-07-02;MA;Morocco;333;1;12969;229
2020-07-03;MA;Morocco;319;1;13288;230
2020-07-04;MA;Morocco;534;2;13822;232
2020-07-05;MA;Morocco;393;3;14215;235
2020-07-06;MA;Morocco;164;2;14379;237
2020-07-07;MA;Morocco;228;3;14607;240
2020-07-08;MA;Morocco;164;2;14771;242
2020-07-09;MA;Morocco;308;0;15079;242
2020-07-10;MA;Morocco;249;1;15328;243
2020-07-11;MA;Morocco;214;2;15542;245
2020-07-12;MA;Morocco;203;5;15745;250
2020-07-13;MA;Morocco;191;5;15936;255
2020-07-14;MA;Morocco;161;2;16097;257
2020-07-15;MA;Morocco;165;2;16262;259
2020-07-16;MA;Morocco;283;4;16545;263
2020-07-17;MA;Morocco;181;1;16726;264
2020-07-18;MA;Morocco;289;5;17015;269
2020-07-19;MA;Morocco;221;4;17236;273
2020-07-20;MA;Morocco;326;3;17562;276
2020-07-21;MA;Morocco;180;4;17742;280
2020-07-22;MA;Morocco;220;5;17962;285
2020-07-23;MA;Morocco;302;7;18264;292
2020-07-24;MA;Morocco;570;7;18834;299
2020-07-25;MA;Morocco;811;6;19645;305
2020-07-26;MA;Morocco;633;8;20278;313
2020-07-27;MA;Morocco;609;3;20887;316
2020-07-28;MA;Morocco;500;11;21387;327
2020-07-29;MA;Morocco;826;7;22213;334
2020-07-30;MA;Morocco;1046;12;23259;346
2020-07-31;MA;Morocco;1063;7;24322;353
2020-08-01;MA;Morocco;693;14;25015;367
2020-08-02;MA;Morocco;522;15;25537;382
2020-08-03;MA;Morocco;659;19;26196;401
2020-08-04;MA;Morocco;1021;16;27217;417
2020-08-05;MA;Morocco;1283;18;28500;435
2020-08-06;MA;Morocco;1144;14;29644;449
2020-08-07;MA;Morocco;1018;12;30662;461
2020-08-08;MA;Morocco;1345;19;32007;480
2020-08-09;MA;Morocco;1230;18;33237;498
2020-08-10;MA;Morocco;826;18;34063;516
2020-08-11;MA;Morocco;1132;17;35195;533
2020-08-12;MA;Morocco;1499;23;36694;556
2020-08-13;MA;Morocco;1241;28;37935;584
2020-08-14;MA;Morocco;1306;27;39241;611
2020-08-15;MA;Morocco;1776;21;41017;632
2020-08-16;MA;Morocco;1472;26;42489;658
2020-08-17;MA;Morocco;1069;23;43558;681
2020-08-18;MA;Morocco;1245;33;44803;714
2020-08-19;MA;Morocco;1510;29;46313;743
2020-08-20;MA;Morocco;1325;32;47638;775
2020-08-21;MA;Morocco;1609;42;49247;817
2020-08-22;MA;Morocco;1565;41;50812;858
2020-08-23;MA;Morocco;1537;30;52349;888
2020-08-24;MA;Morocco;903;32;53252;920
2020-08-25;MA;Morocco;1276;35;54528;955
2020-08-26;MA;Morocco;1336;29;55864;984
2020-08-27;MA;Morocco;1221;27;57085;1011
2020-08-28;MA;Morocco;1404;41;58489;1052
2020-08-29;MA;Morocco;1567;26;60056;1078
2020-08-30;MA;Morocco;1343;33;61399;1111
2020-08-31;MA;Morocco;1191;30;62590;1141
2020-09-01;MA;Morocco;1191;43;63781;1184
2020-09-02;MA;Morocco;1672;32;65453;1216
2020-09-03;MA;Morocco;1402;37;66855;1253
2020-09-04;MA;Morocco;1750;39;68605;1292
2020-09-05;MA;Morocco;1555;37;70160;1329
2020-09-06;MA;Morocco;2234;32;72394;1361
2020-09-07;MA;Morocco;1386;33;73780;1394
2020-09-08;MA;Morocco;1941;33;75721;1427
2020-09-09;MA;Morocco;2157;26;77878;1453
2020-09-10;MA;Morocco;1889;38;79767;1491
2020-09-11;MA;Morocco;2430;33;82197;1524
2020-09-12;MA;Morocco;2238;29;84435;1553
2020-09-13;MA;Morocco;2251;25;86686;1578
2020-09-14;MA;Morocco;1517;36;88203;1614
2020-09-15;MA;Morocco;2121;34;90324;1648
2020-09-16;MA;Morocco;1692;38;92016;1686
2020-09-17;MA;Morocco;2488;28;94504;1714
2020-09-18;MA;Morocco;2760;41;97264;1755
2020-09-19;MA;Morocco;2552;40;99816;1795
2020-09-20;MA;Morocco;1927;35;101743;1830
2020-09-21;MA;Morocco;1376;25;103119;1855
2020-09-22;MA;Morocco;2227;34;105346;1889
2020-09-23;MA;Morocco;2397;29;107743;1918
2020-09-24;MA;Morocco;2356;38;110099;1956
2020-09-25;MA;Morocco;2423;42;112522;1998
2020-09-26;MA;Morocco;2719;43;115241;2041
2020-09-27;MA;Morocco;2444;28;117685;2069
2020-09-28;MA;Morocco;1422;44;119107;2113
2020-09-29;MA;Morocco;2076;39;121183;2152
2020-09-30;MA;Morocco;2470;42;123653;2194
2020-10-01;MA;Morocco;2391;35;126044;2229
2020-10-02;MA;Morocco;2521;34;128565;2263
2020-10-03;MA;Morocco;2663;30;131228;2293
2020-10-04;MA;Morocco;2044;37;133272;2330
2020-10-05;MA;Morocco;1423;39;134695;2369
2020-10-06;MA;Morocco;2553;41;137248;2410
2020-10-07;MA;Morocco;2776;29;140024;2439
2020-10-08;MA;Morocco;2929;47;142953;2486
2020-10-09;MA;Morocco;3445;44;146398;2530
2020-10-10;MA;Morocco;3443;42;149841;2572
2020-10-11;MA;Morocco;2563;33;152404;2605
2020-10-12;MA;Morocco;1357;31;153761;2636
2020-10-13;MA;Morocco;3185;49;156946;2685
2020-10-14;MA;Morocco;3387;41;160333;2726
2020-10-15;MA;Morocco;3317;46;163650;2772
2020-10-16;MA;Morocco;3498;46;167148;2818
2020-10-17;MA;Morocco;3763;60;170911;2878
2020-10-18;MA;Morocco;2721;50;173632;2928
2020-10-19;MA;Morocco;2117;48;175749;2976
2020-10-20;MA;Morocco;3254;51;179003;3027
2020-10-21;MA;Morocco;3577;52;182580;3079
2020-10-22;MA;Morocco;4151;53;186731;3132
2020-10-23;MA;Morocco;3685;73;190416;3205
2020-10-24;MA;Morocco;4045;50;194461;3255
2020-10-25;MA;Morocco;3020;46;197481;3301
2020-10-26;MA;Morocco;2264;72;199745;3373
2020-10-27;MA;Morocco;3988;72;203733;3445
2020-10-28;MA;Morocco;3985;61;207718;3506
2020-10-29;MA;Morocco;4320;66;212038;3572
2020-10-30;MA;Morocco;3256;53;215294;3625
2020-10-31;MA;Morocco;3790;70;219084;3695
2020-11-01;MA;Morocco;3460;67;222544;3762
2020-11-02;MA;Morocco;2526;64;225070;3826
2020-11-03;MA;Morocco;4495;74;229565;3900
2020-11-04;MA;Morocco;5745;82;235310;3982
2020-11-05;MA;Morocco;5641;77;240951;4059
2020-11-06;MA;Morocco;5398;68;246349;4127
2020-11-07;MA;Morocco;5836;70;252185;4197
2020-11-08;MA;Morocco;4596;75;256781;4272
2020-11-09;MA;Morocco;3170;84;259951;4356
2020-11-10;MA;Morocco;5214;69;265165;4425
2020-11-11;MA;Morocco;5461;81;270626;4506
2020-11-12;MA;Morocco;6195;64;276821;4570
2020-11-13;MA;Morocco;5515;61;282336;4631
2020-11-14;MA;Morocco;5875;66;288211;4697
2020-11-15;MA;Morocco;4966;82;293177;4779
2020-11-16;MA;Morocco;3012;71;296189;4850
2020-11-17;MA;Morocco;5415;82;301604;4932
2020-11-18;MA;Morocco;5391;81;306995;5013
2020-11-19;MA;Morocco;4559;77;311554;5090
2020-11-20;MA;Morocco;4706;92;316260;5182
2020-11-21;MA;Morocco;4702;74;320962;5256
2020-11-22;MA;Morocco;3979;60;324941;5316
2020-11-23;MA;Morocco;2587;80;327528;5396
2020-11-24;MA;Morocco;3999;73;331527;5469
2020-11-25;MA;Morocco;4979;70;336506;5539
2020-11-26;MA;Morocco;4178;80;340684;5619
2020-11-27;MA;Morocco;4592;70;345276;5689
2020-11-28;MA;Morocco;4412;50;349688;5739
2020-11-29;MA;Morocco;4115;50;353803;5789
2020-11-30;MA;Morocco;2533;57;356336;5846
2020-12-01;MA;Morocco;3508;69;359844;5915
2020-12-02;MA;Morocco;4346;70;364190;5985
2020-12-03;MA;Morocco;4434;78;368624;6063
2020-12-04;MA;Morocco;3996;73;372620;6136
2020-12-05;MA;Morocco;4118;48;376738;6184
2020-12-06;MA;Morocco;2919;61;379657;6245
2020-12-07;MA;Morocco;1531;75;381188;6320
2020-12-08;MA;Morocco;2900;50;384088;6370
2020-12-09;MA;Morocco;4096;57;388184;6427
2020-12-10;MA;Morocco;3345;65;391529;6492
2020-12-11;MA;Morocco;3035;50;394564;6542
2020-12-12;MA;Morocco;3033;47;397597;6589
2020-12-13;MA;Morocco;2012;35;399609;6624
2020-12-14;MA;Morocco;1217;35;400826;6659
2020-12-15;MA;Morocco;2793;52;403619;6711
2020-12-16;MA;Morocco;3351;38;406970;6749
2020-12-17;MA;Morocco;2776;55;409746;6804
2020-12-18;MA;Morocco;2647;50;412393;6854
2020-12-19;MA;Morocco;2833;55;415226;6909
2020-12-20;MA;Morocco;1899;48;417125;6957
2020-12-21;MA;Morocco;877;43;418002;7000
2020-12-22;MA;Morocco;2646;30;420648;7030
2020-12-23;MA;Morocco;2566;56;423214;7086
2020-12-24;MA;Morocco;2650;44;425864;7130
2020-12-25;MA;Morocco;2329;40;428193;7170
2020-12-26;MA;Morocco;2369;34;430562;7204
2020-12-27;MA;Morocco;1517;36;432079;7240
2020-12-28;MA;Morocco;950;32;433029;7272
2020-12-29;MA;Morocco;2160;42;435189;7314
2020-12-30;MA;Morocco;2143;41;437332;7355
2020-12-31;MA;Morocco;1861;33;439193;7388
2021-01-01;MA;Morocco;1777;37;440970;7425
2021-01-02;MA;Morocco;1171;27;442141;7452
2021-01-03;MA;Morocco;1005;33;443146;7485
2021-01-04;MA;Morocco;656;53;443802;7538
2021-01-05;MA;Morocco;1637;43;445439;7581
2021-01-06;MA;Morocco;1642;37;447081;7618
2021-01-07;MA;Morocco;1597;27;448678;7645
2021-01-08;MA;Morocco;1543;40;450221;7685
2021-01-09;MA;Morocco;1416;24;451637;7709
2021-01-10;MA;Morocco;895;34;452532;7743
2021-01-11;MA;Morocco;456;24;452988;7767
2021-01-12;MA;Morocco;801;17;453789;7784
2021-01-13;MA;Morocco;1266;26;455055;7810
2021-01-14;MA;Morocco;1279;44;456334;7854
2021-01-15;MA;Morocco;1291;34;457625;7888
2021-01-16;MA;Morocco;1240;23;458865;7911
2021-01-17;MA;Morocco;806;31;459671;7942
2021-01-18;MA;Morocco;473;35;460144;7977
2021-01-19;MA;Morocco;1246;34;461390;8011
2021-01-20;MA;Morocco;1152;32;462542;8043
2021-01-21;MA;Morocco;1164;33;463706;8076
2021-01-22;MA;Morocco;1138;29;464844;8105
2021-01-23;MA;Morocco;925;23;465769;8128
2021-01-24;MA;Morocco;520;22;466289;8150
2021-01-25;MA;Morocco;337;22;466626;8172
2021-01-26;MA;Morocco;867;15;467493;8187
2021-01-27;MA;Morocco;890;20;468383;8207
2021-01-28;MA;Morocco;756;17;469139;8224
2021-01-29;MA;Morocco;851;22;469990;8246
2021-01-30;MA;Morocco;701;13;470691;8259
2021-01-31;MA;Morocco;466;16;471157;8275
2021-02-01;MA;Morocco;281;12;471438;8287
2021-02-02;MA;Morocco;835;22;472273;8309
2021-02-03;MA;Morocco;774;14;473047;8323
2021-02-04;MA;Morocco;620;28;473667;8351
2021-02-05;MA;Morocco;712;17;474379;8368
2021-02-06;MA;Morocco;587;13;474966;8381
2021-02-07;MA;Morocco;389;13;475355;8394
2021-02-08;MA;Morocco;234;14;475589;8408
2021-02-09;MA;Morocco;536;16;476125;8424
2021-02-10;MA;Morocco;564;12;476689;8436
2021-02-11;MA;Morocco;471;4;477160;8440
2021-02-12;MA;Morocco;496;10;477656;8450
2021-02-13;MA;Morocco;479;10;478135;8460
2021-02-14;MA;Morocco;339;17;478474;8477
2021-02-15;MA;Morocco;121;14;478595;8491
2021-02-16;MA;Morocco;476;13;479071;8504
2021-02-17;MA;Morocco;508;13;479579;8517
2021-02-18;MA;Morocco;477;7;480056;8524
2021-02-19;MA;Morocco;448;16;480504;8540
2021-02-20;MA;Morocco;444;8;480948;8548
2021-02-21;MA;Morocco;207;6;481155;8554
2021-02-22;MA;Morocco;108;5;481263;8559
2021-02-23;MA;Morocco;446;15;481709;8574
2021-02-24;MA;Morocco;419;18;482128;8592
2021-02-25;MA;Morocco;386;6;482514;8598
2021-02-26;MA;Morocco;480;10;482994;8608
2021-02-27;MA;Morocco;416;7;483410;8615
2021-02-28;MA;Morocco;244;8;483654;8623
2021-03-01;MA;Morocco;112;14;483766;8637
2021-03-02;MA;Morocco;393;8;484159;8645
2021-03-03;MA;Morocco;594;8;484753;8653
2021-03-04;MA;Morocco;394;16;485147;8669
2021-03-05;MA;Morocco;420;4;485567;8673
2021-03-06;MA;Morocco;407;3;485974;8676
2021-03-07;MA;Morocco;249;6;486223;8682
2021-03-08;MA;Morocco;102;1;486325;8683
2021-03-09;MA;Morocco;508;12;486833;8695
2021-03-10;MA;Morocco;453;10;487286;8705
2021-03-11;MA;Morocco;464;7;487750;8712
2021-03-12;MA;Morocco;431;4;488181;8716
2021-03-13;MA;Morocco;451;2;488632;8718
2021-03-14;MA;Morocco;305;5;488937;8723
2021-03-15;MA;Morocco;159;10;489096;8733
2021-03-16;MA;Morocco;526;4;489622;8737
2021-03-17;MA;Morocco;466;8;490088;8745
2021-03-18;MA;Morocco;487;3;490575;8748
2021-03-19;MA;Morocco;444;7;491019;8755
2021-03-20;MA;Morocco;444;8;491463;8763
2021-03-21;MA;Morocco;246;4;491709;8767
2021-03-22;MA;Morocco;125;2;491834;8769
2021-03-23;MA;Morocco;569;6;492403;8775
2021-03-24;MA;Morocco;439;11;492842;8786
2021-03-25;MA;Morocco;511;2;493353;8788
2021-03-26;MA;Morocco;514;5;493867;8793
2021-03-27;MA;Morocco;491;5;494358;8798
2021-03-28;MA;Morocco;301;0;494659;8798
2021-03-29;MA;Morocco;97;9;494756;8807
2021-03-30;MA;Morocco;665;6;495421;8813
2021-03-31;MA;Morocco;676;5;496097;8818
2021-04-01;MA;Morocco;579;7;496676;8825
2021-04-02;MA;Morocco;581;10;497257;8835
2021-04-03;MA;Morocco;575;7;497832;8842
2021-04-04;MA;Morocco;365;8;498197;8850
2021-04-05;MA;Morocco;132;7;498329;8857
2021-04-06;MA;Morocco;696;8;499025;8865
2021-04-07;MA;Morocco;663;2;499688;8867
2021-04-08;MA;Morocco;635;6;500323;8873
2021-04-09;MA;Morocco;625;12;500948;8885
2021-04-10;MA;Morocco;740;6;501688;8891
2021-04-11;MA;Morocco;414;9;502102;8900
2021-04-12;MA;Morocco;175;9;502277;8909
2021-04-13;MA;Morocco;684;6;502961;8915
2021-04-14;MA;Morocco;703;5;503664;8920
2021-04-15;MA;Morocco;596;7;504260;8927
2021-04-16;MA;Morocco;587;7;504847;8934
2021-04-17;MA;Morocco;600;10;505447;8944
2021-04-18;MA;Morocco;364;1;505811;8945
2021-04-19;MA;Morocco;138;7;505949;8952
2021-04-20;MA;Morocco;720;7;506669;8959
2021-04-21;MA;Morocco;669;10;507338;8969
2021-04-22;MA;Morocco;600;7;507938;8976
2021-04-23;MA;Morocco;592;7;508530;8983
2021-04-24;MA;Morocco;507;5;509037;8988
2021-04-25;MA;Morocco;326;4;509363;8992
2021-04-26;MA;Morocco;102;7;509465;8999
2021-04-27;MA;Morocco;507;6;509972;9005
2021-04-28;MA;Morocco;493;10;510465;9015
2021-04-29;MA;Morocco;421;5;510886;9020
2021-04-30;MA;Morocco;363;3;511249;9023
2021-05-01;MA;Morocco;313;3;511562;9026
2021-05-02;MA;Morocco;294;2;511856;9028
2021-05-03;MA;Morocco;56;4;511912;9032
2021-05-04;MA;Morocco;373;6;512285;9038
2021-05-05;MA;Morocco;371;5;512656;9043
2021-05-06;MA;Morocco;360;6;513016;9049
2021-05-07;MA;Morocco;298;8;513314;9057
2021-05-08;MA;Morocco;314;7;513628;9064
2021-05-09;MA;Morocco;236;8;513864;9072
2021-05-10;MA;Morocco;58;5;513922;9077
2021-05-11;MA;Morocco;242;6;514164;9083
2021-05-12;MA;Morocco;268;5;514432;9088
2021-05-13;MA;Morocco;238;3;514670;9091
2021-05-14;MA;Morocco;35;1;514705;9092
2021-05-15;MA;Morocco;112;6;514817;9098
2021-05-16;MA;Morocco;127;0;514944;9098
2021-05-17;MA;Morocco;79;6;515023;9104
2021-05-18;MA;Morocco;397;1;515420;9105
2021-05-19;MA;Morocco;338;1;515758;9106
2021-05-20;MA;Morocco;333;3;516091;9109
2021-05-21;MA;Morocco;358;6;516449;9115
2021-05-22;MA;Morocco;363;4;516812;9119
2021-05-23;MA;Morocco;211;3;517023;9122
2021-05-24;MA;Morocco;90;4;517113;9126
2021-05-25;MA;Morocco;310;3;517423;9129
2021-05-26;MA;Morocco;385;2;517808;9131
2021-05-27;MA;Morocco;314;3;518122;9134
2021-05-28;MA;Morocco;336;1;518458;9135
2021-05-29;MA;Morocco;410;3;518868;9138
2021-05-30;MA;Morocco;240;5;519108;9143
2021-05-31;MA;Morocco;108;4;519216;9147
2021-06-01;MA;Morocco;394;7;519610;9154
2021-06-02;MA;Morocco;418;6;520028;9160
2021-06-03;MA;Morocco;395;5;520423;9165
2021-06-04;MA;Morocco;346;4;520769;9169
2021-06-05;MA;Morocco;426;4;521195;9173
2021-06-06;MA;Morocco;231;5;521426;9178
2021-06-07;MA;Morocco;104;3;521530;9181
2021-06-08;MA;Morocco;473;6;522003;9187
2021-06-09;MA;Morocco;386;3;522389;9190
2021-06-10;MA;Morocco;376;2;522765;9192
2021-06-11;MA;Morocco;400;10;523165;9202
2021-06-12;MA;Morocco;455;5;523620;9207
2021-06-13;MA;Morocco;270;4;523890;9211
2021-06-14;MA;Morocco;109;2;523999;9213
2021-06-15;MA;Morocco;476;4;524475;9217
2021-06-16;MA;Morocco;500;4;524975;9221
2021-06-17;MA;Morocco;468;4;525443;9225
2021-06-18;MA;Morocco;481;8;525924;9233
2021-06-19;MA;Morocco;439;4;526363;9237
2021-06-20;MA;Morocco;288;1;526651;9238
2021-06-21;MA;Morocco;86;6;526737;9244
2021-06-22;MA;Morocco;437;3;527174;9247
2021-06-23;MA;Morocco;522;7;527696;9254
2021-06-24;MA;Morocco;484;11;528180;9265
2021-06-25;MA;Morocco;551;3;528731;9268
2021-06-26;MA;Morocco;493;5;529224;9273
2021-06-27;MA;Morocco;452;4;529676;9277
2021-06-28;MA;Morocco;219;6;529895;9283
2021-06-29;MA;Morocco;690;9;530585;9292
2021-06-30;MA;Morocco;776;4;531361;9296
2021-07-01;MA;Morocco;789;2;532150;9298
2020-03-22;MZ;Mozambique;1;0;1;0
2020-03-23;MZ;Mozambique;0;0;1;0
2020-03-24;MZ;Mozambique;2;0;3;0
2020-03-25;MZ;Mozambique;2;0;5;0
2020-03-26;MZ;Mozambique;2;0;7;0
2020-03-27;MZ;Mozambique;0;0;7;0
2020-03-28;MZ;Mozambique;1;0;8;0
2020-03-29;MZ;Mozambique;0;0;8;0
2020-03-30;MZ;Mozambique;0;0;8;0
2020-03-31;MZ;Mozambique;0;0;8;0
2020-04-01;MZ;Mozambique;2;0;10;0
2020-04-02;MZ;Mozambique;0;0;10;0
2020-04-03;MZ;Mozambique;0;0;10;0
2020-04-04;MZ;Mozambique;0;0;10;0
2020-04-05;MZ;Mozambique;0;0;10;0
2020-04-06;MZ;Mozambique;0;0;10;0
2020-04-07;MZ;Mozambique;0;0;10;0
2020-04-08;MZ;Mozambique;7;0;17;0
2020-04-09;MZ;Mozambique;0;0;17;0
2020-04-10;MZ;Mozambique;3;0;20;0
2020-04-11;MZ;Mozambique;0;0;20;0
2020-04-12;MZ;Mozambique;1;0;21;0
2020-04-13;MZ;Mozambique;0;0;21;0
2020-04-14;MZ;Mozambique;7;0;28;0
2020-04-15;MZ;Mozambique;1;0;29;0
2020-04-16;MZ;Mozambique;2;0;31;0
2020-04-17;MZ;Mozambique;3;0;34;0
2020-04-18;MZ;Mozambique;1;0;35;0
2020-04-19;MZ;Mozambique;4;0;39;0
2020-04-20;MZ;Mozambique;0;0;39;0
2020-04-21;MZ;Mozambique;0;0;39;0
2020-04-22;MZ;Mozambique;2;0;41;0
2020-04-23;MZ;Mozambique;5;0;46;0
2020-04-24;MZ;Mozambique;19;0;65;0
2020-04-25;MZ;Mozambique;5;0;70;0
2020-04-26;MZ;Mozambique;6;0;76;0
2020-04-27;MZ;Mozambique;0;0;76;0
2020-04-28;MZ;Mozambique;0;0;76;0
2020-04-29;MZ;Mozambique;0;0;76;0
2020-04-30;MZ;Mozambique;0;0;76;0
2020-05-01;MZ;Mozambique;3;0;79;0
2020-05-02;MZ;Mozambique;0;0;79;0
2020-05-03;MZ;Mozambique;1;0;80;0
2020-05-04;MZ;Mozambique;0;0;80;0
2020-05-05;MZ;Mozambique;1;0;81;0
2020-05-06;MZ;Mozambique;0;0;81;0
2020-05-07;MZ;Mozambique;0;0;81;0
2020-05-08;MZ;Mozambique;1;0;82;0
2020-05-09;MZ;Mozambique;5;0;87;0
2020-05-10;MZ;Mozambique;4;0;91;0
2020-05-11;MZ;Mozambique;12;0;103;0
2020-05-12;MZ;Mozambique;1;0;104;0
2020-05-13;MZ;Mozambique;0;0;104;0
2020-05-14;MZ;Mozambique;11;0;115;0
2020-05-15;MZ;Mozambique;4;0;119;0
2020-05-16;MZ;Mozambique;10;0;129;0
2020-05-17;MZ;Mozambique;8;0;137;0
2020-05-18;MZ;Mozambique;8;0;145;0
2020-05-19;MZ;Mozambique;1;0;146;0
2020-05-20;MZ;Mozambique;10;0;156;0
2020-05-21;MZ;Mozambique;6;0;162;0
2020-05-22;MZ;Mozambique;2;0;164;0
2020-05-23;MZ;Mozambique;4;0;168;0
2020-05-24;MZ;Mozambique;26;0;194;0
2020-05-25;MZ;Mozambique;15;1;209;1
2020-05-26;MZ;Mozambique;4;0;213;1
2020-05-27;MZ;Mozambique;14;0;227;1
2020-05-28;MZ;Mozambique;6;1;233;2
2020-05-29;MZ;Mozambique;1;0;234;2
2020-05-30;MZ;Mozambique;10;0;244;2
2020-05-31;MZ;Mozambique;10;0;254;2
2020-06-01;MZ;Mozambique;0;0;254;2
2020-06-02;MZ;Mozambique;53;0;307;2
2020-06-03;MZ;Mozambique;9;0;316;2
2020-06-04;MZ;Mozambique;36;0;352;2
2020-06-05;MZ;Mozambique;2;0;354;2
2020-06-06;MZ;Mozambique;55;0;409;2
2020-06-07;MZ;Mozambique;15;0;424;2
2020-06-08;MZ;Mozambique;9;0;433;2
2020-06-09;MZ;Mozambique;20;0;453;2
2020-06-10;MZ;Mozambique;19;0;472;2
2020-06-11;MZ;Mozambique;17;0;489;2
2020-06-12;MZ;Mozambique;20;0;509;2
2020-06-13;MZ;Mozambique;44;0;553;2
2020-06-14;MZ;Mozambique;30;1;583;3
2020-06-15;MZ;Mozambique;26;0;609;3
2020-06-16;MZ;Mozambique;29;1;638;4
2020-06-17;MZ;Mozambique;13;0;651;4
2020-06-18;MZ;Mozambique;11;0;662;4
2020-06-19;MZ;Mozambique;6;0;668;4
2020-06-20;MZ;Mozambique;20;0;688;4
2020-06-21;MZ;Mozambique;45;1;733;5
2020-06-22;MZ;Mozambique;4;0;737;5
2020-06-23;MZ;Mozambique;20;0;757;5
2020-06-24;MZ;Mozambique;5;0;762;5
2020-06-25;MZ;Mozambique;26;0;788;5
2020-06-26;MZ;Mozambique;28;0;816;5
2020-06-27;MZ;Mozambique;23;0;839;5
2020-06-28;MZ;Mozambique;20;0;859;5
2020-06-29;MZ;Mozambique;24;1;883;6
2020-06-30;MZ;Mozambique;6;0;889;6
2020-07-01;MZ;Mozambique;14;0;903;6
2020-07-02;MZ;Mozambique;15;0;918;6
2020-07-03;MZ;Mozambique;21;0;939;6
2020-07-04;MZ;Mozambique;30;1;969;7
2020-07-05;MZ;Mozambique;18;1;987;8
2020-07-06;MZ;Mozambique;25;0;1012;8
2020-07-07;MZ;Mozambique;28;0;1040;8
2020-07-08;MZ;Mozambique;31;0;1071;8
2020-07-09;MZ;Mozambique;21;1;1092;9
2020-07-10;MZ;Mozambique;19;0;1111;9
2020-07-11;MZ;Mozambique;24;0;1135;9
2020-07-12;MZ;Mozambique;22;0;1157;9
2020-07-13;MZ;Mozambique;62;0;1219;9
2020-07-14;MZ;Mozambique;49;0;1268;9
2020-07-15;MZ;Mozambique;62;0;1330;9
2020-07-16;MZ;Mozambique;53;0;1383;9
2020-07-17;MZ;Mozambique;19;0;1402;9
2020-07-18;MZ;Mozambique;33;1;1435;10
2020-07-19;MZ;Mozambique;56;0;1491;10
2020-07-20;MZ;Mozambique;16;1;1507;11
2020-07-21;MZ;Mozambique;29;0;1536;11
2020-07-22;MZ;Mozambique;21;0;1557;11
2020-07-23;MZ;Mozambique;25;0;1582;11
2020-07-24;MZ;Mozambique;8;0;1590;11
2020-07-25;MZ;Mozambique;26;0;1616;11
2020-07-26;MZ;Mozambique;53;0;1669;11
2020-07-27;MZ;Mozambique;32;0;1701;11
2020-07-28;MZ;Mozambique;19;0;1720;11
2020-07-29;MZ;Mozambique;28;0;1748;11
2020-07-30;MZ;Mozambique;60;0;1808;11
2020-07-31;MZ;Mozambique;56;0;1864;11
2020-08-01;MZ;Mozambique;43;1;1907;12
2020-08-02;MZ;Mozambique;39;1;1946;13
2020-08-03;MZ;Mozambique;27;1;1973;14
2020-08-04;MZ;Mozambique;56;1;2029;15
2020-08-05;MZ;Mozambique;50;0;2079;15
2020-08-06;MZ;Mozambique;41;0;2120;15
2020-08-07;MZ;Mozambique;93;0;2213;15
2020-08-08;MZ;Mozambique;28;1;2241;16
2020-08-09;MZ;Mozambique;28;0;2269;16
2020-08-10;MZ;Mozambique;142;0;2411;16
2020-08-11;MZ;Mozambique;70;1;2481;17
2020-08-12;MZ;Mozambique;78;2;2559;19
2020-08-13;MZ;Mozambique;79;0;2638;19
2020-08-14;MZ;Mozambique;70;0;2708;19
2020-08-15;MZ;Mozambique;83;0;2791;19
2020-08-16;MZ;Mozambique;64;0;2855;19
2020-08-17;MZ;Mozambique;59;0;2914;19
2020-08-18;MZ;Mozambique;77;0;2991;19
2020-08-19;MZ;Mozambique;54;0;3045;19
2020-08-20;MZ;Mozambique;70;1;3115;20
2020-08-21;MZ;Mozambique;80;0;3195;20
2020-08-22;MZ;Mozambique;109;0;3304;20
2020-08-23;MZ;Mozambique;91;0;3395;20
2020-08-24;MZ;Mozambique;45;1;3440;21
2020-08-25;MZ;Mozambique;68;0;3508;21
2020-08-26;MZ;Mozambique;82;0;3590;21
2020-08-27;MZ;Mozambique;61;0;3651;21
2020-08-28;MZ;Mozambique;46;0;3697;21
2020-08-29;MZ;Mozambique;63;1;3760;22
2020-08-30;MZ;Mozambique;61;1;3821;23
2020-08-31;MZ;Mozambique;95;0;3916;23
2020-09-01;MZ;Mozambique;123;0;4039;23
2020-09-02;MZ;Mozambique;78;2;4117;25
2020-09-03;MZ;Mozambique;90;1;4207;26
2020-09-04;MZ;Mozambique;58;0;4265;26
2020-09-05;MZ;Mozambique;76;0;4341;26
2020-09-06;MZ;Mozambique;103;1;4444;27
2020-09-07;MZ;Mozambique;113;0;4557;27
2020-09-08;MZ;Mozambique;90;1;4647;28
2020-09-09;MZ;Mozambique;117;0;4764;28
2020-09-10;MZ;Mozambique;68;3;4832;31
2020-09-11;MZ;Mozambique;86;0;4918;31
2020-09-12;MZ;Mozambique;122;4;5040;35
2020-09-13;MZ;Mozambique;229;0;5269;35
2020-09-14;MZ;Mozambique;213;0;5482;35
2020-09-15;MZ;Mozambique;231;2;5713;37
2020-09-16;MZ;Mozambique;281;2;5994;39
2020-09-17;MZ;Mozambique;167;0;6161;39
2020-09-18;MZ;Mozambique;103;1;6264;40
2020-09-19;MZ;Mozambique;273;1;6537;41
2020-09-20;MZ;Mozambique;234;2;6771;43
2020-09-21;MZ;Mozambique;141;1;6912;44
2020-09-22;MZ;Mozambique;202;1;7114;45
2020-09-23;MZ;Mozambique;148;4;7262;49
2020-09-24;MZ;Mozambique;137;2;7399;51
2020-09-25;MZ;Mozambique;190;2;7589;53
2020-09-26;MZ;Mozambique;168;1;7757;54
2020-09-27;MZ;Mozambique;226;4;7983;58
2020-09-28;MZ;Mozambique;305;1;8288;59
2020-09-29;MZ;Mozambique;268;0;8556;59
2020-09-30;MZ;Mozambique;172;2;8728;61
2020-10-01;MZ;Mozambique;160;1;8888;62
2020-10-02;MZ;Mozambique;91;2;8979;64
2020-10-03;MZ;Mozambique;70;0;9049;64
2020-10-04;MZ;Mozambique;147;2;9196;66
2020-10-05;MZ;Mozambique;100;0;9296;66
2020-10-06;MZ;Mozambique;102;1;9398;67
2020-10-07;MZ;Mozambique;96;1;9494;68
2020-10-08;MZ;Mozambique;145;0;9639;68
2020-10-09;MZ;Mozambique;103;1;9742;69
2020-10-10;MZ;Mozambique;102;1;9844;70
2020-10-11;MZ;Mozambique;157;1;10001;71
2020-10-12;MZ;Mozambique;87;1;10088;72
2020-10-13;MZ;Mozambique;170;1;10258;73
2020-10-14;MZ;Mozambique;134;0;10392;73
2020-10-15;MZ;Mozambique;145;0;10537;73
2020-10-16;MZ;Mozambique;75;0;10612;73
2020-10-17;MZ;Mozambique;95;1;10707;74
2020-10-18;MZ;Mozambique;159;1;10866;75
2020-10-19;MZ;Mozambique;214;0;11080;75
2020-10-20;MZ;Mozambique;110;3;11190;78
2020-10-21;MZ;Mozambique;141;1;11331;79
2020-10-22;MZ;Mozambique;228;2;11559;81
2020-10-23;MZ;Mozambique;189;1;11748;82
2020-10-24;MZ;Mozambique;147;3;11895;85
2020-10-25;MZ;Mozambique;91;1;11986;86
2020-10-26;MZ;Mozambique;175;2;12161;88
2020-10-27;MZ;Mozambique;112;1;12273;89
2020-10-28;MZ;Mozambique;142;2;12415;91
2020-10-29;MZ;Mozambique;110;0;12525;91
2020-10-30;MZ;Mozambique;252;0;12777;91
2020-10-31;MZ;Mozambique;92;1;12869;92
2020-11-01;MZ;Mozambique;119;1;12988;93
2020-11-02;MZ;Mozambique;142;1;13130;94
2020-11-03;MZ;Mozambique;72;1;13202;95
2020-11-04;MZ;Mozambique;81;0;13283;95
2020-11-05;MZ;Mozambique;108;2;13391;97
2020-11-06;MZ;Mozambique;94;2;13485;99
2020-11-07;MZ;Mozambique;92;0;13577;99
2020-11-08;MZ;Mozambique;191;0;13768;99
2020-11-09;MZ;Mozambique;55;0;13823;99
2020-11-10;MZ;Mozambique;69;0;13892;99
2020-11-11;MZ;Mozambique;99;5;13991;104
2020-11-12;MZ;Mozambique;103;0;14094;104
2020-11-13;MZ;Mozambique;133;6;14227;110
2020-11-14;MZ;Mozambique;113;0;14340;110
2020-11-15;MZ;Mozambique;108;3;14448;113
2020-11-16;MZ;Mozambique;66;3;14514;116
2020-11-17;MZ;Mozambique;52;2;14566;118
2020-11-18;MZ;Mozambique;63;1;14629;119
2020-11-19;MZ;Mozambique;94;1;14723;120
2020-11-20;MZ;Mozambique;154;1;14877;121
2020-11-21;MZ;Mozambique;104;2;14981;123
2020-11-22;MZ;Mozambique;56;1;15037;124
2020-11-23;MZ;Mozambique;72;2;15109;126
2020-11-24;MZ;Mozambique;122;1;15231;127
2020-11-25;MZ;Mozambique;71;1;15302;128
2020-11-26;MZ;Mozambique;165;0;15467;128
2020-11-27;MZ;Mozambique;39;0;15506;128
2020-11-28;MZ;Mozambique;80;1;15586;129
2020-11-29;MZ;Mozambique;27;1;15613;130
2020-11-30;MZ;Mozambique;88;1;15701;131
2020-12-01;MZ;Mozambique;69;0;15770;131
2020-12-02;MZ;Mozambique;96;1;15866;132
2020-12-03;MZ;Mozambique;52;0;15918;132
2020-12-04;MZ;Mozambique;120;1;16038;133
2020-12-05;MZ;Mozambique;95;0;16133;133
2020-12-06;MZ;Mozambique;111;0;16244;133
2020-12-07;MZ;Mozambique;82;3;16326;136
2020-12-08;MZ;Mozambique;47;0;16373;136
2020-12-09;MZ;Mozambique;67;2;16440;138
2020-12-10;MZ;Mozambique;81;1;16521;139
2020-12-11;MZ;Mozambique;159;0;16680;139
2020-12-12;MZ;Mozambique;132;1;16812;140
2020-12-13;MZ;Mozambique;142;2;16954;142
2020-12-14;MZ;Mozambique;48;1;17002;143
2020-12-15;MZ;Mozambique;40;1;17042;144
2020-12-16;MZ;Mozambique;101;1;17143;145
2020-12-17;MZ;Mozambique;113;0;17256;145
2020-12-18;MZ;Mozambique;82;1;17338;146
2020-12-19;MZ;Mozambique;139;1;17477;147
2020-12-20;MZ;Mozambique;91;1;17568;148
2020-12-21;MZ;Mozambique;127;1;17695;149
2020-12-22;MZ;Mozambique;72;1;17767;150
2020-12-23;MZ;Mozambique;0;0;17767;150
2020-12-24;MZ;Mozambique;264;6;18031;156
2020-12-25;MZ;Mozambique;77;0;18108;156
2020-12-26;MZ;Mozambique;54;3;18162;159
2020-12-27;MZ;Mozambique;103;2;18265;161
2020-12-28;MZ;Mozambique;45;1;18310;162
2020-12-29;MZ;Mozambique;62;0;18372;162
2020-12-30;MZ;Mozambique;113;3;18485;165
2020-12-31;MZ;Mozambique;157;1;18642;166
2021-01-01;MZ;Mozambique;152;1;18794;167
2021-01-02;MZ;Mozambique;174;1;18968;168
2021-01-03;MZ;Mozambique;341;1;19309;169
2021-01-04;MZ;Mozambique;154;2;19463;171
2021-01-05;MZ;Mozambique;79;0;19542;171
2021-01-06;MZ;Mozambique;125;1;19667;172
2021-01-07;MZ;Mozambique;294;4;19961;176
2021-01-08;MZ;Mozambique;521;5;20482;181
2021-01-09;MZ;Mozambique;879;6;21361;187
2021-01-10;MZ;Mozambique;578;5;21939;192
2021-01-11;MZ;Mozambique;395;5;22334;197
2021-01-12;MZ;Mozambique;662;4;22996;201
2021-01-13;MZ;Mozambique;730;4;23726;205
2021-01-14;MZ;Mozambique;543;6;24269;211
2021-01-15;MZ;Mozambique;735;5;25004;216
2021-01-16;MZ;Mozambique;858;18;25862;234
2021-01-17;MZ;Mozambique;689;7;26551;241
2021-01-18;MZ;Mozambique;895;8;27446;249
2021-01-19;MZ;Mozambique;824;4;28270;253
2021-01-20;MZ;Mozambique;1126;18;29396;271
2021-01-21;MZ;Mozambique;829;12;30225;283
2021-01-22;MZ;Mozambique;623;7;30848;290
2021-01-23;MZ;Mozambique;780;7;31628;297
2021-01-24;MZ;Mozambique;790;8;32418;305
2021-01-25;MZ;Mozambique;363;58;32781;363
2021-01-26;MZ;Mozambique;1274;-34;34055;329
2021-01-27;MZ;Mozambique;871;7;34926;336
2021-01-28;MZ;Mozambique;907;11;35833;347
2021-01-29;MZ;Mozambique;1275;9;37108;356
2021-01-30;MZ;Mozambique;597;7;37705;363
2021-01-31;MZ;Mozambique;949;4;38654;367
2021-02-01;MZ;Mozambique;806;19;39460;386
2021-02-02;MZ;Mozambique;800;17;40260;403
2021-02-03;MZ;Mozambique;1173;12;41433;415
2021-02-04;MZ;Mozambique;1055;12;42488;427
2021-02-05;MZ;Mozambique;696;9;43184;436
2021-02-06;MZ;Mozambique;928;15;44112;451
2021-02-07;MZ;Mozambique;488;9;44600;460
2021-02-08;MZ;Mozambique;312;5;44912;465
2021-02-09;MZ;Mozambique;873;15;45785;480
2021-02-10;MZ;Mozambique;951;6;46736;486
2021-02-11;MZ;Mozambique;1054;15;47790;501
2021-02-12;MZ;Mozambique;798;13;48588;514
2021-02-13;MZ;Mozambique;547;11;49135;525
2021-02-14;MZ;Mozambique;1130;10;50265;535
2021-02-15;MZ;Mozambique;426;12;50691;547
2021-02-16;MZ;Mozambique;1109;4;51800;551
2021-02-17;MZ;Mozambique;829;10;52629;561
2021-02-18;MZ;Mozambique;898;10;53527;571
2021-02-19;MZ;Mozambique;677;12;54204;583
2021-02-20;MZ;Mozambique;764;4;54968;587
2021-02-21;MZ;Mozambique;675;8;55643;595
2021-02-22;MZ;Mozambique;517;4;56160;599
2021-02-23;MZ;Mozambique;435;7;56595;606
2021-02-24;MZ;Mozambique;325;2;56920;608
2021-02-25;MZ;Mozambique;677;5;57597;613
2021-02-26;MZ;Mozambique;621;0;58218;613
2021-02-27;MZ;Mozambique;554;17;58772;630
2021-02-28;MZ;Mozambique;578;11;59350;641
2021-03-01;MZ;Mozambique;257;12;59607;653
2021-03-02;MZ;Mozambique;307;12;59914;665
2021-03-03;MZ;Mozambique;481;3;60395;668
2021-03-04;MZ;Mozambique;775;6;61170;674
2021-03-05;MZ;Mozambique;359;6;61529;680
2021-03-06;MZ;Mozambique;602;6;62131;686
2021-03-07;MZ;Mozambique;389;7;62520;693
2021-03-08;MZ;Mozambique;183;5;62703;698
2021-03-09;MZ;Mozambique;179;2;62882;700
2021-03-10;MZ;Mozambique;292;7;63174;707
2021-03-11;MZ;Mozambique;471;4;63645;711
2021-03-12;MZ;Mozambique;359;8;64004;719
2021-03-13;MZ;Mozambique;292;3;64296;722
2021-03-14;MZ;Mozambique;220;3;64516;725
2021-03-15;MZ;Mozambique;0;0;64516;725
2021-03-16;MZ;Mozambique;413;7;64929;732
2021-03-17;MZ;Mozambique;268;1;65197;733
2021-03-18;MZ;Mozambique;255;4;65452;737
2021-03-19;MZ;Mozambique;347;3;65799;740
2021-03-20;MZ;Mozambique;265;3;66064;743
2021-03-21;MZ;Mozambique;148;3;66212;746
2021-03-22;MZ;Mozambique;94;1;66306;747
2021-03-23;MZ;Mozambique;190;3;66496;750
2021-03-24;MZ;Mozambique;153;2;66649;752
2021-03-25;MZ;Mozambique;113;1;66762;753
2021-03-26;MZ;Mozambique;117;5;66879;758
2021-03-27;MZ;Mozambique;132;4;67011;762
2021-03-28;MZ;Mozambique;186;2;67197;764
2021-03-29;MZ;Mozambique;0;0;67197;764
2021-03-30;MZ;Mozambique;95;5;67292;769
2021-03-31;MZ;Mozambique;287;6;67579;775
2021-04-01;MZ;Mozambique;150;0;67729;775
2021-04-02;MZ;Mozambique;194;3;67923;778
2021-04-03;MZ;Mozambique;82;4;68005;782
2021-04-04;MZ;Mozambique;114;0;68119;782
2021-04-05;MZ;Mozambique;108;0;68227;782
2021-04-06;MZ;Mozambique;65;3;68292;785
2021-04-07;MZ;Mozambique;139;0;68431;785
2021-04-08;MZ;Mozambique;35;3;68466;788
2021-04-09;MZ;Mozambique;40;1;68506;789
2021-04-10;MZ;Mozambique;72;0;68578;789
2021-04-11;MZ;Mozambique;180;2;68758;791
2021-04-12;MZ;Mozambique;34;0;68792;791
2021-04-13;MZ;Mozambique;79;3;68871;794
2021-04-14;MZ;Mozambique;56;0;68927;794
2021-04-15;MZ;Mozambique;75;0;69002;794
2021-04-16;MZ;Mozambique;65;3;69067;797
2021-04-17;MZ;Mozambique;67;1;69134;798
2021-04-18;MZ;Mozambique;69;0;69203;798
2021-04-19;MZ;Mozambique;25;2;69228;800
2021-04-20;MZ;Mozambique;81;2;69309;802
2021-04-21;MZ;Mozambique;128;3;69437;805
2021-04-22;MZ;Mozambique;86;0;69523;805
2021-04-23;MZ;Mozambique;74;1;69597;806
2021-04-24;MZ;Mozambique;46;1;69643;807
2021-04-25;MZ;Mozambique;22;0;69665;807
2021-04-26;MZ;Mozambique;50;2;69715;809
2021-04-27;MZ;Mozambique;47;5;69762;814
2021-04-28;MZ;Mozambique;42;0;69804;814
2021-04-29;MZ;Mozambique;60;0;69864;814
2021-04-30;MZ;Mozambique;53;0;69917;814
2021-05-01;MZ;Mozambique;48;0;69965;814
2021-05-02;MZ;Mozambique;19;1;69984;815
2021-05-03;MZ;Mozambique;16;0;70000;815
2021-05-04;MZ;Mozambique;31;2;70031;817
2021-05-05;MZ;Mozambique;21;1;70052;818
2021-05-06;MZ;Mozambique;56;1;70108;819
2021-05-07;MZ;Mozambique;30;1;70138;820
2021-05-08;MZ;Mozambique;28;1;70166;821
2021-05-09;MZ;Mozambique;46;2;70212;823
2021-05-10;MZ;Mozambique;71;2;70283;825
2021-05-11;MZ;Mozambique;-16;1;70267;826
2021-05-12;MZ;Mozambique;20;0;70287;826
2021-05-13;MZ;Mozambique;28;0;70315;826
2021-05-14;MZ;Mozambique;46;0;70361;826
2021-05-15;MZ;Mozambique;49;0;70410;826
2021-05-16;MZ;Mozambique;32;0;70442;826
2021-05-17;MZ;Mozambique;21;2;70463;828
2021-05-18;MZ;Mozambique;22;0;70485;828
2021-05-19;MZ;Mozambique;24;0;70509;828
2021-05-20;MZ;Mozambique;18;0;70527;828
2021-05-21;MZ;Mozambique;24;3;70551;831
2021-05-22;MZ;Mozambique;17;0;70568;831
2021-05-23;MZ;Mozambique;22;0;70590;831
2021-05-24;MZ;Mozambique;16;0;70606;831
2021-05-25;MZ;Mozambique;30;2;70636;833
2021-05-26;MZ;Mozambique;15;1;70651;834
2021-05-27;MZ;Mozambique;22;0;70673;834
2021-05-28;MZ;Mozambique;24;1;70697;835
2021-05-29;MZ;Mozambique;27;1;70724;836
2021-05-30;MZ;Mozambique;56;0;70780;836
2021-05-31;MZ;Mozambique;15;0;70795;836
2021-06-01;MZ;Mozambique;55;0;70850;836
2021-06-02;MZ;Mozambique;73;0;70923;836
2021-06-03;MZ;Mozambique;42;1;70965;837
2021-06-04;MZ;Mozambique;54;0;71019;837
2021-06-05;MZ;Mozambique;63;0;71082;837
2021-06-06;MZ;Mozambique;32;0;71114;837
2021-06-07;MZ;Mozambique;31;1;71145;838
2021-06-08;MZ;Mozambique;20;1;71165;839
2021-06-09;MZ;Mozambique;74;1;71239;840
2021-06-10;MZ;Mozambique;40;0;71279;840
2021-06-11;MZ;Mozambique;76;0;71355;840
2021-06-12;MZ;Mozambique;106;0;71461;840
2021-06-13;MZ;Mozambique;77;1;71538;841
2021-06-14;MZ;Mozambique;30;0;71568;841
2021-06-15;MZ;Mozambique;83;1;71651;842
2021-06-16;MZ;Mozambique;113;2;71764;844
2021-06-17;MZ;Mozambique;165;0;71929;844
2021-06-18;MZ;Mozambique;194;0;72123;844
2021-06-19;MZ;Mozambique;244;3;72367;847
2021-06-20;MZ;Mozambique;140;1;72507;848
2021-06-21;MZ;Mozambique;70;0;72577;848
2021-06-22;MZ;Mozambique;198;4;72775;852
2021-06-23;MZ;Mozambique;436;5;73211;857
2021-06-24;MZ;Mozambique;441;6;73652;863
2021-06-25;MZ;Mozambique;534;2;74186;865
2021-06-26;MZ;Mozambique;518;2;74704;867
2021-06-27;MZ;Mozambique;434;1;75138;868
2021-06-28;MZ;Mozambique;284;1;75422;869
2021-06-29;MZ;Mozambique;406;3;75828;872
2021-06-30;MZ;Mozambique;576;6;76404;878
2021-07-01;MZ;Mozambique;801;6;77205;884
2020-03-27;MM;Myanmar;8;0;8;0
2020-03-28;MM;Myanmar;0;0;8;0
2020-03-29;MM;Myanmar;2;0;10;0
2020-03-30;MM;Myanmar;4;0;14;0
2020-03-31;MM;Myanmar;1;1;15;1
2020-04-01;MM;Myanmar;0;0;15;1
2020-04-02;MM;Myanmar;5;0;20;1
2020-04-03;MM;Myanmar;0;0;20;1
2020-04-04;MM;Myanmar;1;0;21;1
2020-04-05;MM;Myanmar;0;0;21;1
2020-04-06;MM;Myanmar;1;0;22;1
2020-04-07;MM;Myanmar;0;0;22;1
2020-04-08;MM;Myanmar;0;2;22;3
2020-04-09;MM;Myanmar;1;0;23;3
2020-04-10;MM;Myanmar;4;0;27;3
2020-04-11;MM;Myanmar;11;0;38;3
2020-04-12;MM;Myanmar;3;1;41;4
2020-04-13;MM;Myanmar;21;0;62;4
2020-04-14;MM;Myanmar;1;0;63;4
2020-04-15;MM;Myanmar;11;0;74;4
2020-04-16;MM;Myanmar;11;0;85;4
2020-04-17;MM;Myanmar;3;0;88;4
2020-04-18;MM;Myanmar;10;1;98;5
2020-04-19;MM;Myanmar;13;0;111;5
2020-04-20;MM;Myanmar;8;0;119;5
2020-04-21;MM;Myanmar;2;0;121;5
2020-04-22;MM;Myanmar;2;0;123;5
2020-04-23;MM;Myanmar;16;0;139;5
2020-04-24;MM;Myanmar;5;0;144;5
2020-04-25;MM;Myanmar;2;0;146;5
2020-04-26;MM;Myanmar;0;0;146;5
2020-04-27;MM;Myanmar;0;0;146;5
2020-04-28;MM;Myanmar;4;0;150;5
2020-04-29;MM;Myanmar;0;1;150;6
2020-04-30;MM;Myanmar;1;0;151;6
2020-05-01;MM;Myanmar;0;0;151;6
2020-05-02;MM;Myanmar;0;0;151;6
2020-05-03;MM;Myanmar;4;0;155;6
2020-05-04;MM;Myanmar;6;0;161;6
2020-05-05;MM;Myanmar;0;0;161;6
2020-05-06;MM;Myanmar;0;0;161;6
2020-05-07;MM;Myanmar;15;0;176;6
2020-05-08;MM;Myanmar;1;0;177;6
2020-05-09;MM;Myanmar;1;0;178;6
2020-05-10;MM;Myanmar;2;0;180;6
2020-05-11;MM;Myanmar;0;0;180;6
2020-05-12;MM;Myanmar;0;0;180;6
2020-05-13;MM;Myanmar;1;0;181;6
2020-05-14;MM;Myanmar;0;0;181;6
2020-05-15;MM;Myanmar;1;0;182;6
2020-05-16;MM;Myanmar;0;0;182;6
2020-05-17;MM;Myanmar;2;0;184;6
2020-05-18;MM;Myanmar;7;0;191;6
2020-05-19;MM;Myanmar;2;0;193;6
2020-05-20;MM;Myanmar;6;0;199;6
2020-05-21;MM;Myanmar;0;0;199;6
2020-05-22;MM;Myanmar;0;0;199;6
2020-05-23;MM;Myanmar;2;0;201;6
2020-05-24;MM;Myanmar;0;0;201;6
2020-05-25;MM;Myanmar;2;0;203;6
2020-05-26;MM;Myanmar;3;0;206;6
2020-05-27;MM;Myanmar;0;0;206;6
2020-05-28;MM;Myanmar;0;0;206;6
2020-05-29;MM;Myanmar;1;0;207;6
2020-05-30;MM;Myanmar;17;0;224;6
2020-05-31;MM;Myanmar;0;0;224;6
2020-06-01;MM;Myanmar;4;0;228;6
2020-06-02;MM;Myanmar;4;0;232;6
2020-06-03;MM;Myanmar;1;0;233;6
2020-06-04;MM;Myanmar;3;0;236;6
2020-06-05;MM;Myanmar;0;0;236;6
2020-06-06;MM;Myanmar;4;0;240;6
2020-06-07;MM;Myanmar;2;0;242;6
2020-06-08;MM;Myanmar;2;0;244;6
2020-06-09;MM;Myanmar;2;0;246;6
2020-06-10;MM;Myanmar;2;0;248;6
2020-06-11;MM;Myanmar;12;0;260;6
2020-06-12;MM;Myanmar;1;0;261;6
2020-06-13;MM;Myanmar;0;0;261;6
2020-06-14;MM;Myanmar;0;0;261;6
2020-06-15;MM;Myanmar;1;0;262;6
2020-06-16;MM;Myanmar;0;0;262;6
2020-06-17;MM;Myanmar;0;0;262;6
2020-06-18;MM;Myanmar;24;0;286;6
2020-06-19;MM;Myanmar;0;0;286;6
2020-06-20;MM;Myanmar;1;0;287;6
2020-06-21;MM;Myanmar;3;0;290;6
2020-06-22;MM;Myanmar;1;0;291;6
2020-06-23;MM;Myanmar;1;0;292;6
2020-06-24;MM;Myanmar;1;0;293;6
2020-06-25;MM;Myanmar;0;0;293;6
2020-06-26;MM;Myanmar;0;0;293;6
2020-06-27;MM;Myanmar;3;0;296;6
2020-06-28;MM;Myanmar;3;0;299;6
2020-06-29;MM;Myanmar;0;0;299;6
2020-06-30;MM;Myanmar;0;0;299;6
2020-07-01;MM;Myanmar;4;0;303;6
2020-07-02;MM;Myanmar;1;0;304;6
2020-07-03;MM;Myanmar;2;0;306;6
2020-07-04;MM;Myanmar;7;0;313;6
2020-07-05;MM;Myanmar;0;0;313;6
2020-07-06;MM;Myanmar;3;0;316;6
2020-07-07;MM;Myanmar;0;0;316;6
2020-07-08;MM;Myanmar;1;0;317;6
2020-07-09;MM;Myanmar;4;0;321;6
2020-07-10;MM;Myanmar;5;0;326;6
2020-07-11;MM;Myanmar;4;0;330;6
2020-07-12;MM;Myanmar;1;0;331;6
2020-07-13;MM;Myanmar;5;0;336;6
2020-07-14;MM;Myanmar;1;0;337;6
2020-07-15;MM;Myanmar;0;0;337;6
2020-07-16;MM;Myanmar;2;0;339;6
2020-07-17;MM;Myanmar;0;0;339;6
2020-07-18;MM;Myanmar;1;0;340;6
2020-07-19;MM;Myanmar;1;0;341;6
2020-07-20;MM;Myanmar;0;0;341;6
2020-07-21;MM;Myanmar;0;0;341;6
2020-07-22;MM;Myanmar;2;0;343;6
2020-07-23;MM;Myanmar;0;0;343;6
2020-07-24;MM;Myanmar;3;0;346;6
2020-07-25;MM;Myanmar;2;0;348;6
2020-07-26;MM;Myanmar;2;0;350;6
2020-07-27;MM;Myanmar;0;0;350;6
2020-07-28;MM;Myanmar;1;0;351;6
2020-07-29;MM;Myanmar;0;0;351;6
2020-07-30;MM;Myanmar;2;0;353;6
2020-07-31;MM;Myanmar;0;0;353;6
2020-08-01;MM;Myanmar;0;0;353;6
2020-08-02;MM;Myanmar;0;0;353;6
2020-08-03;MM;Myanmar;2;0;355;6
2020-08-04;MM;Myanmar;1;0;356;6
2020-08-05;MM;Myanmar;1;0;357;6
2020-08-06;MM;Myanmar;0;0;357;6
2020-08-07;MM;Myanmar;2;0;359;6
2020-08-08;MM;Myanmar;0;0;359;6
2020-08-09;MM;Myanmar;1;0;360;6
2020-08-10;MM;Myanmar;0;0;360;6
2020-08-11;MM;Myanmar;0;0;360;6
2020-08-12;MM;Myanmar;1;0;361;6
2020-08-13;MM;Myanmar;8;0;369;6
2020-08-14;MM;Myanmar;5;0;374;6
2020-08-15;MM;Myanmar;0;0;374;6
2020-08-16;MM;Myanmar;1;0;375;6
2020-08-17;MM;Myanmar;1;0;376;6
2020-08-18;MM;Myanmar;0;0;376;6
2020-08-19;MM;Myanmar;18;0;394;6
2020-08-20;MM;Myanmar;5;0;399;6
2020-08-21;MM;Myanmar;36;0;435;6
2020-08-22;MM;Myanmar;6;0;441;6
2020-08-23;MM;Myanmar;9;0;450;6
2020-08-24;MM;Myanmar;24;0;474;6
2020-08-25;MM;Myanmar;30;0;504;6
2020-08-26;MM;Myanmar;76;0;580;6
2020-08-27;MM;Myanmar;22;0;602;6
2020-08-28;MM;Myanmar;41;0;643;6
2020-08-29;MM;Myanmar;106;0;749;6
2020-08-30;MM;Myanmar;26;0;775;6
2020-08-31;MM;Myanmar;107;0;882;6
2020-09-01;MM;Myanmar;37;0;919;6
2020-09-02;MM;Myanmar;76;0;995;6
2020-09-03;MM;Myanmar;116;0;1111;6
2020-09-04;MM;Myanmar;60;1;1171;7
2020-09-05;MM;Myanmar;148;1;1319;8
2020-09-06;MM;Myanmar;100;0;1419;8
2020-09-07;MM;Myanmar;99;0;1518;8
2020-09-08;MM;Myanmar;289;4;1807;12
2020-09-09;MM;Myanmar;202;2;2009;14
2020-09-10;MM;Myanmar;141;0;2150;14
2020-09-11;MM;Myanmar;272;0;2422;14
2020-09-12;MM;Myanmar;374;2;2796;16
2020-09-13;MM;Myanmar;219;8;3015;24
2020-09-14;MM;Myanmar;180;8;3195;32
2020-09-15;MM;Myanmar;441;7;3636;39
2020-09-16;MM;Myanmar;258;7;3894;46
2020-09-17;MM;Myanmar;405;15;4299;61
2020-09-18;MM;Myanmar;322;14;4621;75
2020-09-19;MM;Myanmar;642;6;5263;81
2020-09-20;MM;Myanmar;542;13;5805;94
2020-09-21;MM;Myanmar;666;6;6471;100
2020-09-22;MM;Myanmar;488;16;6959;116
2020-09-23;MM;Myanmar;868;17;7827;133
2020-09-24;MM;Myanmar;688;22;8515;155
2020-09-25;MM;Myanmar;597;19;9112;174
2020-09-26;MM;Myanmar;879;24;9991;198
2020-09-27;MM;Myanmar;743;28;10734;226
2020-09-28;MM;Myanmar;897;30;11631;256
2020-09-29;MM;Myanmar;794;28;12425;284
2020-09-30;MM;Myanmar;948;26;13373;310
2020-10-01;MM;Myanmar;1010;11;14383;321
2020-10-02;MM;Myanmar;1142;32;15525;353
2020-10-03;MM;Myanmar;978;18;16503;371
2020-10-04;MM;Myanmar;1291;41;17794;412
2020-10-05;MM;Myanmar;987;32;18781;444
2020-10-06;MM;Myanmar;1252;27;20033;471
2020-10-07;MM;Myanmar;1400;39;21433;510
2020-10-08;MM;Myanmar;1012;25;22445;535
2020-10-09;MM;Myanmar;1461;31;23906;566
2020-10-10;MM;Myanmar;2158;32;26064;598
2020-10-11;MM;Myanmar;1910;48;27974;646
2020-10-12;MM;Myanmar;1340;18;29314;664
2020-10-13;MM;Myanmar;1123;29;30437;693
2020-10-14;MM;Myanmar;888;39;31325;732
2020-10-15;MM;Myanmar;1026;33;32351;765
2020-10-16;MM;Myanmar;1137;34;33488;799
2020-10-17;MM;Myanmar;1387;39;34875;838
2020-10-18;MM;Myanmar;1150;42;36025;880
2020-10-19;MM;Myanmar;1180;34;37205;914
2020-10-20;MM;Myanmar;1297;31;38502;945
2020-10-21;MM;Myanmar;1194;27;39696;972
2020-10-22;MM;Myanmar;1312;33;41008;1005
2020-10-23;MM;Myanmar;1357;33;42365;1038
2020-10-24;MM;Myanmar;1423;28;43788;1066
2020-10-25;MM;Myanmar;986;29;44774;1095
2020-10-26;MM;Myanmar;1426;27;46200;1122
2020-10-27;MM;Myanmar;1466;25;47666;1147
2020-10-28;MM;Myanmar;1406;25;49072;1172
2020-10-29;MM;Myanmar;1331;27;50403;1199
2020-10-30;MM;Myanmar;1093;20;51496;1219
2020-10-31;MM;Myanmar;1210;18;52706;1237
2020-11-01;MM;Myanmar;699;21;53405;1258
2020-11-02;MM;Myanmar;1202;24;54607;1282
2020-11-03;MM;Myanmar;1197;25;55804;1307
2020-11-04;MM;Myanmar;1136;23;56940;1330
2020-11-05;MM;Myanmar;995;22;57935;1352
2020-11-06;MM;Myanmar;1342;24;59277;1376
2020-11-07;MM;Myanmar;1071;20;60348;1396
2020-11-08;MM;Myanmar;1029;24;61377;1420
2020-11-09;MM;Myanmar;598;17;61975;1437
2020-11-10;MM;Myanmar;1266;24;63241;1461
2020-11-11;MM;Myanmar;1212;19;64453;1480
2020-11-12;MM;Myanmar;1145;28;65598;1508
2020-11-13;MM;Myanmar;1136;26;66734;1534
2020-11-14;MM;Myanmar;1277;18;68011;1552
2020-11-15;MM;Myanmar;983;25;68994;1577
2020-11-16;MM;Myanmar;1167;22;70161;1599
2020-11-17;MM;Myanmar;1569;26;71730;1625
2020-11-18;MM;Myanmar;1592;25;73322;1650
2020-11-19;MM;Myanmar;1560;26;74882;1676
2020-11-20;MM;Myanmar;1532;19;76414;1695
2020-11-21;MM;Myanmar;1434;27;77848;1722
2020-11-22;MM;Myanmar;1398;17;79246;1739
2020-11-23;MM;Myanmar;1259;26;80505;1765
2020-11-24;MM;Myanmar;1731;19;82236;1784
2020-11-25;MM;Myanmar;1330;26;83566;1810
2020-11-26;MM;Myanmar;1639;36;85205;1846
2020-11-27;MM;Myanmar;1428;19;86633;1865
2020-11-28;MM;Myanmar;1344;22;87977;1887
2020-11-29;MM;Myanmar;1509;31;89486;1918
2020-11-30;MM;Myanmar;1227;23;90713;1941
2020-12-01;MM;Myanmar;1476;31;92189;1972
2020-12-02;MM;Myanmar;1411;26;93600;1998
2020-12-03;MM;Myanmar;1418;30;95018;2028
2020-12-04;MM;Myanmar;1502;31;96520;2059
2020-12-05;MM;Myanmar;1527;22;98047;2081
2020-12-06;MM;Myanmar;1108;29;99155;2110
2020-12-07;MM;Myanmar;1276;22;100431;2132
2020-12-08;MM;Myanmar;1308;19;101739;2151
2020-12-09;MM;Myanmar;1427;23;103166;2174
2020-12-10;MM;Myanmar;1321;27;104487;2201
2020-12-11;MM;Myanmar;1376;19;105863;2220
2020-12-12;MM;Myanmar;1352;25;107215;2245
2020-12-13;MM;Myanmar;1127;23;108342;2268
2020-12-14;MM;Myanmar;1170;24;109512;2292
2020-12-15;MM;Myanmar;1155;27;110667;2319
2020-12-16;MM;Myanmar;1233;27;111900;2346
2020-12-17;MM;Myanmar;1182;31;113082;2377
2020-12-18;MM;Myanmar;1116;21;114198;2398
2020-12-19;MM;Myanmar;989;26;115187;2424
2020-12-20;MM;Myanmar;947;19;116134;2443
2020-12-21;MM;Myanmar;848;22;116982;2465
2020-12-22;MM;Myanmar;964;19;117946;2484
2020-12-23;MM;Myanmar;923;23;118869;2507
2020-12-24;MM;Myanmar;919;25;119788;2532
2020-12-25;MM;Myanmar;758;20;120546;2552
2020-12-26;MM;Myanmar;734;27;121280;2579
2020-12-27;MM;Myanmar;606;22;121886;2601
2020-12-28;MM;Myanmar;648;17;122534;2618
2020-12-29;MM;Myanmar;619;19;123153;2637
2020-12-30;MM;Myanmar;587;27;123740;2664
2020-12-31;MM;Myanmar;890;18;124630;2682
2021-01-01;MM;Myanmar;412;15;125042;2697
2021-01-02;MM;Myanmar;574;14;125616;2711
2021-01-03;MM;Myanmar;729;17;126345;2728
2021-01-04;MM;Myanmar;590;16;126935;2744
2021-01-05;MM;Myanmar;649;22;127584;2766
2021-01-06;MM;Myanmar;594;19;128178;2785
2021-01-07;MM;Myanmar;594;14;128772;2799
2021-01-08;MM;Myanmar;711;13;129483;2812
2021-01-09;MM;Myanmar;566;14;130049;2826
2021-01-10;MM;Myanmar;555;20;130604;2846
2021-01-11;MM;Myanmar;582;12;131186;2858
2021-01-12;MM;Myanmar;551;20;131737;2878
2021-01-13;MM;Myanmar;523;24;132260;2902
2021-01-14;MM;Myanmar;605;10;132865;2912
2021-01-15;MM;Myanmar;513;14;133378;2926
2021-01-16;MM;Myanmar;491;16;133869;2942
2021-01-17;MM;Myanmar;449;13;134318;2955
2021-01-18;MM;Myanmar;477;18;134795;2973
2021-01-19;MM;Myanmar;448;13;135243;2986
2021-01-20;MM;Myanmar;478;11;135721;2997
2021-01-21;MM;Myanmar;445;16;136166;3013
2021-01-22;MM;Myanmar;425;18;136591;3031
2021-01-23;MM;Myanmar;507;14;137098;3045
2021-01-24;MM;Myanmar;476;17;137574;3062
2021-01-25;MM;Myanmar;383;7;137957;3069
2021-01-26;MM;Myanmar;411;13;138368;3082
2021-01-27;MM;Myanmar;434;7;138802;3089
2021-01-28;MM;Myanmar;350;14;139152;3103
2021-01-29;MM;Myanmar;363;12;139515;3115
2021-01-30;MM;Myanmar;349;10;139864;3125
2021-01-31;MM;Myanmar;281;6;140145;3131
2021-02-01;MM;Myanmar;209;7;140354;3138
2021-02-02;MM;Myanmar;0;0;140354;3138
2021-02-03;MM;Myanmar;573;22;140927;3160
2021-02-04;MM;Myanmar;177;3;141104;3163
2021-02-05;MM;Myanmar;200;5;141304;3168
2021-02-06;MM;Myanmar;0;0;141304;3168
2021-02-07;MM;Myanmar;0;0;141304;3168
2021-02-08;MM;Myanmar;123;9;141427;3177
2021-02-09;MM;Myanmar;21;3;141448;3180
2021-02-10;MM;Myanmar;39;1;141487;3181
2021-02-11;MM;Myanmar;35;3;141522;3184
2021-02-12;MM;Myanmar;21;4;141543;3188
2021-02-13;MM;Myanmar;42;0;141585;3188
2021-02-14;MM;Myanmar;16;1;141601;3189
2021-02-15;MM;Myanmar;36;1;141637;3190
2021-02-16;MM;Myanmar;22;2;141659;3192
2021-02-17;MM;Myanmar;31;0;141690;3192
2021-02-18;MM;Myanmar;19;-1;141709;3191
2021-02-19;MM;Myanmar;19;3;141728;3194
2021-02-20;MM;Myanmar;7;2;141735;3196
2021-02-21;MM;Myanmar;15;0;141750;3196
2021-02-22;MM;Myanmar;11;1;141761;3197
2021-02-23;MM;Myanmar;22;0;141783;3197
2021-02-24;MM;Myanmar;33;0;141816;3197
2021-02-25;MM;Myanmar;25;1;141841;3198
2021-02-26;MM;Myanmar;34;0;141875;3198
2021-02-27;MM;Myanmar;15;1;141890;3199
2021-02-28;MM;Myanmar;6;0;141896;3199
2021-03-01;MM;Myanmar;20;0;141916;3199
2021-03-02;MM;Myanmar;49;0;141965;3199
2021-03-03;MM;Myanmar;19;0;141984;3199
2021-03-04;MM;Myanmar;16;1;142000;3200
2021-03-05;MM;Myanmar;0;0;142000;3200
2021-03-06;MM;Myanmar;23;0;142023;3200
2021-03-07;MM;Myanmar;11;0;142034;3200
2021-03-08;MM;Myanmar;11;0;142045;3200
2021-03-09;MM;Myanmar;14;0;142059;3200
2021-03-10;MM;Myanmar;14;0;142073;3200
2021-03-11;MM;Myanmar;41;1;142114;3201
2021-03-12;MM;Myanmar;8;0;142122;3201
2021-03-13;MM;Myanmar;14;0;142136;3201
2021-03-14;MM;Myanmar;11;1;142147;3202
2021-03-15;MM;Myanmar;0;0;142147;3202
2021-03-16;MM;Myanmar;15;1;142162;3203
2021-03-17;MM;Myanmar;28;0;142190;3203
2021-03-18;MM;Myanmar;22;1;142212;3204
2021-03-19;MM;Myanmar;0;0;142212;3204
2021-03-20;MM;Myanmar;0;0;142212;3204
2021-03-21;MM;Myanmar;0;0;142212;3204
2021-03-22;MM;Myanmar;34;0;142246;3204
2021-03-23;MM;Myanmar;18;0;142264;3204
2021-03-24;MM;Myanmar;28;0;142292;3204
2021-03-25;MM;Myanmar;23;0;142315;3204
2021-03-26;MM;Myanmar;25;1;142340;3205
2021-03-27;MM;Myanmar;37;1;142377;3206
2021-03-28;MM;Myanmar;8;0;142385;3206
2021-03-29;MM;Myanmar;8;0;142393;3206
2021-03-30;MM;Myanmar;19;0;142412;3206
2021-03-31;MM;Myanmar;22;0;142434;3206
2021-04-01;MM;Myanmar;32;0;142466;3206
2021-04-02;MM;Myanmar;0;0;142466;3206
2021-04-03;MM;Myanmar;13;0;142479;3206
2021-04-04;MM;Myanmar;18;0;142497;3206
2021-04-05;MM;Myanmar;14;0;142511;3206
2021-04-06;MM;Myanmar;19;0;142530;3206
2021-04-07;MM;Myanmar;11;0;142541;3206
2021-04-08;MM;Myanmar;8;0;142549;3206
2021-04-09;MM;Myanmar;9;0;142558;3206
2021-04-10;MM;Myanmar;14;0;142572;3206
2021-04-11;MM;Myanmar;4;0;142576;3206
2021-04-12;MM;Myanmar;20;0;142596;3206
2021-04-13;MM;Myanmar;0;0;142596;3206
2021-04-14;MM;Myanmar;9;0;142605;3206
2021-04-15;MM;Myanmar;5;0;142610;3206
2021-04-16;MM;Myanmar;7;0;142617;3206
2021-04-17;MM;Myanmar;2;0;142619;3206
2021-04-18;MM;Myanmar;9;0;142628;3206
2021-04-19;MM;Myanmar;16;0;142644;3206
2021-04-20;MM;Myanmar;0;0;142644;3206
2021-04-21;MM;Myanmar;17;0;142661;3206
2021-04-22;MM;Myanmar;13;0;142674;3206
2021-04-23;MM;Myanmar;13;0;142687;3206
2021-04-24;MM;Myanmar;17;0;142704;3206
2021-04-25;MM;Myanmar;8;0;142712;3206
2021-04-26;MM;Myanmar;10;1;142722;3207
2021-04-27;MM;Myanmar;18;0;142740;3207
2021-04-28;MM;Myanmar;50;2;142790;3209
2021-04-29;MM;Myanmar;10;0;142800;3209
2021-04-30;MM;Myanmar;17;0;142817;3209
2021-05-01;MM;Myanmar;14;0;142831;3209
2021-05-02;MM;Myanmar;7;0;142838;3209
2021-05-03;MM;Myanmar;4;0;142842;3209
2021-05-04;MM;Myanmar;16;0;142858;3209
2021-05-05;MM;Myanmar;16;1;142874;3210
2021-05-06;MM;Myanmar;0;0;142874;3210
2021-05-07;MM;Myanmar;29;0;142903;3210
2021-05-08;MM;Myanmar;31;0;142934;3210
2021-05-09;MM;Myanmar;13;0;142947;3210
2021-05-10;MM;Myanmar;16;0;142963;3210
2021-05-11;MM;Myanmar;11;0;142974;3210
2021-05-12;MM;Myanmar;23;1;142997;3211
2021-05-13;MM;Myanmar;7;1;143004;3212
2021-05-14;MM;Myanmar;31;0;143035;3212
2021-05-15;MM;Myanmar;24;0;143059;3212
2021-05-16;MM;Myanmar;6;0;143065;3212
2021-05-17;MM;Myanmar;32;1;143097;3213
2021-05-18;MM;Myanmar;34;0;143131;3213
2021-05-19;MM;Myanmar;28;3;143159;3216
2021-05-20;MM;Myanmar;24;0;143183;3216
2021-05-21;MM;Myanmar;28;0;143211;3216
2021-05-22;MM;Myanmar;17;0;143228;3216
2021-05-23;MM;Myanmar;6;0;143234;3216
2021-05-24;MM;Myanmar;28;0;143262;3216
2021-05-25;MM;Myanmar;34;0;143296;3216
2021-05-26;MM;Myanmar;22;0;143318;3216
2021-05-27;MM;Myanmar;96;0;143414;3216
2021-05-28;MM;Myanmar;72;0;143486;3216
2021-05-29;MM;Myanmar;40;0;143526;3216
2021-05-30;MM;Myanmar;45;0;143571;3216
2021-05-31;MM;Myanmar;58;1;143629;3217
2021-06-01;MM;Myanmar;122;0;143751;3217
2021-06-02;MM;Myanmar;72;1;143823;3218
2021-06-03;MM;Myanmar;122;3;143945;3221
2021-06-04;MM;Myanmar;212;0;144157;3221
2021-06-05;MM;Myanmar;96;2;144253;3223
2021-06-06;MM;Myanmar;64;2;144317;3225
2021-06-07;MM;Myanmar;139;2;144456;3227
2021-06-08;MM;Myanmar;123;1;144579;3228
2021-06-09;MM;Myanmar;136;5;144715;3233
2021-06-10;MM;Myanmar;161;4;144876;3237
2021-06-11;MM;Myanmar;188;2;145064;3239
2021-06-12;MM;Myanmar;166;2;145230;3241
2021-06-13;MM;Myanmar;373;3;145603;3244
2021-06-14;MM;Myanmar;223;4;145826;3248
2021-06-15;MM;Myanmar;225;0;146051;3248
2021-06-16;MM;Myanmar;355;2;146406;3250
2021-06-17;MM;Myanmar;362;0;146768;3250
2021-06-18;MM;Myanmar;301;1;147069;3251
2021-06-19;MM;Myanmar;546;7;147615;3258
2021-06-20;MM;Myanmar;407;4;148022;3262
2021-06-21;MM;Myanmar;595;3;148617;3265
2021-06-22;MM;Myanmar;630;2;149247;3267
2021-06-23;MM;Myanmar;680;2;149927;3269
2021-06-24;MM;Myanmar;787;6;150714;3275
2021-06-25;MM;Myanmar;859;7;151573;3282
2021-06-26;MM;Myanmar;783;8;152356;3290
2021-06-27;MM;Myanmar;804;7;153160;3297
2021-06-28;MM;Myanmar;1225;12;154385;3309
2021-06-29;MM;Myanmar;1312;11;155697;3320
2021-06-30;MM;Myanmar;1580;14;157277;3334
2021-07-01;MM;Myanmar;2070;13;159347;3347
2020-03-14;NA;Namibia;2;0;2;0
2020-03-15;NA;Namibia;0;0;2;0
2020-03-16;NA;Namibia;0;0;2;0
2020-03-17;NA;Namibia;0;0;2;0
2020-03-18;NA;Namibia;0;0;2;0
2020-03-19;NA;Namibia;1;0;3;0
2020-03-20;NA;Namibia;0;0;3;0
2020-03-21;NA;Namibia;0;0;3;0
2020-03-22;NA;Namibia;0;0;3;0
2020-03-23;NA;Namibia;1;0;4;0
2020-03-24;NA;Namibia;3;0;7;0
2020-03-25;NA;Namibia;0;0;7;0
2020-03-26;NA;Namibia;1;0;8;0
2020-03-27;NA;Namibia;0;0;8;0
2020-03-28;NA;Namibia;0;0;8;0
2020-03-29;NA;Namibia;3;0;11;0
2020-03-30;NA;Namibia;0;0;11;0
2020-03-31;NA;Namibia;0;0;11;0
2020-04-01;NA;Namibia;3;0;14;0
2020-04-02;NA;Namibia;0;0;14;0
2020-04-03;NA;Namibia;0;0;14;0
2020-04-04;NA;Namibia;0;0;14;0
2020-04-05;NA;Namibia;2;0;16;0
2020-04-06;NA;Namibia;0;0;16;0
2020-04-07;NA;Namibia;0;0;16;0
2020-04-08;NA;Namibia;0;0;16;0
2020-04-09;NA;Namibia;0;0;16;0
2020-04-10;NA;Namibia;0;0;16;0
2020-04-11;NA;Namibia;0;0;16;0
2020-04-12;NA;Namibia;0;0;16;0
2020-04-13;NA;Namibia;0;0;16;0
2020-04-14;NA;Namibia;0;0;16;0
2020-04-15;NA;Namibia;0;0;16;0
2020-04-16;NA;Namibia;0;0;16;0
2020-04-17;NA;Namibia;0;0;16;0
2020-04-18;NA;Namibia;0;0;16;0
2020-04-19;NA;Namibia;0;0;16;0
2020-04-20;NA;Namibia;0;0;16;0
2020-04-21;NA;Namibia;0;0;16;0
2020-04-22;NA;Namibia;0;0;16;0
2020-04-23;NA;Namibia;0;0;16;0
2020-04-24;NA;Namibia;0;0;16;0
2020-04-25;NA;Namibia;0;0;16;0
2020-04-26;NA;Namibia;0;0;16;0
2020-04-27;NA;Namibia;0;0;16;0
2020-04-28;NA;Namibia;0;0;16;0
2020-04-29;NA;Namibia;0;0;16;0
2020-04-30;NA;Namibia;0;0;16;0
2020-05-01;NA;Namibia;0;0;16;0
2020-05-02;NA;Namibia;0;0;16;0
2020-05-03;NA;Namibia;0;0;16;0
2020-05-04;NA;Namibia;0;0;16;0
2020-05-05;NA;Namibia;0;0;16;0
2020-05-06;NA;Namibia;0;0;16;0
2020-05-07;NA;Namibia;0;0;16;0
2020-05-08;NA;Namibia;0;0;16;0
2020-05-09;NA;Namibia;0;0;16;0
2020-05-10;NA;Namibia;0;0;16;0
2020-05-11;NA;Namibia;0;0;16;0
2020-05-12;NA;Namibia;0;0;16;0
2020-05-13;NA;Namibia;0;0;16;0
2020-05-14;NA;Namibia;0;0;16;0
2020-05-15;NA;Namibia;0;0;16;0
2020-05-16;NA;Namibia;0;0;16;0
2020-05-17;NA;Namibia;0;0;16;0
2020-05-18;NA;Namibia;0;0;16;0
2020-05-19;NA;Namibia;0;0;16;0
2020-05-20;NA;Namibia;0;0;16;0
2020-05-21;NA;Namibia;2;0;18;0
2020-05-22;NA;Namibia;1;0;19;0
2020-05-23;NA;Namibia;1;0;20;0
2020-05-24;NA;Namibia;1;0;21;0
2020-05-25;NA;Namibia;0;0;21;0
2020-05-26;NA;Namibia;0;0;21;0
2020-05-27;NA;Namibia;1;0;22;0
2020-05-28;NA;Namibia;0;0;22;0
2020-05-29;NA;Namibia;1;0;23;0
2020-05-30;NA;Namibia;0;0;23;0
2020-05-31;NA;Namibia;1;0;24;0
2020-06-01;NA;Namibia;1;0;25;0
2020-06-02;NA;Namibia;0;0;25;0
2020-06-03;NA;Namibia;0;0;25;0
2020-06-04;NA;Namibia;0;0;25;0
2020-06-05;NA;Namibia;0;0;25;0
2020-06-06;NA;Namibia;4;0;29;0
2020-06-07;NA;Namibia;0;0;29;0
2020-06-08;NA;Namibia;2;0;31;0
2020-06-09;NA;Namibia;0;0;31;0
2020-06-10;NA;Namibia;0;0;31;0
2020-06-11;NA;Namibia;0;0;31;0
2020-06-12;NA;Namibia;0;0;31;0
2020-06-13;NA;Namibia;1;0;32;0
2020-06-14;NA;Namibia;0;0;32;0
2020-06-15;NA;Namibia;0;0;32;0
2020-06-16;NA;Namibia;2;0;34;0
2020-06-17;NA;Namibia;2;0;36;0
2020-06-18;NA;Namibia;3;0;39;0
2020-06-19;NA;Namibia;6;0;45;0
2020-06-20;NA;Namibia;1;0;46;0
2020-06-21;NA;Namibia;9;0;55;0
2020-06-22;NA;Namibia;8;0;63;0
2020-06-23;NA;Namibia;9;0;72;0
2020-06-24;NA;Namibia;4;0;76;0
2020-06-25;NA;Namibia;26;0;102;0
2020-06-26;NA;Namibia;19;0;121;0
2020-06-27;NA;Namibia;15;0;136;0
2020-06-28;NA;Namibia;47;0;183;0
2020-06-29;NA;Namibia;13;0;196;0
2020-06-30;NA;Namibia;9;0;205;0
2020-07-01;NA;Namibia;80;0;285;0
2020-07-02;NA;Namibia;8;0;293;0
2020-07-03;NA;Namibia;57;0;350;0
2020-07-04;NA;Namibia;25;0;375;0
2020-07-05;NA;Namibia;37;0;412;0
2020-07-06;NA;Namibia;73;0;485;0
2020-07-07;NA;Namibia;54;0;539;0
2020-07-08;NA;Namibia;54;0;593;0
2020-07-09;NA;Namibia;22;0;615;0
2020-07-10;NA;Namibia;53;1;668;1
2020-07-11;NA;Namibia;0;0;668;1
2020-07-12;NA;Namibia;117;0;785;1
2020-07-13;NA;Namibia;76;0;861;1
2020-07-14;NA;Namibia;3;1;864;2
2020-07-15;NA;Namibia;96;0;960;2
2020-07-16;NA;Namibia;72;0;1032;2
2020-07-17;NA;Namibia;46;0;1078;2
2020-07-18;NA;Namibia;125;0;1203;2
2020-07-19;NA;Namibia;44;1;1247;3
2020-07-20;NA;Namibia;97;1;1344;4
2020-07-21;NA;Namibia;22;3;1366;7
2020-07-22;NA;Namibia;36;0;1402;7
2020-07-23;NA;Namibia;120;0;1522;7
2020-07-24;NA;Namibia;96;0;1618;7
2020-07-25;NA;Namibia;69;0;1687;7
2020-07-26;NA;Namibia;88;1;1775;8
2020-07-27;NA;Namibia;68;0;1843;8
2020-07-28;NA;Namibia;74;0;1917;8
2020-07-29;NA;Namibia;69;1;1986;9
2020-07-30;NA;Namibia;66;1;2052;10
2020-07-31;NA;Namibia;77;0;2129;10
2020-08-01;NA;Namibia;95;1;2224;11
2020-08-02;NA;Namibia;70;0;2294;11
2020-08-03;NA;Namibia;112;1;2406;12
2020-08-04;NA;Namibia;64;0;2470;12
2020-08-05;NA;Namibia;70;0;2540;12
2020-08-06;NA;Namibia;112;3;2652;15
2020-08-07;NA;Namibia;150;1;2802;16
2020-08-08;NA;Namibia;0;0;2802;16
2020-08-09;NA;Namibia;147;3;2949;19
2020-08-10;NA;Namibia;152;0;3101;19
2020-08-11;NA;Namibia;128;0;3229;19
2020-08-12;NA;Namibia;177;3;3406;22
2020-08-13;NA;Namibia;138;5;3544;27
2020-08-14;NA;Namibia;182;4;3726;31
2020-08-15;NA;Namibia;181;4;3907;35
2020-08-16;NA;Namibia;247;0;4154;35
2020-08-17;NA;Namibia;190;1;4344;36
2020-08-18;NA;Namibia;120;1;4464;37
2020-08-19;NA;Namibia;201;2;4665;39
2020-08-20;NA;Namibia;247;2;4912;41
2020-08-21;NA;Namibia;315;1;5227;42
2020-08-22;NA;Namibia;311;4;5538;46
2020-08-23;NA;Namibia;316;6;5854;52
2020-08-24;NA;Namibia;176;4;6030;56
2020-08-25;NA;Namibia;130;1;6160;57
2020-08-26;NA;Namibia;271;2;6431;59
2020-08-27;NA;Namibia;281;1;6712;60
2020-08-28;NA;Namibia;194;5;6906;65
2020-08-29;NA;Namibia;210;4;7116;69
2020-08-30;NA;Namibia;249;3;7365;72
2020-08-31;NA;Namibia;185;3;7550;75
2020-09-01;NA;Namibia;142;6;7692;81
2020-09-02;NA;Namibia;152;1;7844;82
2020-09-03;NA;Namibia;238;4;8082;86
2020-09-04;NA;Namibia;241;1;8323;87
2020-09-05;NA;Namibia;191;0;8514;87
2020-09-06;NA;Namibia;171;2;8685;89
2020-09-07;NA;Namibia;125;2;8810;91
2020-09-08;NA;Namibia;118;0;8928;91
2020-09-09;NA;Namibia;180;2;9108;93
2020-09-10;NA;Namibia;148;3;9256;96
2020-09-11;NA;Namibia;181;2;9437;98
2020-09-12;NA;Namibia;167;0;9604;98
2020-09-13;NA;Namibia;115;3;9719;101
2020-09-14;NA;Namibia;99;2;9818;103
2020-09-15;NA;Namibia;83;3;9901;106
2020-09-16;NA;Namibia;63;2;9964;108
2020-09-17;NA;Namibia;114;0;10078;108
2020-09-18;NA;Namibia;129;0;10207;108
2020-09-19;NA;Namibia;85;3;10292;111
2020-09-20;NA;Namibia;85;1;10377;112
2020-09-21;NA;Namibia;149;1;10526;113
2020-09-22;NA;Namibia;81;3;10607;116
2020-09-23;NA;Namibia;56;1;10663;117
2020-09-24;NA;Namibia;77;2;10740;119
2020-09-25;NA;Namibia;95;0;10835;119
2020-09-26;NA;Namibia;83;1;10918;120
2020-09-27;NA;Namibia;115;0;11033;120
2020-09-28;NA;Namibia;88;1;11121;121
2020-09-29;NA;Namibia;19;0;11140;121
2020-09-30;NA;Namibia;125;0;11265;121
2020-10-01;NA;Namibia;108;2;11373;123
2020-10-02;NA;Namibia;107;0;11480;123
2020-10-03;NA;Namibia;92;0;11572;123
2020-10-04;NA;Namibia;54;0;11626;123
2020-10-05;NA;Namibia;28;2;11654;125
2020-10-06;NA;Namibia;19;0;11673;125
2020-10-07;NA;Namibia;41;1;11714;126
2020-10-08;NA;Namibia;67;1;11781;127
2020-10-09;NA;Namibia;48;0;11829;127
2020-10-10;NA;Namibia;62;1;11891;128
2020-10-11;NA;Namibia;45;0;11936;128
2020-10-12;NA;Namibia;53;1;11989;129
2020-10-13;NA;Namibia;11;0;12000;129
2020-10-14;NA;Namibia;69;1;12069;130
2020-10-15;NA;Namibia;34;0;12103;130
2020-10-16;NA;Namibia;112;1;12215;131
2020-10-17;NA;Namibia;48;0;12263;131
2020-10-18;NA;Namibia;30;0;12293;131
2020-10-19;NA;Namibia;33;0;12326;131
2020-10-20;NA;Namibia;41;1;12367;132
2020-10-21;NA;Namibia;39;1;12406;133
2020-10-22;NA;Namibia;54;0;12460;133
2020-10-23;NA;Namibia;41;0;12501;133
2020-10-24;NA;Namibia;78;0;12579;133
2020-10-25;NA;Namibia;81;0;12660;133
2020-10-26;NA;Namibia;15;0;12675;133
2020-10-27;NA;Namibia;54;0;12729;133
2020-10-28;NA;Namibia;77;0;12806;133
2020-10-29;NA;Namibia;52;0;12858;133
2020-10-30;NA;Namibia;49;0;12907;133
2020-10-31;NA;Namibia;28;0;12935;133
2020-11-01;NA;Namibia;53;0;12988;133
2020-11-02;NA;Namibia;24;0;13012;133
2020-11-03;NA;Namibia;18;0;13030;133
2020-11-04;NA;Namibia;16;0;13046;133
2020-11-05;NA;Namibia;44;0;13090;133
2020-11-06;NA;Namibia;53;0;13143;133
2020-11-07;NA;Namibia;27;1;13170;134
2020-11-08;NA;Namibia;41;0;13211;134
2020-11-09;NA;Namibia;29;0;13240;134
2020-11-10;NA;Namibia;13;0;13253;134
2020-11-11;NA;Namibia;39;0;13292;134
2020-11-12;NA;Namibia;53;1;13345;135
2020-11-13;NA;Namibia;27;3;13372;138
2020-11-14;NA;Namibia;77;0;13449;138
2020-11-15;NA;Namibia;59;0;13508;138
2020-11-16;NA;Namibia;47;0;13555;138
2020-11-17;NA;Namibia;11;2;13566;140
2020-11-18;NA;Namibia;44;0;13610;140
2020-11-19;NA;Namibia;52;1;13662;141
2020-11-20;NA;Namibia;50;2;13712;143
2020-11-21;NA;Namibia;99;2;13811;145
2020-11-22;NA;Namibia;54;0;13865;145
2020-11-23;NA;Namibia;32;0;13897;145
2020-11-24;NA;Namibia;41;0;13938;145
2020-11-25;NA;Namibia;68;0;14006;145
2020-11-26;NA;Namibia;149;2;14155;147
2020-11-27;NA;Namibia;52;2;14207;149
2020-11-28;NA;Namibia;78;1;14285;150
2020-11-29;NA;Namibia;60;1;14345;151
2020-11-30;NA;Namibia;35;0;14380;151
2020-12-01;NA;Namibia;36;0;14416;151
2020-12-02;NA;Namibia;61;0;14477;151
2020-12-03;NA;Namibia;122;0;14599;151
2020-12-04;NA;Namibia;205;1;14804;152
2020-12-05;NA;Namibia;146;0;14950;152
2020-12-06;NA;Namibia;128;0;15078;152
2020-12-07;NA;Namibia;141;0;15219;152
2020-12-08;NA;Namibia;79;1;15298;153
2020-12-09;NA;Namibia;174;2;15472;155
2020-12-10;NA;Namibia;301;3;15773;158
2020-12-11;NA;Namibia;324;2;16097;160
2020-12-12;NA;Namibia;172;0;16269;160
2020-12-13;NA;Namibia;267;0;16536;160
2020-12-14;NA;Namibia;190;3;16726;163
2020-12-15;NA;Namibia;187;1;16913;164
2020-12-16;NA;Namibia;363;0;17276;164
2020-12-17;NA;Namibia;331;0;17607;164
2020-12-18;NA;Namibia;434;5;18041;169
2020-12-19;NA;Namibia;396;2;18437;171
2020-12-20;NA;Namibia;277;6;18714;177
2020-12-21;NA;Namibia;585;3;19299;180
2020-12-22;NA;Namibia;330;1;19629;181
2020-12-23;NA;Namibia;355;2;19984;183
2020-12-24;NA;Namibia;595;4;20579;187
2020-12-25;NA;Namibia;683;0;21262;187
2020-12-26;NA;Namibia;136;0;21398;187
2020-12-27;NA;Namibia;525;4;21923;191
2020-12-28;NA;Namibia;364;2;22287;193
2020-12-29;NA;Namibia;564;2;22851;195
2020-12-30;NA;Namibia;482;1;23333;196
2020-12-31;NA;Namibia;608;9;23941;205
2021-01-01;NA;Namibia;604;3;24545;208
2021-01-02;NA;Namibia;109;5;24654;213
2021-01-03;NA;Namibia;462;2;25116;215
2021-01-04;NA;Namibia;270;3;25386;218
2021-01-05;NA;Namibia;501;4;25887;222
2021-01-06;NA;Namibia;432;13;26319;235
2021-01-07;NA;Namibia;363;5;26682;240
2021-01-08;NA;Namibia;573;5;27255;245
2021-01-09;NA;Namibia;468;6;27723;251
2021-01-10;NA;Namibia;536;3;28259;254
2021-01-11;NA;Namibia;343;7;28602;261
2021-01-12;NA;Namibia;269;3;28871;264
2021-01-13;NA;Namibia;312;7;29183;271
2021-01-14;NA;Namibia;387;4;29570;275
2021-01-15;NA;Namibia;319;5;29889;280
2021-01-16;NA;Namibia;309;0;30198;280
2021-01-17;NA;Namibia;165;5;30363;285
2021-01-18;NA;Namibia;390;8;30753;293
2021-01-19;NA;Namibia;242;3;30995;296
2021-01-20;NA;Namibia;258;5;31253;301
2021-01-21;NA;Namibia;262;9;31515;310
2021-01-22;NA;Namibia;333;1;31848;311
2021-01-23;NA;Namibia;365;6;32213;317
2021-01-24;NA;Namibia;212;2;32425;319
2021-01-25;NA;Namibia;225;0;32650;319
2021-01-26;NA;Namibia;307;9;32957;328
2021-01-27;NA;Namibia;308;4;33265;332
2021-01-28;NA;Namibia;194;0;33459;332
2021-01-29;NA;Namibia;237;10;33696;342
2021-01-30;NA;Namibia;136;8;33832;350
2021-01-31;NA;Namibia;112;2;33944;352
2021-02-01;NA;Namibia;224;1;34168;353
2021-02-02;NA;Namibia;102;2;34270;355
2021-02-03;NA;Namibia;102;4;34372;359
2021-02-04;NA;Namibia;147;5;34519;364
2021-02-05;NA;Namibia;96;6;34615;370
2021-02-06;NA;Namibia;229;1;34844;371
2021-02-07;NA;Namibia;129;4;34973;375
2021-02-08;NA;Namibia;97;0;35070;375
2021-02-09;NA;Namibia;131;2;35201;377
2021-02-10;NA;Namibia;41;1;35242;378
2021-02-11;NA;Namibia;111;4;35353;382
2021-02-12;NA;Namibia;201;2;35554;384
2021-02-13;NA;Namibia;243;2;35797;386
2021-02-14;NA;Namibia;155;2;35952;388
2021-02-15;NA;Namibia;273;1;36225;389
2021-02-16;NA;Namibia;141;3;36366;392
2021-02-17;NA;Namibia;74;2;36440;394
2021-02-18;NA;Namibia;240;0;36680;394
2021-02-19;NA;Namibia;313;5;36993;399
2021-02-20;NA;Namibia;302;3;37295;402
2021-02-21;NA;Namibia;188;0;37483;402
2021-02-22;NA;Namibia;259;4;37742;406
2021-02-23;NA;Namibia;154;5;37896;411
2021-02-24;NA;Namibia;80;2;37976;413
2021-02-25;NA;Namibia;230;3;38206;416
2021-02-26;NA;Namibia;218;2;38424;418
2021-02-27;NA;Namibia;218;2;38642;420
2021-02-28;NA;Namibia;203;4;38845;424
2021-03-01;NA;Namibia;188;4;39033;428
2021-03-02;NA;Namibia;149;2;39182;430
2021-03-03;NA;Namibia;115;4;39297;434
2021-03-04;NA;Namibia;169;2;39466;436
2021-03-05;NA;Namibia;210;1;39676;437
2021-03-06;NA;Namibia;201;0;39877;437
2021-03-07;NA;Namibia;153;1;40030;438
2021-03-08;NA;Namibia;157;1;40187;439
2021-03-09;NA;Namibia;150;5;40337;444
2021-03-10;NA;Namibia;114;4;40451;448
2021-03-11;NA;Namibia;180;2;40631;450
2021-03-12;NA;Namibia;179;6;40810;456
2021-03-13;NA;Namibia;215;2;41025;458
2021-03-14;NA;Namibia;175;0;41200;458
2021-03-15;NA;Namibia;224;7;41424;465
2021-03-16;NA;Namibia;42;9;41466;474
2021-03-17;NA;Namibia;80;3;41546;477
2021-03-18;NA;Namibia;138;6;41684;483
2021-03-19;NA;Namibia;281;3;41965;486
2021-03-20;NA;Namibia;238;6;42203;492
2021-03-21;NA;Namibia;274;0;42477;492
2021-03-22;NA;Namibia;176;2;42653;494
2021-03-23;NA;Namibia;118;4;42771;498
2021-03-24;NA;Namibia;93;4;42864;502
2021-03-25;NA;Namibia;146;0;43010;502
2021-03-26;NA;Namibia;169;2;43179;504
2021-03-27;NA;Namibia;320;4;43499;508
2021-03-28;NA;Namibia;133;1;43632;509
2021-03-29;NA;Namibia;291;4;43923;513
2021-03-30;NA;Namibia;128;7;44051;520
2021-03-31;NA;Namibia;88;3;44139;523
2021-04-01;NA;Namibia;235;5;44374;528
2021-04-02;NA;Namibia;207;3;44581;531
2021-04-03;NA;Namibia;102;2;44683;533
2021-04-04;NA;Namibia;107;4;44790;537
2021-04-05;NA;Namibia;96;1;44886;538
2021-04-06;NA;Namibia;122;4;45008;542
2021-04-07;NA;Namibia;31;6;45039;548
2021-04-08;NA;Namibia;15;9;45054;557
2021-04-09;NA;Namibia;139;2;45193;559
2021-04-10;NA;Namibia;130;5;45323;564
2021-04-11;NA;Namibia;204;6;45527;570
2021-04-12;NA;Namibia;260;5;45787;575
2021-04-13;NA;Namibia;162;11;45949;586
2021-04-14;NA;Namibia;102;6;46051;592
2021-04-15;NA;Namibia;134;4;46185;596
2021-04-16;NA;Namibia;145;3;46330;599
2021-04-17;NA;Namibia;185;3;46515;602
2021-04-18;NA;Namibia;140;2;46655;604
2021-04-19;NA;Namibia;118;0;46773;604
2021-04-20;NA;Namibia;102;4;46875;608
2021-04-21;NA;Namibia;79;1;46954;609
2021-04-22;NA;Namibia;218;7;47172;616
2021-04-23;NA;Namibia;211;6;47383;622
2021-04-24;NA;Namibia;288;2;47671;624
2021-04-25;NA;Namibia;105;1;47776;625
2021-04-26;NA;Namibia;165;3;47941;628
2021-04-27;NA;Namibia;70;6;48011;634
2021-04-28;NA;Namibia;166;4;48177;638
2021-04-29;NA;Namibia;0;0;48177;638
2021-04-30;NA;Namibia;174;4;48351;642
2021-05-01;NA;Namibia;303;1;48654;643
2021-05-02;NA;Namibia;0;0;48654;643
2021-05-03;NA;Namibia;0;0;48654;643
2021-05-04;NA;Namibia;0;0;48654;643
2021-05-05;NA;Namibia;669;24;49323;667
2021-05-06;NA;Namibia;137;7;49460;674
2021-05-07;NA;Namibia;92;8;49552;682
2021-05-08;NA;Namibia;341;1;49893;683
2021-05-09;NA;Namibia;177;6;50070;689
2021-05-10;NA;Namibia;139;2;50209;691
2021-05-11;NA;Namibia;92;5;50301;696
2021-05-12;NA;Namibia;214;6;50515;702
2021-05-13;NA;Namibia;218;2;50733;704
2021-05-14;NA;Namibia;0;0;50733;704
2021-05-15;NA;Namibia;216;1;50949;705
2021-05-16;NA;Namibia;269;13;51218;718
2021-05-17;NA;Namibia;172;5;51390;723
2021-05-18;NA;Namibia;246;10;51636;733
2021-05-19;NA;Namibia;191;6;51827;739
2021-05-20;NA;Namibia;0;0;51827;739
2021-05-21;NA;Namibia;606;20;52433;759
2021-05-22;NA;Namibia;279;4;52712;763
2021-05-23;NA;Namibia;234;2;52946;765
2021-05-24;NA;Namibia;261;9;53207;774
2021-05-25;NA;Namibia;225;5;53432;779
2021-05-26;NA;Namibia;171;10;53603;789
2021-05-27;NA;Namibia;300;6;53903;795
2021-05-28;NA;Namibia;365;12;54268;807
2021-05-29;NA;Namibia;391;11;54659;818
2021-05-30;NA;Namibia;482;6;55141;824
2021-05-31;NA;Namibia;408;6;55549;830
2021-06-01;NA;Namibia;263;24;55812;854
2021-06-02;NA;Namibia;452;11;56264;865
2021-06-03;NA;Namibia;717;12;56981;877
2021-06-04;NA;Namibia;596;22;57577;899
2021-06-05;NA;Namibia;480;6;58057;905
2021-06-06;NA;Namibia;650;7;58707;912
2021-06-07;NA;Namibia;385;8;59092;920
2021-06-08;NA;Namibia;722;16;59814;936
2021-06-09;NA;Namibia;515;14;60329;950
2021-06-10;NA;Namibia;1045;18;61374;968
2021-06-11;NA;Namibia;1432;5;62806;973
2021-06-12;NA;Namibia;1399;20;64205;993
2021-06-13;NA;Namibia;884;2;65089;995
2021-06-14;NA;Namibia;726;13;65815;1008
2021-06-15;NA;Namibia;1206;32;67021;1040
2021-06-16;NA;Namibia;2075;33;69096;1073
2021-06-17;NA;Namibia;1016;34;70112;1107
2021-06-18;NA;Namibia;1649;27;71761;1134
2021-06-19;NA;Namibia;0;0;71761;1134
2021-06-20;NA;Namibia;1403;27;73164;1161
2021-06-21;NA;Namibia;2602;18;75766;1179
2021-06-22;NA;Namibia;0;0;75766;1179
2021-06-23;NA;Namibia;1567;45;77333;1224
2021-06-24;NA;Namibia;1390;55;78723;1279
2021-06-25;NA;Namibia;2547;26;81270;1305
2021-06-26;NA;Namibia;2428;40;83698;1345
2021-06-27;NA;Namibia;1007;55;84705;1400
2021-06-28;NA;Namibia;1944;45;86649;1445
2021-06-29;NA;Namibia;0;0;86649;1445
2021-06-30;NA;Namibia;3268;76;89917;1521
2021-07-01;NA;Namibia;1291;35;91208;1556
2021-04-08;NR;Nauru;0;0;0;0
2021-04-09;NR;Nauru;0;0;0;0
2021-04-10;NR;Nauru;0;0;0;0
2021-04-11;NR;Nauru;0;0;0;0
2021-04-12;NR;Nauru;0;0;0;0
2021-04-13;NR;Nauru;0;0;0;0
2021-04-14;NR;Nauru;0;0;0;0
2021-04-15;NR;Nauru;0;0;0;0
2021-04-16;NR;Nauru;0;0;0;0
2021-04-17;NR;Nauru;0;0;0;0
2021-04-18;NR;Nauru;0;0;0;0
2021-04-19;NR;Nauru;0;0;0;0
2021-04-20;NR;Nauru;0;0;0;0
2021-04-21;NR;Nauru;0;0;0;0
2021-04-22;NR;Nauru;0;0;0;0
2021-04-23;NR;Nauru;0;0;0;0
2021-04-24;NR;Nauru;0;0;0;0
2021-04-25;NR;Nauru;0;0;0;0
2021-04-26;NR;Nauru;0;0;0;0
2021-04-27;NR;Nauru;0;0;0;0
2021-04-28;NR;Nauru;0;0;0;0
2021-04-29;NR;Nauru;0;0;0;0
2021-04-30;NR;Nauru;0;0;0;0
2021-05-01;NR;Nauru;0;0;0;0
2021-05-02;NR;Nauru;0;0;0;0
2021-05-03;NR;Nauru;0;0;0;0
2021-05-04;NR;Nauru;0;0;0;0
2021-05-05;NR;Nauru;0;0;0;0
2021-05-06;NR;Nauru;0;0;0;0
2021-05-07;NR;Nauru;0;0;0;0
2021-05-08;NR;Nauru;0;0;0;0
2021-05-09;NR;Nauru;0;0;0;0
2021-05-10;NR;Nauru;0;0;0;0
2021-05-11;NR;Nauru;0;0;0;0
2021-05-12;NR;Nauru;0;0;0;0
2021-05-13;NR;Nauru;0;0;0;0
2021-05-14;NR;Nauru;0;0;0;0
2021-05-15;NR;Nauru;0;0;0;0
2021-05-16;NR;Nauru;0;0;0;0
2021-05-17;NR;Nauru;0;0;0;0
2021-05-18;NR;Nauru;0;0;0;0
2021-05-19;NR;Nauru;0;0;0;0
2021-05-20;NR;Nauru;0;0;0;0
2021-05-21;NR;Nauru;0;0;0;0
2021-05-22;NR;Nauru;0;0;0;0
2021-05-23;NR;Nauru;0;0;0;0
2021-05-24;NR;Nauru;0;0;0;0
2021-05-25;NR;Nauru;0;0;0;0
2021-05-26;NR;Nauru;0;0;0;0
2021-05-27;NR;Nauru;0;0;0;0
2021-05-28;NR;Nauru;0;0;0;0
2021-05-29;NR;Nauru;0;0;0;0
2021-05-30;NR;Nauru;0;0;0;0
2021-05-31;NR;Nauru;0;0;0;0
2021-06-01;NR;Nauru;0;0;0;0
2021-06-02;NR;Nauru;0;0;0;0
2021-06-03;NR;Nauru;0;0;0;0
2021-06-04;NR;Nauru;0;0;0;0
2021-06-05;NR;Nauru;0;0;0;0
2021-06-06;NR;Nauru;0;0;0;0
2021-06-07;NR;Nauru;0;0;0;0
2021-06-08;NR;Nauru;0;0;0;0
2021-06-09;NR;Nauru;0;0;0;0
2021-06-10;NR;Nauru;0;0;0;0
2021-06-11;NR;Nauru;0;0;0;0
2021-06-12;NR;Nauru;0;0;0;0
2021-06-13;NR;Nauru;0;0;0;0
2021-06-14;NR;Nauru;0;0;0;0
2021-06-15;NR;Nauru;0;0;0;0
2021-06-16;NR;Nauru;0;0;0;0
2021-06-17;NR;Nauru;0;0;0;0
2021-06-18;NR;Nauru;0;0;0;0
2021-06-19;NR;Nauru;0;0;0;0
2021-06-20;NR;Nauru;0;0;0;0
2021-06-21;NR;Nauru;0;0;0;0
2021-06-22;NR;Nauru;0;0;0;0
2021-06-23;NR;Nauru;0;0;0;0
2021-06-24;NR;Nauru;0;0;0;0
2021-06-25;NR;Nauru;0;0;0;0
2021-06-26;NR;Nauru;0;0;0;0
2021-06-27;NR;Nauru;0;0;0;0
2021-06-28;NR;Nauru;0;0;0;0
2021-06-29;NR;Nauru;0;0;0;0
2020-01-25;NP;Nepal;1;0;1;0
2020-01-26;NP;Nepal;0;0;1;0
2020-01-27;NP;Nepal;0;0;1;0
2020-01-28;NP;Nepal;0;0;1;0
2020-01-29;NP;Nepal;0;0;1;0
2020-01-30;NP;Nepal;0;0;1;0
2020-01-31;NP;Nepal;0;0;1;0
2020-02-01;NP;Nepal;0;0;1;0
2020-02-02;NP;Nepal;0;0;1;0
2020-02-03;NP;Nepal;0;0;1;0
2020-02-04;NP;Nepal;0;0;1;0
2020-02-05;NP;Nepal;0;0;1;0
2020-02-06;NP;Nepal;0;0;1;0
2020-02-07;NP;Nepal;0;0;1;0
2020-02-08;NP;Nepal;0;0;1;0
2020-02-09;NP;Nepal;0;0;1;0
2020-02-10;NP;Nepal;0;0;1;0
2020-02-11;NP;Nepal;0;0;1;0
2020-02-12;NP;Nepal;0;0;1;0
2020-02-13;NP;Nepal;0;0;1;0
2020-02-14;NP;Nepal;0;0;1;0
2020-02-15;NP;Nepal;0;0;1;0
2020-02-16;NP;Nepal;0;0;1;0
2020-02-17;NP;Nepal;0;0;1;0
2020-02-18;NP;Nepal;0;0;1;0
2020-02-19;NP;Nepal;0;0;1;0
2020-02-20;NP;Nepal;0;0;1;0
2020-02-21;NP;Nepal;0;0;1;0
2020-02-22;NP;Nepal;0;0;1;0
2020-02-23;NP;Nepal;0;0;1;0
2020-02-24;NP;Nepal;0;0;1;0
2020-02-25;NP;Nepal;0;0;1;0
2020-02-26;NP;Nepal;0;0;1;0
2020-02-27;NP;Nepal;0;0;1;0
2020-02-28;NP;Nepal;0;0;1;0
2020-02-29;NP;Nepal;0;0;1;0
2020-03-01;NP;Nepal;0;0;1;0
2020-03-02;NP;Nepal;0;0;1;0
2020-03-03;NP;Nepal;0;0;1;0
2020-03-04;NP;Nepal;0;0;1;0
2020-03-05;NP;Nepal;0;0;1;0
2020-03-06;NP;Nepal;0;0;1;0
2020-03-07;NP;Nepal;0;0;1;0
2020-03-08;NP;Nepal;0;0;1;0
2020-03-09;NP;Nepal;0;0;1;0
2020-03-10;NP;Nepal;0;0;1;0
2020-03-11;NP;Nepal;0;0;1;0
2020-03-12;NP;Nepal;0;0;1;0
2020-03-13;NP;Nepal;0;0;1;0
2020-03-14;NP;Nepal;0;0;1;0
2020-03-15;NP;Nepal;0;0;1;0
2020-03-16;NP;Nepal;0;0;1;0
2020-03-17;NP;Nepal;0;0;1;0
2020-03-18;NP;Nepal;0;0;1;0
2020-03-19;NP;Nepal;0;0;1;0
2020-03-20;NP;Nepal;0;0;1;0
2020-03-21;NP;Nepal;0;0;1;0
2020-03-22;NP;Nepal;0;0;1;0
2020-03-23;NP;Nepal;1;0;2;0
2020-03-24;NP;Nepal;0;0;2;0
2020-03-25;NP;Nepal;1;0;3;0
2020-03-26;NP;Nepal;0;0;3;0
2020-03-27;NP;Nepal;1;0;4;0
2020-03-28;NP;Nepal;1;0;5;0
2020-03-29;NP;Nepal;0;0;5;0
2020-03-30;NP;Nepal;0;0;5;0
2020-03-31;NP;Nepal;0;0;5;0
2020-04-01;NP;Nepal;0;0;5;0
2020-04-02;NP;Nepal;1;0;6;0
2020-04-03;NP;Nepal;0;0;6;0
2020-04-04;NP;Nepal;3;0;9;0
2020-04-05;NP;Nepal;0;0;9;0
2020-04-06;NP;Nepal;0;0;9;0
2020-04-07;NP;Nepal;0;0;9;0
2020-04-08;NP;Nepal;0;0;9;0
2020-04-09;NP;Nepal;0;0;9;0
2020-04-10;NP;Nepal;0;0;9;0
2020-04-11;NP;Nepal;0;0;9;0
2020-04-12;NP;Nepal;3;0;12;0
2020-04-13;NP;Nepal;2;0;14;0
2020-04-14;NP;Nepal;2;0;16;0
2020-04-15;NP;Nepal;0;0;16;0
2020-04-16;NP;Nepal;0;0;16;0
2020-04-17;NP;Nepal;14;0;30;0
2020-04-18;NP;Nepal;1;0;31;0
2020-04-19;NP;Nepal;0;0;31;0
2020-04-20;NP;Nepal;0;0;31;0
2020-04-21;NP;Nepal;12;0;43;0
2020-04-22;NP;Nepal;2;0;45;0
2020-04-23;NP;Nepal;3;0;48;0
2020-04-24;NP;Nepal;1;0;49;0
2020-04-25;NP;Nepal;0;0;49;0
2020-04-26;NP;Nepal;3;0;52;0
2020-04-27;NP;Nepal;0;0;52;0
2020-04-28;NP;Nepal;2;0;54;0
2020-04-29;NP;Nepal;3;0;57;0
2020-04-30;NP;Nepal;0;0;57;0
2020-05-01;NP;Nepal;2;0;59;0
2020-05-02;NP;Nepal;0;0;59;0
2020-05-03;NP;Nepal;16;0;75;0
2020-05-04;NP;Nepal;0;0;75;0
2020-05-05;NP;Nepal;7;0;82;0
2020-05-06;NP;Nepal;17;0;99;0
2020-05-07;NP;Nepal;2;0;101;0
2020-05-08;NP;Nepal;1;0;102;0
2020-05-09;NP;Nepal;8;0;110;0
2020-05-10;NP;Nepal;0;0;110;0
2020-05-11;NP;Nepal;24;0;134;0
2020-05-12;NP;Nepal;83;0;217;0
2020-05-13;NP;Nepal;33;0;250;0
2020-05-14;NP;Nepal;-1;0;249;0
2020-05-15;NP;Nepal;18;0;267;0
2020-05-16;NP;Nepal;24;1;291;1
2020-05-17;NP;Nepal;4;1;295;2
2020-05-18;NP;Nepal;80;0;375;2
2020-05-19;NP;Nepal;27;0;402;2
2020-05-20;NP;Nepal;25;0;427;2
2020-05-21;NP;Nepal;30;1;457;3
2020-05-22;NP;Nepal;59;0;516;3
2020-05-23;NP;Nepal;68;0;584;3
2020-05-24;NP;Nepal;19;0;603;3
2020-05-25;NP;Nepal;79;1;682;4
2020-05-26;NP;Nepal;90;0;772;4
2020-05-27;NP;Nepal;114;0;886;4
2020-05-28;NP;Nepal;156;1;1042;5
2020-05-29;NP;Nepal;170;1;1212;6
2020-05-30;NP;Nepal;189;0;1401;6
2020-05-31;NP;Nepal;171;2;1572;8
2020-06-01;NP;Nepal;239;0;1811;8
2020-06-02;NP;Nepal;288;0;2099;8
2020-06-03;NP;Nepal;201;1;2300;9
2020-06-04;NP;Nepal;334;1;2634;10
2020-06-05;NP;Nepal;278;1;2912;11
2020-06-06;NP;Nepal;323;2;3235;13
2020-06-07;NP;Nepal;213;0;3448;13
2020-06-08;NP;Nepal;314;1;3762;14
2020-06-09;NP;Nepal;324;1;4086;15
2020-06-10;NP;Nepal;278;0;4364;15
2020-06-11;NP;Nepal;250;0;4614;15
2020-06-12;NP;Nepal;448;1;5062;16
2020-06-13;NP;Nepal;273;2;5335;18
2020-06-14;NP;Nepal;425;1;5760;19
2020-06-15;NP;Nepal;451;0;6211;19
2020-06-16;NP;Nepal;380;0;6591;19
2020-06-17;NP;Nepal;586;1;7177;20
2020-06-18;NP;Nepal;671;2;7848;22
2020-06-19;NP;Nepal;426;0;8274;22
2020-06-20;NP;Nepal;331;0;8605;22
2020-06-21;NP;Nepal;421;1;9026;23
2020-06-22;NP;Nepal;535;0;9561;23
2020-06-23;NP;Nepal;538;1;10099;24
2020-06-24;NP;Nepal;629;0;10728;24
2020-06-25;NP;Nepal;434;2;11162;26
2020-06-26;NP;Nepal;593;1;11755;27
2020-06-27;NP;Nepal;554;1;12309;28
2020-06-28;NP;Nepal;463;0;12772;28
2020-06-29;NP;Nepal;476;1;13248;29
2020-06-30;NP;Nepal;316;0;13564;29
2020-07-01;NP;Nepal;482;1;14046;30
2020-07-02;NP;Nepal;473;1;14519;31
2020-07-03;NP;Nepal;740;1;15259;32
2020-07-04;NP;Nepal;232;2;15491;34
2020-07-05;NP;Nepal;293;0;15784;34
2020-07-06;NP;Nepal;180;1;15964;35
2020-07-07;NP;Nepal;204;0;16168;35
2020-07-08;NP;Nepal;255;0;16423;35
2020-07-09;NP;Nepal;108;0;16531;35
2020-07-10;NP;Nepal;118;0;16649;35
2020-07-11;NP;Nepal;70;3;16719;38
2020-07-12;NP;Nepal;82;0;16801;38
2020-07-13;NP;Nepal;144;0;16945;38
2020-07-14;NP;Nepal;116;0;17061;38
2020-07-15;NP;Nepal;116;1;17177;39
2020-07-16;NP;Nepal;167;0;17344;39
2020-07-17;NP;Nepal;101;1;17445;40
2020-07-18;NP;Nepal;57;0;17502;40
2020-07-19;NP;Nepal;156;0;17658;40
2020-07-20;NP;Nepal;186;0;17844;40
2020-07-21;NP;Nepal;150;0;17994;40
2020-07-22;NP;Nepal;100;2;18094;42
2020-07-23;NP;Nepal;147;1;18241;43
2020-07-24;NP;Nepal;133;1;18374;44
2020-07-25;NP;Nepal;109;1;18483;45
2020-07-26;NP;Nepal;130;0;18613;45
2020-07-27;NP;Nepal;139;3;18752;48
2020-07-28;NP;Nepal;311;1;19063;49
2020-07-29;NP;Nepal;210;0;19273;49
2020-07-30;NP;Nepal;274;3;19547;52
2020-07-31;NP;Nepal;224;4;19771;56
2020-08-01;NP;Nepal;315;0;20086;56
2020-08-02;NP;Nepal;246;1;20332;57
2020-08-03;NP;Nepal;418;0;20750;57
2020-08-04;NP;Nepal;259;1;21009;58
2020-08-05;NP;Nepal;381;2;21390;60
2020-08-06;NP;Nepal;360;5;21750;65
2020-08-07;NP;Nepal;464;5;22214;70
2020-08-08;NP;Nepal;378;3;22592;73
2020-08-09;NP;Nepal;380;2;22972;75
2020-08-10;NP;Nepal;338;4;23310;79
2020-08-11;NP;Nepal;638;4;23948;83
2020-08-12;NP;Nepal;484;8;24432;91
2020-08-13;NP;Nepal;525;4;24957;95
2020-08-14;NP;Nepal;594;4;25551;99
2020-08-15;NP;Nepal;468;3;26019;102
2020-08-16;NP;Nepal;641;2;26660;104
2020-08-17;NP;Nepal;581;3;27241;107
2020-08-18;NP;Nepal;1016;7;28257;114
2020-08-19;NP;Nepal;681;6;28938;120
2020-08-20;NP;Nepal;707;6;29645;126
2020-08-21;NP;Nepal;838;11;30483;137
2020-08-22;NP;Nepal;634;9;31117;146
2020-08-23;NP;Nepal;818;3;31935;149
2020-08-24;NP;Nepal;743;8;32678;157
2020-08-25;NP;Nepal;855;7;33533;164
2020-08-26;NP;Nepal;885;11;34418;175
2020-08-27;NP;Nepal;1111;8;35529;183
2020-08-28;NP;Nepal;927;12;36456;195
2020-08-29;NP;Nepal;884;12;37340;207
2020-08-30;NP;Nepal;1221;14;38561;221
2020-08-31;NP;Nepal;899;7;39460;228
2020-09-01;NP;Nepal;1069;11;40529;239
2020-09-02;NP;Nepal;1120;12;41649;251
2020-09-03;NP;Nepal;1228;6;42877;257
2020-09-04;NP;Nepal;1359;14;44236;271
2020-09-05;NP;Nepal;1041;9;45277;280
2020-09-06;NP;Nepal;980;9;46257;289
2020-09-07;NP;Nepal;979;11;47236;300
2020-09-08;NP;Nepal;902;6;48138;306
2020-09-09;NP;Nepal;1081;6;49219;312
2020-09-10;NP;Nepal;1246;5;50465;317
2020-09-11;NP;Nepal;1454;5;51919;322
2020-09-12;NP;Nepal;1201;14;53120;336
2020-09-13;NP;Nepal;1039;9;54159;345
2020-09-14;NP;Nepal;1170;15;55329;360
2020-09-15;NP;Nepal;1459;11;56788;371
2020-09-16;NP;Nepal;1539;8;58327;379
2020-09-17;NP;Nepal;1246;4;59573;383
2020-09-18;NP;Nepal;2020;7;61593;390
2020-09-19;NP;Nepal;1204;11;62797;401
2020-09-20;NP;Nepal;1325;10;64122;411
2020-09-21;NP;Nepal;1154;16;65276;427
2020-09-22;NP;Nepal;1356;2;66632;429
2020-09-23;NP;Nepal;1172;7;67804;436
2020-09-24;NP;Nepal;1497;17;69301;453
2020-09-25;NP;Nepal;1313;6;70614;459
2020-09-26;NP;Nepal;1207;8;71821;467
2020-09-27;NP;Nepal;1573;10;73394;477
2020-09-28;NP;Nepal;1351;4;74745;481
2020-09-29;NP;Nepal;1513;10;76258;491
2020-09-30;NP;Nepal;1559;7;77817;498
2020-10-01;NP;Nepal;1911;11;79728;509
2020-10-02;NP;Nepal;2722;11;82450;520
2020-10-03;NP;Nepal;2120;8;84570;528
2020-10-04;NP;Nepal;2253;7;86823;535
2020-10-05;NP;Nepal;2440;19;89263;554
2020-10-06;NP;Nepal;1551;9;90814;563
2020-10-07;NP;Nepal;3439;15;94253;578
2020-10-08;NP;Nepal;4364;12;98617;590
2020-10-09;NP;Nepal;2059;10;100676;600
2020-10-10;NP;Nepal;5008;14;105684;614
2020-10-11;NP;Nepal;2071;22;107755;636
2020-10-12;NP;Nepal;4047;9;111802;645
2020-10-13;NP;Nepal;3556;18;115358;663
2020-10-14;NP;Nepal;2638;12;117996;675
2020-10-15;NP;Nepal;3749;19;121745;694
2020-10-16;NP;Nepal;4392;21;126137;715
2020-10-17;NP;Nepal;3167;12;129304;727
2020-10-18;NP;Nepal;2942;12;132246;739
2020-10-19;NP;Nepal;3790;18;136036;757
2020-10-20;NP;Nepal;3093;8;139129;765
2020-10-21;NP;Nepal;5743;26;144872;791
2020-10-22;NP;Nepal;3637;21;148509;812
2020-10-23;NP;Nepal;4499;17;153008;829
2020-10-24;NP;Nepal;2225;13;155233;842
2020-10-25;NP;Nepal;2856;5;158089;847
2020-10-26;NP;Nepal;1741;15;159830;862
2020-10-27;NP;Nepal;570;14;160400;876
2020-10-28;NP;Nepal;1954;11;162354;887
2020-10-29;NP;Nepal;2364;17;164718;904
2020-10-30;NP;Nepal;3517;16;168235;920
2020-10-31;NP;Nepal;2508;17;170743;937
2020-11-01;NP;Nepal;2824;23;173567;960
2020-11-02;NP;Nepal;2933;24;176500;984
2020-11-03;NP;Nepal;3114;20;179614;1004
2020-11-04;NP;Nepal;3309;30;182923;1034
2020-11-05;NP;Nepal;3051;18;185974;1052
2020-11-06;NP;Nepal;2909;18;188883;1070
2020-11-07;NP;Nepal;2753;17;191636;1087
2020-11-08;NP;Nepal;2817;21;194453;1108
2020-11-09;NP;Nepal;2571;18;197024;1126
2020-11-10;NP;Nepal;2736;22;199760;1148
2020-11-11;NP;Nepal;2569;26;202329;1174
2020-11-12;NP;Nepal;1913;15;204242;1189
2020-11-13;NP;Nepal;2111;13;206353;1202
2020-11-14;NP;Nepal;1946;13;208299;1215
2020-11-15;NP;Nepal;1477;6;209776;1221
2020-11-16;NP;Nepal;1197;9;210973;1230
2020-11-17;NP;Nepal;502;17;211475;1247
2020-11-18;NP;Nepal;1442;12;212917;1259
2020-11-19;NP;Nepal;2103;17;215020;1276
2020-11-20;NP;Nepal;1945;22;216965;1298
2020-11-21;NP;Nepal;1674;7;218639;1305
2020-11-22;NP;Nepal;1669;16;220308;1321
2020-11-23;NP;Nepal;1980;16;222288;1337
2020-11-24;NP;Nepal;1790;24;224078;1361
2020-11-25;NP;Nepal;1948;28;226026;1389
2020-11-26;NP;Nepal;1614;23;227640;1412
2020-11-27;NP;Nepal;1703;23;229343;1435
2020-11-28;NP;Nepal;1380;19;230723;1454
2020-11-29;NP;Nepal;1255;25;231978;1479
2020-11-30;NP;Nepal;1474;29;233452;1508
2020-12-01;NP;Nepal;0;21;233452;1529
2020-12-02;NP;Nepal;2794;9;236246;1538
2020-12-03;NP;Nepal;1343;13;237589;1551
2020-12-04;NP;Nepal;1272;16;238861;1567
2020-12-05;NP;Nepal;1024;10;239885;1577
2020-12-06;NP;Nepal;1096;17;240981;1594
2020-12-07;NP;Nepal;1014;20;241995;1614
2020-12-08;NP;Nepal;1382;23;243377;1637
2020-12-09;NP;Nepal;1056;14;244433;1651
2020-12-10;NP;Nepal;1217;12;245650;1663
2020-12-11;NP;Nepal;1044;11;246694;1674
2020-12-12;NP;Nepal;899;15;247593;1689
2020-12-13;NP;Nepal;830;9;248423;1698
2020-12-14;NP;Nepal;821;18;249244;1716
2020-12-15;NP;Nepal;936;14;250180;1730
2020-12-16;NP;Nepal;736;13;250916;1743
2020-12-17;NP;Nepal;776;6;251692;1749
2020-12-18;NP;Nepal;782;16;252474;1765
2020-12-19;NP;Nepal;710;12;253184;1777
2020-12-20;NP;Nepal;588;11;253772;1788
2020-12-21;NP;Nepal;742;7;254514;1795
2020-12-22;NP;Nepal;722;3;255236;1798
2020-12-23;NP;Nepal;743;5;255979;1803
2020-12-24;NP;Nepal;613;5;256592;1808
2020-12-25;NP;Nepal;608;8;257200;1816
2020-12-26;NP;Nepal;500;3;257700;1819
2020-12-27;NP;Nepal;481;6;258181;1825
2020-12-28;NP;Nepal;659;7;258840;1832
2020-12-29;NP;Nepal;708;8;259548;1840
2020-12-30;NP;Nepal;511;7;260059;1847
2020-12-31;NP;Nepal;534;9;260593;1856
2021-01-01;NP;Nepal;426;8;261019;1864
2021-01-02;NP;Nepal;419;6;261438;1870
2021-01-03;NP;Nepal;421;8;261859;1878
2021-01-04;NP;Nepal;403;7;262262;1885
2021-01-05;NP;Nepal;522;8;262784;1893
2021-01-06;NP;Nepal;409;6;263193;1899
2021-01-07;NP;Nepal;412;4;263605;1903
2021-01-08;NP;Nepal;554;6;264159;1909
2021-01-09;NP;Nepal;362;3;264521;1912
2021-01-10;NP;Nepal;259;5;264780;1917
2021-01-11;NP;Nepal;488;10;265268;1927
2021-01-12;NP;Nepal;430;5;265698;1932
2021-01-13;NP;Nepal;445;5;266143;1937
2021-01-14;NP;Nepal;403;6;266546;1943
2021-01-15;NP;Nepal;270;5;266816;1948
2021-01-16;NP;Nepal;240;6;267056;1954
2021-01-17;NP;Nepal;266;5;267322;1959
2021-01-18;NP;Nepal;322;6;267644;1965
2021-01-19;NP;Nepal;348;4;267992;1969
2021-01-20;NP;Nepal;318;6;268310;1975
2021-01-21;NP;Nepal;336;4;268646;1979
2021-01-22;NP;Nepal;302;7;268948;1986
2021-01-23;NP;Nepal;232;8;269180;1994
2021-01-24;NP;Nepal;270;7;269450;2001
2021-01-25;NP;Nepal;339;10;269789;2011
2021-01-26;NP;Nepal;303;6;270092;2017
2021-01-27;NP;Nepal;283;3;270375;2020
2021-01-28;NP;Nepal;213;0;270588;2020
2021-01-29;NP;Nepal;157;5;270745;2025
2021-01-30;NP;Nepal;109;2;270854;2027
2021-01-31;NP;Nepal;105;2;270959;2029
2021-02-01;NP;Nepal;159;0;271118;2029
2021-02-02;NP;Nepal;171;1;271289;2030
2021-02-03;NP;Nepal;142;1;271431;2031
2021-02-04;NP;Nepal;171;2;271602;2033
2021-02-05;NP;Nepal;105;2;271707;2035
2021-02-06;NP;Nepal;99;0;271806;2035
2021-02-07;NP;Nepal;119;3;271925;2038
2021-02-08;NP;Nepal;130;7;272055;2045
2021-02-09;NP;Nepal;160;2;272215;2047
2021-02-10;NP;Nepal;134;0;272349;2047
2021-02-11;NP;Nepal;81;5;272430;2052
2021-02-12;NP;Nepal;127;2;272557;2054
2021-02-13;NP;Nepal;57;0;272614;2054
2021-02-14;NP;Nepal;104;0;272718;2054
2021-02-15;NP;Nepal;122;1;272840;2055
2021-02-16;NP;Nepal;105;0;272945;2055
2021-02-17;NP;Nepal;125;0;273070;2055
2021-02-18;NP;Nepal;96;3;273166;2058
2021-02-19;NP;Nepal;97;3;273263;2061
2021-02-20;NP;Nepal;88;0;273351;2061
2021-02-21;NP;Nepal;80;0;273431;2061
2021-02-22;NP;Nepal;125;0;273556;2061
2021-02-23;NP;Nepal;110;4;273666;2065
2021-02-24;NP;Nepal;94;619;273760;2684
2021-02-25;NP;Nepal;112;1;273872;2685
2021-02-26;NP;Nepal;112;86;273984;2771
2021-02-27;NP;Nepal;81;2;274065;2773
2021-02-28;NP;Nepal;78;1;274143;2774
2021-03-01;NP;Nepal;73;3;274216;2777
2021-03-02;NP;Nepal;78;0;274294;2777
2021-03-03;NP;Nepal;87;1;274381;2778
2021-03-04;NP;Nepal;107;0;274488;2778
2021-03-05;NP;Nepal;120;232;274608;3010
2021-03-06;NP;Nepal;47;0;274655;3010
2021-03-07;NP;Nepal;66;0;274721;3010
2021-03-08;NP;Nepal;89;1;274810;3011
2021-03-09;NP;Nepal;59;1;274869;3012
2021-03-10;NP;Nepal;104;0;274973;3012
2021-03-11;NP;Nepal;97;0;275070;3012
2021-03-12;NP;Nepal;48;0;275118;3012
2021-03-13;NP;Nepal;60;2;275178;3014
2021-03-14;NP;Nepal;53;0;275231;3014
2021-03-15;NP;Nepal;79;0;275310;3014
2021-03-16;NP;Nepal;114;0;275424;3014
2021-03-17;NP;Nepal;94;0;275518;3014
2021-03-18;NP;Nepal;107;1;275625;3015
2021-03-19;NP;Nepal;125;1;275750;3016
2021-03-20;NP;Nepal;79;0;275829;3016
2021-03-21;NP;Nepal;77;0;275906;3016
2021-03-22;NP;Nepal;150;3;276056;3019
2021-03-23;NP;Nepal;188;0;276244;3019
2021-03-24;NP;Nepal;145;1;276389;3020
2021-03-25;NP;Nepal;120;0;276509;3020
2021-03-26;NP;Nepal;156;4;276665;3024
2021-03-27;NP;Nepal;85;3;276750;3027
2021-03-28;NP;Nepal;89;0;276839;3027
2021-03-29;NP;Nepal;141;0;276980;3027
2021-03-30;NP;Nepal;167;3;277147;3030
2021-03-31;NP;Nepal;162;0;277309;3030
2021-04-01;NP;Nepal;152;1;277461;3031
2021-04-02;NP;Nepal;179;0;277640;3031
2021-04-03;NP;Nepal;128;1;277768;3032
2021-04-04;NP;Nepal;176;0;277944;3032
2021-04-05;NP;Nepal;266;4;278210;3036
2021-04-06;NP;Nepal;260;0;278470;3036
2021-04-07;NP;Nepal;298;2;278768;3038
2021-04-08;NP;Nepal;332;0;279100;3038
2021-04-09;NP;Nepal;288;0;279388;3038
2021-04-10;NP;Nepal;337;1;279725;3039
2021-04-11;NP;Nepal;303;1;280028;3040
2021-04-12;NP;Nepal;496;13;280524;3053
2021-04-13;NP;Nepal;460;5;280984;3058
2021-04-14;NP;Nepal;580;3;281564;3061
2021-04-15;NP;Nepal;490;5;282054;3066
2021-04-16;NP;Nepal;836;4;282890;3070
2021-04-17;NP;Nepal;768;5;283658;3075
2021-04-18;NP;Nepal;1015;8;284673;3083
2021-04-19;NP;Nepal;1227;8;285900;3091
2021-04-20;NP;Nepal;1667;11;287567;3102
2021-04-21;NP;Nepal;2220;10;289787;3112
2021-04-22;NP;Nepal;2365;5;292152;3117
2021-04-23;NP;Nepal;2449;5;294601;3122
2021-04-24;NP;Nepal;2486;14;297087;3136
2021-04-25;NP;Nepal;3032;28;300119;3164
2021-04-26;NP;Nepal;3442;12;303561;3176
2021-04-27;NP;Nepal;4364;18;307925;3194
2021-04-28;NP;Nepal;4774;17;312699;3211
2021-04-29;NP;Nepal;4831;35;317530;3246
2021-04-30;NP;Nepal;5657;33;323187;3279
2021-05-01;NP;Nepal;5706;19;328893;3298
2021-05-02;NP;Nepal;7137;27;336030;3325
2021-05-03;NP;Nepal;7388;37;343418;3362
2021-05-04;NP;Nepal;7587;55;351005;3417
2021-05-05;NP;Nepal;8605;58;359610;3475
2021-05-06;NP;Nepal;8970;54;368580;3529
2021-05-07;NP;Nepal;9023;50;377603;3579
2021-05-08;NP;Nepal;8287;53;385890;3632
2021-05-09;NP;Nepal;8777;88;394667;3720
2021-05-10;NP;Nepal;9127;139;403794;3859
2021-05-11;NP;Nepal;9317;225;413111;4084
2021-05-12;NP;Nepal;9238;168;422349;4252
2021-05-13;NP;Nepal;8842;214;431191;4466
2021-05-14;NP;Nepal;8467;203;439658;4669
2021-05-15;NP;Nepal;8046;187;447704;4856
2021-05-16;NP;Nepal;7316;145;455020;5001
2021-05-17;NP;Nepal;9198;214;464218;5215
2021-05-18;NP;Nepal;8136;196;472354;5411
2021-05-19;NP;Nepal;8064;246;480418;5657
2021-05-20;NP;Nepal;8227;190;488645;5847
2021-05-21;NP;Nepal;8407;177;497052;6024
2021-05-22;NP;Nepal;8591;129;505643;6153
2021-05-23;NP;Nepal;7598;193;513241;6346
2021-05-24;NP;Nepal;7220;185;520461;6531
2021-05-25;NP;Nepal;8387;169;528848;6700
2021-05-26;NP;Nepal;6677;145;535525;6845
2021-05-27;NP;Nepal;6731;106;542256;6951
2021-05-28;NP;Nepal;6855;96;549111;7047
2021-05-29;NP;Nepal;4311;116;553422;7163
2021-05-30;NP;Nepal;3702;109;557124;7272
2021-05-31;NP;Nepal;4178;114;561302;7386
2021-06-01;NP;Nepal;5285;68;566587;7454
2021-06-02;NP;Nepal;4524;101;571111;7555
2021-06-03;NP;Nepal;5825;75;576936;7630
2021-06-04;NP;Nepal;4624;101;581560;7731
2021-06-05;NP;Nepal;3540;68;585100;7799
2021-06-06;NP;Nepal;3024;99;588124;7898
2021-06-07;NP;Nepal;3370;92;591494;7990
2021-06-08;NP;Nepal;3870;108;595364;8098
2021-06-09;NP;Nepal;3449;81;598813;8179
2021-06-10;NP;Nepal;2874;59;601687;8238
2021-06-11;NP;Nepal;2709;67;604396;8305
2021-06-12;NP;Nepal;2382;61;606778;8366
2021-06-13;NP;Nepal;1694;46;608472;8412
2021-06-14;NP;Nepal;2049;53;610521;8465
2021-06-15;NP;Nepal;1681;41;612202;8506
2021-06-16;NP;Nepal;2014;52;614216;8558
2021-06-17;NP;Nepal;1768;39;615984;8597
2021-06-18;NP;Nepal;1963;44;617947;8641
2021-06-19;NP;Nepal;1688;34;619635;8675
2021-06-20;NP;Nepal;1421;51;621056;8726
2021-06-21;NP;Nepal;1584;46;622640;8772
2021-06-22;NP;Nepal;3703;41;626343;8813
2021-06-23;NP;Nepal;1511;81;627854;8894
2021-06-24;NP;Nepal;1577;24;629431;8918
2021-06-25;NP;Nepal;1721;27;631152;8945
2021-06-26;NP;Nepal;1174;30;632326;8975
2021-06-27;NP;Nepal;1353;34;633679;9009
2021-06-28;NP;Nepal;1509;42;635188;9051
2021-06-29;NP;Nepal;1728;20;636916;9071
2021-06-30;NP;Nepal;1889;41;638805;9112
2021-07-01;NP;Nepal;1857;33;640662;9145
2020-02-27;NL;Netherlands;1;0;1;0
2020-02-28;NL;Netherlands;0;0;1;0
2020-02-29;NL;Netherlands;5;0;6;0
2020-03-01;NL;Netherlands;4;0;10;0
2020-03-02;NL;Netherlands;8;0;18;0
2020-03-03;NL;Netherlands;6;0;24;0
2020-03-04;NL;Netherlands;14;0;38;0
2020-03-05;NL;Netherlands;44;0;82;0
2020-03-06;NL;Netherlands;46;1;128;1
2020-03-07;NL;Netherlands;60;0;188;1
2020-03-08;NL;Netherlands;77;2;265;3
2020-03-09;NL;Netherlands;56;0;321;3
2020-03-10;NL;Netherlands;61;1;382;4
2020-03-11;NL;Netherlands;121;1;503;5
2020-03-12;NL;Netherlands;0;0;503;5
2020-03-13;NL;Netherlands;303;5;806;10
2020-03-14;NL;Netherlands;156;2;962;12
2020-03-15;NL;Netherlands;176;8;1138;20
2020-03-16;NL;Netherlands;278;4;1416;24
2020-03-17;NL;Netherlands;295;19;1711;43
2020-03-18;NL;Netherlands;347;15;2058;58
2020-03-19;NL;Netherlands;409;19;2467;77
2020-03-20;NL;Netherlands;536;30;3003;107
2020-03-21;NL;Netherlands;637;30;3640;137
2020-03-22;NL;Netherlands;577;43;4217;180
2020-03-23;NL;Netherlands;547;34;4764;214
2020-03-24;NL;Netherlands;816;63;5580;277
2020-03-25;NL;Netherlands;858;80;6438;357
2020-03-26;NL;Netherlands;1030;78;7468;435
2020-03-27;NL;Netherlands;1179;112;8647;547
2020-03-28;NL;Netherlands;1172;93;9819;640
2020-03-29;NL;Netherlands;1111;132;10930;772
2020-03-30;NL;Netherlands;887;93;11817;865
2020-03-31;NL;Netherlands;850;175;12667;1040
2020-04-01;NL;Netherlands;1029;135;13696;1175
2020-04-02;NL;Netherlands;1092;166;14788;1341
2020-04-03;NL;Netherlands;1033;149;15821;1490
2020-04-04;NL;Netherlands;906;166;16727;1656
2020-04-05;NL;Netherlands;1226;115;17953;1771
2020-04-06;NL;Netherlands;973;103;18926;1874
2020-04-07;NL;Netherlands;783;234;19709;2108
2020-04-08;NL;Netherlands;973;147;20682;2255
2020-04-09;NL;Netherlands;1221;148;21903;2403
2020-04-10;NL;Netherlands;1346;117;23249;2520
2020-04-11;NL;Netherlands;1322;133;24571;2653
2020-04-12;NL;Netherlands;1175;94;25746;2747
2020-04-13;NL;Netherlands;964;86;26710;2833
2020-04-14;NL;Netherlands;870;122;27580;2955
2020-04-15;NL;Netherlands;736;190;28316;3145
2020-04-16;NL;Netherlands;1067;182;29383;3327
2020-04-17;NL;Netherlands;1236;144;30619;3471
2020-04-18;NL;Netherlands;1147;142;31766;3613
2020-04-19;NL;Netherlands;1072;84;32838;3697
2020-04-20;NL;Netherlands;750;67;33588;3764
2020-04-21;NL;Netherlands;729;165;34317;3929
2020-04-22;NL;Netherlands;715;139;35032;4068
2020-04-23;NL;Netherlands;889;124;35921;4192
2020-04-24;NL;Netherlands;808;112;36729;4304
2020-04-25;NL;Netherlands;655;120;37384;4424
2020-04-26;NL;Netherlands;656;67;38040;4491
2020-04-27;NL;Netherlands;400;43;38440;4534
2020-04-28;NL;Netherlands;172;48;38612;4582
2020-04-29;NL;Netherlands;386;145;38998;4727
2020-04-30;NL;Netherlands;514;84;39512;4811
2020-05-01;NL;Netherlands;477;98;39989;4909
2020-05-02;NL;Netherlands;445;94;40434;5003
2020-05-03;NL;Netherlands;335;69;40769;5072
2020-05-04;NL;Netherlands;199;26;40968;5098
2020-05-05;NL;Netherlands;318;87;41286;5185
2020-05-06;NL;Netherlands;232;36;41518;5221
2020-05-07;NL;Netherlands;455;85;41973;5306
2020-05-08;NL;Netherlands;319;71;42292;5377
2020-05-09;NL;Netherlands;289;64;42581;5441
2020-05-10;NL;Netherlands;245;18;42826;5459
2020-05-11;NL;Netherlands;161;16;42987;5475
2020-05-12;NL;Netherlands;196;54;43183;5529
2020-05-13;NL;Netherlands;227;52;43410;5581
2020-05-14;NL;Netherlands;270;28;43680;5609
2020-05-15;NL;Netherlands;200;53;43880;5662
2020-05-16;NL;Netherlands;190;27;44070;5689
2020-05-17;NL;Netherlands;125;10;44195;5699
2020-05-18;NL;Netherlands;146;14;44341;5713
2020-05-19;NL;Netherlands;108;21;44449;5734
2020-05-20;NL;Netherlands;198;33;44647;5767
2020-05-21;NL;Netherlands;253;27;44900;5794
2020-05-22;NL;Netherlands;188;13;45088;5807
2020-05-23;NL;Netherlands;177;23;45265;5830
2020-05-24;NL;Netherlands;172;11;45437;5841
2020-05-25;NL;Netherlands;210;8;45647;5849
2020-05-26;NL;Netherlands;133;26;45780;5875
2020-05-27;NL;Netherlands;190;15;45970;5890
2020-05-28;NL;Netherlands;182;32;46152;5922
2020-05-29;NL;Netherlands;176;28;46328;5950
2020-05-30;NL;Netherlands;132;20;46460;5970
2020-05-31;NL;Netherlands;185;5;46645;5975
2020-06-01;NL;Netherlands;104;6;46749;5981
2020-06-02;NL;Netherlands;103;5;46852;5986
2020-06-03;NL;Netherlands;87;10;46939;5996
2020-06-04;NL;Netherlands;209;13;47148;6009
2020-06-05;NL;Netherlands;210;15;47358;6024
2020-06-06;NL;Netherlands;183;6;47541;6030
2020-06-07;NL;Netherlands;239;2;47780;6032
2020-06-08;NL;Netherlands;165;3;47945;6035
2020-06-09;NL;Netherlands;164;15;48109;6050
2020-06-10;NL;Netherlands;185;11;48294;6061
2020-06-11;NL;Netherlands;164;2;48458;6063
2020-06-12;NL;Netherlands;210;9;48668;6072
2020-06-13;NL;Netherlands;179;4;48847;6076
2020-06-14;NL;Netherlands;143;2;48990;6078
2020-06-15;NL;Netherlands;165;6;49155;6084
2020-06-16;NL;Netherlands;140;5;49295;6089
2020-06-17;NL;Netherlands;117;4;49412;6093
2020-06-18;NL;Netherlands;115;4;49527;6097
2020-06-19;NL;Netherlands;107;3;49634;6100
2020-06-20;NL;Netherlands;76;8;49710;6108
2020-06-21;NL;Netherlands;91;1;49801;6109
2020-06-22;NL;Netherlands;65;0;49866;6109
2020-06-23;NL;Netherlands;64;5;49930;6114
2020-06-24;NL;Netherlands;82;2;50012;6116
2020-06-25;NL;Netherlands;110;3;50122;6119
2020-06-26;NL;Netherlands;91;3;50213;6122
2020-06-27;NL;Netherlands;69;2;50282;6124
2020-06-28;NL;Netherlands;73;0;50355;6124
2020-06-29;NL;Netherlands;78;2;50433;6126
2020-06-30;NL;Netherlands;50;6;50483;6132
2020-07-01;NL;Netherlands;62;2;50545;6134
2020-07-02;NL;Netherlands;78;3;50623;6137
2020-07-03;NL;Netherlands;75;2;50698;6139
2020-07-04;NL;Netherlands;63;6;50761;6145
2020-07-05;NL;Netherlands;73;1;50834;6146
2020-07-06;NL;Netherlands;36;1;50870;6147
2020-07-07;NL;Netherlands;37;4;50907;6151
2020-07-08;NL;Netherlands;52;3;50959;6154
2020-07-09;NL;Netherlands;54;2;51013;6156
2020-07-10;NL;Netherlands;42;-1;51055;6155
2020-07-11;NL;Netherlands;81;1;51136;6156
2020-07-12;NL;Netherlands;101;0;51237;6156
2020-07-13;NL;Netherlands;71;0;51308;6156
2020-07-14;NL;Netherlands;54;-2;51362;6154
2020-07-15;NL;Netherlands;109;1;51471;6155
2020-07-16;NL;Netherlands;101;1;51572;6156
2020-07-17;NL;Netherlands;110;1;51682;6157
2020-07-18;NL;Netherlands;127;-2;51809;6155
2020-07-19;NL;Netherlands;146;0;51955;6155
2020-07-20;NL;Netherlands;187;0;52142;6155
2020-07-21;NL;Netherlands;165;0;52307;6155
2020-07-22;NL;Netherlands;168;3;52475;6158
2020-07-23;NL;Netherlands;165;0;52640;6158
2020-07-24;NL;Netherlands;197;0;52837;6158
2020-07-25;NL;Netherlands;147;1;52984;6159
2020-07-26;NL;Netherlands;294;19;53278;6178
2020-07-27;NL;Netherlands;146;-18;53424;6160
2020-07-28;NL;Netherlands;223;4;53647;6164
2020-07-29;NL;Netherlands;248;2;53895;6166
2020-07-30;NL;Netherlands;354;0;54249;6166
2020-07-31;NL;Netherlands;341;0;54590;6166
2020-08-01;NL;Netherlands;431;1;55021;6167
2020-08-02;NL;Netherlands;387;2;55408;6169
2020-08-03;NL;Netherlands;378;0;55786;6169
2020-08-04;NL;Netherlands;493;1;56279;6170
2020-08-05;NL;Netherlands;471;3;56750;6173
2020-08-06;NL;Netherlands;715;0;57465;6173
2020-08-07;NL;Netherlands;652;1;58117;6174
2020-08-08;NL;Netherlands;600;4;58717;6178
2020-08-09;NL;Netherlands;643;0;59360;6178
2020-08-10;NL;Netherlands;698;0;60058;6178
2020-08-11;NL;Netherlands;333;-16;60391;6162
2020-08-12;NL;Netherlands;1327;20;61718;6182
2020-08-13;NL;Netherlands;688;5;62406;6187
2020-08-14;NL;Netherlands;721;2;63127;6189
2020-08-15;NL;Netherlands;762;2;63889;6191
2020-08-16;NL;Netherlands;579;3;64468;6194
2020-08-17;NL;Netherlands;512;0;64980;6194
2020-08-18;NL;Netherlands;580;3;65560;6197
2020-08-19;NL;Netherlands;658;7;66218;6204
2020-08-20;NL;Netherlands;625;11;66843;6215
2020-08-21;NL;Netherlands;613;4;67456;6219
2020-08-22;NL;Netherlands;595;6;68051;6225
2020-08-23;NL;Netherlands;519;0;68570;6225
2020-08-24;NL;Netherlands;654;2;69224;6227
2020-08-25;NL;Netherlands;459;6;69683;6233
2020-08-26;NL;Netherlands;699;8;70382;6241
2020-08-27;NL;Netherlands;602;3;70984;6244
2020-08-28;NL;Netherlands;573;3;71557;6247
2020-08-29;NL;Netherlands;571;5;72128;6252
2020-08-30;NL;Netherlands;551;0;72679;6252
2020-08-31;NL;Netherlands;553;0;73232;6252
2020-09-01;NL;Netherlands;570;8;73802;6260
2020-09-02;NL;Netherlands;858;7;74660;6267
2020-09-03;NL;Netherlands;696;1;75356;6268
2020-09-04;NL;Netherlands;817;2;76173;6270
2020-09-05;NL;Netherlands;734;5;76907;6275
2020-09-06;NL;Netherlands;950;2;77857;6277
2020-09-07;NL;Netherlands;845;1;78702;6278
2020-09-08;NL;Netherlands;1090;1;79792;6279
2020-09-09;NL;Netherlands;1293;2;81085;6281
2020-09-10;NL;Netherlands;931;4;82016;6285
2020-09-11;NL;Netherlands;1354;5;83370;6290
2020-09-12;NL;Netherlands;1339;1;84709;6291
2020-09-13;NL;Netherlands;1167;1;85876;6292
2020-09-14;NL;Netherlands;1318;4;87194;6296
2020-09-15;NL;Netherlands;1479;4;88673;6300
2020-09-16;NL;Netherlands;1752;3;90425;6303
2020-09-17;NL;Netherlands;1837;7;92262;6310
2020-09-18;NL;Netherlands;2083;8;94345;6318
2020-09-19;NL;Netherlands;1916;2;96261;6320
2020-09-20;NL;Netherlands;1956;4;98217;6324
2020-09-21;NL;Netherlands;2274;3;100491;6327
2020-09-22;NL;Netherlands;2353;11;102844;6338
2020-09-23;NL;Netherlands;2460;6;105304;6344
2020-09-24;NL;Netherlands;2595;17;107899;6361
2020-09-25;NL;Netherlands;2859;16;110758;6377
2020-09-26;NL;Netherlands;2760;38;113518;6415
2020-09-27;NL;Netherlands;3041;8;116559;6423
2020-09-28;NL;Netherlands;2950;6;119509;6429
2020-09-29;NL;Netherlands;3111;14;122620;6443
2020-09-30;NL;Netherlands;3368;14;125988;6457
2020-10-01;NL;Netherlands;3295;13;129283;6470
2020-10-02;NL;Netherlands;3883;12;133166;6482
2020-10-03;NL;Netherlands;4028;21;137194;6503
2020-10-04;NL;Netherlands;4032;5;141226;6508
2020-10-05;NL;Netherlands;4611;1;145837;6509
2020-10-06;NL;Netherlands;4576;29;150413;6538
2020-10-07;NL;Netherlands;5052;36;155465;6574
2020-10-08;NL;Netherlands;5867;13;161332;6587
2020-10-09;NL;Netherlands;6016;14;167348;6601
2020-10-10;NL;Netherlands;6546;23;173894;6624
2020-10-11;NL;Netherlands;6394;18;180288;6642
2020-10-12;NL;Netherlands;6850;12;187138;6654
2020-10-13;NL;Netherlands;7453;35;194591;6689
2020-10-14;NL;Netherlands;7351;31;201942;6720
2020-10-15;NL;Netherlands;7857;29;209799;6749
2020-10-16;NL;Netherlands;8022;16;217821;6765
2020-10-17;NL;Netherlands;8149;32;225970;6797
2020-10-18;NL;Netherlands;8233;14;234203;6811
2020-10-19;NL;Netherlands;8014;17;242217;6828
2020-10-20;NL;Netherlands;8194;46;250411;6874
2020-10-21;NL;Netherlands;8796;60;259207;6934
2020-10-22;NL;Netherlands;9310;47;268517;6981
2020-10-23;NL;Netherlands;10029;45;278546;7026
2020-10-24;NL;Netherlands;8683;55;287229;7081
2020-10-25;NL;Netherlands;10237;27;297466;7108
2020-10-26;NL;Netherlands;10365;26;307831;7134
2020-10-27;NL;Netherlands;10321;70;318152;7204
2020-10-28;NL;Netherlands;8156;61;326308;7265
2020-10-29;NL;Netherlands;10321;56;336629;7321
2020-10-30;NL;Netherlands;11172;87;347801;7408
2020-10-31;NL;Netherlands;9839;51;357640;7459
2020-11-01;NL;Netherlands;8711;39;366351;7498
2020-11-02;NL;Netherlands;8312;29;374663;7527
2020-11-03;NL;Netherlands;7777;113;382440;7640
2020-11-04;NL;Netherlands;7680;108;390120;7748
2020-11-05;NL;Netherlands;6992;88;397112;7836
2020-11-06;NL;Netherlands;7280;118;404392;7954
2020-11-07;NL;Netherlands;6715;74;411107;8028
2020-11-08;NL;Netherlands;5699;44;416806;8072
2020-11-09;NL;Netherlands;4697;40;421503;8112
2020-11-10;NL;Netherlands;4724;99;426227;8211
2020-11-11;NL;Netherlands;5469;75;431696;8286
2020-11-12;NL;Netherlands;5680;89;437376;8375
2020-11-13;NL;Netherlands;6157;55;443533;8430
2020-11-14;NL;Netherlands;5968;86;449501;8516
2020-11-15;NL;Netherlands;5460;43;454961;8559
2020-11-16;NL;Netherlands;4876;44;459837;8603
2020-11-17;NL;Netherlands;4368;86;464205;8689
2020-11-18;NL;Netherlands;4695;83;468900;8772
2020-11-19;NL;Netherlands;5741;74;474641;8846
2020-11-20;NL;Netherlands;6008;52;480649;8898
2020-11-21;NL;Netherlands;6171;48;486820;8946
2020-11-22;NL;Netherlands;5473;21;492293;8967
2020-11-23;NL;Netherlands;5208;54;497501;9021
2020-11-24;NL;Netherlands;4002;90;501503;9111
2020-11-25;NL;Netherlands;5054;74;506557;9185
2020-11-26;NL;Netherlands;4605;75;511162;9260
2020-11-27;NL;Netherlands;5883;83;517045;9343
2020-11-28;NL;Netherlands;4594;60;521639;9403
2020-11-29;NL;Netherlands;5697;23;527336;9426
2020-11-30;NL;Netherlands;4594;27;531930;9453
2020-12-01;NL;Netherlands;4199;65;536129;9518
2020-12-02;NL;Netherlands;5109;66;541238;9584
2020-12-03;NL;Netherlands;5744;61;546982;9645
2020-12-04;NL;Netherlands;6058;59;553040;9704
2020-12-05;NL;Netherlands;6676;39;559716;9743
2020-12-06;NL;Netherlands;6912;25;566628;9768
2020-12-07;NL;Netherlands;7122;18;573750;9786
2020-12-08;NL;Netherlands;6247;71;579997;9857
2020-12-09;NL;Netherlands;6646;66;586643;9923
2020-12-10;NL;Netherlands;8830;62;595473;9985
2020-12-11;NL;Netherlands;8979;66;604452;10051
2020-12-12;NL;Netherlands;9178;53;613630;10104
2020-12-13;NL;Netherlands;9937;30;623567;10134
2020-12-14;NL;Netherlands;8518;34;632085;10168
2020-12-15;NL;Netherlands;6716;86;638801;10254
2020-12-16;NL;Netherlands;11271;79;650072;10333
2020-12-17;NL;Netherlands;12871;75;662943;10408
2020-12-18;NL;Netherlands;12024;84;674967;10492
2020-12-19;NL;Netherlands;12283;54;687250;10546
2020-12-20;NL;Netherlands;13072;32;700322;10578
2020-12-21;NL;Netherlands;11218;28;711540;10606
2020-12-22;NL;Netherlands;9889;114;721429;10720
2020-12-23;NL;Netherlands;10473;105;731902;10825
2020-12-24;NL;Netherlands;11591;89;743493;10914
2020-12-25;NL;Netherlands;11545;101;755038;11015
2020-12-26;NL;Netherlands;9869;47;764907;11062
2020-12-27;NL;Netherlands;9102;28;774009;11090
2020-12-28;NL;Netherlands;7458;45;781467;11135
2020-12-29;NL;Netherlands;7592;170;789059;11305
2020-12-30;NL;Netherlands;9533;112;798592;11417
2020-12-31;NL;Netherlands;9790;108;808382;11525
2021-01-01;NL;Netherlands;8234;99;816616;11624
2021-01-02;NL;Netherlands;8633;36;825249;11660
2021-01-03;NL;Netherlands;7453;47;832702;11707
2021-01-04;NL;Netherlands;6614;63;839316;11770
2021-01-05;NL;Netherlands;6506;152;845822;11922
2021-01-06;NL;Netherlands;7238;174;853060;12096
2021-01-07;NL;Netherlands;9745;86;862805;12182
2021-01-08;NL;Netherlands;8258;87;871063;12269
2021-01-09;NL;Netherlands;7380;137;878443;12406
2021-01-10;NL;Netherlands;6655;55;885098;12461
2021-01-11;NL;Netherlands;5468;51;890566;12512
2021-01-12;NL;Netherlands;4977;152;895543;12664
2021-01-13;NL;Netherlands;6197;122;901740;12786
2021-01-14;NL;Netherlands;6566;89;908306;12875
2021-01-15;NL;Netherlands;6082;94;914388;12969
2021-01-16;NL;Netherlands;5324;97;919712;13066
2021-01-17;NL;Netherlands;5643;41;925355;13107
2021-01-18;NL;Netherlands;4792;50;930147;13157
2021-01-19;NL;Netherlands;4356;107;934503;13264
2021-01-20;NL;Netherlands;5603;86;940106;13350
2021-01-21;NL;Netherlands;5842;89;945948;13439
2021-01-22;NL;Netherlands;5799;89;951747;13528
2021-01-23;NL;Netherlands;5466;88;957213;13616
2021-01-24;NL;Netherlands;4940;30;962153;13646
2021-01-25;NL;Netherlands;4041;40;966194;13686
2021-01-26;NL;Netherlands;3962;86;970156;13772
2021-01-27;NL;Netherlands;4816;69;974972;13841
2021-01-28;NL;Netherlands;4730;84;979702;13925
2021-01-29;NL;Netherlands;4418;56;984120;13981
2021-01-30;NL;Netherlands;4230;88;988350;14069
2021-01-31;NL;Netherlands;3725;39;992075;14108
2021-02-01;NL;Netherlands;3225;27;995300;14135
2021-02-02;NL;Netherlands;3624;83;998924;14218
2021-02-03;NL;Netherlands;4086;63;1003010;14281
2021-02-04;NL;Netherlands;4258;65;1007268;14346
2021-02-05;NL;Netherlands;4368;61;1011636;14407
2021-02-06;NL;Netherlands;4121;61;1015757;14468
2021-02-07;NL;Netherlands;3963;48;1019720;14516
2021-02-08;NL;Netherlands;2246;27;1021966;14543
2021-02-09;NL;Netherlands;1813;86;1023779;14629
2021-02-10;NL;Netherlands;3244;81;1027023;14710
2021-02-11;NL;Netherlands;4431;72;1031454;14782
2021-02-12;NL;Netherlands;4387;65;1035841;14847
2021-02-13;NL;Netherlands;4229;66;1040070;14913
2021-02-14;NL;Netherlands;3471;23;1043541;14936
2021-02-15;NL;Netherlands;2840;27;1046381;14963
2021-02-16;NL;Netherlands;2739;87;1049120;15050
2021-02-17;NL;Netherlands;3424;88;1052544;15138
2021-02-18;NL;Netherlands;4572;73;1057116;15211
2021-02-19;NL;Netherlands;4787;50;1061903;15261
2021-02-20;NL;Netherlands;4619;62;1066522;15323
2021-02-21;NL;Netherlands;4701;17;1071223;15340
2021-02-22;NL;Netherlands;4202;32;1075425;15372
2021-02-23;NL;Netherlands;3847;94;1079272;15466
2021-02-24;NL;Netherlands;4414;63;1083686;15529
2021-02-25;NL;Netherlands;5044;32;1088730;15561
2021-02-26;NL;Netherlands;5169;65;1093899;15626
2021-02-27;NL;Netherlands;4976;42;1098875;15668
2021-02-28;NL;Netherlands;4689;20;1103564;15688
2021-03-01;NL;Netherlands;3783;22;1107347;15710
2021-03-02;NL;Netherlands;4017;65;1111364;15775
2021-03-03;NL;Netherlands;5040;49;1116404;15824
2021-03-04;NL;Netherlands;4162;33;1120566;15857
2021-03-05;NL;Netherlands;4733;33;1125299;15890
2021-03-06;NL;Netherlands;5395;41;1130694;15931
2021-03-07;NL;Netherlands;4564;31;1135258;15962
2021-03-08;NL;Netherlands;3844;28;1139102;15990
2021-03-09;NL;Netherlands;4379;56;1143481;16046
2021-03-10;NL;Netherlands;5355;31;1148836;16077
2021-03-11;NL;Netherlands;5421;50;1154257;16127
2021-03-12;NL;Netherlands;6123;26;1160380;16153
2021-03-13;NL;Netherlands;6543;23;1166923;16176
2021-03-14;NL;Netherlands;6052;24;1172975;16200
2021-03-15;NL;Netherlands;5526;18;1178501;16218
2021-03-16;NL;Netherlands;5066;33;1183567;16251
2021-03-17;NL;Netherlands;6140;47;1189707;16298
2021-03-18;NL;Netherlands;6338;34;1196045;16332
2021-03-19;NL;Netherlands;7577;47;1203622;16379
2021-03-20;NL;Netherlands;7825;16;1211447;16395
2021-03-21;NL;Netherlands;7163;16;1218610;16411
2021-03-22;NL;Netherlands;6337;15;1224947;16426
2021-03-23;NL;Netherlands;5799;49;1230746;16475
2021-03-24;NL;Netherlands;7918;35;1238664;16510
2021-03-25;NL;Netherlands;8018;26;1246682;16536
2021-03-26;NL;Netherlands;8040;25;1254722;16561
2021-03-27;NL;Netherlands;9160;31;1263882;16592
2021-03-28;NL;Netherlands;7698;15;1271580;16607
2021-03-29;NL;Netherlands;6939;13;1278519;16620
2021-03-30;NL;Netherlands;6066;37;1284585;16657
2021-03-31;NL;Netherlands;8221;32;1292806;16689
2021-04-01;NL;Netherlands;8321;24;1301127;16713
2021-04-02;NL;Netherlands;7647;20;1308774;16733
2021-04-03;NL;Netherlands;8139;33;1316913;16766
2021-04-04;NL;Netherlands;7108;24;1324021;16790
2021-04-05;NL;Netherlands;5539;11;1329560;16801
2021-04-06;NL;Netherlands;5752;25;1335312;16826
2021-04-07;NL;Netherlands;6430;24;1341742;16850
2021-04-08;NL;Netherlands;8292;23;1350034;16873
2021-04-09;NL;Netherlands;7982;42;1358016;16915
2021-04-10;NL;Netherlands;8008;24;1366024;16939
2021-04-11;NL;Netherlands;8427;20;1374451;16959
2021-04-12;NL;Netherlands;6731;22;1381182;16981
2021-04-13;NL;Netherlands;6779;37;1387961;17018
2021-04-14;NL;Netherlands;5582;30;1393543;17048
2021-04-15;NL;Netherlands;8890;15;1402433;17063
2021-04-16;NL;Netherlands;9041;17;1411474;17080
2021-04-17;NL;Netherlands;8397;34;1419871;17114
2021-04-18;NL;Netherlands;8569;13;1428440;17127
2021-04-19;NL;Netherlands;7161;23;1435601;17150
2021-04-20;NL;Netherlands;6880;29;1442481;17179
2021-04-21;NL;Netherlands;8590;23;1451071;17202
2021-04-22;NL;Netherlands;9682;24;1460753;17226
2021-04-23;NL;Netherlands;9284;19;1470037;17245
2021-04-24;NL;Netherlands;8107;24;1478144;17269
2021-04-25;NL;Netherlands;8061;12;1486205;17281
2021-04-26;NL;Netherlands;6232;14;1492437;17295
2021-04-27;NL;Netherlands;5369;33;1497806;17328
2021-04-28;NL;Netherlands;8670;11;1506476;17339
2021-04-29;NL;Netherlands;8689;33;1515165;17372
2021-04-30;NL;Netherlands;7808;26;1522973;17398
2021-05-01;NL;Netherlands;5780;23;1528753;17421
2021-05-02;NL;Netherlands;5511;4;1534264;17425
2021-05-03;NL;Netherlands;9230;18;1543494;17443
2021-05-04;NL;Netherlands;7754;32;1551248;17475
2021-05-05;NL;Netherlands;7301;26;1558549;17501
2021-05-06;NL;Netherlands;6803;24;1565352;17525
2021-05-07;NL;Netherlands;7509;22;1572861;17547
2021-05-08;NL;Netherlands;7439;31;1580300;17578
2021-05-09;NL;Netherlands;6568;4;1586868;17582
2021-05-10;NL;Netherlands;5874;20;1592742;17602
2021-05-11;NL;Netherlands;5538;46;1598280;17648
2021-05-12;NL;Netherlands;6379;16;1604659;17664
2021-05-13;NL;Netherlands;6040;15;1610699;17679
2021-05-14;NL;Netherlands;5535;11;1616234;17690
2021-05-15;NL;Netherlands;4468;13;1620702;17703
2021-05-16;NL;Netherlands;4449;14;1625151;17717
2021-05-17;NL;Netherlands;2846;8;1627997;17725
2021-05-18;NL;Netherlands;5359;17;1633356;17742
2021-05-19;NL;Netherlands;4584;16;1637940;17758
2021-05-20;NL;Netherlands;4670;20;1642610;17778
2021-05-21;NL;Netherlands;4171;12;1646781;17790
2021-05-22;NL;Netherlands;3179;20;1649960;17810
2021-05-23;NL;Netherlands;3435;7;1653395;17817
2021-05-24;NL;Netherlands;2695;10;1656090;17827
2021-05-25;NL;Netherlands;2497;13;1658587;17840
2021-05-26;NL;Netherlands;2777;10;1661364;17850
2021-05-27;NL;Netherlands;3344;16;1664708;17866
2021-05-28;NL;Netherlands;3873;15;1668581;17881
2021-05-29;NL;Netherlands;3386;8;1671967;17889
2021-05-30;NL;Netherlands;2727;6;1674694;17895
2021-05-31;NL;Netherlands;2050;2;1676744;17897
2021-06-01;NL;Netherlands;2349;9;1679093;17906
2021-06-02;NL;Netherlands;2516;12;1681609;17918
2021-06-03;NL;Netherlands;2765;14;1684374;17932
2021-06-04;NL;Netherlands;2404;8;1686778;17940
2021-06-05;NL;Netherlands;2147;10;1688925;17950
2021-06-06;NL;Netherlands;1556;4;1690481;17954
2021-06-07;NL;Netherlands;1385;3;1691866;17957
2021-06-08;NL;Netherlands;1436;15;1693302;17972
2021-06-09;NL;Netherlands;1732;5;1695034;17977
2021-06-10;NL;Netherlands;1575;6;1696609;17983
2021-06-11;NL;Netherlands;1390;3;1697999;17986
2021-06-12;NL;Netherlands;1214;1;1699213;17987
2021-06-13;NL;Netherlands;1047;2;1700260;17989
2021-06-14;NL;Netherlands;864;4;1701124;17993
2021-06-15;NL;Netherlands;1050;1;1702174;17994
2021-06-16;NL;Netherlands;1044;4;1703218;17998
2021-06-17;NL;Netherlands;1087;3;1704305;18001
2021-06-18;NL;Netherlands;901;3;1705206;18004
2021-06-19;NL;Netherlands;699;3;1705905;18007
2021-06-20;NL;Netherlands;706;0;1706611;18007
2021-06-21;NL;Netherlands;570;1;1707181;18008
2021-06-22;NL;Netherlands;700;3;1707881;18011
2021-06-23;NL;Netherlands;658;4;1708539;18015
2021-06-24;NL;Netherlands;722;3;1709261;18018
2021-06-25;NL;Netherlands;650;5;1709911;18023
2021-06-26;NL;Netherlands;563;0;1710474;18023
2021-06-27;NL;Netherlands;499;1;1710973;18024
2021-06-28;NL;Netherlands;572;0;1711545;18024
2021-06-29;NL;Netherlands;555;4;1712100;18028
2021-06-30;NL;Netherlands;647;0;1712747;18028
2021-07-01;NL;Netherlands;829;3;1713576;18031
2021-02-02;NC;New Caledonia;0;0;0;0
2021-02-03;NC;New Caledonia;0;0;0;0
2021-02-04;NC;New Caledonia;0;0;0;0
2021-02-05;NC;New Caledonia;0;0;0;0
2021-02-06;NC;New Caledonia;0;0;0;0
2021-02-07;NC;New Caledonia;0;0;0;0
2021-02-08;NC;New Caledonia;0;0;0;0
2021-02-09;NC;New Caledonia;0;0;0;0
2021-02-10;NC;New Caledonia;0;0;0;0
2021-02-11;NC;New Caledonia;0;0;0;0
2021-02-12;NC;New Caledonia;0;0;0;0
2021-02-13;NC;New Caledonia;0;0;0;0
2021-02-14;NC;New Caledonia;0;0;0;0
2021-02-15;NC;New Caledonia;0;0;0;0
2021-02-16;NC;New Caledonia;0;0;0;0
2021-02-17;NC;New Caledonia;0;0;0;0
2021-02-18;NC;New Caledonia;0;0;0;0
2021-02-19;NC;New Caledonia;0;0;0;0
2021-02-20;NC;New Caledonia;0;0;0;0
2021-02-21;NC;New Caledonia;0;0;0;0
2021-02-22;NC;New Caledonia;0;0;0;0
2021-02-23;NC;New Caledonia;0;0;0;0
2021-02-24;NC;New Caledonia;0;0;0;0
2021-02-25;NC;New Caledonia;0;0;0;0
2021-02-26;NC;New Caledonia;0;0;0;0
2021-02-27;NC;New Caledonia;0;0;0;0
2021-02-28;NC;New Caledonia;0;0;0;0
2021-03-01;NC;New Caledonia;0;0;0;0
2021-03-02;NC;New Caledonia;0;0;0;0
2021-03-03;NC;New Caledonia;0;0;0;0
2021-03-04;NC;New Caledonia;0;0;0;0
2021-03-05;NC;New Caledonia;0;0;0;0
2021-03-06;NC;New Caledonia;0;0;0;0
2021-03-07;NC;New Caledonia;0;0;0;0
2021-03-08;NC;New Caledonia;0;0;0;0
2021-03-09;NC;New Caledonia;0;0;0;0
2021-03-10;NC;New Caledonia;0;0;0;0
2021-03-11;NC;New Caledonia;0;0;0;0
2021-03-12;NC;New Caledonia;0;0;0;0
2021-03-13;NC;New Caledonia;0;0;0;0
2021-03-14;NC;New Caledonia;0;0;0;0
2021-03-15;NC;New Caledonia;0;0;0;0
2021-03-16;NC;New Caledonia;0;0;0;0
2021-03-17;NC;New Caledonia;0;0;0;0
2021-03-18;NC;New Caledonia;0;0;0;0
2021-03-19;NC;New Caledonia;0;0;0;0
2021-03-20;NC;New Caledonia;0;0;0;0
2021-03-21;NC;New Caledonia;0;0;0;0
2021-03-22;NC;New Caledonia;0;0;0;0
2021-03-23;NC;New Caledonia;0;0;0;0
2021-03-24;NC;New Caledonia;0;0;0;0
2021-03-25;NC;New Caledonia;0;0;0;0
2021-03-26;NC;New Caledonia;0;0;0;0
2021-03-27;NC;New Caledonia;0;0;0;0
2021-03-28;NC;New Caledonia;0;0;0;0
2021-03-29;NC;New Caledonia;0;0;0;0
2021-03-30;NC;New Caledonia;0;0;0;0
2021-03-31;NC;New Caledonia;0;0;0;0
2021-04-01;NC;New Caledonia;0;0;0;0
2021-04-02;NC;New Caledonia;0;0;0;0
2021-04-03;NC;New Caledonia;0;0;0;0
2021-04-04;NC;New Caledonia;0;0;0;0
2021-04-05;NC;New Caledonia;0;0;0;0
2021-04-06;NC;New Caledonia;0;0;0;0
2021-04-07;NC;New Caledonia;0;0;0;0
2021-04-08;NC;New Caledonia;0;0;0;0
2021-04-09;NC;New Caledonia;0;0;0;0
2021-04-10;NC;New Caledonia;0;0;0;0
2021-04-11;NC;New Caledonia;0;0;0;0
2021-04-12;NC;New Caledonia;0;0;0;0
2021-04-13;NC;New Caledonia;0;0;0;0
2021-04-14;NC;New Caledonia;0;0;0;0
2021-04-15;NC;New Caledonia;0;0;0;0
2021-04-16;NC;New Caledonia;0;0;0;0
2021-04-17;NC;New Caledonia;0;0;0;0
2021-04-18;NC;New Caledonia;0;0;0;0
2021-04-19;NC;New Caledonia;0;0;0;0
2021-04-20;NC;New Caledonia;0;0;0;0
2021-04-21;NC;New Caledonia;0;0;0;0
2021-04-22;NC;New Caledonia;0;0;0;0
2021-04-23;NC;New Caledonia;0;0;0;0
2021-04-24;NC;New Caledonia;0;0;0;0
2021-04-25;NC;New Caledonia;0;0;0;0
2021-04-26;NC;New Caledonia;0;0;0;0
2021-04-27;NC;New Caledonia;0;0;0;0
2021-04-28;NC;New Caledonia;0;0;0;0
2021-04-29;NC;New Caledonia;0;0;0;0
2021-04-30;NC;New Caledonia;0;0;0;0
2021-05-01;NC;New Caledonia;0;0;0;0
2021-05-02;NC;New Caledonia;0;0;0;0
2021-05-03;NC;New Caledonia;0;0;0;0
2021-05-04;NC;New Caledonia;0;0;0;0
2021-05-05;NC;New Caledonia;0;0;0;0
2021-05-06;NC;New Caledonia;0;0;0;0
2021-05-07;NC;New Caledonia;0;0;0;0
2021-05-08;NC;New Caledonia;0;0;0;0
2021-05-09;NC;New Caledonia;0;0;0;0
2021-05-10;NC;New Caledonia;0;0;0;0
2021-05-11;NC;New Caledonia;0;0;0;0
2021-05-12;NC;New Caledonia;0;0;0;0
2021-05-13;NC;New Caledonia;0;0;0;0
2021-05-14;NC;New Caledonia;0;0;0;0
2021-05-15;NC;New Caledonia;0;0;0;0
2021-05-16;NC;New Caledonia;0;0;0;0
2021-05-17;NC;New Caledonia;0;0;0;0
2021-05-18;NC;New Caledonia;0;0;0;0
2021-05-19;NC;New Caledonia;0;0;0;0
2021-05-20;NC;New Caledonia;0;0;0;0
2021-05-21;NC;New Caledonia;0;0;0;0
2021-05-22;NC;New Caledonia;0;0;0;0
2021-05-23;NC;New Caledonia;0;0;0;0
2021-05-24;NC;New Caledonia;0;0;0;0
2021-05-25;NC;New Caledonia;0;0;0;0
2021-05-26;NC;New Caledonia;0;0;0;0
2021-05-27;NC;New Caledonia;0;0;0;0
2021-05-28;NC;New Caledonia;0;0;0;0
2021-05-29;NC;New Caledonia;0;0;0;0
2021-05-30;NC;New Caledonia;0;0;0;0
2021-05-31;NC;New Caledonia;0;0;0;0
2021-06-01;NC;New Caledonia;0;0;0;0
2021-06-02;NC;New Caledonia;0;0;0;0
2021-06-03;NC;New Caledonia;0;0;0;0
2021-06-04;NC;New Caledonia;0;0;0;0
2021-06-05;NC;New Caledonia;0;0;0;0
2021-06-06;NC;New Caledonia;0;0;0;0
2021-06-07;NC;New Caledonia;0;0;0;0
2021-06-08;NC;New Caledonia;0;0;0;0
2021-06-09;NC;New Caledonia;0;0;0;0
2021-06-10;NC;New Caledonia;0;0;0;0
2021-06-11;NC;New Caledonia;0;0;0;0
2021-06-12;NC;New Caledonia;0;0;0;0
2021-06-13;NC;New Caledonia;0;0;0;0
2021-06-14;NC;New Caledonia;0;0;0;0
2021-06-15;NC;New Caledonia;0;0;0;0
2021-06-16;NC;New Caledonia;0;0;0;0
2021-06-17;NC;New Caledonia;0;0;0;0
2021-06-18;NC;New Caledonia;0;0;0;0
2021-06-19;NC;New Caledonia;0;0;0;0
2021-06-20;NC;New Caledonia;0;0;0;0
2021-06-21;NC;New Caledonia;0;0;0;0
2021-06-22;NC;New Caledonia;0;0;0;0
2021-06-23;NC;New Caledonia;0;0;0;0
2021-06-24;NC;New Caledonia;0;0;0;0
2021-06-25;NC;New Caledonia;0;0;0;0
2021-06-26;NC;New Caledonia;0;0;0;0
2021-06-27;NC;New Caledonia;0;0;0;0
2021-06-28;NC;New Caledonia;0;0;0;0
2021-06-29;NC;New Caledonia;0;0;0;0
2020-02-28;NZ;New Zealand;1;0;1;0
2020-02-29;NZ;New Zealand;0;0;1;0
2020-03-01;NZ;New Zealand;0;0;1;0
2020-03-02;NZ;New Zealand;0;0;1;0
2020-03-03;NZ;New Zealand;0;0;1;0
2020-03-04;NZ;New Zealand;2;0;3;0
2020-03-05;NZ;New Zealand;0;0;3;0
2020-03-06;NZ;New Zealand;1;0;4;0
2020-03-07;NZ;New Zealand;1;0;5;0
2020-03-08;NZ;New Zealand;0;0;5;0
2020-03-09;NZ;New Zealand;0;0;5;0
2020-03-10;NZ;New Zealand;0;0;5;0
2020-03-11;NZ;New Zealand;0;0;5;0
2020-03-12;NZ;New Zealand;0;0;5;0
2020-03-13;NZ;New Zealand;0;0;5;0
2020-03-14;NZ;New Zealand;1;0;6;0
2020-03-15;NZ;New Zealand;2;0;8;0
2020-03-16;NZ;New Zealand;0;0;8;0
2020-03-17;NZ;New Zealand;4;0;12;0
2020-03-18;NZ;New Zealand;8;0;20;0
2020-03-19;NZ;New Zealand;8;0;28;0
2020-03-20;NZ;New Zealand;11;0;39;0
2020-03-21;NZ;New Zealand;13;0;52;0
2020-03-22;NZ;New Zealand;50;0;102;0
2020-03-23;NZ;New Zealand;0;0;102;0
2020-03-24;NZ;New Zealand;53;0;155;0
2020-03-25;NZ;New Zealand;50;0;205;0
2020-03-26;NZ;New Zealand;78;0;283;0
2020-03-27;NZ;New Zealand;85;0;368;0
2020-03-28;NZ;New Zealand;83;0;451;0
2020-03-29;NZ;New Zealand;63;1;514;1
2020-03-30;NZ;New Zealand;75;0;589;1
2020-03-31;NZ;New Zealand;58;0;647;1
2020-04-01;NZ;New Zealand;61;0;708;1
2020-04-02;NZ;New Zealand;89;0;797;1
2020-04-03;NZ;New Zealand;71;0;868;1
2020-04-04;NZ;New Zealand;82;0;950;1
2020-04-05;NZ;New Zealand;89;0;1039;1
2020-04-06;NZ;New Zealand;67;0;1106;1
2020-04-07;NZ;New Zealand;54;0;1160;1
2020-04-08;NZ;New Zealand;50;0;1210;1
2020-04-09;NZ;New Zealand;29;0;1239;1
2020-04-10;NZ;New Zealand;44;1;1283;2
2020-04-11;NZ;New Zealand;29;2;1312;4
2020-04-12;NZ;New Zealand;18;0;1330;4
2020-04-13;NZ;New Zealand;19;1;1349;5
2020-04-14;NZ;New Zealand;17;4;1366;9
2020-04-15;NZ;New Zealand;20;0;1386;9
2020-04-16;NZ;New Zealand;15;0;1401;9
2020-04-17;NZ;New Zealand;8;2;1409;11
2020-04-18;NZ;New Zealand;13;0;1422;11
2020-04-19;NZ;New Zealand;9;1;1431;12
2020-04-20;NZ;New Zealand;9;0;1440;12
2020-04-21;NZ;New Zealand;5;1;1445;13
2020-04-22;NZ;New Zealand;6;1;1451;14
2020-04-23;NZ;New Zealand;5;3;1456;17
2020-04-24;NZ;New Zealand;5;1;1461;18
2020-04-25;NZ;New Zealand;9;0;1470;18
2020-04-26;NZ;New Zealand;-1;1;1469;19
2020-04-27;NZ;New Zealand;3;0;1472;19
2020-04-28;NZ;New Zealand;2;0;1474;19
2020-04-29;NZ;New Zealand;2;0;1476;19
2020-04-30;NZ;New Zealand;3;0;1479;19
2020-05-01;NZ;New Zealand;6;1;1485;20
2020-05-02;NZ;New Zealand;2;0;1487;20
2020-05-03;NZ;New Zealand;0;0;1487;20
2020-05-04;NZ;New Zealand;-1;0;1486;20
2020-05-05;NZ;New Zealand;2;1;1488;21
2020-05-06;NZ;New Zealand;1;0;1489;21
2020-05-07;NZ;New Zealand;1;0;1490;21
2020-05-08;NZ;New Zealand;2;0;1492;21
2020-05-09;NZ;New Zealand;2;0;1494;21
2020-05-10;NZ;New Zealand;3;0;1497;21
2020-05-11;NZ;New Zealand;0;0;1497;21
2020-05-12;NZ;New Zealand;0;0;1497;21
2020-05-13;NZ;New Zealand;0;0;1497;21
2020-05-14;NZ;New Zealand;1;0;1498;21
2020-05-15;NZ;New Zealand;0;0;1498;21
2020-05-16;NZ;New Zealand;1;0;1499;21
2020-05-17;NZ;New Zealand;0;0;1499;21
2020-05-18;NZ;New Zealand;0;0;1499;21
2020-05-19;NZ;New Zealand;4;0;1503;21
2020-05-20;NZ;New Zealand;0;0;1503;21
2020-05-21;NZ;New Zealand;1;0;1504;21
2020-05-22;NZ;New Zealand;0;0;1504;21
2020-05-23;NZ;New Zealand;0;0;1504;21
2020-05-24;NZ;New Zealand;0;0;1504;21
2020-05-25;NZ;New Zealand;0;0;1504;21
2020-05-26;NZ;New Zealand;0;0;1504;21
2020-05-27;NZ;New Zealand;0;1;1504;22
2020-05-28;NZ;New Zealand;0;0;1504;22
2020-05-29;NZ;New Zealand;0;0;1504;22
2020-05-30;NZ;New Zealand;0;0;1504;22
2020-05-31;NZ;New Zealand;0;0;1504;22
2020-06-01;NZ;New Zealand;0;0;1504;22
2020-06-02;NZ;New Zealand;0;0;1504;22
2020-06-03;NZ;New Zealand;0;0;1504;22
2020-06-04;NZ;New Zealand;0;0;1504;22
2020-06-05;NZ;New Zealand;0;0;1504;22
2020-06-06;NZ;New Zealand;0;0;1504;22
2020-06-07;NZ;New Zealand;0;0;1504;22
2020-06-08;NZ;New Zealand;0;0;1504;22
2020-06-09;NZ;New Zealand;0;0;1504;22
2020-06-10;NZ;New Zealand;0;0;1504;22
2020-06-11;NZ;New Zealand;0;0;1504;22
2020-06-12;NZ;New Zealand;0;0;1504;22
2020-06-13;NZ;New Zealand;0;0;1504;22
2020-06-14;NZ;New Zealand;0;0;1504;22
2020-06-15;NZ;New Zealand;2;0;1506;22
2020-06-16;NZ;New Zealand;0;0;1506;22
2020-06-17;NZ;New Zealand;1;0;1507;22
2020-06-18;NZ;New Zealand;0;0;1507;22
2020-06-19;NZ;New Zealand;2;0;1509;22
2020-06-20;NZ;New Zealand;2;0;1511;22
2020-06-21;NZ;New Zealand;2;0;1513;22
2020-06-22;NZ;New Zealand;2;0;1515;22
2020-06-23;NZ;New Zealand;1;0;1516;22
2020-06-24;NZ;New Zealand;3;0;1519;22
2020-06-25;NZ;New Zealand;1;0;1520;22
2020-06-26;NZ;New Zealand;2;0;1522;22
2020-06-27;NZ;New Zealand;4;0;1526;22
2020-06-28;NZ;New Zealand;2;0;1528;22
2020-06-29;NZ;New Zealand;0;0;1528;22
2020-06-30;NZ;New Zealand;0;0;1528;22
2020-07-01;NZ;New Zealand;2;0;1530;22
2020-07-02;NZ;New Zealand;0;0;1530;22
2020-07-03;NZ;New Zealand;0;0;1530;22
2020-07-04;NZ;New Zealand;3;0;1533;22
2020-07-05;NZ;New Zealand;1;0;1534;22
2020-07-06;NZ;New Zealand;2;0;1536;22
2020-07-07;NZ;New Zealand;1;0;1537;22
2020-07-08;NZ;New Zealand;3;0;1540;22
2020-07-09;NZ;New Zealand;2;0;1542;22
2020-07-10;NZ;New Zealand;1;0;1543;22
2020-07-11;NZ;New Zealand;1;0;1544;22
2020-07-12;NZ;New Zealand;0;0;1544;22
2020-07-13;NZ;New Zealand;1;0;1545;22
2020-07-14;NZ;New Zealand;2;0;1547;22
2020-07-15;NZ;New Zealand;1;0;1548;22
2020-07-16;NZ;New Zealand;1;0;1549;22
2020-07-17;NZ;New Zealand;1;0;1550;22
2020-07-18;NZ;New Zealand;3;0;1553;22
2020-07-19;NZ;New Zealand;1;0;1554;22
2020-07-20;NZ;New Zealand;1;0;1555;22
2020-07-21;NZ;New Zealand;0;0;1555;22
2020-07-22;NZ;New Zealand;0;0;1555;22
2020-07-23;NZ;New Zealand;1;0;1556;22
2020-07-24;NZ;New Zealand;0;0;1556;22
2020-07-25;NZ;New Zealand;0;0;1556;22
2020-07-26;NZ;New Zealand;0;0;1556;22
2020-07-27;NZ;New Zealand;1;0;1557;22
2020-07-28;NZ;New Zealand;2;0;1559;22
2020-07-29;NZ;New Zealand;1;0;1560;22
2020-07-30;NZ;New Zealand;0;0;1560;22
2020-07-31;NZ;New Zealand;2;0;1562;22
2020-08-01;NZ;New Zealand;3;0;1565;22
2020-08-02;NZ;New Zealand;2;0;1567;22
2020-08-03;NZ;New Zealand;0;0;1567;22
2020-08-04;NZ;New Zealand;2;0;1569;22
2020-08-05;NZ;New Zealand;0;0;1569;22
2020-08-06;NZ;New Zealand;0;0;1569;22
2020-08-07;NZ;New Zealand;0;0;1569;22
2020-08-08;NZ;New Zealand;0;0;1569;22
2020-08-09;NZ;New Zealand;0;0;1569;22
2020-08-10;NZ;New Zealand;1;0;1570;22
2020-08-11;NZ;New Zealand;0;0;1570;22
2020-08-12;NZ;New Zealand;19;0;1589;22
2020-08-13;NZ;New Zealand;13;0;1602;22
2020-08-14;NZ;New Zealand;7;0;1609;22
2020-08-15;NZ;New Zealand;13;0;1622;22
2020-08-16;NZ;New Zealand;9;0;1631;22
2020-08-17;NZ;New Zealand;12;0;1643;22
2020-08-18;NZ;New Zealand;6;0;1649;22
2020-08-19;NZ;New Zealand;5;0;1654;22
2020-08-20;NZ;New Zealand;11;0;1665;22
2020-08-21;NZ;New Zealand;6;0;1671;22
2020-08-22;NZ;New Zealand;3;0;1674;22
2020-08-23;NZ;New Zealand;9;0;1683;22
2020-08-24;NZ;New Zealand;7;0;1690;22
2020-08-25;NZ;New Zealand;5;0;1695;22
2020-08-26;NZ;New Zealand;7;0;1702;22
2020-08-27;NZ;New Zealand;12;0;1714;22
2020-08-28;NZ;New Zealand;13;0;1727;22
2020-08-29;NZ;New Zealand;2;0;1729;22
2020-08-30;NZ;New Zealand;9;0;1738;22
2020-08-31;NZ;New Zealand;14;0;1752;22
2020-09-01;NZ;New Zealand;5;0;1757;22
2020-09-02;NZ;New Zealand;2;0;1759;22
2020-09-03;NZ;New Zealand;5;0;1764;22
2020-09-04;NZ;New Zealand;3;2;1767;24
2020-09-05;NZ;New Zealand;5;0;1772;24
2020-09-06;NZ;New Zealand;4;0;1776;24
2020-09-07;NZ;New Zealand;6;0;1782;24
2020-09-08;NZ;New Zealand;6;0;1788;24
2020-09-09;NZ;New Zealand;4;0;1792;24
2020-09-10;NZ;New Zealand;1;0;1793;24
2020-09-11;NZ;New Zealand;2;0;1795;24
2020-09-12;NZ;New Zealand;2;0;1797;24
2020-09-13;NZ;New Zealand;1;0;1798;24
2020-09-14;NZ;New Zealand;3;0;1801;24
2020-09-15;NZ;New Zealand;1;1;1802;25
2020-09-16;NZ;New Zealand;7;0;1809;25
2020-09-17;NZ;New Zealand;0;0;1809;25
2020-09-18;NZ;New Zealand;2;0;1811;25
2020-09-19;NZ;New Zealand;4;0;1815;25
2020-09-20;NZ;New Zealand;0;0;1815;25
2020-09-21;NZ;New Zealand;0;0;1815;25
2020-09-22;NZ;New Zealand;9;0;1824;25
2020-09-23;NZ;New Zealand;3;0;1827;25
2020-09-24;NZ;New Zealand;2;0;1829;25
2020-09-25;NZ;New Zealand;2;0;1831;25
2020-09-26;NZ;New Zealand;2;0;1833;25
2020-09-27;NZ;New Zealand;0;0;1833;25
2020-09-28;NZ;New Zealand;2;0;1835;25
2020-09-29;NZ;New Zealand;1;0;1836;25
2020-09-30;NZ;New Zealand;12;0;1848;25
2020-10-01;NZ;New Zealand;0;0;1848;25
2020-10-02;NZ;New Zealand;1;0;1849;25
2020-10-03;NZ;New Zealand;5;0;1854;25
2020-10-04;NZ;New Zealand;1;0;1855;25
2020-10-05;NZ;New Zealand;3;0;1858;25
2020-10-06;NZ;New Zealand;3;0;1861;25
2020-10-07;NZ;New Zealand;3;0;1864;25
2020-10-08;NZ;New Zealand;2;0;1866;25
2020-10-09;NZ;New Zealand;4;0;1870;25
2020-10-10;NZ;New Zealand;1;0;1871;25
2020-10-11;NZ;New Zealand;0;0;1871;25
2020-10-12;NZ;New Zealand;1;0;1872;25
2020-10-13;NZ;New Zealand;2;0;1874;25
2020-10-14;NZ;New Zealand;2;0;1876;25
2020-10-15;NZ;New Zealand;4;0;1880;25
2020-10-16;NZ;New Zealand;3;0;1883;25
2020-10-17;NZ;New Zealand;3;0;1886;25
2020-10-18;NZ;New Zealand;0;0;1886;25
2020-10-19;NZ;New Zealand;1;0;1887;25
2020-10-20;NZ;New Zealand;25;0;1912;25
2020-10-21;NZ;New Zealand;2;0;1914;25
2020-10-22;NZ;New Zealand;9;0;1923;25
2020-10-23;NZ;New Zealand;11;0;1934;25
2020-10-24;NZ;New Zealand;1;0;1935;25
2020-10-25;NZ;New Zealand;5;0;1940;25
2020-10-26;NZ;New Zealand;1;0;1941;25
2020-10-27;NZ;New Zealand;2;0;1943;25
2020-10-28;NZ;New Zealand;6;0;1949;25
2020-10-29;NZ;New Zealand;1;0;1950;25
2020-10-30;NZ;New Zealand;7;0;1957;25
2020-10-31;NZ;New Zealand;2;0;1959;25
2020-11-01;NZ;New Zealand;4;0;1963;25
2020-11-02;NZ;New Zealand;5;0;1968;25
2020-11-03;NZ;New Zealand;3;0;1971;25
2020-11-04;NZ;New Zealand;2;0;1973;25
2020-11-05;NZ;New Zealand;1;0;1974;25
2020-11-06;NZ;New Zealand;2;0;1976;25
2020-11-07;NZ;New Zealand;6;0;1982;25
2020-11-08;NZ;New Zealand;4;0;1986;25
2020-11-09;NZ;New Zealand;1;0;1987;25
2020-11-10;NZ;New Zealand;1;0;1988;25
2020-11-11;NZ;New Zealand;3;0;1991;25
2020-11-12;NZ;New Zealand;4;0;1995;25
2020-11-13;NZ;New Zealand;3;0;1998;25
2020-11-14;NZ;New Zealand;3;0;2001;25
2020-11-15;NZ;New Zealand;0;0;2001;25
2020-11-16;NZ;New Zealand;4;0;2005;25
2020-11-17;NZ;New Zealand;3;0;2008;25
2020-11-18;NZ;New Zealand;2;0;2010;25
2020-11-19;NZ;New Zealand;3;0;2013;25
2020-11-20;NZ;New Zealand;6;0;2019;25
2020-11-21;NZ;New Zealand;9;0;2028;25
2020-11-22;NZ;New Zealand;2;0;2030;25
2020-11-23;NZ;New Zealand;1;0;2031;25
2020-11-24;NZ;New Zealand;8;0;2039;25
2020-11-25;NZ;New Zealand;1;0;2040;25
2020-11-26;NZ;New Zealand;7;0;2047;25
2020-11-27;NZ;New Zealand;3;0;2050;25
2020-11-28;NZ;New Zealand;0;0;2050;25
2020-11-29;NZ;New Zealand;6;0;2056;25
2020-11-30;NZ;New Zealand;3;0;2059;25
2020-12-01;NZ;New Zealand;1;0;2060;25
2020-12-02;NZ;New Zealand;9;0;2069;25
2020-12-03;NZ;New Zealand;0;0;2069;25
2020-12-04;NZ;New Zealand;9;0;2078;25
2020-12-05;NZ;New Zealand;0;0;2078;25
2020-12-06;NZ;New Zealand;1;0;2079;25
2020-12-07;NZ;New Zealand;6;0;2085;25
2020-12-08;NZ;New Zealand;3;0;2088;25
2020-12-09;NZ;New Zealand;0;0;2088;25
2020-12-10;NZ;New Zealand;4;0;2092;25
2020-12-11;NZ;New Zealand;0;0;2092;25
2020-12-12;NZ;New Zealand;4;0;2096;25
2020-12-13;NZ;New Zealand;0;0;2096;25
2020-12-14;NZ;New Zealand;0;0;2096;25
2020-12-15;NZ;New Zealand;4;0;2100;25
2020-12-16;NZ;New Zealand;0;0;2100;25
2020-12-17;NZ;New Zealand;10;0;2110;25
2020-12-18;NZ;New Zealand;0;0;2110;25
2020-12-19;NZ;New Zealand;6;0;2116;25
2020-12-20;NZ;New Zealand;5;0;2121;25
2020-12-21;NZ;New Zealand;0;0;2121;25
2020-12-22;NZ;New Zealand;7;0;2128;25
2020-12-23;NZ;New Zealand;0;0;2128;25
2020-12-24;NZ;New Zealand;0;0;2128;25
2020-12-25;NZ;New Zealand;0;0;2128;25
2020-12-26;NZ;New Zealand;16;0;2144;25
2020-12-27;NZ;New Zealand;0;0;2144;25
2020-12-28;NZ;New Zealand;7;0;2151;25
2020-12-29;NZ;New Zealand;0;0;2151;25
2020-12-30;NZ;New Zealand;11;0;2162;25
2020-12-31;NZ;New Zealand;0;0;2162;25
2021-01-01;NZ;New Zealand;0;0;2162;25
2021-01-02;NZ;New Zealand;19;0;2181;25
2021-01-03;NZ;New Zealand;0;0;2181;25
2021-01-04;NZ;New Zealand;5;0;2186;25
2021-01-05;NZ;New Zealand;0;0;2186;25
2021-01-06;NZ;New Zealand;2;0;2188;25
2021-01-07;NZ;New Zealand;0;0;2188;25
2021-01-08;NZ;New Zealand;0;0;2188;25
2021-01-09;NZ;New Zealand;31;0;2219;25
2021-01-10;NZ;New Zealand;3;0;2222;25
2021-01-11;NZ;New Zealand;0;0;2222;25
2021-01-12;NZ;New Zealand;6;0;2228;25
2021-01-13;NZ;New Zealand;0;0;2228;25
2021-01-14;NZ;New Zealand;18;0;2246;25
2021-01-15;NZ;New Zealand;0;0;2246;25
2021-01-16;NZ;New Zealand;10;0;2256;25
2021-01-17;NZ;New Zealand;6;0;2262;25
2021-01-18;NZ;New Zealand;0;0;2262;25
2021-01-19;NZ;New Zealand;5;0;2267;25
2021-01-20;NZ;New Zealand;0;0;2267;25
2021-01-21;NZ;New Zealand;9;0;2276;25
2021-01-22;NZ;New Zealand;0;0;2276;25
2021-01-23;NZ;New Zealand;7;0;2283;25
2021-01-24;NZ;New Zealand;5;0;2288;25
2021-01-25;NZ;New Zealand;2;0;2290;25
2021-01-26;NZ;New Zealand;5;0;2295;25
2021-01-27;NZ;New Zealand;4;0;2299;25
2021-01-28;NZ;New Zealand;6;0;2305;25
2021-01-29;NZ;New Zealand;-2;0;2303;25
2021-01-30;NZ;New Zealand;1;0;2304;25
2021-01-31;NZ;New Zealand;0;0;2304;25
2021-02-01;NZ;New Zealand;3;0;2307;25
2021-02-02;NZ;New Zealand;1;0;2308;25
2021-02-03;NZ;New Zealand;5;0;2313;25
2021-02-04;NZ;New Zealand;2;0;2315;25
2021-02-05;NZ;New Zealand;0;0;2315;25
2021-02-06;NZ;New Zealand;5;0;2320;25
2021-02-07;NZ;New Zealand;0;0;2320;25
2021-02-08;NZ;New Zealand;2;0;2322;25
2021-02-09;NZ;New Zealand;2;0;2324;25
2021-02-10;NZ;New Zealand;0;0;2324;25
2021-02-11;NZ;New Zealand;2;0;2326;25
2021-02-12;NZ;New Zealand;2;0;2328;25
2021-02-13;NZ;New Zealand;2;0;2330;25
2021-02-14;NZ;New Zealand;6;0;2336;25
2021-02-15;NZ;New Zealand;1;1;2337;26
2021-02-16;NZ;New Zealand;3;0;2340;26
2021-02-17;NZ;New Zealand;4;0;2344;26
2021-02-18;NZ;New Zealand;4;0;2348;26
2021-02-19;NZ;New Zealand;2;0;2350;26
2021-02-20;NZ;New Zealand;0;0;2350;26
2021-02-21;NZ;New Zealand;7;0;2357;26
2021-02-22;NZ;New Zealand;6;0;2363;26
2021-02-23;NZ;New Zealand;2;0;2365;26
2021-02-24;NZ;New Zealand;3;0;2368;26
2021-02-25;NZ;New Zealand;3;0;2371;26
2021-02-26;NZ;New Zealand;1;0;2372;26
2021-02-27;NZ;New Zealand;4;0;2376;26
2021-02-28;NZ;New Zealand;2;0;2378;26
2021-03-01;NZ;New Zealand;4;0;2382;26
2021-03-02;NZ;New Zealand;2;0;2384;26
2021-03-03;NZ;New Zealand;5;0;2389;26
2021-03-04;NZ;New Zealand;0;0;2389;26
2021-03-05;NZ;New Zealand;9;0;2398;26
2021-03-06;NZ;New Zealand;1;0;2399;26
2021-03-07;NZ;New Zealand;6;0;2405;26
2021-03-08;NZ;New Zealand;4;0;2409;26
2021-03-09;NZ;New Zealand;1;0;2410;26
2021-03-10;NZ;New Zealand;6;0;2416;26
2021-03-11;NZ;New Zealand;1;0;2417;26
2021-03-12;NZ;New Zealand;5;0;2422;26
2021-03-13;NZ;New Zealand;1;0;2423;26
2021-03-14;NZ;New Zealand;7;0;2430;26
2021-03-15;NZ;New Zealand;2;0;2432;26
2021-03-16;NZ;New Zealand;2;0;2434;26
2021-03-17;NZ;New Zealand;0;0;2434;26
2021-03-18;NZ;New Zealand;10;0;2444;26
2021-03-19;NZ;New Zealand;0;0;2444;26
2021-03-20;NZ;New Zealand;9;0;2453;26
2021-03-21;NZ;New Zealand;9;0;2462;26
2021-03-22;NZ;New Zealand;0;0;2462;26
2021-03-23;NZ;New Zealand;8;0;2470;26
2021-03-24;NZ;New Zealand;6;0;2476;26
2021-03-25;NZ;New Zealand;3;0;2479;26
2021-03-26;NZ;New Zealand;2;0;2481;26
2021-03-27;NZ;New Zealand;1;0;2482;26
2021-03-28;NZ;New Zealand;11;0;2493;26
2021-03-29;NZ;New Zealand;2;0;2495;26
2021-03-30;NZ;New Zealand;2;0;2497;26
2021-03-31;NZ;New Zealand;4;0;2501;26
2021-04-01;NZ;New Zealand;0;0;2501;26
2021-04-02;NZ;New Zealand;0;0;2501;26
2021-04-03;NZ;New Zealand;0;0;2501;26
2021-04-04;NZ;New Zealand;6;0;2507;26
2021-04-05;NZ;New Zealand;17;0;2524;26
2021-04-06;NZ;New Zealand;7;0;2531;26
2021-04-07;NZ;New Zealand;24;0;2555;26
2021-04-08;NZ;New Zealand;6;0;2561;26
2021-04-09;NZ;New Zealand;10;0;2571;26
2021-04-10;NZ;New Zealand;3;0;2574;26
2021-04-11;NZ;New Zealand;9;0;2583;26
2021-04-12;NZ;New Zealand;4;0;2587;26
2021-04-13;NZ;New Zealand;2;0;2589;26
2021-04-14;NZ;New Zealand;2;0;2591;26
2021-04-15;NZ;New Zealand;0;0;2591;26
2021-04-16;NZ;New Zealand;0;0;2591;26
2021-04-17;NZ;New Zealand;4;0;2595;26
2021-04-18;NZ;New Zealand;1;0;2596;26
2021-04-19;NZ;New Zealand;1;0;2597;26
2021-04-20;NZ;New Zealand;2;0;2599;26
2021-04-21;NZ;New Zealand;1;0;2600;26
2021-04-22;NZ;New Zealand;0;0;2600;26
2021-04-23;NZ;New Zealand;0;0;2600;26
2021-04-24;NZ;New Zealand;1;0;2601;26
2021-04-25;NZ;New Zealand;0;0;2601;26
2021-04-26;NZ;New Zealand;8;0;2609;26
2021-04-27;NZ;New Zealand;0;0;2609;26
2021-04-28;NZ;New Zealand;4;0;2613;26
2021-04-29;NZ;New Zealand;0;0;2613;26
2021-04-30;NZ;New Zealand;0;0;2613;26
2021-05-01;NZ;New Zealand;5;0;2618;26
2021-05-02;NZ;New Zealand;4;0;2622;26
2021-05-03;NZ;New Zealand;1;0;2623;26
2021-05-04;NZ;New Zealand;6;0;2629;26
2021-05-05;NZ;New Zealand;4;0;2633;26
2021-05-06;NZ;New Zealand;1;0;2634;26
2021-05-07;NZ;New Zealand;0;0;2634;26
2021-05-08;NZ;New Zealand;8;0;2642;26
2021-05-09;NZ;New Zealand;2;0;2644;26
2021-05-10;NZ;New Zealand;0;0;2644;26
2021-05-11;NZ;New Zealand;-1;0;2643;26
2021-05-12;NZ;New Zealand;1;0;2644;26
2021-05-13;NZ;New Zealand;1;0;2645;26
2021-05-14;NZ;New Zealand;0;0;2645;26
2021-05-15;NZ;New Zealand;1;0;2646;26
2021-05-16;NZ;New Zealand;5;0;2651;26
2021-05-17;NZ;New Zealand;2;0;2653;26
2021-05-18;NZ;New Zealand;5;0;2658;26
2021-05-19;NZ;New Zealand;1;0;2659;26
2021-05-20;NZ;New Zealand;3;0;2662;26
2021-05-21;NZ;New Zealand;1;0;2663;26
2021-05-22;NZ;New Zealand;6;0;2669;26
2021-05-23;NZ;New Zealand;0;0;2669;26
2021-05-24;NZ;New Zealand;1;0;2670;26
2021-05-25;NZ;New Zealand;0;0;2670;26
2021-05-26;NZ;New Zealand;1;0;2671;26
2021-05-27;NZ;New Zealand;0;0;2671;26
2021-05-28;NZ;New Zealand;0;0;2671;26
2021-05-29;NZ;New Zealand;2;0;2673;26
2021-05-30;NZ;New Zealand;1;0;2674;26
2021-05-31;NZ;New Zealand;0;0;2674;26
2021-06-01;NZ;New Zealand;6;0;2680;26
2021-06-02;NZ;New Zealand;2;0;2682;26
2021-06-03;NZ;New Zealand;1;0;2683;26
2021-06-04;NZ;New Zealand;0;0;2683;26
2021-06-05;NZ;New Zealand;0;0;2683;26
2021-06-06;NZ;New Zealand;0;0;2683;26
2021-06-07;NZ;New Zealand;10;0;2693;26
2021-06-08;NZ;New Zealand;4;0;2697;26
2021-06-09;NZ;New Zealand;1;0;2698;26
2021-06-10;NZ;New Zealand;5;0;2703;26
2021-06-11;NZ;New Zealand;0;0;2703;26
2021-06-12;NZ;New Zealand;6;0;2709;26
2021-06-13;NZ;New Zealand;1;0;2710;26
2021-06-14;NZ;New Zealand;0;0;2710;26
2021-06-15;NZ;New Zealand;2;0;2712;26
2021-06-16;NZ;New Zealand;2;0;2714;26
2021-06-17;NZ;New Zealand;1;0;2715;26
2021-06-18;NZ;New Zealand;0;0;2715;26
2021-06-19;NZ;New Zealand;4;0;2719;26
2021-06-20;NZ;New Zealand;2;0;2721;26
2021-06-21;NZ;New Zealand;0;0;2721;26
2021-06-22;NZ;New Zealand;3;0;2724;26
2021-06-23;NZ;New Zealand;0;0;2724;26
2021-06-24;NZ;New Zealand;2;0;2726;26
2021-06-25;NZ;New Zealand;4;0;2730;26
2021-06-26;NZ;New Zealand;0;0;2730;26
2021-06-27;NZ;New Zealand;9;0;2739;26
2021-06-28;NZ;New Zealand;3;0;2742;26
2021-06-29;NZ;New Zealand;1;0;2743;26
2021-06-30;NZ;New Zealand;0;0;2743;26
2021-07-01;NZ;New Zealand;0;0;2743;26
2020-03-19;NI;Nicaragua;1;0;1;0
2020-03-20;NI;Nicaragua;0;0;1;0
2020-03-21;NI;Nicaragua;1;0;2;0
2020-03-22;NI;Nicaragua;0;0;2;0
2020-03-23;NI;Nicaragua;0;0;2;0
2020-03-24;NI;Nicaragua;0;0;2;0
2020-03-25;NI;Nicaragua;0;0;2;0
2020-03-26;NI;Nicaragua;0;0;2;0
2020-03-27;NI;Nicaragua;0;1;2;1
2020-03-28;NI;Nicaragua;2;0;4;1
2020-03-29;NI;Nicaragua;0;0;4;1
2020-03-30;NI;Nicaragua;0;0;4;1
2020-03-31;NI;Nicaragua;1;0;5;1
2020-04-01;NI;Nicaragua;0;0;5;1
2020-04-02;NI;Nicaragua;0;0;5;1
2020-04-03;NI;Nicaragua;0;0;5;1
2020-04-04;NI;Nicaragua;0;0;5;1
2020-04-05;NI;Nicaragua;1;0;6;1
2020-04-06;NI;Nicaragua;0;0;6;1
2020-04-07;NI;Nicaragua;0;0;6;1
2020-04-08;NI;Nicaragua;0;0;6;1
2020-04-09;NI;Nicaragua;1;0;7;1
2020-04-10;NI;Nicaragua;0;0;7;1
2020-04-11;NI;Nicaragua;1;0;8;1
2020-04-12;NI;Nicaragua;1;0;9;1
2020-04-13;NI;Nicaragua;0;0;9;1
2020-04-14;NI;Nicaragua;0;0;9;1
2020-04-15;NI;Nicaragua;0;0;9;1
2020-04-16;NI;Nicaragua;0;0;9;1
2020-04-17;NI;Nicaragua;0;0;9;1
2020-04-18;NI;Nicaragua;0;1;9;2
2020-04-19;NI;Nicaragua;1;0;10;2
2020-04-20;NI;Nicaragua;0;0;10;2
2020-04-21;NI;Nicaragua;0;0;10;2
2020-04-22;NI;Nicaragua;0;0;10;2
2020-04-23;NI;Nicaragua;1;1;11;3
2020-04-24;NI;Nicaragua;0;0;11;3
2020-04-25;NI;Nicaragua;1;0;12;3
2020-04-26;NI;Nicaragua;1;0;13;3
2020-04-27;NI;Nicaragua;0;0;13;3
2020-04-28;NI;Nicaragua;0;0;13;3
2020-04-29;NI;Nicaragua;0;0;13;3
2020-04-30;NI;Nicaragua;1;0;14;3
2020-05-01;NI;Nicaragua;0;0;14;3
2020-05-02;NI;Nicaragua;0;0;14;3
2020-05-03;NI;Nicaragua;1;2;15;5
2020-05-04;NI;Nicaragua;0;0;15;5
2020-05-05;NI;Nicaragua;1;0;16;5
2020-05-06;NI;Nicaragua;0;0;16;5
2020-05-07;NI;Nicaragua;0;0;16;5
2020-05-08;NI;Nicaragua;0;0;16;5
2020-05-09;NI;Nicaragua;0;0;16;5
2020-05-10;NI;Nicaragua;0;0;16;5
2020-05-11;NI;Nicaragua;0;0;16;5
2020-05-12;NI;Nicaragua;9;3;25;8
2020-05-13;NI;Nicaragua;0;0;25;8
2020-05-14;NI;Nicaragua;0;0;25;8
2020-05-15;NI;Nicaragua;0;0;25;8
2020-05-16;NI;Nicaragua;0;0;25;8
2020-05-17;NI;Nicaragua;0;0;25;8
2020-05-18;NI;Nicaragua;0;0;25;8
2020-05-19;NI;Nicaragua;229;9;254;17
2020-05-20;NI;Nicaragua;0;0;254;17
2020-05-21;NI;Nicaragua;25;0;279;17
2020-05-22;NI;Nicaragua;0;0;279;17
2020-05-23;NI;Nicaragua;0;0;279;17
2020-05-24;NI;Nicaragua;0;0;279;17
2020-05-25;NI;Nicaragua;0;0;279;17
2020-05-26;NI;Nicaragua;480;18;759;35
2020-05-27;NI;Nicaragua;0;0;759;35
2020-05-28;NI;Nicaragua;0;0;759;35
2020-05-29;NI;Nicaragua;0;0;759;35
2020-05-30;NI;Nicaragua;0;0;759;35
2020-05-31;NI;Nicaragua;0;0;759;35
2020-06-01;NI;Nicaragua;0;0;759;35
2020-06-02;NI;Nicaragua;359;11;1118;46
2020-06-03;NI;Nicaragua;0;0;1118;46
2020-06-04;NI;Nicaragua;0;0;1118;46
2020-06-05;NI;Nicaragua;0;0;1118;46
2020-06-06;NI;Nicaragua;0;0;1118;46
2020-06-07;NI;Nicaragua;0;0;1118;46
2020-06-08;NI;Nicaragua;0;0;1118;46
2020-06-09;NI;Nicaragua;346;9;1464;55
2020-06-10;NI;Nicaragua;0;0;1464;55
2020-06-11;NI;Nicaragua;0;0;1464;55
2020-06-12;NI;Nicaragua;0;0;1464;55
2020-06-13;NI;Nicaragua;0;0;1464;55
2020-06-14;NI;Nicaragua;0;0;1464;55
2020-06-15;NI;Nicaragua;0;0;1464;55
2020-06-16;NI;Nicaragua;359;9;1823;64
2020-06-17;NI;Nicaragua;0;0;1823;64
2020-06-18;NI;Nicaragua;0;0;1823;64
2020-06-19;NI;Nicaragua;0;0;1823;64
2020-06-20;NI;Nicaragua;0;0;1823;64
2020-06-21;NI;Nicaragua;0;0;1823;64
2020-06-22;NI;Nicaragua;0;0;1823;64
2020-06-23;NI;Nicaragua;347;10;2170;74
2020-06-24;NI;Nicaragua;0;0;2170;74
2020-06-25;NI;Nicaragua;0;0;2170;74
2020-06-26;NI;Nicaragua;0;0;2170;74
2020-06-27;NI;Nicaragua;0;0;2170;74
2020-06-28;NI;Nicaragua;0;0;2170;74
2020-06-29;NI;Nicaragua;0;0;2170;74
2020-06-30;NI;Nicaragua;349;9;2519;83
2020-07-01;NI;Nicaragua;0;0;2519;83
2020-07-02;NI;Nicaragua;0;0;2519;83
2020-07-03;NI;Nicaragua;0;0;2519;83
2020-07-04;NI;Nicaragua;0;0;2519;83
2020-07-05;NI;Nicaragua;0;0;2519;83
2020-07-06;NI;Nicaragua;0;0;2519;83
2020-07-07;NI;Nicaragua;327;8;2846;91
2020-07-08;NI;Nicaragua;0;0;2846;91
2020-07-09;NI;Nicaragua;0;0;2846;91
2020-07-10;NI;Nicaragua;0;0;2846;91
2020-07-11;NI;Nicaragua;0;0;2846;91
2020-07-12;NI;Nicaragua;0;0;2846;91
2020-07-13;NI;Nicaragua;0;0;2846;91
2020-07-14;NI;Nicaragua;301;8;3147;99
2020-07-15;NI;Nicaragua;0;0;3147;99
2020-07-16;NI;Nicaragua;0;0;3147;99
2020-07-17;NI;Nicaragua;0;0;3147;99
2020-07-18;NI;Nicaragua;0;0;3147;99
2020-07-19;NI;Nicaragua;0;0;3147;99
2020-07-20;NI;Nicaragua;0;0;3147;99
2020-07-21;NI;Nicaragua;292;9;3439;108
2020-07-22;NI;Nicaragua;0;0;3439;108
2020-07-23;NI;Nicaragua;0;0;3439;108
2020-07-24;NI;Nicaragua;0;0;3439;108
2020-07-25;NI;Nicaragua;0;0;3439;108
2020-07-26;NI;Nicaragua;0;0;3439;108
2020-07-27;NI;Nicaragua;0;0;3439;108
2020-07-28;NI;Nicaragua;233;8;3672;116
2020-07-29;NI;Nicaragua;0;0;3672;116
2020-07-30;NI;Nicaragua;0;0;3672;116
2020-07-31;NI;Nicaragua;0;0;3672;116
2020-08-01;NI;Nicaragua;0;0;3672;116
2020-08-02;NI;Nicaragua;0;0;3672;116
2020-08-03;NI;Nicaragua;0;0;3672;116
2020-08-04;NI;Nicaragua;230;7;3902;123
2020-08-05;NI;Nicaragua;0;0;3902;123
2020-08-06;NI;Nicaragua;0;0;3902;123
2020-08-07;NI;Nicaragua;0;0;3902;123
2020-08-08;NI;Nicaragua;0;0;3902;123
2020-08-09;NI;Nicaragua;0;0;3902;123
2020-08-10;NI;Nicaragua;0;0;3902;123
2020-08-11;NI;Nicaragua;213;5;4115;128
2020-08-12;NI;Nicaragua;0;0;4115;128
2020-08-13;NI;Nicaragua;0;0;4115;128
2020-08-14;NI;Nicaragua;0;0;4115;128
2020-08-15;NI;Nicaragua;0;0;4115;128
2020-08-16;NI;Nicaragua;0;0;4115;128
2020-08-17;NI;Nicaragua;0;0;4115;128
2020-08-18;NI;Nicaragua;196;5;4311;133
2020-08-19;NI;Nicaragua;0;0;4311;133
2020-08-20;NI;Nicaragua;0;0;4311;133
2020-08-21;NI;Nicaragua;0;0;4311;133
2020-08-22;NI;Nicaragua;0;0;4311;133
2020-08-23;NI;Nicaragua;0;0;4311;133
2020-08-24;NI;Nicaragua;0;0;4311;133
2020-08-25;NI;Nicaragua;183;4;4494;137
2020-08-26;NI;Nicaragua;0;0;4494;137
2020-08-27;NI;Nicaragua;0;0;4494;137
2020-08-28;NI;Nicaragua;0;0;4494;137
2020-08-29;NI;Nicaragua;0;0;4494;137
2020-08-30;NI;Nicaragua;0;0;4494;137
2020-08-31;NI;Nicaragua;0;0;4494;137
2020-09-01;NI;Nicaragua;174;4;4668;141
2020-09-02;NI;Nicaragua;0;0;4668;141
2020-09-03;NI;Nicaragua;0;0;4668;141
2020-09-04;NI;Nicaragua;0;0;4668;141
2020-09-05;NI;Nicaragua;0;0;4668;141
2020-09-06;NI;Nicaragua;0;0;4668;141
2020-09-07;NI;Nicaragua;0;0;4668;141
2020-09-08;NI;Nicaragua;150;3;4818;144
2020-09-09;NI;Nicaragua;0;0;4818;144
2020-09-10;NI;Nicaragua;0;0;4818;144
2020-09-11;NI;Nicaragua;0;0;4818;144
2020-09-12;NI;Nicaragua;0;0;4818;144
2020-09-13;NI;Nicaragua;0;0;4818;144
2020-09-14;NI;Nicaragua;0;0;4818;144
2020-09-15;NI;Nicaragua;143;3;4961;147
2020-09-16;NI;Nicaragua;0;0;4961;147
2020-09-17;NI;Nicaragua;0;0;4961;147
2020-09-18;NI;Nicaragua;0;0;4961;147
2020-09-19;NI;Nicaragua;0;0;4961;147
2020-09-20;NI;Nicaragua;0;0;4961;147
2020-09-21;NI;Nicaragua;0;0;4961;147
2020-09-22;NI;Nicaragua;112;2;5073;149
2020-09-23;NI;Nicaragua;0;0;5073;149
2020-09-24;NI;Nicaragua;0;0;5073;149
2020-09-25;NI;Nicaragua;0;0;5073;149
2020-09-26;NI;Nicaragua;0;0;5073;149
2020-09-27;NI;Nicaragua;0;0;5073;149
2020-09-28;NI;Nicaragua;0;0;5073;149
2020-09-29;NI;Nicaragua;97;2;5170;151
2020-09-30;NI;Nicaragua;0;0;5170;151
2020-10-01;NI;Nicaragua;0;0;5170;151
2020-10-02;NI;Nicaragua;0;0;5170;151
2020-10-03;NI;Nicaragua;0;0;5170;151
2020-10-04;NI;Nicaragua;0;0;5170;151
2020-10-05;NI;Nicaragua;0;0;5170;151
2020-10-06;NI;Nicaragua;94;0;5264;151
2020-10-07;NI;Nicaragua;0;2;5264;153
2020-10-08;NI;Nicaragua;0;0;5264;153
2020-10-09;NI;Nicaragua;0;0;5264;153
2020-10-10;NI;Nicaragua;0;0;5264;153
2020-10-11;NI;Nicaragua;0;0;5264;153
2020-10-12;NI;Nicaragua;0;0;5264;153
2020-10-13;NI;Nicaragua;89;1;5353;154
2020-10-14;NI;Nicaragua;0;0;5353;154
2020-10-15;NI;Nicaragua;0;0;5353;154
2020-10-16;NI;Nicaragua;0;0;5353;154
2020-10-17;NI;Nicaragua;0;0;5353;154
2020-10-18;NI;Nicaragua;0;0;5353;154
2020-10-19;NI;Nicaragua;0;0;5353;154
2020-10-20;NI;Nicaragua;81;1;5434;155
2020-10-21;NI;Nicaragua;0;0;5434;155
2020-10-22;NI;Nicaragua;0;0;5434;155
2020-10-23;NI;Nicaragua;0;0;5434;155
2020-10-24;NI;Nicaragua;0;0;5434;155
2020-10-25;NI;Nicaragua;0;0;5434;155
2020-10-26;NI;Nicaragua;0;0;5434;155
2020-10-27;NI;Nicaragua;80;1;5514;156
2020-10-28;NI;Nicaragua;0;0;5514;156
2020-10-29;NI;Nicaragua;0;0;5514;156
2020-10-30;NI;Nicaragua;0;0;5514;156
2020-10-31;NI;Nicaragua;0;0;5514;156
2020-11-01;NI;Nicaragua;0;0;5514;156
2020-11-02;NI;Nicaragua;0;0;5514;156
2020-11-03;NI;Nicaragua;0;0;5514;156
2020-11-04;NI;Nicaragua;0;0;5514;156
2020-11-05;NI;Nicaragua;77;1;5591;157
2020-11-06;NI;Nicaragua;0;0;5591;157
2020-11-07;NI;Nicaragua;0;0;5591;157
2020-11-08;NI;Nicaragua;0;0;5591;157
2020-11-09;NI;Nicaragua;0;0;5591;157
2020-11-10;NI;Nicaragua;70;1;5661;158
2020-11-11;NI;Nicaragua;0;0;5661;158
2020-11-12;NI;Nicaragua;0;0;5661;158
2020-11-13;NI;Nicaragua;0;0;5661;158
2020-11-14;NI;Nicaragua;0;0;5661;158
2020-11-15;NI;Nicaragua;0;0;5661;158
2020-11-16;NI;Nicaragua;0;0;5661;158
2020-11-17;NI;Nicaragua;64;1;5725;159
2020-11-18;NI;Nicaragua;0;0;5725;159
2020-11-19;NI;Nicaragua;0;0;5725;159
2020-11-20;NI;Nicaragua;0;0;5725;159
2020-11-21;NI;Nicaragua;0;0;5725;159
2020-11-22;NI;Nicaragua;0;0;5725;159
2020-11-23;NI;Nicaragua;0;0;5725;159
2020-11-24;NI;Nicaragua;59;1;5784;160
2020-11-25;NI;Nicaragua;0;0;5784;160
2020-11-26;NI;Nicaragua;0;0;5784;160
2020-11-27;NI;Nicaragua;0;0;5784;160
2020-11-28;NI;Nicaragua;0;0;5784;160
2020-11-29;NI;Nicaragua;0;0;5784;160
2020-11-30;NI;Nicaragua;0;0;5784;160
2020-12-01;NI;Nicaragua;54;1;5838;161
2020-12-02;NI;Nicaragua;0;0;5838;161
2020-12-03;NI;Nicaragua;0;0;5838;161
2020-12-04;NI;Nicaragua;0;0;5838;161
2020-12-05;NI;Nicaragua;0;0;5838;161
2020-12-06;NI;Nicaragua;0;0;5838;161
2020-12-07;NI;Nicaragua;0;0;5838;161
2020-12-08;NI;Nicaragua;49;1;5887;162
2020-12-09;NI;Nicaragua;0;0;5887;162
2020-12-10;NI;Nicaragua;0;0;5887;162
2020-12-11;NI;Nicaragua;0;0;5887;162
2020-12-12;NI;Nicaragua;0;0;5887;162
2020-12-13;NI;Nicaragua;0;0;5887;162
2020-12-14;NI;Nicaragua;0;0;5887;162
2020-12-15;NI;Nicaragua;0;0;5887;162
2020-12-16;NI;Nicaragua;51;1;5938;163
2020-12-17;NI;Nicaragua;0;0;5938;163
2020-12-18;NI;Nicaragua;0;0;5938;163
2020-12-19;NI;Nicaragua;0;0;5938;163
2020-12-20;NI;Nicaragua;0;0;5938;163
2020-12-21;NI;Nicaragua;0;0;5938;163
2020-12-22;NI;Nicaragua;0;0;5938;163
2020-12-23;NI;Nicaragua;53;1;5991;164
2020-12-24;NI;Nicaragua;0;0;5991;164
2020-12-25;NI;Nicaragua;0;0;5991;164
2020-12-26;NI;Nicaragua;0;0;5991;164
2020-12-27;NI;Nicaragua;0;0;5991;164
2020-12-28;NI;Nicaragua;0;0;5991;164
2020-12-29;NI;Nicaragua;55;1;6046;165
2020-12-30;NI;Nicaragua;0;0;6046;165
2020-12-31;NI;Nicaragua;0;0;6046;165
2021-01-01;NI;Nicaragua;0;0;6046;165
2021-01-02;NI;Nicaragua;0;0;6046;165
2021-01-03;NI;Nicaragua;0;0;6046;165
2021-01-04;NI;Nicaragua;0;0;6046;165
2021-01-05;NI;Nicaragua;51;1;6097;166
2021-01-06;NI;Nicaragua;0;0;6097;166
2021-01-07;NI;Nicaragua;0;0;6097;166
2021-01-08;NI;Nicaragua;0;0;6097;166
2021-01-09;NI;Nicaragua;0;0;6097;166
2021-01-10;NI;Nicaragua;0;0;6097;166
2021-01-11;NI;Nicaragua;0;0;6097;166
2021-01-12;NI;Nicaragua;55;1;6152;167
2021-01-13;NI;Nicaragua;0;0;6152;167
2021-01-14;NI;Nicaragua;0;0;6152;167
2021-01-15;NI;Nicaragua;0;0;6152;167
2021-01-16;NI;Nicaragua;0;0;6152;167
2021-01-17;NI;Nicaragua;0;0;6152;167
2021-01-18;NI;Nicaragua;0;0;6152;167
2021-01-19;NI;Nicaragua;52;1;6204;168
2021-01-20;NI;Nicaragua;0;0;6204;168
2021-01-21;NI;Nicaragua;0;0;6204;168
2021-01-22;NI;Nicaragua;0;0;6204;168
2021-01-23;NI;Nicaragua;0;0;6204;168
2021-01-24;NI;Nicaragua;0;0;6204;168
2021-01-25;NI;Nicaragua;0;0;6204;168
2021-01-26;NI;Nicaragua;49;1;6253;169
2021-01-27;NI;Nicaragua;0;0;6253;169
2021-01-28;NI;Nicaragua;0;0;6253;169
2021-01-29;NI;Nicaragua;0;0;6253;169
2021-01-30;NI;Nicaragua;0;0;6253;169
2021-01-31;NI;Nicaragua;0;0;6253;169
2021-02-01;NI;Nicaragua;0;0;6253;169
2021-02-02;NI;Nicaragua;46;1;6299;170
2021-02-03;NI;Nicaragua;0;0;6299;170
2021-02-04;NI;Nicaragua;0;0;6299;170
2021-02-05;NI;Nicaragua;0;0;6299;170
2021-02-06;NI;Nicaragua;0;0;6299;170
2021-02-07;NI;Nicaragua;0;0;6299;170
2021-02-08;NI;Nicaragua;0;0;6299;170
2021-02-09;NI;Nicaragua;48;1;6347;171
2021-02-10;NI;Nicaragua;0;0;6347;171
2021-02-11;NI;Nicaragua;0;0;6347;171
2021-02-12;NI;Nicaragua;0;0;6347;171
2021-02-13;NI;Nicaragua;0;0;6347;171
2021-02-14;NI;Nicaragua;0;0;6347;171
2021-02-15;NI;Nicaragua;0;0;6347;171
2021-02-16;NI;Nicaragua;51;1;6398;172
2021-02-17;NI;Nicaragua;0;0;6398;172
2021-02-18;NI;Nicaragua;0;0;6398;172
2021-02-19;NI;Nicaragua;0;0;6398;172
2021-02-20;NI;Nicaragua;0;0;6398;172
2021-02-21;NI;Nicaragua;0;0;6398;172
2021-02-22;NI;Nicaragua;0;0;6398;172
2021-02-23;NI;Nicaragua;47;1;6445;173
2021-02-24;NI;Nicaragua;0;0;6445;173
2021-02-25;NI;Nicaragua;0;0;6445;173
2021-02-26;NI;Nicaragua;0;0;6445;173
2021-02-27;NI;Nicaragua;0;0;6445;173
2021-02-28;NI;Nicaragua;0;0;6445;173
2021-03-01;NI;Nicaragua;0;0;6445;173
2021-03-02;NI;Nicaragua;44;1;6489;174
2021-03-03;NI;Nicaragua;0;0;6489;174
2021-03-04;NI;Nicaragua;0;0;6489;174
2021-03-05;NI;Nicaragua;0;0;6489;174
2021-03-06;NI;Nicaragua;0;0;6489;174
2021-03-07;NI;Nicaragua;0;0;6489;174
2021-03-08;NI;Nicaragua;0;0;6489;174
2021-03-09;NI;Nicaragua;48;1;6537;175
2021-03-10;NI;Nicaragua;0;0;6537;175
2021-03-11;NI;Nicaragua;0;0;6537;175
2021-03-12;NI;Nicaragua;0;0;6537;175
2021-03-13;NI;Nicaragua;0;0;6537;175
2021-03-14;NI;Nicaragua;0;0;6537;175
2021-03-15;NI;Nicaragua;0;0;6537;175
2021-03-16;NI;Nicaragua;45;1;6582;176
2021-03-17;NI;Nicaragua;0;0;6582;176
2021-03-18;NI;Nicaragua;0;0;6582;176
2021-03-19;NI;Nicaragua;0;0;6582;176
2021-03-20;NI;Nicaragua;0;0;6582;176
2021-03-21;NI;Nicaragua;0;0;6582;176
2021-03-22;NI;Nicaragua;0;0;6582;176
2021-03-23;NI;Nicaragua;47;1;6629;177
2021-03-24;NI;Nicaragua;0;0;6629;177
2021-03-25;NI;Nicaragua;0;0;6629;177
2021-03-26;NI;Nicaragua;0;0;6629;177
2021-03-27;NI;Nicaragua;0;0;6629;177
2021-03-28;NI;Nicaragua;0;0;6629;177
2021-03-29;NI;Nicaragua;0;0;6629;177
2021-03-30;NI;Nicaragua;48;1;6677;178
2021-03-31;NI;Nicaragua;0;0;6677;178
2021-04-01;NI;Nicaragua;0;0;6677;178
2021-04-02;NI;Nicaragua;0;0;6677;178
2021-04-03;NI;Nicaragua;0;0;6677;178
2021-04-04;NI;Nicaragua;0;0;6677;178
2021-04-05;NI;Nicaragua;0;0;6677;178
2021-04-06;NI;Nicaragua;50;1;6727;179
2021-04-07;NI;Nicaragua;0;0;6727;179
2021-04-08;NI;Nicaragua;0;0;6727;179
2021-04-09;NI;Nicaragua;0;0;6727;179
2021-04-10;NI;Nicaragua;0;0;6727;179
2021-04-11;NI;Nicaragua;0;0;6727;179
2021-04-12;NI;Nicaragua;0;0;6727;179
2021-04-13;NI;Nicaragua;51;1;6778;180
2021-04-14;NI;Nicaragua;0;0;6778;180
2021-04-15;NI;Nicaragua;0;0;6778;180
2021-04-16;NI;Nicaragua;0;0;6778;180
2021-04-17;NI;Nicaragua;0;0;6778;180
2021-04-18;NI;Nicaragua;0;0;6778;180
2021-04-19;NI;Nicaragua;0;0;6778;180
2021-04-20;NI;Nicaragua;57;1;6835;181
2021-04-21;NI;Nicaragua;0;0;6835;181
2021-04-22;NI;Nicaragua;0;0;6835;181
2021-04-23;NI;Nicaragua;0;0;6835;181
2021-04-24;NI;Nicaragua;0;0;6835;181
2021-04-25;NI;Nicaragua;0;0;6835;181
2021-04-26;NI;Nicaragua;0;0;6835;181
2021-04-27;NI;Nicaragua;63;1;6898;182
2021-04-28;NI;Nicaragua;0;0;6898;182
2021-04-29;NI;Nicaragua;0;0;6898;182
2021-04-30;NI;Nicaragua;0;0;6898;182
2021-05-01;NI;Nicaragua;0;0;6898;182
2021-05-02;NI;Nicaragua;0;0;6898;182
2021-05-03;NI;Nicaragua;0;0;6898;182
2021-05-04;NI;Nicaragua;91;1;6989;183
2021-05-05;NI;Nicaragua;0;0;6989;183
2021-05-06;NI;Nicaragua;0;0;6989;183
2021-05-07;NI;Nicaragua;0;0;6989;183
2021-05-08;NI;Nicaragua;0;0;6989;183
2021-05-09;NI;Nicaragua;0;0;6989;183
2021-05-10;NI;Nicaragua;0;0;6989;183
2021-05-11;NI;Nicaragua;97;1;7086;184
2021-05-12;NI;Nicaragua;0;0;7086;184
2021-05-13;NI;Nicaragua;0;0;7086;184
2021-05-14;NI;Nicaragua;0;0;7086;184
2021-05-15;NI;Nicaragua;0;0;7086;184
2021-05-16;NI;Nicaragua;0;0;7086;184
2021-05-17;NI;Nicaragua;0;0;7086;184
2021-05-18;NI;Nicaragua;107;1;7193;185
2021-05-19;NI;Nicaragua;0;0;7193;185
2021-05-20;NI;Nicaragua;0;0;7193;185
2021-05-21;NI;Nicaragua;0;0;7193;185
2021-05-22;NI;Nicaragua;0;0;7193;185
2021-05-23;NI;Nicaragua;0;0;7193;185
2021-05-24;NI;Nicaragua;0;0;7193;185
2021-05-25;NI;Nicaragua;131;1;7324;186
2021-05-26;NI;Nicaragua;0;0;7324;186
2021-05-27;NI;Nicaragua;0;0;7324;186
2021-05-28;NI;Nicaragua;0;0;7324;186
2021-05-29;NI;Nicaragua;0;0;7324;186
2021-05-30;NI;Nicaragua;0;0;7324;186
2021-05-31;NI;Nicaragua;0;0;7324;186
2021-06-01;NI;Nicaragua;157;1;7481;187
2021-06-02;NI;Nicaragua;0;0;7481;187
2021-06-03;NI;Nicaragua;0;0;7481;187
2021-06-04;NI;Nicaragua;0;0;7481;187
2021-06-05;NI;Nicaragua;0;0;7481;187
2021-06-06;NI;Nicaragua;0;0;7481;187
2021-06-07;NI;Nicaragua;0;0;7481;187
2021-06-08;NI;Nicaragua;181;1;7662;188
2021-06-09;NI;Nicaragua;0;0;7662;188
2021-06-10;NI;Nicaragua;0;0;7662;188
2021-06-11;NI;Nicaragua;0;0;7662;188
2021-06-12;NI;Nicaragua;0;0;7662;188
2021-06-13;NI;Nicaragua;0;0;7662;188
2021-06-14;NI;Nicaragua;0;0;7662;188
2021-06-15;NI;Nicaragua;34;0;7696;188
2021-06-16;NI;Nicaragua;0;0;7696;188
2021-06-17;NI;Nicaragua;0;0;7696;188
2021-06-18;NI;Nicaragua;0;0;7696;188
2021-06-19;NI;Nicaragua;0;0;7696;188
2021-06-20;NI;Nicaragua;0;0;7696;188
2021-06-21;NI;Nicaragua;0;0;7696;188
2021-06-22;NI;Nicaragua;224;1;7920;189
2021-06-23;NI;Nicaragua;0;0;7920;189
2021-06-24;NI;Nicaragua;0;0;7920;189
2021-06-25;NI;Nicaragua;0;0;7920;189
2021-06-26;NI;Nicaragua;0;0;7920;189
2021-06-27;NI;Nicaragua;0;0;7920;189
2021-06-28;NI;Nicaragua;0;0;7920;189
2021-06-29;NI;Nicaragua;258;2;8178;191
2021-06-30;NI;Nicaragua;0;0;8178;191
2021-07-01;NI;Nicaragua;0;0;8178;191
2020-03-20;NE;Niger;1;0;1;0
2020-03-21;NE;Niger;0;0;1;0
2020-03-22;NE;Niger;1;0;2;0
2020-03-23;NE;Niger;1;0;3;0
2020-03-24;NE;Niger;0;0;3;0
2020-03-25;NE;Niger;4;1;7;1
2020-03-26;NE;Niger;3;0;10;1
2020-03-27;NE;Niger;0;0;10;1
2020-03-28;NE;Niger;0;0;10;1
2020-03-29;NE;Niger;8;0;18;1
2020-03-30;NE;Niger;9;2;27;3
2020-03-31;NE;Niger;0;0;27;3
2020-04-01;NE;Niger;47;2;74;5
2020-04-02;NE;Niger;24;0;98;5
2020-04-03;NE;Niger;22;0;120;5
2020-04-04;NE;Niger;24;3;144;8
2020-04-05;NE;Niger;40;2;184;10
2020-04-06;NE;Niger;69;0;253;10
2020-04-07;NE;Niger;25;1;278;11
2020-04-08;NE;Niger;64;0;342;11
2020-04-09;NE;Niger;68;0;410;11
2020-04-10;NE;Niger;28;0;438;11
2020-04-11;NE;Niger;53;0;491;11
2020-04-12;NE;Niger;38;1;529;12
2020-04-13;NE;Niger;0;0;529;12
2020-04-14;NE;Niger;41;2;570;14
2020-04-15;NE;Niger;14;0;584;14
2020-04-16;NE;Niger;0;0;584;14
2020-04-17;NE;Niger;43;4;627;18
2020-04-18;NE;Niger;12;1;639;19
2020-04-19;NE;Niger;9;1;648;20
2020-04-20;NE;Niger;0;0;648;20
2020-04-21;NE;Niger;9;0;657;20
2020-04-22;NE;Niger;5;2;662;22
2020-04-23;NE;Niger;9;2;671;24
2020-04-24;NE;Niger;10;0;681;24
2020-04-25;NE;Niger;3;3;684;27
2020-04-26;NE;Niger;12;2;696;29
2020-04-27;NE;Niger;5;0;701;29
2020-04-28;NE;Niger;8;2;709;31
2020-04-29;NE;Niger;4;1;713;32
2020-04-30;NE;Niger;6;0;719;32
2020-05-01;NE;Niger;9;1;728;33
2020-05-02;NE;Niger;8;2;736;35
2020-05-03;NE;Niger;14;1;750;36
2020-05-04;NE;Niger;5;1;755;37
2020-05-05;NE;Niger;8;1;763;38
2020-05-06;NE;Niger;7;0;770;38
2020-05-07;NE;Niger;11;4;781;42
2020-05-08;NE;Niger;14;2;795;44
2020-05-09;NE;Niger;20;1;815;45
2020-05-10;NE;Niger;6;1;821;46
2020-05-11;NE;Niger;11;0;832;46
2020-05-12;NE;Niger;22;1;854;47
2020-05-13;NE;Niger;6;2;860;49
2020-05-14;NE;Niger;16;1;876;50
2020-05-15;NE;Niger;9;1;885;51
2020-05-16;NE;Niger;4;0;889;51
2020-05-17;NE;Niger;15;3;904;54
2020-05-18;NE;Niger;5;1;909;55
2020-05-19;NE;Niger;5;0;914;55
2020-05-20;NE;Niger;6;3;920;58
2020-05-21;NE;Niger;4;2;924;60
2020-05-22;NE;Niger;13;0;937;60
2020-05-23;NE;Niger;6;1;943;61
2020-05-24;NE;Niger;2;0;945;61
2020-05-25;NE;Niger;6;1;951;62
2020-05-26;NE;Niger;1;1;952;63
2020-05-27;NE;Niger;0;0;952;63
2020-05-28;NE;Niger;3;1;955;64
2020-05-29;NE;Niger;0;0;955;64
2020-05-30;NE;Niger;1;0;956;64
2020-05-31;NE;Niger;2;0;958;64
2020-06-01;NE;Niger;0;1;958;65
2020-06-02;NE;Niger;2;0;960;65
2020-06-03;NE;Niger;1;0;961;65
2020-06-04;NE;Niger;2;0;963;65
2020-06-05;NE;Niger;3;0;966;65
2020-06-06;NE;Niger;4;0;970;65
2020-06-07;NE;Niger;3;0;973;65
2020-06-08;NE;Niger;0;0;973;65
2020-06-09;NE;Niger;1;0;974;65
2020-06-10;NE;Niger;0;0;974;65
2020-06-11;NE;Niger;0;0;974;65
2020-06-12;NE;Niger;4;0;978;65
2020-06-13;NE;Niger;2;1;980;66
2020-06-14;NE;Niger;0;0;980;66
2020-06-15;NE;Niger;0;0;980;66
2020-06-16;NE;Niger;36;0;1016;66
2020-06-17;NE;Niger;4;1;1020;67
2020-06-18;NE;Niger;0;0;1020;67
2020-06-19;NE;Niger;0;0;1020;67
2020-06-20;NE;Niger;15;0;1035;67
2020-06-21;NE;Niger;1;0;1036;67
2020-06-22;NE;Niger;10;0;1046;67
2020-06-23;NE;Niger;5;0;1051;67
2020-06-24;NE;Niger;0;0;1051;67
2020-06-25;NE;Niger;5;0;1056;67
2020-06-26;NE;Niger;3;0;1059;67
2020-06-27;NE;Niger;3;0;1062;67
2020-06-28;NE;Niger;12;0;1074;67
2020-06-29;NE;Niger;1;0;1075;67
2020-06-30;NE;Niger;0;0;1075;67
2020-07-01;NE;Niger;0;0;1075;67
2020-07-02;NE;Niger;6;1;1081;68
2020-07-03;NE;Niger;1;0;1082;68
2020-07-04;NE;Niger;0;0;1082;68
2020-07-05;NE;Niger;6;0;1088;68
2020-07-06;NE;Niger;5;0;1093;68
2020-07-07;NE;Niger;1;0;1094;68
2020-07-08;NE;Niger;3;0;1097;68
2020-07-09;NE;Niger;0;0;1097;68
2020-07-10;NE;Niger;2;0;1099;68
2020-07-11;NE;Niger;0;0;1099;68
2020-07-12;NE;Niger;0;0;1099;68
2020-07-13;NE;Niger;0;0;1099;68
2020-07-14;NE;Niger;0;0;1099;68
2020-07-15;NE;Niger;1;1;1100;69
2020-07-16;NE;Niger;2;0;1102;69
2020-07-17;NE;Niger;0;0;1102;69
2020-07-18;NE;Niger;2;0;1104;69
2020-07-19;NE;Niger;0;0;1104;69
2020-07-20;NE;Niger;1;0;1105;69
2020-07-21;NE;Niger;8;0;1113;69
2020-07-22;NE;Niger;9;0;1122;69
2020-07-23;NE;Niger;2;0;1124;69
2020-07-24;NE;Niger;0;0;1124;69
2020-07-25;NE;Niger;0;0;1124;69
2020-07-26;NE;Niger;12;0;1136;69
2020-07-27;NE;Niger;-4;0;1132;69
2020-07-28;NE;Niger;0;0;1132;69
2020-07-29;NE;Niger;0;0;1132;69
2020-07-30;NE;Niger;2;0;1134;69
2020-07-31;NE;Niger;0;0;1134;69
2020-08-01;NE;Niger;2;0;1136;69
2020-08-02;NE;Niger;11;0;1147;69
2020-08-03;NE;Niger;5;0;1152;69
2020-08-04;NE;Niger;0;0;1152;69
2020-08-05;NE;Niger;0;0;1152;69
2020-08-06;NE;Niger;1;0;1153;69
2020-08-07;NE;Niger;0;0;1153;69
2020-08-08;NE;Niger;4;0;1157;69
2020-08-09;NE;Niger;1;0;1158;69
2020-08-10;NE;Niger;0;0;1158;69
2020-08-11;NE;Niger;0;0;1158;69
2020-08-12;NE;Niger;3;0;1161;69
2020-08-13;NE;Niger;0;0;1161;69
2020-08-14;NE;Niger;0;0;1161;69
2020-08-15;NE;Niger;4;0;1165;69
2020-08-16;NE;Niger;2;0;1167;69
2020-08-17;NE;Niger;0;0;1167;69
2020-08-18;NE;Niger;0;0;1167;69
2020-08-19;NE;Niger;0;0;1167;69
2020-08-20;NE;Niger;2;0;1169;69
2020-08-21;NE;Niger;3;0;1172;69
2020-08-22;NE;Niger;0;0;1172;69
2020-08-23;NE;Niger;0;0;1172;69
2020-08-24;NE;Niger;0;0;1172;69
2020-08-25;NE;Niger;1;0;1173;69
2020-08-26;NE;Niger;0;0;1173;69
2020-08-27;NE;Niger;0;0;1173;69
2020-08-28;NE;Niger;2;0;1175;69
2020-08-29;NE;Niger;0;0;1175;69
2020-08-30;NE;Niger;0;0;1175;69
2020-08-31;NE;Niger;1;0;1176;69
2020-09-01;NE;Niger;0;0;1176;69
2020-09-02;NE;Niger;0;0;1176;69
2020-09-03;NE;Niger;1;0;1177;69
2020-09-04;NE;Niger;0;0;1177;69
2020-09-05;NE;Niger;0;0;1177;69
2020-09-06;NE;Niger;0;0;1177;69
2020-09-07;NE;Niger;0;0;1177;69
2020-09-08;NE;Niger;1;0;1178;69
2020-09-09;NE;Niger;0;0;1178;69
2020-09-10;NE;Niger;0;0;1178;69
2020-09-11;NE;Niger;0;0;1178;69
2020-09-12;NE;Niger;0;0;1178;69
2020-09-13;NE;Niger;2;0;1180;69
2020-09-14;NE;Niger;0;0;1180;69
2020-09-15;NE;Niger;2;0;1182;69
2020-09-16;NE;Niger;0;0;1182;69
2020-09-17;NE;Niger;1;0;1183;69
2020-09-18;NE;Niger;0;0;1183;69
2020-09-19;NE;Niger;0;0;1183;69
2020-09-20;NE;Niger;5;0;1188;69
2020-09-21;NE;Niger;1;0;1189;69
2020-09-22;NE;Niger;4;0;1193;69
2020-09-23;NE;Niger;0;0;1193;69
2020-09-24;NE;Niger;1;0;1194;69
2020-09-25;NE;Niger;0;0;1194;69
2020-09-26;NE;Niger;0;0;1194;69
2020-09-27;NE;Niger;2;0;1196;69
2020-09-28;NE;Niger;0;0;1196;69
2020-09-29;NE;Niger;0;0;1196;69
2020-09-30;NE;Niger;1;0;1197;69
2020-10-01;NE;Niger;0;0;1197;69
2020-10-02;NE;Niger;1;0;1198;69
2020-10-03;NE;Niger;2;0;1200;69
2020-10-04;NE;Niger;0;0;1200;69
2020-10-05;NE;Niger;0;0;1200;69
2020-10-06;NE;Niger;0;0;1200;69
2020-10-07;NE;Niger;0;0;1200;69
2020-10-08;NE;Niger;1;0;1201;69
2020-10-09;NE;Niger;0;0;1201;69
2020-10-10;NE;Niger;0;0;1201;69
2020-10-11;NE;Niger;0;0;1201;69
2020-10-12;NE;Niger;1;0;1202;69
2020-10-13;NE;Niger;1;0;1203;69
2020-10-14;NE;Niger;2;0;1205;69
2020-10-15;NE;Niger;2;0;1207;69
2020-10-16;NE;Niger;2;0;1209;69
2020-10-17;NE;Niger;0;0;1209;69
2020-10-18;NE;Niger;1;0;1210;69
2020-10-19;NE;Niger;1;0;1211;69
2020-10-20;NE;Niger;1;0;1212;69
2020-10-21;NE;Niger;2;0;1214;69
2020-10-22;NE;Niger;1;0;1215;69
2020-10-23;NE;Niger;0;0;1215;69
2020-10-24;NE;Niger;0;0;1215;69
2020-10-25;NE;Niger;0;0;1215;69
2020-10-26;NE;Niger;0;0;1215;69
2020-10-27;NE;Niger;3;0;1218;69
2020-10-28;NE;Niger;0;0;1218;69
2020-10-29;NE;Niger;1;0;1219;69
2020-10-30;NE;Niger;1;0;1220;69
2020-10-31;NE;Niger;0;0;1220;69
2020-11-01;NE;Niger;1;0;1221;69
2020-11-02;NE;Niger;1;0;1222;69
2020-11-03;NE;Niger;0;0;1222;69
2020-11-04;NE;Niger;3;0;1225;69
2020-11-05;NE;Niger;1;0;1226;69
2020-11-06;NE;Niger;4;0;1230;69
2020-11-07;NE;Niger;12;0;1242;69
2020-11-08;NE;Niger;1;0;1243;69
2020-11-09;NE;Niger;3;0;1246;69
2020-11-10;NE;Niger;10;0;1256;69
2020-11-11;NE;Niger;7;0;1263;69
2020-11-12;NE;Niger;19;0;1282;69
2020-11-13;NE;Niger;7;0;1289;69
2020-11-14;NE;Niger;12;1;1301;70
2020-11-15;NE;Niger;6;0;1307;70
2020-11-16;NE;Niger;9;0;1316;70
2020-11-17;NE;Niger;11;0;1327;70
2020-11-18;NE;Niger;4;0;1331;70
2020-11-19;NE;Niger;4;0;1335;70
2020-11-20;NE;Niger;5;0;1340;70
2020-11-21;NE;Niger;11;0;1351;70
2020-11-22;NE;Niger;17;0;1368;70
2020-11-23;NE;Niger;13;0;1381;70
2020-11-24;NE;Niger;25;0;1406;70
2020-11-25;NE;Niger;13;0;1419;70
2020-11-26;NE;Niger;24;0;1443;70
2020-11-27;NE;Niger;29;0;1472;70
2020-11-28;NE;Niger;12;0;1484;70
2020-11-29;NE;Niger;32;0;1516;70
2020-11-30;NE;Niger;32;2;1548;72
2020-12-01;NE;Niger;38;3;1586;75
2020-12-02;NE;Niger;54;1;1640;76
2020-12-03;NE;Niger;0;0;1640;76
2020-12-04;NE;Niger;86;1;1726;77
2020-12-05;NE;Niger;63;0;1789;77
2020-12-06;NE;Niger;67;0;1856;77
2020-12-07;NE;Niger;38;1;1894;78
2020-12-08;NE;Niger;93;1;1987;79
2020-12-09;NE;Niger;91;0;2078;79
2020-12-10;NE;Niger;48;1;2126;80
2020-12-11;NE;Niger;34;0;2160;80
2020-12-12;NE;Niger;39;0;2199;80
2020-12-13;NE;Niger;59;0;2258;80
2020-12-14;NE;Niger;64;2;2322;82
2020-12-15;NE;Niger;39;0;2361;82
2020-12-16;NE;Niger;0;0;2361;82
2020-12-17;NE;Niger;145;2;2506;84
2020-12-18;NE;Niger;54;1;2560;85
2020-12-19;NE;Niger;52;1;2612;86
2020-12-20;NE;Niger;47;1;2659;87
2020-12-21;NE;Niger;65;0;2724;87
2020-12-22;NE;Niger;79;2;2803;89
2020-12-23;NE;Niger;73;0;2876;89
2020-12-24;NE;Niger;57;1;2933;90
2020-12-25;NE;Niger;72;1;3005;91
2020-12-26;NE;Niger;52;3;3057;94
2020-12-27;NE;Niger;53;2;3110;96
2020-12-28;NE;Niger;49;3;3159;99
2020-12-29;NE;Niger;49;3;3208;102
2020-12-30;NE;Niger;0;0;3208;102
2020-12-31;NE;Niger;115;2;3323;104
2021-01-01;NE;Niger;80;2;3403;106
2021-01-02;NE;Niger;34;4;3437;110
2021-01-03;NE;Niger;28;0;3465;110
2021-01-04;NE;Niger;0;0;3465;110
2021-01-05;NE;Niger;35;0;3500;110
2021-01-06;NE;Niger;134;3;3634;113
2021-01-07;NE;Niger;72;6;3706;119
2021-01-08;NE;Niger;41;6;3747;125
2021-01-09;NE;Niger;72;1;3819;126
2021-01-10;NE;Niger;58;0;3877;126
2021-01-11;NE;Niger;47;2;3924;128
2021-01-12;NE;Niger;45;7;3969;135
2021-01-13;NE;Niger;29;1;3998;136
2021-01-14;NE;Niger;60;1;4058;137
2021-01-15;NE;Niger;47;1;4105;138
2021-01-16;NE;Niger;27;0;4132;138
2021-01-17;NE;Niger;24;2;4156;140
2021-01-18;NE;Niger;48;5;4204;145
2021-01-19;NE;Niger;21;1;4225;146
2021-01-20;NE;Niger;24;1;4249;147
2021-01-21;NE;Niger;18;0;4267;147
2021-01-22;NE;Niger;41;3;4308;150
2021-01-23;NE;Niger;13;1;4321;151
2021-01-24;NE;Niger;32;0;4353;151
2021-01-25;NE;Niger;0;0;4353;151
2021-01-26;NE;Niger;54;2;4407;153
2021-01-27;NE;Niger;26;0;4433;153
2021-01-28;NE;Niger;41;4;4474;157
2021-01-29;NE;Niger;15;2;4489;159
2021-01-30;NE;Niger;27;0;4516;159
2021-01-31;NE;Niger;1;0;4517;159
2021-02-01;NE;Niger;20;2;4537;161
2021-02-02;NE;Niger;11;1;4548;162
2021-02-03;NE;Niger;17;1;4565;163
2021-02-04;NE;Niger;10;1;4575;164
2021-02-05;NE;Niger;14;1;4589;165
2021-02-06;NE;Niger;9;0;4598;165
2021-02-07;NE;Niger;14;0;4612;165
2021-02-08;NE;Niger;9;1;4621;166
2021-02-09;NE;Niger;22;1;4643;167
2021-02-10;NE;Niger;13;0;4656;167
2021-02-11;NE;Niger;9;0;4665;167
2021-02-12;NE;Niger;13;2;4678;169
2021-02-13;NE;Niger;12;0;4690;169
2021-02-14;NE;Niger;5;0;4695;169
2021-02-15;NE;Niger;7;0;4702;169
2021-02-16;NE;Niger;4;0;4706;169
2021-02-17;NE;Niger;9;1;4715;170
2021-02-18;NE;Niger;3;0;4718;170
2021-02-19;NE;Niger;7;0;4725;170
2021-02-20;NE;Niger;8;0;4733;170
2021-02-21;NE;Niger;0;0;4733;170
2021-02-22;NE;Niger;7;2;4740;172
2021-02-23;NE;Niger;0;0;4740;172
2021-02-24;NE;Niger;0;0;4740;172
2021-02-25;NE;Niger;0;0;4740;172
2021-02-26;NE;Niger;0;0;4740;172
2021-02-27;NE;Niger;0;0;4740;172
2021-02-28;NE;Niger;0;0;4740;172
2021-03-01;NE;Niger;0;0;4740;172
2021-03-02;NE;Niger;0;0;4740;172
2021-03-03;NE;Niger;0;0;4740;172
2021-03-04;NE;Niger;0;0;4740;172
2021-03-05;NE;Niger;0;0;4740;172
2021-03-06;NE;Niger;0;0;4740;172
2021-03-07;NE;Niger;82;5;4822;177
2021-03-08;NE;Niger;6;0;4828;177
2021-03-09;NE;Niger;7;0;4835;177
2021-03-10;NE;Niger;13;2;4848;179
2021-03-11;NE;Niger;5;1;4853;180
2021-03-12;NE;Niger;0;0;4853;180
2021-03-13;NE;Niger;4;1;4857;181
2021-03-14;NE;Niger;3;1;4860;182
2021-03-15;NE;Niger;5;0;4865;182
2021-03-16;NE;Niger;5;1;4870;183
2021-03-17;NE;Niger;34;2;4904;185
2021-03-18;NE;Niger;2;0;4906;185
2021-03-19;NE;Niger;5;0;4911;185
2021-03-20;NE;Niger;7;0;4918;185
2021-03-21;NE;Niger;0;0;4918;185
2021-03-22;NE;Niger;10;0;4928;185
2021-03-23;NE;Niger;11;0;4939;185
2021-03-24;NE;Niger;0;0;4939;185
2021-03-25;NE;Niger;25;0;4964;185
2021-03-26;NE;Niger;8;0;4972;185
2021-03-27;NE;Niger;0;0;4972;185
2021-03-28;NE;Niger;15;0;4987;185
2021-03-29;NE;Niger;0;0;4987;185
2021-03-30;NE;Niger;14;1;5001;186
2021-03-31;NE;Niger;0;0;5001;186
2021-04-01;NE;Niger;20;1;5021;187
2021-04-02;NE;Niger;0;0;5021;187
2021-04-03;NE;Niger;7;1;5028;188
2021-04-04;NE;Niger;13;0;5041;188
2021-04-05;NE;Niger;0;0;5041;188
2021-04-06;NE;Niger;7;0;5048;188
2021-04-07;NE;Niger;4;0;5052;188
2021-04-08;NE;Niger;6;0;5058;188
2021-04-09;NE;Niger;4;0;5062;188
2021-04-10;NE;Niger;10;0;5072;188
2021-04-11;NE;Niger;2;1;5074;189
2021-04-12;NE;Niger;7;0;5081;189
2021-04-13;NE;Niger;0;0;5081;189
2021-04-14;NE;Niger;0;0;5081;189
2021-04-15;NE;Niger;32;1;5113;190
2021-04-16;NE;Niger;3;0;5116;190
2021-04-17;NE;Niger;0;0;5116;190
2021-04-18;NE;Niger;15;0;5131;190
2021-04-19;NE;Niger;0;0;5131;190
2021-04-20;NE;Niger;9;1;5140;191
2021-04-21;NE;Niger;1;0;5141;191
2021-04-22;NE;Niger;2;0;5143;191
2021-04-23;NE;Niger;0;0;5143;191
2021-04-24;NE;Niger;15;0;5158;191
2021-04-25;NE;Niger;33;0;5191;191
2021-04-26;NE;Niger;13;0;5204;191
2021-04-27;NE;Niger;16;0;5220;191
2021-04-28;NE;Niger;4;0;5224;191
2021-04-29;NE;Niger;2;0;5226;191
2021-04-30;NE;Niger;2;0;5228;191
2021-05-01;NE;Niger;1;0;5229;191
2021-05-02;NE;Niger;22;0;5251;191
2021-05-03;NE;Niger;10;0;5261;191
2021-05-04;NE;Niger;25;1;5286;192
2021-05-05;NE;Niger;0;0;5286;192
2021-05-06;NE;Niger;0;0;5286;192
2021-05-07;NE;Niger;24;0;5310;192
2021-05-08;NE;Niger;3;0;5313;192
2021-05-09;NE;Niger;6;0;5319;192
2021-05-10;NE;Niger;3;0;5322;192
2021-05-11;NE;Niger;2;0;5324;192
2021-05-12;NE;Niger;1;0;5325;192
2021-05-13;NE;Niger;1;0;5326;192
2021-05-14;NE;Niger;0;0;5326;192
2021-05-15;NE;Niger;4;0;5330;192
2021-05-16;NE;Niger;3;0;5333;192
2021-05-17;NE;Niger;6;0;5339;192
2021-05-18;NE;Niger;9;0;5348;192
2021-05-19;NE;Niger;8;0;5356;192
2021-05-20;NE;Niger;5;0;5361;192
2021-05-21;NE;Niger;3;0;5364;192
2021-05-22;NE;Niger;5;0;5369;192
2021-05-23;NE;Niger;14;0;5383;192
2021-05-24;NE;Niger;0;0;5383;192
2021-05-25;NE;Niger;6;0;5389;192
2021-05-26;NE;Niger;9;0;5398;192
2021-05-27;NE;Niger;8;0;5406;192
2021-05-28;NE;Niger;0;0;5406;192
2021-05-29;NE;Niger;4;0;5410;192
2021-05-30;NE;Niger;0;0;5410;192
2021-05-31;NE;Niger;0;0;5410;192
2021-06-01;NE;Niger;0;0;5410;192
2021-06-02;NE;Niger;5;0;5415;192
2021-06-03;NE;Niger;1;0;5416;192
2021-06-04;NE;Niger;15;0;5431;192
2021-06-05;NE;Niger;7;0;5438;192
2021-06-06;NE;Niger;1;0;5439;192
2021-06-07;NE;Niger;0;0;5439;192
2021-06-08;NE;Niger;1;0;5440;192
2021-06-09;NE;Niger;0;0;5440;192
2021-06-10;NE;Niger;4;0;5444;192
2021-06-11;NE;Niger;2;0;5446;192
2021-06-12;NE;Niger;0;0;5446;192
2021-06-13;NE;Niger;0;0;5446;192
2021-06-14;NE;Niger;6;0;5452;192
2021-06-15;NE;Niger;0;0;5452;192
2021-06-16;NE;Niger;3;0;5455;192
2021-06-17;NE;Niger;2;1;5457;193
2021-06-18;NE;Niger;2;0;5459;193
2021-06-19;NE;Niger;10;0;5469;193
2021-06-20;NE;Niger;0;0;5469;193
2021-06-21;NE;Niger;0;0;5469;193
2021-06-22;NE;Niger;0;0;5469;193
2021-06-23;NE;Niger;3;0;5472;193
2021-06-24;NE;Niger;3;0;5475;193
2021-06-25;NE;Niger;3;0;5478;193
2021-06-26;NE;Niger;0;0;5478;193
2021-06-27;NE;Niger;1;0;5479;193
2021-06-28;NE;Niger;1;0;5480;193
2021-06-29;NE;Niger;8;0;5488;193
2021-06-30;NE;Niger;1;0;5489;193
2021-07-01;NE;Niger;3;0;5492;193
2020-02-28;NG;Nigeria;1;0;1;0
2020-02-29;NG;Nigeria;0;0;1;0
2020-03-01;NG;Nigeria;0;0;1;0
2020-03-02;NG;Nigeria;0;0;1;0
2020-03-03;NG;Nigeria;0;0;1;0
2020-03-04;NG;Nigeria;0;0;1;0
2020-03-05;NG;Nigeria;0;0;1;0
2020-03-06;NG;Nigeria;0;0;1;0
2020-03-07;NG;Nigeria;0;0;1;0
2020-03-08;NG;Nigeria;0;0;1;0
2020-03-09;NG;Nigeria;1;0;2;0
2020-03-10;NG;Nigeria;0;0;2;0
2020-03-11;NG;Nigeria;0;0;2;0
2020-03-12;NG;Nigeria;0;0;2;0
2020-03-13;NG;Nigeria;0;0;2;0
2020-03-14;NG;Nigeria;0;0;2;0
2020-03-15;NG;Nigeria;0;0;2;0
2020-03-16;NG;Nigeria;0;0;2;0
2020-03-17;NG;Nigeria;1;0;3;0
2020-03-18;NG;Nigeria;5;0;8;0
2020-03-19;NG;Nigeria;0;0;8;0
2020-03-20;NG;Nigeria;4;0;12;0
2020-03-21;NG;Nigeria;10;0;22;0
2020-03-22;NG;Nigeria;8;0;30;0
2020-03-23;NG;Nigeria;10;1;40;1
2020-03-24;NG;Nigeria;4;0;44;1
2020-03-25;NG;Nigeria;7;0;51;1
2020-03-26;NG;Nigeria;14;0;65;1
2020-03-27;NG;Nigeria;5;0;70;1
2020-03-28;NG;Nigeria;19;0;89;1
2020-03-29;NG;Nigeria;22;0;111;1
2020-03-30;NG;Nigeria;20;1;131;2
2020-03-31;NG;Nigeria;4;0;135;2
2020-04-01;NG;Nigeria;39;0;174;2
2020-04-02;NG;Nigeria;10;0;184;2
2020-04-03;NG;Nigeria;26;2;210;4
2020-04-04;NG;Nigeria;4;0;214;4
2020-04-05;NG;Nigeria;18;1;232;5
2020-04-06;NG;Nigeria;6;0;238;5
2020-04-07;NG;Nigeria;16;1;254;6
2020-04-08;NG;Nigeria;22;0;276;6
2020-04-09;NG;Nigeria;12;1;288;7
2020-04-10;NG;Nigeria;17;0;305;7
2020-04-11;NG;Nigeria;13;3;318;10
2020-04-12;NG;Nigeria;5;0;323;10
2020-04-13;NG;Nigeria;20;0;343;10
2020-04-14;NG;Nigeria;30;1;373;11
2020-04-15;NG;Nigeria;34;1;407;12
2020-04-16;NG;Nigeria;35;1;442;13
2020-04-17;NG;Nigeria;51;4;493;17
2020-04-18;NG;Nigeria;49;2;542;19
2020-04-19;NG;Nigeria;85;2;627;21
2020-04-20;NG;Nigeria;38;1;665;22
2020-04-21;NG;Nigeria;0;0;665;22
2020-04-22;NG;Nigeria;208;6;873;28
2020-04-23;NG;Nigeria;108;3;981;31
2020-04-24;NG;Nigeria;114;1;1095;32
2020-04-25;NG;Nigeria;87;3;1182;35
2020-04-26;NG;Nigeria;91;5;1273;40
2020-04-27;NG;Nigeria;64;0;1337;40
2020-04-28;NG;Nigeria;195;4;1532;44
2020-04-29;NG;Nigeria;196;7;1728;51
2020-04-30;NG;Nigeria;204;7;1932;58
2020-05-01;NG;Nigeria;238;10;2170;68
2020-05-02;NG;Nigeria;218;17;2388;85
2020-05-03;NG;Nigeria;170;2;2558;87
2020-05-04;NG;Nigeria;244;6;2802;93
2020-05-05;NG;Nigeria;148;5;2950;98
2020-05-06;NG;Nigeria;195;5;3145;103
2020-05-07;NG;Nigeria;381;4;3526;107
2020-05-08;NG;Nigeria;386;10;3912;117
2020-05-09;NG;Nigeria;239;11;4151;128
2020-05-10;NG;Nigeria;248;15;4399;143
2020-05-11;NG;Nigeria;242;7;4641;150
2020-05-12;NG;Nigeria;146;8;4787;158
2020-05-13;NG;Nigeria;184;6;4971;164
2020-05-14;NG;Nigeria;191;3;5162;167
2020-05-15;NG;Nigeria;288;4;5450;171
2020-05-16;NG;Nigeria;171;5;5621;176
2020-05-17;NG;Nigeria;338;6;5959;182
2020-05-18;NG;Nigeria;216;9;6175;191
2020-05-19;NG;Nigeria;226;1;6401;192
2020-05-20;NG;Nigeria;276;8;6677;200
2020-05-21;NG;Nigeria;339;11;7016;211
2020-05-22;NG;Nigeria;245;10;7261;221
2020-05-23;NG;Nigeria;265;0;7526;221
2020-05-24;NG;Nigeria;313;5;7839;226
2020-05-25;NG;Nigeria;229;7;8068;233
2020-05-26;NG;Nigeria;276;16;8344;249
2020-05-27;NG;Nigeria;389;5;8733;254
2020-05-28;NG;Nigeria;182;5;8915;259
2020-05-29;NG;Nigeria;387;2;9302;261
2020-05-30;NG;Nigeria;553;12;9855;273
2020-05-31;NG;Nigeria;307;14;10162;287
2020-06-01;NG;Nigeria;416;12;10578;299
2020-06-02;NG;Nigeria;241;15;10819;314
2020-06-03;NG;Nigeria;347;1;11166;315
2020-06-04;NG;Nigeria;350;8;11516;323
2020-06-05;NG;Nigeria;328;10;11844;333
2020-06-06;NG;Nigeria;389;9;12233;342
2020-06-07;NG;Nigeria;253;12;12486;354
2020-06-08;NG;Nigeria;315;7;12801;361
2020-06-09;NG;Nigeria;663;4;13464;365
2020-06-10;NG;Nigeria;409;17;13873;382
2020-06-11;NG;Nigeria;681;5;14554;387
2020-06-12;NG;Nigeria;627;12;15181;399
2020-06-13;NG;Nigeria;501;8;15682;407
2020-06-14;NG;Nigeria;403;13;16085;420
2020-06-15;NG;Nigeria;573;4;16658;424
2020-06-16;NG;Nigeria;490;31;17148;455
2020-06-17;NG;Nigeria;587;14;17735;469
2020-06-18;NG;Nigeria;745;6;18480;475
2020-06-19;NG;Nigeria;667;12;19147;487
2020-06-20;NG;Nigeria;661;19;19808;506
2020-06-21;NG;Nigeria;436;12;20244;518
2020-06-22;NG;Nigeria;675;7;20919;525
2020-06-23;NG;Nigeria;452;8;21371;533
2020-06-24;NG;Nigeria;649;9;22020;542
2020-06-25;NG;Nigeria;594;7;22614;549
2020-06-26;NG;Nigeria;684;5;23298;554
2020-06-27;NG;Nigeria;779;4;24077;558
2020-06-28;NG;Nigeria;490;7;24567;565
2020-06-29;NG;Nigeria;566;8;25133;573
2020-06-30;NG;Nigeria;561;17;25694;590
2020-07-01;NG;Nigeria;790;13;26484;603
2020-07-02;NG;Nigeria;626;13;27110;616
2020-07-03;NG;Nigeria;454;12;27564;628
2020-07-04;NG;Nigeria;603;6;28167;634
2020-07-05;NG;Nigeria;544;11;28711;645
2020-07-06;NG;Nigeria;575;9;29286;654
2020-07-07;NG;Nigeria;503;15;29789;669
2020-07-08;NG;Nigeria;460;15;30249;684
2020-07-09;NG;Nigeria;499;5;30748;689
2020-07-10;NG;Nigeria;575;20;31323;709
2020-07-11;NG;Nigeria;664;15;31987;724
2020-07-12;NG;Nigeria;571;16;32558;740
2020-07-13;NG;Nigeria;595;4;33153;744
2020-07-14;NG;Nigeria;463;10;33616;754
2020-07-15;NG;Nigeria;643;6;34259;760
2020-07-16;NG;Nigeria;595;9;34854;769
2020-07-17;NG;Nigeria;600;3;35454;772
2020-07-18;NG;Nigeria;653;6;36107;778
2020-07-19;NG;Nigeria;556;11;36663;789
2020-07-20;NG;Nigeria;562;12;37225;801
2020-07-21;NG;Nigeria;576;4;37801;805
2020-07-22;NG;Nigeria;543;8;38344;813
2020-07-23;NG;Nigeria;604;20;38948;833
2020-07-24;NG;Nigeria;591;12;39539;845
2020-07-25;NG;Nigeria;438;11;39977;856
2020-07-26;NG;Nigeria;555;2;40532;858
2020-07-27;NG;Nigeria;648;2;41180;860
2020-07-28;NG;Nigeria;624;8;41804;868
2020-07-29;NG;Nigeria;404;5;42208;873
2020-07-30;NG;Nigeria;481;5;42689;878
2020-07-31;NG;Nigeria;462;1;43151;879
2020-08-01;NG;Nigeria;386;4;43537;883
2020-08-02;NG;Nigeria;304;5;43841;888
2020-08-03;NG;Nigeria;288;8;44129;896
2020-08-04;NG;Nigeria;304;14;44433;910
2020-08-05;NG;Nigeria;457;17;44890;927
2020-08-06;NG;Nigeria;354;3;45244;930
2020-08-07;NG;Nigeria;443;6;45687;936
2020-08-08;NG;Nigeria;453;6;46140;942
2020-08-09;NG;Nigeria;437;3;46577;945
2020-08-10;NG;Nigeria;290;5;46867;950
2020-08-11;NG;Nigeria;423;6;47290;956
2020-08-12;NG;Nigeria;453;0;47743;956
2020-08-13;NG;Nigeria;373;10;48116;966
2020-08-14;NG;Nigeria;329;7;48445;973
2020-08-15;NG;Nigeria;325;1;48770;974
2020-08-16;NG;Nigeria;298;1;49068;975
2020-08-17;NG;Nigeria;417;2;49485;977
2020-08-18;NG;Nigeria;410;4;49895;981
2020-08-19;NG;Nigeria;593;4;50488;985
2020-08-20;NG;Nigeria;476;7;50964;992
2020-08-21;NG;Nigeria;340;4;51304;996
2020-08-22;NG;Nigeria;601;1;51905;997
2020-08-23;NG;Nigeria;322;5;52227;1002
2020-08-24;NG;Nigeria;321;2;52548;1004
2020-08-25;NG;Nigeria;252;3;52800;1007
2020-08-26;NG;Nigeria;221;3;53021;1010
2020-08-27;NG;Nigeria;296;1;53317;1011
2020-08-28;NG;Nigeria;160;0;53477;1011
2020-08-29;NG;Nigeria;250;0;53727;1011
2020-08-30;NG;Nigeria;138;2;53865;1013
2020-08-31;NG;Nigeria;143;0;54008;1013
2020-09-01;NG;Nigeria;239;10;54247;1023
2020-09-02;NG;Nigeria;216;4;54463;1027
2020-09-03;NG;Nigeria;125;21;54588;1048
2020-09-04;NG;Nigeria;155;3;54743;1051
2020-09-05;NG;Nigeria;162;3;54905;1054
2020-09-06;NG;Nigeria;100;3;55005;1057
2020-09-07;NG;Nigeria;155;4;55160;1061
2020-09-08;NG;Nigeria;296;6;55456;1067
2020-09-09;NG;Nigeria;176;3;55632;1070
2020-09-10;NG;Nigeria;197;5;55829;1075
2020-09-11;NG;Nigeria;188;1;56017;1076
2020-09-12;NG;Nigeria;160;2;56177;1078
2020-09-13;NG;Nigeria;79;4;56256;1082
2020-09-14;NG;Nigeria;132;1;56388;1083
2020-09-15;NG;Nigeria;90;5;56478;1088
2020-09-16;NG;Nigeria;126;3;56604;1091
2020-09-17;NG;Nigeria;131;2;56735;1093
2020-09-18;NG;Nigeria;221;1;56956;1094
2020-09-19;NG;Nigeria;189;1;57145;1095
2020-09-20;NG;Nigeria;97;3;57242;1098
2020-09-21;NG;Nigeria;195;2;57437;1100
2020-09-22;NG;Nigeria;176;0;57613;1100
2020-09-23;NG;Nigeria;111;2;57724;1102
2020-09-24;NG;Nigeria;125;0;57849;1102
2020-09-25;NG;Nigeria;213;1;58062;1103
2020-09-26;NG;Nigeria;136;3;58198;1106
2020-09-27;NG;Nigeria;126;2;58324;1108
2020-09-28;NG;Nigeria;136;3;58460;1111
2020-09-29;NG;Nigeria;187;0;58647;1111
2020-09-30;NG;Nigeria;201;1;58848;1112
2020-10-01;NG;Nigeria;153;0;59001;1112
2020-10-02;NG;Nigeria;126;0;59127;1112
2020-10-03;NG;Nigeria;160;1;59287;1113
2020-10-04;NG;Nigeria;58;0;59345;1113
2020-10-05;NG;Nigeria;120;0;59465;1113
2020-10-06;NG;Nigeria;118;0;59583;1113
2020-10-07;NG;Nigeria;155;0;59738;1113
2020-10-08;NG;Nigeria;103;0;59841;1113
2020-10-09;NG;Nigeria;151;0;59992;1113
2020-10-10;NG;Nigeria;111;2;60103;1115
2020-10-11;NG;Nigeria;163;0;60266;1115
2020-10-12;NG;Nigeria;164;0;60430;1115
2020-10-13;NG;Nigeria;225;1;60655;1116
2020-10-14;NG;Nigeria;179;0;60834;1116
2020-10-15;NG;Nigeria;148;0;60982;1116
2020-10-16;NG;Nigeria;212;3;61194;1119
2020-10-17;NG;Nigeria;113;4;61307;1123
2020-10-18;NG;Nigeria;133;2;61440;1125
2020-10-19;NG;Nigeria;118;0;61558;1125
2020-10-20;NG;Nigeria;72;0;61630;1125
2020-10-21;NG;Nigeria;37;0;61667;1125
2020-10-22;NG;Nigeria;138;2;61805;1127
2020-10-23;NG;Nigeria;77;2;61882;1129
2020-10-24;NG;Nigeria;48;0;61930;1129
2020-10-25;NG;Nigeria;62;1;61992;1130
2020-10-26;NG;Nigeria;119;2;62111;1132
2020-10-27;NG;Nigeria;113;3;62224;1135
2020-10-28;NG;Nigeria;147;4;62371;1139
2020-10-29;NG;Nigeria;150;2;62521;1141
2020-10-30;NG;Nigeria;170;3;62691;1144
2020-10-31;NG;Nigeria;162;0;62853;1144
2020-11-01;NG;Nigeria;111;2;62964;1146
2020-11-02;NG;Nigeria;72;1;63036;1147
2020-11-03;NG;Nigeria;137;4;63173;1151
2020-11-04;NG;Nigeria;155;4;63328;1155
2020-11-05;NG;Nigeria;180;0;63508;1155
2020-11-06;NG;Nigeria;223;0;63731;1155
2020-11-07;NG;Nigeria;59;0;63790;1155
2020-11-08;NG;Nigeria;300;-1;64090;1154
2020-11-09;NG;Nigeria;94;4;64184;1158
2020-11-10;NG;Nigeria;152;2;64336;1160
2020-11-11;NG;Nigeria;180;2;64516;1162
2020-11-12;NG;Nigeria;212;0;64728;1162
2020-11-13;NG;Nigeria;156;1;64884;1163
2020-11-14;NG;Nigeria;112;0;64996;1163
2020-11-15;NG;Nigeria;152;0;65148;1163
2020-11-16;NG;Nigeria;157;0;65305;1163
2020-11-17;NG;Nigeria;152;0;65457;1163
2020-11-18;NG;Nigeria;236;0;65693;1163
2020-11-19;NG;Nigeria;146;2;65839;1165
2020-11-20;NG;Nigeria;143;0;65982;1165
2020-11-21;NG;Nigeria;246;1;66228;1166
2020-11-22;NG;Nigeria;155;1;66383;1167
2020-11-23;NG;Nigeria;56;1;66439;1168
2020-11-24;NG;Nigeria;168;1;66607;1169
2020-11-25;NG;Nigeria;198;0;66805;1169
2020-11-26;NG;Nigeria;169;0;66974;1169
2020-11-27;NG;Nigeria;246;2;67220;1171
2020-11-28;NG;Nigeria;110;0;67330;1171
2020-11-29;NG;Nigeria;82;2;67412;1173
2020-11-30;NG;Nigeria;145;0;67557;1173
2020-12-01;NG;Nigeria;281;3;67838;1176
2020-12-02;NG;Nigeria;122;1;67960;1177
2020-12-03;NG;Nigeria;343;2;68303;1179
2020-12-04;NG;Nigeria;324;0;68627;1179
2020-12-05;NG;Nigeria;310;1;68937;1180
2020-12-06;NG;Nigeria;318;0;69255;1180
2020-12-07;NG;Nigeria;390;1;69645;1181
2020-12-08;NG;Nigeria;550;1;70195;1182
2020-12-09;NG;Nigeria;474;2;70669;1184
2020-12-10;NG;Nigeria;675;6;71344;1190
2020-12-11;NG;Nigeria;796;0;72140;1190
2020-12-12;NG;Nigeria;617;4;72757;1194
2020-12-13;NG;Nigeria;418;3;73175;1197
2020-12-14;NG;Nigeria;199;0;73374;1197
2020-12-15;NG;Nigeria;758;3;74132;1200
2020-12-16;NG;Nigeria;930;0;75062;1200
2020-12-17;NG;Nigeria;1145;1;76207;1201
2020-12-18;NG;Nigeria;806;11;77013;1212
2020-12-19;NG;Nigeria;920;6;77933;1218
2020-12-20;NG;Nigeria;501;3;78434;1221
2020-12-21;NG;Nigeria;356;6;78790;1227
2020-12-22;NG;Nigeria;999;4;79789;1231
2020-12-23;NG;Nigeria;1133;5;80922;1236
2020-12-24;NG;Nigeria;1041;6;81963;1242
2020-12-25;NG;Nigeria;784;4;82747;1246
2020-12-26;NG;Nigeria;829;1;83576;1247
2020-12-27;NG;Nigeria;838;7;84414;1254
2020-12-28;NG;Nigeria;397;10;84811;1264
2020-12-29;NG;Nigeria;749;3;85560;1267
2020-12-30;NG;Nigeria;1016;11;86576;1278
2020-12-31;NG;Nigeria;1031;11;87607;1289
2021-01-01;NG;Nigeria;980;5;88587;1294
2021-01-02;NG;Nigeria;576;8;89163;1302
2021-01-03;NG;Nigeria;917;9;90080;1311
2021-01-04;NG;Nigeria;1271;7;91351;1318
2021-01-05;NG;Nigeria;1354;1;92705;1319
2021-01-06;NG;Nigeria;1664;5;94369;1324
2021-01-07;NG;Nigeria;1565;6;95934;1330
2021-01-08;NG;Nigeria;1544;12;97478;1342
2021-01-09;NG;Nigeria;1585;8;99063;1350
2021-01-10;NG;Nigeria;1024;8;100087;1358
2021-01-11;NG;Nigeria;1244;3;101331;1361
2021-01-12;NG;Nigeria;1270;12;102601;1373
2021-01-13;NG;Nigeria;1398;9;103999;1382
2021-01-14;NG;Nigeria;1479;23;105478;1405
2021-01-15;NG;Nigeria;1867;8;107345;1413
2021-01-16;NG;Nigeria;1598;7;108943;1420
2021-01-17;NG;Nigeria;1444;15;110387;1435
2021-01-18;NG;Nigeria;1617;14;112004;1449
2021-01-19;NG;Nigeria;1301;15;113305;1464
2021-01-20;NG;Nigeria;1386;14;114691;1478
2021-01-21;NG;Nigeria;1964;7;116655;1485
2021-01-22;NG;Nigeria;1483;5;118138;1490
2021-01-23;NG;Nigeria;2464;12;120602;1502
2021-01-24;NG;Nigeria;964;2;121566;1504
2021-01-25;NG;Nigeria;1430;3;122996;1507
2021-01-26;NG;Nigeria;1303;15;124299;1522
2021-01-27;NG;Nigeria;1861;21;126160;1543
2021-01-28;NG;Nigeria;864;4;127024;1547
2021-01-29;NG;Nigeria;1650;30;128674;1577
2021-01-30;NG;Nigeria;1883;1;130557;1578
2021-01-31;NG;Nigeria;685;8;131242;1586
2021-02-01;NG;Nigeria;676;21;131918;1607
2021-02-02;NG;Nigeria;1634;6;133552;1613
2021-02-03;NG;Nigeria;1138;5;134690;1618
2021-02-04;NG;Nigeria;1340;14;136030;1632
2021-02-05;NG;Nigeria;1624;9;137654;1641
2021-02-06;NG;Nigeria;1588;6;139242;1647
2021-02-07;NG;Nigeria;506;20;139748;1667
2021-02-08;NG;Nigeria;643;6;140391;1673
2021-02-09;NG;Nigeria;1056;21;141447;1694
2021-02-10;NG;Nigeria;1131;8;142578;1702
2021-02-11;NG;Nigeria;938;8;143516;1710
2021-02-12;NG;Nigeria;1005;24;144521;1734
2021-02-13;NG;Nigeria;1143;13;145664;1747
2021-02-14;NG;Nigeria;520;5;146184;1752
2021-02-15;NG;Nigeria;744;9;146928;1761
2021-02-16;NG;Nigeria;1368;16;148296;1777
2021-02-17;NG;Nigeria;1073;10;149369;1787
2021-02-18;NG;Nigeria;877;16;150246;1803
2021-02-19;NG;Nigeria;662;10;150908;1813
2021-02-20;NG;Nigeria;645;18;151553;1831
2021-02-21;NG;Nigeria;521;8;152074;1839
2021-02-22;NG;Nigeria;542;23;152616;1862
2021-02-23;NG;Nigeria;571;12;153187;1874
2021-02-24;NG;Nigeria;655;11;153842;1885
2021-02-25;NG;Nigeria;634;6;154476;1891
2021-02-26;NG;Nigeria;600;11;155076;1902
2021-02-27;NG;Nigeria;341;3;155417;1905
2021-02-28;NG;Nigeria;240;2;155657;1907
2021-03-01;NG;Nigeria;360;8;156017;1915
2021-03-02;NG;Nigeria;479;8;156496;1923
2021-03-03;NG;Nigeria;464;16;156960;1939
2021-03-04;NG;Nigeria;711;12;157671;1951
2021-03-05;NG;Nigeria;371;3;158042;1954
2021-03-06;NG;Nigeria;195;10;158237;1964
2021-03-07;NG;Nigeria;269;5;158506;1969
2021-03-08;NG;Nigeria;400;13;158906;1982
2021-03-09;NG;Nigeria;346;6;159252;1988
2021-03-10;NG;Nigeria;394;5;159646;1993
2021-03-11;NG;Nigeria;287;8;159933;2001
2021-03-12;NG;Nigeria;399;8;160332;2009
2021-03-13;NG;Nigeria;205;4;160537;2013
2021-03-14;NG;Nigeria;120;0;160657;2013
2021-03-15;NG;Nigeria;238;3;160895;2016
2021-03-16;NG;Nigeria;179;2;161074;2018
2021-03-17;NG;Nigeria;187;9;161261;2027
2021-03-18;NG;Nigeria;148;0;161409;2027
2021-03-19;NG;Nigeria;130;0;161539;2027
2021-03-20;NG;Nigeria;112;3;161651;2030
2021-03-21;NG;Nigeria;86;0;161737;2030
2021-03-22;NG;Nigeria;131;0;161868;2030
2021-03-23;NG;Nigeria;208;1;162076;2031
2021-03-24;NG;Nigeria;102;0;162178;2031
2021-03-25;NG;Nigeria;97;5;162275;2036
2021-03-26;NG;Nigeria;113;3;162388;2039
2021-03-27;NG;Nigeria;101;2;162489;2041
2021-03-28;NG;Nigeria;104;7;162593;2048
2021-03-29;NG;Nigeria;48;1;162641;2049
2021-03-30;NG;Nigeria;121;7;162762;2056
2021-03-31;NG;Nigeria;129;1;162891;2057
2021-04-01;NG;Nigeria;106;1;162997;2058
2021-04-02;NG;Nigeria;66;0;163063;2058
2021-04-03;NG;Nigeria;50;0;163113;2058
2021-04-04;NG;Nigeria;82;0;163195;2058
2021-04-05;NG;Nigeria;135;0;163330;2058
2021-04-06;NG;Nigeria;58;0;163388;2058
2021-04-07;NG;Nigeria;110;0;163498;2058
2021-04-08;NG;Nigeria;83;0;163581;2058
2021-04-09;NG;Nigeria;71;1;163652;2059
2021-04-10;NG;Nigeria;84;1;163736;2060
2021-04-11;NG;Nigeria;63;0;163799;2060
2021-04-12;NG;Nigeria;38;1;163837;2061
2021-04-13;NG;Nigeria;74;0;163911;2061
2021-04-14;NG;Nigeria;89;0;164000;2061
2021-04-15;NG;Nigeria;80;0;164080;2061
2021-04-16;NG;Nigeria;67;0;164147;2061
2021-04-17;NG;Nigeria;60;0;164207;2061
2021-04-18;NG;Nigeria;26;0;164233;2061
2021-04-19;NG;Nigeria;70;0;164303;2061
2021-04-20;NG;Nigeria;120;0;164423;2061
2021-04-21;NG;Nigeria;65;0;164488;2061
2021-04-22;NG;Nigeria;100;0;164588;2061
2021-04-23;NG;Nigeria;45;0;164633;2061
2021-04-24;NG;Nigeria;51;0;164684;2061
2021-04-25;NG;Nigeria;35;1;164719;2062
2021-04-26;NG;Nigeria;37;0;164756;2062
2021-04-27;NG;Nigeria;156;1;164912;2063
2021-04-28;NG;Nigeria;81;0;164993;2063
2021-04-29;NG;Nigeria;62;0;165055;2063
2021-04-30;NG;Nigeria;55;0;165110;2063
2021-05-01;NG;Nigeria;0;0;165110;2063
2021-05-02;NG;Nigeria;43;0;165153;2063
2021-05-03;NG;Nigeria;46;0;165199;2063
2021-05-04;NG;Nigeria;16;0;165215;2063
2021-05-05;NG;Nigeria;58;2;165273;2065
2021-05-06;NG;Nigeria;28;0;165301;2065
2021-05-07;NG;Nigeria;39;0;165340;2065
2021-05-08;NG;Nigeria;30;0;165370;2065
2021-05-09;NG;Nigeria;49;0;165419;2065
2021-05-10;NG;Nigeria;49;0;165468;2065
2021-05-11;NG;Nigeria;47;0;165515;2065
2021-05-12;NG;Nigeria;44;1;165559;2066
2021-05-13;NG;Nigeria;53;0;165612;2066
2021-05-14;NG;Nigeria;49;0;165661;2066
2021-05-15;NG;Nigeria;41;0;165702;2066
2021-05-16;NG;Nigeria;7;0;165709;2066
2021-05-17;NG;Nigeria;69;1;165778;2067
2021-05-18;NG;Nigeria;0;0;165778;2067
2021-05-19;NG;Nigeria;74;0;165852;2067
2021-05-20;NG;Nigeria;49;0;165901;2067
2021-05-21;NG;Nigeria;43;0;165944;2067
2021-05-22;NG;Nigeria;35;0;165979;2067
2021-05-23;NG;Nigeria;40;0;166019;2067
2021-05-24;NG;Nigeria;42;0;166061;2067
2021-05-25;NG;Nigeria;37;4;166098;2071
2021-05-26;NG;Nigeria;48;0;166146;2071
2021-05-27;NG;Nigeria;45;0;166191;2071
2021-05-28;NG;Nigeria;63;0;166254;2071
2021-05-29;NG;Nigeria;31;0;166285;2071
2021-05-30;NG;Nigeria;30;0;166315;2071
2021-05-31;NG;Nigeria;203;28;166518;2099
2021-06-01;NG;Nigeria;16;0;166534;2099
2021-06-02;NG;Nigeria;26;0;166560;2099
2021-06-03;NG;Nigeria;122;18;166682;2117
2021-06-04;NG;Nigeria;48;0;166730;2117
2021-06-05;NG;Nigeria;26;0;166756;2117
2021-06-06;NG;Nigeria;11;0;166767;2117
2021-06-07;NG;Nigeria;49;0;166816;2117
2021-06-08;NG;Nigeria;102;0;166918;2117
2021-06-09;NG;Nigeria;64;0;166982;2117
2021-06-10;NG;Nigeria;0;0;166982;2117
2021-06-11;NG;Nigeria;69;0;167051;2117
2021-06-12;NG;Nigeria;8;0;167059;2117
2021-06-13;NG;Nigeria;7;0;167066;2117
2021-06-14;NG;Nigeria;12;0;167078;2117
2021-06-15;NG;Nigeria;17;0;167095;2117
2021-06-16;NG;Nigeria;8;0;167103;2117
2021-06-17;NG;Nigeria;39;0;167142;2117
2021-06-18;NG;Nigeria;13;0;167155;2117
2021-06-19;NG;Nigeria;51;0;167206;2117
2021-06-20;NG;Nigeria;0;0;167206;2117
2021-06-21;NG;Nigeria;86;1;167292;2118
2021-06-22;NG;Nigeria;39;0;167331;2118
2021-06-23;NG;Nigeria;44;0;167375;2118
2021-06-24;NG;Nigeria;26;0;167401;2118
2021-06-25;NG;Nigeria;29;1;167430;2119
2021-06-26;NG;Nigeria;35;0;167465;2119
2021-06-27;NG;Nigeria;2;0;167467;2119
2021-06-28;NG;Nigeria;65;0;167532;2119
2021-06-29;NG;Nigeria;11;1;167543;2120
2021-06-30;NG;Nigeria;75;0;167618;2120
2021-07-01;NG;Nigeria;74;1;167692;2121
2020-01-22;;North America;0;0;1;0
2020-01-23;;North America;0;0;1;0
2020-01-24;;North America;1;0;2;0
2020-01-25;;North America;0;0;2;0
2020-01-26;;North America;4;0;6;0
2020-01-27;;North America;0;0;6;0
2020-01-28;;North America;1;0;7;0
2020-01-29;;North America;1;0;8;0
2020-01-30;;North America;0;0;8;0
2020-01-31;;North America;4;0;12;0
2020-02-01;;North America;0;0;12;0
2020-02-02;;North America;0;0;12;0
2020-02-03;;North America;3;0;15;0
2020-02-04;;North America;0;0;15;0
2020-02-05;;North America;1;0;16;0
2020-02-06;;North America;1;0;17;0
2020-02-07;;North America;2;0;19;0
2020-02-08;;North America;0;0;19;0
2020-02-09;;North America;0;0;19;0
2020-02-10;;North America;0;0;19;0
2020-02-11;;North America;1;0;20;0
2020-02-12;;North America;0;0;20;0
2020-02-13;;North America;1;0;21;0
2020-02-14;;North America;0;0;21;0
2020-02-15;;North America;0;0;21;0
2020-02-16;;North America;0;0;21;0
2020-02-17;;North America;1;0;22;0
2020-02-18;;North America;0;0;22;0
2020-02-19;;North America;0;0;22;0
2020-02-20;;North America;0;0;22;0
2020-02-21;;North America;3;0;25;0
2020-02-22;;North America;0;0;25;0
2020-02-23;;North America;0;0;25;0
2020-02-24;;North America;1;0;26;0
2020-02-25;;North America;1;0;27;0
2020-02-26;;North America;0;0;27;0
2020-02-27;;North America;3;0;30;0
2020-02-28;;North America;2;0;32;0
2020-02-29;;North America;17;1;49;1
2020-03-01;;North America;13;0;62;1
2020-03-02;;North America;26;5;88;6
2020-03-03;;North America;22;1;110;7
2020-03-04;;North America;36;4;146;11
2020-03-05;;North America;81;1;227;12
2020-03-06;;North America;68;2;295;14
2020-03-07;;North America;171;3;466;17
2020-03-08;;North America;134;4;600;21
2020-03-09;;North America;92;2;692;23
2020-03-10;;North America;191;6;883;29
2020-03-11;;North America;409;6;1292;35
2020-03-12;;North America;468;10;1760;45
2020-03-13;;North America;748;8;2508;53
2020-03-14;;North America;802;7;3310;60
2020-03-15;;North America;312;12;3622;72
2020-03-16;;North America;1686;31;5308;103
2020-03-17;;North America;1949;40;7257;143
2020-03-18;;North America;2893;66;10150;209
2020-03-19;;North America;4759;76;14909;285
2020-03-20;;North America;6658;111;21567;396
2020-03-21;;North America;6563;108;28130;504
2020-03-22;;North America;9382;131;37512;635
2020-03-23;;North America;12026;202;49538;837
2020-03-24;;North America;11471;251;61009;1088
2020-03-25;;North America;12853;351;73862;1439
2020-03-26;;North America;19053;437;92915;1876
2020-03-27;;North America;19743;548;112658;2424
2020-03-28;;North America;21031;685;133689;3109
2020-03-29;;North America;20084;650;153773;3759
2020-03-30;;North America;23532;765;177305;4524
2020-03-31;;North America;28016;1131;205321;5655
2020-04-01;;North America;33761;1329;239082;6984
2020-04-02;;North America;34444;1586;273526;8570
2020-04-03;;North America;33990;1507;307516;10077
2020-04-04;;North America;33453;1679;340969;11756
2020-04-05;;North America;33385;1735;374354;13491
2020-04-06;;North America;32864;1907;407218;15398
2020-04-07;;North America;32782;2669;440000;18067
2020-04-08;;North America;33325;2281;473325;20348
2020-04-09;;North America;38390;2374;511715;22722
2020-04-10;;North America;36869;2346;548584;25068
2020-04-11;;North America;31189;2304;579773;27372
2020-04-12;;North America;29253;2053;609026;29425
2020-04-13;;North America;29142;2196;638168;31621
2020-04-14;;North America;30841;2672;669009;34293
2020-04-15;;North America;27605;2822;696614;37115
2020-04-16;;North America;33487;2416;730101;39531
2020-04-17;;North America;36401;2323;766502;41854
2020-04-18;;North America;30615;2250;797117;44104
2020-04-19;;North America;28625;2187;825742;46291
2020-04-20;;North America;32998;2426;858740;48717
2020-04-21;;North America;28765;2866;887505;51583
2020-04-22;;North America;32771;2796;920276;54379
2020-04-23;;North America;37100;2751;957376;57130
2020-04-24;;North America;35795;2544;993171;59674
2020-04-25;;North America;33354;2008;1026525;61682
2020-04-26;;North America;29568;1624;1056093;63306
2020-04-27;;North America;26678;1798;1082771;65104
2020-04-28;;North America;27577;2566;1110348;67670
2020-04-29;;North America;29985;2840;1140333;70510
2020-04-30;;North America;32858;2522;1173191;73032
2020-05-01;;North America;38972;2254;1212163;75286
2020-05-02;;North America;31333;1991;1243496;77277
2020-05-03;;North America;28819;1447;1272315;78724
2020-05-04;;North America;27583;1772;1299898;80496
2020-05-05;;North America;27676;2651;1327574;83147
2020-05-06;;North America;28508;2692;1356082;85839
2020-05-07;;North America;31704;2360;1387786;88199
2020-05-08;;North America;30923;2128;1418709;90327
2020-05-09;;North America;29286;1833;1447995;92160
2020-05-10;;North America;22556;1233;1470551;93393
2020-05-11;;North America;22525;1305;1493076;94698
2020-05-12;;North America;26674;2127;1519750;96825
2020-05-13;;North America;24315;2142;1544065;98967
2020-05-14;;North America;31098;2192;1575163;101159
2020-05-15;;North America;29323;2090;1604486;103249
2020-05-16;;North America;28404;1616;1632890;104865
2020-05-17;;North America;22166;1061;1655056;105926
2020-05-18;;North America;26849;1486;1681905;107412
2020-05-19;;North America;26227;1896;1708132;109308
2020-05-20;;North America;26740;2060;1734872;111368
2020-05-21;;North America;30900;1723;1765772;113091
2020-05-22;;North America;28979;1826;1794751;114917
2020-05-23;;North America;26884;1383;1821635;116300
2020-05-24;;North America;25565;969;1847200;117269
2020-05-25;;North America;23417;940;1870617;118209
2020-05-26;;North America;25611;1312;1896228;119521
2020-05-27;;North America;24299;2042;1920527;121563
2020-05-28;;North America;27976;1682;1948503;123245
2020-05-29;;North America;30042;1604;1978545;124849
2020-05-30;;North America;28919;1415;2007464;126264
2020-05-31;;North America;24509;844;2031973;127108
2020-06-01;;North America;22478;1088;2054451;128196
2020-06-02;;North America;27641;1559;2082092;129755
2020-06-03;;North America;25811;2193;2107903;131948
2020-06-04;;North America;28433;1924;2136336;133872
2020-06-05;;North America;31875;1632;2168211;135504
2020-06-06;;North America;26980;1088;2195191;136592
2020-06-07;;North America;23817;728;2219008;137320
2020-06-08;;North America;23012;936;2242020;138256
2020-06-09;;North America;25301;1592;2267321;139848
2020-06-10;;North America;28685;1692;2296006;141540
2020-06-11;;North America;30684;1491;2326690;143031
2020-06-12;;North America;32899;1403;2359589;144434
2020-06-13;;North America;31721;1239;2391310;145673
2020-06-14;;North America;26143;677;2417453;146350
2020-06-15;;North America;25052;898;2442505;147248
2020-06-16;;North America;31142;1627;2473647;148875
2020-06-17;;North America;34992;1587;2508639;150462
2020-06-18;;North America;37271;1407;2545910;151869
2020-06-19;;North America;39930;1367;2585840;153236
2020-06-20;;North America;40849;1039;2626689;154275
2020-06-21;;North America;33675;1426;2660364;155701
2020-06-22;;North America;40040;1271;2700404;156972
2020-06-23;;North America;46940;1647;2747344;158619
2020-06-24;;North America;44291;1778;2791635;160397
2020-06-25;;North America;50428;1360;2842063;161757
2020-06-26;;North America;54380;1483;2896443;163240
2020-06-27;;North America;49657;1199;2946100;164439
2020-06-28;;North America;49038;646;2995138;165085
2020-06-29;;North America;48886;938;3044024;166023
2020-06-30;;North America;56001;1305;3100025;167328
2020-07-01;;North America;61737;1572;3161762;168900
2020-07-02;;North America;67824;1523;3229586;170423
2020-07-03;;North America;62974;1436;3292560;171859
2020-07-04;;North America;57494;954;3350054;172813
2020-07-05;;North America;60600;681;3410654;173494
2020-07-06;;North America;52337;967;3462991;174461
2020-07-07;;North America;70878;2167;3533869;176628
2020-07-08;;North America;71376;1718;3605245;178346
2020-07-09;;North America;74929;1854;3680174;180200
2020-07-10;;North America;79804;1647;3759978;181847
2020-07-11;;North America;70811;1386;3830789;183233
2020-07-12;;North America;67782;849;3898571;184082
2020-07-13;;North America;68463;1025;3967034;185107
2020-07-14;;North America;79968;1902;4047002;187009
2020-07-15;;North America;80084;1687;4127086;188696
2020-07-16;;North America;87608;1745;4214694;190441
2020-07-17;;North America;84822;1789;4299516;192230
2020-07-18;;North America;78956;1564;4378472;193794
2020-07-19;;North America;71247;885;4449719;194679
2020-07-20;;North America;72152;976;4521871;195655
2020-07-21;;North America;76329;2146;4598200;197801
2020-07-22;;North America;81606;2123;4679806;199924
2020-07-23;;North America;83116;1911;4762922;201835
2020-07-24;;North America;87036;2019;4849958;203854
2020-07-25;;North America;78257;1798;4928215;205652
2020-07-26;;North America;66599;939;4994814;206591
2020-07-27;;North America;66700;1627;5061514;208218
2020-07-28;;North America;78456;2337;5139970;210555
2020-07-29;;North America;83242;2068;5223212;212623
2020-07-30;;North America;80835;2037;5304047;214660
2020-07-31;;North America;83161;2071;5387208;216731
2020-08-01;;North America;71651;1996;5458859;218727
2020-08-02;;North America;54695;807;5513554;219534
2020-08-03;;North America;54116;931;5567670;220465
2020-08-04;;North America;70268;2269;5637938;222734
2020-08-05;;North America;66253;2395;5704191;225129
2020-08-06;;North America;71070;2208;5775261;227337
2020-08-07;;North America;72005;2164;5847266;229501
2020-08-08;;North America;65959;1889;5913225;231390
2020-08-09;;North America;54123;929;5967348;232319
2020-08-10;;North America;57540;1440;6024888;233759
2020-08-11;;North America;59596;2035;6084484;235794
2020-08-12;;North America;66731;2362;6151215;238156
2020-08-13;;North America;64507;1797;6215722;239953
2020-08-14;;North America;76602;2064;6292324;242017
2020-08-15;;North America;58674;1733;6350998;243750
2020-08-16;;North America;47930;921;6398928;244671
2020-08-17;;North America;43430;847;6442358;245518
2020-08-18;;North America;54857;2079;6497215;247597
2020-08-19;;North America;58476;2160;6555691;249757
2020-08-20;;North America;54975;1825;6610666;251582
2020-08-21;;North America;60029;1707;6670695;253289
2020-08-22;;North America;54460;1673;6725155;254962
2020-08-23;;North America;42669;846;6767824;255808
2020-08-24;;North America;44261;904;6812085;256712
2020-08-25;;North America;50163;1981;6862248;258693
2020-08-26;;North America;55337;1933;6917585;260626
2020-08-27;;North America;56771;1769;6974356;262395
2020-08-28;;North America;58205;1654;7032561;264049
2020-08-29;;North America;53447;1689;7086008;265738
2020-08-30;;North America;41286;837;7127294;266575
2020-08-31;;North America;44523;899;7171817;267474
2020-09-01;;North America;52587;1961;7224404;269435
2020-09-02;;North America;50871;1761;7275275;271196
2020-09-03;;North America;55651;1674;7330926;272870
2020-09-04;;North America;60745;1567;7391671;274437
2020-09-05;;North America;55529;1363;7447200;275800
2020-09-06;;North America;38362;741;7485562;276541
2020-09-07;;North America;31103;626;7516665;277167
2020-09-08;;North America;38136;1269;7554801;278436
2020-09-09;;North America;43563;1806;7598364;280242
2020-09-10;;North America;45964;1612;7644328;281854
2020-09-11;;North America;58397;1776;7702725;283630
2020-09-12;;North America;52638;1206;7755363;284836
2020-09-13;;North America;41760;698;7797123;285534
2020-09-14;;North America;43634;761;7840757;286295
2020-09-15;;North America;48231;1898;7888988;288193
2020-09-16;;North America;48881;1352;7937869;289545
2020-09-17;;North America;53740;1169;7991609;290714
2020-09-18;;North America;59992;1649;8051601;292363
2020-09-19;;North America;52867;1307;8104468;293670
2020-09-20;;North America;45697;567;8150165;294237
2020-09-21;;North America;60922;733;8211087;294970
2020-09-22;;North America;49671;1754;8260758;296724
2020-09-23;;North America;49424;1748;8310182;298472
2020-09-24;;North America;57838;1478;8368020;299950
2020-09-25;;North America;60082;1445;8428102;301395
2020-09-26;;North America;55476;1265;8483578;302660
2020-09-27;;North America;44561;546;8528139;303206
2020-09-28;;North America;42799;620;8570938;303826
2020-09-29;;North America;53236;1495;8624174;305321
2020-09-30;;North America;51024;1553;8675198;306874
2020-10-01;;North America;56580;1401;8731778;308275
2020-10-02;;North America;65984;1436;8797762;309711
2020-10-03;;North America;59013;1171;8856775;310882
2020-10-04;;North America;44234;686;8901009;311568
2020-10-05;;North America;74520;3378;8975529;314946
2020-10-06;;North America;56389;1245;9031918;316191
2020-10-07;;North America;61744;1414;9093662;317605
2020-10-08;;North America;70858;1443;9164520;319048
2020-10-09;;North America;69098;1449;9233618;320497
2020-10-10;;North America;66029;897;9299647;321394
2020-10-11;;North America;53490;667;9353137;322061
2020-10-12;;North America;49848;648;9402985;322709
2020-10-13;;North America;63681;1376;9466666;324085
2020-10-14;;North America;71242;1548;9537908;325633
2020-10-15;;North America;77247;1346;9615155;326979
2020-10-16;;North America;82480;1470;9697635;328449
2020-10-17;;North America;66628;1211;9764263;329660
2020-10-18;;North America;59916;666;9824179;330326
2020-10-19;;North America;78575;755;9902754;331081
2020-10-20;;North America;73733;1544;9976487;332625
2020-10-21;;North America;77072;1752;10053559;334377
2020-10-22;;North America;89704;996;10143263;335373
2020-10-23;;North America;94519;1935;10237782;337308
2020-10-24;;North America;95677;1475;10333459;338783
2020-10-25;;North America;71676;733;10405135;339516
2020-10-26;;North America;78960;882;10484095;340398
2020-10-27;;North America;89091;1706;10573186;342104
2020-10-28;;North America;92051;1636;10665237;343740
2020-10-29;;North America;103988;1578;10769225;345318
2020-10-30;;North America;113232;1681;10882457;346999
2020-10-31;;North America;101900;1486;10984357;348485
2020-11-01;;North America;114590;710;11098947;349195
2020-11-02;;North America;95250;867;11194197;350062
2020-11-03;;North America;140223;2196;11334420;352258
2020-11-04;;North America;116153;1860;11450573;354118
2020-11-05;;North America;141383;1802;11591956;355920
2020-11-06;;North America;143318;1909;11735274;357829
2020-11-07;;North America;142165;1665;11877439;359494
2020-11-08;;North America;127155;878;12004594;360372
2020-11-09;;North America;133697;1106;12138291;361478
2020-11-10;;North America;154762;2162;12293053;363640
2020-11-11;;North America;162349;2143;12455402;365783
2020-11-12;;North America;179802;1956;12635204;367739
2020-11-13;;North America;195671;1913;12830875;369652
2020-11-14;;North America;182324;2120;13013199;371772
2020-11-15;;North America;146873;1158;13160072;372930
2020-11-16;;North America;175053;1292;13335125;374222
2020-11-17;;North America;174095;1998;13509220;376220
2020-11-18;;North America;185687;2623;13694907;378843
2020-11-19;;North America;205356;2788;13900263;381631
2020-11-20;;North America;213837;2805;14114100;384436
2020-11-21;;North America;195363;2280;14309463;386716
2020-11-22;;North America;163428;1420;14472891;388136
2020-11-23;;North America;193774;1517;14666665;389653
2020-11-24;;North America;195215;3103;14861880;392756
2020-11-25;;North America;203902;3241;15065782;395997
2020-11-26;;North America;132546;2183;15198328;398180
2020-11-27;;North America;230928;2331;15429256;400511
2020-11-28;;North America;176130;2067;15605386;402578
2020-11-29;;North America;154452;1356;15759838;403934
2020-11-30;;North America;179724;1818;15939562;405752
2020-12-01;;North America;206148;3497;16145710;409249
2020-12-02;;North America;226619;3781;16372329;413030
2020-12-03;;North America;247512;3736;16619841;416766
2020-12-04;;North America;256725;3561;16876566;420327
2020-12-05;;North America;238484;3079;17115050;423406
2020-12-06;;North America;199417;1745;17314467;425151
2020-12-07;;North America;214202;2191;17528669;427342
2020-12-08;;North America;247065;3595;17775734;430937
2020-12-09;;North America;247314;4165;18023048;435102
2020-12-10;;North America;256922;3885;18279970;438987
2020-12-11;;North America;265129;4311;18545099;443298
2020-12-12;;North America;241364;3324;18786463;446622
2020-12-13;;North America;207137;2025;18993600;448647
2020-12-14;;North America;213882;2253;19207482;450900
2020-12-15;;North America;232011;4152;19439493;455052
2020-12-16;;North America;270170;4557;19709663;459609
2020-12-17;;North America;265225;4494;19974888;464103
2020-12-18;;North America;277402;3940;20252290;468043
2020-12-19;;North America;216182;3459;20468472;471502
2020-12-20;;North America;206507;2224;20674979;473726
2020-12-21;;North America;217580;2559;20892559;476285
2020-12-22;;North America;223709;4551;21116268;480836
2020-12-23;;North America;254790;4484;21371058;485320
2020-12-24;;North America;220380;4007;21591438;489327
2020-12-25;;North America;115036;2228;21706474;491555
2020-12-26;;North America;238240;2228;21944714;493783
2020-12-27;;North America;176359;2018;22121073;495801
2020-12-28;;North America;193813;2726;22314886;498527
2020-12-29;;North America;229837;4937;22544723;503464
2020-12-30;;North America;263067;5031;22807790;508495
2020-12-31;;North America;263729;4587;23071519;513082
2021-01-01;;North America;172351;2982;23243870;516064
2021-01-02;;North America;314894;3027;23558764;519091
2021-01-03;;North America;233597;1998;23792361;521089
2021-01-04;;North America;209307;2996;24001668;524085
2021-01-05;;North America;260664;5018;24262332;529103
2021-01-06;;North America;286916;5342;24549248;534445
2021-01-07;;North America;308736;5315;24857984;539760
2021-01-08;;North America;327377;5453;25185361;545213
2021-01-09;;North America;294759;4704;25480120;549917
2021-01-10;;North America;236673;2700;25716793;552617
2021-01-11;;North America;238102;3013;25954895;555630
2021-01-12;;North America;257798;6105;26212693;561735
2021-01-13;;North America;262700;5560;26475393;567295
2021-01-14;;North America;267734;5280;26743127;572575
2021-01-15;;North America;278176;5271;27021303;577846
2021-01-16;;North America;236948;4877;27258251;582723
2021-01-17;;North America;201096;2584;27459347;585307
2021-01-18;;North America;165011;2371;27624358;587678
2021-01-19;;North America;208175;4603;27832533;592281
2021-01-20;;North America;216961;6272;28049494;598553
2021-01-21;;North America;229795;6271;28279289;604824
2021-01-22;;North America;224643;5594;28503932;610418
2021-01-23;;North America;202616;5052;28706548;615470
2021-01-24;;North America;151814;2625;28858362;618095
2021-01-25;;North America;171787;2889;29030149;620984
2021-01-26;;North America;175666;6025;29205815;627009
2021-01-27;;North America;183238;5822;29389053;632831
2021-01-28;;North America;198747;5850;29587800;638681
2021-01-29;;North America;194918;5331;29782718;644012
2021-01-30;;North America;168359;4526;29951077;648538
2021-01-31;;North America;128196;2506;30079273;651044
2021-02-01;;North America;149625;2863;30228898;653907
2021-02-02;;North America;128683;4083;30357581;657990
2021-02-03;;North America;144349;5875;30501930;663865
2021-02-04;;North America;134454;3999;30636384;667864
2021-02-05;;North America;171218;6981;30807602;674845
2021-02-06;;North America;126418;4386;30934020;679231
2021-02-07;;North America;103190;2023;31037210;681254
2021-02-08;;North America;103078;2353;31140288;683607
2021-02-09;;North America;113392;5012;31253680;688619
2021-02-10;;North America;115071;4831;31368751;693450
2021-02-11;;North America;125569;4922;31494320;698372
2021-02-12;;North America;118063;4416;31612383;702788
2021-02-13;;North America;105734;3576;31718117;706364
2021-02-14;;North America;74761;1705;31792878;708069
2021-02-15;;North America;63662;1552;31856540;709621
2021-02-16;;North America;80272;3257;31936812;712878
2021-02-17;;North America;86411;3615;32023223;716493
2021-02-18;;North America;87681;3769;32110904;720262
2021-02-19;;North America;95156;3648;32206060;723910
2021-02-20;;North America;86676;2788;32292736;726698
2021-02-21;;North America;66915;1670;32359651;728368
2021-02-22;;North America;66114;1911;32425765;730279
2021-02-23;;North America;88494;3668;32514259;733947
2021-02-24;;North America;91147;4323;32605406;738270
2021-02-25;;North America;93275;3466;32698681;741736
2021-02-26;;North America;92302;2965;32790983;744701
2021-02-27;;North America;78790;2438;32869773;747139
2021-02-28;;North America;59714;1644;32929487;748783
2021-03-01;;North America;68060;2061;32997547;750844
2021-03-02;;North America;72338;3098;33069885;753942
2021-03-03;;North America;82117;3485;33152002;757427
2021-03-04;;North America;82622;2878;33234624;760305
2021-03-05;;North America;79854;2593;33314478;762898
2021-03-06;;North America;71460;2364;33385938;765262
2021-03-07;;North America;50163;1034;33436101;766296
2021-03-08;;North America;54168;1156;33490269;767452
2021-03-09;;North America;72952;2794;33563221;770246
2021-03-10;;North America;72131;2371;33635352;772617
2021-03-11;;North America;76682;2313;33712034;774930
2021-03-12;;North America;77152;2372;33789186;777302
2021-03-13;;North America;65463;1722;33854649;779024
2021-03-14;;North America;46476;857;33901125;779881
2021-03-15;;North America;64924;1091;33966049;780972
2021-03-16;;North America;63684;1472;34029733;782444
2021-03-17;;North America;73645;2117;34103378;784561
2021-03-18;;North America;74806;2449;34178184;787010
2021-03-19;;North America;77330;1877;34255514;788887
2021-03-20;;North America;68846;1434;34324360;790321
2021-03-21;;North America;42291;725;34366651;791046
2021-03-22;;North America;60917;1024;34427568;792070
2021-03-23;;North America;68591;1791;34496159;793861
2021-03-24;;North America;100738;2175;34596897;796036
2021-03-25;;North America;82472;2073;34679369;798109
2021-03-26;;North America;93406;1922;34772775;800031
2021-03-27;;North America;75932;1439;34848707;801470
2021-03-28;;North America;52160;773;34900867;802243
2021-03-29;;North America;79187;996;34980054;803239
2021-03-30;;North America;75098;1787;35055152;805026
2021-03-31;;North America;84474;1772;35139626;806798
2021-04-01;;North America;94363;1624;35233989;808422
2021-04-02;;North America;79613;1204;35313602;809626
2021-04-03;;North America;75095;968;35388697;810594
2021-04-04;;North America;42670;493;35431367;811087
2021-04-05;;North America;89610;850;35520977;811937
2021-04-06;;North America;84015;1578;35604992;813515
2021-04-07;;North America;91547;3310;35696539;816825
2021-04-08;;North America;98369;1681;35794908;818506
2021-04-09;;North America;103936;1935;35898844;820441
2021-04-10;;North America;85203;2989;35984047;823430
2021-04-11;;North America;59821;524;36043868;823954
2021-04-12;;North America;84779;970;36128647;824924
2021-04-13;;North America;98006;1554;36226653;826478
2021-04-14;;North America;94957;1642;36321610;828120
2021-04-15;;North America;94764;1461;36416374;829581
2021-04-16;;North America;100181;1490;36516555;831071
2021-04-17;;North America;68616;1354;36585171;832425
2021-04-18;;North America;55256;547;36640427;832972
2021-04-19;;North America;85086;744;36725513;833716
2021-04-20;;North America;78388;1562;36803901;835278
2021-04-21;;North America;81269;1546;36885170;836824
2021-04-22;;North America;88645;1662;36973815;838486
2021-04-23;;North America;81649;1368;37055464;839854
2021-04-24;;North America;69936;1198;37125400;841052
2021-04-25;;North America;45150;512;37170550;841564
2021-04-26;;North America;62427;790;37232977;842354
2021-04-27;;North America;67029;1251;37300006;843605
2021-04-28;;North America;74435;1495;37374441;845100
2021-04-29;;North America;81198;1575;37455639;846675
2021-04-30;;North America;77739;1369;37533378;848044
2021-05-01;;North America;58548;1080;37591926;849124
2021-05-02;;North America;39050;486;37630976;849610
2021-05-03;;North America;71921;846;37702897;850456
2021-05-04;;North America;56471;1440;37759368;851896
2021-05-05;;North America;63100;1232;37822468;853128
2021-05-06;;North America;65402;1149;37887870;854277
2021-05-07;;North America;66277;1442;37954147;855719
2021-05-08;;North America;47464;1020;38001611;856739
2021-05-09;;North America;31399;385;38033010;857124
2021-05-10;;North America;55767;753;38088777;857877
2021-05-11;;North America;48814;1194;38137591;859071
2021-05-12;;North America;54792;1271;38192383;860342
2021-05-13;;North America;54761;1235;38247144;861577
2021-05-14;;North America;60757;1094;38307901;862671
2021-05-15;;North America;42937;873;38350838;863544
2021-05-16;;North America;26548;424;38377386;863968
2021-05-17;;North America;45442;659;38422828;864627
2021-05-18;;North America;42140;1246;38464968;865873
2021-05-19;;North America;44669;947;38509637;866820
2021-05-20;;North America;47023;1103;38556660;867923
2021-05-21;;North America;43779;972;38600439;868895
2021-05-22;;North America;30631;951;38631070;869846
2021-05-23;;North America;21351;321;38652421;870167
2021-05-24;;North America;37091;724;38689512;870891
2021-05-25;;North America;37309;1045;38726821;871936
2021-05-26;;North America;37928;1431;38764749;873367
2021-05-27;;North America;43538;1968;38808287;875335
2021-05-28;;North America;36927;1135;38845214;876470
2021-05-29;;North America;22036;831;38867250;877301
2021-05-30;;North America;14108;253;38881358;877554
2021-05-31;;North America;19327;469;38900685;878023
2021-06-01;;North America;39675;5060;38940360;883083
2021-06-02;;North America;30852;1028;38971212;884111
2021-06-03;;North America;33348;976;39004560;885087
2021-06-04;;North America;30009;909;39034569;885996
2021-06-05;;North America;23073;655;39057642;886651
2021-06-06;;North America;13037;299;39070679;886950
2021-06-07;;North America;26164;533;39096843;887483
2021-06-08;;North America;26322;778;39123165;888261
2021-06-09;;North America;32663;897;39155828;889158
2021-06-10;;North America;28213;792;39184041;889950
2021-06-11;;North America;38335;1038;39222376;890988
2021-06-12;;North America;20114;659;39242490;891647
2021-06-13;;North America;12059;254;39254549;891901
2021-06-14;;North America;23236;390;39277785;892291
2021-06-15;;North America;25667;689;39303452;892980
2021-06-16;;North America;25940;732;39329392;893712
2021-06-17;;North America;23377;545;39352769;894257
2021-06-18;;North America;34180;912;39386949;895169
2021-06-19;;North America;17547;349;39404496;895518
2021-06-20;;North America;14912;417;39419408;895935
2021-06-21;;North America;22595;519;39442003;896454
2021-06-22;;North America;23910;770;39465913;897224
2021-06-23;;North America;27575;908;39493488;898132
2021-06-24;;North America;28062;730;39521550;898862
2021-06-25;;North America;40534;957;39562084;899819
2021-06-26;;North America;20779;442;39582863;900261
2021-06-27;;North America;12861;210;39595724;900471
2021-06-28;;North America;27050;356;39622774;900827
2021-06-29;;North America;27948;749;39650722;901576
2021-06-30;;North America;28545;679;39679267;902255
2021-07-01;;North America;31411;680;39710678;902935
2020-02-26;MK;North Macedonia;1;0;1;0
2020-02-27;MK;North Macedonia;0;0;1;0
2020-02-28;MK;North Macedonia;0;0;1;0
2020-02-29;MK;North Macedonia;0;0;1;0
2020-03-01;MK;North Macedonia;0;0;1;0
2020-03-02;MK;North Macedonia;0;0;1;0
2020-03-03;MK;North Macedonia;0;0;1;0
2020-03-04;MK;North Macedonia;0;0;1;0
2020-03-05;MK;North Macedonia;0;0;1;0
2020-03-06;MK;North Macedonia;2;0;3;0
2020-03-07;MK;North Macedonia;0;0;3;0
2020-03-08;MK;North Macedonia;0;0;3;0
2020-03-09;MK;North Macedonia;0;0;3;0
2020-03-10;MK;North Macedonia;4;0;7;0
2020-03-11;MK;North Macedonia;0;0;7;0
2020-03-12;MK;North Macedonia;0;0;7;0
2020-03-13;MK;North Macedonia;7;0;14;0
2020-03-14;MK;North Macedonia;0;0;14;0
2020-03-15;MK;North Macedonia;0;0;14;0
2020-03-16;MK;North Macedonia;4;0;18;0
2020-03-17;MK;North Macedonia;8;0;26;0
2020-03-18;MK;North Macedonia;9;0;35;0
2020-03-19;MK;North Macedonia;13;0;48;0
2020-03-20;MK;North Macedonia;19;0;67;0
2020-03-21;MK;North Macedonia;18;0;85;0
2020-03-22;MK;North Macedonia;30;1;115;1
2020-03-23;MK;North Macedonia;21;1;136;2
2020-03-24;MK;North Macedonia;12;0;148;2
2020-03-25;MK;North Macedonia;29;1;177;3
2020-03-26;MK;North Macedonia;24;0;201;3
2020-03-27;MK;North Macedonia;18;0;219;3
2020-03-28;MK;North Macedonia;22;1;241;4
2020-03-29;MK;North Macedonia;18;2;259;6
2020-03-30;MK;North Macedonia;26;1;285;7
2020-03-31;MK;North Macedonia;44;2;329;9
2020-04-01;MK;North Macedonia;25;2;354;11
2020-04-02;MK;North Macedonia;30;0;384;11
2020-04-03;MK;North Macedonia;46;1;430;12
2020-04-04;MK;North Macedonia;53;5;483;17
2020-04-05;MK;North Macedonia;72;1;555;18
2020-04-06;MK;North Macedonia;15;5;570;23
2020-04-07;MK;North Macedonia;29;3;599;26
2020-04-08;MK;North Macedonia;18;3;617;29
2020-04-09;MK;North Macedonia;46;1;663;30
2020-04-10;MK;North Macedonia;48;2;711;32
2020-04-11;MK;North Macedonia;49;2;760;34
2020-04-12;MK;North Macedonia;68;0;828;34
2020-04-13;MK;North Macedonia;26;4;854;38
2020-04-14;MK;North Macedonia;54;6;908;44
2020-04-15;MK;North Macedonia;66;1;974;45
2020-04-16;MK;North Macedonia;107;1;1081;46
2020-04-17;MK;North Macedonia;36;3;1117;49
2020-04-18;MK;North Macedonia;53;0;1170;49
2020-04-19;MK;North Macedonia;37;2;1207;51
2020-04-20;MK;North Macedonia;18;3;1225;54
2020-04-21;MK;North Macedonia;6;1;1231;55
2020-04-22;MK;North Macedonia;28;1;1259;56
2020-04-23;MK;North Macedonia;41;0;1300;56
2020-04-24;MK;North Macedonia;26;1;1326;57
2020-04-25;MK;North Macedonia;41;2;1367;59
2020-04-26;MK;North Macedonia;19;2;1386;61
2020-04-27;MK;North Macedonia;13;4;1399;65
2020-04-28;MK;North Macedonia;22;6;1421;71
2020-04-29;MK;North Macedonia;21;2;1442;73
2020-04-30;MK;North Macedonia;23;4;1465;77
2020-05-01;MK;North Macedonia;29;4;1494;81
2020-05-02;MK;North Macedonia;12;1;1506;82
2020-05-03;MK;North Macedonia;5;2;1511;84
2020-05-04;MK;North Macedonia;7;1;1518;85
2020-05-05;MK;North Macedonia;8;1;1526;86
2020-05-06;MK;North Macedonia;13;2;1539;88
2020-05-07;MK;North Macedonia;33;1;1572;89
2020-05-08;MK;North Macedonia;14;1;1586;90
2020-05-09;MK;North Macedonia;36;1;1622;91
2020-05-10;MK;North Macedonia;20;0;1642;91
2020-05-11;MK;North Macedonia;22;0;1664;91
2020-05-12;MK;North Macedonia;10;1;1674;92
2020-05-13;MK;North Macedonia;20;3;1694;95
2020-05-14;MK;North Macedonia;29;0;1723;95
2020-05-15;MK;North Macedonia;17;2;1740;97
2020-05-16;MK;North Macedonia;22;1;1762;98
2020-05-17;MK;North Macedonia;30;3;1792;101
2020-05-18;MK;North Macedonia;25;3;1817;104
2020-05-19;MK;North Macedonia;22;2;1839;106
2020-05-20;MK;North Macedonia;19;4;1858;110
2020-05-21;MK;North Macedonia;40;1;1898;111
2020-05-22;MK;North Macedonia;23;1;1921;112
2020-05-23;MK;North Macedonia;20;1;1941;113
2020-05-24;MK;North Macedonia;37;0;1978;113
2020-05-25;MK;North Macedonia;21;0;1999;113
2020-05-26;MK;North Macedonia;15;3;2014;116
2020-05-27;MK;North Macedonia;25;3;2039;119
2020-05-28;MK;North Macedonia;38;2;2077;121
2020-05-29;MK;North Macedonia;52;5;2129;126
2020-05-30;MK;North Macedonia;35;5;2164;131
2020-05-31;MK;North Macedonia;62;2;2226;133
2020-06-01;MK;North Macedonia;89;7;2315;140
2020-06-02;MK;North Macedonia;76;1;2391;141
2020-06-03;MK;North Macedonia;101;4;2492;145
2020-06-04;MK;North Macedonia;119;2;2611;147
2020-06-05;MK;North Macedonia;179;2;2790;149
2020-06-06;MK;North Macedonia;125;2;2915;151
2020-06-07;MK;North Macedonia;110;2;3025;153
2020-06-08;MK;North Macedonia;127;3;3152;156
2020-06-09;MK;North Macedonia;87;1;3239;157
2020-06-10;MK;North Macedonia;125;7;3364;164
2020-06-11;MK;North Macedonia;174;5;3538;169
2020-06-12;MK;North Macedonia;163;2;3701;171
2020-06-13;MK;North Macedonia;194;8;3895;179
2020-06-14;MK;North Macedonia;162;9;4057;188
2020-06-15;MK;North Macedonia;100;5;4157;193
2020-06-16;MK;North Macedonia;142;8;4299;201
2020-06-17;MK;North Macedonia;183;9;4482;210
2020-06-18;MK;North Macedonia;182;6;4664;216
2020-06-19;MK;North Macedonia;156;6;4820;222
2020-06-20;MK;North Macedonia;185;11;5005;233
2020-06-21;MK;North Macedonia;101;5;5106;238
2020-06-22;MK;North Macedonia;90;9;5196;247
2020-06-23;MK;North Macedonia;115;4;5311;251
2020-06-24;MK;North Macedonia;134;8;5445;259
2020-06-25;MK;North Macedonia;150;6;5595;265
2020-06-26;MK;North Macedonia;163;3;5758;268
2020-06-27;MK;North Macedonia;148;9;5906;277
2020-06-28;MK;North Macedonia;174;9;6080;286
2020-06-29;MK;North Macedonia;129;12;6209;298
2020-06-30;MK;North Macedonia;125;4;6334;302
2020-07-01;MK;North Macedonia;120;4;6454;306
2020-07-02;MK;North Macedonia;171;15;6625;321
2020-07-03;MK;North Macedonia;162;7;6787;328
2020-07-04;MK;North Macedonia;145;6;6932;334
2020-07-05;MK;North Macedonia;114;7;7046;341
2020-07-06;MK;North Macedonia;78;5;7124;346
2020-07-07;MK;North Macedonia;120;5;7244;351
2020-07-08;MK;North Macedonia;162;8;7406;359
2020-07-09;MK;North Macedonia;166;3;7572;362
2020-07-10;MK;North Macedonia;205;6;7777;368
2020-07-11;MK;North Macedonia;198;8;7975;376
2020-07-12;MK;North Macedonia;136;6;8111;382
2020-07-13;MK;North Macedonia;86;3;8197;385
2020-07-14;MK;North Macedonia;135;4;8332;389
2020-07-15;MK;North Macedonia;198;4;8530;393
2020-07-16;MK;North Macedonia;93;8;8623;401
2020-07-17;MK;North Macedonia;163;5;8786;406
2020-07-18;MK;North Macedonia;240;8;9026;414
2020-07-19;MK;North Macedonia;127;8;9153;422
2020-07-20;MK;North Macedonia;96;10;9249;432
2020-07-21;MK;North Macedonia;163;0;9412;432
2020-07-22;MK;North Macedonia;135;10;9547;442
2020-07-23;MK;North Macedonia;122;3;9669;445
2020-07-24;MK;North Macedonia;128;6;9797;451
2020-07-25;MK;North Macedonia;137;9;9934;460
2020-07-26;MK;North Macedonia;152;0;10086;460
2020-07-27;MK;North Macedonia;127;6;10213;466
2020-07-28;MK;North Macedonia;102;5;10315;471
2020-07-29;MK;North Macedonia;188;5;10503;476
2020-07-30;MK;North Macedonia;114;4;10617;480
2020-07-31;MK;North Macedonia;137;6;10754;486
2020-08-01;MK;North Macedonia;137;7;10891;493
2020-08-02;MK;North Macedonia;163;4;11054;497
2020-08-03;MK;North Macedonia;74;3;11128;500
2020-08-04;MK;North Macedonia;74;5;11202;505
2020-08-05;MK;North Macedonia;87;6;11289;511
2020-08-06;MK;North Macedonia;110;6;11399;517
2020-08-07;MK;North Macedonia;155;2;11554;519
2020-08-08;MK;North Macedonia;200;4;11754;523
2020-08-09;MK;North Macedonia;85;4;11839;527
2020-08-10;MK;North Macedonia;103;1;11942;528
2020-08-11;MK;North Macedonia;141;1;12083;529
2020-08-12;MK;North Macedonia;134;1;12217;530
2020-08-13;MK;North Macedonia;140;2;12357;532
2020-08-14;MK;North Macedonia;158;3;12515;535
2020-08-15;MK;North Macedonia;138;4;12653;539
2020-08-16;MK;North Macedonia;86;5;12739;544
2020-08-17;MK;North Macedonia;101;3;12840;547
2020-08-18;MK;North Macedonia;130;2;12970;549
2020-08-19;MK;North Macedonia;106;2;13076;551
2020-08-20;MK;North Macedonia;118;3;13194;554
2020-08-21;MK;North Macedonia;114;3;13308;557
2020-08-22;MK;North Macedonia;150;6;13458;563
2020-08-23;MK;North Macedonia;137;1;13595;564
2020-08-24;MK;North Macedonia;78;4;13673;568
2020-08-25;MK;North Macedonia;126;5;13799;573
2020-08-26;MK;North Macedonia;115;5;13914;578
2020-08-27;MK;North Macedonia;90;7;14004;585
2020-08-28;MK;North Macedonia;159;5;14163;590
2020-08-29;MK;North Macedonia;130;6;14293;596
2020-08-30;MK;North Macedonia;37;4;14330;600
2020-08-31;MK;North Macedonia;11;3;14341;603
2020-09-01;MK;North Macedonia;114;1;14455;604
2020-09-02;MK;North Macedonia;145;2;14600;606
2020-09-03;MK;North Macedonia;162;0;14762;606
2020-09-04;MK;North Macedonia;109;3;14871;609
2020-09-05;MK;North Macedonia;127;5;14998;614
2020-09-06;MK;North Macedonia;92;3;15090;617
2020-09-07;MK;North Macedonia;37;6;15127;623
2020-09-08;MK;North Macedonia;99;8;15226;631
2020-09-09;MK;North Macedonia;67;3;15293;634
2020-09-10;MK;North Macedonia;121;3;15414;637
2020-09-11;MK;North Macedonia;141;5;15555;642
2020-09-12;MK;North Macedonia;139;4;15694;646
2020-09-13;MK;North Macedonia;97;2;15791;648
2020-09-14;MK;North Macedonia;36;4;15827;652
2020-09-15;MK;North Macedonia;98;9;15925;661
2020-09-16;MK;North Macedonia;163;7;16088;668
2020-09-17;MK;North Macedonia;186;7;16274;675
2020-09-18;MK;North Macedonia;143;8;16417;683
2020-09-19;MK;North Macedonia;140;6;16557;689
2020-09-20;MK;North Macedonia;178;4;16735;693
2020-09-21;MK;North Macedonia;45;7;16780;700
2020-09-22;MK;North Macedonia;87;5;16867;705
2020-09-23;MK;North Macedonia;182;5;17049;710
2020-09-24;MK;North Macedonia;151;2;17200;712
2020-09-25;MK;North Macedonia;143;9;17343;721
2020-09-26;MK;North Macedonia;140;1;17483;722
2020-09-27;MK;North Macedonia;146;3;17629;725
2020-09-28;MK;North Macedonia;45;4;17674;729
2020-09-29;MK;North Macedonia;112;8;17786;737
2020-09-30;MK;North Macedonia;191;2;17977;739
2020-10-01;MK;North Macedonia;161;4;18138;743
2020-10-02;MK;North Macedonia;225;6;18363;749
2020-10-03;MK;North Macedonia;239;4;18602;753
2020-10-04;MK;North Macedonia;188;3;18790;756
2020-10-05;MK;North Macedonia;83;4;18873;760
2020-10-06;MK;North Macedonia;223;8;19096;768
2020-10-07;MK;North Macedonia;317;4;19413;772
2020-10-08;MK;North Macedonia;364;3;19777;775
2020-10-09;MK;North Macedonia;386;6;20163;781
2020-10-10;MK;North Macedonia;392;4;20555;785
2020-10-11;MK;North Macedonia;382;7;20937;792
2020-10-12;MK;North Macedonia;176;5;21113;797
2020-10-13;MK;North Macedonia;80;3;21193;800
2020-10-14;MK;North Macedonia;443;9;21636;809
2020-10-15;MK;North Macedonia;534;6;22170;815
2020-10-16;MK;North Macedonia;437;6;22607;821
2020-10-17;MK;North Macedonia;594;3;23201;824
2020-10-18;MK;North Macedonia;427;10;23628;834
2020-10-19;MK;North Macedonia;160;12;23788;846
2020-10-20;MK;North Macedonia;408;4;24196;850
2020-10-21;MK;North Macedonia;640;12;24836;862
2020-10-22;MK;North Macedonia;637;12;25473;874
2020-10-23;MK;North Macedonia;518;9;25991;883
2020-10-24;MK;North Macedonia;403;14;26394;897
2020-10-25;MK;North Macedonia;560;22;26954;919
2020-10-26;MK;North Macedonia;245;15;27199;934
2020-10-27;MK;North Macedonia;628;15;27827;949
2020-10-28;MK;North Macedonia;870;14;28697;963
2020-10-29;MK;North Macedonia;861;14;29558;977
2020-10-30;MK;North Macedonia;930;5;30488;982
2020-10-31;MK;North Macedonia;1084;12;31572;994
2020-11-01;MK;North Macedonia;864;10;32436;1004
2020-11-02;MK;North Macedonia;561;21;32997;1025
2020-11-03;MK;North Macedonia;911;24;33908;1049
2020-11-04;MK;North Macedonia;1189;22;35097;1071
2020-11-05;MK;North Macedonia;1275;13;36372;1084
2020-11-06;MK;North Macedonia;1127;12;37499;1096
2020-11-07;MK;North Macedonia;1283;14;38782;1110
2020-11-08;MK;North Macedonia;978;26;39760;1136
2020-11-09;MK;North Macedonia;515;20;40275;1156
2020-11-10;MK;North Macedonia;947;30;41222;1186
2020-11-11;MK;North Macedonia;1318;26;42540;1212
2020-11-12;MK;North Macedonia;1295;26;43835;1238
2020-11-13;MK;North Macedonia;1063;25;44898;1263
2020-11-14;MK;North Macedonia;1164;18;46062;1281
2020-11-15;MK;North Macedonia;988;24;47050;1305
2020-11-16;MK;North Macedonia;586;40;47636;1345
2020-11-17;MK;North Macedonia;977;31;48613;1376
2020-11-18;MK;North Macedonia;1402;21;50015;1397
2020-11-19;MK;North Macedonia;1198;26;51213;1423
2020-11-20;MK;North Macedonia;1236;39;52449;1462
2020-11-21;MK;North Macedonia;1182;25;53631;1487
2020-11-22;MK;North Macedonia;1112;24;54743;1511
2020-11-23;MK;North Macedonia;384;35;55127;1546
2020-11-24;MK;North Macedonia;1037;15;56164;1561
2020-11-25;MK;North Macedonia;1287;39;57451;1600
2020-11-26;MK;North Macedonia;1157;30;58608;1630
2020-11-27;MK;North Macedonia;1093;28;59701;1658
2020-11-28;MK;North Macedonia;1022;41;60723;1699
2020-11-29;MK;North Macedonia;820;32;61543;1731
2020-11-30;MK;North Macedonia;335;32;61878;1763
2020-12-01;MK;North Macedonia;1067;29;62945;1792
2020-12-02;MK;North Macedonia;945;33;63890;1825
2020-12-03;MK;North Macedonia;1341;22;65231;1847
2020-12-04;MK;North Macedonia;1099;30;66330;1877
2020-12-05;MK;North Macedonia;981;24;67311;1901
2020-12-06;MK;North Macedonia;657;23;67968;1924
2020-12-07;MK;North Macedonia;364;25;68332;1949
2020-12-08;MK;North Macedonia;1120;28;69452;1977
2020-12-09;MK;North Macedonia;502;46;69954;2023
2020-12-10;MK;North Macedonia;929;28;70883;2051
2020-12-11;MK;North Macedonia;1161;26;72044;2077
2020-12-12;MK;North Macedonia;981;19;73025;2096
2020-12-13;MK;North Macedonia;613;25;73638;2121
2020-12-14;MK;North Macedonia;213;26;73851;2147
2020-12-15;MK;North Macedonia;881;22;74732;2169
2020-12-16;MK;North Macedonia;865;25;75597;2194
2020-12-17;MK;North Macedonia;654;31;76251;2225
2020-12-18;MK;North Macedonia;883;29;77134;2254
2020-12-19;MK;North Macedonia;815;20;77949;2274
2020-12-20;MK;North Macedonia;356;18;78305;2292
2020-12-21;MK;North Macedonia;129;22;78434;2314
2020-12-22;MK;North Macedonia;756;26;79190;2340
2020-12-23;MK;North Macedonia;625;14;79815;2354
2020-12-24;MK;North Macedonia;592;21;80407;2375
2020-12-25;MK;North Macedonia;489;26;80896;2401
2020-12-26;MK;North Macedonia;529;26;81425;2427
2020-12-27;MK;North Macedonia;296;18;81721;2445
2020-12-28;MK;North Macedonia;83;11;81804;2456
2020-12-29;MK;North Macedonia;497;17;82301;2473
2020-12-30;MK;North Macedonia;493;15;82794;2488
2020-12-31;MK;North Macedonia;535;15;83329;2503
2021-01-01;MK;North Macedonia;414;7;83743;2510
2021-01-02;MK;North Macedonia;46;12;83789;2522
2021-01-03;MK;North Macedonia;235;8;84024;2530
2021-01-04;MK;North Macedonia;105;20;84129;2550
2021-01-05;MK;North Macedonia;580;9;84709;2559
2021-01-06;MK;North Macedonia;619;12;85328;2571
2021-01-07;MK;North Macedonia;166;10;85494;2581
2021-01-08;MK;North Macedonia;100;11;85594;2592
2021-01-09;MK;North Macedonia;556;22;86150;2614
2021-01-10;MK;North Macedonia;344;8;86494;2622
2021-01-11;MK;North Macedonia;103;13;86597;2635
2021-01-12;MK;North Macedonia;520;12;87117;2647
2021-01-13;MK;North Macedonia;473;10;87590;2657
2021-01-14;MK;North Macedonia;396;15;87986;2672
2021-01-15;MK;North Macedonia;403;10;88389;2682
2021-01-16;MK;North Macedonia;360;14;88749;2696
2021-01-17;MK;North Macedonia;189;6;88938;2702
2021-01-18;MK;North Macedonia;54;13;88992;2715
2021-01-19;MK;North Macedonia;400;11;89392;2726
2021-01-20;MK;North Macedonia;71;13;89463;2739
2021-01-21;MK;North Macedonia;354;15;89817;2754
2021-01-22;MK;North Macedonia;307;14;90124;2768
2021-01-23;MK;North Macedonia;347;11;90471;2779
2021-01-24;MK;North Macedonia;183;6;90654;2785
2021-01-25;MK;North Macedonia;63;6;90717;2791
2021-01-26;MK;North Macedonia;444;21;91161;2812
2021-01-27;MK;North Macedonia;394;9;91555;2821
2021-01-28;MK;North Macedonia;336;10;91891;2831
2021-01-29;MK;North Macedonia;302;10;92193;2841
2021-01-30;MK;North Macedonia;325;7;92518;2848
2021-01-31;MK;North Macedonia;175;7;92693;2855
2021-02-01;MK;North Macedonia;60;11;92753;2866
2021-02-02;MK;North Macedonia;407;7;93160;2873
2021-02-03;MK;North Macedonia;350;20;93510;2893
2021-02-04;MK;North Macedonia;372;7;93882;2900
2021-02-05;MK;North Macedonia;314;8;94196;2908
2021-02-06;MK;North Macedonia;403;8;94599;2916
2021-02-07;MK;North Macedonia;199;8;94798;2924
2021-02-08;MK;North Macedonia;73;22;94871;2946
2021-02-09;MK;North Macedonia;476;9;95347;2955
2021-02-10;MK;North Macedonia;389;4;95736;2959
2021-02-11;MK;North Macedonia;416;7;96152;2966
2021-02-12;MK;North Macedonia;366;5;96518;2971
2021-02-13;MK;North Macedonia;354;5;96872;2976
2021-02-14;MK;North Macedonia;180;13;97052;2989
2021-02-15;MK;North Macedonia;49;9;97101;2998
2021-02-16;MK;North Macedonia;355;5;97456;3003
2021-02-17;MK;North Macedonia;347;7;97803;3010
2021-02-18;MK;North Macedonia;371;8;98174;3018
2021-02-19;MK;North Macedonia;410;19;98584;3037
2021-02-20;MK;North Macedonia;447;10;99031;3047
2021-02-21;MK;North Macedonia;254;16;99285;3063
2021-02-22;MK;North Macedonia;123;13;99408;3076
2021-02-23;MK;North Macedonia;509;9;99917;3085
2021-02-24;MK;North Macedonia;715;13;100632;3098
2021-02-25;MK;North Macedonia;582;13;101214;3111
2021-02-26;MK;North Macedonia;548;8;101762;3119
2021-02-27;MK;North Macedonia;720;7;102482;3126
2021-02-28;MK;North Macedonia;305;11;102787;3137
2021-03-01;MK;North Macedonia;233;7;103020;3144
2021-03-02;MK;North Macedonia;726;7;103746;3151
2021-03-03;MK;North Macedonia;802;5;104548;3156
2021-03-04;MK;North Macedonia;721;9;105269;3165
2021-03-05;MK;North Macedonia;841;11;106110;3176
2021-03-06;MK;North Macedonia;722;9;106832;3185
2021-03-07;MK;North Macedonia;331;10;107163;3195
2021-03-08;MK;North Macedonia;316;11;107479;3206
2021-03-09;MK;North Macedonia;871;22;108350;3228
2021-03-10;MK;North Macedonia;912;16;109262;3244
2021-03-11;MK;North Macedonia;947;21;110209;3265
2021-03-12;MK;North Macedonia;868;15;111077;3280
2021-03-13;MK;North Macedonia;1030;20;112107;3300
2021-03-14;MK;North Macedonia;539;19;112646;3319
2021-03-15;MK;North Macedonia;284;21;112930;3340
2021-03-16;MK;North Macedonia;999;24;113929;3364
2021-03-17;MK;North Macedonia;1293;24;115222;3388
2021-03-18;MK;North Macedonia;1216;15;116438;3403
2021-03-19;MK;North Macedonia;999;21;117437;3424
2021-03-20;MK;North Macedonia;1299;24;118736;3448
2021-03-21;MK;North Macedonia;642;25;119378;3473
2021-03-22;MK;North Macedonia;450;30;119828;3503
2021-03-23;MK;North Macedonia;1054;25;120882;3528
2021-03-24;MK;North Macedonia;1345;17;122227;3545
2021-03-25;MK;North Macedonia;1264;29;123491;3574
2021-03-26;MK;North Macedonia;1419;33;124910;3607
2021-03-27;MK;North Macedonia;1320;35;126230;3642
2021-03-28;MK;North Macedonia;708;33;126938;3675
2021-03-29;MK;North Macedonia;302;41;127240;3716
2021-03-30;MK;North Macedonia;1271;33;128511;3749
2021-03-31;MK;North Macedonia;1511;32;130022;3781
2021-04-01;MK;North Macedonia;1402;29;131424;3810
2021-04-02;MK;North Macedonia;1316;50;132740;3860
2021-04-03;MK;North Macedonia;1394;45;134134;3905
2021-04-04;MK;North Macedonia;733;35;134867;3940
2021-04-05;MK;North Macedonia;300;37;135167;3977
2021-04-06;MK;North Macedonia;1259;45;136426;4022
2021-04-07;MK;North Macedonia;1302;51;137728;4073
2021-04-08;MK;North Macedonia;1163;35;138891;4108
2021-04-09;MK;North Macedonia;1174;42;140065;4150
2021-04-10;MK;North Macedonia;1092;32;141157;4182
2021-04-11;MK;North Macedonia;687;46;141844;4228
2021-04-12;MK;North Macedonia;190;34;142034;4262
2021-04-13;MK;North Macedonia;1128;27;143162;4289
2021-04-14;MK;North Macedonia;949;33;144111;4322
2021-04-15;MK;North Macedonia;890;35;145001;4357
2021-04-16;MK;North Macedonia;908;31;145909;4388
2021-04-17;MK;North Macedonia;824;31;146733;4419
2021-04-18;MK;North Macedonia;361;24;147094;4443
2021-04-19;MK;North Macedonia;135;35;147229;4478
2021-04-20;MK;North Macedonia;766;31;147995;4509
2021-04-21;MK;North Macedonia;623;47;148618;4556
2021-04-22;MK;North Macedonia;603;39;149221;4595
2021-04-23;MK;North Macedonia;489;33;149710;4628
2021-04-24;MK;North Macedonia;564;22;150274;4650
2021-04-25;MK;North Macedonia;314;27;150588;4677
2021-04-26;MK;North Macedonia;84;37;150672;4714
2021-04-27;MK;North Macedonia;450;28;151122;4742
2021-04-28;MK;North Macedonia;447;30;151569;4772
2021-04-29;MK;North Macedonia;433;46;152002;4818
2021-04-30;MK;North Macedonia;365;37;152367;4855
2021-05-01;MK;North Macedonia;214;36;152581;4891
2021-05-02;MK;North Macedonia;104;45;152685;4936
2021-05-03;MK;North Macedonia;62;25;152747;4961
2021-05-04;MK;North Macedonia;67;31;152814;4992
2021-05-05;MK;North Macedonia;323;24;153137;5016
2021-05-06;MK;North Macedonia;324;26;153461;5042
2021-05-07;MK;North Macedonia;233;25;153694;5067
2021-05-08;MK;North Macedonia;197;12;153891;5079
2021-05-09;MK;North Macedonia;135;14;154026;5093
2021-05-10;MK;North Macedonia;25;16;154051;5109
2021-05-11;MK;North Macedonia;171;26;154222;5135
2021-05-12;MK;North Macedonia;150;16;154372;5151
2021-05-13;MK;North Macedonia;122;17;154494;5168
2021-05-14;MK;North Macedonia;30;16;154524;5184
2021-05-15;MK;North Macedonia;112;13;154636;5197
2021-05-16;MK;North Macedonia;62;14;154698;5211
2021-05-17;MK;North Macedonia;27;19;154725;5230
2021-05-18;MK;North Macedonia;79;2;154804;5232
2021-05-19;MK;North Macedonia;87;17;154891;5249
2021-05-20;MK;North Macedonia;46;16;154937;5265
2021-05-21;MK;North Macedonia;45;15;154982;5280
2021-05-22;MK;North Macedonia;46;16;155028;5296
2021-05-23;MK;North Macedonia;35;15;155063;5311
2021-05-24;MK;North Macedonia;4;18;155067;5329
2021-05-25;MK;North Macedonia;4;13;155071;5342
2021-05-26;MK;North Macedonia;46;14;155117;5356
2021-05-27;MK;North Macedonia;52;13;155169;5369
2021-05-28;MK;North Macedonia;48;18;155217;5387
2021-05-29;MK;North Macedonia;29;11;155246;5398
2021-05-30;MK;North Macedonia;23;10;155269;5408
2021-05-31;MK;North Macedonia;3;5;155272;5413
2021-06-01;MK;North Macedonia;32;10;155304;5423
2021-06-02;MK;North Macedonia;41;6;155345;5429
2021-06-03;MK;North Macedonia;19;6;155364;5435
2021-06-04;MK;North Macedonia;15;7;155379;5442
2021-06-05;MK;North Macedonia;28;6;155407;5448
2021-06-06;MK;North Macedonia;10;7;155417;5455
2021-06-07;MK;North Macedonia;1;3;155418;5458
2021-06-08;MK;North Macedonia;23;4;155441;5462
2021-06-09;MK;North Macedonia;28;5;155469;5467
2021-06-10;MK;North Macedonia;18;1;155487;5468
2021-06-11;MK;North Macedonia;20;2;155507;5470
2021-06-12;MK;North Macedonia;21;1;155528;5471
2021-06-13;MK;North Macedonia;8;0;155536;5471
2021-06-14;MK;North Macedonia;4;1;155540;5472
2021-06-15;MK;North Macedonia;28;0;155568;5472
2021-06-16;MK;North Macedonia;15;0;155583;5472
2021-06-17;MK;North Macedonia;10;0;155593;5472
2021-06-18;MK;North Macedonia;19;2;155612;5474
2021-06-19;MK;North Macedonia;4;1;155616;5475
2021-06-20;MK;North Macedonia;8;0;155624;5475
2021-06-21;MK;North Macedonia;3;2;155627;5477
2021-06-22;MK;North Macedonia;13;0;155640;5477
2021-06-23;MK;North Macedonia;5;1;155645;5478
2021-06-24;MK;North Macedonia;10;3;155655;5481
2021-06-25;MK;North Macedonia;8;3;155663;5484
2021-06-26;MK;North Macedonia;6;0;155669;5484
2021-06-27;MK;North Macedonia;4;0;155673;5484
2021-06-28;MK;North Macedonia;3;0;155676;5484
2021-06-29;MK;North Macedonia;6;0;155682;5484
2021-06-30;MK;North Macedonia;2;0;155684;5484
2021-07-01;MK;North Macedonia;5;1;155689;5485
2021-01-14;;Northern Cyprus;0;0;0;0
2021-01-15;;Northern Cyprus;0;0;0;0
2021-01-16;;Northern Cyprus;0;0;0;0
2021-01-17;;Northern Cyprus;0;0;0;0
2021-01-18;;Northern Cyprus;0;0;0;0
2021-01-19;;Northern Cyprus;0;0;0;0
2021-01-20;;Northern Cyprus;0;0;0;0
2021-01-21;;Northern Cyprus;0;0;0;0
2021-01-22;;Northern Cyprus;0;0;0;0
2021-01-23;;Northern Cyprus;0;0;0;0
2021-01-24;;Northern Cyprus;0;0;0;0
2021-01-25;;Northern Cyprus;0;0;0;0
2021-01-26;;Northern Cyprus;0;0;0;0
2021-01-27;;Northern Cyprus;0;0;0;0
2021-01-28;;Northern Cyprus;0;0;0;0
2021-01-29;;Northern Cyprus;0;0;0;0
2021-01-30;;Northern Cyprus;0;0;0;0
2021-01-31;;Northern Cyprus;0;0;0;0
2021-02-01;;Northern Cyprus;0;0;0;0
2021-02-02;;Northern Cyprus;0;0;0;0
2021-02-03;;Northern Cyprus;0;0;0;0
2021-02-04;;Northern Cyprus;0;0;0;0
2021-02-05;;Northern Cyprus;0;0;0;0
2021-02-06;;Northern Cyprus;0;0;0;0
2021-02-07;;Northern Cyprus;0;0;0;0
2021-02-08;;Northern Cyprus;0;0;0;0
2021-02-09;;Northern Cyprus;0;0;0;0
2021-02-10;;Northern Cyprus;0;0;0;0
2021-02-11;;Northern Cyprus;0;0;0;0
2021-02-12;;Northern Cyprus;0;0;0;0
2021-02-13;;Northern Cyprus;0;0;0;0
2021-02-14;;Northern Cyprus;0;0;0;0
2021-02-15;;Northern Cyprus;0;0;0;0
2021-02-16;;Northern Cyprus;0;0;0;0
2021-02-17;;Northern Cyprus;0;0;0;0
2021-02-18;;Northern Cyprus;0;0;0;0
2021-02-19;;Northern Cyprus;0;0;0;0
2021-02-20;;Northern Cyprus;0;0;0;0
2021-02-21;;Northern Cyprus;0;0;0;0
2021-02-22;;Northern Cyprus;0;0;0;0
2021-02-23;;Northern Cyprus;0;0;0;0
2021-02-24;;Northern Cyprus;0;0;0;0
2021-02-25;;Northern Cyprus;0;0;0;0
2021-02-26;;Northern Cyprus;0;0;0;0
2021-02-27;;Northern Cyprus;0;0;0;0
2021-02-28;;Northern Cyprus;0;0;0;0
2021-03-01;;Northern Cyprus;0;0;0;0
2021-03-02;;Northern Cyprus;0;0;0;0
2021-03-03;;Northern Cyprus;0;0;0;0
2021-03-04;;Northern Cyprus;0;0;0;0
2021-03-05;;Northern Cyprus;0;0;0;0
2021-03-06;;Northern Cyprus;0;0;0;0
2021-03-07;;Northern Cyprus;0;0;0;0
2021-03-08;;Northern Cyprus;0;0;0;0
2021-03-09;;Northern Cyprus;0;0;0;0
2021-03-10;;Northern Cyprus;0;0;0;0
2021-03-11;;Northern Cyprus;0;0;0;0
2021-03-12;;Northern Cyprus;0;0;0;0
2021-03-13;;Northern Cyprus;0;0;0;0
2021-03-14;;Northern Cyprus;0;0;0;0
2021-03-15;;Northern Cyprus;0;0;0;0
2021-03-16;;Northern Cyprus;0;0;0;0
2021-03-17;;Northern Cyprus;0;0;0;0
2021-03-18;;Northern Cyprus;0;0;0;0
2021-03-19;;Northern Cyprus;0;0;0;0
2021-03-20;;Northern Cyprus;0;0;0;0
2021-03-21;;Northern Cyprus;0;0;0;0
2021-03-22;;Northern Cyprus;0;0;0;0
2021-03-23;;Northern Cyprus;0;0;0;0
2021-03-24;;Northern Cyprus;0;0;0;0
2021-03-25;;Northern Cyprus;0;0;0;0
2021-03-26;;Northern Cyprus;0;0;0;0
2021-03-27;;Northern Cyprus;0;0;0;0
2021-03-28;;Northern Cyprus;0;0;0;0
2021-03-29;;Northern Cyprus;0;0;0;0
2021-03-30;;Northern Cyprus;0;0;0;0
2021-03-31;;Northern Cyprus;0;0;0;0
2021-04-01;;Northern Cyprus;0;0;0;0
2021-04-02;;Northern Cyprus;0;0;0;0
2021-04-03;;Northern Cyprus;0;0;0;0
2021-04-04;;Northern Cyprus;0;0;0;0
2021-04-05;;Northern Cyprus;0;0;0;0
2021-04-06;;Northern Cyprus;0;0;0;0
2021-04-07;;Northern Cyprus;0;0;0;0
2021-04-08;;Northern Cyprus;0;0;0;0
2021-04-09;;Northern Cyprus;0;0;0;0
2021-04-10;;Northern Cyprus;0;0;0;0
2021-04-11;;Northern Cyprus;0;0;0;0
2021-04-12;;Northern Cyprus;0;0;0;0
2021-04-13;;Northern Cyprus;0;0;0;0
2021-04-14;;Northern Cyprus;0;0;0;0
2021-04-15;;Northern Cyprus;0;0;0;0
2021-04-16;;Northern Cyprus;0;0;0;0
2021-04-17;;Northern Cyprus;0;0;0;0
2021-04-18;;Northern Cyprus;0;0;0;0
2021-04-19;;Northern Cyprus;0;0;0;0
2021-04-20;;Northern Cyprus;0;0;0;0
2021-04-21;;Northern Cyprus;0;0;0;0
2021-04-22;;Northern Cyprus;0;0;0;0
2021-04-23;;Northern Cyprus;0;0;0;0
2021-04-24;;Northern Cyprus;0;0;0;0
2021-04-25;;Northern Cyprus;0;0;0;0
2021-04-26;;Northern Cyprus;0;0;0;0
2021-04-27;;Northern Cyprus;0;0;0;0
2021-04-28;;Northern Cyprus;0;0;0;0
2021-04-29;;Northern Cyprus;0;0;0;0
2021-04-30;;Northern Cyprus;0;0;0;0
2021-05-01;;Northern Cyprus;0;0;0;0
2021-05-02;;Northern Cyprus;0;0;0;0
2021-05-03;;Northern Cyprus;0;0;0;0
2021-05-04;;Northern Cyprus;0;0;0;0
2021-05-05;;Northern Cyprus;0;0;0;0
2021-05-06;;Northern Cyprus;0;0;0;0
2021-05-07;;Northern Cyprus;0;0;0;0
2021-05-08;;Northern Cyprus;0;0;0;0
2021-05-09;;Northern Cyprus;0;0;0;0
2021-05-10;;Northern Cyprus;0;0;0;0
2021-05-11;;Northern Cyprus;0;0;0;0
2021-05-12;;Northern Cyprus;0;0;0;0
2021-05-13;;Northern Cyprus;0;0;0;0
2021-05-14;;Northern Cyprus;0;0;0;0
2021-05-15;;Northern Cyprus;0;0;0;0
2021-05-16;;Northern Cyprus;0;0;0;0
2021-05-17;;Northern Cyprus;0;0;0;0
2021-05-18;;Northern Cyprus;0;0;0;0
2021-05-19;;Northern Cyprus;0;0;0;0
2021-05-20;;Northern Cyprus;0;0;0;0
2021-05-21;;Northern Cyprus;0;0;0;0
2021-05-22;;Northern Cyprus;0;0;0;0
2021-05-23;;Northern Cyprus;0;0;0;0
2021-05-24;;Northern Cyprus;0;0;0;0
2021-05-25;;Northern Cyprus;0;0;0;0
2021-05-26;;Northern Cyprus;0;0;0;0
2021-05-27;;Northern Cyprus;0;0;0;0
2020-02-23;NO;Norway;0;0;0;0
2020-02-26;NO;Norway;1;0;1;0
2020-02-27;NO;Norway;0;0;1;0
2020-02-28;NO;Norway;5;0;6;0
2020-02-29;NO;Norway;9;0;15;0
2020-03-01;NO;Norway;4;0;19;0
2020-03-02;NO;Norway;6;0;25;0
2020-03-03;NO;Norway;7;0;32;0
2020-03-04;NO;Norway;24;0;56;0
2020-03-05;NO;Norway;31;0;87;0
2020-03-06;NO;Norway;21;0;108;0
2020-03-07;NO;Norway;39;0;147;0
2020-03-08;NO;Norway;29;0;176;0
2020-03-09;NO;Norway;29;0;205;0
2020-03-10;NO;Norway;195;0;400;0
2020-03-11;NO;Norway;198;0;598;0
2020-03-12;NO;Norway;104;0;702;0
2020-03-13;NO;Norway;294;0;996;0
2020-03-14;NO;Norway;94;3;1090;3
2020-03-15;NO;Norway;131;0;1221;3
2020-03-16;NO;Norway;112;0;1333;3
2020-03-17;NO;Norway;130;0;1463;3
2020-03-18;NO;Norway;87;3;1550;6
2020-03-19;NO;Norway;196;1;1746;7
2020-03-20;NO;Norway;168;0;1914;7
2020-03-21;NO;Norway;204;0;2118;7
2020-03-22;NO;Norway;267;0;2385;7
2020-03-23;NO;Norway;236;3;2621;10
2020-03-24;NO;Norway;242;2;2863;12
2020-03-25;NO;Norway;221;2;3084;14
2020-03-26;NO;Norway;285;0;3369;14
2020-03-27;NO;Norway;386;5;3755;19
2020-03-28;NO;Norway;260;4;4015;23
2020-03-29;NO;Norway;269;2;4284;25
2020-03-30;NO;Norway;161;7;4445;32
2020-03-31;NO;Norway;196;7;4641;39
2020-04-01;NO;Norway;222;5;4863;44
2020-04-02;NO;Norway;284;6;5147;50
2020-04-03;NO;Norway;223;9;5370;59
2020-04-04;NO;Norway;180;3;5550;62
2020-04-05;NO;Norway;137;9;5687;71
2020-04-06;NO;Norway;178;5;5865;76
2020-04-07;NO;Norway;221;13;6086;89
2020-04-08;NO;Norway;0;12;6086;101
2020-04-09;NO;Norway;125;7;6211;108
2020-04-10;NO;Norway;103;5;6314;113
2020-04-11;NO;Norway;95;6;6409;119
2020-04-12;NO;Norway;116;9;6525;128
2020-04-13;NO;Norway;78;6;6603;134
2020-04-14;NO;Norway;20;5;6623;139
2020-04-15;NO;Norway;117;11;6740;150
2020-04-16;NO;Norway;156;2;6896;152
2020-04-17;NO;Norway;41;9;6937;161
2020-04-18;NO;Norway;99;3;7036;164
2020-04-19;NO;Norway;42;1;7078;165
2020-04-20;NO;Norway;78;16;7156;181
2020-04-21;NO;Norway;35;1;7191;182
2020-04-22;NO;Norway;147;5;7338;187
2020-04-23;NO;Norway;63;7;7401;194
2020-04-24;NO;Norway;62;5;7463;199
2020-04-25;NO;Norway;36;2;7499;201
2020-04-26;NO;Norway;28;0;7527;201
2020-04-27;NO;Norway;72;4;7599;205
2020-04-28;NO;Norway;61;1;7660;206
2020-04-29;NO;Norway;50;1;7710;207
2020-04-30;NO;Norway;28;3;7738;210
2020-05-01;NO;Norway;45;0;7783;210
2020-05-02;NO;Norway;26;1;7809;211
2020-05-03;NO;Norway;38;0;7847;211
2020-05-04;NO;Norway;57;3;7904;214
2020-05-05;NO;Norway;51;1;7955;215
2020-05-06;NO;Norway;41;1;7996;216
2020-05-07;NO;Norway;38;1;8034;217
2020-05-08;NO;Norway;36;1;8070;218
2020-05-09;NO;Norway;29;1;8099;219
2020-05-10;NO;Norway;6;0;8105;219
2020-05-11;NO;Norway;27;5;8132;224
2020-05-12;NO;Norway;25;4;8157;228
2020-05-13;NO;Norway;18;1;8175;229
2020-05-14;NO;Norway;21;3;8196;232
2020-05-15;NO;Norway;23;0;8219;232
2020-05-16;NO;Norway;18;0;8237;232
2020-05-17;NO;Norway;12;0;8249;232
2020-05-18;NO;Norway;8;1;8257;233
2020-05-19;NO;Norway;10;0;8267;233
2020-05-20;NO;Norway;14;1;8281;234
2020-05-21;NO;Norway;28;1;8309;235
2020-05-22;NO;Norway;23;0;8332;235
2020-05-23;NO;Norway;14;0;8346;235
2020-05-24;NO;Norway;6;0;8352;235
2020-05-25;NO;Norway;12;0;8364;235
2020-05-26;NO;Norway;19;0;8383;235
2020-05-27;NO;Norway;18;0;8401;235
2020-05-28;NO;Norway;10;1;8411;236
2020-05-29;NO;Norway;11;0;8422;236
2020-05-30;NO;Norway;15;0;8437;236
2020-05-31;NO;Norway;3;0;8440;236
2020-06-01;NO;Norway;6;0;8446;236
2020-06-02;NO;Norway;9;1;8455;237
2020-06-03;NO;Norway;22;0;8477;237
2020-06-04;NO;Norway;27;1;8504;238
2020-06-05;NO;Norway;18;0;8522;238
2020-06-06;NO;Norway;9;0;8531;238
2020-06-07;NO;Norway;16;0;8547;238
2020-06-08;NO;Norway;14;1;8561;239
2020-06-09;NO;Norway;15;0;8576;239
2020-06-10;NO;Norway;18;0;8594;239
2020-06-11;NO;Norway;14;3;8608;242
2020-06-12;NO;Norway;12;0;8620;242
2020-06-13;NO;Norway;8;0;8628;242
2020-06-14;NO;Norway;3;0;8631;242
2020-06-15;NO;Norway;16;0;8647;242
2020-06-16;NO;Norway;13;0;8660;242
2020-06-17;NO;Norway;32;1;8692;243
2020-06-18;NO;Norway;16;1;8708;244
2020-06-19;NO;Norway;18;0;8726;244
2020-06-20;NO;Norway;16;0;8742;244
2020-06-21;NO;Norway;3;0;8745;244
2020-06-22;NO;Norway;6;4;8751;248
2020-06-23;NO;Norway;21;0;8772;248
2020-06-24;NO;Norway;16;1;8788;249
2020-06-25;NO;Norway;0;0;8788;249
2020-06-26;NO;Norway;44;0;8832;249
2020-06-27;NO;Norway;14;0;8846;249
2020-06-28;NO;Norway;9;0;8855;249
2020-06-29;NO;Norway;7;0;8862;249
2020-06-30;NO;Norway;17;1;8879;250
2020-07-01;NO;Norway;17;1;8896;251
2020-07-02;NO;Norway;6;0;8902;251
2020-07-03;NO;Norway;19;0;8921;251
2020-07-04;NO;Norway;5;0;8926;251
2020-07-05;NO;Norway;4;0;8930;251
2020-07-06;NO;Norway;6;0;8936;251
2020-07-07;NO;Norway;11;0;8947;251
2020-07-08;NO;Norway;3;0;8950;251
2020-07-09;NO;Norway;15;1;8965;252
2020-07-10;NO;Norway;9;0;8974;252
2020-07-11;NO;Norway;3;0;8977;252
2020-07-12;NO;Norway;4;0;8981;252
2020-07-13;NO;Norway;3;1;8984;253
2020-07-14;NO;Norway;17;0;9001;253
2020-07-15;NO;Norway;10;0;9011;253
2020-07-16;NO;Norway;4;1;9015;254
2020-07-17;NO;Norway;10;1;9025;255
2020-07-18;NO;Norway;3;0;9028;255
2020-07-19;NO;Norway;0;0;9028;255
2020-07-20;NO;Norway;6;0;9034;255
2020-07-21;NO;Norway;19;0;9053;255
2020-07-22;NO;Norway;6;0;9059;255
2020-07-23;NO;Norway;26;0;9085;255
2020-07-24;NO;Norway;7;0;9092;255
2020-07-25;NO;Norway;19;0;9111;255
2020-07-26;NO;Norway;6;0;9117;255
2020-07-27;NO;Norway;15;0;9132;255
2020-07-28;NO;Norway;18;0;9150;255
2020-07-29;NO;Norway;22;0;9172;255
2020-07-30;NO;Norway;36;0;9208;255
2020-07-31;NO;Norway;32;0;9240;255
2020-08-01;NO;Norway;13;0;9253;255
2020-08-02;NO;Norway;15;0;9268;255
2020-08-03;NO;Norway;66;1;9334;256
2020-08-04;NO;Norway;28;0;9362;256
2020-08-05;NO;Norway;47;0;9409;256
2020-08-06;NO;Norway;59;0;9468;256
2020-08-07;NO;Norway;83;0;9551;256
2020-08-08;NO;Norway;48;0;9599;256
2020-08-09;NO;Norway;39;0;9638;256
2020-08-10;NO;Norway;46;0;9684;256
2020-08-11;NO;Norway;67;0;9751;256
2020-08-12;NO;Norway;32;0;9783;256
2020-08-13;NO;Norway;68;1;9851;257
2020-08-14;NO;Norway;57;4;9908;261
2020-08-15;NO;Norway;57;0;9965;261
2020-08-16;NO;Norway;40;0;10005;261
2020-08-17;NO;Norway;55;0;10060;261
2020-08-18;NO;Norway;51;1;10111;262
2020-08-19;NO;Norway;51;0;10162;262
2020-08-20;NO;Norway;35;2;10197;264
2020-08-21;NO;Norway;78;0;10275;264
2020-08-22;NO;Norway;24;0;10299;264
2020-08-23;NO;Norway;24;0;10323;264
2020-08-24;NO;Norway;72;0;10395;264
2020-08-25;NO;Norway;59;0;10454;264
2020-08-26;NO;Norway;50;0;10504;264
2020-08-27;NO;Norway;38;0;10542;264
2020-08-28;NO;Norway;40;0;10582;264
2020-08-29;NO;Norway;29;0;10611;264
2020-08-30;NO;Norway;32;0;10643;264
2020-08-31;NO;Norway;139;0;10782;264
2020-09-01;NO;Norway;89;0;10871;264
2020-09-02;NO;Norway;163;0;11034;264
2020-09-03;NO;Norway;86;0;11120;264
2020-09-04;NO;Norway;111;0;11231;264
2020-09-05;NO;Norway;65;0;11296;264
2020-09-06;NO;Norway;92;0;11388;264
2020-09-07;NO;Norway;133;0;11521;264
2020-09-08;NO;Norway;102;0;11623;264
2020-09-09;NO;Norway;123;0;11746;264
2020-09-10;NO;Norway;121;1;11867;265
2020-09-11;NO;Norway;136;0;12003;265
2020-09-12;NO;Norway;76;0;12079;265
2020-09-13;NO;Norway;75;0;12154;265
2020-09-14;NO;Norway;122;0;12276;265
2020-09-15;NO;Norway;117;0;12393;265
2020-09-16;NO;Norway;105;0;12498;265
2020-09-17;NO;Norway;146;1;12644;266
2020-09-18;NO;Norway;125;1;12769;267
2020-09-19;NO;Norway;89;0;12858;267
2020-09-20;NO;Norway;39;0;12897;267
2020-09-21;NO;Norway;108;0;13005;267
2020-09-22;NO;Norway;148;0;13153;267
2020-09-23;NO;Norway;124;0;13277;267
2020-09-24;NO;Norway;129;3;13406;270
2020-09-25;NO;Norway;139;0;13545;270
2020-09-26;NO;Norway;82;0;13627;270
2020-09-27;NO;Norway;71;0;13698;270
2020-09-28;NO;Norway;90;4;13788;274
2020-09-29;NO;Norway;127;0;13915;274
2020-09-30;NO;Norway;112;0;14027;274
2020-10-01;NO;Norway;122;0;14149;274
2020-10-02;NO;Norway;135;1;14284;275
2020-10-03;NO;Norway;78;0;14362;275
2020-10-04;NO;Norway;95;0;14457;275
2020-10-05;NO;Norway;148;0;14605;275
2020-10-06;NO;Norway;179;0;14784;275
2020-10-07;NO;Norway;229;0;15013;275
2020-10-08;NO;Norway;208;0;15221;275
2020-10-09;NO;Norway;167;0;15388;275
2020-10-10;NO;Norway;78;0;15466;275
2020-10-11;NO;Norway;58;0;15524;275
2020-10-12;NO;Norway;115;1;15639;276
2020-10-13;NO;Norway;154;1;15793;277
2020-10-14;NO;Norway;160;0;15953;277
2020-10-15;NO;Norway;184;1;16137;278
2020-10-16;NO;Norway;135;0;16272;278
2020-10-17;NO;Norway;97;0;16369;278
2020-10-18;NO;Norway;88;0;16457;278
2020-10-19;NO;Norway;146;0;16603;278
2020-10-20;NO;Norway;169;0;16772;278
2020-10-21;NO;Norway;192;1;16964;279
2020-10-22;NO;Norway;270;0;17234;279
2020-10-23;NO;Norway;298;0;17532;279
2020-10-24;NO;Norway;217;0;17749;279
2020-10-25;NO;Norway;160;0;17909;279
2020-10-26;NO;Norway;433;0;18342;279
2020-10-27;NO;Norway;324;1;18666;280
2020-10-28;NO;Norway;403;0;19069;280
2020-10-29;NO;Norway;495;1;19564;281
2020-10-30;NO;Norway;498;1;20062;282
2020-10-31;NO;Norway;269;0;20331;282
2020-11-01;NO;Norway;304;0;20635;282
2020-11-02;NO;Norway;704;0;21339;282
2020-11-03;NO;Norway;617;0;21956;282
2020-11-04;NO;Norway;622;0;22578;282
2020-11-05;NO;Norway;651;2;23229;284
2020-11-06;NO;Norway;606;1;23835;285
2020-11-07;NO;Norway;408;0;24243;285
2020-11-08;NO;Norway;489;0;24732;285
2020-11-09;NO;Norway;593;0;25325;285
2020-11-10;NO;Norway;562;0;25887;285
2020-11-11;NO;Norway;624;0;26511;285
2020-11-12;NO;Norway;717;6;27228;291
2020-11-13;NO;Norway;688;3;27916;294
2020-11-14;NO;Norway;518;0;28434;294
2020-11-15;NO;Norway;0;0;28434;294
2020-11-16;NO;Norway;0;0;28434;294
2020-11-17;NO;Norway;1680;4;30114;298
2020-11-18;NO;Norway;656;2;30770;300
2020-11-19;NO;Norway;671;5;31441;305
2020-11-20;NO;Norway;573;1;32014;306
2020-11-21;NO;Norway;338;0;32352;306
2020-11-22;NO;Norway;413;0;32765;306
2020-11-23;NO;Norway;418;5;33183;311
2020-11-24;NO;Norway;534;3;33717;314
2020-11-25;NO;Norway;551;2;34268;316
2020-11-26;NO;Norway;480;0;34748;316
2020-11-27;NO;Norway;445;12;35193;328
2020-11-28;NO;Norway;353;0;35546;328
2020-11-29;NO;Norway;282;0;35828;328
2020-11-30;NO;Norway;322;4;36150;332
2020-12-01;NO;Norway;441;2;36591;334
2020-12-02;NO;Norway;378;17;36969;351
2020-12-03;NO;Norway;402;2;37371;353
2020-12-04;NO;Norway;430;1;37801;354
2020-12-05;NO;Norway;272;0;38073;354
2020-12-06;NO;Norway;250;0;38323;354
2020-12-07;NO;Norway;380;5;38703;359
2020-12-08;NO;Norway;460;2;39163;361
2020-12-09;NO;Norway;362;0;39525;361
2020-12-10;NO;Norway;498;21;40023;382
2020-12-11;NO;Norway;416;5;40439;387
2020-12-12;NO;Norway;364;0;40803;387
2020-12-13;NO;Norway;200;0;41003;387
2020-12-14;NO;Norway;331;6;41334;393
2020-12-15;NO;Norway;518;2;41852;395
2020-12-16;NO;Norway;460;7;42312;402
2020-12-17;NO;Norway;464;2;42776;404
2020-12-18;NO;Norway;431;0;43207;404
2020-12-19;NO;Norway;375;0;43582;404
2020-12-20;NO;Norway;323;0;43905;404
2020-12-21;NO;Norway;431;1;44336;405
2020-12-22;NO;Norway;596;0;44932;405
2020-12-23;NO;Norway;523;16;45455;421
2020-12-24;NO;Norway;476;0;45931;421
2020-12-25;NO;Norway;317;0;46248;421
2020-12-26;NO;Norway;430;0;46678;421
2020-12-27;NO;Norway;381;0;47059;421
2020-12-28;NO;Norway;526;8;47585;429
2020-12-29;NO;Norway;693;4;48278;433
2020-12-30;NO;Norway;732;3;49010;436
2020-12-31;NO;Norway;557;0;49567;436
2021-01-01;NO;Norway;236;0;49803;436
2021-01-02;NO;Norway;463;0;50266;436
2021-01-03;NO;Norway;450;0;50716;436
2021-01-04;NO;Norway;529;13;51245;449
2021-01-05;NO;Norway;935;3;52180;452
2021-01-06;NO;Norway;787;13;52967;465
2021-01-07;NO;Norway;825;2;53792;467
2021-01-08;NO;Norway;684;5;54476;472
2021-01-09;NO;Norway;443;0;54919;472
2021-01-10;NO;Norway;555;0;55474;472
2021-01-11;NO;Norway;429;6;55903;478
2021-01-12;NO;Norway;712;4;56615;482
2021-01-13;NO;Norway;667;27;57282;509
2021-01-14;NO;Norway;454;2;57736;511
2021-01-15;NO;Norway;466;6;58202;517
2021-01-16;NO;Norway;243;0;58445;517
2021-01-17;NO;Norway;206;0;58651;517
2021-01-18;NO;Norway;383;4;59034;521
2021-01-19;NO;Norway;422;4;59456;525
2021-01-20;NO;Norway;431;18;59887;543
2021-01-21;NO;Norway;372;1;60259;544
2021-01-22;NO;Norway;306;0;60565;544
2021-01-23;NO;Norway;238;0;60803;544
2021-01-24;NO;Norway;279;0;61082;544
2021-01-25;NO;Norway;233;4;61315;548
2021-01-26;NO;Norway;279;2;61594;550
2021-01-27;NO;Norway;367;6;61961;556
2021-01-28;NO;Norway;315;1;62276;557
2021-01-29;NO;Norway;299;7;62575;564
2021-01-30;NO;Norway;218;0;62793;564
2021-01-31;NO;Norway;173;0;62966;564
2021-02-01;NO;Norway;296;3;63262;567
2021-02-02;NO;Norway;291;1;63553;568
2021-02-03;NO;Norway;286;6;63839;574
2021-02-04;NO;Norway;373;8;64212;582
2021-02-05;NO;Norway;271;0;64483;582
2021-02-06;NO;Norway;170;0;64653;582
2021-02-07;NO;Norway;119;0;64772;582
2021-02-08;NO;Norway;346;0;65118;582
2021-02-09;NO;Norway;220;1;65338;583
2021-02-10;NO;Norway;209;9;65547;592
2021-02-11;NO;Norway;264;0;65811;592
2021-02-12;NO;Norway;425;0;66236;592
2021-02-13;NO;Norway;156;0;66392;592
2021-02-14;NO;Norway;109;0;66501;592
2021-02-15;NO;Norway;353;1;66854;593
2021-02-16;NO;Norway;286;0;67140;593
2021-02-17;NO;Norway;358;14;67498;607
2021-02-18;NO;Norway;326;0;67824;607
2021-02-19;NO;Norway;283;0;68107;607
2021-02-20;NO;Norway;208;0;68315;607
2021-02-21;NO;Norway;217;0;68532;607
2021-02-22;NO;Norway;226;1;68758;608
2021-02-23;NO;Norway;390;0;69148;608
2021-02-24;NO;Norway;341;12;69489;620
2021-02-25;NO;Norway;551;0;70040;620
2021-02-26;NO;Norway;524;2;70564;622
2021-02-27;NO;Norway;262;0;70826;622
2021-02-28;NO;Norway;180;0;71006;622
2021-03-01;NO;Norway;729;1;71735;623
2021-03-02;NO;Norway;499;0;72234;623
2021-03-03;NO;Norway;689;9;72923;632
2021-03-04;NO;Norway;570;0;73493;632
2021-03-05;NO;Norway;690;0;74183;632
2021-03-06;NO;Norway;363;0;74546;632
2021-03-07;NO;Norway;396;0;74942;632
2021-03-08;NO;Norway;828;0;75770;632
2021-03-09;NO;Norway;714;0;76484;632
2021-03-10;NO;Norway;685;0;77169;632
2021-03-11;NO;Norway;872;7;78041;639
2021-03-12;NO;Norway;905;0;78946;639
2021-03-13;NO;Norway;854;0;79800;639
2021-03-14;NO;Norway;640;0;80440;639
2021-03-15;NO;Norway;865;1;81305;640
2021-03-16;NO;Norway;1150;1;82455;641
2021-03-17;NO;Norway;1064;7;83519;648
2021-03-18;NO;Norway;1034;0;84553;648
2021-03-19;NO;Norway;989;0;85542;648
2021-03-20;NO;Norway;820;0;86362;648
2021-03-21;NO;Norway;577;0;86939;648
2021-03-22;NO;Norway;1096;1;88035;649
2021-03-23;NO;Norway;1085;0;89120;649
2021-03-24;NO;Norway;984;7;90104;656
2021-03-25;NO;Norway;831;0;90935;656
2021-03-26;NO;Norway;1072;0;92007;656
2021-03-27;NO;Norway;462;0;92469;656
2021-03-28;NO;Norway;681;0;93150;656
2021-03-29;NO;Norway;989;4;94139;660
2021-03-30;NO;Norway;1069;1;95208;661
2021-03-31;NO;Norway;871;12;96079;673
2021-04-01;NO;Norway;691;0;96770;673
2021-04-02;NO;Norway;640;0;97410;673
2021-04-03;NO;Norway;692;0;98102;673
2021-04-04;NO;Norway;574;0;98676;673
2021-04-05;NO;Norway;573;3;99249;676
2021-04-06;NO;Norway;900;1;100149;677
2021-04-07;NO;Norway;933;6;101082;683
2021-04-08;NO;Norway;878;1;101960;684
2021-04-09;NO;Norway;759;0;102719;684
2021-04-10;NO;Norway;255;0;102974;684
2021-04-11;NO;Norway;647;0;103621;684
2021-04-12;NO;Norway;648;3;104269;687
2021-04-13;NO;Norway;739;1;105008;688
2021-04-14;NO;Norway;599;18;105607;706
2021-04-15;NO;Norway;617;1;106224;707
2021-04-16;NO;Norway;503;1;106727;708
2021-04-17;NO;Norway;417;0;107144;708
2021-04-18;NO;Norway;366;0;107510;708
2021-04-19;NO;Norway;518;1;108028;709
2021-04-20;NO;Norway;314;0;108342;709
2021-04-21;NO;Norway;795;25;109137;734
2021-04-22;NO;Norway;444;1;109581;735
2021-04-23;NO;Norway;480;1;110061;736
2021-04-24;NO;Norway;329;0;110390;736
2021-04-25;NO;Norway;222;0;110612;736
2021-04-26;NO;Norway;550;0;111162;736
2021-04-27;NO;Norway;524;0;111686;736
2021-04-28;NO;Norway;470;17;112156;753
2021-04-29;NO;Norway;385;1;112541;754
2021-04-30;NO;Norway;429;2;112970;756
2021-05-01;NO;Norway;289;0;113259;756
2021-05-02;NO;Norway;210;0;113469;756
2021-05-03;NO;Norway;483;1;113952;757
2021-05-04;NO;Norway;484;0;114436;757
2021-05-05;NO;Norway;469;10;114905;767
2021-05-06;NO;Norway;506;0;115411;767
2021-05-07;NO;Norway;407;0;115818;767
2021-05-08;NO;Norway;316;0;116134;767
2021-05-09;NO;Norway;231;0;116365;767
2021-05-10;NO;Norway;657;0;117022;767
2021-05-11;NO;Norway;473;0;117495;767
2021-05-12;NO;Norway;500;7;117995;774
2021-05-13;NO;Norway;320;0;118315;774
2021-05-14;NO;Norway;425;0;118740;774
2021-05-15;NO;Norway;312;0;119052;774
2021-05-16;NO;Norway;247;0;119299;774
2021-05-17;NO;Norway;201;0;119500;774
2021-05-18;NO;Norway;314;0;119814;774
2021-05-19;NO;Norway;478;7;120292;781
2021-05-20;NO;Norway;505;0;120797;781
2021-05-21;NO;Norway;714;0;121511;781
2021-05-22;NO;Norway;452;0;121963;781
2021-05-23;NO;Norway;451;0;122414;781
2021-05-24;NO;Norway;238;1;122652;782
2021-05-25;NO;Norway;511;0;123163;782
2021-05-26;NO;Norway;499;1;123662;783
2021-05-27;NO;Norway;409;0;124071;783
2021-05-28;NO;Norway;339;0;124410;783
2021-05-29;NO;Norway;245;0;124655;783
2021-05-30;NO;Norway;169;0;124824;783
2021-05-31;NO;Norway;292;0;125116;783
2021-06-01;NO;Norway;460;0;125576;783
2021-06-02;NO;Norway;353;2;125929;785
2021-06-03;NO;Norway;289;0;126218;785
2021-06-04;NO;Norway;303;0;126521;785
2021-06-05;NO;Norway;168;0;126689;785
2021-06-06;NO;Norway;128;0;126817;785
2021-06-07;NO;Norway;249;-1;127066;784
2021-06-08;NO;Norway;188;0;127254;784
2021-06-09;NO;Norway;212;5;127466;789
2021-06-10;NO;Norway;210;0;127676;789
2021-06-11;NO;Norway;198;0;127874;789
2021-06-12;NO;Norway;112;0;127986;789
2021-06-13;NO;Norway;60;0;128046;789
2021-06-14;NO;Norway;231;0;128277;789
2021-06-15;NO;Norway;222;0;128499;789
2021-06-16;NO;Norway;180;1;128679;790
2021-06-17;NO;Norway;219;0;128898;790
2021-06-18;NO;Norway;197;0;129095;790
2021-06-19;NO;Norway;130;0;129225;790
2021-06-20;NO;Norway;108;0;129333;790
2021-06-21;NO;Norway;212;0;129545;790
2021-06-22;NO;Norway;221;0;129766;790
2021-06-23;NO;Norway;178;2;129944;792
2021-06-24;NO;Norway;326;0;130270;792
2021-06-25;NO;Norway;72;0;130342;792
2021-06-26;NO;Norway;149;0;130491;792
2021-06-27;NO;Norway;97;0;130588;792
2021-06-28;NO;Norway;156;0;130744;792
2021-06-29;NO;Norway;293;0;131037;792
2021-06-30;NO;Norway;279;2;131316;794
2021-07-01;NO;Norway;193;0;131509;794
2020-01-25;;Oceania;0;0;0;0
2020-01-26;;Oceania;4;0;4;0
2020-01-27;;Oceania;1;0;5;0
2020-01-28;;Oceania;0;0;5;0
2020-01-29;;Oceania;1;0;6;0
2020-01-30;;Oceania;3;0;9;0
2020-01-31;;Oceania;0;0;9;0
2020-02-01;;Oceania;3;0;12;0
2020-02-02;;Oceania;0;0;12;0
2020-02-03;;Oceania;0;0;12;0
2020-02-04;;Oceania;1;0;13;0
2020-02-05;;Oceania;0;0;13;0
2020-02-06;;Oceania;1;0;14;0
2020-02-07;;Oceania;1;0;15;0
2020-02-08;;Oceania;0;0;15;0
2020-02-09;;Oceania;0;0;15;0
2020-02-10;;Oceania;0;0;15;0
2020-02-11;;Oceania;0;0;15;0
2020-02-12;;Oceania;0;0;15;0
2020-02-13;;Oceania;0;0;15;0
2020-02-14;;Oceania;0;0;15;0
2020-02-15;;Oceania;0;0;15;0
2020-02-16;;Oceania;0;0;15;0
2020-02-17;;Oceania;0;0;15;0
2020-02-18;;Oceania;0;0;15;0
2020-02-19;;Oceania;0;0;15;0
2020-02-20;;Oceania;0;0;15;0
2020-02-21;;Oceania;0;0;15;0
2020-02-22;;Oceania;0;0;15;0
2020-02-23;;Oceania;0;0;15;0
2020-02-24;;Oceania;0;0;15;0
2020-02-25;;Oceania;0;0;15;0
2020-02-26;;Oceania;0;0;15;0
2020-02-27;;Oceania;0;0;15;0
2020-02-28;;Oceania;1;0;16;0
2020-02-29;;Oceania;10;0;26;0
2020-03-01;;Oceania;2;1;28;1
2020-03-02;;Oceania;3;0;31;1
2020-03-03;;Oceania;9;0;40;1
2020-03-04;;Oceania;15;1;55;2
2020-03-05;;Oceania;3;0;58;2
2020-03-06;;Oceania;6;0;64;2
2020-03-07;;Oceania;4;0;68;2
2020-03-08;;Oceania;13;1;81;3
2020-03-09;;Oceania;15;0;96;3
2020-03-10;;Oceania;16;0;112;3
2020-03-11;;Oceania;21;0;133;3
2020-03-12;;Oceania;0;0;133;3
2020-03-13;;Oceania;72;0;205;3
2020-03-14;;Oceania;51;0;256;3
2020-03-15;;Oceania;49;0;305;3
2020-03-16;;Oceania;80;0;385;3
2020-03-17;;Oceania;79;2;464;5
2020-03-18;;Oceania;124;1;588;6
2020-03-19;;Oceania;122;0;710;6
2020-03-20;;Oceania;122;1;832;7
2020-03-21;;Oceania;293;0;1125;7
2020-03-22;;Oceania;529;0;1654;7
2020-03-23;;Oceania;134;0;1788;7
2020-03-24;;Oceania;416;1;2204;8
2020-03-25;;Oceania;371;0;2575;8
2020-03-26;;Oceania;524;5;3099;13
2020-03-27;;Oceania;418;0;3517;13
2020-03-28;;Oceania;580;1;4097;14
2020-03-29;;Oceania;407;3;4504;17
2020-03-30;;Oceania;452;1;4956;18
2020-03-31;;Oceania;256;1;5212;19
2020-04-01;;Oceania;364;2;5576;21
2020-04-02;;Oceania;345;4;5921;25
2020-04-03;;Oceania;285;4;6206;29
2020-04-04;;Oceania;307;2;6513;31
2020-04-05;;Oceania;226;5;6739;36
2020-04-06;;Oceania;180;5;6919;41
2020-04-07;;Oceania;153;5;7072;46
2020-04-08;;Oceania;165;5;7237;51
2020-04-09;;Oceania;127;1;7364;52
2020-04-10;;Oceania;152;4;7516;56
2020-04-11;;Oceania;117;5;7633;61
2020-04-12;;Oceania;30;3;7663;64
2020-04-13;;Oceania;55;2;7718;66
2020-04-14;;Oceania;81;5;7799;71
2020-04-15;;Oceania;45;1;7844;72
2020-04-16;;Oceania;43;0;7887;72
2020-04-17;;Oceania;68;5;7955;77
2020-04-18;;Oceania;59;1;8014;78
2020-04-19;;Oceania;51;1;8065;79
2020-04-20;;Oceania;23;0;8088;79
2020-04-21;;Oceania;27;1;8115;80
2020-04-22;;Oceania;14;1;8129;81
2020-04-23;;Oceania;15;11;8144;92
2020-04-24;;Oceania;20;5;8164;97
2020-04-25;;Oceania;26;1;8190;98
2020-04-26;;Oceania;19;4;8209;102
2020-04-27;;Oceania;10;0;8219;102
2020-04-28;;Oceania;25;6;8244;108
2020-04-29;;Oceania;10;2;8254;110
2020-04-30;;Oceania;17;2;8271;112
2020-05-01;;Oceania;18;1;8289;113
2020-05-02;;Oceania;23;1;8312;114
2020-05-03;;Oceania;23;1;8335;115
2020-05-04;;Oceania;24;1;8359;116
2020-05-05;;Oceania;30;2;8389;118
2020-05-06;;Oceania;20;0;8409;118
2020-05-07;;Oceania;20;0;8429;118
2020-05-08;;Oceania;7;0;8436;118
2020-05-09;;Oceania;23;0;8459;118
2020-05-10;;Oceania;12;0;8471;118
2020-05-11;;Oceania;22;0;8493;118
2020-05-12;;Oceania;10;1;8503;119
2020-05-13;;Oceania;9;0;8512;119
2020-05-14;;Oceania;31;0;8543;119
2020-05-15;;Oceania;16;0;8559;119
2020-05-16;;Oceania;10;0;8569;119
2020-05-17;;Oceania;10;1;8579;120
2020-05-18;;Oceania;14;0;8593;120
2020-05-19;;Oceania;8;1;8601;121
2020-05-20;;Oceania;9;0;8610;121
2020-05-21;;Oceania;15;1;8625;122
2020-05-22;;Oceania;4;0;8629;122
2020-05-23;;Oceania;15;1;8644;123
2020-05-24;;Oceania;0;0;8644;123
2020-05-25;;Oceania;12;0;8656;123
2020-05-26;;Oceania;13;1;8669;124
2020-05-27;;Oceania;11;1;8680;125
2020-05-28;;Oceania;15;0;8695;125
2020-05-29;;Oceania;19;0;8714;125
2020-05-30;;Oceania;8;0;8722;125
2020-05-31;;Oceania;10;0;8732;125
2020-06-01;;Oceania;19;-1;8751;124
2020-06-02;;Oceania;8;0;8759;124
2020-06-03;;Oceania;11;0;8770;124
2020-06-04;;Oceania;7;0;8777;124
2020-06-05;;Oceania;5;0;8782;124
2020-06-06;;Oceania;7;0;8789;124
2020-06-07;;Oceania;6;0;8795;124
2020-06-08;;Oceania;2;0;8797;124
2020-06-09;;Oceania;7;0;8804;124
2020-06-10;;Oceania;11;0;8815;124
2020-06-11;;Oceania;4;0;8819;124
2020-06-12;;Oceania;5;0;8824;124
2020-06-13;;Oceania;26;0;8850;124
2020-06-14;;Oceania;15;0;8865;124
2020-06-15;;Oceania;14;0;8879;124
2020-06-16;;Oceania;23;0;8902;124
2020-06-17;;Oceania;22;0;8924;124
2020-06-18;;Oceania;18;0;8942;124
2020-06-19;;Oceania;4;0;8946;124
2020-06-20;;Oceania;52;0;8998;124
2020-06-21;;Oceania;15;0;9013;124
2020-06-22;;Oceania;21;0;9034;124
2020-06-23;;Oceania;30;1;9064;125
2020-06-24;;Oceania;41;1;9105;126
2020-06-25;;Oceania;38;0;9143;126
2020-06-26;;Oceania;9;0;9152;126
2020-06-27;;Oceania;89;0;9241;126
2020-06-28;;Oceania;80;0;9321;126
2020-06-29;;Oceania;70;0;9391;126
2020-06-30;;Oceania;86;0;9477;126
2020-07-01;;Oceania;83;0;9560;126
2020-07-02;;Oceania;65;0;9625;126
2020-07-03;;Oceania;194;0;9819;126
2020-07-04;;Oceania;186;0;10005;126
2020-07-05;;Oceania;142;2;10147;128
2020-07-06;;Oceania;176;0;10323;128
2020-07-07;;Oceania;132;0;10455;128
2020-07-08;;Oceania;173;0;10628;128
2020-07-09;;Oceania;325;0;10953;128
2020-07-10;;Oceania;180;1;11133;129
2020-07-11;;Oceania;245;1;11378;130
2020-07-12;;Oceania;183;0;11561;130
2020-07-13;;Oceania;272;0;11833;130
2020-07-14;;Oceania;238;3;12071;133
2020-07-15;;Oceania;324;2;12395;135
2020-07-16;;Oceania;424;3;12819;138
2020-07-17;;Oceania;213;2;13032;140
2020-07-18;;Oceania;365;4;13397;144
2020-07-19;;Oceania;269;1;13666;145
2020-07-20;;Oceania;363;3;14029;148
2020-07-21;;Oceania;474;2;14503;150
2020-07-22;;Oceania;411;5;14914;155
2020-07-23;;Oceania;295;6;15209;161
2020-07-24;;Oceania;356;6;15565;167
2020-07-25;;Oceania;460;10;16025;177
2020-07-26;;Oceania;555;6;16580;183
2020-07-27;;Oceania;369;6;16949;189
2020-07-28;;Oceania;282;9;17231;198
2020-07-29;;Oceania;717;14;17948;212
2020-07-30;;Oceania;605;8;18553;220
2020-07-31;;Oceania;388;6;18941;226
2020-08-01;;Oceania;637;7;19578;233
2020-08-02;;Oceania;444;13;20022;246
2020-08-03;;Oceania;413;11;20435;257
2020-08-04;;Oceania;720;15;21155;272
2020-08-05;;Oceania;484;8;21639;280
2020-08-06;;Oceania;392;12;22031;292
2020-08-07;;Oceania;451;12;22482;304
2020-08-08;;Oceania;386;17;22868;321
2020-08-09;;Oceania;339;18;23207;339
2020-08-10;;Oceania;317;18;23524;357
2020-08-11;;Oceania;414;21;23938;378
2020-08-12;;Oceania;323;9;24261;387
2020-08-13;;Oceania;382;14;24643;401
2020-08-14;;Oceania;300;4;24943;405
2020-08-15;;Oceania;265;17;25208;422
2020-08-16;;Oceania;332;25;25540;447
2020-08-17;;Oceania;237;17;25777;464
2020-08-18;;Oceania;236;12;26013;476
2020-08-19;;Oceania;252;13;26265;489
2020-08-20;;Oceania;196;10;26461;499
2020-08-21;;Oceania;201;13;26662;512
2020-08-22;;Oceania;212;17;26874;529
2020-08-23;;Oceania;153;15;27027;544
2020-08-24;;Oceania;145;8;27172;552
2020-08-25;;Oceania;174;24;27346;576
2020-08-26;;Oceania;125;23;27471;599
2020-08-27;;Oceania;143;12;27614;611
2020-08-28;;Oceania;141;18;27755;629
2020-08-29;;Oceania;125;11;27880;640
2020-08-30;;Oceania;91;41;27971;681
2020-08-31;;Oceania;87;5;28058;686
2020-09-01;;Oceania;111;6;28169;692
2020-09-02;;Oceania;139;15;28308;707
2020-09-03;;Oceania;92;59;28400;766
2020-09-04;;Oceania;82;13;28482;779
2020-09-05;;Oceania;87;5;28569;784
2020-09-06;;Oceania;56;9;28625;793
2020-09-07;;Oceania;58;8;28683;801
2020-09-08;;Oceania;104;11;28787;812
2020-09-09;;Oceania;65;7;28852;819
2020-09-10;;Oceania;44;9;28896;828
2020-09-11;;Oceania;46;6;28942;834
2020-09-12;;Oceania;46;7;28988;841
2020-09-13;;Oceania;44;7;29032;848
2020-09-14;;Oceania;51;0;29083;848
2020-09-15;;Oceania;40;9;29123;857
2020-09-16;;Oceania;47;8;29170;865
2020-09-17;;Oceania;48;5;29218;870
2020-09-18;;Oceania;26;7;29244;877
2020-09-19;;Oceania;17;5;29261;882
2020-09-20;;Oceania;15;3;29276;885
2020-09-21;;Oceania;30;3;29306;888
2020-09-22;;Oceania;49;5;29355;893
2020-09-23;;Oceania;11;2;29366;895
2020-09-24;;Oceania;26;8;29392;903
2020-09-25;;Oceania;19;1;29411;904
2020-09-26;;Oceania;26;2;29437;906
2020-09-27;;Oceania;4;3;29441;909
2020-09-28;;Oceania;13;7;29454;916
2020-09-29;;Oceania;26;4;29480;920
2020-09-30;;Oceania;30;2;29510;922
2020-10-01;;Oceania;18;2;29528;924
2020-10-02;;Oceania;13;3;29541;927
2020-10-03;;Oceania;20;1;29561;928
2020-10-04;;Oceania;14;0;29575;928
2020-10-05;;Oceania;28;1;29603;929
2020-10-06;;Oceania;12;2;29615;931
2020-10-07;;Oceania;28;0;29643;931
2020-10-08;;Oceania;30;0;29673;931
2020-10-09;;Oceania;22;0;29695;931
2020-10-10;;Oceania;20;1;29715;932
2020-10-11;;Oceania;27;0;29742;932
2020-10-12;;Oceania;39;1;29781;933
2020-10-13;;Oceania;29;5;29810;938
2020-10-14;;Oceania;35;0;29845;938
2020-10-15;;Oceania;19;0;29864;938
2020-10-16;;Oceania;10;0;29874;938
2020-10-17;;Oceania;18;0;29892;938
2020-10-18;;Oceania;9;1;29901;939
2020-10-19;;Oceania;7;0;29908;939
2020-10-20;;Oceania;63;0;29971;939
2020-10-21;;Oceania;18;0;29989;939
2020-10-22;;Oceania;30;0;30019;939
2020-10-23;;Oceania;30;0;30049;939
2020-10-24;;Oceania;19;0;30068;939
2020-10-25;;Oceania;17;0;30085;939
2020-10-26;;Oceania;20;0;30105;939
2020-10-27;;Oceania;20;2;30125;941
2020-10-28;;Oceania;20;0;30145;941
2020-10-29;;Oceania;17;0;30162;941
2020-10-30;;Oceania;13;0;30175;941
2020-10-31;;Oceania;12;0;30187;941
2020-11-01;;Oceania;10;0;30197;941
2020-11-02;;Oceania;20;0;30217;941
2020-11-03;;Oceania;22;0;30239;941
2020-11-04;;Oceania;10;0;30249;941
2020-11-05;;Oceania;14;0;30263;941
2020-11-06;;Oceania;10;0;30273;941
2020-11-07;;Oceania;12;0;30285;941
2020-11-08;;Oceania;13;0;30298;941
2020-11-09;;Oceania;8;0;30306;941
2020-11-10;;Oceania;4;0;30310;941
2020-11-11;;Oceania;8;0;30318;941
2020-11-12;;Oceania;5;0;30323;941
2020-11-13;;Oceania;10;0;30333;941
2020-11-14;;Oceania;32;0;30365;941
2020-11-15;;Oceania;40;0;30405;941
2020-11-16;;Oceania;13;0;30418;941
2020-11-17;;Oceania;25;0;30443;941
2020-11-18;;Oceania;13;0;30456;941
2020-11-19;;Oceania;10;0;30466;941
2020-11-20;;Oceania;20;0;30486;941
2020-11-21;;Oceania;24;0;30510;941
2020-11-22;;Oceania;15;0;30525;941
2020-11-23;;Oceania;36;0;30561;941
2020-11-24;;Oceania;22;0;30583;941
2020-11-25;;Oceania;28;0;30611;941
2020-11-26;;Oceania;15;0;30626;941
2020-11-27;;Oceania;17;0;30643;941
2020-11-28;;Oceania;6;0;30649;941
2020-11-29;;Oceania;16;1;30665;942
2020-11-30;;Oceania;28;0;30693;942
2020-12-01;;Oceania;25;0;30718;942
2020-12-02;;Oceania;25;0;30743;942
2020-12-03;;Oceania;12;0;30755;942
2020-12-04;;Oceania;18;0;30773;942
2020-12-05;;Oceania;9;0;30782;942
2020-12-06;;Oceania;8;0;30790;942
2020-12-07;;Oceania;21;0;30811;942
2020-12-08;;Oceania;22;0;30833;942
2020-12-09;;Oceania;7;0;30840;942
2020-12-10;;Oceania;15;0;30855;942
2020-12-11;;Oceania;50;1;30905;943
2020-12-12;;Oceania;9;0;30914;943
2020-12-13;;Oceania;14;0;30928;943
2020-12-14;;Oceania;11;0;30939;943
2020-12-15;;Oceania;20;0;30959;943
2020-12-16;;Oceania;12;0;30971;943
2020-12-17;;Oceania;62;0;31033;943
2020-12-18;;Oceania;33;0;31066;943
2020-12-19;;Oceania;48;0;31114;943
2020-12-20;;Oceania;35;0;31149;943
2020-12-21;;Oceania;22;1;31171;944
2020-12-22;;Oceania;25;0;31196;944
2020-12-23;;Oceania;25;0;31221;944
2020-12-24;;Oceania;31;0;31252;944
2020-12-25;;Oceania;23;0;31275;944
2020-12-26;;Oceania;27;0;31302;944
2020-12-27;;Oceania;29;1;31331;945
2020-12-28;;Oceania;19;0;31350;945
2020-12-29;;Oceania;35;0;31385;945
2020-12-30;;Oceania;35;0;31420;945
2020-12-31;;Oceania;20;0;31440;945
2021-01-01;;Oceania;35;0;31475;945
2021-01-02;;Oceania;43;0;31518;945
2021-01-03;;Oceania;39;0;31557;945
2021-01-04;;Oceania;18;0;31575;945
2021-01-05;;Oceania;23;0;31598;945
2021-01-06;;Oceania;12;0;31610;945
2021-01-07;;Oceania;25;0;31635;945
2021-01-08;;Oceania;23;0;31658;945
2021-01-09;;Oceania;44;0;31702;945
2021-01-10;;Oceania;22;0;31724;945
2021-01-11;;Oceania;28;0;31752;945
2021-01-12;;Oceania;26;0;31778;945
2021-01-13;;Oceania;20;0;31798;945
2021-01-14;;Oceania;28;0;31826;945
2021-01-15;;Oceania;20;0;31846;945
2021-01-16;;Oceania;31;0;31877;945
2021-01-17;;Oceania;19;0;31896;945
2021-01-18;;Oceania;10;0;31906;945
2021-01-19;;Oceania;14;0;31920;945
2021-01-20;;Oceania;10;0;31930;945
2021-01-21;;Oceania;16;0;31946;945
2021-01-22;;Oceania;5;0;31951;945
2021-01-23;;Oceania;13;0;31964;945
2021-01-24;;Oceania;16;0;31980;945
2021-01-25;;Oceania;5;0;31985;945
2021-01-26;;Oceania;26;0;32011;945
2021-01-27;;Oceania;13;0;32024;945
2021-01-28;;Oceania;11;0;32035;945
2021-01-29;;Oceania;5;0;32040;945
2021-01-30;;Oceania;6;0;32046;945
2021-01-31;;Oceania;7;0;32053;945
2021-02-01;;Oceania;24;0;32077;945
2021-02-02;;Oceania;7;0;32084;945
2021-02-03;;Oceania;15;0;32099;945
2021-02-04;;Oceania;6;0;32105;945
2021-02-05;;Oceania;30;0;32135;945
2021-02-06;;Oceania;8;0;32143;945
2021-02-07;;Oceania;10;0;32153;945
2021-02-08;;Oceania;10;0;32163;945
2021-02-09;;Oceania;13;0;32176;945
2021-02-10;;Oceania;9;0;32185;945
2021-02-11;;Oceania;24;0;32209;945
2021-02-12;;Oceania;7;0;32216;945
2021-02-13;;Oceania;8;0;32224;945
2021-02-14;;Oceania;8;0;32232;945
2021-02-15;;Oceania;7;1;32239;946
2021-02-16;;Oceania;50;1;32289;947
2021-02-17;;Oceania;5;0;32294;947
2021-02-18;;Oceania;10;0;32304;947
2021-02-19;;Oceania;4;0;32308;947
2021-02-20;;Oceania;21;0;32329;947
2021-02-21;;Oceania;11;0;32340;947
2021-02-22;;Oceania;99;0;32439;947
2021-02-23;;Oceania;59;0;32498;947
2021-02-24;;Oceania;40;1;32538;948
2021-02-25;;Oceania;102;1;32640;949
2021-02-26;;Oceania;11;0;32651;949
2021-02-27;;Oceania;56;0;32707;949
2021-02-28;;Oceania;10;0;32717;949
2021-03-01;;Oceania;102;2;32819;951
2021-03-02;;Oceania;12;0;32831;951
2021-03-03;;Oceania;20;0;32851;951
2021-03-04;;Oceania;14;0;32865;951
2021-03-05;;Oceania;144;2;33009;953
2021-03-06;;Oceania;6;0;33015;953
2021-03-07;;Oceania;109;0;33124;953
2021-03-08;;Oceania;111;0;33235;953
2021-03-09;;Oceania;85;0;33320;953
2021-03-10;;Oceania;22;0;33342;953
2021-03-11;;Oceania;91;5;33433;958
2021-03-12;;Oceania;15;0;33448;958
2021-03-13;;Oceania;6;0;33454;958
2021-03-14;;Oceania;374;0;33828;958
2021-03-15;;Oceania;105;5;33933;963
2021-03-16;;Oceania;101;0;34034;963
2021-03-17;;Oceania;12;0;34046;963
2021-03-18;;Oceania;156;5;34202;968
2021-03-19;;Oceania;188;5;34390;973
2021-03-20;;Oceania;440;0;34830;973
2021-03-21;;Oceania;19;0;34849;973
2021-03-22;;Oceania;279;0;35128;973
2021-03-23;;Oceania;417;1;35545;974
2021-03-24;;Oceania;366;2;35911;976
2021-03-25;;Oceania;12;0;35923;976
2021-03-26;;Oceania;566;0;36489;976
2021-03-27;;Oceania;8;0;36497;976
2021-03-28;;Oceania;552;6;37049;982
2021-03-29;;Oceania;187;4;37236;986
2021-03-30;;Oceania;281;7;37517;993
2021-03-31;;Oceania;394;4;37911;997
2021-04-01;;Oceania;132;0;38043;997
2021-04-02;;Oceania;371;0;38414;997
2021-04-03;;Oceania;151;0;38565;997
2021-04-04;;Oceania;434;1;38999;998
2021-04-05;;Oceania;393;6;39392;1004
2021-04-06;;Oceania;21;0;39413;1004
2021-04-07;;Oceania;258;1;39671;1005
2021-04-08;;Oceania;216;0;39887;1005
2021-04-09;;Oceania;17;0;39904;1005
2021-04-10;;Oceania;515;0;40419;1005
2021-04-11;;Oceania;123;0;40542;1005
2021-04-12;;Oceania;174;2;40716;1007
2021-04-13;;Oceania;242;0;40958;1007
2021-04-14;;Oceania;184;2;41142;1009
2021-04-15;;Oceania;219;11;41361;1020
2021-04-16;;Oceania;171;0;41532;1020
2021-04-17;;Oceania;28;0;41560;1020
2021-04-18;;Oceania;410;7;41970;1027
2021-04-19;;Oceania;238;2;42208;1029
2021-04-20;;Oceania;27;0;42235;1029
2021-04-21;;Oceania;21;1;42256;1030
2021-04-22;;Oceania;438;8;42694;1038
2021-04-23;;Oceania;15;0;42709;1038
2021-04-24;;Oceania;276;3;42985;1041
2021-04-25;;Oceania;89;0;43074;1041
2021-04-26;;Oceania;222;3;43296;1044
2021-04-27;;Oceania;39;0;43335;1044
2021-04-28;;Oceania;109;2;43444;1046
2021-04-29;;Oceania;112;0;43556;1046
2021-04-30;;Oceania;14;0;43570;1046
2021-05-01;;Oceania;142;8;43712;1054
2021-05-02;;Oceania;105;0;43817;1054
2021-05-03;;Oceania;71;0;43888;1054
2021-05-04;;Oceania;32;6;43920;1060
2021-05-05;;Oceania;27;0;43947;1060
2021-05-06;;Oceania;371;1;44318;1061
2021-05-07;;Oceania;13;0;44331;1061
2021-05-08;;Oceania;31;0;44362;1061
2021-05-09;;Oceania;14;0;44376;1061
2021-05-10;;Oceania;464;0;44840;1061
2021-05-11;;Oceania;426;9;45266;1070
2021-05-12;;Oceania;523;0;45789;1070
2021-05-13;;Oceania;252;4;46041;1074
2021-05-14;;Oceania;473;3;46514;1077
2021-05-15;;Oceania;12;0;46526;1077
2021-05-16;;Oceania;14;0;46540;1077
2021-05-17;;Oceania;9;0;46549;1077
2021-05-18;;Oceania;518;0;47067;1077
2021-05-19;;Oceania;437;5;47504;1082
2021-05-20;;Oceania;290;13;47794;1095
2021-05-21;;Oceania;11;0;47805;1095
2021-05-22;;Oceania;39;0;47844;1095
2021-05-23;;Oceania;18;0;47862;1095
2021-05-24;;Oceania;296;2;48158;1097
2021-05-25;;Oceania;73;0;48231;1097
2021-05-26;;Oceania;191;3;48422;1100
2021-05-27;;Oceania;86;3;48508;1103
2021-05-28;;Oceania;412;0;48920;1103
2021-05-29;;Oceania;15;0;48935;1103
2021-05-30;;Oceania;127;0;49062;1103
2021-05-31;;Oceania;112;0;49174;1103
2021-06-01;;Oceania;38;0;49212;1103
2021-06-02;;Oceania;59;0;49271;1103
2021-06-03;;Oceania;308;0;49579;1103
2021-06-04;;Oceania;51;0;49630;1103
2021-06-05;;Oceania;122;2;49752;1105
2021-06-06;;Oceania;170;0;49922;1105
2021-06-07;;Oceania;135;0;50057;1105
2021-06-08;;Oceania;127;0;50184;1105
2021-06-09;;Oceania;233;0;50417;1105
2021-06-10;;Oceania;88;0;50505;1105
2021-06-11;;Oceania;57;0;50562;1105
2021-06-12;;Oceania;104;0;50666;1105
2021-06-13;;Oceania;140;1;50806;1106
2021-06-14;;Oceania;99;0;50905;1106
2021-06-15;;Oceania;131;1;51036;1107
2021-06-16;;Oceania;247;0;51283;1107
2021-06-17;;Oceania;107;3;51390;1110
2021-06-18;;Oceania;128;0;51518;1110
2021-06-19;;Oceania;297;6;51815;1116
2021-06-20;;Oceania;192;1;52007;1117
2021-06-21;;Oceania;217;0;52224;1117
2021-06-22;;Oceania;197;2;52421;1119
2021-06-23;;Oceania;369;4;52790;1123
2021-06-24;;Oceania;321;0;53111;1123
2021-06-25;;Oceania;252;1;53363;1124
2021-06-26;;Oceania;327;1;53690;1125
2021-06-27;;Oceania;300;0;53990;1125
2021-06-28;;Oceania;276;2;54266;1127
2021-06-29;;Oceania;355;4;54621;1131
2021-06-30;;Oceania;315;0;54936;1131
2021-07-01;;Oceania;472;3;55408;1134
2020-02-24;OM;Oman;2;0;2;0
2020-02-25;OM;Oman;0;0;2;0
2020-02-26;OM;Oman;2;0;4;0
2020-02-27;OM;Oman;0;0;4;0
2020-02-28;OM;Oman;0;0;4;0
2020-02-29;OM;Oman;2;0;6;0
2020-03-01;OM;Oman;0;0;6;0
2020-03-02;OM;Oman;0;0;6;0
2020-03-03;OM;Oman;6;0;12;0
2020-03-04;OM;Oman;3;0;15;0
2020-03-05;OM;Oman;1;0;16;0
2020-03-06;OM;Oman;0;0;16;0
2020-03-07;OM;Oman;0;0;16;0
2020-03-08;OM;Oman;0;0;16;0
2020-03-09;OM;Oman;0;0;16;0
2020-03-10;OM;Oman;2;0;18;0
2020-03-11;OM;Oman;0;0;18;0
2020-03-12;OM;Oman;0;0;18;0
2020-03-13;OM;Oman;1;0;19;0
2020-03-14;OM;Oman;0;0;19;0
2020-03-15;OM;Oman;3;0;22;0
2020-03-16;OM;Oman;0;0;22;0
2020-03-17;OM;Oman;2;0;24;0
2020-03-18;OM;Oman;15;0;39;0
2020-03-19;OM;Oman;9;0;48;0
2020-03-20;OM;Oman;0;0;48;0
2020-03-21;OM;Oman;4;0;52;0
2020-03-22;OM;Oman;3;0;55;0
2020-03-23;OM;Oman;11;0;66;0
2020-03-24;OM;Oman;18;0;84;0
2020-03-25;OM;Oman;15;0;99;0
2020-03-26;OM;Oman;10;0;109;0
2020-03-27;OM;Oman;22;0;131;0
2020-03-28;OM;Oman;21;0;152;0
2020-03-29;OM;Oman;15;0;167;0
2020-03-30;OM;Oman;12;0;179;0
2020-03-31;OM;Oman;13;1;192;1
2020-04-01;OM;Oman;18;0;210;1
2020-04-02;OM;Oman;21;0;231;1
2020-04-03;OM;Oman;21;0;252;1
2020-04-04;OM;Oman;25;1;277;2
2020-04-05;OM;Oman;21;0;298;2
2020-04-06;OM;Oman;33;0;331;2
2020-04-07;OM;Oman;40;0;371;2
2020-04-08;OM;Oman;48;0;419;2
2020-04-09;OM;Oman;38;1;457;3
2020-04-10;OM;Oman;27;0;484;3
2020-04-11;OM;Oman;62;0;546;3
2020-04-12;OM;Oman;53;1;599;4
2020-04-13;OM;Oman;128;0;727;4
2020-04-14;OM;Oman;86;0;813;4
2020-04-15;OM;Oman;97;0;910;4
2020-04-16;OM;Oman;109;0;1019;4
2020-04-17;OM;Oman;50;2;1069;6
2020-04-18;OM;Oman;111;0;1180;6
2020-04-19;OM;Oman;86;1;1266;7
2020-04-20;OM;Oman;144;0;1410;7
2020-04-21;OM;Oman;98;1;1508;8
2020-04-22;OM;Oman;106;0;1614;8
2020-04-23;OM;Oman;102;1;1716;9
2020-04-24;OM;Oman;74;1;1790;10
2020-04-25;OM;Oman;115;0;1905;10
2020-04-26;OM;Oman;93;0;1998;10
2020-04-27;OM;Oman;51;0;2049;10
2020-04-28;OM;Oman;82;0;2131;10
2020-04-29;OM;Oman;143;0;2274;10
2020-04-30;OM;Oman;74;1;2348;11
2020-05-01;OM;Oman;99;0;2447;11
2020-05-02;OM;Oman;36;1;2483;12
2020-05-03;OM;Oman;85;0;2568;12
2020-05-04;OM;Oman;69;0;2637;12
2020-05-05;OM;Oman;98;1;2735;13
2020-05-06;OM;Oman;168;0;2903;13
2020-05-07;OM;Oman;55;2;2958;15
2020-05-08;OM;Oman;154;1;3112;16
2020-05-09;OM;Oman;112;1;3224;17
2020-05-10;OM;Oman;175;0;3399;17
2020-05-11;OM;Oman;174;0;3573;17
2020-05-12;OM;Oman;148;0;3721;17
2020-05-13;OM;Oman;298;0;4019;17
2020-05-14;OM;Oman;322;1;4341;18
2020-05-15;OM;Oman;284;2;4625;20
2020-05-16;OM;Oman;404;1;5029;21
2020-05-17;OM;Oman;157;1;5186;22
2020-05-18;OM;Oman;193;3;5379;25
2020-05-19;OM;Oman;292;2;5671;27
2020-05-20;OM;Oman;372;3;6043;30
2020-05-21;OM;Oman;327;1;6370;31
2020-05-22;OM;Oman;424;3;6794;34
2020-05-23;OM;Oman;463;2;7257;36
2020-05-24;OM;Oman;513;1;7770;37
2020-05-25;OM;Oman;0;0;7770;37
2020-05-26;OM;Oman;348;0;8118;37
2020-05-27;OM;Oman;255;2;8373;39
2020-05-28;OM;Oman;636;1;9009;40
2020-05-29;OM;Oman;811;0;9820;40
2020-05-30;OM;Oman;603;2;10423;42
2020-05-31;OM;Oman;1014;7;11437;49
2020-06-01;OM;Oman;786;1;12223;50
2020-06-02;OM;Oman;576;9;12799;59
2020-06-03;OM;Oman;738;8;13537;67
2020-06-04;OM;Oman;779;0;14316;67
2020-06-05;OM;Oman;770;5;15086;72
2020-06-06;OM;Oman;930;0;16016;72
2020-06-07;OM;Oman;866;3;16882;75
2020-06-08;OM;Oman;604;6;17486;81
2020-06-09;OM;Oman;712;2;18198;83
2020-06-10;OM;Oman;689;1;18887;84
2020-06-11;OM;Oman;1067;5;19954;89
2020-06-12;OM;Oman;1117;7;21071;96
2020-06-13;OM;Oman;1006;3;22077;99
2020-06-14;OM;Oman;1404;5;23481;104
2020-06-15;OM;Oman;1043;4;24524;108
2020-06-16;OM;Oman;745;6;25269;114
2020-06-17;OM;Oman;810;2;26079;116
2020-06-18;OM;Oman;739;3;26818;119
2020-06-19;OM;Oman;852;6;27670;125
2020-06-20;OM;Oman;896;3;28566;128
2020-06-21;OM;Oman;905;3;29471;131
2020-06-22;OM;Oman;1605;6;31076;137
2020-06-23;OM;Oman;1318;3;32394;140
2020-06-24;OM;Oman;1142;2;33536;142
2020-06-25;OM;Oman;1366;2;34902;144
2020-06-26;OM;Oman;1132;9;36034;153
2020-06-27;OM;Oman;919;6;36953;159
2020-06-28;OM;Oman;1197;4;38150;163
2020-06-29;OM;Oman;910;6;39060;169
2020-06-30;OM;Oman;1010;7;40070;176
2020-07-01;OM;Oman;1124;9;41194;185
2020-07-02;OM;Oman;1361;3;42555;188
2020-07-03;OM;Oman;1374;5;43929;193
2020-07-04;OM;Oman;1177;10;45106;203
2020-07-05;OM;Oman;1072;10;46178;213
2020-07-06;OM;Oman;1557;5;47735;218
2020-07-07;OM;Oman;1262;6;48997;224
2020-07-08;OM;Oman;1210;9;50207;233
2020-07-09;OM;Oman;1518;3;51725;236
2020-07-10;OM;Oman;1889;8;53614;244
2020-07-11;OM;Oman;1083;4;54697;248
2020-07-12;OM;Oman;1318;9;56015;257
2020-07-13;OM;Oman;2164;2;58179;259
2020-07-14;OM;Oman;1389;14;59568;273
2020-07-15;OM;Oman;1679;8;61247;281
2020-07-16;OM;Oman;1327;9;62574;290
2020-07-17;OM;Oman;1619;8;64193;298
2020-07-18;OM;Oman;1311;10;65504;308
2020-07-19;OM;Oman;1157;10;66661;318
2020-07-20;OM;Oman;1739;8;68400;326
2020-07-21;OM;Oman;1487;11;69887;337
2020-07-22;OM;Oman;1660;12;71547;349
2020-07-23;OM;Oman;1099;6;72646;355
2020-07-24;OM;Oman;1145;4;73791;359
2020-07-25;OM;Oman;1067;12;74858;371
2020-07-26;OM;Oman;1147;13;76005;384
2020-07-27;OM;Oman;1053;9;77058;393
2020-07-28;OM;Oman;846;9;77904;402
2020-07-29;OM;Oman;665;10;78569;412
2020-07-30;OM;Oman;590;9;79159;421
2020-07-31;OM;Oman;0;0;79159;421
2020-08-01;OM;Oman;0;0;79159;421
2020-08-02;OM;Oman;0;0;79159;421
2020-08-03;OM;Oman;0;0;79159;421
2020-08-04;OM;Oman;0;0;79159;421
2020-08-05;OM;Oman;1127;67;80286;488
2020-08-06;OM;Oman;427;4;80713;492
2020-08-07;OM;Oman;354;10;81067;502
2020-08-08;OM;Oman;290;7;81357;509
2020-08-09;OM;Oman;223;4;81580;513
2020-08-10;OM;Oman;207;8;81787;521
2020-08-11;OM;Oman;263;12;82050;533
2020-08-12;OM;Oman;249;6;82299;539
2020-08-13;OM;Oman;232;12;82531;551
2020-08-14;OM;Oman;212;6;82743;557
2020-08-15;OM;Oman;181;5;82924;562
2020-08-16;OM;Oman;162;10;83086;572
2020-08-17;OM;Oman;140;16;83226;588
2020-08-18;OM;Oman;192;9;83418;597
2020-08-19;OM;Oman;188;6;83606;603
2020-08-20;OM;Oman;163;6;83769;609
2020-08-21;OM;Oman;0;0;83769;609
2020-08-22;OM;Oman;0;0;83769;609
2020-08-23;OM;Oman;0;0;83769;609
2020-08-24;OM;Oman;740;28;84509;637
2020-08-25;OM;Oman;143;5;84652;642
2020-08-26;OM;Oman;166;4;84818;646
2020-08-27;OM;Oman;187;4;85005;650
2020-08-28;OM;Oman;0;0;85005;650
2020-08-29;OM;Oman;0;0;85005;650
2020-08-30;OM;Oman;539;27;85544;677
2020-08-31;OM;Oman;178;8;85722;685
2020-09-01;OM;Oman;206;4;85928;689
2020-09-02;OM;Oman;0;0;85928;689
2020-09-03;OM;Oman;452;16;86380;705
2020-09-04;OM;Oman;0;0;86380;705
2020-09-05;OM;Oman;0;0;86380;705
2020-09-06;OM;Oman;692;23;87072;728
2020-09-07;OM;Oman;256;6;87328;734
2020-09-08;OM;Oman;262;8;87590;742
2020-09-09;OM;Oman;349;9;87939;751
2020-09-10;OM;Oman;398;11;88337;762
2020-09-11;OM;Oman;0;0;88337;762
2020-09-12;OM;Oman;0;0;88337;762
2020-09-13;OM;Oman;1409;18;89746;780
2020-09-14;OM;Oman;476;10;90222;790
2020-09-15;OM;Oman;438;7;90660;797
2020-09-16;OM;Oman;536;8;91196;805
2020-09-17;OM;Oman;557;13;91753;818
2020-09-18;OM;Oman;0;0;91753;818
2020-09-19;OM;Oman;0;0;91753;818
2020-09-20;OM;Oman;1722;28;93475;846
2020-09-21;OM;Oman;576;7;94051;853
2020-09-22;OM;Oman;660;12;94711;865
2020-09-23;OM;Oman;628;10;95339;875
2020-09-24;OM;Oman;568;10;95907;885
2020-09-25;OM;Oman;0;0;95907;885
2020-09-26;OM;Oman;0;0;95907;885
2020-09-27;OM;Oman;1543;24;97450;909
2020-09-28;OM;Oman;607;15;98057;924
2020-09-29;OM;Oman;528;11;98585;935
2020-09-30;OM;Oman;0;0;98585;935
2020-10-01;OM;Oman;0;0;98585;935
2020-10-02;OM;Oman;0;0;98585;935
2020-10-03;OM;Oman;0;0;98585;935
2020-10-04;OM;Oman;2685;42;101270;977
2020-10-05;OM;Oman;544;8;101814;985
2020-10-06;OM;Oman;834;5;102648;990
2020-10-07;OM;Oman;817;10;103465;1000
2020-10-08;OM;Oman;664;9;104129;1009
2020-10-09;OM;Oman;0;0;104129;1009
2020-10-10;OM;Oman;0;0;104129;1009
2020-10-11;OM;Oman;1761;29;105890;1038
2020-10-12;OM;Oman;685;8;106575;1046
2020-10-13;OM;Oman;638;7;107213;1053
2020-10-14;OM;Oman;563;8;107776;1061
2020-10-15;OM;Oman;520;10;108296;1071
2020-10-16;OM;Oman;0;0;108296;1071
2020-10-17;OM;Oman;0;0;108296;1071
2020-10-18;OM;Oman;1657;30;109953;1101
2020-10-19;OM;Oman;641;13;110594;1114
2020-10-20;OM;Oman;439;8;111033;1122
2020-10-21;OM;Oman;451;15;111484;1137
2020-10-22;OM;Oman;353;10;111837;1147
2020-10-23;OM;Oman;0;0;111837;1147
2020-10-24;OM;Oman;0;0;111837;1147
2020-10-25;OM;Oman;1095;27;112932;1174
2020-10-26;OM;Oman;422;16;113354;1190
2020-10-27;OM;Oman;466;13;113820;1203
2020-10-28;OM;Oman;614;5;114434;1208
2020-10-29;OM;Oman;0;0;114434;1208
2020-10-30;OM;Oman;0;0;114434;1208
2020-10-31;OM;Oman;0;0;114434;1208
2020-11-01;OM;Oman;1300;38;115734;1246
2020-11-02;OM;Oman;418;10;116152;1256
2020-11-03;OM;Oman;376;8;116528;1264
2020-11-04;OM;Oman;319;11;116847;1275
2020-11-05;OM;Oman;320;11;117167;1286
2020-11-06;OM;Oman;0;0;117167;1286
2020-11-07;OM;Oman;0;0;117167;1286
2020-11-08;OM;Oman;973;15;118140;1301
2020-11-09;OM;Oman;363;9;118503;1310
2020-11-10;OM;Oman;381;6;118884;1316
2020-11-11;OM;Oman;302;5;119186;1321
2020-11-12;OM;Oman;256;5;119442;1326
2020-11-13;OM;Oman;0;0;119442;1326
2020-11-14;OM;Oman;0;0;119442;1326
2020-11-15;OM;Oman;947;12;120389;1338
2020-11-16;OM;Oman;329;12;120718;1350
2020-11-17;OM;Oman;0;0;120718;1350
2020-11-18;OM;Oman;411;10;121129;1360
2020-11-19;OM;Oman;231;5;121360;1365
2020-11-20;OM;Oman;0;0;121360;1365
2020-11-21;OM;Oman;0;0;121360;1365
2020-11-22;OM;Oman;721;15;122081;1380
2020-11-23;OM;Oman;275;6;122356;1386
2020-11-24;OM;Oman;223;5;122579;1391
2020-11-25;OM;Oman;0;0;122579;1391
2020-11-26;OM;Oman;0;0;122579;1391
2020-11-27;OM;Oman;0;0;122579;1391
2020-11-28;OM;Oman;0;0;122579;1391
2020-11-29;OM;Oman;905;27;123484;1418
2020-11-30;OM;Oman;215;5;123699;1423
2020-12-01;OM;Oman;209;7;123908;1430
2020-12-02;OM;Oman;237;0;124145;1430
2020-12-03;OM;Oman;184;5;124329;1435
2020-12-04;OM;Oman;0;0;124329;1435
2020-12-05;OM;Oman;0;0;124329;1435
2020-12-06;OM;Oman;557;9;124886;1444
2020-12-07;OM;Oman;229;8;125115;1452
2020-12-08;OM;Oman;210;2;125325;1454
2020-12-09;OM;Oman;165;7;125490;1461
2020-12-10;OM;Oman;179;2;125669;1463
2020-12-11;OM;Oman;0;0;125669;1463
2020-12-12;OM;Oman;0;0;125669;1463
2020-12-13;OM;Oman;571;8;126240;1471
2020-12-14;OM;Oman;264;1;126504;1472
2020-12-15;OM;Oman;215;3;126719;1475
2020-12-16;OM;Oman;116;5;126835;1480
2020-12-17;OM;Oman;184;3;127019;1483
2020-12-18;OM;Oman;0;0;127019;1483
2020-12-19;OM;Oman;0;0;127019;1483
2020-12-20;OM;Oman;648;5;127667;1488
2020-12-21;OM;Oman;264;1;127931;1489
2020-12-22;OM;Oman;212;1;128143;1490
2020-12-23;OM;Oman;93;1;128236;1491
2020-12-24;OM;Oman;54;0;128290;1491
2020-12-25;OM;Oman;0;0;128290;1491
2020-12-26;OM;Oman;0;0;128290;1491
2020-12-27;OM;Oman;182;4;128472;1495
2020-12-28;OM;Oman;91;0;128563;1495
2020-12-29;OM;Oman;70;2;128633;1497
2020-12-30;OM;Oman;86;0;128719;1497
2020-12-31;OM;Oman;148;2;128867;1499
2021-01-01;OM;Oman;0;0;128867;1499
2021-01-02;OM;Oman;0;0;128867;1499
2021-01-03;OM;Oman;537;2;129404;1501
2021-01-04;OM;Oman;180;1;129584;1502
2021-01-05;OM;Oman;190;0;129774;1502
2021-01-06;OM;Oman;114;2;129888;1504
2021-01-07;OM;Oman;182;1;130070;1505
2021-01-08;OM;Oman;0;0;130070;1505
2021-01-09;OM;Oman;0;0;130070;1505
2021-01-10;OM;Oman;538;3;130608;1508
2021-01-11;OM;Oman;172;0;130780;1508
2021-01-12;OM;Oman;164;0;130944;1508
2021-01-13;OM;Oman;142;0;131086;1508
2021-01-14;OM;Oman;178;1;131264;1509
2021-01-15;OM;Oman;0;0;131264;1509
2021-01-16;OM;Oman;0;0;131264;1509
2021-01-17;OM;Oman;526;3;131790;1512
2021-01-18;OM;Oman;221;2;132011;1514
2021-01-19;OM;Oman;135;2;132146;1516
2021-01-20;OM;Oman;171;0;132317;1516
2021-01-21;OM;Oman;169;1;132486;1517
2021-01-22;OM;Oman;0;0;132486;1517
2021-01-23;OM;Oman;0;0;132486;1517
2021-01-24;OM;Oman;558;4;133044;1521
2021-01-25;OM;Oman;209;1;133253;1522
2021-01-26;OM;Oman;154;2;133407;1524
2021-01-27;OM;Oman;167;1;133574;1525
2021-01-28;OM;Oman;154;2;133728;1527
2021-01-29;OM;Oman;0;0;133728;1527
2021-01-30;OM;Oman;0;0;133728;1527
2021-01-31;OM;Oman;598;2;134326;1529
2021-02-01;OM;Oman;198;3;134524;1532
2021-02-02;OM;Oman;161;0;134685;1532
2021-02-03;OM;Oman;171;0;134856;1532
2021-02-04;OM;Oman;185;0;135041;1532
2021-02-05;OM;Oman;0;0;135041;1532
2021-02-06;OM;Oman;0;0;135041;1532
2021-02-07;OM;Oman;633;2;135674;1534
2021-02-08;OM;Oman;316;1;135990;1535
2021-02-09;OM;Oman;197;1;136187;1536
2021-02-10;OM;Oman;190;1;136377;1537
2021-02-11;OM;Oman;245;2;136622;1539
2021-02-12;OM;Oman;0;0;136622;1539
2021-02-13;OM;Oman;0;0;136622;1539
2021-02-14;OM;Oman;684;3;137306;1542
2021-02-15;OM;Oman;286;1;137592;1543
2021-02-16;OM;Oman;337;1;137929;1544
2021-02-17;OM;Oman;277;5;138206;1549
2021-02-18;OM;Oman;288;0;138494;1549
2021-02-19;OM;Oman;0;0;138494;1549
2021-02-20;OM;Oman;0;0;138494;1549
2021-02-21;OM;Oman;868;3;139362;1552
2021-02-22;OM;Oman;330;3;139692;1555
2021-02-23;OM;Oman;297;2;139989;1557
2021-02-24;OM;Oman;311;1;140300;1558
2021-02-25;OM;Oman;288;4;140588;1562
2021-02-26;OM;Oman;0;0;140588;1562
2021-02-27;OM;Oman;0;0;140588;1562
2021-02-28;OM;Oman;908;8;141496;1570
2021-03-01;OM;Oman;312;7;141808;1577
2021-03-02;OM;Oman;361;3;142169;1580
2021-03-03;OM;Oman;358;3;142527;1583
2021-03-04;OM;Oman;369;0;142896;1583
2021-03-05;OM;Oman;0;0;142896;1583
2021-03-06;OM;Oman;0;0;142896;1583
2021-03-07;OM;Oman;1059;8;143955;1591
2021-03-08;OM;Oman;449;3;144404;1594
2021-03-09;OM;Oman;427;3;144831;1597
2021-03-10;OM;Oman;426;3;145257;1600
2021-03-11;OM;Oman;0;0;145257;1600
2021-03-12;OM;Oman;0;0;145257;1600
2021-03-13;OM;Oman;0;0;145257;1600
2021-03-14;OM;Oman;1610;8;146867;1608
2021-03-15;OM;Oman;556;1;147423;1609
2021-03-16;OM;Oman;587;5;148010;1614
2021-03-17;OM;Oman;548;3;148558;1617
2021-03-18;OM;Oman;577;3;149135;1620
2021-03-19;OM;Oman;0;0;149135;1620
2021-03-20;OM;Oman;0;0;149135;1620
2021-03-21;OM;Oman;1665;2;150800;1622
2021-03-22;OM;Oman;728;7;151528;1629
2021-03-23;OM;Oman;836;4;152364;1633
2021-03-24;OM;Oman;741;11;153105;1644
2021-03-25;OM;Oman;733;6;153838;1650
2021-03-26;OM;Oman;0;0;153838;1650
2021-03-27;OM;Oman;0;0;153838;1650
2021-03-28;OM;Oman;2249;11;156087;1661
2021-03-29;OM;Oman;796;1;156883;1662
2021-03-30;OM;Oman;1173;7;158056;1669
2021-03-31;OM;Oman;1162;9;159218;1678
2021-04-01;OM;Oman;800;3;160018;1681
2021-04-02;OM;Oman;0;0;160018;1681
2021-04-03;OM;Oman;0;0;160018;1681
2021-04-04;OM;Oman;3139;9;163157;1690
2021-04-05;OM;Oman;1117;32;164274;1722
2021-04-06;OM;Oman;1206;6;165480;1728
2021-04-07;OM;Oman;1205;7;166685;1735
2021-04-08;OM;Oman;1320;12;168005;1747
2021-04-09;OM;Oman;0;0;168005;1747
2021-04-10;OM;Oman;0;0;168005;1747
2021-04-11;OM;Oman;3544;29;171549;1776
2021-04-12;OM;Oman;1480;13;173029;1789
2021-04-13;OM;Oman;1335;9;174364;1798
2021-04-14;OM;Oman;1269;9;175633;1807
2021-04-15;OM;Oman;1035;14;176668;1821
2021-04-16;OM;Oman;0;0;176668;1821
2021-04-17;OM;Oman;0;0;176668;1821
2021-04-18;OM;Oman;3363;57;180031;1878
2021-04-19;OM;Oman;1399;12;181430;1890
2021-04-20;OM;Oman;1263;19;182693;1909
2021-04-21;OM;Oman;1077;17;183770;1926
2021-04-22;OM;Oman;1508;16;185278;1942
2021-04-23;OM;Oman;0;0;185278;1942
2021-04-24;OM;Oman;0;0;185278;1942
2021-04-25;OM;Oman;3538;35;188816;1977
2021-04-26;OM;Oman;1454;6;190270;1983
2021-04-27;OM;Oman;1128;9;191398;1992
2021-04-28;OM;Oman;928;9;192326;2001
2021-04-29;OM;Oman;927;9;193253;2010
2021-04-30;OM;Oman;0;0;193253;2010
2021-05-01;OM;Oman;0;0;193253;2010
2021-05-02;OM;Oman;2554;33;195807;2043
2021-05-03;OM;Oman;1093;10;196900;2053
2021-05-04;OM;Oman;902;9;197802;2062
2021-05-05;OM;Oman;770;9;198572;2071
2021-05-06;OM;Oman;772;12;199344;2083
2021-05-07;OM;Oman;0;0;199344;2083
2021-05-08;OM;Oman;0;0;199344;2083
2021-05-09;OM;Oman;2006;37;201350;2120
2021-05-10;OM;Oman;787;18;202137;2138
2021-05-11;OM;Oman;576;10;202713;2148
2021-05-12;OM;Oman;0;0;202713;2148
2021-05-13;OM;Oman;0;0;202713;2148
2021-05-14;OM;Oman;0;0;202713;2148
2021-05-15;OM;Oman;0;0;202713;2148
2021-05-16;OM;Oman;2798;45;205511;2193
2021-05-17;OM;Oman;786;13;206297;2206
2021-05-18;OM;Oman;812;13;207109;2219
2021-05-19;OM;Oman;696;9;207805;2228
2021-05-20;OM;Oman;802;11;208607;2239
2021-05-21;OM;Oman;0;0;208607;2239
2021-05-22;OM;Oman;0;0;208607;2239
2021-05-23;OM;Oman;1757;26;210364;2265
2021-05-24;OM;Oman;857;9;211221;2274
2021-05-25;OM;Oman;817;10;212038;2284
2021-05-26;OM;Oman;866;9;212904;2293
2021-05-27;OM;Oman;880;10;213784;2303
2021-05-28;OM;Oman;0;0;213784;2303
2021-05-29;OM;Oman;0;0;213784;2303
2021-05-30;OM;Oman;2399;31;216183;2334
2021-05-31;OM;Oman;1041;11;217224;2345
2021-06-01;OM;Oman;1047;11;218271;2356
2021-06-02;OM;Oman;1258;14;219529;2370
2021-06-03;OM;Oman;1173;15;220702;2385
2021-06-04;OM;Oman;0;0;220702;2385
2021-06-05;OM;Oman;0;0;220702;2385
2021-06-06;OM;Oman;3177;28;223879;2413
2021-06-07;OM;Oman;1216;11;225095;2424
2021-06-08;OM;Oman;1553;10;226648;2434
2021-06-09;OM;Oman;1931;14;228579;2448
2021-06-10;OM;Oman;1640;19;230219;2467
2021-06-11;OM;Oman;0;0;230219;2467
2021-06-12;OM;Oman;0;0;230219;2467
2021-06-13;OM;Oman;4415;46;234634;2513
2021-06-14;OM;Oman;1806;19;236440;2532
2021-06-15;OM;Oman;2126;33;238566;2565
2021-06-16;OM;Oman;2142;26;240708;2591
2021-06-17;OM;Oman;2015;35;242723;2626
2021-06-18;OM;Oman;0;0;242723;2626
2021-06-19;OM;Oman;0;0;242723;2626
2021-06-20;OM;Oman;5320;84;248043;2710
2021-06-21;OM;Oman;2529;31;250572;2741
2021-06-22;OM;Oman;2037;41;252609;2782
2021-06-23;OM;Oman;2047;34;254656;2816
2021-06-24;OM;Oman;1886;32;256542;2848
2021-06-25;OM;Oman;0;0;256542;2848
2021-06-26;OM;Oman;0;0;256542;2848
2021-06-27;OM;Oman;5517;119;262059;2967
2021-06-28;OM;Oman;2243;46;264302;3013
2021-06-29;OM;Oman;2234;43;266536;3056
2021-06-30;OM;Oman;2009;44;268545;3100
2021-07-01;OM;Oman;1959;40;270504;3140
2020-02-25;PK;Pakistan;2;0;2;0
2020-02-26;PK;Pakistan;0;0;2;0
2020-02-27;PK;Pakistan;0;0;2;0
2020-02-28;PK;Pakistan;2;0;4;0
2020-02-29;PK;Pakistan;0;0;4;0
2020-03-01;PK;Pakistan;0;0;4;0
2020-03-02;PK;Pakistan;1;0;5;0
2020-03-03;PK;Pakistan;0;0;5;0
2020-03-04;PK;Pakistan;0;0;5;0
2020-03-05;PK;Pakistan;1;0;6;0
2020-03-06;PK;Pakistan;0;0;6;0
2020-03-07;PK;Pakistan;0;0;6;0
2020-03-08;PK;Pakistan;0;0;6;0
2020-03-09;PK;Pakistan;10;0;16;0
2020-03-10;PK;Pakistan;3;0;19;0
2020-03-11;PK;Pakistan;1;0;20;0
2020-03-12;PK;Pakistan;8;0;28;0
2020-03-13;PK;Pakistan;3;0;31;0
2020-03-14;PK;Pakistan;22;0;53;0
2020-03-15;PK;Pakistan;83;0;136;0
2020-03-16;PK;Pakistan;100;0;236;0
2020-03-17;PK;Pakistan;63;0;299;0
2020-03-18;PK;Pakistan;155;2;454;2
2020-03-19;PK;Pakistan;47;1;501;3
2020-03-20;PK;Pakistan;229;0;730;3
2020-03-21;PK;Pakistan;46;2;776;5
2020-03-22;PK;Pakistan;99;1;875;6
2020-03-23;PK;Pakistan;97;1;972;7
2020-03-24;PK;Pakistan;91;1;1063;8
2020-03-25;PK;Pakistan;138;1;1201;9
2020-03-26;PK;Pakistan;172;2;1373;11
2020-03-27;PK;Pakistan;122;1;1495;12
2020-03-28;PK;Pakistan;102;2;1597;14
2020-03-29;PK;Pakistan;120;7;1717;21
2020-03-30;PK;Pakistan;221;5;1938;26
2020-03-31;PK;Pakistan;180;1;2118;27
2020-04-01;PK;Pakistan;303;7;2421;34
2020-04-02;PK;Pakistan;265;6;2686;40
2020-04-03;PK;Pakistan;132;1;2818;41
2020-04-04;PK;Pakistan;339;6;3157;47
2020-04-05;PK;Pakistan;609;6;3766;53
2020-04-06;PK;Pakistan;269;4;4035;57
2020-04-07;PK;Pakistan;228;4;4263;61
2020-04-08;PK;Pakistan;226;4;4489;65
2020-04-09;PK;Pakistan;206;1;4695;66
2020-04-10;PK;Pakistan;316;20;5011;86
2020-04-11;PK;Pakistan;219;5;5230;91
2020-04-12;PK;Pakistan;266;2;5496;93
2020-04-13;PK;Pakistan;341;3;5837;96
2020-04-14;PK;Pakistan;546;15;6383;111
2020-04-15;PK;Pakistan;536;17;6919;128
2020-04-16;PK;Pakistan;106;7;7025;135
2020-04-17;PK;Pakistan;613;8;7638;143
2020-04-18;PK;Pakistan;710;25;8348;168
2020-04-19;PK;Pakistan;70;8;8418;176
2020-04-20;PK;Pakistan;1147;25;9565;201
2020-04-21;PK;Pakistan;511;11;10076;212
2020-04-22;PK;Pakistan;1079;25;11155;237
2020-04-23;PK;Pakistan;785;16;11940;253
2020-04-24;PK;Pakistan;783;16;12723;269
2020-04-25;PK;Pakistan;605;12;13328;281
2020-04-26;PK;Pakistan;587;11;13915;292
2020-04-27;PK;Pakistan;697;20;14612;312
2020-04-28;PK;Pakistan;913;31;15525;343
2020-04-29;PK;Pakistan;1292;42;16817;385
2020-04-30;PK;Pakistan;1297;32;18114;417
2020-05-01;PK;Pakistan;989;23;19103;440
2020-05-02;PK;Pakistan;981;17;20084;457
2020-05-03;PK;Pakistan;857;19;20941;476
2020-05-04;PK;Pakistan;1108;38;22049;514
2020-05-05;PK;Pakistan;2024;50;24073;564
2020-05-06;PK;Pakistan;571;21;24644;585
2020-05-07;PK;Pakistan;1791;14;26435;599
2020-05-08;PK;Pakistan;2301;37;28736;636
2020-05-09;PK;Pakistan;1598;23;30334;659
2020-05-10;PK;Pakistan;1747;47;32081;706
2020-05-11;PK;Pakistan;2255;31;34336;737
2020-05-12;PK;Pakistan;962;24;35298;761
2020-05-13;PK;Pakistan;490;9;35788;770
2020-05-14;PK;Pakistan;3011;64;38799;834
2020-05-15;PK;Pakistan;0;0;38799;834
2020-05-16;PK;Pakistan;1352;39;40151;873
2020-05-17;PK;Pakistan;1974;30;42125;903
2020-05-18;PK;Pakistan;1841;36;43966;939
2020-05-19;PK;Pakistan;1932;46;45898;985
2020-05-20;PK;Pakistan;2193;32;48091;1017
2020-05-21;PK;Pakistan;2603;50;50694;1067
2020-05-22;PK;Pakistan;1743;34;52437;1101
2020-05-23;PK;Pakistan;2164;32;54601;1133
2020-05-24;PK;Pakistan;1748;34;56349;1167
2020-05-25;PK;Pakistan;1356;30;57705;1197
2020-05-26;PK;Pakistan;1446;28;59151;1225
2020-05-27;PK;Pakistan;2076;35;61227;1260
2020-05-28;PK;Pakistan;2801;57;64028;1317
2020-05-29;PK;Pakistan;2429;78;66457;1395
2020-05-30;PK;Pakistan;3039;88;69496;1483
2020-05-31;PK;Pakistan;2964;60;72460;1543
2020-06-01;PK;Pakistan;3938;78;76398;1621
2020-06-02;PK;Pakistan;4065;67;80463;1688
2020-06-03;PK;Pakistan;4801;82;85264;1770
2020-06-04;PK;Pakistan;3985;68;89249;1838
2020-06-05;PK;Pakistan;4734;97;93983;1935
2020-06-06;PK;Pakistan;4960;67;98943;2002
2020-06-07;PK;Pakistan;4728;65;103671;2067
2020-06-08;PK;Pakistan;4646;105;108317;2172
2020-06-09;PK;Pakistan;5385;83;113702;2255
2020-06-10;PK;Pakistan;5834;101;119536;2356
2020-06-11;PK;Pakistan;6397;107;125933;2463
2020-06-12;PK;Pakistan;0;0;125933;2463
2020-06-13;PK;Pakistan;6472;88;132405;2551
2020-06-14;PK;Pakistan;12073;178;144478;2729
2020-06-15;PK;Pakistan;4443;110;148921;2839
2020-06-16;PK;Pakistan;5839;136;154760;2975
2020-06-17;PK;Pakistan;5358;118;160118;3093
2020-06-18;PK;Pakistan;4944;136;165062;3229
2020-06-19;PK;Pakistan;6604;153;171666;3382
2020-06-20;PK;Pakistan;4951;119;176617;3501
2020-06-21;PK;Pakistan;4471;89;181088;3590
2020-06-22;PK;Pakistan;3946;105;185034;3695
2020-06-23;PK;Pakistan;3892;60;188926;3755
2020-06-24;PK;Pakistan;4044;148;192970;3903
2020-06-25;PK;Pakistan;2775;59;195745;3962
2020-06-26;PK;Pakistan;3138;73;198883;4035
2020-06-27;PK;Pakistan;4072;83;202955;4118
2020-06-28;PK;Pakistan;3557;49;206512;4167
2020-06-29;PK;Pakistan;2825;137;209337;4304
2020-06-30;PK;Pakistan;4133;91;213470;4395
2020-07-01;PK;Pakistan;4339;78;217809;4473
2020-07-02;PK;Pakistan;4087;78;221896;4551
2020-07-03;PK;Pakistan;0;0;221896;4551
2020-07-04;PK;Pakistan;3387;68;225283;4619
2020-07-05;PK;Pakistan;6535;143;231818;4762
2020-07-06;PK;Pakistan;2691;77;234509;4839
2020-07-07;PK;Pakistan;2980;83;237489;4922
2020-07-08;PK;Pakistan;3359;61;240848;4983
2020-07-09;PK;Pakistan;2751;75;243599;5058
2020-07-10;PK;Pakistan;2752;65;246351;5123
2020-07-11;PK;Pakistan;2521;74;248872;5197
2020-07-12;PK;Pakistan;2753;69;251625;5266
2020-07-13;PK;Pakistan;1979;54;253604;5320
2020-07-14;PK;Pakistan;2165;66;255769;5386
2020-07-15;PK;Pakistan;2145;40;257914;5426
2020-07-16;PK;Pakistan;0;0;257914;5426
2020-07-17;PK;Pakistan;4003;96;261917;5522
2020-07-18;PK;Pakistan;1579;46;263496;5568
2020-07-19;PK;Pakistan;1587;31;265083;5599
2020-07-20;PK;Pakistan;1013;40;266096;5639
2020-07-21;PK;Pakistan;1332;38;267428;5677
2020-07-22;PK;Pakistan;1763;32;269191;5709
2020-07-23;PK;Pakistan;1209;54;270400;5763
2020-07-24;PK;Pakistan;1487;24;271887;5787
2020-07-25;PK;Pakistan;1226;35;273113;5822
2020-07-26;PK;Pakistan;0;0;273113;5822
2020-07-27;PK;Pakistan;1176;20;274289;5842
2020-07-28;PK;Pakistan;936;23;275225;5865
2020-07-29;PK;Pakistan;1063;27;276288;5892
2020-07-30;PK;Pakistan;1114;32;277402;5924
2020-07-31;PK;Pakistan;903;27;278305;5951
2020-08-01;PK;Pakistan;0;0;278305;5951
2020-08-02;PK;Pakistan;1394;25;279699;5976
2020-08-03;PK;Pakistan;762;23;280461;5999
2020-08-04;PK;Pakistan;0;0;280461;5999
2020-08-05;PK;Pakistan;675;15;281136;6014
2020-08-06;PK;Pakistan;727;21;281863;6035
2020-08-07;PK;Pakistan;782;17;282645;6052
2020-08-08;PK;Pakistan;842;16;283487;6068
2020-08-09;PK;Pakistan;634;14;284121;6082
2020-08-10;PK;Pakistan;539;15;284660;6097
2020-08-11;PK;Pakistan;531;15;285191;6112
2020-08-12;PK;Pakistan;730;17;285921;6129
2020-08-13;PK;Pakistan;753;10;286674;6139
2020-08-14;PK;Pakistan;626;14;287300;6153
2020-08-15;PK;Pakistan;747;9;288047;6162
2020-08-16;PK;Pakistan;1168;13;289215;6175
2020-08-17;PK;Pakistan;0;0;289215;6175
2020-08-18;PK;Pakistan;617;15;289832;6190
2020-08-19;PK;Pakistan;613;11;290445;6201
2020-08-20;PK;Pakistan;513;8;290958;6209
2020-08-21;PK;Pakistan;630;10;291588;6219
2020-08-22;PK;Pakistan;586;12;292174;6231
2020-08-23;PK;Pakistan;1087;13;293261;6244
2020-08-24;PK;Pakistan;0;0;293261;6244
2020-08-25;PK;Pakistan;450;11;293711;6255
2020-08-26;PK;Pakistan;482;12;294193;6267
2020-08-27;PK;Pakistan;445;7;294638;6274
2020-08-28;PK;Pakistan;415;9;295053;6283
2020-08-29;PK;Pakistan;319;1;295372;6284
2020-08-30;PK;Pakistan;264;4;295636;6288
2020-08-31;PK;Pakistan;213;6;295849;6294
2020-09-01;PK;Pakistan;300;4;296149;6298
2020-09-02;PK;Pakistan;865;30;297014;6328
2020-09-03;PK;Pakistan;498;7;297512;6335
2020-09-04;PK;Pakistan;513;5;298025;6340
2020-09-05;PK;Pakistan;0;0;298025;6340
2020-09-06;PK;Pakistan;878;5;298903;6345
2020-09-07;PK;Pakistan;330;5;299233;6350
2020-09-08;PK;Pakistan;426;9;299659;6359
2020-09-09;PK;Pakistan;371;6;300030;6365
2020-09-10;PK;Pakistan;341;5;300371;6370
2020-09-11;PK;Pakistan;584;3;300955;6373
2020-09-12;PK;Pakistan;526;6;301481;6379
2020-09-13;PK;Pakistan;539;4;302020;6383
2020-09-14;PK;Pakistan;404;6;302424;6389
2020-09-15;PK;Pakistan;665;4;303089;6393
2020-09-16;PK;Pakistan;545;6;303634;6399
2020-09-17;PK;Pakistan;752;9;304386;6408
2020-09-18;PK;Pakistan;645;7;305031;6415
2020-09-19;PK;Pakistan;640;1;305671;6416
2020-09-20;PK;Pakistan;633;4;306304;6420
2020-09-21;PK;Pakistan;582;4;306886;6424
2020-09-22;PK;Pakistan;532;8;307418;6432
2020-09-23;PK;Pakistan;799;5;308217;6437
2020-09-24;PK;Pakistan;798;7;309015;6444
2020-09-25;PK;Pakistan;566;7;309581;6451
2020-09-26;PK;Pakistan;694;6;310275;6457
2020-09-27;PK;Pakistan;566;9;310841;6466
2020-09-28;PK;Pakistan;675;8;311516;6474
2020-09-29;PK;Pakistan;747;5;312263;6479
2020-09-30;PK;Pakistan;543;5;312806;6484
2020-10-01;PK;Pakistan;625;15;313431;6499
2020-10-02;PK;Pakistan;553;8;313984;6507
2020-10-03;PK;Pakistan;632;6;314616;6513
2020-10-04;PK;Pakistan;0;0;314616;6513
2020-10-05;PK;Pakistan;1111;10;315727;6523
2020-10-06;PK;Pakistan;624;12;316351;6535
2020-10-07;PK;Pakistan;583;9;316934;6544
2020-10-08;PK;Pakistan;661;8;317595;6552
2020-10-09;PK;Pakistan;671;6;318266;6558
2020-10-10;PK;Pakistan;666;12;318932;6570
2020-10-11;PK;Pakistan;385;10;319317;6580
2020-10-12;PK;Pakistan;531;8;319848;6588
2020-10-13;PK;Pakistan;615;13;320463;6601
2020-10-14;PK;Pakistan;755;13;321218;6614
2020-10-15;PK;Pakistan;659;7;321877;6621
2020-10-16;PK;Pakistan;575;17;322452;6638
2020-10-17;PK;Pakistan;567;16;323019;6654
2020-10-18;PK;Pakistan;433;5;323452;6659
2020-10-19;PK;Pakistan;582;14;324034;6673
2020-10-20;PK;Pakistan;710;19;324744;6692
2020-10-21;PK;Pakistan;736;10;325480;6702
2020-10-22;PK;Pakistan;736;13;326216;6715
2020-10-23;PK;Pakistan;847;12;327063;6727
2020-10-24;PK;Pakistan;832;9;327895;6736
2020-10-25;PK;Pakistan;707;3;328602;6739
2020-10-26;PK;Pakistan;773;6;329375;6745
2020-10-27;PK;Pakistan;825;14;330200;6759
2020-10-28;PK;Pakistan;908;16;331108;6775
2020-10-29;PK;Pakistan;1078;20;332186;6795
2020-10-30;PK;Pakistan;807;11;332993;6806
2020-10-31;PK;Pakistan;977;17;333970;6823
2020-11-01;PK;Pakistan;1123;12;335093;6835
2020-11-02;PK;Pakistan;1167;14;336260;6849
2020-11-03;PK;Pakistan;1313;18;337573;6867
2020-11-04;PK;Pakistan;1302;26;338875;6893
2020-11-05;PK;Pakistan;1376;30;340251;6923
2020-11-06;PK;Pakistan;1502;20;341753;6943
2020-11-07;PK;Pakistan;1436;25;343189;6968
2020-11-08;PK;Pakistan;1650;9;344839;6977
2020-11-09;PK;Pakistan;1637;23;346476;7000
2020-11-10;PK;Pakistan;1708;21;348184;7021
2020-11-11;PK;Pakistan;1808;34;349992;7055
2020-11-12;PK;Pakistan;2304;37;352296;7092
2020-11-13;PK;Pakistan;2165;17;354461;7109
2020-11-14;PK;Pakistan;2443;32;356904;7141
2020-11-15;PK;Pakistan;2128;19;359032;7160
2020-11-16;PK;Pakistan;2050;33;361082;7193
2020-11-17;PK;Pakistan;2298;37;363380;7230
2020-11-18;PK;Pakistan;2547;18;365927;7248
2020-11-19;PK;Pakistan;2738;313;368665;7561
2020-11-20;PK;Pakistan;2843;42;371508;7603
2020-11-21;PK;Pakistan;2665;59;374173;7662
2020-11-22;PK;Pakistan;2756;34;376929;7696
2020-11-23;PK;Pakistan;2954;48;379883;7744
2020-11-24;PK;Pakistan;3009;59;382892;7803
2020-11-25;PK;Pakistan;3306;40;386198;7843
2020-11-26;PK;Pakistan;3113;54;389311;7897
2020-11-27;PK;Pakistan;3045;45;392356;7942
2020-11-28;PK;Pakistan;2829;43;395185;7985
2020-11-29;PK;Pakistan;2839;40;398024;8025
2020-11-30;PK;Pakistan;2458;66;400482;8091
2020-12-01;PK;Pakistan;2829;75;403311;8166
2020-12-02;PK;Pakistan;3499;39;406810;8205
2020-12-03;PK;Pakistan;3262;55;410072;8260
2020-12-04;PK;Pakistan;3119;43;413191;8303
2020-12-05;PK;Pakistan;3308;58;416499;8361
2020-12-06;PK;Pakistan;3795;37;420294;8398
2020-12-07;PK;Pakistan;2885;89;423179;8487
2020-12-08;PK;Pakistan;2963;60;426142;8547
2020-12-09;PK;Pakistan;3138;56;429280;8603
2020-12-10;PK;Pakistan;3047;50;432327;8653
2020-12-11;PK;Pakistan;2729;71;435056;8724
2020-12-12;PK;Pakistan;3369;72;438425;8796
2020-12-13;PK;Pakistan;2362;36;440787;8832
2020-12-14;PK;Pakistan;2459;73;443246;8905
2020-12-15;PK;Pakistan;2731;105;445977;9010
2020-12-16;PK;Pakistan;2545;70;448522;9080
2020-12-17;PK;Pakistan;2972;84;451494;9164
2020-12-18;PK;Pakistan;3179;86;454673;9250
2020-12-19;PK;Pakistan;2615;80;457288;9330
2020-12-20;PK;Pakistan;1680;62;458968;9392
2020-12-21;PK;Pakistan;1704;82;460672;9474
2020-12-22;PK;Pakistan;2142;83;462814;9557
2020-12-23;PK;Pakistan;2256;111;465070;9668
2020-12-24;PK;Pakistan;2152;85;467222;9753
2020-12-25;PK;Pakistan;2260;63;469482;9816
2020-12-26;PK;Pakistan;1853;58;471335;9874
2020-12-27;PK;Pakistan;1974;55;473309;9929
2020-12-28;PK;Pakistan;1776;63;475085;9992
2020-12-29;PK;Pakistan;2155;55;477240;10047
2020-12-30;PK;Pakistan;2475;58;479715;10105
2020-12-31;PK;Pakistan;2463;71;482178;10176
2021-01-01;PK;Pakistan;2184;82;484362;10258
2021-01-02;PK;Pakistan;2272;53;486634;10311
2021-01-03;PK;Pakistan;1895;39;488529;10350
2021-01-04;PK;Pakistan;1947;59;490476;10409
2021-01-05;PK;Pakistan;2118;52;492594;10461
2021-01-06;PK;Pakistan;2481;50;495075;10511
2021-01-07;PK;Pakistan;2435;47;497510;10558
2021-01-08;PK;Pakistan;2007;40;499517;10598
2021-01-09;PK;Pakistan;2899;46;502416;10644
2021-01-10;PK;Pakistan;1877;32;504293;10676
2021-01-11;PK;Pakistan;2408;41;506701;10717
2021-01-12;PK;Pakistan;2123;55;508824;10772
2021-01-13;PK;Pakistan;3097;46;511921;10818
2021-01-14;PK;Pakistan;2417;45;514338;10863
2021-01-15;PK;Pakistan;2432;45;516770;10908
2021-01-16;PK;Pakistan;2521;43;519291;10951
2021-01-17;PK;Pakistan;1920;46;521211;10997
2021-01-18;PK;Pakistan;1800;58;523011;11055
2021-01-19;PK;Pakistan;1772;48;524783;11103
2021-01-20;PK;Pakistan;2363;54;527146;11157
2021-01-21;PK;Pakistan;1745;47;528891;11204
2021-01-22;PK;Pakistan;1927;43;530818;11247
2021-01-23;PK;Pakistan;1594;48;532412;11295
2021-01-24;PK;Pakistan;1629;23;534041;11318
2021-01-25;PK;Pakistan;1873;58;535914;11376
2021-01-26;PK;Pakistan;1563;74;537477;11450
2021-01-27;PK;Pakistan;1910;64;539387;11514
2021-01-28;PK;Pakistan;1644;46;541031;11560
2021-01-29;PK;Pakistan;2183;63;543214;11623
2021-01-30;PK;Pakistan;1599;34;544813;11657
2021-01-31;PK;Pakistan;1615;26;546428;11683
2021-02-01;PK;Pakistan;1220;63;547648;11746
2021-02-02;PK;Pakistan;1384;56;549032;11802
2021-02-03;PK;Pakistan;1508;31;550540;11833
2021-02-04;PK;Pakistan;1302;53;551842;11886
2021-02-05;PK;Pakistan;1286;28;553128;11914
2021-02-06;PK;Pakistan;1346;53;554474;11967
2021-02-07;PK;Pakistan;1037;59;555511;12026
2021-02-08;PK;Pakistan;1008;40;556519;12066
2021-02-09;PK;Pakistan;1072;62;557591;12128
2021-02-10;PK;Pakistan;1502;57;559093;12185
2021-02-11;PK;Pakistan;1270;33;560363;12218
2021-02-12;PK;Pakistan;1262;58;561625;12276
2021-02-13;PK;Pakistan;1404;31;563029;12307
2021-02-14;PK;Pakistan;1048;26;564077;12333
2021-02-15;PK;Pakistan;0;0;564077;12333
2021-02-16;PK;Pakistan;1912;103;565989;12436
2021-02-17;PK;Pakistan;1272;52;567261;12488
2021-02-18;PK;Pakistan;1245;39;568506;12527
2021-02-19;PK;Pakistan;1340;36;569846;12563
2021-02-20;PK;Pakistan;1328;38;571174;12601
2021-02-21;PK;Pakistan;1160;16;572334;12617
2021-02-22;PK;Pakistan;1050;41;573384;12658
2021-02-23;PK;Pakistan;1196;50;574580;12708
2021-02-24;PK;Pakistan;1361;64;575941;12772
2021-02-25;PK;Pakistan;1541;32;577482;12804
2021-02-26;PK;Pakistan;1315;33;578797;12837
2021-02-27;PK;Pakistan;1176;23;579973;12860
2021-02-28;PK;Pakistan;1392;36;581365;12896
2021-03-01;PK;Pakistan;1163;42;582528;12938
2021-03-02;PK;Pakistan;1388;75;583916;13013
2021-03-03;PK;Pakistan;1519;63;585435;13076
2021-03-04;PK;Pakistan;1579;52;587014;13128
2021-03-05;PK;Pakistan;1714;38;588728;13166
2021-03-06;PK;Pakistan;1780;39;590508;13205
2021-03-07;PK;Pakistan;1592;22;592100;13227
2021-03-08;PK;Pakistan;1353;54;593453;13281
2021-03-09;PK;Pakistan;1786;43;595239;13324
2021-03-10;PK;Pakistan;2258;53;597497;13377
2021-03-11;PK;Pakistan;2701;53;600198;13430
2021-03-12;PK;Pakistan;2338;46;602536;13476
2021-03-13;PK;Pakistan;2664;32;605200;13508
2021-03-14;PK;Pakistan;2253;29;607453;13537
2021-03-15;PK;Pakistan;2511;58;609964;13595
2021-03-16;PK;Pakistan;2351;61;612315;13656
2021-03-17;PK;Pakistan;3495;61;615810;13717
2021-03-18;PK;Pakistan;3449;40;619259;13757
2021-03-19;PK;Pakistan;3876;42;623135;13799
2021-03-20;PK;Pakistan;3667;44;626802;13843
2021-03-21;PK;Pakistan;3669;20;630471;13863
2021-03-22;PK;Pakistan;3270;72;633741;13935
2021-03-23;PK;Pakistan;3301;30;637042;13965
2021-03-24;PK;Pakistan;3946;63;640988;14028
2021-03-25;PK;Pakistan;4368;63;645356;14091
2021-03-26;PK;Pakistan;4468;67;649824;14158
2021-03-27;PK;Pakistan;4767;57;654591;14215
2021-03-28;PK;Pakistan;4525;41;659116;14256
2021-03-29;PK;Pakistan;4084;100;663200;14356
2021-03-30;PK;Pakistan;4757;78;667957;14434
2021-03-31;PK;Pakistan;4974;96;672931;14530
2021-04-01;PK;Pakistan;5234;83;678165;14613
2021-04-02;PK;Pakistan;4723;84;682888;14697
2021-04-03;PK;Pakistan;5020;81;687908;14778
2021-04-04;PK;Pakistan;4323;43;692231;14821
2021-04-05;PK;Pakistan;3953;103;696184;14924
2021-04-06;PK;Pakistan;4004;102;700188;15026
2021-04-07;PK;Pakistan;5329;98;705517;15124
2021-04-08;PK;Pakistan;5312;105;710829;15229
2021-04-09;PK;Pakistan;5139;100;715968;15329
2021-04-10;PK;Pakistan;5050;114;721018;15443
2021-04-11;PK;Pakistan;4584;58;725602;15501
2021-04-12;PK;Pakistan;4318;118;729920;15619
2021-04-13;PK;Pakistan;4503;135;734423;15754
2021-04-14;PK;Pakistan;5395;118;739818;15872
2021-04-15;PK;Pakistan;5364;110;745182;15982
2021-04-16;PK;Pakistan;4976;112;750158;16094
2021-04-17;PK;Pakistan;6127;149;756285;16243
2021-04-18;PK;Pakistan;5152;73;761437;16316
2021-04-19;PK;Pakistan;5445;137;766882;16453
2021-04-20;PK;Pakistan;5499;147;772381;16600
2021-04-21;PK;Pakistan;5857;98;778238;16698
2021-04-22;PK;Pakistan;5870;144;784108;16842
2021-04-23;PK;Pakistan;5908;157;790016;16999
2021-04-24;PK;Pakistan;5611;118;795627;17117
2021-04-25;PK;Pakistan;4825;70;800452;17187
2021-04-26;PK;Pakistan;4487;142;804939;17329
2021-04-27;PK;Pakistan;5292;201;810231;17530
2021-04-28;PK;Pakistan;5480;150;815711;17680
2021-04-29;PK;Pakistan;5112;131;820823;17811
2021-04-30;PK;Pakistan;4696;146;825519;17957
2021-05-01;PK;Pakistan;4414;113;829933;18070
2021-05-02;PK;Pakistan;4213;79;834146;18149
2021-05-03;PK;Pakistan;3377;161;837523;18310
2021-05-04;PK;Pakistan;0;0;837523;18310
2021-05-05;PK;Pakistan;4113;119;841636;18429
2021-05-06;PK;Pakistan;8495;248;850131;18677
2021-05-07;PK;Pakistan;4109;120;854240;18797
2021-05-08;PK;Pakistan;3786;118;858026;18915
2021-05-09;PK;Pakistan;3447;78;861473;18993
2021-05-10;PK;Pakistan;3084;113;864557;19106
2021-05-11;PK;Pakistan;2881;104;867438;19210
2021-05-12;PK;Pakistan;3265;126;870703;19336
2021-05-13;PK;Pakistan;2517;48;873220;19384
2021-05-14;PK;Pakistan;1531;83;874751;19467
2021-05-15;PK;Pakistan;2379;76;877130;19543
2021-05-16;PK;Pakistan;3232;74;880362;19617
2021-05-17;PK;Pakistan;2566;135;882928;19752
2021-05-18;PK;Pakistan;3256;104;886184;19856
2021-05-19;PK;Pakistan;4207;131;890391;19987
2021-05-20;PK;Pakistan;3070;102;893461;20089
2021-05-21;PK;Pakistan;4007;88;897468;20177
2021-05-22;PK;Pakistan;3084;74;900552;20251
2021-05-23;PK;Pakistan;3047;57;903599;20308
2021-05-24;PK;Pakistan;2253;92;905852;20400
2021-05-25;PK;Pakistan;2724;65;908576;20465
2021-05-26;PK;Pakistan;2726;75;911302;20540
2021-05-27;PK;Pakistan;2482;67;913784;20607
2021-05-28;PK;Pakistan;2455;73;916239;20680
2021-05-29;PK;Pakistan;2697;56;918936;20736
2021-05-30;PK;Pakistan;2117;43;921053;20779
2021-05-31;PK;Pakistan;1771;71;922824;20850
2021-06-01;PK;Pakistan;1843;80;924667;20930
2021-06-02;PK;Pakistan;2028;92;926695;21022
2021-06-03;PK;Pakistan;1893;83;928588;21105
2021-06-04;PK;Pakistan;1923;84;930511;21189
2021-06-05;PK;Pakistan;1629;76;932140;21265
2021-06-06;PK;Pakistan;1490;58;933630;21323
2021-06-07;PK;Pakistan;1383;53;935013;21376
2021-06-08;PK;Pakistan;1118;77;936131;21453
2021-06-09;PK;Pakistan;1303;76;937434;21529
2021-06-10;PK;Pakistan;1303;47;938737;21576
2021-06-11;PK;Pakistan;1194;57;939931;21633
2021-06-12;PK;Pakistan;1239;56;941170;21689
2021-06-13;PK;Pakistan;1019;34;942189;21723
2021-06-14;PK;Pakistan;838;59;943027;21782
2021-06-15;PK;Pakistan;1038;46;944065;21828
2021-06-16;PK;Pakistan;1119;46;945184;21874
2021-06-17;PK;Pakistan;1043;39;946227;21913
2021-06-18;PK;Pakistan;991;27;947218;21940
2021-06-19;PK;Pakistan;0;0;947218;21940
2021-06-20;PK;Pakistan;1957;67;949175;22007
2021-06-21;PK;Pakistan;663;27;949838;22034
2021-06-22;PK;Pakistan;930;39;950768;22073
2021-06-23;PK;Pakistan;1097;35;951865;22108
2021-06-24;PK;Pakistan;1042;44;952907;22152
2021-06-25;PK;Pakistan;935;36;953842;22188
2021-06-26;PK;Pakistan;901;23;954743;22211
2021-06-27;PK;Pakistan;914;20;955657;22231
2021-06-28;PK;Pakistan;735;23;956392;22254
2021-06-29;PK;Pakistan;979;27;957371;22281
2021-06-30;PK;Pakistan;1037;40;958408;22321
2021-07-01;PK;Pakistan;1277;24;959685;22345
2020-03-05;PS;Palestine;4;0;4;0
2020-03-06;PS;Palestine;3;0;7;0
2020-03-07;PS;Palestine;9;0;16;0
2020-03-08;PS;Palestine;0;0;16;0
2020-03-09;PS;Palestine;3;0;19;0
2020-03-10;PS;Palestine;7;0;26;0
2020-03-11;PS;Palestine;4;0;30;0
2020-03-12;PS;Palestine;0;0;30;0
2020-03-13;PS;Palestine;1;0;31;0
2020-03-14;PS;Palestine;4;0;35;0
2020-03-15;PS;Palestine;3;0;38;0
2020-03-16;PS;Palestine;0;0;38;0
2020-03-17;PS;Palestine;1;0;39;0
2020-03-18;PS;Palestine;2;0;41;0
2020-03-19;PS;Palestine;3;0;44;0
2020-03-20;PS;Palestine;3;0;47;0
2020-03-21;PS;Palestine;1;0;48;0
2020-03-22;PS;Palestine;4;0;52;0
2020-03-23;PS;Palestine;7;0;59;0
2020-03-24;PS;Palestine;0;0;59;0
2020-03-25;PS;Palestine;0;0;59;0
2020-03-26;PS;Palestine;25;1;84;1
2020-03-27;PS;Palestine;7;0;91;1
2020-03-28;PS;Palestine;7;0;98;1
2020-03-29;PS;Palestine;11;0;109;1
2020-03-30;PS;Palestine;7;0;116;1
2020-03-31;PS;Palestine;3;0;119;1
2020-04-01;PS;Palestine;15;0;134;1
2020-04-02;PS;Palestine;27;0;161;1
2020-04-03;PS;Palestine;33;0;194;1
2020-04-04;PS;Palestine;23;0;217;1
2020-04-05;PS;Palestine;20;0;237;1
2020-04-06;PS;Palestine;17;0;254;1
2020-04-07;PS;Palestine;7;0;261;1
2020-04-08;PS;Palestine;2;0;263;1
2020-04-09;PS;Palestine;0;0;263;1
2020-04-10;PS;Palestine;4;1;267;2
2020-04-11;PS;Palestine;1;0;268;2
2020-04-12;PS;Palestine;3;0;271;2
2020-04-13;PS;Palestine;2;0;273;2
2020-04-14;PS;Palestine;11;0;284;2
2020-04-15;PS;Palestine;7;0;291;2
2020-04-16;PS;Palestine;3;0;294;2
2020-04-17;PS;Palestine;13;0;307;2
2020-04-18;PS;Palestine;6;0;313;2
2020-04-19;PS;Palestine;6;0;319;2
2020-04-20;PS;Palestine;10;0;329;2
2020-04-21;PS;Palestine;0;0;329;2
2020-04-22;PS;Palestine;6;0;335;2
2020-04-23;PS;Palestine;1;0;336;2
2020-04-24;PS;Palestine;4;0;340;2
2020-04-25;PS;Palestine;2;0;342;2
2020-04-26;PS;Palestine;0;0;342;2
2020-04-27;PS;Palestine;0;0;342;2
2020-04-28;PS;Palestine;1;0;343;2
2020-04-29;PS;Palestine;1;0;344;2
2020-04-30;PS;Palestine;0;0;344;2
2020-05-01;PS;Palestine;9;0;353;2
2020-05-02;PS;Palestine;0;0;353;2
2020-05-03;PS;Palestine;0;0;353;2
2020-05-04;PS;Palestine;9;0;362;2
2020-05-05;PS;Palestine;9;0;371;2
2020-05-06;PS;Palestine;3;0;374;2
2020-05-07;PS;Palestine;1;0;375;2
2020-05-08;PS;Palestine;0;0;375;2
2020-05-09;PS;Palestine;0;0;375;2
2020-05-10;PS;Palestine;0;0;375;2
2020-05-11;PS;Palestine;0;0;375;2
2020-05-12;PS;Palestine;0;0;375;2
2020-05-13;PS;Palestine;0;0;375;2
2020-05-14;PS;Palestine;0;0;375;2
2020-05-15;PS;Palestine;0;0;375;2
2020-05-16;PS;Palestine;1;0;376;2
2020-05-17;PS;Palestine;5;0;381;2
2020-05-18;PS;Palestine;7;0;388;2
2020-05-19;PS;Palestine;3;0;391;2
2020-05-20;PS;Palestine;7;0;398;2
2020-05-21;PS;Palestine;25;0;423;2
2020-05-22;PS;Palestine;0;0;423;2
2020-05-23;PS;Palestine;0;1;423;3
2020-05-24;PS;Palestine;0;0;423;3
2020-05-25;PS;Palestine;0;0;423;3
2020-05-26;PS;Palestine;6;0;429;3
2020-05-27;PS;Palestine;5;0;434;3
2020-05-28;PS;Palestine;12;0;446;3
2020-05-29;PS;Palestine;0;0;446;3
2020-05-30;PS;Palestine;1;0;447;3
2020-05-31;PS;Palestine;1;0;448;3
2020-06-01;PS;Palestine;1;0;449;3
2020-06-02;PS;Palestine;2;0;451;3
2020-06-03;PS;Palestine;6;0;457;3
2020-06-04;PS;Palestine;7;0;464;3
2020-06-05;PS;Palestine;0;0;464;3
2020-06-06;PS;Palestine;0;0;464;3
2020-06-07;PS;Palestine;8;0;472;3
2020-06-08;PS;Palestine;1;0;473;3
2020-06-09;PS;Palestine;8;0;481;3
2020-06-10;PS;Palestine;4;0;485;3
2020-06-11;PS;Palestine;2;0;487;3
2020-06-12;PS;Palestine;2;0;489;3
2020-06-13;PS;Palestine;0;0;489;3
2020-06-14;PS;Palestine;3;0;492;3
2020-06-15;PS;Palestine;13;0;505;3
2020-06-16;PS;Palestine;9;0;514;3
2020-06-17;PS;Palestine;41;0;555;3
2020-06-18;PS;Palestine;45;0;600;3
2020-06-19;PS;Palestine;75;0;675;3
2020-06-20;PS;Palestine;109;0;784;3
2020-06-21;PS;Palestine;49;0;833;3
2020-06-22;PS;Palestine;168;0;1001;3
2020-06-23;PS;Palestine;168;0;1169;3
2020-06-24;PS;Palestine;159;0;1328;3
2020-06-25;PS;Palestine;54;0;1382;3
2020-06-26;PS;Palestine;175;0;1557;3
2020-06-27;PS;Palestine;258;1;1815;4
2020-06-28;PS;Palestine;175;0;1990;4
2020-06-29;PS;Palestine;195;1;2185;5
2020-06-30;PS;Palestine;243;3;2428;8
2020-07-01;PS;Palestine;330;0;2758;8
2020-07-02;PS;Palestine;322;1;3080;9
2020-07-03;PS;Palestine;254;2;3334;11
2020-07-04;PS;Palestine;501;2;3835;13
2020-07-05;PS;Palestine;442;3;4277;16
2020-07-06;PS;Palestine;64;1;4341;17
2020-07-07;PS;Palestine;306;1;4647;18
2020-07-08;PS;Palestine;382;2;5029;20
2020-07-09;PS;Palestine;191;4;5220;24
2020-07-10;PS;Palestine;331;3;5551;27
2020-07-11;PS;Palestine;380;6;5931;33
2020-07-12;PS;Palestine;299;3;6230;36
2020-07-13;PS;Palestine;336;3;6566;39
2020-07-14;PS;Palestine;198;5;6764;44
2020-07-15;PS;Palestine;300;0;7064;44
2020-07-16;PS;Palestine;348;7;7412;51
2020-07-17;PS;Palestine;352;2;7764;53
2020-07-18;PS;Palestine;440;6;8204;59
2020-07-19;PS;Palestine;345;3;8549;62
2020-07-20;PS;Palestine;367;1;8916;63
2020-07-21;PS;Palestine;312;1;9228;64
2020-07-22;PS;Palestine;170;2;9398;66
2020-07-23;PS;Palestine;346;1;9744;67
2020-07-24;PS;Palestine;349;3;10093;70
2020-07-25;PS;Palestine;213;5;10306;75
2020-07-26;PS;Palestine;163;1;10469;76
2020-07-27;PS;Palestine;152;2;10621;78
2020-07-28;PS;Palestine;317;1;10938;79
2020-07-29;PS;Palestine;346;1;11284;80
2020-07-30;PS;Palestine;264;1;11548;81
2020-07-31;PS;Palestine;289;1;11837;82
2020-08-01;PS;Palestine;323;1;12160;83
2020-08-02;PS;Palestine;137;1;12297;84
2020-08-03;PS;Palestine;244;0;12541;84
2020-08-04;PS;Palestine;229;2;12770;86
2020-08-05;PS;Palestine;295;3;13065;89
2020-08-06;PS;Palestine;333;3;13398;92
2020-08-07;PS;Palestine;324;2;13722;94
2020-08-08;PS;Palestine;206;2;13928;96
2020-08-09;PS;Palestine;280;1;14208;97
2020-08-10;PS;Palestine;302;3;14510;100
2020-08-11;PS;Palestine;365;4;14875;104
2020-08-12;PS;Palestine;309;1;15184;105
2020-08-13;PS;Palestine;307;1;15491;106
2020-08-14;PS;Palestine;343;0;15834;106
2020-08-15;PS;Palestine;319;2;16153;108
2020-08-16;PS;Palestine;381;2;16534;110
2020-08-17;PS;Palestine;310;3;16844;113
2020-08-18;PS;Palestine;462;0;17306;113
2020-08-19;PS;Palestine;300;6;17606;119
2020-08-20;PS;Palestine;383;1;17989;120
2020-08-21;PS;Palestine;324;2;18313;122
2020-08-22;PS;Palestine;163;3;18476;125
2020-08-23;PS;Palestine;326;3;18802;128
2020-08-24;PS;Palestine;411;5;19213;133
2020-08-25;PS;Palestine;465;0;19678;133
2020-08-26;PS;Palestine;477;4;20155;137
2020-08-27;PS;Palestine;522;4;20677;141
2020-08-28;PS;Palestine;574;4;21251;145
2020-08-29;PS;Palestine;417;2;21668;147
2020-08-30;PS;Palestine;536;5;22204;152
2020-08-31;PS;Palestine;525;0;22729;152
2020-09-01;PS;Palestine;552;7;23281;159
2020-09-02;PS;Palestine;594;3;23875;162
2020-09-03;PS;Palestine;596;5;24471;167
2020-09-04;PS;Palestine;671;3;25142;170
2020-09-05;PS;Palestine;433;7;25575;177
2020-09-06;PS;Palestine;552;4;26127;181
2020-09-07;PS;Palestine;652;3;26779;184
2020-09-08;PS;Palestine;584;6;27363;190
2020-09-09;PS;Palestine;556;2;27919;192
2020-09-10;PS;Palestine;745;6;28664;198
2020-09-11;PS;Palestine;592;6;29256;204
2020-09-12;PS;Palestine;650;6;29906;210
2020-09-13;PS;Palestine;668;11;30574;221
2020-09-14;PS;Palestine;788;5;31362;226
2020-09-15;PS;Palestine;888;3;32250;229
2020-09-16;PS;Palestine;756;14;33006;243
2020-09-17;PS;Palestine;837;1;33843;244
2020-09-18;PS;Palestine;558;6;34401;250
2020-09-19;PS;Palestine;602;3;35003;253
2020-09-20;PS;Palestine;683;9;35686;262
2020-09-21;PS;Palestine;465;3;36151;265
2020-09-22;PS;Palestine;429;4;36580;269
2020-09-23;PS;Palestine;503;3;37083;272
2020-09-24;PS;Palestine;508;2;37591;274
2020-09-25;PS;Palestine;372;4;37963;278
2020-09-26;PS;Palestine;290;7;38253;285
2020-09-27;PS;Palestine;450;6;38703;291
2020-09-28;PS;Palestine;418;8;39121;299
2020-09-29;PS;Palestine;420;7;39541;306
2020-09-30;PS;Palestine;358;5;39899;311
2020-10-01;PS;Palestine;423;7;40322;318
2020-10-02;PS;Palestine;444;3;40766;321
2020-10-03;PS;Palestine;312;8;41078;329
2020-10-04;PS;Palestine;420;1;41498;330
2020-10-05;PS;Palestine;459;9;41957;339
2020-10-06;PS;Palestine;475;10;42432;349
2020-10-07;PS;Palestine;408;6;42840;355
2020-10-08;PS;Palestine;416;4;43256;359
2020-10-09;PS;Palestine;408;8;43664;367
2020-10-10;PS;Palestine;281;11;43945;378
2020-10-11;PS;Palestine;354;3;44299;381
2020-10-12;PS;Palestine;385;6;44684;387
2020-10-13;PS;Palestine;516;4;45200;391
2020-10-14;PS;Palestine;458;2;45658;393
2020-10-15;PS;Palestine;442;8;46100;401
2020-10-16;PS;Palestine;334;1;46434;402
2020-10-17;PS;Palestine;312;0;46746;402
2020-10-18;PS;Palestine;389;6;47135;408
2020-10-19;PS;Palestine;481;5;47616;413
2020-10-20;PS;Palestine;513;8;48129;421
2020-10-21;PS;Palestine;499;6;48628;427
2020-10-22;PS;Palestine;506;8;49134;435
2020-10-23;PS;Palestine;445;4;49579;439
2020-10-24;PS;Palestine;410;4;49989;443
2020-10-25;PS;Palestine;453;5;50442;448
2020-10-26;PS;Palestine;510;6;50952;454
2020-10-27;PS;Palestine;576;4;51528;458
2020-10-28;PS;Palestine;420;7;51948;465
2020-10-29;PS;Palestine;623;8;52571;473
2020-10-30;PS;Palestine;504;8;53075;481
2020-10-31;PS;Palestine;445;2;53520;483
2020-11-01;PS;Palestine;540;6;54060;489
2020-11-02;PS;Palestine;715;4;54775;493
2020-11-03;PS;Palestine;633;8;55408;501
2020-11-04;PS;Palestine;682;3;56090;504
2020-11-05;PS;Palestine;582;4;56672;508
2020-11-06;PS;Palestine;554;3;57226;511
2020-11-07;PS;Palestine;431;1;57657;512
2020-11-08;PS;Palestine;501;3;58158;515
2020-11-09;PS;Palestine;680;6;58838;521
2020-11-10;PS;Palestine;584;12;59422;533
2020-11-11;PS;Palestine;643;5;60065;538
2020-11-12;PS;Palestine;719;4;60784;542
2020-11-13;PS;Palestine;730;6;61514;548
2020-11-14;PS;Palestine;653;10;62167;558
2020-11-15;PS;Palestine;864;7;63031;565
2020-11-16;PS;Palestine;836;7;63867;572
2020-11-17;PS;Palestine;1068;8;64935;580
2020-11-18;PS;Palestine;1251;9;66186;589
2020-11-19;PS;Palestine;1110;9;67296;598
2020-11-20;PS;Palestine;1472;8;68768;606
2020-11-21;PS;Palestine;1486;14;70254;620
2020-11-22;PS;Palestine;1390;16;71644;636
2020-11-23;PS;Palestine;1552;9;73196;645
2020-11-24;PS;Palestine;1811;11;75007;656
2020-11-25;PS;Palestine;1720;9;76727;665
2020-11-26;PS;Palestine;1766;15;78493;680
2020-11-27;PS;Palestine;1936;9;80429;689
2020-11-28;PS;Palestine;1461;15;81890;704
2020-11-29;PS;Palestine;1695;13;83585;717
2020-11-30;PS;Palestine;2062;15;85647;732
2020-12-01;PS;Palestine;2357;15;88004;747
2020-12-02;PS;Palestine;2188;16;90192;763
2020-12-03;PS;Palestine;2516;17;92708;780
2020-12-04;PS;Palestine;1968;17;94676;797
2020-12-05;PS;Palestine;1422;15;96098;812
2020-12-06;PS;Palestine;1940;16;98038;828
2020-12-07;PS;Palestine;1720;20;99758;848
2020-12-08;PS;Palestine;1351;19;101109;867
2020-12-09;PS;Palestine;1883;23;102992;890
2020-12-10;PS;Palestine;1887;20;104879;910
2020-12-11;PS;Palestine;1743;21;106622;931
2020-12-12;PS;Palestine;1477;30;108099;961
2020-12-13;PS;Palestine;1639;17;109738;978
2020-12-14;PS;Palestine;1364;22;111102;1000
2020-12-15;PS;Palestine;2307;23;113409;1023
2020-12-16;PS;Palestine;2197;25;115606;1048
2020-12-17;PS;Palestine;2149;30;117755;1078
2020-12-18;PS;Palestine;1857;19;119612;1097
2020-12-19;PS;Palestine;1604;20;121216;1117
2020-12-20;PS;Palestine;1427;24;122643;1141
2020-12-21;PS;Palestine;1302;28;123945;1169
2020-12-22;PS;Palestine;1561;29;125506;1198
2020-12-23;PS;Palestine;1870;28;127376;1226
2020-12-24;PS;Palestine;1704;17;129080;1243
2020-12-25;PS;Palestine;1518;17;130598;1260
2020-12-26;PS;Palestine;1306;21;131904;1281
2020-12-27;PS;Palestine;1189;28;133093;1309
2020-12-28;PS;Palestine;1217;23;134310;1332
2020-12-29;PS;Palestine;1149;19;135459;1351
2020-12-30;PS;Palestine;1277;20;136736;1371
2020-12-31;PS;Palestine;1268;29;138004;1400
2021-01-01;PS;Palestine;1219;18;139223;1418
2021-01-02;PS;Palestine;1064;28;140287;1446
2021-01-03;PS;Palestine;932;24;141219;1470
2021-01-04;PS;Palestine;1009;20;142228;1490
2021-01-05;PS;Palestine;941;15;143169;1505
2021-01-06;PS;Palestine;1088;14;144257;1519
2021-01-07;PS;Palestine;995;17;145252;1536
2021-01-08;PS;Palestine;822;23;146074;1559
2021-01-09;PS;Palestine;627;24;146701;1583
2021-01-10;PS;Palestine;699;21;147400;1604
2021-01-11;PS;Palestine;771;10;148171;1614
2021-01-12;PS;Palestine;797;16;148968;1630
2021-01-13;PS;Palestine;801;28;149769;1658
2021-01-14;PS;Palestine;736;7;150505;1665
2021-01-15;PS;Palestine;637;22;151142;1687
2021-01-16;PS;Palestine;427;13;151569;1700
2021-01-17;PS;Palestine;462;18;152031;1718
2021-01-18;PS;Palestine;524;8;152555;1726
2021-01-19;PS;Palestine;538;15;153093;1741
2021-01-20;PS;Palestine;497;10;153590;1751
2021-01-21;PS;Palestine;473;6;154063;1757
2021-01-22;PS;Palestine;494;12;154557;1769
2021-01-23;PS;Palestine;449;14;155006;1783
2021-01-24;PS;Palestine;408;8;155414;1791
2021-01-25;PS;Palestine;470;5;155884;1796
2021-01-26;PS;Palestine;509;7;156393;1803
2021-01-27;PS;Palestine;603;5;156996;1808
2021-01-28;PS;Palestine;597;4;157593;1812
2021-01-29;PS;Palestine;575;11;158168;1823
2021-01-30;PS;Palestine;391;8;158559;1831
2021-01-31;PS;Palestine;403;2;158962;1833
2021-02-01;PS;Palestine;481;7;159443;1840
2021-02-02;PS;Palestine;513;9;159956;1849
2021-02-03;PS;Palestine;470;8;160426;1857
2021-02-04;PS;Palestine;661;8;161087;1865
2021-02-05;PS;Palestine;472;2;161559;1867
2021-02-06;PS;Palestine;470;3;162029;1870
2021-02-07;PS;Palestine;572;11;162601;1881
2021-02-08;PS;Palestine;612;7;163213;1888
2021-02-09;PS;Palestine;762;9;163975;1897
2021-02-10;PS;Palestine;761;12;164736;1909
2021-02-11;PS;Palestine;799;1;165535;1910
2021-02-12;PS;Palestine;665;8;166200;1918
2021-02-13;PS;Palestine;600;12;166800;1930
2021-02-14;PS;Palestine;804;3;167604;1933
2021-02-15;PS;Palestine;840;3;168444;1936
2021-02-16;PS;Palestine;1043;6;169487;1942
2021-02-17;PS;Palestine;1040;6;170527;1948
2021-02-18;PS;Palestine;627;8;171154;1956
2021-02-19;PS;Palestine;563;5;171717;1961
2021-02-20;PS;Palestine;598;10;172315;1971
2021-02-21;PS;Palestine;1320;5;173635;1976
2021-02-22;PS;Palestine;1334;10;174969;1986
2021-02-23;PS;Palestine;1408;8;176377;1994
2021-02-24;PS;Palestine;1391;5;177768;1999
2021-02-25;PS;Palestine;1525;9;179293;2008
2021-02-26;PS;Palestine;1555;11;180848;2019
2021-02-27;PS;Palestine;1061;6;181909;2025
2021-02-28;PS;Palestine;1703;17;183612;2042
2021-03-01;PS;Palestine;1724;16;185336;2058
2021-03-02;PS;Palestine;1973;5;187309;2063
2021-03-03;PS;Palestine;2017;15;189326;2078
2021-03-04;PS;Palestine;1877;13;191203;2091
2021-03-05;PS;Palestine;1826;19;193029;2110
2021-03-06;PS;Palestine;1519;17;194548;2127
2021-03-07;PS;Palestine;2264;13;196812;2140
2021-03-08;PS;Palestine;1742;17;198554;2157
2021-03-09;PS;Palestine;1828;13;200382;2170
2021-03-10;PS;Palestine;1996;23;202378;2193
2021-03-11;PS;Palestine;1291;18;203669;2211
2021-03-12;PS;Palestine;1983;17;205652;2228
2021-03-13;PS;Palestine;1784;27;207436;2255
2021-03-14;PS;Palestine;1868;13;209304;2268
2021-03-15;PS;Palestine;2298;25;211602;2293
2021-03-16;PS;Palestine;2189;21;213791;2314
2021-03-17;PS;Palestine;2193;29;215984;2343
2021-03-18;PS;Palestine;2077;15;218061;2358
2021-03-19;PS;Palestine;1851;21;219912;2379
2021-03-20;PS;Palestine;1479;27;221391;2406
2021-03-21;PS;Palestine;2247;21;223638;2427
2021-03-22;PS;Palestine;2338;31;225976;2458
2021-03-23;PS;Palestine;2068;20;228044;2478
2021-03-24;PS;Palestine;2032;23;230076;2501
2021-03-25;PS;Palestine;1962;20;232038;2521
2021-03-26;PS;Palestine;1511;16;233549;2537
2021-03-27;PS;Palestine;1199;20;234748;2557
2021-03-28;PS;Palestine;1714;24;236462;2581
2021-03-29;PS;Palestine;1786;18;238248;2599
2021-03-30;PS;Palestine;1817;15;240065;2614
2021-03-31;PS;Palestine;2288;13;242353;2627
2021-04-01;PS;Palestine;2292;18;244645;2645
2021-04-02;PS;Palestine;2248;16;246893;2661
2021-04-03;PS;Palestine;1589;20;248482;2681
2021-04-04;PS;Palestine;2806;25;251288;2706
2021-04-05;PS;Palestine;2634;10;253922;2716
2021-04-06;PS;Palestine;2539;19;256461;2735
2021-04-07;PS;Palestine;2672;18;259133;2753
2021-04-08;PS;Palestine;2884;28;262017;2781
2021-04-09;PS;Palestine;2378;31;264395;2812
2021-04-10;PS;Palestine;1502;26;265897;2838
2021-04-11;PS;Palestine;2235;22;268132;2860
2021-04-12;PS;Palestine;2724;23;270856;2883
2021-04-13;PS;Palestine;1911;18;272767;2901
2021-04-14;PS;Palestine;1923;22;274690;2923
2021-04-15;PS;Palestine;1717;14;276407;2937
2021-04-16;PS;Palestine;1728;18;278135;2955
2021-04-17;PS;Palestine;1618;28;279753;2983
2021-04-18;PS;Palestine;988;34;280741;3017
2021-04-19;PS;Palestine;1529;30;282270;3047
2021-04-20;PS;Palestine;2010;31;284280;3078
2021-04-21;PS;Palestine;1748;18;286028;3096
2021-04-22;PS;Palestine;1652;19;287680;3115
2021-04-23;PS;Palestine;1440;23;289120;3138
2021-04-24;PS;Palestine;1139;13;290259;3151
2021-04-25;PS;Palestine;713;16;290972;3167
2021-04-26;PS;Palestine;1080;17;292052;3184
2021-04-27;PS;Palestine;1414;17;293466;3201
2021-04-28;PS;Palestine;1084;5;294550;3206
2021-04-29;PS;Palestine;1051;25;295601;3231
2021-04-30;PS;Palestine;861;18;296462;3249
2021-05-01;PS;Palestine;0;0;296462;3249
2021-05-02;PS;Palestine;1176;23;297638;3272
2021-05-03;PS;Palestine;565;11;298203;3283
2021-05-04;PS;Palestine;718;13;298921;3296
2021-05-05;PS;Palestine;815;21;299736;3317
2021-05-06;PS;Palestine;651;9;300387;3326
2021-05-07;PS;Palestine;559;12;300946;3338
2021-05-08;PS;Palestine;491;13;301437;3351
2021-05-09;PS;Palestine;314;7;301751;3358
2021-05-10;PS;Palestine;498;20;302249;3378
2021-05-11;PS;Palestine;528;15;302777;3393
2021-05-12;PS;Palestine;493;8;303270;3401
2021-05-13;PS;Palestine;0;0;303270;3401
2021-05-14;PS;Palestine;0;0;303270;3401
2021-05-15;PS;Palestine;388;22;303658;3423
2021-05-16;PS;Palestine;169;5;303827;3428
2021-05-17;PS;Palestine;247;9;304074;3437
2021-05-18;PS;Palestine;0;0;304074;3437
2021-05-19;PS;Palestine;458;11;304532;3448
2021-05-20;PS;Palestine;0;0;304532;3448
2021-05-21;PS;Palestine;436;4;304968;3452
2021-05-22;PS;Palestine;233;7;305201;3459
2021-05-23;PS;Palestine;0;0;305201;3459
2021-05-24;PS;Palestine;576;11;305777;3470
2021-05-25;PS;Palestine;557;10;306334;3480
2021-05-26;PS;Palestine;461;3;306795;3483
2021-05-27;PS;Palestine;0;0;306795;3483
2021-05-28;PS;Palestine;774;6;307569;3489
2021-05-29;PS;Palestine;269;3;307838;3492
2021-05-30;PS;Palestine;210;3;308048;3495
2021-05-31;PS;Palestine;302;2;308350;3497
2021-06-01;PS;Palestine;382;6;308732;3503
2021-06-02;PS;Palestine;304;4;309036;3507
2021-06-03;PS;Palestine;297;2;309333;3509
2021-06-04;PS;Palestine;311;2;309644;3511
2021-06-05;PS;Palestine;209;5;309853;3516
2021-06-06;PS;Palestine;173;1;310026;3517
2021-06-07;PS;Palestine;0;0;310026;3517
2021-06-08;PS;Palestine;518;3;310544;3520
2021-06-09;PS;Palestine;0;0;310544;3520
2021-06-10;PS;Palestine;474;4;311018;3524
2021-06-11;PS;Palestine;0;0;311018;3524
2021-06-12;PS;Palestine;0;0;311018;3524
2021-06-13;PS;Palestine;516;9;311534;3533
2021-06-14;PS;Palestine;156;6;311690;3539
2021-06-15;PS;Palestine;258;3;311948;3542
2021-06-16;PS;Palestine;216;2;312164;3544
2021-06-17;PS;Palestine;170;1;312334;3545
2021-06-18;PS;Palestine;165;3;312499;3548
2021-06-19;PS;Palestine;106;2;312605;3550
2021-06-20;PS;Palestine;68;1;312673;3551
2021-06-21;PS;Palestine;138;3;312811;3554
2021-06-22;PS;Palestine;204;1;313015;3555
2021-06-23;PS;Palestine;0;0;313015;3555
2021-06-24;PS;Palestine;0;0;313015;3555
2021-06-25;PS;Palestine;505;1;313520;3556
2021-06-26;PS;Palestine;0;0;313520;3556
2021-06-27;PS;Palestine;201;3;313721;3559
2021-06-28;PS;Palestine;130;2;313851;3561
2021-06-29;PS;Palestine;0;0;313851;3561
2021-06-30;PS;Palestine;316;2;314167;3563
2021-07-01;PS;Palestine;121;2;314288;3565
2020-03-09;PA;Panama;0;0;0;0
2020-03-10;PA;Panama;1;0;1;0
2020-03-11;PA;Panama;7;1;8;1
2020-03-12;PA;Panama;3;0;11;1
2020-03-13;PA;Panama;16;0;27;1
2020-03-14;PA;Panama;9;0;36;1
2020-03-15;PA;Panama;7;0;43;1
2020-03-16;PA;Panama;12;0;55;1
2020-03-17;PA;Panama;14;0;69;1
2020-03-18;PA;Panama;17;0;86;1
2020-03-19;PA;Panama;23;0;109;1
2020-03-20;PA;Panama;28;0;137;1
2020-03-21;PA;Panama;63;0;200;1
2020-03-22;PA;Panama;113;2;313;3
2020-03-23;PA;Panama;32;3;345;6
2020-03-24;PA;Panama;0;0;345;6
2020-03-25;PA;Panama;98;2;443;8
2020-03-26;PA;Panama;115;0;558;8
2020-03-27;PA;Panama;116;1;674;9
2020-03-28;PA;Panama;112;5;786;14
2020-03-29;PA;Panama;115;3;901;17
2020-03-30;PA;Panama;88;7;989;24
2020-03-31;PA;Panama;192;6;1181;30
2020-04-01;PA;Panama;0;0;1181;30
2020-04-02;PA;Panama;136;2;1317;32
2020-04-03;PA;Panama;158;5;1475;37
2020-04-04;PA;Panama;198;4;1673;41
2020-04-05;PA;Panama;128;5;1801;46
2020-04-06;PA;Panama;187;8;1988;54
2020-04-07;PA;Panama;112;1;2100;55
2020-04-08;PA;Panama;149;4;2249;59
2020-04-09;PA;Panama;279;4;2528;63
2020-04-10;PA;Panama;224;3;2752;66
2020-04-11;PA;Panama;222;8;2974;74
2020-04-12;PA;Panama;260;5;3234;79
2020-04-13;PA;Panama;166;8;3400;87
2020-04-14;PA;Panama;72;7;3472;94
2020-04-15;PA;Panama;102;1;3574;95
2020-04-16;PA;Panama;177;8;3751;103
2020-04-17;PA;Panama;265;6;4016;109
2020-04-18;PA;Panama;194;7;4210;116
2020-04-19;PA;Panama;63;4;4273;120
2020-04-20;PA;Panama;194;6;4467;126
2020-04-21;PA;Panama;191;10;4658;136
2020-04-22;PA;Panama;163;5;4821;141
2020-04-23;PA;Panama;345;5;5166;146
2020-04-24;PA;Panama;172;8;5338;154
2020-04-25;PA;Panama;200;5;5538;159
2020-04-26;PA;Panama;241;6;5779;165
2020-04-27;PA;Panama;242;2;6021;167
2020-04-28;PA;Panama;0;0;6021;167
2020-04-29;PA;Panama;357;11;6378;178
2020-04-30;PA;Panama;154;10;6532;188
2020-05-01;PA;Panama;188;4;6720;192
2020-05-02;PA;Panama;370;5;7090;197
2020-05-03;PA;Panama;0;0;7090;197
2020-05-04;PA;Panama;107;3;7197;200
2020-05-05;PA;Panama;326;10;7523;210
2020-05-06;PA;Panama;208;8;7731;218
2020-05-07;PA;Panama;137;7;7868;225
2020-05-08;PA;Panama;202;6;8070;231
2020-05-09;PA;Panama;212;6;8282;237
2020-05-10;PA;Panama;166;7;8448;244
2020-05-11;PA;Panama;168;5;8616;249
2020-05-12;PA;Panama;167;3;8783;252
2020-05-13;PA;Panama;161;4;8944;256
2020-05-14;PA;Panama;174;4;9118;260
2020-05-15;PA;Panama;150;6;9268;266
2020-05-16;PA;Panama;181;3;9449;269
2020-05-17;PA;Panama;157;6;9606;275
2020-05-18;PA;Panama;120;4;9726;279
2020-05-19;PA;Panama;141;2;9867;281
2020-05-20;PA;Panama;110;6;9977;287
2020-05-21;PA;Panama;139;4;10116;291
2020-05-22;PA;Panama;151;4;10267;295
2020-05-23;PA;Panama;310;4;10577;299
2020-05-24;PA;Panama;349;7;10926;306
2020-05-25;PA;Panama;257;4;11183;310
2020-05-26;PA;Panama;264;3;11447;313
2020-05-27;PA;Panama;281;2;11728;315
2020-05-28;PA;Panama;403;5;12131;320
2020-05-29;PA;Panama;400;6;12531;326
2020-05-30;PA;Panama;487;4;13018;330
2020-05-31;PA;Panama;445;6;13463;336
2020-06-01;PA;Panama;374;8;13837;344
2020-06-02;PA;Panama;258;8;14095;352
2020-06-03;PA;Panama;514;5;14609;357
2020-06-04;PA;Panama;435;6;15044;363
2020-06-05;PA;Panama;419;7;15463;370
2020-06-06;PA;Panama;541;16;16004;386
2020-06-07;PA;Panama;421;7;16425;393
2020-06-08;PA;Panama;429;5;16854;398
2020-06-09;PA;Panama;379;5;17233;403
2020-06-10;PA;Panama;656;10;17889;413
2020-06-11;PA;Panama;697;5;18586;418
2020-06-12;PA;Panama;625;3;19211;421
2020-06-13;PA;Panama;848;8;20059;429
2020-06-14;PA;Panama;1359;8;21418;437
2020-06-15;PA;Panama;4;11;21422;448
2020-06-16;PA;Panama;540;9;21962;457
2020-06-17;PA;Panama;635;13;22597;470
2020-06-18;PA;Panama;754;5;23351;475
2020-06-19;PA;Panama;923;10;24274;485
2020-06-20;PA;Panama;948;8;25222;493
2020-06-21;PA;Panama;808;8;26030;501
2020-06-22;PA;Panama;722;20;26752;521
2020-06-23;PA;Panama;562;15;27314;536
2020-06-24;PA;Panama;716;11;28030;547
2020-06-25;PA;Panama;1007;17;29037;564
2020-06-26;PA;Panama;868;11;29905;575
2020-06-27;PA;Panama;753;17;30658;592
2020-06-28;PA;Panama;1028;12;31686;604
2020-06-29;PA;Panama;1099;16;32785;620
2020-06-30;PA;Panama;765;11;33550;631
2020-07-01;PA;Panama;913;14;34463;645
2020-07-02;PA;Panama;774;22;35237;667
2020-07-03;PA;Panama;758;31;35995;698
2020-07-04;PA;Panama;988;22;36983;720
2020-07-05;PA;Panama;1166;27;38149;747
2020-07-06;PA;Panama;1185;23;39334;770
2020-07-07;PA;Panama;957;29;40291;799
2020-07-08;PA;Panama;960;20;41251;819
2020-07-09;PA;Panama;965;20;42216;839
2020-07-10;PA;Panama;1041;24;43257;863
2020-07-11;PA;Panama;1075;30;44332;893
2020-07-12;PA;Panama;1301;16;45633;909
2020-07-13;PA;Panama;1540;23;47173;932
2020-07-14;PA;Panama;923;28;48096;960
2020-07-15;PA;Panama;1147;22;49243;982
2020-07-16;PA;Panama;1130;18;50373;1000
2020-07-17;PA;Panama;1035;38;51408;1038
2020-07-18;PA;Panama;853;33;52261;1071
2020-07-19;PA;Panama;1207;25;53468;1096
2020-07-20;PA;Panama;958;31;54426;1127
2020-07-21;PA;Panama;727;32;55153;1159
2020-07-22;PA;Panama;753;21;55906;1180
2020-07-23;PA;Panama;911;29;56817;1209
2020-07-24;PA;Panama;1176;41;57993;1250
2020-07-25;PA;Panama;871;25;58864;1275
2020-07-26;PA;Panama;1432;19;60296;1294
2020-07-27;PA;Panama;1146;28;61442;1322
2020-07-28;PA;Panama;781;27;62223;1349
2020-07-29;PA;Panama;1046;25;63269;1374
2020-07-30;PA;Panama;922;23;64191;1397
2020-07-31;PA;Panama;1065;24;65256;1421
2020-08-01;PA;Panama;1127;28;66383;1449
2020-08-02;PA;Panama;1070;22;67453;1471
2020-08-03;PA;Panama;1003;26;68456;1497
2020-08-04;PA;Panama;968;25;69424;1522
2020-08-05;PA;Panama;807;31;70231;1553
2020-08-06;PA;Panama;1187;21;71418;1574
2020-08-07;PA;Panama;1142;17;72560;1591
2020-08-08;PA;Panama;1091;18;73651;1609
2020-08-09;PA;Panama;841;30;74492;1639
2020-08-10;PA;Panama;902;25;75394;1664
2020-08-11;PA;Panama;1070;16;76464;1680
2020-08-12;PA;Panama;913;23;77377;1703
2020-08-13;PA;Panama;1069;19;78446;1722
2020-08-14;PA;Panama;956;12;79402;1734
2020-08-15;PA;Panama;1263;12;80665;1746
2020-08-16;PA;Panama;1275;21;81940;1767
2020-08-17;PA;Panama;603;21;82543;1788
2020-08-18;PA;Panama;247;21;82790;1809
2020-08-19;PA;Panama;964;18;83754;1827
2020-08-20;PA;Panama;101;17;83855;1844
2020-08-21;PA;Panama;537;15;84392;1859
2020-08-22;PA;Panama;1088;19;85480;1878
2020-08-23;PA;Panama;1420;14;86900;1892
2020-08-24;PA;Panama;585;14;87485;1906
2020-08-25;PA;Panama;896;13;88381;1919
2020-08-26;PA;Panama;701;13;89082;1932
2020-08-27;PA;Panama;900;16;89982;1948
2020-08-28;PA;Panama;642;18;90624;1966
2020-08-29;PA;Panama;713;17;91337;1983
2020-08-30;PA;Panama;728;12;92065;1995
2020-08-31;PA;Panama;917;7;92982;2002
2020-09-01;PA;Panama;570;16;93552;2018
2020-09-02;PA;Panama;532;12;94084;2030
2020-09-03;PA;Panama;830;16;94914;2046
2020-09-04;PA;Panama;682;17;95596;2063
2020-09-05;PA;Panama;709;12;96305;2075
2020-09-06;PA;Panama;738;11;97043;2086
2020-09-07;PA;Panama;535;13;97578;2099
2020-09-08;PA;Panama;829;8;98407;2107
2020-09-09;PA;Panama;635;9;99042;2116
2020-09-10;PA;Panama;673;11;99715;2127
2020-09-11;PA;Panama;615;13;100330;2140
2020-09-12;PA;Panama;711;15;101041;2155
2020-09-13;PA;Panama;704;11;101745;2166
2020-09-14;PA;Panama;459;7;102204;2173
2020-09-15;PA;Panama;628;14;102832;2187
2020-09-16;PA;Panama;634;11;103466;2198
2020-09-17;PA;Panama;672;15;104138;2213
2020-09-18;PA;Panama;741;16;104879;2229
2020-09-19;PA;Panama;722;18;105601;2247
2020-09-20;PA;Panama;602;10;106203;2257
2020-09-21;PA;Panama;607;15;106810;2272
2020-09-22;PA;Panama;474;13;107284;2285
2020-09-23;PA;Panama;706;6;107990;2291
2020-09-24;PA;Panama;736;6;108726;2297
2020-09-25;PA;Panama;705;14;109431;2311
2020-09-26;PA;Panama;677;12;110108;2323
2020-09-27;PA;Panama;447;17;110555;2340
2020-09-28;PA;Panama;722;8;111277;2348
2020-09-29;PA;Panama;576;16;111853;2364
2020-09-30;PA;Panama;742;8;112595;2372
2020-10-01;PA;Panama;747;15;113342;2387
2020-10-02;PA;Panama;620;19;113962;2406
2020-10-03;PA;Panama;691;8;114653;2414
2020-10-04;PA;Panama;633;9;115286;2423
2020-10-05;PA;Panama;633;7;115919;2430
2020-10-06;PA;Panama;683;10;116602;2440
2020-10-07;PA;Panama;698;8;117300;2448
2020-10-08;PA;Panama;754;15;118054;2463
2020-10-09;PA;Panama;787;11;118841;2474
2020-10-10;PA;Panama;825;8;119666;2482
2020-10-11;PA;Panama;647;9;120313;2491
2020-10-12;PA;Panama;489;11;120802;2502
2020-10-13;PA;Panama;494;9;121296;2511
2020-10-14;PA;Panama;832;8;122128;2519
2020-10-15;PA;Panama;755;10;122883;2529
2020-10-16;PA;Panama;615;17;123498;2546
2020-10-17;PA;Panama;609;11;124107;2557
2020-10-18;PA;Panama;638;7;124745;2564
2020-10-19;PA;Panama;436;10;125181;2574
2020-10-20;PA;Panama;558;11;125739;2585
2020-10-21;PA;Panama;696;12;126435;2597
2020-10-22;PA;Panama;792;15;127227;2612
2020-10-23;PA;Panama;639;10;127866;2622
2020-10-24;PA;Panama;649;6;128515;2628
2020-10-25;PA;Panama;685;5;129200;2633
2020-10-26;PA;Panama;551;5;129751;2638
2020-10-27;PA;Panama;671;12;130422;2650
2020-10-28;PA;Panama;825;13;131247;2663
2020-10-29;PA;Panama;798;15;132045;2678
2020-10-30;PA;Panama;822;10;132867;2688
2020-10-31;PA;Panama;731;12;133598;2700
2020-11-01;PA;Panama;738;6;134336;2706
2020-11-02;PA;Panama;579;14;134915;2720
2020-11-03;PA;Panama;677;11;135592;2731
2020-11-04;PA;Panama;432;13;136024;2744
2020-11-05;PA;Panama;543;12;136567;2756
2020-11-06;PA;Panama;1193;14;137760;2770
2020-11-07;PA;Panama;746;11;138506;2781
2020-11-08;PA;Panama;1021;17;139527;2798
2020-11-09;PA;Panama;804;10;140331;2808
2020-11-10;PA;Panama;971;9;141302;2817
2020-11-11;PA;Panama;1163;6;142465;2823
2020-11-12;PA;Panama;887;7;143352;2830
2020-11-13;PA;Panama;1125;26;144477;2856
2020-11-14;PA;Panama;832;11;145309;2867
2020-11-15;PA;Panama;1344;6;146653;2873
2020-11-16;PA;Panama;1014;8;147667;2881
2020-11-17;PA;Panama;1054;12;148721;2893
2020-11-18;PA;Panama;1112;14;149833;2907
2020-11-19;PA;Panama;1256;15;151089;2922
2020-11-20;PA;Panama;1200;10;152289;2932
2020-11-21;PA;Panama;1288;14;153577;2946
2020-11-22;PA;Panama;1206;11;154783;2957
2020-11-23;PA;Panama;875;16;155658;2973
2020-11-24;PA;Panama;1272;13;156930;2986
2020-11-25;PA;Panama;1602;16;158532;3002
2020-11-26;PA;Panama;1755;16;160287;3018
2020-11-27;PA;Panama;1457;12;161744;3030
2020-11-28;PA;Panama;1709;9;163453;3039
2020-11-29;PA;Panama;1276;21;164729;3060
2020-11-30;PA;Panama;1077;19;165806;3079
2020-12-01;PA;Panama;1505;19;167311;3098
2020-12-02;PA;Panama;2028;16;169339;3114
2020-12-03;PA;Panama;1880;27;171219;3141
2020-12-04;PA;Panama;2388;13;173607;3154
2020-12-05;PA;Panama;2300;19;175907;3173
2020-12-06;PA;Panama;1812;20;177719;3193
2020-12-07;PA;Panama;1511;19;179230;3212
2020-12-08;PA;Panama;1936;29;181166;3241
2020-12-09;PA;Panama;1811;23;182977;3264
2020-12-10;PA;Panama;2447;23;185424;3287
2020-12-11;PA;Panama;2355;22;187779;3309
2020-12-12;PA;Panama;2806;22;190585;3331
2020-12-13;PA;Panama;2422;25;193007;3356
2020-12-14;PA;Panama;1612;26;194619;3382
2020-12-15;PA;Panama;2368;29;196987;3411
2020-12-16;PA;Panama;2960;28;199947;3439
2020-12-17;PA;Panama;3348;42;203295;3481
2020-12-18;PA;Panama;3015;23;206310;3504
2020-12-19;PA;Panama;3274;23;209584;3527
2020-12-20;PA;Panama;2755;39;212339;3566
2020-12-21;PA;Panama;1699;31;214038;3597
2020-12-22;PA;Panama;3164;35;217202;3632
2020-12-23;PA;Panama;3059;32;220261;3664
2020-12-24;PA;Panama;3413;51;223674;3715
2020-12-25;PA;Panama;2986;41;226660;3756
2020-12-26;PA;Panama;2064;43;228724;3799
2020-12-27;PA;Panama;2633;41;231357;3840
2020-12-28;PA;Panama;2348;52;233705;3892
2020-12-29;PA;Panama;4574;41;238279;3933
2020-12-30;PA;Panama;4465;42;242744;3975
2020-12-31;PA;Panama;4046;47;246790;4022
2021-01-01;PA;Panama;2943;42;249733;4064
2021-01-02;PA;Panama;2031;39;251764;4103
2021-01-03;PA;Panama;1972;37;253736;4140
2021-01-04;PA;Panama;2494;57;256230;4197
2021-01-05;PA;Panama;3540;41;259770;4238
2021-01-06;PA;Panama;5186;45;264956;4283
2021-01-07;PA;Panama;4135;38;269091;4321
2021-01-08;PA;Panama;3946;42;273037;4363
2021-01-09;PA;Panama;3735;43;276772;4406
2021-01-10;PA;Panama;2424;49;279196;4455
2021-01-11;PA;Panama;2157;45;281353;4500
2021-01-12;PA;Panama;3740;61;285093;4561
2021-01-13;PA;Panama;3315;33;288408;4594
2021-01-14;PA;Panama;2877;57;291285;4651
2021-01-15;PA;Panama;2307;38;293592;4689
2021-01-16;PA;Panama;2677;49;296269;4738
2021-01-17;PA;Panama;1750;49;298019;4787
2021-01-18;PA;Panama;1342;41;299361;4828
2021-01-19;PA;Panama;2173;36;301534;4864
2021-01-20;PA;Panama;2243;48;303777;4912
2021-01-21;PA;Panama;1975;32;305752;4944
2021-01-22;PA;Panama;2041;36;307793;4980
2021-01-23;PA;Panama;2058;54;309851;5034
2021-01-24;PA;Panama;1393;29;311244;5063
2021-01-25;PA;Panama;914;35;312158;5098
2021-01-26;PA;Panama;1676;39;313834;5137
2021-01-27;PA;Panama;1566;39;315400;5176
2021-01-28;PA;Panama;1408;20;316808;5196
2021-01-29;PA;Panama;1445;25;318253;5221
2021-01-30;PA;Panama;1200;23;319453;5244
2021-01-31;PA;Panama;926;26;320379;5270
2021-02-01;PA;Panama;724;26;321103;5296
2021-02-02;PA;Panama;1098;43;322201;5339
2021-02-03;PA;Panama;1181;27;323382;5366
2021-02-04;PA;Panama;1107;25;324489;5391
2021-02-05;PA;Panama;998;35;325487;5426
2021-02-06;PA;Panama;977;29;326464;5455
2021-02-07;PA;Panama;627;25;327091;5480
2021-02-08;PA;Panama;563;26;327654;5506
2021-02-09;PA;Panama;822;25;328476;5531
2021-02-10;PA;Panama;891;19;329367;5550
2021-02-11;PA;Panama;708;22;330075;5572
2021-02-12;PA;Panama;910;23;330985;5595
2021-02-13;PA;Panama;707;26;331692;5621
2021-02-14;PA;Panama;487;15;332179;5636
2021-02-15;PA;Panama;500;6;332679;5642
2021-02-16;PA;Panama;572;13;333251;5655
2021-02-17;PA;Panama;504;17;333755;5672
2021-02-18;PA;Panama;708;22;334463;5694
2021-02-19;PA;Panama;876;17;335339;5711
2021-02-20;PA;Panama;698;16;336037;5727
2021-02-21;PA;Panama;484;15;336521;5742
2021-02-22;PA;Panama;566;14;337087;5756
2021-02-23;PA;Panama;718;16;337805;5772
2021-02-24;PA;Panama;896;17;338701;5789
2021-02-25;PA;Panama;682;21;339383;5810
2021-02-26;PA;Panama;398;10;339781;5820
2021-02-27;PA;Panama;664;11;340445;5831
2021-02-28;PA;Panama;470;14;340915;5845
2021-03-01;PA;Panama;505;13;341420;5858
2021-03-02;PA;Panama;599;13;342019;5871
2021-03-03;PA;Panama;722;13;342741;5884
2021-03-04;PA;Panama;540;11;343281;5895
2021-03-05;PA;Panama;462;12;343743;5907
2021-03-06;PA;Panama;734;3;344477;5910
2021-03-07;PA;Panama;357;13;344834;5923
2021-03-08;PA;Panama;402;11;345236;5934
2021-03-09;PA;Panama;523;10;345759;5944
2021-03-10;PA;Panama;542;13;346301;5957
2021-03-11;PA;Panama;474;15;346775;5972
2021-03-12;PA;Panama;451;9;347226;5981
2021-03-13;PA;Panama;415;6;347641;5987
2021-03-14;PA;Panama;278;7;347919;5994
2021-03-15;PA;Panama;236;11;348155;6005
2021-03-16;PA;Panama;425;4;348580;6009
2021-03-17;PA;Panama;440;9;349020;6018
2021-03-18;PA;Panama;485;7;349505;6025
2021-03-19;PA;Panama;715;10;350220;6035
2021-03-20;PA;Panama;445;7;350665;6042
2021-03-21;PA;Panama;326;2;350991;6044
2021-03-22;PA;Panama;222;8;351213;6052
2021-03-23;PA;Panama;454;8;351667;6060
2021-03-24;PA;Panama;415;5;352082;6065
2021-03-25;PA;Panama;497;8;352579;6073
2021-03-26;PA;Panama;438;14;353017;6087
2021-03-27;PA;Panama;480;3;353497;6090
2021-03-28;PA;Panama;342;10;353839;6100
2021-03-29;PA;Panama;246;3;354085;6103
2021-03-30;PA;Panama;519;6;354604;6109
2021-03-31;PA;Panama;447;5;355051;6114
2021-04-01;PA;Panama;448;5;355499;6119
2021-04-02;PA;Panama;351;7;355850;6126
2021-04-03;PA;Panama;223;5;356073;6131
2021-04-04;PA;Panama;304;4;356377;6135
2021-04-05;PA;Panama;179;3;356556;6138
2021-04-06;PA;Panama;357;8;356913;6146
2021-04-07;PA;Panama;364;2;357277;6148
2021-04-08;PA;Panama;427;4;357704;6152
2021-04-09;PA;Panama;394;4;358098;6156
2021-04-10;PA;Panama;279;3;358377;6159
2021-04-11;PA;Panama;234;4;358611;6163
2021-04-12;PA;Panama;181;4;358792;6167
2021-04-13;PA;Panama;329;6;359121;6173
2021-04-14;PA;Panama;395;4;359516;6177
2021-04-15;PA;Panama;314;6;359830;6183
2021-04-16;PA;Panama;419;2;360249;6185
2021-04-17;PA;Panama;348;2;360597;6187
2021-04-18;PA;Panama;244;1;360841;6188
2021-04-19;PA;Panama;203;1;361044;6189
2021-04-20;PA;Panama;275;3;361319;6192
2021-04-21;PA;Panama;359;4;361678;6196
2021-04-22;PA;Panama;314;2;361992;6198
2021-04-23;PA;Panama;366;2;362358;6200
2021-04-24;PA;Panama;338;7;362696;6207
2021-04-25;PA;Panama;271;2;362967;6209
2021-04-26;PA;Panama;198;3;363165;6212
2021-04-27;PA;Panama;368;4;363533;6216
2021-04-28;PA;Panama;362;6;363895;6222
2021-04-29;PA;Panama;323;5;364218;6227
2021-04-30;PA;Panama;358;5;364576;6232
2021-05-01;PA;Panama;268;3;364844;6235
2021-05-02;PA;Panama;260;3;365104;6238
2021-05-03;PA;Panama;195;6;365299;6244
2021-05-04;PA;Panama;320;4;365619;6248
2021-05-05;PA;Panama;356;4;365975;6252
2021-05-06;PA;Panama;389;3;366364;6255
2021-05-07;PA;Panama;398;3;366762;6258
2021-05-08;PA;Panama;508;7;367270;6265
2021-05-09;PA;Panama;386;6;367656;6271
2021-05-10;PA;Panama;252;6;367908;6277
2021-05-11;PA;Panama;460;5;368368;6282
2021-05-12;PA;Panama;562;3;368930;6285
2021-05-13;PA;Panama;525;3;369455;6288
2021-05-14;PA;Panama;588;4;370043;6292
2021-05-15;PA;Panama;490;4;370533;6296
2021-05-16;PA;Panama;344;0;370877;6296
2021-05-17;PA;Panama;268;1;371145;6297
2021-05-18;PA;Panama;539;3;371684;6300
2021-05-19;PA;Panama;537;5;372221;6305
2021-05-20;PA;Panama;579;9;372800;6314
2021-05-21;PA;Panama;508;7;373308;6321
2021-05-22;PA;Panama;466;7;373774;6328
2021-05-23;PA;Panama;347;3;374121;6331
2021-05-24;PA;Panama;235;15;374356;6346
2021-05-25;PA;Panama;581;7;374937;6353
2021-05-26;PA;Panama;663;4;375600;6357
2021-05-27;PA;Panama;637;4;376237;6361
2021-05-28;PA;Panama;617;4;376854;6365
2021-05-29;PA;Panama;574;4;377428;6369
2021-05-30;PA;Panama;348;1;377776;6370
2021-05-31;PA;Panama;321;1;378097;6371
2021-06-01;PA;Panama;731;6;378828;6377
2021-06-02;PA;Panama;678;4;379506;6381
2021-06-03;PA;Panama;701;7;380207;6388
2021-06-04;PA;Panama;915;1;381122;6389
2021-06-05;PA;Panama;827;6;381949;6395
2021-06-06;PA;Panama;526;7;382475;6402
2021-06-07;PA;Panama;376;2;382851;6404
2021-06-08;PA;Panama;882;4;383733;6408
2021-06-09;PA;Panama;779;5;384512;6413
2021-06-10;PA;Panama;841;6;385353;6419
2021-06-11;PA;Panama;916;8;386269;6427
2021-06-12;PA;Panama;858;12;387127;6439
2021-06-13;PA;Panama;715;5;387842;6444
2021-06-14;PA;Panama;483;7;388325;6451
2021-06-15;PA;Panama;848;1;389173;6452
2021-06-16;PA;Panama;1048;5;390221;6457
2021-06-17;PA;Panama;969;1;391190;6458
2021-06-18;PA;Panama;976;7;392166;6465
2021-06-19;PA;Panama;978;3;393144;6468
2021-06-20;PA;Panama;583;7;393727;6475
2021-06-21;PA;Panama;514;2;394241;6477
2021-06-22;PA;Panama;1208;6;395449;6483
2021-06-23;PA;Panama;1077;8;396526;6491
2021-06-24;PA;Panama;1201;9;397727;6500
2021-06-25;PA;Panama;1093;5;398820;6505
2021-06-26;PA;Panama;1057;9;399877;6514
2021-06-27;PA;Panama;789;10;400666;6524
2021-06-28;PA;Panama;666;5;401332;6529
2021-06-29;PA;Panama;1249;7;402581;6536
2021-06-30;PA;Panama;1197;9;403778;6545
2021-07-01;PA;Panama;1205;7;404983;6552
2020-03-20;PG;Papua New Guinea;1;0;1;0
2020-03-21;PG;Papua New Guinea;0;0;1;0
2020-03-22;PG;Papua New Guinea;0;0;1;0
2020-03-23;PG;Papua New Guinea;0;0;1;0
2020-03-24;PG;Papua New Guinea;0;0;1;0
2020-03-25;PG;Papua New Guinea;0;0;1;0
2020-03-26;PG;Papua New Guinea;0;0;1;0
2020-03-27;PG;Papua New Guinea;0;0;1;0
2020-03-28;PG;Papua New Guinea;0;0;1;0
2020-03-29;PG;Papua New Guinea;0;0;1;0
2020-03-30;PG;Papua New Guinea;0;0;1;0
2020-03-31;PG;Papua New Guinea;0;0;1;0
2020-04-01;PG;Papua New Guinea;0;0;1;0
2020-04-02;PG;Papua New Guinea;0;0;1;0
2020-04-03;PG;Papua New Guinea;0;0;1;0
2020-04-04;PG;Papua New Guinea;0;0;1;0
2020-04-05;PG;Papua New Guinea;0;0;1;0
2020-04-06;PG;Papua New Guinea;1;0;2;0
2020-04-07;PG;Papua New Guinea;0;0;2;0
2020-04-08;PG;Papua New Guinea;0;0;2;0
2020-04-09;PG;Papua New Guinea;0;0;2;0
2020-04-10;PG;Papua New Guinea;0;0;2;0
2020-04-11;PG;Papua New Guinea;0;0;2;0
2020-04-12;PG;Papua New Guinea;0;0;2;0
2020-04-13;PG;Papua New Guinea;0;0;2;0
2020-04-14;PG;Papua New Guinea;0;0;2;0
2020-04-15;PG;Papua New Guinea;0;0;2;0
2020-04-16;PG;Papua New Guinea;5;0;7;0
2020-04-17;PG;Papua New Guinea;0;0;7;0
2020-04-18;PG;Papua New Guinea;0;0;7;0
2020-04-19;PG;Papua New Guinea;0;0;7;0
2020-04-20;PG;Papua New Guinea;0;0;7;0
2020-04-21;PG;Papua New Guinea;0;0;7;0
2020-04-22;PG;Papua New Guinea;1;0;8;0
2020-04-23;PG;Papua New Guinea;0;0;8;0
2020-04-24;PG;Papua New Guinea;0;0;8;0
2020-04-25;PG;Papua New Guinea;0;0;8;0
2020-04-26;PG;Papua New Guinea;0;0;8;0
2020-04-27;PG;Papua New Guinea;0;0;8;0
2020-04-28;PG;Papua New Guinea;0;0;8;0
2020-04-29;PG;Papua New Guinea;0;0;8;0
2020-04-30;PG;Papua New Guinea;0;0;8;0
2020-05-01;PG;Papua New Guinea;0;0;8;0
2020-05-02;PG;Papua New Guinea;0;0;8;0
2020-05-03;PG;Papua New Guinea;0;0;8;0
2020-05-04;PG;Papua New Guinea;0;0;8;0
2020-05-05;PG;Papua New Guinea;0;0;8;0
2020-05-06;PG;Papua New Guinea;0;0;8;0
2020-05-07;PG;Papua New Guinea;0;0;8;0
2020-05-08;PG;Papua New Guinea;0;0;8;0
2020-05-09;PG;Papua New Guinea;0;0;8;0
2020-05-10;PG;Papua New Guinea;0;0;8;0
2020-05-11;PG;Papua New Guinea;0;0;8;0
2020-05-12;PG;Papua New Guinea;0;0;8;0
2020-05-13;PG;Papua New Guinea;0;0;8;0
2020-05-14;PG;Papua New Guinea;0;0;8;0
2020-05-15;PG;Papua New Guinea;0;0;8;0
2020-05-16;PG;Papua New Guinea;0;0;8;0
2020-05-17;PG;Papua New Guinea;0;0;8;0
2020-05-18;PG;Papua New Guinea;0;0;8;0
2020-05-19;PG;Papua New Guinea;0;0;8;0
2020-05-20;PG;Papua New Guinea;0;0;8;0
2020-05-21;PG;Papua New Guinea;0;0;8;0
2020-05-22;PG;Papua New Guinea;0;0;8;0
2020-05-23;PG;Papua New Guinea;0;0;8;0
2020-05-24;PG;Papua New Guinea;0;0;8;0
2020-05-25;PG;Papua New Guinea;0;0;8;0
2020-05-26;PG;Papua New Guinea;0;0;8;0
2020-05-27;PG;Papua New Guinea;0;0;8;0
2020-05-28;PG;Papua New Guinea;0;0;8;0
2020-05-29;PG;Papua New Guinea;0;0;8;0
2020-05-30;PG;Papua New Guinea;0;0;8;0
2020-05-31;PG;Papua New Guinea;0;0;8;0
2020-06-01;PG;Papua New Guinea;0;0;8;0
2020-06-02;PG;Papua New Guinea;0;0;8;0
2020-06-03;PG;Papua New Guinea;0;0;8;0
2020-06-04;PG;Papua New Guinea;0;0;8;0
2020-06-05;PG;Papua New Guinea;0;0;8;0
2020-06-06;PG;Papua New Guinea;0;0;8;0
2020-06-07;PG;Papua New Guinea;0;0;8;0
2020-06-08;PG;Papua New Guinea;0;0;8;0
2020-06-09;PG;Papua New Guinea;0;0;8;0
2020-06-10;PG;Papua New Guinea;0;0;8;0
2020-06-11;PG;Papua New Guinea;0;0;8;0
2020-06-12;PG;Papua New Guinea;0;0;8;0
2020-06-13;PG;Papua New Guinea;0;0;8;0
2020-06-14;PG;Papua New Guinea;0;0;8;0
2020-06-15;PG;Papua New Guinea;0;0;8;0
2020-06-16;PG;Papua New Guinea;0;0;8;0
2020-06-17;PG;Papua New Guinea;0;0;8;0
2020-06-18;PG;Papua New Guinea;0;0;8;0
2020-06-19;PG;Papua New Guinea;0;0;8;0
2020-06-20;PG;Papua New Guinea;0;0;8;0
2020-06-21;PG;Papua New Guinea;0;0;8;0
2020-06-22;PG;Papua New Guinea;1;0;9;0
2020-06-23;PG;Papua New Guinea;0;0;9;0
2020-06-24;PG;Papua New Guinea;1;0;10;0
2020-06-25;PG;Papua New Guinea;0;0;10;0
2020-06-26;PG;Papua New Guinea;1;0;11;0
2020-06-27;PG;Papua New Guinea;0;0;11;0
2020-06-28;PG;Papua New Guinea;0;0;11;0
2020-06-29;PG;Papua New Guinea;0;0;11;0
2020-06-30;PG;Papua New Guinea;0;0;11;0
2020-07-01;PG;Papua New Guinea;0;0;11;0
2020-07-02;PG;Papua New Guinea;0;0;11;0
2020-07-03;PG;Papua New Guinea;0;0;11;0
2020-07-04;PG;Papua New Guinea;0;0;11;0
2020-07-05;PG;Papua New Guinea;0;0;11;0
2020-07-06;PG;Papua New Guinea;0;0;11;0
2020-07-07;PG;Papua New Guinea;0;0;11;0
2020-07-08;PG;Papua New Guinea;0;0;11;0
2020-07-09;PG;Papua New Guinea;0;0;11;0
2020-07-10;PG;Papua New Guinea;0;0;11;0
2020-07-11;PG;Papua New Guinea;0;0;11;0
2020-07-12;PG;Papua New Guinea;0;0;11;0
2020-07-13;PG;Papua New Guinea;0;0;11;0
2020-07-14;PG;Papua New Guinea;0;0;11;0
2020-07-15;PG;Papua New Guinea;0;0;11;0
2020-07-16;PG;Papua New Guinea;0;0;11;0
2020-07-17;PG;Papua New Guinea;4;0;15;0
2020-07-18;PG;Papua New Guinea;1;0;16;0
2020-07-19;PG;Papua New Guinea;0;0;16;0
2020-07-20;PG;Papua New Guinea;3;0;19;0
2020-07-21;PG;Papua New Guinea;8;0;27;0
2020-07-22;PG;Papua New Guinea;3;0;30;0
2020-07-23;PG;Papua New Guinea;1;0;31;0
2020-07-24;PG;Papua New Guinea;1;0;32;0
2020-07-25;PG;Papua New Guinea;7;0;39;0
2020-07-26;PG;Papua New Guinea;23;0;62;0
2020-07-27;PG;Papua New Guinea;0;0;62;0
2020-07-28;PG;Papua New Guinea;1;0;63;0
2020-07-29;PG;Papua New Guinea;0;1;63;1
2020-07-30;PG;Papua New Guinea;0;1;63;2
2020-07-31;PG;Papua New Guinea;9;0;72;2
2020-08-01;PG;Papua New Guinea;19;0;91;2
2020-08-02;PG;Papua New Guinea;19;0;110;2
2020-08-03;PG;Papua New Guinea;1;0;111;2
2020-08-04;PG;Papua New Guinea;3;0;114;2
2020-08-05;PG;Papua New Guinea;39;0;153;2
2020-08-06;PG;Papua New Guinea;10;1;163;3
2020-08-07;PG;Papua New Guinea;25;0;188;3
2020-08-08;PG;Papua New Guinea;0;0;188;3
2020-08-09;PG;Papua New Guinea;26;0;214;3
2020-08-10;PG;Papua New Guinea;0;0;214;3
2020-08-11;PG;Papua New Guinea;0;0;214;3
2020-08-12;PG;Papua New Guinea;73;0;287;3
2020-08-13;PG;Papua New Guinea;-16;0;271;3
2020-08-14;PG;Papua New Guinea;0;0;271;3
2020-08-15;PG;Papua New Guinea;0;0;271;3
2020-08-16;PG;Papua New Guinea;52;0;323;3
2020-08-17;PG;Papua New Guinea;10;0;333;3
2020-08-18;PG;Papua New Guinea;14;0;347;3
2020-08-19;PG;Papua New Guinea;0;0;347;3
2020-08-20;PG;Papua New Guinea;14;1;361;4
2020-08-21;PG;Papua New Guinea;0;0;361;4
2020-08-22;PG;Papua New Guinea;0;0;361;4
2020-08-23;PG;Papua New Guinea;40;0;401;4
2020-08-24;PG;Papua New Guinea;0;0;401;4
2020-08-25;PG;Papua New Guinea;18;0;419;4
2020-08-26;PG;Papua New Guinea;0;0;419;4
2020-08-27;PG;Papua New Guinea;5;0;424;4
2020-08-28;PG;Papua New Guinea;29;1;453;5
2020-08-29;PG;Papua New Guinea;0;0;453;5
2020-08-30;PG;Papua New Guinea;6;0;459;5
2020-08-31;PG;Papua New Guinea;0;0;459;5
2020-09-01;PG;Papua New Guinea;1;0;460;5
2020-09-02;PG;Papua New Guinea;11;0;471;5
2020-09-03;PG;Papua New Guinea;0;0;471;5
2020-09-04;PG;Papua New Guinea;8;0;479;5
2020-09-05;PG;Papua New Guinea;9;0;488;5
2020-09-06;PG;Papua New Guinea;9;0;497;5
2020-09-07;PG;Papua New Guinea;0;0;497;5
2020-09-08;PG;Papua New Guinea;6;0;503;5
2020-09-09;PG;Papua New Guinea;1;0;504;5
2020-09-10;PG;Papua New Guinea;3;0;507;5
2020-09-11;PG;Papua New Guinea;1;0;508;5
2020-09-12;PG;Papua New Guinea;0;0;508;5
2020-09-13;PG;Papua New Guinea;2;1;510;6
2020-09-14;PG;Papua New Guinea;1;0;511;6
2020-09-15;PG;Papua New Guinea;0;0;511;6
2020-09-16;PG;Papua New Guinea;5;0;516;6
2020-09-17;PG;Papua New Guinea;0;0;516;6
2020-09-18;PG;Papua New Guinea;0;0;516;6
2020-09-19;PG;Papua New Guinea;0;0;516;6
2020-09-20;PG;Papua New Guinea;1;1;517;7
2020-09-21;PG;Papua New Guinea;0;0;517;7
2020-09-22;PG;Papua New Guinea;10;0;527;7
2020-09-23;PG;Papua New Guinea;0;0;527;7
2020-09-24;PG;Papua New Guinea;4;0;531;7
2020-09-25;PG;Papua New Guinea;1;0;532;7
2020-09-26;PG;Papua New Guinea;0;0;532;7
2020-09-27;PG;Papua New Guinea;0;0;532;7
2020-09-28;PG;Papua New Guinea;0;0;532;7
2020-09-29;PG;Papua New Guinea;2;0;534;7
2020-09-30;PG;Papua New Guinea;0;0;534;7
2020-10-01;PG;Papua New Guinea;5;0;539;7
2020-10-02;PG;Papua New Guinea;0;0;539;7
2020-10-03;PG;Papua New Guinea;1;0;540;7
2020-10-04;PG;Papua New Guinea;0;0;540;7
2020-10-05;PG;Papua New Guinea;0;0;540;7
2020-10-06;PG;Papua New Guinea;1;0;541;7
2020-10-07;PG;Papua New Guinea;0;0;541;7
2020-10-08;PG;Papua New Guinea;8;0;549;7
2020-10-09;PG;Papua New Guinea;0;0;549;7
2020-10-10;PG;Papua New Guinea;0;0;549;7
2020-10-11;PG;Papua New Guinea;5;0;554;7
2020-10-12;PG;Papua New Guinea;11;0;565;7
2020-10-13;PG;Papua New Guinea;0;0;565;7
2020-10-14;PG;Papua New Guinea;13;0;578;7
2020-10-15;PG;Papua New Guinea;0;0;578;7
2020-10-16;PG;Papua New Guinea;0;0;578;7
2020-10-17;PG;Papua New Guinea;3;0;581;7
2020-10-18;PG;Papua New Guinea;0;0;581;7
2020-10-19;PG;Papua New Guinea;0;0;581;7
2020-10-20;PG;Papua New Guinea;0;0;581;7
2020-10-21;PG;Papua New Guinea;0;0;581;7
2020-10-22;PG;Papua New Guinea;2;0;583;7
2020-10-23;PG;Papua New Guinea;0;0;583;7
2020-10-24;PG;Papua New Guinea;0;0;583;7
2020-10-25;PG;Papua New Guinea;0;0;583;7
2020-10-26;PG;Papua New Guinea;5;0;588;7
2020-10-27;PG;Papua New Guinea;0;0;588;7
2020-10-28;PG;Papua New Guinea;0;0;588;7
2020-10-29;PG;Papua New Guinea;1;0;589;7
2020-10-30;PG;Papua New Guinea;0;0;589;7
2020-10-31;PG;Papua New Guinea;0;0;589;7
2020-11-01;PG;Papua New Guinea;0;0;589;7
2020-11-02;PG;Papua New Guinea;1;0;590;7
2020-11-03;PG;Papua New Guinea;7;0;597;7
2020-11-04;PG;Papua New Guinea;0;0;597;7
2020-11-05;PG;Papua New Guinea;0;0;597;7
2020-11-06;PG;Papua New Guinea;0;0;597;7
2020-11-07;PG;Papua New Guinea;0;0;597;7
2020-11-08;PG;Papua New Guinea;2;0;599;7
2020-11-09;PG;Papua New Guinea;0;0;599;7
2020-11-10;PG;Papua New Guinea;0;0;599;7
2020-11-11;PG;Papua New Guinea;0;0;599;7
2020-11-12;PG;Papua New Guinea;0;0;599;7
2020-11-13;PG;Papua New Guinea;1;0;600;7
2020-11-14;PG;Papua New Guinea;0;0;600;7
2020-11-15;PG;Papua New Guinea;2;0;602;7
2020-11-16;PG;Papua New Guinea;0;0;602;7
2020-11-17;PG;Papua New Guinea;0;0;602;7
2020-11-18;PG;Papua New Guinea;2;0;604;7
2020-11-19;PG;Papua New Guinea;0;0;604;7
2020-11-20;PG;Papua New Guinea;0;0;604;7
2020-11-21;PG;Papua New Guinea;0;0;604;7
2020-11-22;PG;Papua New Guinea;0;0;604;7
2020-11-23;PG;Papua New Guinea;26;0;630;7
2020-11-24;PG;Papua New Guinea;0;0;630;7
2020-11-25;PG;Papua New Guinea;15;0;645;7
2020-11-26;PG;Papua New Guinea;0;0;645;7
2020-11-27;PG;Papua New Guinea;0;0;645;7
2020-11-28;PG;Papua New Guinea;0;0;645;7
2020-11-29;PG;Papua New Guinea;0;0;645;7
2020-11-30;PG;Papua New Guinea;11;0;656;7
2020-12-01;PG;Papua New Guinea;13;0;669;7
2020-12-02;PG;Papua New Guinea;0;0;669;7
2020-12-03;PG;Papua New Guinea;2;0;671;7
2020-12-04;PG;Papua New Guinea;0;0;671;7
2020-12-05;PG;Papua New Guinea;0;0;671;7
2020-12-06;PG;Papua New Guinea;0;0;671;7
2020-12-07;PG;Papua New Guinea;0;0;671;7
2020-12-08;PG;Papua New Guinea;13;0;684;7
2020-12-09;PG;Papua New Guinea;0;0;684;7
2020-12-10;PG;Papua New Guinea;0;0;684;7
2020-12-11;PG;Papua New Guinea;36;1;720;8
2020-12-12;PG;Papua New Guinea;0;0;720;8
2020-12-13;PG;Papua New Guinea;5;0;725;8
2020-12-14;PG;Papua New Guinea;0;0;725;8
2020-12-15;PG;Papua New Guinea;4;0;729;8
2020-12-16;PG;Papua New Guinea;0;0;729;8
2020-12-17;PG;Papua New Guinea;31;0;760;8
2020-12-18;PG;Papua New Guinea;0;0;760;8
2020-12-19;PG;Papua New Guinea;0;0;760;8
2020-12-20;PG;Papua New Guinea;0;0;760;8
2020-12-21;PG;Papua New Guinea;1;1;761;9
2020-12-22;PG;Papua New Guinea;0;0;761;9
2020-12-23;PG;Papua New Guinea;0;0;761;9
2020-12-24;PG;Papua New Guinea;19;0;780;9
2020-12-25;PG;Papua New Guinea;0;0;780;9
2020-12-26;PG;Papua New Guinea;0;0;780;9
2020-12-27;PG;Papua New Guinea;0;0;780;9
2020-12-28;PG;Papua New Guinea;0;0;780;9
2020-12-29;PG;Papua New Guinea;0;0;780;9
2020-12-30;PG;Papua New Guinea;0;0;780;9
2020-12-31;PG;Papua New Guinea;0;0;780;9
2021-01-01;PG;Papua New Guinea;0;0;780;9
2021-01-02;PG;Papua New Guinea;0;0;780;9
2021-01-03;PG;Papua New Guinea;19;0;799;9
2021-01-04;PG;Papua New Guinea;0;0;799;9
2021-01-05;PG;Papua New Guinea;0;0;799;9
2021-01-06;PG;Papua New Guinea;0;0;799;9
2021-01-07;PG;Papua New Guinea;0;0;799;9
2021-01-08;PG;Papua New Guinea;12;0;811;9
2021-01-09;PG;Papua New Guinea;0;0;811;9
2021-01-10;PG;Papua New Guinea;0;0;811;9
2021-01-11;PG;Papua New Guinea;8;0;819;9
2021-01-12;PG;Papua New Guinea;4;0;823;9
2021-01-13;PG;Papua New Guinea;10;0;833;9
2021-01-14;PG;Papua New Guinea;1;0;834;9
2021-01-15;PG;Papua New Guinea;0;0;834;9
2021-01-16;PG;Papua New Guinea;0;0;834;9
2021-01-17;PG;Papua New Guinea;0;0;834;9
2021-01-18;PG;Papua New Guinea;0;0;834;9
2021-01-19;PG;Papua New Guinea;0;0;834;9
2021-01-20;PG;Papua New Guinea;1;0;835;9
2021-01-21;PG;Papua New Guinea;0;0;835;9
2021-01-22;PG;Papua New Guinea;0;0;835;9
2021-01-23;PG;Papua New Guinea;0;0;835;9
2021-01-24;PG;Papua New Guinea;0;0;835;9
2021-01-25;PG;Papua New Guinea;0;0;835;9
2021-01-26;PG;Papua New Guinea;15;0;850;9
2021-01-27;PG;Papua New Guinea;1;0;851;9
2021-01-28;PG;Papua New Guinea;0;0;851;9
2021-01-29;PG;Papua New Guinea;0;0;851;9
2021-01-30;PG;Papua New Guinea;0;0;851;9
2021-01-31;PG;Papua New Guinea;0;0;851;9
2021-02-01;PG;Papua New Guinea;16;0;867;9
2021-02-02;PG;Papua New Guinea;0;0;867;9
2021-02-03;PG;Papua New Guinea;0;0;867;9
2021-02-04;PG;Papua New Guinea;0;0;867;9
2021-02-05;PG;Papua New Guinea;24;0;891;9
2021-02-06;PG;Papua New Guinea;0;0;891;9
2021-02-07;PG;Papua New Guinea;4;0;895;9
2021-02-08;PG;Papua New Guinea;5;0;900;9
2021-02-09;PG;Papua New Guinea;0;0;900;9
2021-02-10;PG;Papua New Guinea;0;0;900;9
2021-02-11;PG;Papua New Guinea;14;0;914;9
2021-02-12;PG;Papua New Guinea;0;0;914;9
2021-02-13;PG;Papua New Guinea;0;0;914;9
2021-02-14;PG;Papua New Guinea;0;0;914;9
2021-02-15;PG;Papua New Guinea;0;0;914;9
2021-02-16;PG;Papua New Guinea;41;1;955;10
2021-02-17;PG;Papua New Guinea;0;0;955;10
2021-02-18;PG;Papua New Guinea;0;0;955;10
2021-02-19;PG;Papua New Guinea;0;0;955;10
2021-02-20;PG;Papua New Guinea;15;0;970;10
2021-02-21;PG;Papua New Guinea;0;0;970;10
2021-02-22;PG;Papua New Guinea;86;0;1056;10
2021-02-23;PG;Papua New Guinea;55;0;1111;10
2021-02-24;PG;Papua New Guinea;28;1;1139;11
2021-02-25;PG;Papua New Guinea;89;1;1228;12
2021-02-26;PG;Papua New Guinea;0;0;1228;12
2021-02-27;PG;Papua New Guinea;47;0;1275;12
2021-02-28;PG;Papua New Guinea;0;0;1275;12
2021-03-01;PG;Papua New Guinea;90;2;1365;14
2021-03-02;PG;Papua New Guinea;0;0;1365;14
2021-03-03;PG;Papua New Guinea;0;0;1365;14
2021-03-04;PG;Papua New Guinea;0;0;1365;14
2021-03-05;PG;Papua New Guinea;127;2;1492;16
2021-03-06;PG;Papua New Guinea;0;0;1492;16
2021-03-07;PG;Papua New Guinea;91;0;1583;16
2021-03-08;PG;Papua New Guinea;87;0;1670;16
2021-03-09;PG;Papua New Guinea;71;0;1741;16
2021-03-10;PG;Papua New Guinea;0;0;1741;16
2021-03-11;PG;Papua New Guinea;78;5;1819;21
2021-03-12;PG;Papua New Guinea;0;0;1819;21
2021-03-13;PG;Papua New Guinea;0;0;1819;21
2021-03-14;PG;Papua New Guinea;354;0;2173;21
2021-03-15;PG;Papua New Guinea;96;5;2269;26
2021-03-16;PG;Papua New Guinea;82;0;2351;26
2021-03-17;PG;Papua New Guinea;0;0;2351;26
2021-03-18;PG;Papua New Guinea;128;5;2479;31
2021-03-19;PG;Papua New Guinea;179;5;2658;36
2021-03-20;PG;Papua New Guinea;427;0;3085;36
2021-03-21;PG;Papua New Guinea;0;0;3085;36
2021-03-22;PG;Papua New Guinea;274;0;3359;36
2021-03-23;PG;Papua New Guinea;399;1;3758;37
2021-03-24;PG;Papua New Guinea;351;2;4109;39
2021-03-25;PG;Papua New Guinea;0;0;4109;39
2021-03-26;PG;Papua New Guinea;551;0;4660;39
2021-03-27;PG;Papua New Guinea;0;0;4660;39
2021-03-28;PG;Papua New Guinea;524;6;5184;45
2021-03-29;PG;Papua New Guinea;165;4;5349;49
2021-03-30;PG;Papua New Guinea;271;7;5620;56
2021-03-31;PG;Papua New Guinea;371;4;5991;60
2021-04-01;PG;Papua New Guinea;121;0;6112;60
2021-04-02;PG;Papua New Guinea;363;0;6475;60
2021-04-03;PG;Papua New Guinea;144;0;6619;60
2021-04-04;PG;Papua New Guinea;419;1;7038;61
2021-04-05;PG;Papua New Guinea;368;6;7406;67
2021-04-06;PG;Papua New Guinea;0;0;7406;67
2021-04-07;PG;Papua New Guinea;228;1;7634;68
2021-04-08;PG;Papua New Guinea;205;0;7839;68
2021-04-09;PG;Papua New Guinea;0;0;7839;68
2021-04-10;PG;Papua New Guinea;503;0;8342;68
2021-04-11;PG;Papua New Guinea;100;0;8442;68
2021-04-12;PG;Papua New Guinea;160;1;8602;69
2021-04-13;PG;Papua New Guinea;219;0;8821;69
2021-04-14;PG;Papua New Guinea;163;2;8984;71
2021-04-15;PG;Papua New Guinea;204;11;9188;82
2021-04-16;PG;Papua New Guinea;155;0;9343;82
2021-04-17;PG;Papua New Guinea;0;0;9343;82
2021-04-18;PG;Papua New Guinea;395;7;9738;89
2021-04-19;PG;Papua New Guinea;214;2;9952;91
2021-04-20;PG;Papua New Guinea;0;0;9952;91
2021-04-21;PG;Papua New Guinea;0;0;9952;91
2021-04-22;PG;Papua New Guinea;386;8;10338;99
2021-04-23;PG;Papua New Guinea;0;0;10338;99
2021-04-24;PG;Papua New Guinea;264;3;10602;102
2021-04-25;PG;Papua New Guinea;68;0;10670;102
2021-04-26;PG;Papua New Guinea;165;3;10835;105
2021-04-27;PG;Papua New Guinea;0;0;10835;105
2021-04-28;PG;Papua New Guinea;80;2;10915;107
2021-04-29;PG;Papua New Guinea;82;0;10997;107
2021-04-30;PG;Papua New Guinea;0;0;10997;107
2021-05-01;PG;Papua New Guinea;122;8;11119;115
2021-05-02;PG;Papua New Guinea;87;0;11206;115
2021-05-03;PG;Papua New Guinea;56;0;11262;115
2021-05-04;PG;Papua New Guinea;11;6;11273;121
2021-05-05;PG;Papua New Guinea;0;0;11273;121
2021-05-06;PG;Papua New Guinea;357;0;11630;121
2021-05-07;PG;Papua New Guinea;0;0;11630;121
2021-05-08;PG;Papua New Guinea;0;0;11630;121
2021-05-09;PG;Papua New Guinea;0;0;11630;121
2021-05-10;PG;Papua New Guinea;456;0;12086;121
2021-05-11;PG;Papua New Guinea;407;9;12493;130
2021-05-12;PG;Papua New Guinea;504;0;12997;130
2021-05-13;PG;Papua New Guinea;245;3;13242;133
2021-05-14;PG;Papua New Guinea;465;3;13707;136
2021-05-15;PG;Papua New Guinea;0;0;13707;136
2021-05-16;PG;Papua New Guinea;0;0;13707;136
2021-05-17;PG;Papua New Guinea;0;0;13707;136
2021-05-18;PG;Papua New Guinea;499;0;14206;136
2021-05-19;PG;Papua New Guinea;433;5;14639;141
2021-05-20;PG;Papua New Guinea;271;13;14910;154
2021-05-21;PG;Papua New Guinea;0;0;14910;154
2021-05-22;PG;Papua New Guinea;0;0;14910;154
2021-05-23;PG;Papua New Guinea;0;0;14910;154
2021-05-24;PG;Papua New Guinea;277;2;15187;156
2021-05-25;PG;Papua New Guinea;35;0;15222;156
2021-05-26;PG;Papua New Guinea;146;3;15368;159
2021-05-27;PG;Papua New Guinea;47;3;15415;162
2021-05-28;PG;Papua New Guinea;357;0;15772;162
2021-05-29;PG;Papua New Guinea;0;0;15772;162
2021-05-30;PG;Papua New Guinea;76;0;15848;162
2021-05-31;PG;Papua New Guinea;62;0;15910;162
2021-06-01;PG;Papua New Guinea;0;0;15910;162
2021-06-02;PG;Papua New Guinea;0;0;15910;162
2021-06-03;PG;Papua New Guinea;275;0;16185;162
2021-06-04;PG;Papua New Guinea;0;0;16185;162
2021-06-05;PG;Papua New Guinea;73;2;16258;164
2021-06-06;PG;Papua New Guinea;69;0;16327;164
2021-06-07;PG;Papua New Guinea;47;0;16374;164
2021-06-08;PG;Papua New Guinea;24;0;16398;164
2021-06-09;PG;Papua New Guinea;182;0;16580;164
2021-06-10;PG;Papua New Guinea;41;0;16621;164
2021-06-11;PG;Papua New Guinea;0;0;16621;164
2021-06-12;PG;Papua New Guinea;40;0;16661;164
2021-06-13;PG;Papua New Guinea;21;1;16682;165
2021-06-14;PG;Papua New Guinea;0;0;16682;165
2021-06-15;PG;Papua New Guinea;0;0;16682;165
2021-06-16;PG;Papua New Guinea;109;0;16791;165
2021-06-17;PG;Papua New Guinea;8;2;16799;167
2021-06-18;PG;Papua New Guinea;0;0;16799;167
2021-06-19;PG;Papua New Guinea;134;6;16933;173
2021-06-20;PG;Papua New Guinea;0;0;16933;173
2021-06-21;PG;Papua New Guinea;80;0;17013;173
2021-06-22;PG;Papua New Guinea;0;0;17013;173
2021-06-23;PG;Papua New Guinea;66;0;17079;173
2021-06-24;PG;Papua New Guinea;0;0;17079;173
2021-06-25;PG;Papua New Guinea;0;0;17079;173
2021-06-26;PG;Papua New Guinea;19;0;17098;173
2021-06-27;PG;Papua New Guinea;0;0;17098;173
2021-06-28;PG;Papua New Guinea;0;0;17098;173
2021-06-29;PG;Papua New Guinea;0;0;17098;173
2021-06-30;PG;Papua New Guinea;0;0;17098;173
2021-07-01;PG;Papua New Guinea;0;0;17098;173
2020-03-07;PY;Paraguay;0;0;0;0
2020-03-08;PY;Paraguay;1;0;1;0
2020-03-09;PY;Paraguay;0;0;1;0
2020-03-10;PY;Paraguay;0;0;1;0
2020-03-11;PY;Paraguay;4;0;5;0
2020-03-12;PY;Paraguay;0;0;5;0
2020-03-13;PY;Paraguay;1;0;6;0
2020-03-14;PY;Paraguay;0;0;6;0
2020-03-15;PY;Paraguay;0;0;6;0
2020-03-16;PY;Paraguay;2;0;8;0
2020-03-17;PY;Paraguay;1;0;9;0
2020-03-18;PY;Paraguay;2;0;11;0
2020-03-19;PY;Paraguay;0;0;11;0
2020-03-20;PY;Paraguay;2;0;13;0
2020-03-21;PY;Paraguay;5;1;18;1
2020-03-22;PY;Paraguay;4;0;22;1
2020-03-23;PY;Paraguay;0;0;22;1
2020-03-24;PY;Paraguay;5;1;27;2
2020-03-25;PY;Paraguay;10;1;37;3
2020-03-26;PY;Paraguay;4;0;41;3
2020-03-27;PY;Paraguay;11;0;52;3
2020-03-28;PY;Paraguay;4;0;56;3
2020-03-29;PY;Paraguay;3;0;59;3
2020-03-30;PY;Paraguay;5;0;64;3
2020-03-31;PY;Paraguay;1;0;65;3
2020-04-01;PY;Paraguay;4;0;69;3
2020-04-02;PY;Paraguay;8;0;77;3
2020-04-03;PY;Paraguay;15;0;92;3
2020-04-04;PY;Paraguay;4;0;96;3
2020-04-05;PY;Paraguay;8;0;104;3
2020-04-06;PY;Paraguay;9;2;113;5
2020-04-07;PY;Paraguay;2;0;115;5
2020-04-08;PY;Paraguay;4;0;119;5
2020-04-09;PY;Paraguay;5;0;124;5
2020-04-10;PY;Paraguay;5;1;129;6
2020-04-11;PY;Paraguay;4;0;133;6
2020-04-12;PY;Paraguay;1;0;134;6
2020-04-13;PY;Paraguay;13;0;147;6
2020-04-14;PY;Paraguay;12;1;159;7
2020-04-15;PY;Paraguay;2;1;161;8
2020-04-16;PY;Paraguay;13;0;174;8
2020-04-17;PY;Paraguay;25;0;199;8
2020-04-18;PY;Paraguay;3;0;202;8
2020-04-19;PY;Paraguay;4;0;206;8
2020-04-20;PY;Paraguay;2;0;208;8
2020-04-21;PY;Paraguay;0;0;208;8
2020-04-22;PY;Paraguay;5;1;213;9
2020-04-23;PY;Paraguay;0;0;213;9
2020-04-24;PY;Paraguay;10;0;223;9
2020-04-25;PY;Paraguay;5;0;228;9
2020-04-26;PY;Paraguay;0;0;228;9
2020-04-27;PY;Paraguay;0;0;228;9
2020-04-28;PY;Paraguay;11;0;239;9
2020-04-29;PY;Paraguay;0;0;239;9
2020-04-30;PY;Paraguay;27;1;266;10
2020-05-01;PY;Paraguay;67;0;333;10
2020-05-02;PY;Paraguay;37;0;370;10
2020-05-03;PY;Paraguay;26;0;396;10
2020-05-04;PY;Paraguay;19;0;415;10
2020-05-05;PY;Paraguay;16;0;431;10
2020-05-06;PY;Paraguay;9;0;440;10
2020-05-07;PY;Paraguay;22;0;462;10
2020-05-08;PY;Paraguay;101;0;563;10
2020-05-09;PY;Paraguay;126;0;689;10
2020-05-10;PY;Paraguay;24;0;713;10
2020-05-11;PY;Paraguay;11;0;724;10
2020-05-12;PY;Paraguay;13;0;737;10
2020-05-13;PY;Paraguay;3;1;740;11
2020-05-14;PY;Paraguay;14;0;754;11
2020-05-15;PY;Paraguay;5;0;759;11
2020-05-16;PY;Paraguay;19;0;778;11
2020-05-17;PY;Paraguay;8;0;786;11
2020-05-18;PY;Paraguay;2;0;788;11
2020-05-19;PY;Paraguay;41;0;829;11
2020-05-20;PY;Paraguay;4;0;833;11
2020-05-21;PY;Paraguay;3;0;836;11
2020-05-22;PY;Paraguay;2;0;838;11
2020-05-23;PY;Paraguay;12;0;850;11
2020-05-24;PY;Paraguay;12;0;862;11
2020-05-25;PY;Paraguay;3;0;865;11
2020-05-26;PY;Paraguay;12;0;877;11
2020-05-27;PY;Paraguay;7;0;884;11
2020-05-28;PY;Paraguay;16;0;900;11
2020-05-29;PY;Paraguay;17;0;917;11
2020-05-30;PY;Paraguay;47;0;964;11
2020-05-31;PY;Paraguay;22;0;986;11
2020-06-01;PY;Paraguay;9;0;995;11
2020-06-02;PY;Paraguay;18;0;1013;11
2020-06-03;PY;Paraguay;57;0;1070;11
2020-06-04;PY;Paraguay;16;0;1086;11
2020-06-05;PY;Paraguay;1;0;1087;11
2020-06-06;PY;Paraguay;3;0;1090;11
2020-06-07;PY;Paraguay;45;0;1135;11
2020-06-08;PY;Paraguay;10;0;1145;11
2020-06-09;PY;Paraguay;42;0;1187;11
2020-06-10;PY;Paraguay;15;0;1202;11
2020-06-11;PY;Paraguay;28;0;1230;11
2020-06-12;PY;Paraguay;24;0;1254;11
2020-06-13;PY;Paraguay;7;0;1261;11
2020-06-14;PY;Paraguay;28;0;1289;11
2020-06-15;PY;Paraguay;7;1;1296;12
2020-06-16;PY;Paraguay;7;1;1303;13
2020-06-17;PY;Paraguay;5;0;1308;13
2020-06-18;PY;Paraguay;22;0;1330;13
2020-06-19;PY;Paraguay;6;0;1336;13
2020-06-20;PY;Paraguay;26;0;1362;13
2020-06-21;PY;Paraguay;17;0;1379;13
2020-06-22;PY;Paraguay;13;0;1392;13
2020-06-23;PY;Paraguay;30;0;1422;13
2020-06-24;PY;Paraguay;106;0;1528;13
2020-06-25;PY;Paraguay;41;0;1569;13
2020-06-26;PY;Paraguay;142;0;1711;13
2020-06-27;PY;Paraguay;231;2;1942;15
2020-06-28;PY;Paraguay;185;0;2127;15
2020-06-29;PY;Paraguay;64;1;2191;16
2020-06-30;PY;Paraguay;30;1;2221;17
2020-07-01;PY;Paraguay;39;2;2260;19
2020-07-02;PY;Paraguay;43;0;2303;19
2020-07-03;PY;Paraguay;46;0;2349;19
2020-07-04;PY;Paraguay;36;1;2385;20
2020-07-05;PY;Paraguay;42;0;2427;20
2020-07-06;PY;Paraguay;29;0;2456;20
2020-07-07;PY;Paraguay;46;0;2502;20
2020-07-08;PY;Paraguay;52;0;2554;20
2020-07-09;PY;Paraguay;84;0;2638;20
2020-07-10;PY;Paraguay;98;0;2736;20
2020-07-11;PY;Paraguay;84;1;2820;21
2020-07-12;PY;Paraguay;128;1;2948;22
2020-07-13;PY;Paraguay;32;3;2980;25
2020-07-14;PY;Paraguay;94;0;3074;25
2020-07-15;PY;Paraguay;124;0;3198;25
2020-07-16;PY;Paraguay;144;2;3342;27
2020-07-17;PY;Paraguay;115;1;3457;28
2020-07-18;PY;Paraguay;172;1;3629;29
2020-07-19;PY;Paraguay;92;2;3721;31
2020-07-20;PY;Paraguay;27;2;3748;33
2020-07-21;PY;Paraguay;69;2;3817;35
2020-07-22;PY;Paraguay;183;1;4000;36
2020-07-23;PY;Paraguay;113;0;4113;36
2020-07-24;PY;Paraguay;111;2;4224;38
2020-07-25;PY;Paraguay;104;2;4328;40
2020-07-26;PY;Paraguay;116;1;4444;41
2020-07-27;PY;Paraguay;104;2;4548;43
2020-07-28;PY;Paraguay;126;2;4674;45
2020-07-29;PY;Paraguay;192;1;4866;46
2020-07-30;PY;Paraguay;341;1;5207;47
2020-07-31;PY;Paraguay;131;2;5338;49
2020-08-01;PY;Paraguay;147;3;5485;52
2020-08-02;PY;Paraguay;159;0;5644;52
2020-08-03;PY;Paraguay;80;3;5724;55
2020-08-04;PY;Paraguay;128;4;5852;59
2020-08-05;PY;Paraguay;208;2;6060;61
2020-08-06;PY;Paraguay;315;5;6375;66
2020-08-07;PY;Paraguay;133;3;6508;69
2020-08-08;PY;Paraguay;197;3;6705;72
2020-08-09;PY;Paraguay;202;3;6907;75
2020-08-10;PY;Paraguay;327;7;7234;82
2020-08-11;PY;Paraguay;285;4;7519;86
2020-08-12;PY;Paraguay;499;7;8018;93
2020-08-13;PY;Paraguay;371;4;8389;97
2020-08-14;PY;Paraguay;633;11;9022;108
2020-08-15;PY;Paraguay;359;19;9381;127
2020-08-16;PY;Paraguay;410;11;9791;138
2020-08-17;PY;Paraguay;344;7;10135;145
2020-08-18;PY;Paraguay;471;16;10606;161
2020-08-19;PY;Paraguay;527;4;11133;165
2020-08-20;PY;Paraguay;684;5;11817;170
2020-08-21;PY;Paraguay;719;12;12536;182
2020-08-22;PY;Paraguay;438;10;12974;192
2020-08-23;PY;Paraguay;259;13;13233;205
2020-08-24;PY;Paraguay;369;14;13602;219
2020-08-25;PY;Paraguay;626;12;14228;231
2020-08-26;PY;Paraguay;644;16;14872;247
2020-08-27;PY;Paraguay;418;18;15290;265
2020-08-28;PY;Paraguay;583;15;15873;280
2020-08-29;PY;Paraguay;601;14;16474;294
2020-08-30;PY;Paraguay;631;14;17105;308
2020-08-31;PY;Paraguay;557;18;17662;326
2020-09-01;PY;Paraguay;676;22;18338;348
2020-09-02;PY;Paraguay;800;10;19138;358
2020-09-03;PY;Paraguay;821;15;19959;373
2020-09-04;PY;Paraguay;695;25;20654;398
2020-09-05;PY;Paraguay;1217;14;21871;412
2020-09-06;PY;Paraguay;615;23;22486;435
2020-09-07;PY;Paraguay;867;14;23353;449
2020-09-08;PY;Paraguay;861;14;24214;463
2020-09-09;PY;Paraguay;812;11;25026;474
2020-09-10;PY;Paraguay;605;11;25631;485
2020-09-11;PY;Paraguay;881;11;26512;496
2020-09-12;PY;Paraguay;812;18;27324;514
2020-09-13;PY;Paraguay;493;11;27817;525
2020-09-14;PY;Paraguay;550;14;28367;539
2020-09-15;PY;Paraguay;931;13;29298;552
2020-09-16;PY;Paraguay;1121;14;30419;566
2020-09-17;PY;Paraguay;694;18;31113;584
2020-09-18;PY;Paraguay;1014;27;32127;611
2020-09-19;PY;Paraguay;888;25;33015;636
2020-09-20;PY;Paraguay;505;23;33520;659
2020-09-21;PY;Paraguay;740;17;34260;676
2020-09-22;PY;Paraguay;568;29;34828;705
2020-09-23;PY;Paraguay;743;22;35571;727
2020-09-24;PY;Paraguay;833;16;36404;743
2020-09-25;PY;Paraguay;822;18;37226;761
2020-09-26;PY;Paraguay;696;21;37922;782
2020-09-27;PY;Paraguay;762;21;38684;803
2020-09-28;PY;Paraguay;748;15;39432;818
2020-09-29;PY;Paraguay;669;23;40101;841
2020-09-30;PY;Paraguay;657;16;40758;857
2020-10-01;PY;Paraguay;1041;12;41799;869
2020-10-02;PY;Paraguay;885;21;42684;890
2020-10-03;PY;Paraguay;768;23;43452;913
2020-10-04;PY;Paraguay;730;16;44182;929
2020-10-05;PY;Paraguay;533;18;44715;947
2020-10-06;PY;Paraguay;932;19;45647;966
2020-10-07;PY;Paraguay;788;23;46435;989
2020-10-08;PY;Paraguay;881;23;47316;1012
2020-10-09;PY;Paraguay;959;33;48275;1045
2020-10-10;PY;Paraguay;703;20;48978;1065
2020-10-11;PY;Paraguay;697;12;49675;1077
2020-10-12;PY;Paraguay;669;19;50344;1096
2020-10-13;PY;Paraguay;853;12;51197;1108
2020-10-14;PY;Paraguay;648;23;51845;1131
2020-10-15;PY;Paraguay;751;19;52596;1150
2020-10-16;PY;Paraguay;886;15;53482;1165
2020-10-17;PY;Paraguay;533;14;54015;1179
2020-10-18;PY;Paraguay;709;9;54724;1188
2020-10-19;PY;Paraguay;728;19;55452;1207
2020-10-20;PY;Paraguay;621;24;56073;1231
2020-10-21;PY;Paraguay;746;19;56819;1250
2020-10-22;PY;Paraguay;707;12;57526;1262
2020-10-23;PY;Paraguay;733;16;58259;1278
2020-10-24;PY;Paraguay;784;15;59043;1293
2020-10-25;PY;Paraguay;551;16;59594;1309
2020-10-26;PY;Paraguay;515;24;60109;1333
2020-10-27;PY;Paraguay;448;14;60557;1347
2020-10-28;PY;Paraguay;733;12;61290;1359
2020-10-29;PY;Paraguay;760;14;62050;1373
2020-10-30;PY;Paraguay;546;14;62596;1387
2020-10-31;PY;Paraguay;589;17;63185;1404
2020-11-01;PY;Paraguay;546;14;63731;1418
2020-11-02;PY;Paraguay;425;11;64156;1429
2020-11-03;PY;Paraguay;472;12;64628;1441
2020-11-04;PY;Paraguay;630;13;65258;1454
2020-11-05;PY;Paraguay;520;8;65778;1462
2020-11-06;PY;Paraguay;703;10;66481;1472
2020-11-07;PY;Paraguay;460;7;66941;1479
2020-11-08;PY;Paraguay;648;11;67589;1490
2020-11-09;PY;Paraguay;359;12;67948;1502
2020-11-10;PY;Paraguay;549;14;68497;1516
2020-11-11;PY;Paraguay;609;16;69106;1532
2020-11-12;PY;Paraguay;547;11;69653;1543
2020-11-13;PY;Paraguay;739;13;70392;1556
2020-11-14;PY;Paraguay;673;13;71065;1569
2020-11-15;PY;Paraguay;509;18;71574;1587
2020-11-16;PY;Paraguay;525;15;72099;1602
2020-11-17;PY;Paraguay;758;11;72857;1613
2020-11-18;PY;Paraguay;782;11;73639;1624
2020-11-19;PY;Paraguay;856;12;74495;1636
2020-11-20;PY;Paraguay;563;11;75058;1647
2020-11-21;PY;Paraguay;799;5;75857;1652
2020-11-22;PY;Paraguay;619;5;76476;1657
2020-11-23;PY;Paraguay;596;8;77072;1665
2020-11-24;PY;Paraguay;819;12;77891;1677
2020-11-25;PY;Paraguay;987;14;78878;1691
2020-11-26;PY;Paraguay;639;13;79517;1704
2020-11-27;PY;Paraguay;919;16;80436;1720
2020-11-28;PY;Paraguay;695;11;81131;1731
2020-11-29;PY;Paraguay;775;12;81906;1743
2020-11-30;PY;Paraguay;518;13;82424;1756
2020-12-01;PY;Paraguay;1055;15;83479;1771
2020-12-02;PY;Paraguay;1003;12;84482;1783
2020-12-03;PY;Paraguay;995;13;85477;1796
2020-12-04;PY;Paraguay;1022;17;86499;1813
2020-12-05;PY;Paraguay;714;20;87213;1833
2020-12-06;PY;Paraguay;707;20;87920;1853
2020-12-07;PY;Paraguay;803;19;88723;1872
2020-12-08;PY;Paraguay;698;15;89421;1887
2020-12-09;PY;Paraguay;725;14;90146;1901
2020-12-10;PY;Paraguay;812;13;90958;1914
2020-12-11;PY;Paraguay;1155;13;92113;1927
2020-12-12;PY;Paraguay;800;10;92913;1937
2020-12-13;PY;Paraguay;669;16;93582;1953
2020-12-14;PY;Paraguay;641;18;94223;1971
2020-12-15;PY;Paraguay;1130;20;95353;1991
2020-12-16;PY;Paraguay;856;23;96209;2014
2020-12-17;PY;Paraguay;819;18;97028;2032
2020-12-18;PY;Paraguay;1268;18;98296;2050
2020-12-19;PY;Paraguay;861;22;99157;2072
2020-12-20;PY;Paraguay;632;16;99789;2088
2020-12-21;PY;Paraguay;823;15;100612;2103
2020-12-22;PY;Paraguay;932;17;101544;2120
2020-12-23;PY;Paraguay;827;18;102371;2138
2020-12-24;PY;Paraguay;958;16;103329;2154
2020-12-25;PY;Paraguay;559;0;103888;2154
2020-12-26;PY;Paraguay;274;20;104162;2174
2020-12-27;PY;Paraguay;260;14;104422;2188
2020-12-28;PY;Paraguay;952;14;105374;2202
2020-12-29;PY;Paraguay;762;18;106136;2220
2020-12-30;PY;Paraguay;822;22;106958;2242
2020-12-31;PY;Paraguay;974;20;107932;2262
2021-01-01;PY;Paraguay;417;0;108349;2262
2021-01-02;PY;Paraguay;369;17;108718;2279
2021-01-03;PY;Paraguay;355;13;109073;2292
2021-01-04;PY;Paraguay;764;13;109837;2305
2021-01-05;PY;Paraguay;959;16;110796;2321
2021-01-06;PY;Paraguay;898;16;111694;2337
2021-01-07;PY;Paraguay;1162;15;112856;2352
2021-01-08;PY;Paraguay;1138;20;113994;2372
2021-01-09;PY;Paraguay;1032;15;115026;2387
2021-01-10;PY;Paraguay;707;18;115733;2405
2021-01-11;PY;Paraguay;802;15;116535;2420
2021-01-12;PY;Paraguay;1055;17;117590;2437
2021-01-13;PY;Paraguay;1002;14;118592;2451
2021-01-14;PY;Paraguay;1048;15;119640;2466
2021-01-15;PY;Paraguay;1149;13;120789;2479
2021-01-16;PY;Paraguay;859;16;121648;2495
2021-01-17;PY;Paraguay;512;10;122160;2505
2021-01-18;PY;Paraguay;428;13;122588;2518
2021-01-19;PY;Paraguay;771;17;123359;2535
2021-01-20;PY;Paraguay;1088;21;124447;2556
2021-01-21;PY;Paraguay;1071;14;125518;2570
2021-01-22;PY;Paraguay;852;15;126370;2585
2021-01-23;PY;Paraguay;711;22;127081;2607
2021-01-24;PY;Paraguay;571;10;127652;2617
2021-01-25;PY;Paraguay;714;15;128366;2632
2021-01-26;PY;Paraguay;1028;19;129394;2651
2021-01-27;PY;Paraguay;769;17;130163;2668
2021-01-28;PY;Paraguay;754;13;130917;2681
2021-01-29;PY;Paraguay;969;12;131886;2693
2021-01-30;PY;Paraguay;662;11;132548;2704
2021-01-31;PY;Paraguay;679;14;133227;2718
2021-02-01;PY;Paraguay;554;15;133781;2733
2021-02-02;PY;Paraguay;701;17;134482;2750
2021-02-03;PY;Paraguay;747;15;135229;2765
2021-02-04;PY;Paraguay;794;14;136023;2779
2021-02-05;PY;Paraguay;867;12;136890;2791
2021-02-06;PY;Paraguay;713;16;137603;2807
2021-02-07;PY;Paraguay;515;19;138118;2826
2021-02-08;PY;Paraguay;827;20;138945;2846
2021-02-09;PY;Paraguay;874;16;139819;2862
2021-02-10;PY;Paraguay;978;14;140797;2876
2021-02-11;PY;Paraguay;978;15;141775;2891
2021-02-12;PY;Paraguay;823;13;142598;2904
2021-02-13;PY;Paraguay;845;16;143443;2920
2021-02-14;PY;Paraguay;599;16;144042;2936
2021-02-15;PY;Paraguay;1053;17;145095;2953
2021-02-16;PY;Paraguay;1121;18;146216;2971
2021-02-17;PY;Paraguay;1037;20;147253;2991
2021-02-18;PY;Paraguay;1369;17;148622;3008
2021-02-19;PY;Paraguay;1062;18;149684;3026
2021-02-20;PY;Paraguay;1047;19;150731;3045
2021-02-21;PY;Paraguay;987;20;151718;3065
2021-02-22;PY;Paraguay;940;15;152658;3080
2021-02-23;PY;Paraguay;1132;21;153790;3101
2021-02-24;PY;Paraguay;1114;18;154904;3119
2021-02-25;PY;Paraguay;1285;16;156189;3135
2021-02-26;PY;Paraguay;1414;17;157603;3152
2021-02-27;PY;Paraguay;934;15;158537;3167
2021-02-28;PY;Paraguay;937;14;159474;3181
2021-03-01;PY;Paraguay;974;17;160448;3198
2021-03-02;PY;Paraguay;1082;20;161530;3218
2021-03-03;PY;Paraguay;1341;21;162871;3239
2021-03-04;PY;Paraguay;1439;17;164310;3256
2021-03-05;PY;Paraguay;1501;22;165811;3278
2021-03-06;PY;Paraguay;1158;16;166969;3294
2021-03-07;PY;Paraguay;1074;24;168043;3318
2021-03-08;PY;Paraguay;1817;25;169860;3343
2021-03-09;PY;Paraguay;2125;17;171985;3360
2021-03-10;PY;Paraguay;2028;27;174013;3387
2021-03-11;PY;Paraguay;1814;24;175827;3411
2021-03-12;PY;Paraguay;1766;25;177593;3436
2021-03-13;PY;Paraguay;1479;20;179072;3456
2021-03-14;PY;Paraguay;942;20;180014;3476
2021-03-15;PY;Paraguay;1400;41;181414;3517
2021-03-16;PY;Paraguay;1934;37;183348;3554
2021-03-17;PY;Paraguay;2540;34;185888;3588
2021-03-18;PY;Paraguay;2605;32;188493;3620
2021-03-19;PY;Paraguay;2006;42;190499;3662
2021-03-20;PY;Paraguay;2100;33;192599;3695
2021-03-21;PY;Paraguay;1523;35;194122;3730
2021-03-22;PY;Paraguay;1990;39;196112;3769
2021-03-23;PY;Paraguay;2023;49;198135;3818
2021-03-24;PY;Paraguay;2688;51;200823;3869
2021-03-25;PY;Paraguay;1877;41;202700;3910
2021-03-26;PY;Paraguay;2004;48;204704;3958
2021-03-27;PY;Paraguay;1893;45;206597;4003
2021-03-28;PY;Paraguay;2058;60;208655;4063
2021-03-29;PY;Paraguay;1770;50;210425;4113
2021-03-30;PY;Paraguay;2266;48;212691;4161
2021-03-31;PY;Paraguay;1976;45;214667;4206
2021-04-01;PY;Paraguay;1611;44;216278;4250
2021-04-02;PY;Paraguay;1608;44;217886;4294
2021-04-03;PY;Paraguay;1507;50;219393;4344
2021-04-04;PY;Paraguay;1814;55;221207;4399
2021-04-05;PY;Paraguay;1456;64;222663;4463
2021-04-06;PY;Paraguay;2073;59;224736;4522
2021-04-07;PY;Paraguay;2380;62;227116;4584
2021-04-08;PY;Paraguay;2479;60;229595;4644
2021-04-09;PY;Paraguay;2547;54;232142;4698
2021-04-10;PY;Paraguay;1603;51;233745;4749
2021-04-11;PY;Paraguay;1547;78;235292;4827
2021-04-12;PY;Paraguay;2250;62;237542;4889
2021-04-13;PY;Paraguay;2599;89;240141;4978
2021-04-14;PY;Paraguay;2020;62;242161;5040
2021-04-15;PY;Paraguay;2367;70;244528;5110
2021-04-16;PY;Paraguay;0;0;244528;5110
2021-04-17;PY;Paraguay;3836;141;248364;5251
2021-04-18;PY;Paraguay;1801;62;250165;5313
2021-04-19;PY;Paraguay;2278;71;252443;5384
2021-04-20;PY;Paraguay;2603;86;255046;5470
2021-04-21;PY;Paraguay;2660;91;257706;5561
2021-04-22;PY;Paraguay;2676;72;260382;5633
2021-04-23;PY;Paraguay;2752;82;263134;5715
2021-04-24;PY;Paraguay;2162;87;265296;5802
2021-04-25;PY;Paraguay;1786;98;267082;5900
2021-04-26;PY;Paraguay;2271;102;269353;6002
2021-04-27;PY;Paraguay;2461;92;271814;6094
2021-04-28;PY;Paraguay;2356;102;274170;6196
2021-04-29;PY;Paraguay;2695;106;276865;6302
2021-04-30;PY;Paraguay;2212;83;279077;6385
2021-05-01;PY;Paraguay;1946;91;281023;6476
2021-05-02;PY;Paraguay;1520;96;282543;6572
2021-05-03;PY;Paraguay;1910;81;284453;6653
2021-05-04;PY;Paraguay;2214;69;286667;6722
2021-05-05;PY;Paraguay;2307;76;288974;6798
2021-05-06;PY;Paraguay;2566;85;291540;6883
2021-05-07;PY;Paraguay;2693;91;294233;6974
2021-05-08;PY;Paraguay;2073;76;296306;7050
2021-05-09;PY;Paraguay;1483;80;297789;7130
2021-05-10;PY;Paraguay;1895;79;299684;7209
2021-05-11;PY;Paraguay;2377;75;302061;7284
2021-05-12;PY;Paraguay;2828;74;304889;7358
2021-05-13;PY;Paraguay;2568;69;307457;7427
2021-05-14;PY;Paraguay;2181;55;309638;7482
2021-05-15;PY;Paraguay;2108;52;311746;7534
2021-05-16;PY;Paraguay;1781;62;313527;7596
2021-05-17;PY;Paraguay;2020;96;315547;7692
2021-05-18;PY;Paraguay;2704;110;318251;7802
2021-05-19;PY;Paraguay;2781;112;321032;7914
2021-05-20;PY;Paraguay;3031;98;324063;8012
2021-05-21;PY;Paraguay;3166;103;327229;8115
2021-05-22;PY;Paraguay;3228;120;330457;8235
2021-05-23;PY;Paraguay;2514;125;332971;8360
2021-05-24;PY;Paraguay;2720;114;335691;8474
2021-05-25;PY;Paraguay;3223;117;338914;8591
2021-05-26;PY;Paraguay;3307;110;342221;8701
2021-05-27;PY;Paraguay;3136;99;345357;8800
2021-05-28;PY;Paraguay;2827;92;348184;8892
2021-05-29;PY;Paraguay;2429;95;350613;8987
2021-05-30;PY;Paraguay;2075;96;352688;9083
2021-05-31;PY;Paraguay;2696;103;355384;9186
2021-06-01;PY;Paraguay;2860;107;358244;9293
2021-06-02;PY;Paraguay;3196;103;361440;9396
2021-06-03;PY;Paraguay;3262;102;364702;9498
2021-06-04;PY;Paraguay;3481;111;368183;9609
2021-06-05;PY;Paraguay;2838;130;371021;9739
2021-06-06;PY;Paraguay;2144;135;373165;9874
2021-06-07;PY;Paraguay;2831;131;375996;10005
2021-06-08;PY;Paraguay;3135;140;379131;10145
2021-06-09;PY;Paraguay;3100;133;382231;10278
2021-06-10;PY;Paraguay;2758;134;384989;10412
2021-06-11;PY;Paraguay;2698;149;387687;10561
2021-06-12;PY;Paraguay;1963;138;389650;10699
2021-06-13;PY;Paraguay;1786;135;391436;10834
2021-06-14;PY;Paraguay;2046;120;393482;10954
2021-06-15;PY;Paraguay;2667;115;396149;11069
2021-06-16;PY;Paraguay;2612;112;398761;11181
2021-06-17;PY;Paraguay;2482;113;401243;11294
2021-06-18;PY;Paraguay;2149;117;403392;11411
2021-06-19;PY;Paraguay;1683;110;405075;11521
2021-06-20;PY;Paraguay;1145;112;406220;11633
2021-06-21;PY;Paraguay;1501;110;407721;11743
2021-06-22;PY;Paraguay;1746;106;409467;11849
2021-06-23;PY;Paraguay;2148;124;411615;11973
2021-06-24;PY;Paraguay;1842;113;413457;12086
2021-06-25;PY;Paraguay;1863;125;415320;12211
2021-06-26;PY;Paraguay;1523;154;416843;12365
2021-06-27;PY;Paraguay;1487;152;418330;12517
2021-06-28;PY;Paraguay;1434;124;419764;12641
2021-06-29;PY;Paraguay;1825;122;421589;12763
2021-06-30;PY;Paraguay;1693;132;423282;12895
2021-07-01;PY;Paraguay;1716;122;424998;13017
2020-01-06;PE;Peru;0;0;0;0
2020-01-07;PE;Peru;0;0;0;0
2020-01-08;PE;Peru;0;0;0;0
2020-01-09;PE;Peru;0;0;0;0
2020-01-10;PE;Peru;0;0;0;0
2020-01-11;PE;Peru;0;0;0;0
2020-01-12;PE;Peru;0;0;0;0
2020-01-13;PE;Peru;0;0;0;0
2020-01-14;PE;Peru;0;0;0;0
2020-01-15;PE;Peru;0;0;0;0
2020-01-16;PE;Peru;0;0;0;0
2020-01-17;PE;Peru;0;0;0;0
2020-01-18;PE;Peru;0;0;0;0
2020-01-19;PE;Peru;0;0;0;0
2020-01-20;PE;Peru;0;0;0;0
2020-01-21;PE;Peru;0;0;0;0
2020-01-22;PE;Peru;0;0;0;0
2020-01-23;PE;Peru;0;0;0;0
2020-01-24;PE;Peru;0;0;0;0
2020-01-25;PE;Peru;0;0;0;0
2020-01-26;PE;Peru;0;0;0;0
2020-01-27;PE;Peru;0;0;0;0
2020-01-28;PE;Peru;0;0;0;0
2020-01-29;PE;Peru;0;0;0;0
2020-01-30;PE;Peru;0;0;0;0
2020-01-31;PE;Peru;0;0;0;0
2020-02-01;PE;Peru;0;0;0;0
2020-02-02;PE;Peru;0;0;0;0
2020-02-03;PE;Peru;0;0;0;0
2020-02-04;PE;Peru;0;0;0;0
2020-02-05;PE;Peru;0;0;0;0
2020-02-06;PE;Peru;0;0;0;0
2020-02-07;PE;Peru;0;0;0;0
2020-02-08;PE;Peru;0;0;0;0
2020-02-09;PE;Peru;0;0;0;0
2020-02-10;PE;Peru;0;0;0;0
2020-02-11;PE;Peru;0;0;0;0
2020-02-12;PE;Peru;0;0;0;0
2020-02-13;PE;Peru;0;0;0;0
2020-02-14;PE;Peru;0;0;0;0
2020-02-15;PE;Peru;0;0;0;0
2020-02-16;PE;Peru;0;0;0;0
2020-02-17;PE;Peru;0;0;0;0
2020-02-18;PE;Peru;0;0;0;0
2020-02-19;PE;Peru;0;0;0;0
2020-02-20;PE;Peru;0;0;0;0
2020-02-21;PE;Peru;0;0;0;0
2020-02-22;PE;Peru;0;0;0;0
2020-02-23;PE;Peru;0;0;0;0
2020-02-24;PE;Peru;0;0;0;0
2020-02-25;PE;Peru;0;0;0;0
2020-02-26;PE;Peru;0;0;0;0
2020-02-27;PE;Peru;0;0;0;0
2020-02-28;PE;Peru;0;0;0;0
2020-02-29;PE;Peru;0;0;0;0
2020-03-01;PE;Peru;0;0;0;0
2020-03-02;PE;Peru;0;0;0;0
2020-03-03;PE;Peru;0;0;0;0
2020-03-04;PE;Peru;0;0;0;0
2020-03-05;PE;Peru;0;0;0;0
2020-03-06;PE;Peru;1;1;1;1
2020-03-07;PE;Peru;0;0;1;1
2020-03-08;PE;Peru;5;1;6;2
2020-03-09;PE;Peru;1;0;7;2
2020-03-10;PE;Peru;4;0;11;2
2020-03-11;PE;Peru;0;0;11;2
2020-03-12;PE;Peru;4;1;15;3
2020-03-13;PE;Peru;13;0;28;3
2020-03-14;PE;Peru;10;0;38;3
2020-03-15;PE;Peru;5;2;43;5
2020-03-16;PE;Peru;43;0;86;5
2020-03-17;PE;Peru;31;4;117;9
2020-03-18;PE;Peru;28;6;145;15
2020-03-19;PE;Peru;89;5;234;20
2020-03-20;PE;Peru;0;6;234;26
2020-03-21;PE;Peru;84;4;318;30
2020-03-22;PE;Peru;45;4;363;34
2020-03-23;PE;Peru;32;5;395;39
2020-03-24;PE;Peru;21;6;416;45
2020-03-25;PE;Peru;64;12;480;57
2020-03-26;PE;Peru;100;6;580;63
2020-03-27;PE;Peru;55;8;635;71
2020-03-28;PE;Peru;36;15;671;86
2020-03-29;PE;Peru;181;9;852;95
2020-03-30;PE;Peru;98;18;950;113
2020-03-31;PE;Peru;115;25;1065;138
2020-04-01;PE;Peru;258;23;1323;161
2020-04-02;PE;Peru;91;22;1414;183
2020-04-03;PE;Peru;181;26;1595;209
2020-04-04;PE;Peru;151;49;1746;258
2020-04-05;PE;Peru;535;59;2281;317
2020-04-06;PE;Peru;280;43;2561;360
2020-04-07;PE;Peru;393;63;2954;423
2020-04-08;PE;Peru;1388;48;4342;471
2020-04-09;PE;Peru;914;98;5256;569
2020-04-10;PE;Peru;641;81;5897;650
2020-04-11;PE;Peru;951;103;6848;753
2020-04-12;PE;Peru;671;93;7519;846
2020-04-13;PE;Peru;2265;106;9784;952
2020-04-14;PE;Peru;519;109;10303;1061
2020-04-15;PE;Peru;1172;139;11475;1200
2020-04-16;PE;Peru;1016;133;12491;1333
2020-04-17;PE;Peru;998;157;13489;1490
2020-04-18;PE;Peru;931;138;14420;1628
2020-04-19;PE;Peru;1208;158;15628;1786
2020-04-20;PE;Peru;697;204;16325;1990
2020-04-21;PE;Peru;1512;209;17837;2199
2020-04-22;PE;Peru;1413;219;19250;2418
2020-04-23;PE;Peru;1664;246;20914;2664
2020-04-24;PE;Peru;734;246;21648;2910
2020-04-25;PE;Peru;3683;288;25331;3198
2020-04-26;PE;Peru;2186;290;27517;3488
2020-04-27;PE;Peru;1182;305;28699;3793
2020-04-28;PE;Peru;2491;313;31190;4106
2020-04-29;PE;Peru;2741;344;33931;4450
2020-04-30;PE;Peru;3045;332;36976;4782
2020-05-01;PE;Peru;3483;399;40459;5181
2020-05-02;PE;Peru;2075;408;42534;5589
2020-05-03;PE;Peru;3394;415;45928;6004
2020-05-04;PE;Peru;1444;438;47372;6442
2020-05-05;PE;Peru;3817;429;51189;6871
2020-05-06;PE;Peru;3628;457;54817;7328
2020-05-07;PE;Peru;3709;481;58526;7809
2020-05-08;PE;Peru;3321;454;61847;8263
2020-05-09;PE;Peru;3168;477;65015;8740
2020-05-10;PE;Peru;2292;518;67307;9258
2020-05-11;PE;Peru;1515;520;68822;9778
2020-05-12;PE;Peru;3237;516;72059;10294
2020-05-13;PE;Peru;4247;466;76306;10760
2020-05-14;PE;Peru;4298;517;80604;11277
2020-05-15;PE;Peru;3891;547;84495;11824
2020-05-16;PE;Peru;4046;509;88541;12333
2020-05-17;PE;Peru;3732;502;92273;12835
2020-05-18;PE;Peru;2660;534;94933;13369
2020-05-19;PE;Peru;4550;615;99483;13984
2020-05-20;PE;Peru;4537;528;104020;14512
2020-05-21;PE;Peru;4749;544;108769;15056
2020-05-22;PE;Peru;2929;527;111698;15583
2020-05-23;PE;Peru;4056;518;115754;16101
2020-05-24;PE;Peru;4205;543;119959;16644
2020-05-25;PE;Peru;4020;572;123979;17216
2020-05-26;PE;Peru;5772;580;129751;17796
2020-05-27;PE;Peru;6154;544;135905;18340
2020-05-28;PE;Peru;5874;584;141779;18924
2020-05-29;PE;Peru;6506;685;148285;19609
2020-05-30;PE;Peru;7386;502;155671;20111
2020-05-31;PE;Peru;8805;599;164476;20710
2020-06-01;PE;Peru;5563;568;170039;21278
2020-06-02;PE;Peru;8126;660;178165;21938
2020-06-03;PE;Peru;749;538;178914;22476
2020-06-04;PE;Peru;4284;549;183198;23025
2020-06-05;PE;Peru;4202;615;187400;23640
2020-06-06;PE;Peru;4358;585;191758;24225
2020-06-07;PE;Peru;4757;609;196515;24834
2020-06-08;PE;Peru;3181;568;199696;25402
2020-06-09;PE;Peru;4040;613;203736;26015
2020-06-10;PE;Peru;5087;595;208823;26610
2020-06-11;PE;Peru;5965;615;214788;27225
2020-06-12;PE;Peru;0;600;214788;27825
2020-06-13;PE;Peru;5961;561;220749;28386
2020-06-14;PE;Peru;8987;624;229736;29010
2020-06-15;PE;Peru;3256;593;232992;29603
2020-06-16;PE;Peru;4164;627;237156;30230
2020-06-17;PE;Peru;3752;610;240908;30840
2020-06-18;PE;Peru;3480;603;244388;31443
2020-06-19;PE;Peru;3537;519;247925;31962
2020-06-20;PE;Peru;3413;612;251338;32574
2020-06-21;PE;Peru;3598;766;254936;33340
2020-06-22;PE;Peru;2511;354;257447;33694
2020-06-23;PE;Peru;3363;537;260810;34231
2020-06-24;PE;Peru;3879;548;264689;34779
2020-06-25;PE;Peru;3913;520;268602;35299
2020-06-26;PE;Peru;3762;515;272364;35814
2020-06-27;PE;Peru;3625;523;275989;36337
2020-06-28;PE;Peru;3430;533;279419;36870
2020-06-29;PE;Peru;2946;535;282365;37405
2020-06-30;PE;Peru;2848;493;285213;37898
2020-07-01;PE;Peru;3264;551;288477;38449
2020-07-02;PE;Peru;3527;536;292004;38985
2020-07-03;PE;Peru;3595;548;295599;39533
2020-07-04;PE;Peru;3481;575;299080;40108
2020-07-05;PE;Peru;3638;517;302718;40625
2020-07-06;PE;Peru;2985;575;305703;41200
2020-07-07;PE;Peru;3575;556;309278;41756
2020-07-08;PE;Peru;3633;538;312911;42294
2020-07-09;PE;Peru;3537;564;316448;42858
2020-07-10;PE;Peru;3198;519;319646;43377
2020-07-11;PE;Peru;3064;575;322710;43952
2020-07-12;PE;Peru;3616;576;326326;44528
2020-07-13;PE;Peru;3797;586;330123;45114
2020-07-14;PE;Peru;3744;595;333867;45709
2020-07-15;PE;Peru;3884;591;337751;46300
2020-07-16;PE;Peru;3835;613;341586;46913
2020-07-17;PE;Peru;3951;559;345537;47472
2020-07-18;PE;Peru;3963;1173;349500;48645
2020-07-19;PE;Peru;4090;784;353590;49429
2020-07-20;PE;Peru;4091;15;357681;49444
2020-07-21;PE;Peru;4406;431;362087;49875
2020-07-22;PE;Peru;4463;598;366550;50473
2020-07-23;PE;Peru;4546;624;371096;51097
2020-07-24;PE;Peru;4865;619;375961;51716
2020-07-25;PE;Peru;0;579;375961;52295
2020-07-26;PE;Peru;0;614;375961;52909
2020-07-27;PE;Peru;13756;623;389717;53532
2020-07-28;PE;Peru;5288;650;395005;54182
2020-07-29;PE;Peru;5678;612;400683;54794
2020-07-30;PE;Peru;0;588;400683;55382
2020-07-31;PE;Peru;6809;600;407492;55982
2020-08-01;PE;Peru;0;632;407492;56614
2020-08-02;PE;Peru;21358;671;428850;57285
2020-08-03;PE;Peru;4250;575;433100;57860
2020-08-04;PE;Peru;6790;658;439890;58518
2020-08-05;PE;Peru;7734;657;447624;59175
2020-08-06;PE;Peru;7785;601;455409;59776
2020-08-07;PE;Peru;8466;628;463875;60404
2020-08-08;PE;Peru;0;662;463875;61066
2020-08-09;PE;Peru;14149;652;478024;61718
2020-08-10;PE;Peru;5109;581;483133;62299
2020-08-11;PE;Peru;6547;635;489680;62934
2020-08-12;PE;Peru;0;373;489680;63307
2020-08-13;PE;Peru;8875;832;498555;64139
2020-08-14;PE;Peru;17741;668;516296;64807
2020-08-15;PE;Peru;0;649;516296;65456
2020-08-16;PE;Peru;9507;584;525803;66040
2020-08-17;PE;Peru;10143;549;535946;66589
2020-08-18;PE;Peru;5547;609;541493;67198
2020-08-19;PE;Peru;7828;573;549321;67771
2020-08-20;PE;Peru;9099;515;558420;68286
2020-08-21;PE;Peru;8639;505;567059;68791
2020-08-22;PE;Peru;9008;521;576067;69312
2020-08-23;PE;Peru;9169;514;585236;69826
2020-08-24;PE;Peru;9090;524;594326;70350
2020-08-25;PE;Peru;6112;511;600438;70861
2020-08-26;PE;Peru;6944;525;607382;71386
2020-08-27;PE;Peru;5996;445;613378;71831
2020-08-28;PE;Peru;8619;488;621997;72319
2020-08-29;PE;Peru;7964;482;629961;72801
2020-08-30;PE;Peru;9474;426;639435;73227
2020-08-31;PE;Peru;7731;385;647166;73612
2020-09-01;PE;Peru;4871;427;652037;74039
2020-09-02;PE;Peru;5092;377;657129;74416
2020-09-03;PE;Peru;0;400;657129;74816
2020-09-04;PE;Peru;13016;358;670145;75174
2020-09-05;PE;Peru;6703;366;676848;75540
2020-09-06;PE;Peru;6854;361;683702;75901
2020-09-07;PE;Peru;6275;354;689977;76255
2020-09-08;PE;Peru;1598;331;691575;76586
2020-09-09;PE;Peru;4615;320;696190;76906
2020-09-10;PE;Peru;6586;323;702776;77229
2020-09-11;PE;Peru;7291;302;710067;77531
2020-09-12;PE;Peru;6603;294;716670;77825
2020-09-13;PE;Peru;6162;290;722832;78115
2020-09-14;PE;Peru;6787;279;729619;78394
2020-09-15;PE;Peru;4241;286;733860;78680
2020-09-16;PE;Peru;4160;283;738020;78963
2020-09-17;PE;Peru;6380;258;744400;79221
2020-09-18;PE;Peru;5698;253;750098;79474
2020-09-19;PE;Peru;6314;248;756412;79722
2020-09-20;PE;Peru;6453;282;762865;80004
2020-09-21;PE;Peru;6030;241;768895;80245
2020-09-22;PE;Peru;0;233;768895;80478
2020-09-23;PE;Peru;7651;233;776546;80711
2020-09-24;PE;Peru;6149;222;782695;80933
2020-09-25;PE;Peru;11889;213;794584;81146
2020-09-26;PE;Peru;0;219;794584;81365
2020-09-27;PE;Peru;5558;230;800142;81595
2020-09-28;PE;Peru;5160;166;805302;81761
2020-09-29;PE;Peru;3412;199;808714;81960
2020-09-30;PE;Peru;3054;175;811768;82135
2020-10-01;PE;Peru;3061;159;814829;82294
2020-10-02;PE;Peru;3468;183;818297;82477
2020-10-03;PE;Peru;3267;161;821564;82638
2020-10-04;PE;Peru;0;170;821564;82808
2020-10-05;PE;Peru;6605;183;828169;82991
2020-10-06;PE;Peru;1830;168;829999;83159
2020-10-07;PE;Peru;2930;175;832929;83334
2020-10-08;PE;Peru;2733;181;835662;83515
2020-10-09;PE;Peru;2952;151;838614;83666
2020-10-10;PE;Peru;7474;159;846088;83825
2020-10-11;PE;Peru;3283;153;849371;83978
2020-10-12;PE;Peru;1800;136;851171;84114
2020-10-13;PE;Peru;2803;149;853974;84263
2020-10-14;PE;Peru;0;148;853974;84411
2020-10-15;PE;Peru;5766;138;859740;84549
2020-10-16;PE;Peru;0;132;859740;84681
2020-10-17;PE;Peru;2677;148;862417;84829
2020-10-18;PE;Peru;3132;127;865549;84956
2020-10-19;PE;Peru;3126;121;868675;85077
2020-10-20;PE;Peru;2201;141;870876;85218
2020-10-21;PE;Peru;3242;137;874118;85355
2020-10-22;PE;Peru;5758;128;879876;85483
2020-10-23;PE;Peru;0;113;879876;85596
2020-10-24;PE;Peru;3240;115;883116;85711
2020-10-25;PE;Peru;5599;105;888715;85816
2020-10-26;PE;Peru;0;93;888715;85909
2020-10-27;PE;Peru;1859;123;890574;86032
2020-10-28;PE;Peru;1923;112;892497;86144
2020-10-29;PE;Peru;2431;119;894928;86263
2020-10-30;PE;Peru;2666;106;897594;86369
2020-10-31;PE;Peru;2586;125;900180;86494
2020-11-01;PE;Peru;2323;94;902503;86588
2020-11-02;PE;Peru;0;114;902503;86702
2020-11-03;PE;Peru;0;106;902503;86808
2020-11-04;PE;Peru;9284;98;911787;86906
2020-11-05;PE;Peru;2935;127;914722;87033
2020-11-06;PE;Peru;0;95;914722;87128
2020-11-07;PE;Peru;2781;108;917503;87236
2020-11-08;PE;Peru;2507;91;920010;87327
2020-11-09;PE;Peru;2323;105;922333;87432
2020-11-10;PE;Peru;1194;110;923527;87542
2020-11-11;PE;Peru;1904;104;925431;87646
2020-11-12;PE;Peru;2575;92;928006;87738
2020-11-13;PE;Peru;2231;94;930237;87832
2020-11-14;PE;Peru;2413;122;932650;87954
2020-11-15;PE;Peru;2249;103;934899;88057
2020-11-16;PE;Peru;2112;68;937011;88125
2020-11-17;PE;Peru;1257;93;938268;88218
2020-11-18;PE;Peru;1663;103;939931;88321
2020-11-19;PE;Peru;0;92;939931;88413
2020-11-20;PE;Peru;3986;81;943917;88494
2020-11-21;PE;Peru;4164;104;948081;88598
2020-11-22;PE;Peru;0;105;948081;88703
2020-11-23;PE;Peru;1589;86;949670;88789
2020-11-24;PE;Peru;887;102;950557;88891
2020-11-25;PE;Peru;1882;103;952439;88994
2020-11-26;PE;Peru;0;91;952439;89085
2020-11-27;PE;Peru;3908;101;956347;89186
2020-11-28;PE;Peru;4021;86;960368;89272
2020-11-29;PE;Peru;2162;92;962530;89364
2020-11-30;PE;Peru;0;85;962530;89449
2020-12-01;PE;Peru;1075;112;963605;89561
2020-12-02;PE;Peru;0;102;963605;89663
2020-12-03;PE;Peru;3470;110;967075;89773
2020-12-04;PE;Peru;0;81;967075;89854
2020-12-05;PE;Peru;3785;103;970860;89957
2020-12-06;PE;Peru;1828;93;972688;90050
2020-12-07;PE;Peru;1224;104;973912;90154
2020-12-08;PE;Peru;0;110;973912;90264
2020-12-09;PE;Peru;2709;89;976621;90353
2020-12-10;PE;Peru;2490;100;979111;90453
2020-12-11;PE;Peru;0;102;979111;90555
2020-12-12;PE;Peru;1832;121;980943;90676
2020-12-13;PE;Peru;0;121;980943;90797
2020-12-14;PE;Peru;4030;105;984973;90902
2020-12-15;PE;Peru;1157;120;986130;91022
2020-12-16;PE;Peru;0;101;986130;91123
2020-12-17;PE;Peru;3327;110;989457;91233
2020-12-18;PE;Peru;0;130;989457;91363
2020-12-19;PE;Peru;0;117;989457;91480
2020-12-20;PE;Peru;6442;133;995899;91613
2020-12-21;PE;Peru;1618;123;997517;91736
2020-12-22;PE;Peru;958;121;998475;91857
2020-12-23;PE;Peru;1678;126;1000153;91983
2020-12-24;PE;Peru;0;128;1000153;92111
2020-12-25;PE;Peru;3829;118;1003982;92229
2020-12-26;PE;Peru;1564;123;1005546;92352
2020-12-27;PE;Peru;0;141;1005546;92493
2020-12-28;PE;Peru;2111;136;1007657;92629
2020-12-29;PE;Peru;1251;143;1008908;92772
2020-12-30;PE;Peru;1588;125;1010496;92897
2020-12-31;PE;Peru;4641;173;1015137;93070
2021-01-01;PE;Peru;0;161;1015137;93231
2021-01-02;PE;Peru;0;146;1015137;93377
2021-01-03;PE;Peru;2962;198;1018099;93575
2021-01-04;PE;Peru;1376;173;1019475;93748
2021-01-05;PE;Peru;0;210;1019475;93958
2021-01-06;PE;Peru;2543;182;1022018;94140
2021-01-07;PE;Peru;0;177;1022018;94317
2021-01-08;PE;Peru;4162;210;1026180;94527
2021-01-09;PE;Peru;0;229;1026180;94756
2021-01-10;PE;Peru;0;220;1026180;94976
2021-01-11;PE;Peru;9004;257;1035184;95233
2021-01-12;PE;Peru;2166;250;1037350;95483
2021-01-13;PE;Peru;2881;245;1040231;95728
2021-01-14;PE;Peru;0;316;1040231;96044
2021-01-15;PE;Peru;15792;276;1056023;96320
2021-01-16;PE;Peru;0;332;1056023;96652
2021-01-17;PE;Peru;4544;351;1060567;97003
2021-01-18;PE;Peru;0;322;1060567;97325
2021-01-19;PE;Peru;0;392;1060567;97717
2021-01-20;PE;Peru;12647;420;1073214;98137
2021-01-21;PE;Peru;0;388;1073214;98525
2021-01-22;PE;Peru;9693;441;1082907;98966
2021-01-23;PE;Peru;0;445;1082907;99411
2021-01-24;PE;Peru;11031;499;1093938;99910
2021-01-25;PE;Peru;0;467;1093938;100377
2021-01-26;PE;Peru;13301;804;1107239;101181
2021-01-27;PE;Peru;0;506;1107239;101687
2021-01-28;PE;Peru;6731;301;1113970;101988
2021-01-29;PE;Peru;5715;768;1119685;102756
2021-01-30;PE;Peru;13337;325;1133022;103081
2021-01-31;PE;Peru;5217;729;1138239;103810
2021-02-01;PE;Peru;0;461;1138239;104271
2021-02-02;PE;Peru;4477;611;1142716;104882
2021-02-03;PE;Peru;15621;745;1158337;105627
2021-02-04;PE;Peru;0;381;1158337;106008
2021-02-05;PE;Peru;6715;840;1165052;106848
2021-02-06;PE;Peru;7993;431;1173045;107279
2021-02-07;PE;Peru;13653;583;1186698;107862
2021-02-08;PE;Peru;0;655;1186698;108517
2021-02-09;PE;Peru;10080;824;1196778;109341
2021-02-10;PE;Peru;0;524;1196778;109865
2021-02-11;PE;Peru;6724;661;1203502;110526
2021-02-12;PE;Peru;8807;683;1212309;111209
2021-02-13;PE;Peru;8439;736;1220748;111945
2021-02-14;PE;Peru;14550;678;1235298;112623
2021-02-15;PE;Peru;3203;687;1238501;113310
2021-02-16;PE;Peru;0;681;1238501;113991
2021-02-17;PE;Peru;6228;730;1244729;114721
2021-02-18;PE;Peru;7408;714;1252137;115435
2021-02-19;PE;Peru;9667;864;1261804;116299
2021-02-20;PE;Peru;7719;534;1269523;116833
2021-02-21;PE;Peru;13786;912;1283309;117745
2021-02-22;PE;Peru;0;483;1283309;118228
2021-02-23;PE;Peru;3448;697;1286757;118925
2021-02-24;PE;Peru;6740;650;1293497;119575
2021-02-25;PE;Peru;7302;677;1300799;120252
2021-02-26;PE;Peru;15564;868;1316363;121120
2021-02-27;PE;Peru;7500;694;1323863;121814
2021-02-28;PE;Peru;0;688;1323863;122502
2021-03-01;PE;Peru;5942;863;1329805;123365
2021-03-02;PE;Peru;8492;335;1338297;123700
2021-03-03;PE;Peru;0;684;1338297;124384
2021-03-04;PE;Peru;6672;706;1344969;125090
2021-03-05;PE;Peru;4878;880;1349847;125970
2021-03-06;PE;Peru;8447;449;1358294;126419
2021-03-07;PE;Peru;6670;820;1364964;127239
2021-03-08;PE;Peru;6212;402;1371176;127641
2021-03-09;PE;Peru;8847;974;1380023;128615
2021-03-10;PE;Peru;0;372;1380023;128987
2021-03-11;PE;Peru;7434;621;1387457;129608
2021-03-12;PE;Peru;7114;663;1394571;130271
2021-03-13;PE;Peru;8039;620;1402610;130891
2021-03-14;PE;Peru;5353;644;1407963;131535
2021-03-15;PE;Peru;4443;798;1412406;132333
2021-03-16;PE;Peru;6568;845;1418974;133178
2021-03-17;PE;Peru;16624;535;1435598;133713
2021-03-18;PE;Peru;0;470;1435598;134183
2021-03-19;PE;Peru;16047;1070;1451645;135253
2021-03-20;PE;Peru;0;661;1451645;135914
2021-03-21;PE;Peru;14681;362;1466326;136276
2021-03-22;PE;Peru;0;542;1466326;136818
2021-03-23;PE;Peru;14933;676;1481259;137494
2021-03-24;PE;Peru;0;707;1481259;138201
2021-03-25;PE;Peru;19206;706;1500465;138907
2021-03-26;PE;Peru;11919;876;1512384;139783
2021-03-27;PE;Peru;8589;498;1520973;140281
2021-03-28;PE;Peru;8909;989;1529882;141270
2021-03-29;PE;Peru;3239;668;1533121;141938
2021-03-30;PE;Peru;0;524;1533121;142462
2021-03-31;PE;Peru;15686;954;1548807;143416
2021-04-01;PE;Peru;12916;690;1561723;144106
2021-04-02;PE;Peru;6622;592;1568345;144698
2021-04-03;PE;Peru;5616;1027;1573961;145725
2021-04-04;PE;Peru;8406;702;1582367;146427
2021-04-05;PE;Peru;7842;514;1590209;146941
2021-04-06;PE;Peru;0;793;1590209;147734
2021-04-07;PE;Peru;8384;763;1598593;148497
2021-04-08;PE;Peru;19271;744;1617864;149241
2021-04-09;PE;Peru;10655;776;1628519;150017
2021-04-10;PE;Peru;11248;834;1639767;150851
2021-04-11;PE;Peru;7927;1036;1647694;151887
2021-04-12;PE;Peru;5626;902;1653320;152789
2021-04-13;PE;Peru;6387;749;1659707;153538
2021-04-14;PE;Peru;8030;891;1667737;154429
2021-04-15;PE;Peru;0;456;1667737;154885
2021-04-16;PE;Peru;13326;752;1681063;155637
2021-04-17;PE;Peru;16563;1173;1697626;156810
2021-04-18;PE;Peru;0;433;1697626;157243
2021-04-19;PE;Peru;10161;1121;1707787;158364
2021-04-20;PE;Peru;11301;525;1719088;158889
2021-04-21;PE;Peru;0;841;1719088;159730
2021-04-22;PE;Peru;15518;791;1734606;160521
2021-04-23;PE;Peru;11049;1234;1745655;161755
2021-04-24;PE;Peru;8495;415;1754150;162170
2021-04-25;PE;Peru;7425;1036;1761575;163206
2021-04-26;PE;Peru;6611;764;1768186;163970
2021-04-27;PE;Peru;0;463;1768186;164433
2021-04-28;PE;Peru;15153;1052;1783339;165485
2021-04-29;PE;Peru;0;751;1783339;166236
2021-04-30;PE;Peru;16106;465;1799445;166701
2021-05-01;PE;Peru;0;697;1799445;167398
2021-05-02;PE;Peru;11553;722;1810998;168120
2021-05-03;PE;Peru;3129;953;1814127;169073
2021-05-04;PE;Peru;4562;461;1818689;169534
2021-05-05;PE;Peru;0;666;1818689;170200
2021-05-06;PE;Peru;5768;705;1824457;170905
2021-05-07;PE;Peru;0;658;1824457;171563
2021-05-08;PE;Peru;20599;962;1845056;172525
2021-05-09;PE;Peru;5234;578;1850290;173103
2021-05-10;PE;Peru;0;343;1850290;173446
2021-05-11;PE;Peru;3080;882;1853370;174328
2021-05-12;PE;Peru;12269;527;1865639;174855
2021-05-13;PE;Peru;0;589;1865639;175444
2021-05-14;PE;Peru;13410;650;1879049;176094
2021-05-15;PE;Peru;0;538;1879049;176632
2021-05-16;PE;Peru;10003;564;1889052;177196
2021-05-17;PE;Peru;0;555;1889052;177751
2021-05-18;PE;Peru;4282;193;1893334;177944
2021-05-19;PE;Peru;10281;772;1903615;178716
2021-05-20;PE;Peru;0;268;1903615;178984
2021-05-21;PE;Peru;6745;443;1910360;179427
2021-05-22;PE;Peru;10491;732;1920851;180159
2021-05-23;PE;Peru;4438;446;1925289;180605
2021-05-24;PE;Peru;0;213;1925289;180818
2021-05-25;PE;Peru;6966;843;1932255;181661
2021-05-26;PE;Peru;4990;175;1937245;181836
2021-05-27;PE;Peru;4809;464;1942054;182300
2021-05-28;PE;Peru;0;256;1942054;182556
2021-05-29;PE;Peru;5501;426;1947555;182982
2021-05-30;PE;Peru;0;409;1947555;183391
2021-05-31;PE;Peru;7914;392;1955469;183783
2021-06-01;PE;Peru;0;238;1955469;184021
2021-06-02;PE;Peru;9963;921;1965432;184942
2021-06-03;PE;Peru;0;0;1965432;184942
2021-06-04;PE;Peru;10734;871;1976166;185813
2021-06-05;PE;Peru;4225;260;1980391;186073
2021-06-06;PE;Peru;0;0;1980391;186073
2021-06-07;PE;Peru;3179;438;1983570;186511
2021-06-08;PE;Peru;1429;246;1984999;186757
2021-06-09;PE;Peru;2934;400;1987933;187157
2021-06-10;PE;Peru;7324;690;1995257;187847
2021-06-11;PE;Peru;2799;253;1998056;188100
2021-06-12;PE;Peru;0;0;1998056;188100
2021-06-13;PE;Peru;5569;608;2003625;188708
2021-06-14;PE;Peru;0;0;2003625;188708
2021-06-15;PE;Peru;3852;553;2007477;189261
2021-06-16;PE;Peru;0;0;2007477;189261
2021-06-17;PE;Peru;12239;496;2019716;189757
2021-06-18;PE;Peru;3463;176;2023179;189933
2021-06-19;PE;Peru;0;0;2023179;189933
2021-06-20;PE;Peru;3550;269;2026729;190202
2021-06-21;PE;Peru;3882;443;2030611;190645
2021-06-22;PE;Peru;0;0;2030611;190645
2021-06-23;PE;Peru;2995;261;2033606;190906
2021-06-24;PE;Peru;2843;167;2036449;191073
2021-06-25;PE;Peru;6813;374;2043262;191447
2021-06-26;PE;Peru;0;0;2043262;191447
2021-06-27;PE;Peru;2795;137;2046057;191584
2021-06-28;PE;Peru;2058;315;2048115;191899
2021-06-29;PE;Peru;0;0;2048115;191899
2021-06-30;PE;Peru;3950;432;2052065;192331
2021-07-01;PE;Peru;5489;356;2057554;192687
2020-01-30;PH;Philippines;1;0;1;0
2020-01-31;PH;Philippines;0;0;1;0
2020-02-01;PH;Philippines;0;0;1;0
2020-02-02;PH;Philippines;1;1;2;1
2020-02-03;PH;Philippines;0;0;2;1
2020-02-04;PH;Philippines;0;0;2;1
2020-02-05;PH;Philippines;0;0;2;1
2020-02-06;PH;Philippines;0;0;2;1
2020-02-07;PH;Philippines;1;0;3;1
2020-02-08;PH;Philippines;0;0;3;1
2020-02-09;PH;Philippines;0;0;3;1
2020-02-10;PH;Philippines;0;0;3;1
2020-02-11;PH;Philippines;0;0;3;1
2020-02-12;PH;Philippines;0;0;3;1
2020-02-13;PH;Philippines;0;0;3;1
2020-02-14;PH;Philippines;0;0;3;1
2020-02-15;PH;Philippines;0;0;3;1
2020-02-16;PH;Philippines;0;0;3;1
2020-02-17;PH;Philippines;0;0;3;1
2020-02-18;PH;Philippines;0;0;3;1
2020-02-19;PH;Philippines;0;0;3;1
2020-02-20;PH;Philippines;0;0;3;1
2020-02-21;PH;Philippines;0;0;3;1
2020-02-22;PH;Philippines;0;0;3;1
2020-02-23;PH;Philippines;0;0;3;1
2020-02-24;PH;Philippines;0;0;3;1
2020-02-25;PH;Philippines;0;0;3;1
2020-02-26;PH;Philippines;0;0;3;1
2020-02-27;PH;Philippines;0;0;3;1
2020-02-28;PH;Philippines;0;0;3;1
2020-02-29;PH;Philippines;0;0;3;1
2020-03-01;PH;Philippines;0;0;3;1
2020-03-02;PH;Philippines;0;0;3;1
2020-03-03;PH;Philippines;0;0;3;1
2020-03-04;PH;Philippines;0;0;3;1
2020-03-05;PH;Philippines;0;0;3;1
2020-03-06;PH;Philippines;2;0;5;1
2020-03-07;PH;Philippines;1;0;6;1
2020-03-08;PH;Philippines;4;0;10;1
2020-03-09;PH;Philippines;10;0;20;1
2020-03-10;PH;Philippines;13;0;33;1
2020-03-11;PH;Philippines;16;0;49;1
2020-03-12;PH;Philippines;3;1;52;2
2020-03-13;PH;Philippines;12;3;64;5
2020-03-14;PH;Philippines;47;3;111;8
2020-03-15;PH;Philippines;29;3;140;11
2020-03-16;PH;Philippines;2;1;142;12
2020-03-17;PH;Philippines;45;0;187;12
2020-03-18;PH;Philippines;15;7;202;19
2020-03-19;PH;Philippines;15;-2;217;17
2020-03-20;PH;Philippines;13;1;230;18
2020-03-21;PH;Philippines;77;1;307;19
2020-03-22;PH;Philippines;73;6;380;25
2020-03-23;PH;Philippines;82;8;462;33
2020-03-24;PH;Philippines;90;2;552;35
2020-03-25;PH;Philippines;84;3;636;38
2020-03-26;PH;Philippines;71;7;707;45
2020-03-27;PH;Philippines;96;9;803;54
2020-03-28;PH;Philippines;272;14;1075;68
2020-03-29;PH;Philippines;343;3;1418;71
2020-03-30;PH;Philippines;128;7;1546;78
2020-03-31;PH;Philippines;538;10;2084;88
2020-04-01;PH;Philippines;227;8;2311;96
2020-04-02;PH;Philippines;322;11;2633;107
2020-04-03;PH;Philippines;385;29;3018;136
2020-04-04;PH;Philippines;76;8;3094;144
2020-04-05;PH;Philippines;152;8;3246;152
2020-04-06;PH;Philippines;414;11;3660;163
2020-04-07;PH;Philippines;104;14;3764;177
2020-04-08;PH;Philippines;106;5;3870;182
2020-04-09;PH;Philippines;206;21;4076;203
2020-04-10;PH;Philippines;119;18;4195;221
2020-04-11;PH;Philippines;233;26;4428;247
2020-04-12;PH;Philippines;220;50;4648;297
2020-04-13;PH;Philippines;284;18;4932;315
2020-04-14;PH;Philippines;291;20;5223;335
2020-04-15;PH;Philippines;230;14;5453;349
2020-04-16;PH;Philippines;207;13;5660;362
2020-04-17;PH;Philippines;218;25;5878;387
2020-04-18;PH;Philippines;209;10;6087;397
2020-04-19;PH;Philippines;172;12;6259;409
2020-04-20;PH;Philippines;200;19;6459;428
2020-04-21;PH;Philippines;140;9;6599;437
2020-04-22;PH;Philippines;111;9;6710;446
2020-04-23;PH;Philippines;271;16;6981;462
2020-04-24;PH;Philippines;211;15;7192;477
2020-04-25;PH;Philippines;102;17;7294;494
2020-04-26;PH;Philippines;285;7;7579;501
2020-04-27;PH;Philippines;198;10;7777;511
2020-04-28;PH;Philippines;181;19;7958;530
2020-04-29;PH;Philippines;254;28;8212;558
2020-04-30;PH;Philippines;276;10;8488;568
2020-05-01;PH;Philippines;284;11;8772;579
2020-05-02;PH;Philippines;156;24;8928;603
2020-05-03;PH;Philippines;295;4;9223;607
2020-05-04;PH;Philippines;262;16;9485;623
2020-05-05;PH;Philippines;199;14;9684;637
2020-05-06;PH;Philippines;320;21;10004;658
2020-05-07;PH;Philippines;339;27;10343;685
2020-05-08;PH;Philippines;120;11;10463;696
2020-05-09;PH;Philippines;147;8;10610;704
2020-05-10;PH;Philippines;184;15;10794;719
2020-05-11;PH;Philippines;292;7;11086;726
2020-05-12;PH;Philippines;264;25;11350;751
2020-05-13;PH;Philippines;268;21;11618;772
2020-05-14;PH;Philippines;258;18;11876;790
2020-05-15;PH;Philippines;215;16;12091;806
2020-05-16;PH;Philippines;214;11;12305;817
2020-05-17;PH;Philippines;208;7;12513;824
2020-05-18;PH;Philippines;205;7;12718;831
2020-05-19;PH;Philippines;224;6;12942;837
2020-05-20;PH;Philippines;279;5;13221;842
2020-05-21;PH;Philippines;213;4;13434;846
2020-05-22;PH;Philippines;163;11;13597;857
2020-05-23;PH;Philippines;180;6;13777;863
2020-05-24;PH;Philippines;258;5;14035;868
2020-05-25;PH;Philippines;284;5;14319;873
2020-05-26;PH;Philippines;350;13;14669;886
2020-05-27;PH;Philippines;380;18;15049;904
2020-05-28;PH;Philippines;539;17;15588;921
2020-05-29;PH;Philippines;1046;21;16634;942
2020-05-30;PH;Philippines;590;8;17224;950
2020-05-31;PH;Philippines;862;7;18086;957
2020-06-01;PH;Philippines;552;3;18638;960
2020-06-02;PH;Philippines;359;6;18997;966
2020-06-03;PH;Philippines;751;8;19748;974
2020-06-04;PH;Philippines;634;10;20382;984
2020-06-05;PH;Philippines;244;3;20626;987
2020-06-06;PH;Philippines;714;7;21340;994
2020-06-07;PH;Philippines;555;9;21895;1003
2020-06-08;PH;Philippines;579;8;22474;1011
2020-06-09;PH;Philippines;518;6;22992;1017
2020-06-10;PH;Philippines;740;10;23732;1027
2020-06-11;PH;Philippines;443;9;24175;1036
2020-06-12;PH;Philippines;612;16;24787;1052
2020-06-13;PH;Philippines;605;22;25392;1074
2020-06-14;PH;Philippines;538;14;25930;1088
2020-06-15;PH;Philippines;490;10;26420;1098
2020-06-16;PH;Philippines;361;5;26781;1103
2020-06-17;PH;Philippines;457;5;27238;1108
2020-06-18;PH;Philippines;561;8;27799;1116
2020-06-19;PH;Philippines;660;14;28459;1130
2020-06-20;PH;Philippines;941;20;29400;1150
2020-06-21;PH;Philippines;652;19;30052;1169
2020-06-22;PH;Philippines;630;8;30682;1177
2020-06-23;PH;Philippines;1143;9;31825;1186
2020-06-24;PH;Philippines;470;18;32295;1204
2020-06-25;PH;Philippines;774;8;33069;1212
2020-06-26;PH;Philippines;1004;12;34073;1224
2020-06-27;PH;Philippines;730;12;34803;1236
2020-06-28;PH;Philippines;652;8;35455;1244
2020-06-29;PH;Philippines;983;11;36438;1255
2020-06-30;PH;Philippines;1076;11;37514;1266
2020-07-01;PH;Philippines;997;4;38511;1270
2020-07-02;PH;Philippines;294;4;38805;1274
2020-07-03;PH;Philippines;1531;6;40336;1280
2020-07-04;PH;Philippines;1494;10;41830;1290
2020-07-05;PH;Philippines;2424;7;44254;1297
2020-07-06;PH;Philippines;2079;6;46333;1303
2020-07-07;PH;Philippines;1540;6;47873;1309
2020-07-08;PH;Philippines;2486;5;50359;1314
2020-07-09;PH;Philippines;1395;0;51754;1314
2020-07-10;PH;Philippines;1160;46;52914;1360
2020-07-11;PH;Philippines;1308;12;54222;1372
2020-07-12;PH;Philippines;2037;162;56259;1534
2020-07-13;PH;Philippines;747;65;57006;1599
2020-07-14;PH;Philippines;539;4;57545;1603
2020-07-15;PH;Philippines;1305;11;58850;1614
2020-07-16;PH;Philippines;2416;29;61266;1643
2020-07-17;PH;Philippines;1735;17;63001;1660
2020-07-18;PH;Philippines;2303;113;65304;1773
2020-07-19;PH;Philippines;2152;58;67456;1831
2020-07-20;PH;Philippines;1442;4;68898;1835
2020-07-21;PH;Philippines;1866;2;70764;1837
2020-07-22;PH;Philippines;1505;6;72269;1843
2020-07-23;PH;Philippines;2121;28;74390;1871
2020-07-24;PH;Philippines;2054;8;76444;1879
2020-07-25;PH;Philippines;1968;18;78412;1897
2020-07-26;PH;Philippines;2036;35;80448;1932
2020-07-27;PH;Philippines;1592;13;82040;1945
2020-07-28;PH;Philippines;1633;2;83673;1947
2020-07-29;PH;Philippines;1813;15;85486;1962
2020-07-30;PH;Philippines;3888;21;89374;1983
2020-07-31;PH;Philippines;3980;40;93354;2023
2020-08-01;PH;Philippines;4878;16;98232;2039
2020-08-02;PH;Philippines;4953;20;103185;2059
2020-08-03;PH;Philippines;3145;45;106330;2104
2020-08-04;PH;Philippines;6263;11;112593;2115
2020-08-05;PH;Philippines;3387;8;115980;2123
2020-08-06;PH;Philippines;3480;27;119460;2150
2020-08-07;PH;Philippines;3294;18;122754;2168
2020-08-08;PH;Philippines;4131;41;126885;2209
2020-08-09;PH;Philippines;3028;61;129913;2270
2020-08-10;PH;Philippines;6725;24;136638;2294
2020-08-11;PH;Philippines;2900;18;139538;2312
2020-08-12;PH;Philippines;4211;92;143749;2404
2020-08-13;PH;Philippines;3777;22;147526;2426
2020-08-14;PH;Philippines;6134;16;153660;2442
2020-08-15;PH;Philippines;4258;158;157918;2600
2020-08-16;PH;Philippines;3335;65;161253;2665
2020-08-17;PH;Philippines;3221;16;164474;2681
2020-08-18;PH;Philippines;4739;6;169213;2687
2020-08-19;PH;Philippines;4561;108;173774;2795
2020-08-20;PH;Philippines;4248;88;178022;2883
2020-08-21;PH;Philippines;4343;57;182365;2940
2020-08-22;PH;Philippines;4884;26;187249;2966
2020-08-23;PH;Philippines;2352;32;189601;2998
2020-08-24;PH;Philippines;4651;12;194252;3010
2020-08-25;PH;Philippines;2912;28;197164;3038
2020-08-26;PH;Philippines;5197;99;202361;3137
2020-08-27;PH;Philippines;3220;97;205581;3234
2020-08-28;PH;Philippines;3963;91;209544;3325
2020-08-29;PH;Philippines;3587;94;213131;3419
2020-08-30;PH;Philippines;4265;101;217396;3520
2020-08-31;PH;Philippines;3423;38;220819;3558
2020-09-01;PH;Philippines;3445;39;224264;3597
2020-09-02;PH;Philippines;2176;26;226440;3623
2020-09-03;PH;Philippines;1963;65;228403;3688
2020-09-04;PH;Philippines;3669;49;232072;3737
2020-09-05;PH;Philippines;2498;53;234570;3790
2020-09-06;PH;Philippines;2795;85;237365;3875
2020-09-07;PH;Philippines;1362;15;238727;3890
2020-09-08;PH;Philippines;3260;26;241987;3916
2020-09-09;PH;Philippines;3156;70;245143;3986
2020-09-10;PH;Philippines;3804;80;248947;4066
2020-09-11;PH;Philippines;4017;42;252964;4108
2020-09-12;PH;Philippines;4899;184;257863;4292
2020-09-13;PH;Philippines;3353;79;261216;4371
2020-09-14;PH;Philippines;4672;259;265888;4630
2020-09-15;PH;Philippines;3519;33;269407;4663
2020-09-16;PH;Philippines;3527;69;272934;4732
2020-09-17;PH;Philippines;3355;53;276289;4785
2020-09-18;PH;Philippines;3237;45;279526;4830
2020-09-19;PH;Philippines;3934;100;283460;4930
2020-09-20;PH;Philippines;3283;54;286743;4984
2020-09-21;PH;Philippines;3447;15;290190;4999
2020-09-22;PH;Philippines;1599;50;291789;5049
2020-09-23;PH;Philippines;2802;42;294591;5091
2020-09-24;PH;Philippines;2164;36;296755;5127
2020-09-25;PH;Philippines;2606;69;299361;5196
2020-09-26;PH;Philippines;1895;88;301256;5284
2020-09-27;PH;Philippines;2970;60;304226;5344
2020-09-28;PH;Philippines;3062;37;307288;5381
2020-09-29;PH;Philippines;2015;67;309303;5448
2020-09-30;PH;Philippines;2391;56;311694;5504
2020-10-01;PH;Philippines;2385;58;314079;5562
2020-10-02;PH;Philippines;2599;54;316678;5616
2020-10-03;PH;Philippines;2652;62;319330;5678
2020-10-04;PH;Philippines;3167;98;322497;5776
2020-10-05;PH;Philippines;2265;64;324762;5840
2020-10-06;PH;Philippines;2071;25;326833;5865
2020-10-07;PH;Philippines;2804;60;329637;5925
2020-10-08;PH;Philippines;2232;144;331869;6069
2020-10-09;PH;Philippines;2901;83;334770;6152
2020-10-10;PH;Philippines;2156;86;336926;6238
2020-10-11;PH;Philippines;2415;83;339341;6321
2020-10-12;PH;Philippines;3475;11;342816;6332
2020-10-13;PH;Philippines;1897;40;344713;6372
2020-10-14;PH;Philippines;1823;77;346536;6449
2020-10-15;PH;Philippines;2162;48;348698;6497
2020-10-16;PH;Philippines;3052;34;351750;6531
2020-10-17;PH;Philippines;2588;72;354338;6603
2020-10-18;PH;Philippines;2280;49;356618;6652
2020-10-19;PH;Philippines;2551;23;359169;6675
2020-10-20;PH;Philippines;1606;15;360775;6690
2020-10-21;PH;Philippines;1468;57;362243;6747
2020-10-22;PH;Philippines;1645;36;363888;6783
2020-10-23;PH;Philippines;1911;132;365799;6915
2020-10-24;PH;Philippines;2020;19;367819;6934
2020-10-25;PH;Philippines;2209;43;370028;6977
2020-10-26;PH;Philippines;1602;62;371630;7039
2020-10-27;PH;Philippines;1514;14;373144;7053
2020-10-28;PH;Philippines;2036;61;375180;7114
2020-10-29;PH;Philippines;1755;33;376935;7147
2020-10-30;PH;Philippines;1998;38;378933;7185
2020-10-31;PH;Philippines;1796;36;380729;7221
2020-11-01;PH;Philippines;2384;17;383113;7238
2020-11-02;PH;Philippines;2287;31;385400;7269
2020-11-03;PH;Philippines;1761;49;387161;7318
2020-11-04;PH;Philippines;976;49;388137;7367
2020-11-05;PH;Philippines;1588;42;389725;7409
2020-11-06;PH;Philippines;2084;52;391809;7461
2020-11-07;PH;Philippines;2152;24;393961;7485
2020-11-08;PH;Philippines;2434;54;396395;7539
2020-11-09;PH;Philippines;2054;108;398449;7647
2020-11-10;PH;Philippines;1300;14;399749;7661
2020-11-11;PH;Philippines;1667;49;401416;7710
2020-11-12;PH;Philippines;1404;11;402820;7721
2020-11-13;PH;Philippines;1893;31;404713;7752
2020-11-14;PH;Philippines;1624;39;406337;7791
2020-11-15;PH;Philippines;1501;41;407838;7832
2020-11-16;PH;Philippines;1736;7;409574;7839
2020-11-17;PH;Philippines;1144;23;410718;7862
2020-11-18;PH;Philippines;1379;95;412097;7957
2020-11-19;PH;Philippines;1333;41;413430;7998
2020-11-20;PH;Philippines;1637;27;415067;8025
2020-11-21;PH;Philippines;1785;55;416852;8080
2020-11-22;PH;Philippines;1966;43;418818;8123
2020-11-23;PH;Philippines;1796;50;420614;8173
2020-11-24;PH;Philippines;1108;12;421722;8185
2020-11-25;PH;Philippines;1193;30;422915;8215
2020-11-26;PH;Philippines;1382;27;424297;8242
2020-11-27;PH;Philippines;1621;13;425918;8255
2020-11-28;PH;Philippines;1879;78;427797;8333
2020-11-29;PH;Philippines;2067;40;429864;8373
2020-11-30;PH;Philippines;1766;19;431630;8392
2020-12-01;PH;Philippines;1295;26;432925;8418
2020-12-02;PH;Philippines;1432;18;434357;8436
2020-12-03;PH;Philippines;1056;10;435413;8446
2020-12-04;PH;Philippines;932;63;436345;8509
2020-12-05;PH;Philippines;1724;17;438069;8526
2020-12-06;PH;Philippines;1765;28;439834;8554
2020-12-07;PH;Philippines;1565;18;441399;8572
2020-12-08;PH;Philippines;1386;98;442785;8670
2020-12-09;PH;Philippines;1379;7;444164;8677
2020-12-10;PH;Philippines;1376;24;445540;8701
2020-12-11;PH;Philippines;1499;8;447039;8709
2020-12-12;PH;Philippines;1292;21;448331;8730
2020-12-13;PH;Philippines;1069;3;449400;8733
2020-12-14;PH;Philippines;1333;24;450733;8757
2020-12-15;PH;Philippines;1106;55;451839;8812
2020-12-16;PH;Philippines;1149;21;452988;8833
2020-12-17;PH;Philippines;1459;17;454447;8850
2020-12-18;PH;Philippines;2115;25;456562;8875
2020-12-19;PH;Philippines;1482;36;458044;8911
2020-12-20;PH;Philippines;1745;36;459789;8947
2020-12-21;PH;Philippines;1716;10;461505;8957
2020-12-22;PH;Philippines;1310;64;462815;9021
2020-12-23;PH;Philippines;1189;27;464004;9048
2020-12-24;PH;Philippines;1720;7;465724;9055
2020-12-25;PH;Philippines;1877;7;467601;9062
2020-12-26;PH;Philippines;1404;5;469005;9067
2020-12-27;PH;Philippines;881;42;469886;9109
2020-12-28;PH;Philippines;764;15;470650;9124
2020-12-29;PH;Philippines;876;38;471526;9162
2020-12-30;PH;Philippines;1006;68;472532;9230
2020-12-31;PH;Philippines;1532;14;474064;9244
2021-01-01;PH;Philippines;1756;4;475820;9248
2021-01-02;PH;Philippines;1096;5;476916;9253
2021-01-03;PH;Philippines;891;4;477807;9257
2021-01-04;PH;Philippines;954;6;478761;9263
2021-01-05;PH;Philippines;932;58;479693;9321
2021-01-06;PH;Philippines;1044;26;480737;9347
2021-01-07;PH;Philippines;1346;9;482083;9356
2021-01-08;PH;Philippines;1769;8;483852;9364
2021-01-09;PH;Philippines;1945;34;485797;9398
2021-01-10;PH;Philippines;1893;7;487690;9405
2021-01-11;PH;Philippines;2046;11;489736;9416
2021-01-12;PH;Philippines;1522;138;491258;9554
2021-01-13;PH;Philippines;1442;145;492700;9699
2021-01-14;PH;Philippines;1905;40;494605;9739
2021-01-15;PH;Philippines;2041;137;496646;9876
2021-01-16;PH;Philippines;2045;8;498691;9884
2021-01-17;PH;Philippines;1886;11;500577;9895
2021-01-18;PH;Philippines;2159;14;502736;9909
2021-01-19;PH;Philippines;1348;69;504084;9978
2021-01-20;PH;Philippines;1855;64;505939;10042
2021-01-21;PH;Philippines;1778;74;507717;10116
2021-01-22;PH;Philippines;2170;20;509887;10136
2021-01-23;PH;Philippines;1792;54;511679;10190
2021-01-24;PH;Philippines;1940;52;513619;10242
2021-01-25;PH;Philippines;1377;50;514996;10292
2021-01-26;PH;Philippines;1170;94;516166;10386
2021-01-27;PH;Philippines;2241;95;518407;10481
2021-01-28;PH;Philippines;1168;71;519575;10552
2021-01-29;PH;Philippines;1838;48;521413;10600
2021-01-30;PH;Philippines;2103;69;523516;10669
2021-01-31;PH;Philippines;2102;80;525618;10749
2021-02-01;PH;Philippines;1654;58;527272;10807
2021-02-02;PH;Philippines;1581;67;528853;10874
2021-02-03;PH;Philippines;1265;68;530118;10942
2021-02-04;PH;Philippines;1581;55;531699;10997
2021-02-05;PH;Philippines;1888;61;533587;11058
2021-02-06;PH;Philippines;1934;52;535521;11110
2021-02-07;PH;Philippines;1789;69;537310;11179
2021-02-08;PH;Philippines;1685;52;538995;11231
2021-02-09;PH;Philippines;1232;65;540227;11296
2021-02-10;PH;Philippines;1333;105;541560;11401
2021-02-11;PH;Philippines;1722;68;543282;11469
2021-02-12;PH;Philippines;2018;26;545300;11495
2021-02-13;PH;Philippines;1955;12;547255;11507
2021-02-14;PH;Philippines;1921;8;549176;11515
2021-02-15;PH;Philippines;1684;2;550860;11517
2021-02-16;PH;Philippines;1386;7;552246;11524
2021-02-17;PH;Philippines;1178;53;553424;11577
2021-02-18;PH;Philippines;1739;96;555163;11673
2021-02-19;PH;Philippines;1895;156;557058;11829
2021-02-20;PH;Philippines;2230;239;559288;12068
2021-02-21;PH;Philippines;1881;20;561169;12088
2021-02-22;PH;Philippines;2287;6;563456;12094
2021-02-23;PH;Philippines;1409;13;564865;12107
2021-02-24;PH;Philippines;1555;22;566420;12129
2021-02-25;PH;Philippines;2260;72;568680;12201
2021-02-26;PH;Philippines;2647;46;571327;12247
2021-02-27;PH;Philippines;2920;42;574247;12289
2021-02-28;PH;Philippines;2105;29;576352;12318
2021-03-01;PH;Philippines;2029;4;578381;12322
2021-03-02;PH;Philippines;2061;47;580442;12369
2021-03-03;PH;Philippines;1781;20;582223;12389
2021-03-04;PH;Philippines;2444;15;584667;12404
2021-03-05;PH;Philippines;3037;19;587704;12423
2021-03-06;PH;Philippines;3434;42;591138;12465
2021-03-07;PH;Philippines;3274;51;594412;12516
2021-03-08;PH;Philippines;3351;5;597763;12521
2021-03-09;PH;Philippines;2665;7;600428;12528
2021-03-10;PH;Philippines;2880;17;603308;12545
2021-03-11;PH;Philippines;3740;63;607048;12608
2021-03-12;PH;Philippines;4570;86;611618;12694
2021-03-13;PH;Philippines;4993;72;616611;12766
2021-03-14;PH;Philippines;4887;63;621498;12829
2021-03-15;PH;Philippines;5395;8;626893;12837
2021-03-16;PH;Philippines;4427;11;631320;12848
2021-03-17;PH;Philippines;4378;18;635698;12866
2021-03-18;PH;Philippines;5286;21;640984;12887
2021-03-19;PH;Philippines;7082;13;648066;12900
2021-03-20;PH;Philippines;7990;30;656056;12930
2021-03-21;PH;Philippines;7738;38;663794;12968
2021-03-22;PH;Philippines;7998;4;671792;12972
2021-03-23;PH;Philippines;5861;20;677653;12992
2021-03-24;PH;Philippines;6658;47;684311;13039
2021-03-25;PH;Philippines;8737;56;693048;13095
2021-03-26;PH;Philippines;9808;54;702856;13149
2021-03-27;PH;Philippines;9586;10;712442;13159
2021-03-28;PH;Philippines;9450;11;721892;13170
2021-03-29;PH;Philippines;10002;16;731894;13186
2021-03-30;PH;Philippines;9287;5;741181;13191
2021-03-31;PH;Philippines;6107;106;747288;13297
2021-04-01;PH;Philippines;8911;6;756199;13303
2021-04-02;PH;Philippines;15298;17;771497;13320
2021-04-03;PH;Philippines;12546;103;784043;13423
2021-04-04;PH;Philippines;11008;2;795051;13425
2021-04-05;PH;Philippines;8347;10;803398;13435
2021-04-06;PH;Philippines;9362;382;812760;13817
2021-04-07;PH;Philippines;6404;242;819164;14059
2021-04-08;PH;Philippines;9202;60;828366;14119
2021-04-09;PH;Philippines;12188;401;840554;14520
2021-04-10;PH;Philippines;12655;224;853209;14744
2021-04-11;PH;Philippines;11659;201;864868;14945
2021-04-12;PH;Philippines;11357;204;876225;15149
2021-04-13;PH;Philippines;8558;137;884783;15286
2021-04-14;PH;Philippines;8097;161;892880;15447
2021-04-15;PH;Philippines;11405;147;904285;15594
2021-04-16;PH;Philippines;10686;144;914971;15738
2021-04-17;PH;Philippines;11081;72;926052;15810
2021-04-18;PH;Philippines;10081;150;936133;15960
2021-04-19;PH;Philippines;9612;88;945745;16048
2021-04-20;PH;Philippines;7361;93;953106;16141
2021-04-21;PH;Philippines;9201;124;962307;16265
2021-04-22;PH;Philippines;8742;105;971049;16370
2021-04-23;PH;Philippines;8691;159;979740;16529
2021-04-24;PH;Philippines;9640;145;989380;16674
2021-04-25;PH;Philippines;8143;109;997523;16783
2021-04-26;PH;Philippines;8905;70;1006428;16853
2021-04-27;PH;Philippines;7190;63;1013618;16916
2021-04-28;PH;Philippines;6877;115;1020495;17031
2021-04-29;PH;Philippines;8243;114;1028738;17145
2021-04-30;PH;Philippines;8722;89;1037460;17234
2021-05-01;PH;Philippines;9193;120;1046653;17354
2021-05-02;PH;Philippines;8330;77;1054983;17431
2021-05-03;PH;Philippines;7242;94;1062225;17525
2021-05-04;PH;Philippines;5667;97;1067892;17622
2021-05-05;PH;Philippines;5663;178;1073555;17800
2021-05-06;PH;Philippines;6617;191;1080172;17991
2021-05-07;PH;Philippines;7713;108;1087885;18099
2021-05-08;PH;Philippines;6964;170;1094849;18269
2021-05-09;PH;Philippines;7141;203;1101990;18472
2021-05-10;PH;Philippines;6836;90;1108826;18562
2021-05-11;PH;Philippines;4721;58;1113547;18620
2021-05-12;PH;Philippines;4812;94;1118359;18714
2021-05-13;PH;Philippines;6365;107;1124724;18821
2021-05-14;PH;Philippines;6743;137;1131467;18958
2021-05-15;PH;Philippines;6720;93;1138187;19051
2021-05-16;PH;Philippines;5776;140;1143963;19191
2021-05-17;PH;Philippines;5962;71;1149925;19262
2021-05-18;PH;Philippines;4463;110;1154388;19372
2021-05-19;PH;Philippines;4683;135;1159071;19507
2021-05-20;PH;Philippines;6084;134;1165155;19641
2021-05-21;PH;Philippines;6248;122;1171403;19763
2021-05-22;PH;Philippines;6814;183;1178217;19946
2021-05-23;PH;Philippines;1595;5;1179812;19951
2021-05-24;PH;Philippines;4894;32;1184706;19983
2021-05-25;PH;Philippines;3966;36;1188672;20019
2021-05-26;PH;Philippines;5304;150;1193976;20169
2021-05-27;PH;Philippines;6454;210;1200430;20379
2021-05-28;PH;Philippines;8724;187;1209154;20566
2021-05-29;PH;Philippines;7428;156;1216582;20722
2021-05-30;PH;Philippines;7045;138;1223627;20860
2021-05-31;PH;Philippines;6674;106;1230301;20966
2021-06-01;PH;Philippines;5166;46;1235467;21012
2021-06-02;PH;Philippines;5249;146;1240716;21158
2021-06-03;PH;Philippines;7183;199;1247899;21357
2021-06-04;PH;Philippines;7438;180;1255337;21537
2021-06-05;PH;Philippines;6936;195;1262273;21732
2021-06-06;PH;Philippines;7205;166;1269478;21898
2021-06-07;PH;Philippines;6526;71;1276004;21969
2021-06-08;PH;Philippines;4769;95;1280773;22064
2021-06-09;PH;Philippines;5444;126;1286217;22190
2021-06-10;PH;Philippines;7470;122;1293687;22312
2021-06-11;PH;Philippines;6662;195;1300349;22507
2021-06-12;PH;Philippines;8003;145;1308352;22652
2021-06-13;PH;Philippines;7287;136;1315639;22788
2021-06-14;PH;Philippines;6414;57;1322053;22845
2021-06-15;PH;Philippines;5378;118;1327431;22963
2021-06-16;PH;Philippines;5401;158;1332832;23121
2021-06-17;PH;Philippines;6625;155;1339457;23276
2021-06-18;PH;Philippines;6819;109;1346276;23385
2021-06-19;PH;Philippines;6944;153;1353220;23538
2021-06-20;PH;Philippines;5795;83;1359015;23621
2021-06-21;PH;Philippines;5224;128;1364239;23749
2021-06-22;PH;Philippines;3655;60;1367894;23809
2021-06-23;PH;Philippines;4338;119;1372232;23928
2021-06-24;PH;Philippines;6028;108;1378260;24036
2021-06-25;PH;Philippines;6793;116;1385053;24152
2021-06-26;PH;Philippines;6858;92;1391911;24244
2021-06-27;PH;Philippines;6081;128;1397992;24372
2021-06-28;PH;Philippines;5596;84;1403588;24456
2021-06-29;PH;Philippines;4470;101;1408058;24557
2021-06-30;PH;Philippines;4501;105;1412559;24662
2021-07-01;PH;Philippines;5778;135;1418337;24797
2021-06-15;PN;Pitcairn;0;0;0;0
2021-06-16;PN;Pitcairn;0;0;0;0
2021-06-17;PN;Pitcairn;0;0;0;0
2021-06-18;PN;Pitcairn;0;0;0;0
2021-06-19;PN;Pitcairn;0;0;0;0
2021-06-20;PN;Pitcairn;0;0;0;0
2021-06-21;PN;Pitcairn;0;0;0;0
2020-03-04;PL;Poland;1;0;1;0
2020-03-05;PL;Poland;0;0;1;0
2020-03-06;PL;Poland;4;0;5;0
2020-03-07;PL;Poland;0;0;5;0
2020-03-08;PL;Poland;6;0;11;0
2020-03-09;PL;Poland;5;0;16;0
2020-03-10;PL;Poland;6;0;22;0
2020-03-11;PL;Poland;9;0;31;0
2020-03-12;PL;Poland;18;1;49;1
2020-03-13;PL;Poland;19;1;68;2
2020-03-14;PL;Poland;35;1;103;3
2020-03-15;PL;Poland;16;0;119;3
2020-03-16;PL;Poland;58;1;177;4
2020-03-17;PL;Poland;61;1;238;5
2020-03-18;PL;Poland;13;0;251;5
2020-03-19;PL;Poland;104;0;355;5
2020-03-20;PL;Poland;70;0;425;5
2020-03-21;PL;Poland;111;0;536;5
2020-03-22;PL;Poland;98;2;634;7
2020-03-23;PL;Poland;115;1;749;8
2020-03-24;PL;Poland;152;2;901;10
2020-03-25;PL;Poland;150;4;1051;14
2020-03-26;PL;Poland;170;2;1221;16
2020-03-27;PL;Poland;168;0;1389;16
2020-03-28;PL;Poland;249;2;1638;18
2020-03-29;PL;Poland;224;4;1862;22
2020-03-30;PL;Poland;193;9;2055;31
2020-03-31;PL;Poland;256;2;2311;33
2020-04-01;PL;Poland;243;10;2554;43
2020-04-02;PL;Poland;392;14;2946;57
2020-04-03;PL;Poland;437;14;3383;71
2020-04-04;PL;Poland;244;8;3627;79
2020-04-05;PL;Poland;475;15;4102;94
2020-04-06;PL;Poland;311;13;4413;107
2020-04-07;PL;Poland;435;22;4848;129
2020-04-08;PL;Poland;357;30;5205;159
2020-04-09;PL;Poland;370;15;5575;174
2020-04-10;PL;Poland;380;7;5955;181
2020-04-11;PL;Poland;401;27;6356;208
2020-04-12;PL;Poland;318;24;6674;232
2020-04-13;PL;Poland;260;13;6934;245
2020-04-14;PL;Poland;268;18;7202;263
2020-04-15;PL;Poland;380;23;7582;286
2020-04-16;PL;Poland;336;28;7918;314
2020-04-17;PL;Poland;461;18;8379;332
2020-04-18;PL;Poland;363;15;8742;347
2020-04-19;PL;Poland;545;13;9287;360
2020-04-20;PL;Poland;306;20;9593;380
2020-04-21;PL;Poland;263;21;9856;401
2020-04-22;PL;Poland;313;25;10169;426
2020-04-23;PL;Poland;342;28;10511;454
2020-04-24;PL;Poland;381;40;10892;494
2020-04-25;PL;Poland;381;30;11273;524
2020-04-26;PL;Poland;344;11;11617;535
2020-04-27;PL;Poland;285;27;11902;562
2020-04-28;PL;Poland;316;34;12218;596
2020-04-29;PL;Poland;422;28;12640;624
2020-04-30;PL;Poland;237;20;12877;644
2020-05-01;PL;Poland;228;7;13105;651
2020-05-02;PL;Poland;270;13;13375;664
2020-05-03;PL;Poland;318;14;13693;678
2020-05-04;PL;Poland;313;20;14006;698
2020-05-05;PL;Poland;425;18;14431;716
2020-05-06;PL;Poland;309;17;14740;733
2020-05-07;PL;Poland;307;22;15047;755
2020-05-08;PL;Poland;319;21;15366;776
2020-05-09;PL;Poland;285;9;15651;785
2020-05-10;PL;Poland;345;15;15996;800
2020-05-11;PL;Poland;330;11;16326;811
2020-05-12;PL;Poland;595;28;16921;839
2020-05-13;PL;Poland;283;22;17204;861
2020-05-14;PL;Poland;411;22;17615;883
2020-05-15;PL;Poland;401;24;18016;907
2020-05-16;PL;Poland;241;8;18257;915
2020-05-17;PL;Poland;272;10;18529;925
2020-05-18;PL;Poland;356;11;18885;936
2020-05-19;PL;Poland;383;12;19268;948
2020-05-20;PL;Poland;471;14;19739;962
2020-05-21;PL;Poland;404;10;20143;972
2020-05-22;PL;Poland;476;10;20619;982
2020-05-23;PL;Poland;312;11;20931;993
2020-05-24;PL;Poland;395;3;21326;996
2020-05-25;PL;Poland;305;11;21631;1007
2020-05-26;PL;Poland;443;17;22074;1024
2020-05-27;PL;Poland;399;4;22473;1028
2020-05-28;PL;Poland;352;10;22825;1038
2020-05-29;PL;Poland;330;13;23155;1051
2020-05-30;PL;Poland;416;10;23571;1061
2020-05-31;PL;Poland;215;3;23786;1064
2020-06-01;PL;Poland;379;10;24165;1074
2020-06-02;PL;Poland;230;18;24395;1092
2020-06-03;PL;Poland;292;23;24687;1115
2020-06-04;PL;Poland;361;2;25048;1117
2020-06-05;PL;Poland;362;20;25410;1137
2020-06-06;PL;Poland;576;16;25986;1153
2020-06-07;PL;Poland;575;4;26561;1157
2020-06-08;PL;Poland;599;9;27160;1166
2020-06-09;PL;Poland;400;17;27560;1183
2020-06-10;PL;Poland;282;23;27842;1206
2020-06-11;PL;Poland;359;9;28201;1215
2020-06-12;PL;Poland;376;7;28577;1222
2020-06-13;PL;Poland;440;15;29017;1237
2020-06-14;PL;Poland;375;10;29392;1247
2020-06-15;PL;Poland;396;9;29788;1256
2020-06-16;PL;Poland;407;16;30195;1272
2020-06-17;PL;Poland;506;14;30701;1286
2020-06-18;PL;Poland;314;30;31015;1316
2020-06-19;PL;Poland;301;18;31316;1334
2020-06-20;PL;Poland;304;12;31620;1346
2020-06-21;PL;Poland;311;10;31931;1356
2020-06-22;PL;Poland;296;3;32227;1359
2020-06-23;PL;Poland;300;16;32527;1375
2020-06-24;PL;Poland;294;21;32821;1396
2020-06-25;PL;Poland;298;16;33119;1412
2020-06-26;PL;Poland;276;17;33395;1429
2020-06-27;PL;Poland;319;6;33714;1435
2020-06-28;PL;Poland;193;3;33907;1438
2020-06-29;PL;Poland;247;6;34154;1444
2020-06-30;PL;Poland;239;19;34393;1463
2020-07-01;PL;Poland;382;14;34775;1477
2020-07-02;PL;Poland;371;15;35146;1492
2020-07-03;PL;Poland;259;15;35405;1507
2020-07-04;PL;Poland;314;5;35719;1512
2020-07-05;PL;Poland;231;5;35950;1517
2020-07-06;PL;Poland;205;4;36155;1521
2020-07-07;PL;Poland;257;7;36412;1528
2020-07-08;PL;Poland;277;14;36689;1542
2020-07-09;PL;Poland;262;9;36951;1551
2020-07-10;PL;Poland;265;11;37216;1562
2020-07-11;PL;Poland;305;6;37521;1568
2020-07-12;PL;Poland;370;3;37891;1571
2020-07-13;PL;Poland;299;5;38190;1576
2020-07-14;PL;Poland;267;12;38457;1588
2020-07-15;PL;Poland;264;6;38721;1594
2020-07-16;PL;Poland;333;11;39054;1605
2020-07-17;PL;Poland;353;7;39407;1612
2020-07-18;PL;Poland;339;6;39746;1618
2020-07-19;PL;Poland;358;6;40104;1624
2020-07-20;PL;Poland;279;3;40383;1627
2020-07-21;PL;Poland;399;9;40782;1636
2020-07-22;PL;Poland;380;6;41162;1642
2020-07-23;PL;Poland;418;9;41580;1651
2020-07-24;PL;Poland;458;4;42038;1655
2020-07-25;PL;Poland;584;9;42622;1664
2020-07-26;PL;Poland;443;7;43065;1671
2020-07-27;PL;Poland;337;5;43402;1676
2020-07-28;PL;Poland;502;6;43904;1682
2020-07-29;PL;Poland;512;12;44416;1694
2020-07-30;PL;Poland;615;15;45031;1709
2020-07-31;PL;Poland;657;7;45688;1716
2020-08-01;PL;Poland;658;5;46346;1721
2020-08-02;PL;Poland;548;10;46894;1731
2020-08-03;PL;Poland;575;1;47469;1732
2020-08-04;PL;Poland;680;6;48149;1738
2020-08-05;PL;Poland;640;18;48789;1756
2020-08-06;PL;Poland;726;18;49515;1774
2020-08-07;PL;Poland;809;13;50324;1787
2020-08-08;PL;Poland;843;13;51167;1800
2020-08-09;PL;Poland;624;7;51791;1807
2020-08-10;PL;Poland;619;2;52410;1809
2020-08-11;PL;Poland;551;12;52961;1821
2020-08-12;PL;Poland;715;9;53676;1830
2020-08-13;PL;Poland;811;14;54487;1844
2020-08-14;PL;Poland;832;14;55319;1858
2020-08-15;PL;Poland;771;11;56090;1869
2020-08-16;PL;Poland;594;8;56684;1877
2020-08-17;PL;Poland;595;8;57279;1885
2020-08-18;PL;Poland;597;11;57876;1896
2020-08-19;PL;Poland;735;17;58611;1913
2020-08-20;PL;Poland;767;12;59378;1925
2020-08-21;PL;Poland;903;13;60281;1938
2020-08-22;PL;Poland;900;13;61181;1951
2020-08-23;PL;Poland;581;4;61762;1955
2020-08-24;PL;Poland;548;5;62310;1960
2020-08-25;PL;Poland;763;17;63073;1977
2020-08-26;PL;Poland;729;17;63802;1994
2020-08-27;PL;Poland;887;16;64689;2010
2020-08-28;PL;Poland;791;8;65480;2018
2020-08-29;PL;Poland;759;14;66239;2032
2020-08-30;PL;Poland;631;1;66870;2033
2020-08-31;PL;Poland;502;6;67372;2039
2020-09-01;PL;Poland;550;19;67922;2058
2020-09-02;PL;Poland;595;20;68517;2078
2020-09-03;PL;Poland;612;14;69129;2092
2020-09-04;PL;Poland;691;8;69820;2100
2020-09-05;PL;Poland;567;13;70387;2113
2020-09-06;PL;Poland;437;7;70824;2120
2020-09-07;PL;Poland;302;4;71126;2124
2020-09-08;PL;Poland;400;12;71526;2136
2020-09-09;PL;Poland;421;11;71947;2147
2020-09-10;PL;Poland;506;12;72453;2159
2020-09-11;PL;Poland;594;10;73047;2169
2020-09-12;PL;Poland;603;13;73650;2182
2020-09-13;PL;Poland;502;6;74152;2188
2020-09-14;PL;Poland;377;15;74529;2203
2020-09-15;PL;Poland;605;24;75134;2227
2020-09-16;PL;Poland;600;10;75734;2237
2020-09-17;PL;Poland;837;16;76571;2253
2020-09-18;PL;Poland;757;17;77328;2270
2020-09-19;PL;Poland;1002;12;78330;2282
2020-09-20;PL;Poland;910;11;79240;2293
2020-09-21;PL;Poland;748;5;79988;2298
2020-09-22;PL;Poland;711;18;80699;2316
2020-09-23;PL;Poland;974;28;81673;2344
2020-09-24;PL;Poland;1136;25;82809;2369
2020-09-25;PL;Poland;1587;23;84396;2392
2020-09-26;PL;Poland;1584;32;85980;2424
2020-09-27;PL;Poland;1350;8;87330;2432
2020-09-28;PL;Poland;1306;15;88636;2447
2020-09-29;PL;Poland;1326;36;89962;2483
2020-09-30;PL;Poland;1552;30;91514;2513
2020-10-01;PL;Poland;1967;30;93481;2543
2020-10-02;PL;Poland;2292;27;95773;2570
2020-10-03;PL;Poland;2367;34;98140;2604
2020-10-04;PL;Poland;1934;26;100074;2630
2020-10-05;PL;Poland;2006;29;102080;2659
2020-10-06;PL;Poland;2236;58;104316;2717
2020-10-07;PL;Poland;3003;75;107319;2792
2020-10-08;PL;Poland;4280;75;111599;2867
2020-10-09;PL;Poland;4739;52;116338;2919
2020-10-10;PL;Poland;5300;53;121638;2972
2020-10-11;PL;Poland;4178;32;125816;3004
2020-10-12;PL;Poland;4394;35;130210;3039
2020-10-13;PL;Poland;5068;62;135278;3101
2020-10-14;PL;Poland;6526;116;141804;3217
2020-10-15;PL;Poland;8099;91;149903;3308
2020-10-16;PL;Poland;7705;132;157608;3440
2020-10-17;PL;Poland;9622;84;167230;3524
2020-10-18;PL;Poland;8536;49;175766;3573
2020-10-19;PL;Poland;7482;41;183248;3614
2020-10-20;PL;Poland;9291;107;192539;3721
2020-10-21;PL;Poland;10040;130;202579;3851
2020-10-22;PL;Poland;12107;168;214686;4019
2020-10-23;PL;Poland;13632;153;228318;4172
2020-10-24;PL;Poland;13628;179;241946;4351
2020-10-25;PL;Poland;11742;87;253688;4438
2020-10-26;PL;Poland;10241;45;263929;4483
2020-10-27;PL;Poland;16300;132;280229;4615
2020-10-28;PL;Poland;18820;234;299049;4849
2020-10-29;PL;Poland;20156;300;319205;5149
2020-10-30;PL;Poland;21629;202;340834;5351
2020-10-31;PL;Poland;21897;280;362731;5631
2020-11-01;PL;Poland;17171;152;379902;5783
2020-11-02;PL;Poland;15578;92;395480;5875
2020-11-03;PL;Poland;19364;227;414844;6102
2020-11-04;PL;Poland;24692;373;439536;6475
2020-11-05;PL;Poland;27143;367;466679;6842
2020-11-06;PL;Poland;27086;445;493765;7287
2020-11-07;PL;Poland;27875;349;521640;7636
2020-11-08;PL;Poland;24785;236;546425;7872
2020-11-09;PL;Poland;21713;173;568138;8045
2020-11-10;PL;Poland;25454;330;593592;8375
2020-11-11;PL;Poland;25221;430;618813;8805
2020-11-12;PL;Poland;22683;275;641496;9080
2020-11-13;PL;Poland;24051;419;665547;9499
2020-11-14;PL;Poland;25571;546;691118;10045
2020-11-15;PL;Poland;21854;303;712972;10348
2020-11-16;PL;Poland;20816;143;733788;10491
2020-11-17;PL;Poland;19152;357;752940;10848
2020-11-18;PL;Poland;19883;603;772823;11451
2020-11-19;PL;Poland;23975;637;796798;12088
2020-11-20;PL;Poland;22464;626;819262;12714
2020-11-21;PL;Poland;24213;574;843475;13288
2020-11-22;PL;Poland;17856;330;861331;13618
2020-11-23;PL;Poland;15002;156;876333;13774
2020-11-24;PL;Poland;32733;540;909066;14314
2020-11-25;PL;Poland;15356;674;924422;14988
2020-11-26;PL;Poland;16690;580;941112;15568
2020-11-27;PL;Poland;17304;579;958416;16147
2020-11-28;PL;Poland;15177;599;973593;16746
2020-11-29;PL;Poland;11482;283;985075;17029
2020-11-30;PL;Poland;5736;121;990811;17150
2020-12-01;PL;Poland;9113;449;999924;17599
2020-12-02;PL;Poland;13823;609;1013747;18208
2020-12-03;PL;Poland;14863;620;1028610;18828
2020-12-04;PL;Poland;13236;531;1041846;19359
2020-12-05;PL;Poland;12427;502;1054273;19861
2020-12-06;PL;Poland;9176;228;1063449;20089
2020-12-07;PL;Poland;4421;92;1067870;20181
2020-12-08;PL;Poland;8310;411;1076180;20592
2020-12-09;PL;Poland;12166;568;1088346;21160
2020-12-10;PL;Poland;13750;470;1102096;21630
2020-12-11;PL;Poland;13105;544;1115201;22174
2020-12-12;PL;Poland;11499;502;1126700;22676
2020-12-13;PL;Poland;8976;188;1135676;22864
2020-12-14;PL;Poland;4896;96;1140572;22960
2020-12-15;PL;Poland;6874;349;1147446;23309
2020-12-16;PL;Poland;12455;605;1159901;23914
2020-12-17;PL;Poland;11953;431;1171854;24345
2020-12-18;PL;Poland;11010;426;1182864;24771
2020-12-19;PL;Poland;11246;483;1194110;25254
2020-12-20;PL;Poland;8590;143;1202700;25397
2020-12-21;PL;Poland;4633;77;1207333;25474
2020-12-22;PL;Poland;7192;309;1214525;25783
2020-12-23;PL;Poland;12358;472;1226883;26255
2020-12-24;PL;Poland;13115;497;1239998;26752
2020-12-25;PL;Poland;9081;240;1249079;26992
2020-12-26;PL;Poland;4878;69;1253957;27061
2020-12-27;PL;Poland;3842;57;1257799;27118
2020-12-28;PL;Poland;3211;29;1261010;27147
2020-12-29;PL;Poland;7624;307;1268634;27454
2020-12-30;PL;Poland;12780;565;1281414;28019
2020-12-31;PL;Poland;13464;535;1294878;28554
2021-01-01;PL;Poland;10896;402;1305774;28956
2021-01-02;PL;Poland;7006;102;1312780;29058
2021-01-03;PL;Poland;5782;61;1318562;29119
2021-01-04;PL;Poland;4385;42;1322947;29161
2021-01-05;PL;Poland;7596;341;1330543;29502
2021-01-06;PL;Poland;14220;553;1344763;30055
2021-01-07;PL;Poland;12119;186;1356882;30241
2021-01-08;PL;Poland;8763;333;1365645;30574
2021-01-09;PL;Poland;10744;437;1376389;31011
2021-01-10;PL;Poland;9133;178;1385522;31189
2021-01-11;PL;Poland;4863;75;1390385;31264
2021-01-12;PL;Poland;5394;329;1395779;31593
2021-01-13;PL;Poland;9126;481;1404905;32074
2021-01-14;PL;Poland;9457;382;1414362;32456
2021-01-15;PL;Poland;7958;388;1422320;32844
2021-01-16;PL;Poland;7292;369;1429612;33213
2021-01-17;PL;Poland;5970;142;1435582;33355
2021-01-18;PL;Poland;3332;52;1438914;33407
2021-01-19;PL;Poland;4890;291;1443804;33698
2021-01-20;PL;Poland;6943;443;1450747;34141
2021-01-21;PL;Poland;7008;420;1457755;34561
2021-01-22;PL;Poland;6693;347;1464448;34908
2021-01-23;PL;Poland;6431;345;1470879;35253
2021-01-24;PL;Poland;4566;110;1475445;35363
2021-01-25;PL;Poland;2674;38;1478119;35401
2021-01-26;PL;Poland;4603;264;1482722;35665
2021-01-27;PL;Poland;6790;389;1489512;36054
2021-01-28;PL;Poland;7153;389;1496665;36443
2021-01-29;PL;Poland;6145;337;1502810;36780
2021-01-30;PL;Poland;5864;302;1508674;37082
2021-01-31;PL;Poland;4711;98;1513385;37180
2021-02-01;PL;Poland;2504;42;1515889;37222
2021-02-02;PL;Poland;4326;254;1520215;37476
2021-02-03;PL;Poland;6801;421;1527016;37897
2021-02-04;PL;Poland;6495;447;1533511;38344
2021-02-05;PL;Poland;6053;368;1539564;38712
2021-02-06;PL;Poland;5966;282;1545530;38994
2021-02-07;PL;Poland;4725;93;1550255;39087
2021-02-08;PL;Poland;2431;45;1552686;39132
2021-02-09;PL;Poland;3999;228;1556685;39360
2021-02-10;PL;Poland;6960;361;1563645;39721
2021-02-11;PL;Poland;7013;456;1570658;40177
2021-02-12;PL;Poland;6378;247;1577036;40424
2021-02-13;PL;Poland;6585;285;1583621;40709
2021-02-14;PL;Poland;5334;98;1588955;40807
2021-02-15;PL;Poland;2542;25;1591497;40832
2021-02-16;PL;Poland;5176;196;1596673;41028
2021-02-17;PL;Poland;8699;280;1605372;41308
2021-02-18;PL;Poland;9074;274;1614446;41582
2021-02-19;PL;Poland;8772;241;1623218;41823
2021-02-20;PL;Poland;8509;254;1631727;42077
2021-02-21;PL;Poland;7040;94;1638767;42171
2021-02-22;PL;Poland;3891;17;1642658;42188
2021-02-23;PL;Poland;6304;248;1648962;42436
2021-02-24;PL;Poland;12147;372;1661109;42808
2021-02-25;PL;Poland;12143;286;1673252;43094
2021-02-26;PL;Poland;11536;259;1684788;43353
2021-02-27;PL;Poland;12097;303;1696885;43656
2021-02-28;PL;Poland;10101;113;1706986;43769
2021-03-01;PL;Poland;4786;24;1711772;43793
2021-03-02;PL;Poland;7936;215;1719708;44008
2021-03-03;PL;Poland;15698;352;1735406;44360
2021-03-04;PL;Poland;15253;289;1750659;44649
2021-03-05;PL;Poland;15831;263;1766490;44912
2021-03-06;PL;Poland;14855;247;1781345;45159
2021-03-07;PL;Poland;13569;126;1794914;45285
2021-03-08;PL;Poland;6169;32;1801083;45317
2021-03-09;PL;Poland;9953;282;1811036;45599
2021-03-10;PL;Poland;17277;398;1828313;45997
2021-03-11;PL;Poland;21111;376;1849424;46373
2021-03-12;PL;Poland;18873;351;1868297;46724
2021-03-13;PL;Poland;21063;344;1889360;47068
2021-03-14;PL;Poland;17272;110;1906632;47178
2021-03-15;PL;Poland;10895;28;1917527;47206
2021-03-16;PL;Poland;14394;372;1931921;47578
2021-03-17;PL;Poland;25053;454;1956974;48032
2021-03-18;PL;Poland;27274;356;1984248;48388
2021-03-19;PL;Poland;25996;419;2010244;48807
2021-03-20;PL;Poland;26456;352;2036700;49159
2021-03-21;PL;Poland;21850;141;2058550;49300
2021-03-22;PL;Poland;14579;65;2073129;49365
2021-03-23;PL;Poland;16740;396;2089869;49761
2021-03-24;PL;Poland;30802;579;2120671;50340
2021-03-25;PL;Poland;34150;520;2154821;50860
2021-03-26;PL;Poland;35145;445;2189966;51305
2021-03-27;PL;Poland;31759;448;2221725;51753
2021-03-28;PL;Poland;29266;131;2250991;51884
2021-03-29;PL;Poland;16973;48;2267964;51932
2021-03-30;PL;Poland;20862;460;2288826;52392
2021-03-31;PL;Poland;32891;653;2321717;53045
2021-04-01;PL;Poland;35253;620;2356970;53665
2021-04-02;PL;Poland;30541;500;2387511;54165
2021-04-03;PL;Poland;28073;572;2415584;54737
2021-04-04;PL;Poland;22958;204;2438542;54941
2021-04-05;PL;Poland;9921;64;2448463;55005
2021-04-06;PL;Poland;8246;60;2456709;55065
2021-04-07;PL;Poland;14908;638;2471617;55703
2021-04-08;PL;Poland;27890;956;2499507;56659
2021-04-09;PL;Poland;28499;768;2528006;57427
2021-04-10;PL;Poland;24892;749;2552898;58176
2021-04-11;PL;Poland;21733;245;2574631;58421
2021-04-12;PL;Poland;12016;60;2586647;58481
2021-04-13;PL;Poland;13203;645;2599850;59126
2021-04-14;PL;Poland;21266;804;2621116;59930
2021-04-15;PL;Poland;21126;682;2642242;60612
2021-04-16;PL;Poland;17846;596;2660088;61208
2021-04-17;PL;Poland;15786;617;2675874;61825
2021-04-18;PL;Poland;12151;207;2688025;62032
2021-04-19;PL;Poland;7302;101;2695327;62133
2021-04-20;PL;Poland;9244;601;2704571;62734
2021-04-21;PL;Poland;13922;739;2718493;63473
2021-04-22;PL;Poland;12763;695;2731256;64168
2021-04-23;PL;Poland;10866;539;2742122;64707
2021-04-24;PL;Poland;9510;515;2751632;65222
2021-04-25;PL;Poland;7224;193;2758856;65415
2021-04-26;PL;Poland;3467;22;2762323;65437
2021-04-27;PL;Poland;5711;460;2768034;65897
2021-04-28;PL;Poland;8893;636;2776927;66533
2021-04-29;PL;Poland;8426;540;2785353;67073
2021-04-30;PL;Poland;6789;429;2792142;67502
2021-05-01;PL;Poland;6475;422;2798617;67924
2021-05-02;PL;Poland;4616;144;2803233;68068
2021-05-03;PL;Poland;2523;37;2805756;68105
2021-05-04;PL;Poland;2296;28;2808052;68133
2021-05-05;PL;Poland;3899;349;2811951;68482
2021-05-06;PL;Poland;6427;511;2818378;68993
2021-05-07;PL;Poland;6047;452;2824425;69445
2021-05-08;PL;Poland;4771;421;2829196;69866
2021-05-09;PL;Poland;3856;146;2833052;70012
2021-05-10;PL;Poland;2031;22;2835083;70034
2021-05-11;PL;Poland;3097;302;2838180;70336
2021-05-12;PL;Poland;4159;343;2842339;70679
2021-05-13;PL;Poland;3423;342;2845762;71021
2021-05-14;PL;Poland;3252;290;2849014;71311
2021-05-15;PL;Poland;2897;298;2851911;71609
2021-05-16;PL;Poland;2168;55;2854079;71664
2021-05-17;PL;Poland;1111;11;2855190;71675
2021-05-18;PL;Poland;1734;245;2856924;71920
2021-05-19;PL;Poland;2337;330;2859261;72250
2021-05-20;PL;Poland;2090;250;2861351;72500
2021-05-21;PL;Poland;1680;191;2863031;72691
2021-05-22;PL;Poland;1515;191;2864546;72882
2021-05-23;PL;Poland;1076;46;2865622;72928
2021-05-24;PL;Poland;559;17;2866181;72945
2021-05-25;PL;Poland;1006;151;2867187;73096
2021-05-26;PL;Poland;1263;209;2868450;73305
2021-05-27;PL;Poland;1202;135;2869652;73440
2021-05-28;PL;Poland;943;117;2870595;73557
2021-05-29;PL;Poland;776;125;2871371;73682
2021-05-30;PL;Poland;579;56;2871950;73738
2021-05-31;PL;Poland;333;7;2872283;73745
2021-06-01;PL;Poland;585;111;2872868;73856
2021-06-02;PL;Poland;659;128;2873527;73984
2021-06-03;PL;Poland;565;91;2874092;74075
2021-06-04;PL;Poland;319;26;2874411;74101
2021-06-05;PL;Poland;413;38;2874824;74139
2021-06-06;PL;Poland;312;13;2875136;74152
2021-06-07;PL;Poland;192;8;2875328;74160
2021-06-08;PL;Poland;401;95;2875729;74255
2021-06-09;PL;Poland;560;108;2876289;74363
2021-06-10;PL;Poland;378;84;2876667;74447
2021-06-11;PL;Poland;340;68;2877007;74515
2021-06-12;PL;Poland;236;47;2877243;74562
2021-06-13;PL;Poland;226;11;2877469;74573
2021-06-14;PL;Poland;139;1;2877608;74574
2021-06-15;PL;Poland;211;52;2877819;74626
2021-06-16;PL;Poland;242;62;2878061;74688
2021-06-17;PL;Poland;215;46;2878276;74734
2021-06-18;PL;Poland;190;48;2878466;74782
2021-06-19;PL;Poland;168;41;2878634;74823
2021-06-20;PL;Poland;133;5;2878767;74828
2021-06-21;PL;Poland;73;1;2878840;74829
2021-06-22;PL;Poland;190;29;2879030;74858
2021-06-23;PL;Poland;162;35;2879192;74893
2021-06-24;PL;Poland;144;24;2879336;74917
2021-06-25;PL;Poland;134;36;2879470;74953
2021-06-26;PL;Poland;99;21;2879569;74974
2021-06-27;PL;Poland;69;5;2879638;74979
2021-06-28;PL;Poland;51;0;2879689;74979
2021-06-29;PL;Poland;122;26;2879811;75005
2021-06-30;PL;Poland;101;16;2879912;75021
2021-07-01;PL;Poland;98;23;2880010;75044
2020-01-06;PT;Portugal;0;0;0;0
2020-01-18;PT;Portugal;0;0;0;0
2020-01-24;PT;Portugal;0;0;0;0
2020-02-02;PT;Portugal;0;0;0;0
2020-02-09;PT;Portugal;0;0;0;0
2020-02-15;PT;Portugal;0;0;0;0
2020-02-23;PT;Portugal;0;0;0;0
2020-03-01;PT;Portugal;0;0;0;0
2020-03-02;PT;Portugal;2;0;2;0
2020-03-03;PT;Portugal;0;0;2;0
2020-03-04;PT;Portugal;3;0;5;0
2020-03-05;PT;Portugal;3;0;8;0
2020-03-06;PT;Portugal;5;0;13;0
2020-03-07;PT;Portugal;7;0;20;0
2020-03-08;PT;Portugal;10;0;30;0
2020-03-09;PT;Portugal;0;0;30;0
2020-03-10;PT;Portugal;11;0;41;0
2020-03-11;PT;Portugal;18;0;59;0
2020-03-12;PT;Portugal;0;0;59;0
2020-03-13;PT;Portugal;53;0;112;0
2020-03-14;PT;Portugal;57;0;169;0
2020-03-15;PT;Portugal;76;0;245;0
2020-03-16;PT;Portugal;86;0;331;0
2020-03-17;PT;Portugal;117;1;448;1
2020-03-18;PT;Portugal;0;1;448;2
2020-03-19;PT;Portugal;337;1;785;3
2020-03-20;PT;Portugal;235;3;1020;6
2020-03-21;PT;Portugal;260;6;1280;12
2020-03-22;PT;Portugal;320;2;1600;14
2020-03-23;PT;Portugal;460;9;2060;23
2020-03-24;PT;Portugal;302;10;2362;33
2020-03-25;PT;Portugal;633;10;2995;43
2020-03-26;PT;Portugal;549;17;3544;60
2020-03-27;PT;Portugal;724;16;4268;76
2020-03-28;PT;Portugal;902;24;5170;100
2020-03-29;PT;Portugal;792;19;5962;119
2020-03-30;PT;Portugal;446;21;6408;140
2020-03-31;PT;Portugal;1035;20;7443;160
2020-04-01;PT;Portugal;808;27;8251;187
2020-04-02;PT;Portugal;783;22;9034;209
2020-04-03;PT;Portugal;852;37;9886;246
2020-04-04;PT;Portugal;638;20;10524;266
2020-04-05;PT;Portugal;754;29;11278;295
2020-04-06;PT;Portugal;452;16;11730;311
2020-04-07;PT;Portugal;712;34;12442;345
2020-04-08;PT;Portugal;699;35;13141;380
2020-04-09;PT;Portugal;815;29;13956;409
2020-04-10;PT;Portugal;1516;26;15472;435
2020-04-11;PT;Portugal;515;35;15987;470
2020-04-12;PT;Portugal;598;34;16585;504
2020-04-13;PT;Portugal;349;31;16934;535
2020-04-14;PT;Portugal;514;32;17448;567
2020-04-15;PT;Portugal;643;32;18091;599
2020-04-16;PT;Portugal;750;30;18841;629
2020-04-17;PT;Portugal;181;28;19022;657
2020-04-18;PT;Portugal;663;30;19685;687
2020-04-19;PT;Portugal;521;27;20206;714
2020-04-20;PT;Portugal;657;21;20863;735
2020-04-21;PT;Portugal;516;27;21379;762
2020-04-22;PT;Portugal;603;23;21982;785
2020-04-23;PT;Portugal;371;35;22353;820
2020-04-24;PT;Portugal;444;34;22797;854
2020-04-25;PT;Portugal;595;26;23392;880
2020-04-26;PT;Portugal;472;23;23864;903
2020-04-27;PT;Portugal;163;25;24027;928
2020-04-28;PT;Portugal;295;20;24322;948
2020-04-29;PT;Portugal;183;25;24505;973
2020-04-30;PT;Portugal;540;16;25045;989
2020-05-01;PT;Portugal;306;18;25351;1007
2020-05-02;PT;Portugal;-161;16;25190;1023
2020-05-03;PT;Portugal;92;20;25282;1043
2020-05-04;PT;Portugal;242;20;25524;1063
2020-05-05;PT;Portugal;178;11;25702;1074
2020-05-06;PT;Portugal;480;15;26182;1089
2020-05-07;PT;Portugal;533;16;26715;1105
2020-05-08;PT;Portugal;553;9;27268;1114
2020-05-09;PT;Portugal;138;12;27406;1126
2020-05-10;PT;Portugal;175;9;27581;1135
2020-05-11;PT;Portugal;98;9;27679;1144
2020-05-12;PT;Portugal;234;19;27913;1163
2020-05-13;PT;Portugal;219;12;28132;1175
2020-05-14;PT;Portugal;187;9;28319;1184
2020-05-15;PT;Portugal;264;6;28583;1190
2020-05-16;PT;Portugal;227;13;28810;1203
2020-05-17;PT;Portugal;226;15;29036;1218
2020-05-18;PT;Portugal;173;13;29209;1231
2020-05-19;PT;Portugal;223;16;29432;1247
2020-05-20;PT;Portugal;228;16;29660;1263
2020-05-21;PT;Portugal;252;14;29912;1277
2020-05-22;PT;Portugal;288;12;30200;1289
2020-05-23;PT;Portugal;271;13;30471;1302
2020-05-24;PT;Portugal;152;14;30623;1316
2020-05-25;PT;Portugal;165;14;30788;1330
2020-05-26;PT;Portugal;219;12;31007;1342
2020-05-27;PT;Portugal;285;14;31292;1356
2020-05-28;PT;Portugal;304;13;31596;1369
2020-05-29;PT;Portugal;350;14;31946;1383
2020-05-30;PT;Portugal;257;13;32203;1396
2020-05-31;PT;Portugal;297;14;32500;1410
2020-06-01;PT;Portugal;200;14;32700;1424
2020-06-02;PT;Portugal;195;12;32895;1436
2020-06-03;PT;Portugal;366;11;33261;1447
2020-06-04;PT;Portugal;331;8;33592;1455
2020-06-05;PT;Portugal;377;10;33969;1465
2020-06-06;PT;Portugal;382;9;34351;1474
2020-06-07;PT;Portugal;342;5;34693;1479
2020-06-08;PT;Portugal;192;6;34885;1485
2020-06-09;PT;Portugal;421;7;35306;1492
2020-06-10;PT;Portugal;294;5;35600;1497
2020-06-11;PT;Portugal;310;7;35910;1504
2020-06-12;PT;Portugal;270;1;36180;1505
2020-06-13;PT;Portugal;283;7;36463;1512
2020-06-14;PT;Portugal;227;5;36690;1517
2020-06-15;PT;Portugal;346;3;37036;1520
2020-06-16;PT;Portugal;300;2;37336;1522
2020-06-17;PT;Portugal;336;1;37672;1523
2020-06-18;PT;Portugal;417;1;38089;1524
2020-06-19;PT;Portugal;375;3;38464;1527
2020-06-20;PT;Portugal;377;1;38841;1528
2020-06-21;PT;Portugal;292;2;39133;1530
2020-06-22;PT;Portugal;259;4;39392;1534
2020-06-23;PT;Portugal;345;6;39737;1540
2020-06-24;PT;Portugal;367;3;40104;1543
2020-06-25;PT;Portugal;311;6;40415;1549
2020-06-26;PT;Portugal;451;6;40866;1555
2020-06-27;PT;Portugal;323;6;41189;1561
2020-06-28;PT;Portugal;457;3;41646;1564
2020-06-29;PT;Portugal;266;4;41912;1568
2020-06-30;PT;Portugal;229;8;42141;1576
2020-07-01;PT;Portugal;313;3;42454;1579
2020-07-02;PT;Portugal;328;8;42782;1587
2020-07-03;PT;Portugal;374;11;43156;1598
2020-07-04;PT;Portugal;413;7;43569;1605
2020-07-05;PT;Portugal;328;9;43897;1614
2020-07-06;PT;Portugal;232;6;44129;1620
2020-07-07;PT;Portugal;287;9;44416;1629
2020-07-08;PT;Portugal;443;2;44859;1631
2020-07-09;PT;Portugal;418;13;45277;1644
2020-07-10;PT;Portugal;402;2;45679;1646
2020-07-11;PT;Portugal;542;8;46221;1654
2020-07-12;PT;Portugal;291;6;46512;1660
2020-07-13;PT;Portugal;306;2;46818;1662
2020-07-14;PT;Portugal;233;6;47051;1668
2020-07-15;PT;Portugal;375;8;47426;1676
2020-07-16;PT;Portugal;339;3;47765;1679
2020-07-17;PT;Portugal;312;3;48077;1682
2020-07-18;PT;Portugal;313;2;48390;1684
2020-07-19;PT;Portugal;246;5;48636;1689
2020-07-20;PT;Portugal;135;2;48771;1691
2020-07-21;PT;Portugal;127;6;48898;1697
2020-07-22;PT;Portugal;252;5;49150;1702
2020-07-23;PT;Portugal;229;3;49379;1705
2020-07-24;PT;Portugal;313;7;49692;1712
2020-07-25;PT;Portugal;263;4;49955;1716
2020-07-26;PT;Portugal;209;1;50164;1717
2020-07-27;PT;Portugal;135;2;50299;1719
2020-07-28;PT;Portugal;111;3;50410;1722
2020-07-29;PT;Portugal;203;3;50613;1725
2020-07-30;PT;Portugal;255;2;50868;1727
2020-07-31;PT;Portugal;204;8;51072;1735
2020-08-01;PT;Portugal;238;2;51310;1737
2020-08-02;PT;Portugal;153;1;51463;1738
2020-08-03;PT;Portugal;106;0;51569;1738
2020-08-04;PT;Portugal;112;1;51681;1739
2020-08-05;PT;Portugal;167;1;51848;1740
2020-08-06;PT;Portugal;213;3;52061;1743
2020-08-07;PT;Portugal;290;3;52351;1746
2020-08-08;PT;Portugal;186;4;52537;1750
2020-08-09;PT;Portugal;131;6;52668;1756
2020-08-10;PT;Portugal;157;3;52825;1759
2020-08-11;PT;Portugal;120;2;52945;1761
2020-08-12;PT;Portugal;278;3;53223;1764
2020-08-13;PT;Portugal;325;6;53548;1770
2020-08-14;PT;Portugal;235;2;53783;1772
2020-08-15;PT;Portugal;198;3;53981;1775
2020-08-16;PT;Portugal;121;3;54102;1778
2020-08-17;PT;Portugal;132;1;54234;1779
2020-08-18;PT;Portugal;214;5;54448;1784
2020-08-19;PT;Portugal;253;2;54701;1786
2020-08-20;PT;Portugal;291;2;54992;1788
2020-08-21;PT;Portugal;219;4;55211;1792
2020-08-22;PT;Portugal;241;2;55452;1794
2020-08-23;PT;Portugal;145;2;55597;1796
2020-08-24;PT;Portugal;123;5;55720;1801
2020-08-25;PT;Portugal;192;4;55912;1805
2020-08-26;PT;Portugal;362;2;56274;1807
2020-08-27;PT;Portugal;399;2;56673;1809
2020-08-28;PT;Portugal;401;6;57074;1815
2020-08-29;PT;Portugal;374;3;57448;1818
2020-08-30;PT;Portugal;320;1;57768;1819
2020-08-31;PT;Portugal;244;3;58012;1822
2020-09-01;PT;Portugal;231;2;58243;1824
2020-09-02;PT;Portugal;390;3;58633;1827
2020-09-03;PT;Portugal;418;2;59051;1829
2020-09-04;PT;Portugal;406;4;59457;1833
2020-09-05;PT;Portugal;486;5;59943;1838
2020-09-06;PT;Portugal;315;2;60258;1840
2020-09-07;PT;Portugal;249;3;60507;1843
2020-09-08;PT;Portugal;388;3;60895;1846
2020-09-09;PT;Portugal;646;3;61541;1849
2020-09-10;PT;Portugal;585;3;62126;1852
2020-09-11;PT;Portugal;687;3;62813;1855
2020-09-12;PT;Portugal;497;5;63310;1860
2020-09-13;PT;Portugal;673;7;63983;1867
2020-09-14;PT;Portugal;613;4;64596;1871
2020-09-15;PT;Portugal;425;4;65021;1875
2020-09-16;PT;Portugal;605;3;65626;1878
2020-09-17;PT;Portugal;770;10;66396;1888
2020-09-18;PT;Portugal;780;6;67176;1894
2020-09-19;PT;Portugal;849;5;68025;1899
2020-09-20;PT;Portugal;552;13;68577;1912
2020-09-21;PT;Portugal;623;8;69200;1920
2020-09-22;PT;Portugal;463;5;69663;1925
2020-09-23;PT;Portugal;802;3;70465;1928
2020-09-24;PT;Portugal;691;3;71156;1931
2020-09-25;PT;Portugal;899;5;72055;1936
2020-09-26;PT;Portugal;884;8;72939;1944
2020-09-27;PT;Portugal;665;9;73604;1953
2020-09-28;PT;Portugal;425;4;74029;1957
2020-09-29;PT;Portugal;688;6;74717;1963
2020-09-30;PT;Portugal;825;8;75542;1971
2020-10-01;PT;Portugal;854;6;76396;1977
2020-10-02;PT;Portugal;888;6;77284;1983
2020-10-03;PT;Portugal;963;12;78247;1995
2020-10-04;PT;Portugal;904;10;79151;2005
2020-10-05;PT;Portugal;734;13;79885;2018
2020-10-06;PT;Portugal;427;14;80312;2032
2020-10-07;PT;Portugal;944;8;81256;2040
2020-10-08;PT;Portugal;1278;10;82534;2050
2020-10-09;PT;Portugal;1394;12;83928;2062
2020-10-10;PT;Portugal;1646;5;85574;2067
2020-10-11;PT;Portugal;1090;13;86664;2080
2020-10-12;PT;Portugal;1249;14;87913;2094
2020-10-13;PT;Portugal;1208;16;89121;2110
2020-10-14;PT;Portugal;2072;7;91193;2117
2020-10-15;PT;Portugal;2101;11;93294;2128
2020-10-16;PT;Portugal;2608;21;95902;2149
2020-10-17;PT;Portugal;2153;13;98055;2162
2020-10-18;PT;Portugal;1856;19;99911;2181
2020-10-19;PT;Portugal;1949;17;101860;2198
2020-10-20;PT;Portugal;1876;15;103736;2213
2020-10-21;PT;Portugal;2535;16;106271;2229
2020-10-22;PT;Portugal;3270;16;109541;2245
2020-10-23;PT;Portugal;2899;31;112440;2276
2020-10-24;PT;Portugal;3669;21;116109;2297
2020-10-25;PT;Portugal;2577;19;118686;2316
2020-10-26;PT;Portugal;2447;27;121133;2343
2020-10-27;PT;Portugal;3299;28;124432;2371
2020-10-28;PT;Portugal;3960;24;128392;2395
2020-10-29;PT;Portugal;4224;33;132616;2428
2020-10-30;PT;Portugal;4656;40;137272;2468
2020-10-31;PT;Portugal;4007;39;141279;2507
2020-11-01;PT;Portugal;3062;37;144341;2544
2020-11-02;PT;Portugal;2506;46;146847;2590
2020-11-03;PT;Portugal;2596;45;149443;2635
2020-11-04;PT;Portugal;7497;59;156940;2694
2020-11-05;PT;Portugal;4410;46;161350;2740
2020-11-06;PT;Portugal;5550;52;166900;2792
2020-11-07;PT;Portugal;6640;56;173540;2848
2020-11-08;PT;Portugal;5784;48;179324;2896
2020-11-09;PT;Portugal;4096;63;183420;2959
2020-11-10;PT;Portugal;3817;62;187237;3021
2020-11-11;PT;Portugal;4935;82;192172;3103
2020-11-12;PT;Portugal;5839;78;198011;3181
2020-11-13;PT;Portugal;6653;69;204664;3250
2020-11-14;PT;Portugal;6602;55;211266;3305
2020-11-15;PT;Portugal;6035;76;217301;3381
2020-11-16;PT;Portugal;8371;91;225672;3472
2020-11-17;PT;Portugal;4452;81;230124;3553
2020-11-18;PT;Portugal;5891;79;236015;3632
2020-11-19;PT;Portugal;6994;69;243009;3701
2020-11-20;PT;Portugal;6489;61;249498;3762
2020-11-21;PT;Portugal;6472;62;255970;3824
2020-11-22;PT;Portugal;4788;73;260758;3897
2020-11-23;PT;Portugal;4044;74;264802;3971
2020-11-24;PT;Portugal;3919;85;268721;4056
2020-11-25;PT;Portugal;5290;71;274011;4127
2020-11-26;PT;Portugal;6383;82;280394;4209
2020-11-27;PT;Portugal;5444;67;285838;4276
2020-11-28;PT;Portugal;4868;87;290706;4363
2020-11-29;PT;Portugal;4093;64;294799;4427
2020-11-30;PT;Portugal;3262;78;298061;4505
2020-12-01;PT;Portugal;2401;72;300462;4577
2020-12-02;PT;Portugal;3384;68;303846;4645
2020-12-03;PT;Portugal;3772;79;307618;4724
2020-12-04;PT;Portugal;4935;79;312553;4803
2020-12-05;PT;Portugal;6087;73;318640;4876
2020-12-06;PT;Portugal;3834;87;322474;4963
2020-12-07;PT;Portugal;2597;78;325071;5041
2020-12-08;PT;Portugal;2905;81;327976;5122
2020-12-09;PT;Portugal;4097;70;332073;5192
2020-12-10;PT;Portugal;3134;86;335207;5278
2020-12-11;PT;Portugal;5080;95;340287;5373
2020-12-12;PT;Portugal;4413;88;344700;5461
2020-12-13;PT;Portugal;4044;98;348744;5559
2020-12-14;PT;Portugal;2194;90;350938;5649
2020-12-15;PT;Portugal;2638;84;353576;5733
2020-12-16;PT;Portugal;4720;82;358296;5815
2020-12-17;PT;Portugal;4320;87;362616;5902
2020-12-18;PT;Portugal;4336;75;366952;5977
2020-12-19;PT;Portugal;3835;86;370787;6063
2020-12-20;PT;Portugal;3334;71;374121;6134
2020-12-21;PT;Portugal;2099;57;376220;6191
2020-12-22;PT;Portugal;2436;63;378656;6254
2020-12-23;PT;Portugal;4602;89;383258;6343
2020-12-24;PT;Portugal;4378;70;387636;6413
2020-12-25;PT;Portugal;4146;65;391782;6478
2020-12-26;PT;Portugal;1214;78;392996;6556
2020-12-27;PT;Portugal;1577;63;394573;6619
2020-12-28;PT;Portugal;2093;58;396666;6677
2020-12-29;PT;Portugal;3336;74;400002;6751
2020-12-30;PT;Portugal;6049;79;406051;6830
2020-12-31;PT;Portugal;7627;76;413678;6906
2021-01-01;PT;Portugal;6951;66;420629;6972
2021-01-02;PT;Portugal;3241;73;423870;7045
2021-01-03;PT;Portugal;3384;73;427254;7118
2021-01-04;PT;Portugal;4369;78;431623;7196
2021-01-05;PT;Portugal;4956;90;436579;7286
2021-01-06;PT;Portugal;10027;91;446606;7377
2021-01-07;PT;Portugal;9927;95;456533;7472
2021-01-08;PT;Portugal;10176;118;466709;7590
2021-01-09;PT;Portugal;9478;111;476187;7701
2021-01-10;PT;Portugal;7502;102;483689;7803
2021-01-11;PT;Portugal;5604;122;489293;7925
2021-01-12;PT;Portugal;7259;155;496552;8080
2021-01-13;PT;Portugal;10556;156;507108;8236
2021-01-14;PT;Portugal;10698;148;517806;8384
2021-01-15;PT;Portugal;10663;159;528469;8543
2021-01-16;PT;Portugal;10947;166;539416;8709
2021-01-17;PT;Portugal;10385;152;549801;8861
2021-01-18;PT;Portugal;6702;167;556503;9028
2021-01-19;PT;Portugal;10455;218;566958;9246
2021-01-20;PT;Portugal;14647;219;581605;9465
2021-01-21;PT;Portugal;13544;221;595149;9686
2021-01-22;PT;Portugal;13987;234;609136;9920
2021-01-23;PT;Portugal;15333;274;624469;10194
2021-01-24;PT;Portugal;11721;275;636190;10469
2021-01-25;PT;Portugal;6923;252;643113;10721
2021-01-26;PT;Portugal;10765;291;653878;11012
2021-01-27;PT;Portugal;15073;293;668951;11305
2021-01-28;PT;Portugal;16432;303;685383;11608
2021-01-29;PT;Portugal;13200;278;698583;11886
2021-01-30;PT;Portugal;12435;293;711018;12179
2021-01-31;PT;Portugal;9498;303;720516;12482
2021-02-01;PT;Portugal;5805;275;726321;12757
2021-02-02;PT;Portugal;5540;260;731861;13017
2021-02-03;PT;Portugal;9083;240;740944;13257
2021-02-04;PT;Portugal;7914;225;748858;13482
2021-02-05;PT;Portugal;6916;258;755774;13740
2021-02-06;PT;Portugal;6132;214;761906;13954
2021-02-07;PT;Portugal;3508;204;765414;14158
2021-02-08;PT;Portugal;2505;196;767919;14354
2021-02-09;PT;Portugal;2583;203;770502;14557
2021-02-10;PT;Portugal;4387;161;774889;14718
2021-02-11;PT;Portugal;3480;167;778369;14885
2021-02-12;PT;Portugal;2854;149;781223;15034
2021-02-13;PT;Portugal;2856;149;784079;15183
2021-02-14;PT;Portugal;1677;138;785756;15321
2021-02-15;PT;Portugal;1303;90;787059;15411
2021-02-16;PT;Portugal;1502;111;788561;15522
2021-02-17;PT;Portugal;2324;127;790885;15649
2021-02-18;PT;Portugal;1944;105;792829;15754
2021-02-19;PT;Portugal;1940;67;794769;15821
2021-02-20;PT;Portugal;1570;76;796339;15897
2021-02-21;PT;Portugal;1186;65;797525;15962
2021-02-22;PT;Portugal;549;61;798074;16023
2021-02-23;PT;Portugal;1032;63;799106;16086
2021-02-24;PT;Portugal;1480;50;800586;16136
2021-02-25;PT;Portugal;1160;49;801746;16185
2021-02-26;PT;Portugal;1027;58;802773;16243
2021-02-27;PT;Portugal;1071;33;803844;16276
2021-02-28;PT;Portugal;718;41;804562;16317
2021-03-01;PT;Portugal;394;34;804956;16351
2021-03-02;PT;Portugal;691;38;805647;16389
2021-03-03;PT;Portugal;979;41;806626;16430
2021-03-04;PT;Portugal;830;28;807456;16458
2021-03-05;PT;Portugal;949;28;808405;16486
2021-03-06;PT;Portugal;1007;26;809412;16512
2021-03-07;PT;Portugal;682;28;810094;16540
2021-03-08;PT;Portugal;365;25;810459;16565
2021-03-09;PT;Portugal;847;30;811306;16595
2021-03-10;PT;Portugal;642;22;811948;16617
2021-03-11;PT;Portugal;627;18;812575;16635
2021-03-12;PT;Portugal;577;15;813152;16650
2021-03-13;PT;Portugal;564;19;813716;16669
2021-03-14;PT;Portugal;541;15;814257;16684
2021-03-15;PT;Portugal;256;10;814513;16694
2021-03-16;PT;Portugal;384;13;814897;16707
2021-03-17;PT;Portugal;673;15;815570;16722
2021-03-18;PT;Portugal;485;21;816055;16743
2021-03-19;PT;Portugal;568;11;816623;16754
2021-03-20;PT;Portugal;457;8;817080;16762
2021-03-21;PT;Portugal;450;6;817530;16768
2021-03-22;PT;Portugal;248;16;817778;16784
2021-03-23;PT;Portugal;434;10;818212;16794
2021-03-24;PT;Portugal;575;11;818787;16805
2021-03-25;PT;Portugal;423;9;819210;16814
2021-03-26;PT;Portugal;488;5;819698;16819
2021-03-27;PT;Portugal;344;8;820042;16827
2021-03-28;PT;Portugal;365;10;820407;16837
2021-03-29;PT;Portugal;309;6;820716;16843
2021-03-30;PT;Portugal;388;2;821104;16845
2021-03-31;PT;Portugal;618;3;821722;16848
2021-04-01;PT;Portugal;592;11;822314;16859
2021-04-02;PT;Portugal;548;9;822862;16868
2021-04-03;PT;Portugal;280;7;823142;16875
2021-04-04;PT;Portugal;193;4;823335;16879
2021-04-05;PT;Portugal;159;6;823494;16885
2021-04-06;PT;Portugal;874;2;824368;16887
2021-04-07;PT;Portugal;663;3;825031;16890
2021-04-08;PT;Portugal;602;9;825633;16899
2021-04-09;PT;Portugal;694;5;826327;16904
2021-04-10;PT;Portugal;601;6;826928;16910
2021-04-11;PT;Portugal;566;6;827494;16916
2021-04-12;PT;Portugal;271;2;827765;16918
2021-04-13;PT;Portugal;408;5;828173;16923
2021-04-14;PT;Portugal;684;8;828857;16931
2021-04-15;PT;Portugal;501;2;829358;16933
2021-04-16;PT;Portugal;553;4;829911;16937
2021-04-17;PT;Portugal;649;5;830560;16942
2021-04-18;PT;Portugal;441;3;831001;16945
2021-04-19;PT;Portugal;220;1;831221;16946
2021-04-20;PT;Portugal;424;5;831645;16951
2021-04-21;PT;Portugal;610;1;832255;16952
2021-04-22;PT;Portugal;636;4;832891;16956
2021-04-23;PT;Portugal;506;1;833397;16957
2021-04-24;PT;Portugal;567;2;833964;16959
2021-04-25;PT;Portugal;478;6;834442;16965
2021-04-26;PT;Portugal;196;0;834638;16965
2021-04-27;PT;Portugal;353;5;834991;16970
2021-04-28;PT;Portugal;572;3;835563;16973
2021-04-29;PT;Portugal;470;1;836033;16974
2021-04-30;PT;Portugal;460;0;836493;16974
2021-05-01;PT;Portugal;454;2;836947;16976
2021-05-02;PT;Portugal;330;1;837277;16977
2021-05-03;PT;Portugal;180;0;837457;16977
2021-05-04;PT;Portugal;258;4;837715;16981
2021-05-05;PT;Portugal;387;2;838102;16983
2021-05-06;PT;Portugal;373;5;838475;16988
2021-05-07;PT;Portugal;377;1;838852;16989
2021-05-08;PT;Portugal;406;2;839258;16991
2021-05-09;PT;Portugal;324;1;839582;16992
2021-05-10;PT;Portugal;158;1;839740;16993
2021-05-11;PT;Portugal;268;1;840008;16994
2021-05-12;PT;Portugal;485;4;840493;16998
2021-05-13;PT;Portugal;436;1;840929;16999
2021-05-14;PT;Portugal;450;0;841379;16999
2021-05-15;PT;Portugal;469;7;841848;17006
2021-05-16;PT;Portugal;334;1;842182;17007
2021-05-17;PT;Portugal;199;2;842381;17009
2021-05-18;PT;Portugal;386;2;842767;17011
2021-05-19;PT;Portugal;511;2;843278;17013
2021-05-20;PT;Portugal;451;1;843729;17014
2021-05-21;PT;Portugal;559;3;844288;17017
2021-05-22;PT;Portugal;523;0;844811;17017
2021-05-23;PT;Portugal;413;0;845224;17017
2021-05-24;PT;Portugal;241;1;845465;17018
2021-05-25;PT;Portugal;375;3;845840;17021
2021-05-26;PT;Portugal;594;1;846434;17022
2021-05-27;PT;Portugal;572;0;847006;17022
2021-05-28;PT;Portugal;598;1;847604;17023
2021-05-29;PT;Portugal;609;0;848213;17023
2021-05-30;PT;Portugal;445;0;848658;17023
2021-05-31;PT;Portugal;435;2;849093;17025
2021-06-01;PT;Portugal;445;0;849538;17025
2021-06-02;PT;Portugal;724;1;850262;17026
2021-06-03;PT;Portugal;769;3;851031;17029
2021-06-04;PT;Portugal;430;0;851461;17029
2021-06-05;PT;Portugal;573;3;852034;17032
2021-06-06;PT;Portugal;612;2;852646;17034
2021-06-07;PT;Portugal;388;2;853034;17036
2021-06-08;PT;Portugal;598;1;853632;17037
2021-06-09;PT;Portugal;890;0;854522;17037
2021-06-10;PT;Portugal;910;6;855432;17043
2021-06-11;PT;Portugal;519;1;855951;17044
2021-06-12;PT;Portugal;789;1;856740;17045
2021-06-13;PT;Portugal;707;2;857447;17047
2021-06-14;PT;Portugal;625;0;858072;17047
2021-06-15;PT;Portugal;973;2;859045;17049
2021-06-16;PT;Portugal;1350;6;860395;17055
2021-06-17;PT;Portugal;1233;2;861628;17057
2021-06-18;PT;Portugal;1298;4;862926;17061
2021-06-19;PT;Portugal;1183;1;864109;17062
2021-06-20;PT;Portugal;941;3;865050;17065
2021-06-21;PT;Portugal;756;3;865806;17068
2021-06-22;PT;Portugal;1020;6;866826;17074
2021-06-23;PT;Portugal;1497;3;868323;17077
2021-06-24;PT;Portugal;1556;2;869879;17079
2021-06-25;PT;Portugal;1604;2;871483;17081
2021-06-26;PT;Portugal;1568;2;873051;17083
2021-06-27;PT;Portugal;1496;1;874547;17084
2021-06-28;PT;Portugal;902;2;875449;17086
2021-06-29;PT;Portugal;1746;6;877195;17092
2021-06-30;PT;Portugal;2362;4;879557;17096
2021-07-01;PT;Portugal;2449;5;882006;17101
2020-02-29;QA;Qatar;1;0;1;0
2020-03-01;QA;Qatar;2;0;3;0
2020-03-02;QA;Qatar;0;0;3;0
2020-03-03;QA;Qatar;4;0;7;0
2020-03-04;QA;Qatar;1;0;8;0
2020-03-05;QA;Qatar;0;0;8;0
2020-03-06;QA;Qatar;0;0;8;0
2020-03-07;QA;Qatar;0;0;8;0
2020-03-08;QA;Qatar;7;0;15;0
2020-03-09;QA;Qatar;3;0;18;0
2020-03-10;QA;Qatar;6;0;24;0
2020-03-11;QA;Qatar;238;0;262;0
2020-03-12;QA;Qatar;0;0;262;0
2020-03-13;QA;Qatar;58;0;320;0
2020-03-14;QA;Qatar;17;0;337;0
2020-03-15;QA;Qatar;64;0;401;0
2020-03-16;QA;Qatar;38;0;439;0
2020-03-17;QA;Qatar;0;0;439;0
2020-03-18;QA;Qatar;13;0;452;0
2020-03-19;QA;Qatar;8;0;460;0
2020-03-20;QA;Qatar;10;0;470;0
2020-03-21;QA;Qatar;11;0;481;0
2020-03-22;QA;Qatar;13;0;494;0
2020-03-23;QA;Qatar;7;0;501;0
2020-03-24;QA;Qatar;25;0;526;0
2020-03-25;QA;Qatar;11;0;537;0
2020-03-26;QA;Qatar;12;0;549;0
2020-03-27;QA;Qatar;13;0;562;0
2020-03-28;QA;Qatar;28;1;590;1
2020-03-29;QA;Qatar;44;0;634;1
2020-03-30;QA;Qatar;59;0;693;1
2020-03-31;QA;Qatar;88;1;781;2
2020-04-01;QA;Qatar;54;0;835;2
2020-04-02;QA;Qatar;114;1;949;3
2020-04-03;QA;Qatar;126;0;1075;3
2020-04-04;QA;Qatar;250;0;1325;3
2020-04-05;QA;Qatar;279;1;1604;4
2020-04-06;QA;Qatar;228;0;1832;4
2020-04-07;QA;Qatar;225;2;2057;6
2020-04-08;QA;Qatar;153;0;2210;6
2020-04-09;QA;Qatar;166;0;2376;6
2020-04-10;QA;Qatar;136;0;2512;6
2020-04-11;QA;Qatar;216;0;2728;6
2020-04-12;QA;Qatar;251;1;2979;7
2020-04-13;QA;Qatar;252;0;3231;7
2020-04-14;QA;Qatar;197;0;3428;7
2020-04-15;QA;Qatar;283;0;3711;7
2020-04-16;QA;Qatar;392;0;4103;7
2020-04-17;QA;Qatar;560;0;4663;7
2020-04-18;QA;Qatar;345;1;5008;8
2020-04-19;QA;Qatar;440;0;5448;8
2020-04-20;QA;Qatar;567;1;6015;9
2020-04-21;QA;Qatar;518;0;6533;9
2020-04-22;QA;Qatar;608;1;7141;10
2020-04-23;QA;Qatar;623;0;7764;10
2020-04-24;QA;Qatar;761;0;8525;10
2020-04-25;QA;Qatar;833;0;9358;10
2020-04-26;QA;Qatar;929;0;10287;10
2020-04-27;QA;Qatar;957;0;11244;10
2020-04-28;QA;Qatar;677;0;11921;10
2020-04-29;QA;Qatar;643;0;12564;10
2020-04-30;QA;Qatar;845;0;13409;10
2020-05-01;QA;Qatar;687;2;14096;12
2020-05-02;QA;Qatar;776;0;14872;12
2020-05-03;QA;Qatar;679;0;15551;12
2020-05-04;QA;Qatar;640;0;16191;12
2020-05-05;QA;Qatar;951;0;17142;12
2020-05-06;QA;Qatar;830;0;17972;12
2020-05-07;QA;Qatar;918;0;18890;12
2020-05-08;QA;Qatar;1311;0;20201;12
2020-05-09;QA;Qatar;1130;1;21331;13
2020-05-10;QA;Qatar;1189;1;22520;14
2020-05-11;QA;Qatar;1103;0;23623;14
2020-05-12;QA;Qatar;1526;0;25149;14
2020-05-13;QA;Qatar;1390;0;26539;14
2020-05-14;QA;Qatar;1733;0;28272;14
2020-05-15;QA;Qatar;1153;0;29425;14
2020-05-16;QA;Qatar;1547;1;30972;15
2020-05-17;QA;Qatar;1632;0;32604;15
2020-05-18;QA;Qatar;1365;0;33969;15
2020-05-19;QA;Qatar;1637;0;35606;15
2020-05-20;QA;Qatar;1491;1;37097;16
2020-05-21;QA;Qatar;1554;1;38651;17
2020-05-22;QA;Qatar;1830;2;40481;19
2020-05-23;QA;Qatar;1732;2;42213;21
2020-05-24;QA;Qatar;1501;2;43714;23
2020-05-25;QA;Qatar;1751;3;45465;26
2020-05-26;QA;Qatar;1742;2;47207;28
2020-05-27;QA;Qatar;1740;2;48947;30
2020-05-28;QA;Qatar;1967;3;50914;33
2020-05-29;QA;Qatar;1993;3;52907;36
2020-05-30;QA;Qatar;2355;0;55262;36
2020-05-31;QA;Qatar;1648;2;56910;38
2020-06-01;QA;Qatar;1523;2;58433;40
2020-06-02;QA;Qatar;1826;3;60259;43
2020-06-03;QA;Qatar;1901;2;62160;45
2020-06-04;QA;Qatar;1581;0;63741;45
2020-06-05;QA;Qatar;1754;4;65495;49
2020-06-06;QA;Qatar;1700;2;67195;51
2020-06-07;QA;Qatar;1595;3;68790;54
2020-06-08;QA;Qatar;1368;3;70158;57
2020-06-09;QA;Qatar;1721;5;71879;62
2020-06-10;QA;Qatar;1716;4;73595;66
2020-06-11;QA;Qatar;1476;3;75071;69
2020-06-12;QA;Qatar;1517;1;76588;70
2020-06-13;QA;Qatar;1828;0;78416;70
2020-06-14;QA;Qatar;1186;3;79602;73
2020-06-15;QA;Qatar;1274;3;80876;76
2020-06-16;QA;Qatar;1201;4;82077;80
2020-06-17;QA;Qatar;1097;2;83174;82
2020-06-18;QA;Qatar;1267;4;84441;86
2020-06-19;QA;Qatar;1021;7;85462;93
2020-06-20;QA;Qatar;1026;1;86488;94
2020-06-21;QA;Qatar;881;4;87369;98
2020-06-22;QA;Qatar;1034;1;88403;99
2020-06-23;QA;Qatar;1176;0;89579;99
2020-06-24;QA;Qatar;1199;5;90778;104
2020-06-25;QA;Qatar;1060;2;91838;106
2020-06-26;QA;Qatar;946;3;92784;109
2020-06-27;QA;Qatar;879;1;93663;110
2020-06-28;QA;Qatar;750;0;94413;110
2020-06-29;QA;Qatar;693;3;95106;113
2020-06-30;QA;Qatar;982;0;96088;113
2020-07-01;QA;Qatar;915;2;97003;115
2020-07-02;QA;Qatar;894;3;97897;118
2020-07-03;QA;Qatar;756;3;98653;121
2020-07-04;QA;Qatar;530;2;99183;123
2020-07-05;QA;Qatar;616;5;99799;128
2020-07-06;QA;Qatar;546;5;100345;133
2020-07-07;QA;Qatar;600;1;100945;134
2020-07-08;QA;Qatar;608;4;101553;138
2020-07-09;QA;Qatar;557;4;102110;142
2020-07-10;QA;Qatar;520;4;102630;146
2020-07-11;QA;Qatar;498;0;103128;146
2020-07-12;QA;Qatar;470;1;103598;147
2020-07-13;QA;Qatar;418;2;104016;149
2020-07-14;QA;Qatar;517;1;104533;150
2020-07-15;QA;Qatar;450;1;104983;151
2020-07-16;QA;Qatar;494;1;105477;152
2020-07-17;QA;Qatar;421;1;105898;153
2020-07-18;QA;Qatar;410;1;106308;154
2020-07-19;QA;Qatar;340;3;106648;157
2020-07-20;QA;Qatar;389;2;107037;159
2020-07-21;QA;Qatar;393;1;107430;160
2020-07-22;QA;Qatar;441;3;107871;163
2020-07-23;QA;Qatar;373;1;108244;164
2020-07-24;QA;Qatar;394;0;108638;164
2020-07-25;QA;Qatar;398;0;109036;164
2020-07-26;QA;Qatar;269;1;109305;165
2020-07-27;QA;Qatar;292;0;109597;165
2020-07-28;QA;Qatar;283;2;109880;167
2020-07-29;QA;Qatar;273;2;110153;169
2020-07-30;QA;Qatar;307;2;110460;171
2020-07-31;QA;Qatar;235;3;110695;174
2020-08-01;QA;Qatar;216;0;110911;174
2020-08-02;QA;Qatar;196;3;111107;177
2020-08-03;QA;Qatar;215;0;111322;177
2020-08-04;QA;Qatar;216;0;111538;177
2020-08-05;QA;Qatar;267;1;111805;178
2020-08-06;QA;Qatar;287;0;112092;178
2020-08-07;QA;Qatar;291;2;112383;180
2020-08-08;QA;Qatar;267;2;112650;182
2020-08-09;QA;Qatar;297;2;112947;184
2020-08-10;QA;Qatar;315;4;113262;188
2020-08-11;QA;Qatar;384;0;113646;188
2020-08-12;QA;Qatar;292;2;113938;190
2020-08-13;QA;Qatar;343;0;114281;190
2020-08-14;QA;Qatar;251;0;114532;190
2020-08-15;QA;Qatar;277;2;114809;192
2020-08-16;QA;Qatar;271;1;115080;193
2020-08-17;QA;Qatar;288;0;115368;193
2020-08-18;QA;Qatar;293;0;115661;193
2020-08-19;QA;Qatar;295;0;115956;193
2020-08-20;QA;Qatar;268;0;116224;193
2020-08-21;QA;Qatar;257;0;116481;193
2020-08-22;QA;Qatar;284;0;116765;193
2020-08-23;QA;Qatar;243;0;117008;193
2020-08-24;QA;Qatar;258;1;117266;194
2020-08-25;QA;Qatar;232;0;117498;194
2020-08-26;QA;Qatar;244;0;117742;194
2020-08-27;QA;Qatar;246;1;117988;195
2020-08-28;QA;Qatar;208;1;118196;196
2020-08-29;QA;Qatar;211;0;118407;196
2020-08-30;QA;Qatar;168;1;118575;197
2020-08-31;QA;Qatar;203;0;118778;197
2020-09-01;QA;Qatar;216;1;118994;198
2020-09-02;QA;Qatar;212;1;119206;199
2020-09-03;QA;Qatar;214;2;119420;201
2020-09-04;QA;Qatar;217;0;119637;201
2020-09-05;QA;Qatar;227;1;119864;202
2020-09-06;QA;Qatar;231;1;120095;203
2020-09-07;QA;Qatar;253;2;120348;205
2020-09-08;QA;Qatar;231;0;120579;205
2020-09-09;QA;Qatar;267;0;120846;205
2020-09-10;QA;Qatar;206;0;121052;205
2020-09-11;QA;Qatar;235;0;121287;205
2020-09-12;QA;Qatar;236;0;121523;205
2020-09-13;QA;Qatar;217;0;121740;205
2020-09-14;QA;Qatar;235;2;121975;207
2020-09-15;QA;Qatar;239;1;122214;208
2020-09-16;QA;Qatar;235;0;122449;208
2020-09-17;QA;Qatar;244;0;122693;208
2020-09-18;QA;Qatar;224;1;122917;209
2020-09-19;QA;Qatar;229;0;123146;209
2020-09-20;QA;Qatar;230;1;123376;210
2020-09-21;QA;Qatar;228;1;123604;211
2020-09-22;QA;Qatar;313;0;123917;211
2020-09-23;QA;Qatar;258;1;124175;212
2020-09-24;QA;Qatar;250;0;124425;212
2020-09-25;QA;Qatar;225;0;124650;212
2020-09-26;QA;Qatar;200;2;124850;214
2020-09-27;QA;Qatar;234;0;125084;214
2020-09-28;QA;Qatar;227;0;125311;214
2020-09-29;QA;Qatar;222;0;125533;214
2020-09-30;QA;Qatar;227;0;125760;214
2020-10-01;QA;Qatar;199;0;125959;214
2020-10-02;QA;Qatar;205;1;126164;215
2020-10-03;QA;Qatar;175;1;126339;216
2020-10-04;QA;Qatar;159;0;126498;216
2020-10-05;QA;Qatar;194;0;126692;216
2020-10-06;QA;Qatar;251;0;126943;216
2020-10-07;QA;Qatar;238;2;127181;218
2020-10-08;QA;Qatar;213;0;127394;218
2020-10-09;QA;Qatar;206;1;127600;219
2020-10-10;QA;Qatar;178;0;127778;219
2020-10-11;QA;Qatar;207;1;127985;220
2020-10-12;QA;Qatar;206;0;128191;220
2020-10-13;QA;Qatar;214;0;128405;220
2020-10-14;QA;Qatar;198;0;128603;220
2020-10-15;QA;Qatar;200;2;128803;222
2020-10-16;QA;Qatar;189;0;128992;222
2020-10-17;QA;Qatar;235;1;129227;223
2020-10-18;QA;Qatar;204;1;129431;224
2020-10-19;QA;Qatar;240;0;129671;224
2020-10-20;QA;Qatar;273;0;129944;224
2020-10-21;QA;Qatar;266;1;130210;225
2020-10-22;QA;Qatar;252;3;130462;228
2020-10-23;QA;Qatar;249;1;130711;229
2020-10-24;QA;Qatar;254;0;130965;229
2020-10-25;QA;Qatar;205;1;131170;230
2020-10-26;QA;Qatar;262;0;131432;230
2020-10-27;QA;Qatar;257;0;131689;230
2020-10-28;QA;Qatar;250;0;131939;230
2020-10-29;QA;Qatar;211;1;132150;231
2020-10-30;QA;Qatar;193;1;132343;232
2020-10-31;QA;Qatar;213;0;132556;232
2020-11-01;QA;Qatar;164;0;132720;232
2020-11-02;QA;Qatar;197;0;132917;232
2020-11-03;QA;Qatar;226;0;133143;232
2020-11-04;QA;Qatar;227;0;133370;232
2020-11-05;QA;Qatar;249;0;133619;232
2020-11-06;QA;Qatar;192;0;133811;232
2020-11-07;QA;Qatar;202;0;134013;232
2020-11-08;QA;Qatar;190;0;134203;232
2020-11-09;QA;Qatar;230;0;134433;232
2020-11-10;QA;Qatar;230;1;134663;233
2020-11-11;QA;Qatar;224;0;134887;233
2020-11-12;QA;Qatar;245;1;135132;234
2020-11-13;QA;Qatar;235;0;135367;234
2020-11-14;QA;Qatar;203;0;135570;234
2020-11-15;QA;Qatar;215;0;135785;234
2020-11-16;QA;Qatar;243;1;136028;235
2020-11-17;QA;Qatar;194;0;136222;235
2020-11-18;QA;Qatar;219;0;136441;235
2020-11-19;QA;Qatar;208;0;136649;235
2020-11-20;QA;Qatar;239;0;136888;235
2020-11-21;QA;Qatar;174;0;137062;235
2020-11-22;QA;Qatar;167;1;137229;236
2020-11-23;QA;Qatar;186;0;137415;236
2020-11-24;QA;Qatar;227;0;137642;236
2020-11-25;QA;Qatar;209;1;137851;237
2020-11-26;QA;Qatar;215;0;138066;237
2020-11-27;QA;Qatar;184;0;138250;237
2020-11-28;QA;Qatar;227;0;138477;237
2020-11-29;QA;Qatar;171;0;138648;237
2020-11-30;QA;Qatar;185;0;138833;237
2020-12-01;QA;Qatar;168;1;139001;238
2020-12-02;QA;Qatar;255;1;139256;239
2020-12-03;QA;Qatar;221;0;139477;239
2020-12-04;QA;Qatar;166;0;139643;239
2020-12-05;QA;Qatar;140;0;139783;239
2020-12-06;QA;Qatar;125;0;139908;239
2020-12-07;QA;Qatar;178;0;140086;239
2020-12-08;QA;Qatar;117;0;140203;239
2020-12-09;QA;Qatar;150;1;140353;240
2020-12-10;QA;Qatar;163;0;140516;240
2020-12-11;QA;Qatar;164;0;140680;240
2020-12-12;QA;Qatar;147;0;140827;240
2020-12-13;QA;Qatar;134;0;140961;240
2020-12-14;QA;Qatar;160;1;141121;241
2020-12-15;QA;Qatar;151;0;141272;241
2020-12-16;QA;Qatar;145;1;141417;242
2020-12-17;QA;Qatar;140;0;141557;242
2020-12-18;QA;Qatar;159;0;141716;242
2020-12-19;QA;Qatar;142;1;141858;243
2020-12-20;QA;Qatar;143;0;142001;243
2020-12-21;QA;Qatar;158;0;142159;243
2020-12-22;QA;Qatar;149;0;142308;243
2020-12-23;QA;Qatar;140;0;142448;243
2020-12-24;QA;Qatar;157;0;142605;243
2020-12-25;QA;Qatar;129;1;142734;244
2020-12-26;QA;Qatar;169;0;142903;244
2020-12-27;QA;Qatar;159;0;143062;244
2020-12-28;QA;Qatar;160;0;143222;244
2020-12-29;QA;Qatar;206;1;143428;245
2020-12-30;QA;Qatar;193;0;143621;245
2020-12-31;QA;Qatar;213;0;143834;245
2021-01-01;QA;Qatar;208;0;144042;245
2021-01-02;QA;Qatar;198;0;144240;245
2021-01-03;QA;Qatar;197;0;144437;245
2021-01-04;QA;Qatar;207;0;144644;245
2021-01-05;QA;Qatar;208;0;144852;245
2021-01-06;QA;Qatar;209;0;145061;245
2021-01-07;QA;Qatar;210;0;145271;245
2021-01-08;QA;Qatar;195;1;145466;246
2021-01-09;QA;Qatar;206;0;145672;246
2021-01-10;QA;Qatar;193;0;145865;246
2021-01-11;QA;Qatar;203;0;146068;246
2021-01-12;QA;Qatar;211;0;146279;246
2021-01-13;QA;Qatar;201;0;146480;246
2021-01-14;QA;Qatar;209;0;146689;246
2021-01-15;QA;Qatar;196;0;146885;246
2021-01-16;QA;Qatar;204;0;147089;246
2021-01-17;QA;Qatar;188;0;147277;246
2021-01-18;QA;Qatar;227;2;147504;248
2021-01-19;QA;Qatar;225;0;147729;248
2021-01-20;QA;Qatar;271;0;148000;248
2021-01-21;QA;Qatar;258;0;148258;248
2021-01-22;QA;Qatar;263;0;148521;248
2021-01-23;QA;Qatar;251;0;148772;248
2021-01-24;QA;Qatar;247;0;149019;248
2021-01-25;QA;Qatar;277;0;149296;248
2021-01-26;QA;Qatar;299;0;149595;248
2021-01-27;QA;Qatar;338;0;149933;248
2021-01-28;QA;Qatar;347;0;150280;248
2021-01-29;QA;Qatar;341;0;150621;248
2021-01-30;QA;Qatar;363;0;150984;248
2021-01-31;QA;Qatar;351;0;151335;248
2021-02-01;QA;Qatar;385;1;151720;249
2021-02-02;QA;Qatar;375;0;152095;249
2021-02-03;QA;Qatar;396;0;152491;249
2021-02-04;QA;Qatar;407;0;152898;249
2021-02-05;QA;Qatar;398;1;153296;250
2021-02-06;QA;Qatar;394;0;153690;250
2021-02-07;QA;Qatar;408;0;154098;250
2021-02-08;QA;Qatar;427;1;154525;251
2021-02-09;QA;Qatar;477;2;155002;253
2021-02-10;QA;Qatar;451;0;155453;253
2021-02-11;QA;Qatar;448;1;155901;254
2021-02-12;QA;Qatar;450;0;156351;254
2021-02-13;QA;Qatar;453;1;156804;255
2021-02-14;QA;Qatar;440;0;157244;255
2021-02-15;QA;Qatar;888;0;158132;255
2021-02-16;QA;Qatar;6;1;158138;256
2021-02-17;QA;Qatar;453;0;158591;256
2021-02-18;QA;Qatar;462;0;159053;256
2021-02-19;QA;Qatar;465;0;159518;256
2021-02-20;QA;Qatar;449;0;159967;256
2021-02-21;QA;Qatar;459;0;160426;256
2021-02-22;QA;Qatar;463;1;160889;257
2021-02-23;QA;Qatar;455;0;161344;257
2021-02-24;QA;Qatar;459;0;161803;257
2021-02-25;QA;Qatar;465;0;162268;257
2021-02-26;QA;Qatar;469;0;162737;257
2021-02-27;QA;Qatar;460;0;163197;257
2021-02-28;QA;Qatar;467;1;163664;258
2021-03-01;QA;Qatar;473;1;164137;259
2021-03-02;QA;Qatar;463;0;164600;259
2021-03-03;QA;Qatar;471;1;165071;260
2021-03-04;QA;Qatar;475;0;165546;260
2021-03-05;QA;Qatar;469;1;166015;261
2021-03-06;QA;Qatar;460;1;166475;262
2021-03-07;QA;Qatar;474;0;166949;262
2021-03-08;QA;Qatar;468;1;167417;263
2021-03-09;QA;Qatar;471;1;167888;264
2021-03-10;QA;Qatar;473;0;168361;264
2021-03-11;QA;Qatar;468;0;168829;264
2021-03-12;QA;Qatar;455;1;169284;265
2021-03-13;QA;Qatar;483;0;169767;265
2021-03-14;QA;Qatar;485;1;170252;266
2021-03-15;QA;Qatar;481;1;170733;267
2021-03-16;QA;Qatar;479;1;171212;268
2021-03-17;QA;Qatar;489;2;171701;270
2021-03-18;QA;Qatar;499;0;172200;270
2021-03-19;QA;Qatar;497;1;172697;271
2021-03-20;QA;Qatar;509;1;173206;272
2021-03-21;QA;Qatar;503;1;173709;273
2021-03-22;QA;Qatar;519;1;174228;274
2021-03-23;QA;Qatar;534;1;174762;275
2021-03-24;QA;Qatar;570;3;175332;278
2021-03-25;QA;Qatar;587;3;175919;281
2021-03-26;QA;Qatar;602;1;176521;282
2021-03-27;QA;Qatar;614;2;177135;284
2021-03-28;QA;Qatar;639;0;177774;284
2021-03-29;QA;Qatar;690;2;178464;286
2021-03-30;QA;Qatar;720;3;179184;289
2021-03-31;QA;Qatar;780;2;179964;291
2021-04-01;QA;Qatar;840;4;180804;295
2021-04-02;QA;Qatar;874;3;181678;298
2021-04-03;QA;Qatar;870;3;182548;301
2021-04-04;QA;Qatar;876;2;183424;303
2021-04-05;QA;Qatar;910;3;184334;306
2021-04-06;QA;Qatar;927;6;185261;312
2021-04-07;QA;Qatar;940;8;186201;320
2021-04-08;QA;Qatar;949;2;187150;322
2021-04-09;QA;Qatar;950;2;188100;324
2021-04-10;QA;Qatar;964;7;189064;331
2021-04-11;QA;Qatar;961;2;190025;333
2021-04-12;QA;Qatar;973;2;190998;335
2021-04-13;QA;Qatar;981;5;191979;340
2021-04-14;QA;Qatar;984;8;192963;348
2021-04-15;QA;Qatar;989;9;193952;357
2021-04-16;QA;Qatar;978;10;194930;367
2021-04-17;QA;Qatar;827;9;195757;376
2021-04-18;QA;Qatar;823;6;196580;382
2021-04-19;QA;Qatar;896;4;197476;386
2021-04-20;QA;Qatar;885;5;198361;391
2021-04-21;QA;Qatar;819;9;199180;400
2021-04-22;QA;Qatar;800;7;199980;407
2021-04-23;QA;Qatar;798;6;200778;413
2021-04-24;QA;Qatar;718;5;201496;418
2021-04-25;QA;Qatar;705;10;202201;428
2021-04-26;QA;Qatar;703;9;202904;437
2021-04-27;QA;Qatar;695;4;203599;441
2021-04-28;QA;Qatar;690;4;204289;445
2021-04-29;QA;Qatar;687;5;204976;450
2021-04-30;QA;Qatar;676;8;205652;458
2021-05-01;QA;Qatar;650;7;206302;465
2021-05-02;QA;Qatar;646;7;206948;472
2021-05-03;QA;Qatar;644;8;207592;480
2021-05-04;QA;Qatar;640;3;208232;483
2021-05-05;QA;Qatar;645;6;208877;489
2021-05-06;QA;Qatar;593;4;209470;493
2021-05-07;QA;Qatar;600;3;210070;496
2021-05-08;QA;Qatar;533;6;210603;502
2021-05-09;QA;Qatar;389;6;210992;508
2021-05-10;QA;Qatar;397;4;211389;512
2021-05-11;QA;Qatar;343;4;211732;516
2021-05-12;QA;Qatar;392;3;212124;519
2021-05-13;QA;Qatar;299;3;212423;522
2021-05-14;QA;Qatar;244;2;212667;524
2021-05-15;QA;Qatar;260;2;212927;526
2021-05-16;QA;Qatar;256;4;213183;530
2021-05-17;QA;Qatar;302;2;213485;532
2021-05-18;QA;Qatar;370;4;213855;536
2021-05-19;QA;Qatar;295;2;214150;538
2021-05-20;QA;Qatar;313;1;214463;539
2021-05-21;QA;Qatar;367;2;214830;541
2021-05-22;QA;Qatar;330;2;215160;543
2021-05-23;QA;Qatar;283;1;215443;544
2021-05-24;QA;Qatar;299;3;215742;547
2021-05-25;QA;Qatar;349;2;216091;549
2021-05-26;QA;Qatar;306;3;216397;552
2021-05-27;QA;Qatar;286;0;216683;552
2021-05-28;QA;Qatar;202;0;216885;552
2021-05-29;QA;Qatar;156;2;217041;554
2021-05-30;QA;Qatar;189;0;217230;554
2021-05-31;QA;Qatar;228;2;217458;556
2021-06-01;QA;Qatar;230;4;217688;560
2021-06-02;QA;Qatar;194;2;217882;562
2021-06-03;QA;Qatar;198;1;218080;563
2021-06-04;QA;Qatar;183;2;218263;565
2021-06-05;QA;Qatar;192;1;218455;566
2021-06-06;QA;Qatar;172;3;218627;569
2021-06-07;QA;Qatar;171;0;218798;569
2021-06-08;QA;Qatar;182;1;218980;570
2021-06-09;QA;Qatar;158;3;219138;573
2021-06-10;QA;Qatar;143;1;219281;574
2021-06-11;QA;Qatar;185;0;219466;574
2021-06-12;QA;Qatar;147;2;219613;576
2021-06-13;QA;Qatar;117;1;219730;577
2021-06-14;QA;Qatar;157;2;219887;579
2021-06-15;QA;Qatar;146;0;220033;579
2021-06-16;QA;Qatar;165;0;220198;579
2021-06-17;QA;Qatar;127;2;220325;581
2021-06-18;QA;Qatar;184;1;220509;582
2021-06-19;QA;Qatar;184;0;220693;582
2021-06-20;QA;Qatar;107;1;220800;583
2021-06-21;QA;Qatar;130;0;220930;583
2021-06-22;QA;Qatar;189;1;221119;584
2021-06-23;QA;Qatar;154;2;221273;586
2021-06-24;QA;Qatar;105;1;221378;587
2021-06-25;QA;Qatar;87;1;221465;588
2021-06-26;QA;Qatar;125;0;221590;588
2021-06-27;QA;Qatar;102;0;221692;588
2021-06-28;QA;Qatar;118;0;221810;588
2021-06-29;QA;Qatar;143;0;221953;588
2021-06-30;QA;Qatar;118;2;222071;590
2021-07-01;QA;Qatar;146;1;222217;591
2020-02-26;RO;Romania;1;0;1;0
2020-02-27;RO;Romania;0;0;1;0
2020-02-28;RO;Romania;2;0;3;0
2020-02-29;RO;Romania;0;0;3;0
2020-03-01;RO;Romania;0;0;3;0
2020-03-02;RO;Romania;0;0;3;0
2020-03-03;RO;Romania;0;0;3;0
2020-03-04;RO;Romania;1;0;4;0
2020-03-05;RO;Romania;2;0;6;0
2020-03-06;RO;Romania;3;0;9;0
2020-03-07;RO;Romania;0;0;9;0
2020-03-08;RO;Romania;6;0;15;0
2020-03-09;RO;Romania;0;0;15;0
2020-03-10;RO;Romania;10;0;25;0
2020-03-11;RO;Romania;20;0;45;0
2020-03-12;RO;Romania;4;0;49;0
2020-03-13;RO;Romania;40;0;89;0
2020-03-14;RO;Romania;34;0;123;0
2020-03-15;RO;Romania;8;0;131;0
2020-03-16;RO;Romania;27;0;158;0
2020-03-17;RO;Romania;26;0;184;0
2020-03-18;RO;Romania;76;0;260;0
2020-03-19;RO;Romania;17;0;277;0
2020-03-20;RO;Romania;31;0;308;0
2020-03-21;RO;Romania;59;0;367;0
2020-03-22;RO;Romania;66;3;433;3
2020-03-23;RO;Romania;143;4;576;7
2020-03-24;RO;Romania;218;4;794;11
2020-03-25;RO;Romania;112;6;906;17
2020-03-26;RO;Romania;123;6;1029;23
2020-03-27;RO;Romania;263;3;1292;26
2020-03-28;RO;Romania;160;11;1452;37
2020-03-29;RO;Romania;363;6;1815;43
2020-03-30;RO;Romania;294;22;2109;65
2020-03-31;RO;Romania;136;17;2245;82
2020-04-01;RO;Romania;215;10;2460;92
2020-04-02;RO;Romania;278;23;2738;115
2020-04-03;RO;Romania;445;18;3183;133
2020-04-04;RO;Romania;430;13;3613;146
2020-04-05;RO;Romania;251;5;3864;151
2020-04-06;RO;Romania;193;25;4057;176
2020-04-07;RO;Romania;360;21;4417;197
2020-04-08;RO;Romania;344;23;4761;220
2020-04-09;RO;Romania;441;28;5202;248
2020-04-10;RO;Romania;265;22;5467;270
2020-04-11;RO;Romania;523;21;5990;291
2020-04-12;RO;Romania;310;25;6300;316
2020-04-13;RO;Romania;333;15;6633;331
2020-04-14;RO;Romania;246;20;6879;351
2020-04-15;RO;Romania;337;21;7216;372
2020-04-16;RO;Romania;491;20;7707;392
2020-04-17;RO;Romania;360;19;8067;411
2020-04-18;RO;Romania;351;10;8418;421
2020-04-19;RO;Romania;328;30;8746;451
2020-04-20;RO;Romania;190;27;8936;478
2020-04-21;RO;Romania;306;20;9242;498
2020-04-22;RO;Romania;468;26;9710;524
2020-04-23;RO;Romania;386;21;10096;545
2020-04-24;RO;Romania;321;22;10417;567
2020-04-25;RO;Romania;218;34;10635;601
2020-04-26;RO;Romania;401;18;11036;619
2020-04-27;RO;Romania;303;22;11339;641
2020-04-28;RO;Romania;277;22;11616;663
2020-04-29;RO;Romania;362;30;11978;693
2020-04-30;RO;Romania;262;24;12240;717
2020-05-01;RO;Romania;327;27;12567;744
2020-05-02;RO;Romania;165;27;12732;771
2020-05-03;RO;Romania;431;19;13163;790
2020-05-04;RO;Romania;349;28;13512;818
2020-05-05;RO;Romania;325;23;13837;841
2020-05-06;RO;Romania;270;23;14107;864
2020-05-07;RO;Romania;392;24;14499;888
2020-05-08;RO;Romania;312;35;14811;923
2020-05-09;RO;Romania;320;16;15131;939
2020-05-10;RO;Romania;231;22;15362;961
2020-05-11;RO;Romania;226;21;15588;982
2020-05-12;RO;Romania;190;20;15778;1002
2020-05-13;RO;Romania;224;34;16002;1036
2020-05-14;RO;Romania;245;17;16247;1053
2020-05-15;RO;Romania;190;17;16437;1070
2020-05-16;RO;Romania;267;24;16704;1094
2020-05-17;RO;Romania;167;13;16871;1107
2020-05-18;RO;Romania;165;13;17036;1120
2020-05-19;RO;Romania;155;17;17191;1137
2020-05-20;RO;Romania;196;10;17387;1147
2020-05-21;RO;Romania;198;9;17585;1156
2020-05-22;RO;Romania;127;10;17712;1166
2020-05-23;RO;Romania;145;10;17857;1176
2020-05-24;RO;Romania;213;9;18070;1185
2020-05-25;RO;Romania;213;20;18283;1205
2020-05-26;RO;Romania;146;11;18429;1216
2020-05-27;RO;Romania;165;11;18594;1227
2020-05-28;RO;Romania;197;8;18791;1235
2020-05-29;RO;Romania;191;13;18982;1248
2020-05-30;RO;Romania;151;11;19133;1259
2020-05-31;RO;Romania;124;7;19257;1266
2020-06-01;RO;Romania;141;10;19398;1276
2020-06-02;RO;Romania;119;12;19517;1288
2020-06-03;RO;Romania;152;8;19669;1296
2020-06-04;RO;Romania;238;9;19907;1305
2020-06-05;RO;Romania;196;11;20103;1316
2020-06-06;RO;Romania;187;6;20290;1322
2020-06-07;RO;Romania;189;11;20479;1333
2020-06-08;RO;Romania;125;6;20604;1339
2020-06-09;RO;Romania;145;15;20749;1354
2020-06-10;RO;Romania;196;6;20945;1360
2020-06-11;RO;Romania;237;9;21182;1369
2020-06-12;RO;Romania;222;11;21404;1380
2020-06-13;RO;Romania;275;14;21679;1394
2020-06-14;RO;Romania;320;16;21999;1410
2020-06-15;RO;Romania;166;17;22165;1427
2020-06-16;RO;Romania;250;10;22415;1437
2020-06-17;RO;Romania;345;14;22760;1451
2020-06-18;RO;Romania;320;22;23080;1473
2020-06-19;RO;Romania;320;11;23400;1484
2020-06-20;RO;Romania;330;16;23730;1500
2020-06-21;RO;Romania;315;12;24045;1512
2020-06-22;RO;Romania;246;11;24291;1523
2020-06-23;RO;Romania;214;16;24505;1539
2020-06-24;RO;Romania;321;16;24826;1555
2020-06-25;RO;Romania;460;10;25286;1565
2020-06-26;RO;Romania;411;14;25697;1579
2020-06-27;RO;Romania;325;10;26022;1589
2020-06-28;RO;Romania;291;23;26313;1612
2020-06-29;RO;Romania;269;22;26582;1634
2020-06-30;RO;Romania;388;17;26970;1651
2020-07-01;RO;Romania;326;16;27296;1667
2020-07-02;RO;Romania;450;20;27746;1687
2020-07-03;RO;Romania;420;21;28166;1708
2020-07-04;RO;Romania;416;23;28582;1731
2020-07-05;RO;Romania;391;19;28973;1750
2020-07-06;RO;Romania;250;18;29223;1768
2020-07-07;RO;Romania;397;31;29620;1799
2020-07-08;RO;Romania;555;18;30175;1817
2020-07-09;RO;Romania;614;17;30789;1834
2020-07-10;RO;Romania;592;13;31381;1847
2020-07-11;RO;Romania;698;24;32079;1871
2020-07-12;RO;Romania;456;13;32535;1884
2020-07-13;RO;Romania;413;17;32948;1901
2020-07-14;RO;Romania;637;30;33585;1931
2020-07-15;RO;Romania;641;21;34226;1952
2020-07-16;RO;Romania;777;19;35003;1971
2020-07-17;RO;Romania;799;17;35802;1988
2020-07-18;RO;Romania;889;21;36691;2009
2020-07-19;RO;Romania;767;17;37458;2026
2020-07-20;RO;Romania;681;12;38139;2038
2020-07-21;RO;Romania;994;36;39133;2074
2020-07-22;RO;Romania;1030;27;40163;2101
2020-07-23;RO;Romania;1112;25;41275;2126
2020-07-24;RO;Romania;1119;24;42394;2150
2020-07-25;RO;Romania;1284;15;43678;2165
2020-07-26;RO;Romania;1120;22;44798;2187
2020-07-27;RO;Romania;1104;19;45902;2206
2020-07-28;RO;Romania;1151;33;47053;2239
2020-07-29;RO;Romania;1182;30;48235;2269
2020-07-30;RO;Romania;1356;35;49591;2304
2020-07-31;RO;Romania;1295;39;50886;2343
2020-08-01;RO;Romania;1225;36;52111;2379
2020-08-02;RO;Romania;1075;34;53186;2413
2020-08-03;RO;Romania;823;19;54009;2432
2020-08-04;RO;Romania;1232;48;55241;2480
2020-08-05;RO;Romania;1309;41;56550;2521
2020-08-06;RO;Romania;1345;45;57895;2566
2020-08-07;RO;Romania;1378;50;59273;2616
2020-08-08;RO;Romania;1350;43;60623;2659
2020-08-09;RO;Romania;1145;41;61768;2700
2020-08-10;RO;Romania;779;29;62547;2729
2020-08-11;RO;Romania;1215;35;63762;2764
2020-08-12;RO;Romania;1415;43;65177;2807
2020-08-13;RO;Romania;1454;53;66631;2860
2020-08-14;RO;Romania;1415;44;68046;2904
2020-08-15;RO;Romania;1328;50;69374;2954
2020-08-16;RO;Romania;1087;37;70461;2991
2020-08-17;RO;Romania;733;38;71194;3029
2020-08-18;RO;Romania;1014;45;72208;3074
2020-08-19;RO;Romania;1409;32;73617;3106
2020-08-20;RO;Romania;1346;48;74963;3154
2020-08-21;RO;Romania;1392;42;76355;3196
2020-08-22;RO;Romania;1189;37;77544;3233
2020-08-23;RO;Romania;961;39;78505;3272
2020-08-24;RO;Romania;825;37;79330;3309
2020-08-25;RO;Romania;1060;58;80390;3367
2020-08-26;RO;Romania;1256;54;81646;3421
2020-08-27;RO;Romania;1504;38;83150;3459
2020-08-28;RO;Romania;1318;48;84468;3507
2020-08-29;RO;Romania;1365;32;85833;3539
2020-08-30;RO;Romania;952;39;86785;3578
2020-08-31;RO;Romania;755;43;87540;3621
2020-09-01;RO;Romania;1053;60;88593;3681
2020-09-02;RO;Romania;1298;40;89891;3721
2020-09-03;RO;Romania;1365;44;91256;3765
2020-09-04;RO;Romania;1339;47;92595;3812
2020-09-05;RO;Romania;1269;38;93864;3850
2020-09-06;RO;Romania;1150;43;95014;3893
2020-09-07;RO;Romania;883;33;95897;3926
2020-09-08;RO;Romania;1136;41;97033;3967
2020-09-09;RO;Romania;1271;51;98304;4018
2020-09-10;RO;Romania;1380;47;99684;4065
2020-09-11;RO;Romania;1391;35;101075;4100
2020-09-12;RO;Romania;1311;27;102386;4127
2020-09-13;RO;Romania;1109;36;103495;4163
2020-09-14;RO;Romania;692;22;104187;4185
2020-09-15;RO;Romania;1111;51;105298;4236
2020-09-16;RO;Romania;1713;49;107011;4285
2020-09-17;RO;Romania;1679;27;108690;4312
2020-09-18;RO;Romania;1527;48;110217;4360
2020-09-19;RO;Romania;1333;42;111550;4402
2020-09-20;RO;Romania;1231;33;112781;4435
2020-09-21;RO;Romania;808;23;113589;4458
2020-09-22;RO;Romania;1059;45;114648;4503
2020-09-23;RO;Romania;1767;47;116415;4550
2020-09-24;RO;Romania;1639;41;118054;4591
2020-09-25;RO;Romania;1629;42;119683;4633
2020-09-26;RO;Romania;1552;54;121235;4687
2020-09-27;RO;Romania;1438;31;122673;4718
2020-09-28;RO;Romania;1271;30;123944;4748
2020-09-29;RO;Romania;1470;44;125414;4792
2020-09-30;RO;Romania;2158;33;127572;4825
2020-10-01;RO;Romania;2086;37;129658;4862
2020-10-02;RO;Romania;2343;53;132001;4915
2020-10-03;RO;Romania;2064;32;134065;4947
2020-10-04;RO;Romania;1835;56;135900;5003
2020-10-05;RO;Romania;1591;45;137491;5048
2020-10-06;RO;Romania;2121;73;139612;5121
2020-10-07;RO;Romania;2958;82;142570;5203
2020-10-08;RO;Romania;3130;44;145700;5247
2020-10-09;RO;Romania;3186;52;148886;5299
2020-10-10;RO;Romania;3517;59;152403;5358
2020-10-11;RO;Romania;2880;53;155283;5411
2020-10-12;RO;Romania;2069;56;157352;5467
2020-10-13;RO;Romania;3109;68;160461;5535
2020-10-14;RO;Romania;4016;66;164477;5601
2020-10-15;RO;Romania;4013;73;168490;5674
2020-10-16;RO;Romania;4026;75;172516;5749
2020-10-17;RO;Romania;3952;63;176468;5812
2020-10-18;RO;Romania;3920;60;180388;5872
2020-10-19;RO;Romania;2466;59;182854;5931
2020-10-20;RO;Romania;3400;65;186254;5996
2020-10-21;RO;Romania;4848;69;191102;6065
2020-10-22;RO;Romania;4902;98;196004;6163
2020-10-23;RO;Romania;5028;82;201032;6245
2020-10-24;RO;Romania;4761;73;205793;6318
2020-10-25;RO;Romania;3855;73;209648;6391
2020-10-26;RO;Romania;2844;79;212492;6470
2020-10-27;RO;Romania;4724;104;217216;6574
2020-10-28;RO;Romania;5343;107;222559;6681
2020-10-29;RO;Romania;6481;83;229040;6764
2020-10-30;RO;Romania;6546;103;235586;6867
2020-10-31;RO;Romania;5753;101;241339;6968
2020-11-01;RO;Romania;5324;99;246663;7067
2020-11-02;RO;Romania;4041;86;250704;7153
2020-11-03;RO;Romania;7733;120;258437;7273
2020-11-04;RO;Romania;8651;146;267088;7419
2020-11-05;RO;Romania;9714;121;276802;7540
2020-11-06;RO;Romania;10260;123;287062;7663
2020-11-07;RO;Romania;9937;130;296999;7793
2020-11-08;RO;Romania;6752;86;303751;7879
2020-11-09;RO;Romania;3240;130;306991;8009
2020-11-10;RO;Romania;7304;177;314295;8186
2020-11-11;RO;Romania;9799;203;324094;8389
2020-11-12;RO;Romania;10142;121;334236;8510
2020-11-13;RO;Romania;9489;174;343725;8684
2020-11-14;RO;Romania;9460;129;353185;8813
2020-11-15;RO;Romania;7096;113;360281;8926
2020-11-16;RO;Romania;4931;149;365212;9075
2020-11-17;RO;Romania;8262;186;373474;9261
2020-11-18;RO;Romania;10269;168;383743;9429
2020-11-19;RO;Romania;10108;167;393851;9596
2020-11-20;RO;Romania;9272;160;403123;9756
2020-11-21;RO;Romania;9685;160;412808;9916
2020-11-22;RO;Romania;5837;131;418645;10047
2020-11-23;RO;Romania;4207;130;422852;10177
2020-11-24;RO;Romania;7753;196;430605;10373
2020-11-25;RO;Romania;9739;168;440344;10541
2020-11-26;RO;Romania;9005;171;449349;10712
2020-11-27;RO;Romania;8499;172;457848;10884
2020-11-28;RO;Romania;8134;161;465982;11045
2020-11-29;RO;Romania;5554;148;471536;11193
2020-11-30;RO;Romania;3826;138;475362;11331
2020-12-01;RO;Romania;4272;199;479634;11530
2020-12-02;RO;Romania;4916;135;484550;11665
2020-12-03;RO;Romania;7661;211;492211;11876
2020-12-04;RO;Romania;8062;176;500273;12052
2020-12-05;RO;Romania;8072;134;508345;12186
2020-12-06;RO;Romania;5231;134;513576;12320
2020-12-07;RO;Romania;3660;127;517236;12447
2020-12-08;RO;Romania;7439;213;524675;12660
2020-12-09;RO;Romania;7365;161;532040;12821
2020-12-10;RO;Romania;7067;127;539107;12948
2020-12-11;RO;Romania;6460;168;545567;13116
2020-12-12;RO;Romania;6333;148;551900;13264
2020-12-13;RO;Romania;4435;121;556335;13385
2020-12-14;RO;Romania;3252;109;559587;13494
2020-12-15;RO;Romania;6171;204;565758;13698
2020-12-16;RO;Romania;5991;164;571749;13862
2020-12-17;RO;Romania;5697;107;577446;13969
2020-12-18;RO;Romania;5340;188;582786;14157
2020-12-19;RO;Romania;5158;139;587944;14296
2020-12-20;RO;Romania;3350;98;591294;14394
2020-12-21;RO;Romania;2489;87;593783;14481
2020-12-22;RO;Romania;5009;155;598792;14636
2020-12-23;RO;Romania;5459;130;604251;14766
2020-12-24;RO;Romania;4310;146;608561;14912
2020-12-25;RO;Romania;3812;111;612373;15023
2020-12-26;RO;Romania;1387;85;613760;15108
2020-12-27;RO;Romania;2049;122;615809;15230
2020-12-28;RO;Romania;2620;104;618429;15334
2020-12-29;RO;Romania;4637;135;623066;15469
2020-12-30;RO;Romania;4875;127;627941;15596
2020-12-31;RO;Romania;4322;171;632263;15767
2021-01-01;RO;Romania;3938;74;636201;15841
2021-01-02;RO;Romania;1194;78;637395;15919
2021-01-03;RO;Romania;3034;60;640429;15979
2021-01-04;RO;Romania;3130;78;643559;16057
2021-01-05;RO;Romania;4729;121;648288;16178
2021-01-06;RO;Romania;5719;121;654007;16299
2021-01-07;RO;Romania;4951;111;658958;16410
2021-01-08;RO;Romania;4841;96;663799;16506
2021-01-09;RO;Romania;4403;86;668202;16592
2021-01-10;RO;Romania;3082;62;671284;16654
2021-01-11;RO;Romania;1987;71;673271;16725
2021-01-12;RO;Romania;3697;156;676968;16881
2021-01-13;RO;Romania;4424;88;681392;16969
2021-01-14;RO;Romania;3525;66;684917;17035
2021-01-15;RO;Romania;3353;63;688270;17098
2021-01-16;RO;Romania;3218;66;691488;17164
2021-01-17;RO;Romania;2156;57;693644;17221
2021-01-18;RO;Romania;1509;50;695153;17271
2021-01-19;RO;Romania;2745;98;697898;17369
2021-01-20;RO;Romania;3000;116;700898;17485
2021-01-21;RO;Romania;2878;69;703776;17554
2021-01-22;RO;Romania;2699;74;706475;17628
2021-01-23;RO;Romania;2719;94;709194;17722
2021-01-24;RO;Romania;1816;54;711010;17776
2021-01-25;RO;Romania;1551;65;712561;17841
2021-01-26;RO;Romania;2877;97;715438;17938
2021-01-27;RO;Romania;3174;77;718612;18015
2021-01-28;RO;Romania;2901;90;721513;18105
2021-01-29;RO;Romania;2737;91;724250;18196
2021-01-30;RO;Romania;2668;68;726918;18264
2021-01-31;RO;Romania;1825;71;728743;18335
2021-02-01;RO;Romania;1313;67;730056;18402
2021-02-02;RO;Romania;2676;111;732732;18513
2021-02-03;RO;Romania;2752;87;735484;18600
2021-02-04;RO;Romania;2668;75;738152;18675
2021-02-05;RO;Romania;2580;73;740732;18748
2021-02-06;RO;Romania;2611;61;743343;18809
2021-02-07;RO;Romania;1975;72;745318;18881
2021-02-08;RO;Romania;1319;80;746637;18961
2021-02-09;RO;Romania;2797;95;749434;19056
2021-02-10;RO;Romania;3048;79;752482;19135
2021-02-11;RO;Romania;2644;65;755126;19200
2021-02-12;RO;Romania;2550;77;757676;19277
2021-02-13;RO;Romania;2415;48;760091;19325
2021-02-14;RO;Romania;1872;41;761963;19366
2021-02-15;RO;Romania;1331;79;763294;19445
2021-02-16;RO;Romania;2676;81;765970;19526
2021-02-17;RO;Romania;2815;62;768785;19588
2021-02-18;RO;Romania;3058;71;771843;19659
2021-02-19;RO;Romania;2712;79;774555;19738
2021-02-20;RO;Romania;2721;57;777276;19795
2021-02-21;RO;Romania;2419;52;779695;19847
2021-02-22;RO;Romania;1634;47;781329;19894
2021-02-23;RO;Romania;3382;119;784711;20013
2021-02-24;RO;Romania;3337;73;788048;20086
2021-02-25;RO;Romania;3923;81;791971;20167
2021-02-26;RO;Romania;3761;66;795732;20233
2021-02-27;RO;Romania;3432;54;799164;20287
2021-02-28;RO;Romania;2830;63;801994;20350
2021-03-01;RO;Romania;2096;53;804090;20403
2021-03-02;RO;Romania;3950;106;808040;20509
2021-03-03;RO;Romania;4278;77;812318;20586
2021-03-04;RO;Romania;4271;98;816589;20684
2021-03-05;RO;Romania;4342;101;820931;20785
2021-03-06;RO;Romania;4064;69;824995;20854
2021-03-07;RO;Romania;3288;46;828283;20900
2021-03-08;RO;Romania;2280;63;830563;20963
2021-03-09;RO;Romania;4989;93;835552;21056
2021-03-10;RO;Romania;4564;100;840116;21156
2021-03-11;RO;Romania;5236;96;845352;21252
2021-03-12;RO;Romania;5010;108;850362;21360
2021-03-13;RO;Romania;4964;79;855326;21439
2021-03-14;RO;Romania;4383;44;859709;21483
2021-03-15;RO;Romania;2972;82;862681;21565
2021-03-16;RO;Romania;6118;133;868799;21698
2021-03-17;RO;Romania;6186;89;874985;21787
2021-03-18;RO;Romania;6174;90;881159;21877
2021-03-19;RO;Romania;5593;143;886752;22020
2021-03-20;RO;Romania;6096;112;892848;22132
2021-03-21;RO;Romania;4267;76;897115;22208
2021-03-22;RO;Romania;3743;60;900858;22268
2021-03-23;RO;Romania;6149;174;907007;22442
2021-03-24;RO;Romania;6136;137;913143;22579
2021-03-25;RO;Romania;6651;140;919794;22719
2021-03-26;RO;Romania;6516;116;926310;22835
2021-03-27;RO;Romania;5869;162;932179;22997
2021-03-28;RO;Romania;4439;117;936618;23114
2021-03-29;RO;Romania;3825;120;940443;23234
2021-03-30;RO;Romania;6204;175;946647;23409
2021-03-31;RO;Romania;6156;129;952803;23538
2021-04-01;RO;Romania;6115;136;958918;23674
2021-04-02;RO;Romania;5808;145;964726;23819
2021-04-03;RO;Romania;5498;154;970224;23973
2021-04-04;RO;Romania;4151;97;974375;24070
2021-04-05;RO;Romania;3611;120;977986;24190
2021-04-06;RO;Romania;5231;196;983217;24386
2021-04-07;RO;Romania;5407;175;988624;24561
2021-04-08;RO;Romania;4989;172;993613;24733
2021-04-09;RO;Romania;4942;134;998555;24867
2021-04-10;RO;Romania;4310;139;1002865;25006
2021-04-11;RO;Romania;3302;129;1006167;25135
2021-04-12;RO;Romania;2323;113;1008490;25248
2021-04-13;RO;Romania;3883;193;1012373;25441
2021-04-14;RO;Romania;4076;164;1016449;25605
2021-04-15;RO;Romania;3852;195;1020301;25800
2021-04-16;RO;Romania;3264;137;1023565;25937
2021-04-17;RO;Romania;3474;135;1027039;26072
2021-04-18;RO;Romania;2265;160;1029304;26232
2021-04-19;RO;Romania;1768;149;1031072;26381
2021-04-20;RO;Romania;2931;237;1034003;26618
2021-04-21;RO;Romania;3006;175;1037009;26793
2021-04-22;RO;Romania;2989;150;1039998;26943
2021-04-23;RO;Romania;2523;170;1042521;27113
2021-04-24;RO;Romania;2201;154;1044722;27267
2021-04-25;RO;Romania;1542;127;1046264;27394
2021-04-26;RO;Romania;1256;117;1047520;27511
2021-04-27;RO;Romania;2019;172;1049539;27683
2021-04-28;RO;Romania;2240;150;1051779;27833
2021-04-29;RO;Romania;1850;138;1053629;27971
2021-04-30;RO;Romania;1636;138;1055265;28109
2021-05-01;RO;Romania;1307;85;1056572;28194
2021-05-02;RO;Romania;1083;88;1057655;28282
2021-05-03;RO;Romania;682;98;1058337;28380
2021-05-04;RO;Romania;994;94;1059331;28474
2021-05-05;RO;Romania;1564;142;1060895;28616
2021-05-06;RO;Romania;1632;94;1062527;28710
2021-05-07;RO;Romania;1422;89;1063949;28799
2021-05-08;RO;Romania;1305;104;1065254;28903
2021-05-09;RO;Romania;857;63;1066111;28966
2021-05-10;RO;Romania;620;68;1066731;29034
2021-05-11;RO;Romania;1156;101;1067887;29135
2021-05-12;RO;Romania;930;98;1068817;29233
2021-05-13;RO;Romania;953;75;1069770;29308
2021-05-14;RO;Romania;835;105;1070605;29413
2021-05-15;RO;Romania;729;72;1071334;29485
2021-05-16;RO;Romania;565;38;1071899;29523
2021-05-17;RO;Romania;392;48;1072291;29571
2021-05-18;RO;Romania;681;91;1072972;29662
2021-05-19;RO;Romania;707;54;1073679;29716
2021-05-20;RO;Romania;618;61;1074297;29777
2021-05-21;RO;Romania;484;49;1074781;29826
2021-05-22;RO;Romania;455;59;1075236;29885
2021-05-23;RO;Romania;307;56;1075543;29941
2021-05-24;RO;Romania;230;36;1075773;29977
2021-05-25;RO;Romania;381;63;1076154;30040
2021-05-26;RO;Romania;379;52;1076533;30092
2021-05-27;RO;Romania;307;39;1076840;30131
2021-05-28;RO;Romania;321;43;1077161;30174
2021-05-29;RO;Romania;265;73;1077426;30247
2021-05-30;RO;Romania;158;29;1077584;30276
2021-05-31;RO;Romania;153;36;1077737;30312
2021-06-01;RO;Romania;241;41;1077978;30353
2021-06-02;RO;Romania;164;62;1078142;30415
2021-06-03;RO;Romania;196;84;1078338;30499
2021-06-04;RO;Romania;225;113;1078563;30612
2021-06-05;RO;Romania;179;113;1078742;30725
2021-06-06;RO;Romania;121;90;1078863;30815
2021-06-07;RO;Romania;89;63;1078952;30878
2021-06-08;RO;Romania;202;277;1079154;31155
2021-06-09;RO;Romania;140;228;1079294;31383
2021-06-10;RO;Romania;133;148;1079427;31531
2021-06-11;RO;Romania;103;150;1079530;31681
2021-06-12;RO;Romania;127;123;1079657;31804
2021-06-13;RO;Romania;69;30;1079726;31834
2021-06-14;RO;Romania;50;27;1079776;31861
2021-06-15;RO;Romania;103;96;1079879;31957
2021-06-16;RO;Romania;104;71;1079983;32028
2021-06-17;RO;Romania;87;87;1080070;32115
2021-06-18;RO;Romania;70;97;1080140;32212
2021-06-19;RO;Romania;63;96;1080203;32308
2021-06-20;RO;Romania;53;18;1080256;32326
2021-06-21;RO;Romania;26;65;1080282;32391
2021-06-22;RO;Romania;41;74;1080323;32465
2021-06-23;RO;Romania;66;161;1080389;32626
2021-06-24;RO;Romania;68;145;1080457;32771
2021-06-25;RO;Romania;65;140;1080522;32911
2021-06-26;RO;Romania;62;266;1080584;33177
2021-06-27;RO;Romania;46;76;1080630;33253
2021-06-28;RO;Romania;37;58;1080667;33311
2021-06-29;RO;Romania;73;294;1080740;33605
2021-06-30;RO;Romania;52;181;1080792;33786
2021-07-01;RO;Romania;31;75;1080823;33861
2020-01-31;RU;Russia;2;0;2;0
2020-02-01;RU;Russia;0;0;2;0
2020-02-02;RU;Russia;0;0;2;0
2020-02-03;RU;Russia;0;0;2;0
2020-02-04;RU;Russia;0;0;2;0
2020-02-05;RU;Russia;0;0;2;0
2020-02-06;RU;Russia;0;0;2;0
2020-02-07;RU;Russia;0;0;2;0
2020-02-08;RU;Russia;0;0;2;0
2020-02-09;RU;Russia;0;0;2;0
2020-02-10;RU;Russia;0;0;2;0
2020-02-11;RU;Russia;0;0;2;0
2020-02-12;RU;Russia;0;0;2;0
2020-02-13;RU;Russia;0;0;2;0
2020-02-14;RU;Russia;0;0;2;0
2020-02-15;RU;Russia;0;0;2;0
2020-02-16;RU;Russia;0;0;2;0
2020-02-17;RU;Russia;0;0;2;0
2020-02-18;RU;Russia;0;0;2;0
2020-02-19;RU;Russia;0;0;2;0
2020-02-20;RU;Russia;0;0;2;0
2020-02-21;RU;Russia;0;0;2;0
2020-02-22;RU;Russia;0;0;2;0
2020-02-23;RU;Russia;0;0;2;0
2020-02-24;RU;Russia;0;0;2;0
2020-02-25;RU;Russia;0;0;2;0
2020-02-26;RU;Russia;0;0;2;0
2020-02-27;RU;Russia;0;0;2;0
2020-02-28;RU;Russia;0;0;2;0
2020-02-29;RU;Russia;0;0;2;0
2020-03-01;RU;Russia;0;0;2;0
2020-03-02;RU;Russia;1;0;3;0
2020-03-03;RU;Russia;0;0;3;0
2020-03-04;RU;Russia;0;0;3;0
2020-03-05;RU;Russia;1;0;4;0
2020-03-06;RU;Russia;9;0;13;0
2020-03-07;RU;Russia;0;0;13;0
2020-03-08;RU;Russia;4;0;17;0
2020-03-09;RU;Russia;0;0;17;0
2020-03-10;RU;Russia;3;0;20;0
2020-03-11;RU;Russia;0;0;20;0
2020-03-12;RU;Russia;8;0;28;0
2020-03-13;RU;Russia;17;0;45;0
2020-03-14;RU;Russia;14;0;59;0
2020-03-15;RU;Russia;4;0;63;0
2020-03-16;RU;Russia;27;0;90;0
2020-03-17;RU;Russia;24;0;114;0
2020-03-18;RU;Russia;33;0;147;0
2020-03-19;RU;Russia;52;1;199;1
2020-03-20;RU;Russia;54;0;253;1
2020-03-21;RU;Russia;53;0;306;1
2020-03-22;RU;Russia;61;0;367;1
2020-03-23;RU;Russia;71;0;438;1
2020-03-24;RU;Russia;57;0;495;1
2020-03-25;RU;Russia;163;2;658;3
2020-03-26;RU;Russia;182;0;840;3
2020-03-27;RU;Russia;196;1;1036;4
2020-03-28;RU;Russia;228;0;1264;4
2020-03-29;RU;Russia;270;4;1534;8
2020-03-30;RU;Russia;302;1;1836;9
2020-03-31;RU;Russia;501;8;2337;17
2020-04-01;RU;Russia;440;7;2777;24
2020-04-02;RU;Russia;771;6;3548;30
2020-04-03;RU;Russia;601;4;4149;34
2020-04-04;RU;Russia;582;9;4731;43
2020-04-05;RU;Russia;658;2;5389;45
2020-04-06;RU;Russia;954;2;6343;47
2020-04-07;RU;Russia;1154;11;7497;58
2020-04-08;RU;Russia;1175;5;8672;63
2020-04-09;RU;Russia;1459;13;10131;76
2020-04-10;RU;Russia;1786;18;11917;94
2020-04-11;RU;Russia;1667;12;13584;106
2020-04-12;RU;Russia;2186;24;15770;130
2020-04-13;RU;Russia;2558;18;18328;148
2020-04-14;RU;Russia;2774;22;21102;170
2020-04-15;RU;Russia;3388;28;24490;198
2020-04-16;RU;Russia;3448;34;27938;232
2020-04-17;RU;Russia;4070;41;32008;273
2020-04-18;RU;Russia;4785;40;36793;313
2020-04-19;RU;Russia;6060;48;42853;361
2020-04-20;RU;Russia;4268;44;47121;405
2020-04-21;RU;Russia;5642;51;52763;456
2020-04-22;RU;Russia;5236;57;57999;513
2020-04-23;RU;Russia;4774;42;62773;555
2020-04-24;RU;Russia;5849;60;68622;615
2020-04-25;RU;Russia;5966;66;74588;681
2020-04-26;RU;Russia;6361;66;80949;747
2020-04-27;RU;Russia;6198;47;87147;794
2020-04-28;RU;Russia;6411;73;93558;867
2020-04-29;RU;Russia;5841;105;99399;972
2020-04-30;RU;Russia;7099;101;106498;1073
2020-05-01;RU;Russia;7933;96;114431;1169
2020-05-02;RU;Russia;9623;53;124054;1222
2020-05-03;RU;Russia;10633;58;134687;1280
2020-05-04;RU;Russia;10581;76;145268;1356
2020-05-05;RU;Russia;10102;95;155370;1451
2020-05-06;RU;Russia;10559;86;165929;1537
2020-05-07;RU;Russia;11231;88;177160;1625
2020-05-08;RU;Russia;10699;98;187859;1723
2020-05-09;RU;Russia;10817;104;198676;1827
2020-05-10;RU;Russia;11012;88;209688;1915
2020-05-11;RU;Russia;11656;94;221344;2009
2020-05-12;RU;Russia;10899;107;232243;2116
2020-05-13;RU;Russia;10028;96;242271;2212
2020-05-14;RU;Russia;9974;93;252245;2305
2020-05-15;RU;Russia;10598;113;262843;2418
2020-05-16;RU;Russia;9200;119;272043;2537
2020-05-17;RU;Russia;9709;94;281752;2631
2020-05-18;RU;Russia;8926;91;290678;2722
2020-05-19;RU;Russia;9263;115;299941;2837
2020-05-20;RU;Russia;8764;135;308705;2972
2020-05-21;RU;Russia;8849;127;317554;3099
2020-05-22;RU;Russia;8894;150;326448;3249
2020-05-23;RU;Russia;9434;139;335882;3388
2020-05-24;RU;Russia;8599;153;344481;3541
2020-05-25;RU;Russia;8946;92;353427;3633
2020-05-26;RU;Russia;8915;174;362342;3807
2020-05-27;RU;Russia;8338;161;370680;3968
2020-05-28;RU;Russia;8371;174;379051;4142
2020-05-29;RU;Russia;8572;232;387623;4374
2020-05-30;RU;Russia;8952;181;396575;4555
2020-05-31;RU;Russia;9268;138;405843;4693
2020-06-01;RU;Russia;8485;156;414328;4849
2020-06-02;RU;Russia;8858;182;423186;5031
2020-06-03;RU;Russia;8529;177;431715;5208
2020-06-04;RU;Russia;8823;168;440538;5376
2020-06-05;RU;Russia;8718;144;449256;5520
2020-06-06;RU;Russia;8846;197;458102;5717
2020-06-07;RU;Russia;8971;134;467073;5851
2020-06-08;RU;Russia;8970;112;476043;5963
2020-06-09;RU;Russia;8587;171;484630;6134
2020-06-10;RU;Russia;8393;216;493023;6350
2020-06-11;RU;Russia;8777;172;501800;6522
2020-06-12;RU;Russia;8961;183;510761;6705
2020-06-13;RU;Russia;8697;114;519458;6819
2020-06-14;RU;Russia;8809;119;528267;6938
2020-06-15;RU;Russia;8217;143;536484;7081
2020-06-16;RU;Russia;8241;193;544725;7274
2020-06-17;RU;Russia;7824;194;552549;7468
2020-06-18;RU;Russia;7772;182;560321;7650
2020-06-19;RU;Russia;7971;181;568292;7831
2020-06-20;RU;Russia;7870;161;576162;7992
2020-06-21;RU;Russia;7717;109;583879;8101
2020-06-22;RU;Russia;7586;95;591465;8196
2020-06-23;RU;Russia;7413;153;598878;8349
2020-06-24;RU;Russia;7165;154;606043;8503
2020-06-25;RU;Russia;7105;91;613148;8594
2020-06-26;RU;Russia;6788;176;619936;8770
2020-06-27;RU;Russia;6843;188;626779;8958
2020-06-28;RU;Russia;6784;102;633563;9060
2020-06-29;RU;Russia;6683;92;640246;9152
2020-06-30;RU;Russia;6683;154;646929;9306
2020-07-01;RU;Russia;6550;215;653479;9521
2020-07-02;RU;Russia;6752;147;660231;9668
2020-07-03;RU;Russia;6710;176;666941;9844
2020-07-04;RU;Russia;6623;167;673564;10011
2020-07-05;RU;Russia;6719;134;680283;10145
2020-07-06;RU;Russia;6569;135;686852;10280
2020-07-07;RU;Russia;6363;198;693215;10478
2020-07-08;RU;Russia;6534;172;699749;10650
2020-07-09;RU;Russia;6491;176;706240;10826
2020-07-10;RU;Russia;6623;174;712863;11000
2020-07-11;RU;Russia;6586;188;719449;11188
2020-07-12;RU;Russia;6587;130;726036;11318
2020-07-13;RU;Russia;6511;104;732547;11422
2020-07-14;RU;Russia;6240;175;738787;11597
2020-07-15;RU;Russia;6410;156;745197;11753
2020-07-16;RU;Russia;6415;167;751612;11920
2020-07-17;RU;Russia;6389;186;758001;12106
2020-07-18;RU;Russia;6214;122;764215;12228
2020-07-19;RU;Russia;6096;95;770311;12323
2020-07-20;RU;Russia;5901;85;776212;12408
2020-07-21;RU;Russia;5828;153;782040;12561
2020-07-22;RU;Russia;5850;165;787890;12726
2020-07-23;RU;Russia;5830;147;793720;12873
2020-07-24;RU;Russia;5779;153;799499;13026
2020-07-25;RU;Russia;5833;146;805332;13172
2020-07-26;RU;Russia;5741;77;811073;13249
2020-07-27;RU;Russia;5607;85;816680;13334
2020-07-28;RU;Russia;5380;149;822060;13483
2020-07-29;RU;Russia;5449;167;827509;13650
2020-07-30;RU;Russia;5484;128;832993;13778
2020-07-31;RU;Russia;5468;161;838461;13939
2020-08-01;RU;Russia;5429;95;843890;14034
2020-08-02;RU;Russia;5387;70;849277;14104
2020-08-03;RU;Russia;5364;79;854641;14183
2020-08-04;RU;Russia;5121;144;859762;14327
2020-08-05;RU;Russia;5186;138;864948;14465
2020-08-06;RU;Russia;5239;114;870187;14579
2020-08-07;RU;Russia;5191;119;875378;14698
2020-08-08;RU;Russia;5185;129;880563;14827
2020-08-09;RU;Russia;5155;76;885718;14903
2020-08-10;RU;Russia;5081;70;890799;14973
2020-08-11;RU;Russia;4892;130;895691;15103
2020-08-12;RU;Russia;5054;128;900745;15231
2020-08-13;RU;Russia;5017;122;905762;15353
2020-08-14;RU;Russia;5016;114;910778;15467
2020-08-15;RU;Russia;5030;118;915808;15585
2020-08-16;RU;Russia;4911;68;920719;15653
2020-08-17;RU;Russia;4839;54;925558;15707
2020-08-18;RU;Russia;4718;129;930276;15836
2020-08-19;RU;Russia;4790;115;935066;15951
2020-08-20;RU;Russia;4767;107;939833;16058
2020-08-21;RU;Russia;4838;90;944671;16148
2020-08-22;RU;Russia;4860;120;949531;16268
2020-08-23;RU;Russia;4797;73;954328;16341
2020-08-24;RU;Russia;4688;65;959016;16406
2020-08-25;RU;Russia;4639;118;963655;16524
2020-08-26;RU;Russia;4642;114;968297;16638
2020-08-27;RU;Russia;4675;120;972972;16758
2020-08-28;RU;Russia;4758;108;977730;16866
2020-08-29;RU;Russia;4843;111;982573;16977
2020-08-30;RU;Russia;4897;68;987470;17045
2020-08-31;RU;Russia;4932;83;992402;17128
2020-09-01;RU;Russia;4670;122;997072;17250
2020-09-02;RU;Russia;4893;115;1001965;17365
2020-09-03;RU;Russia;4958;114;1006923;17479
2020-09-04;RU;Russia;5064;119;1011987;17598
2020-09-05;RU;Russia;5144;109;1017131;17707
2020-09-06;RU;Russia;5097;61;1022228;17768
2020-09-07;RU;Russia;5106;50;1027334;17818
2020-09-08;RU;Russia;5020;121;1032354;17939
2020-09-09;RU;Russia;5172;141;1037526;18080
2020-09-10;RU;Russia;5310;127;1042836;18207
2020-09-11;RU;Russia;5421;102;1048257;18309
2020-09-12;RU;Russia;5406;117;1053663;18426
2020-09-13;RU;Russia;5361;91;1059024;18517
2020-09-14;RU;Russia;5414;56;1064438;18573
2020-09-15;RU;Russia;5435;150;1069873;18723
2020-09-16;RU;Russia;5612;130;1075485;18853
2020-09-17;RU;Russia;5667;143;1081152;18996
2020-09-18;RU;Russia;5803;132;1086955;19128
2020-09-19;RU;Russia;5960;142;1092915;19270
2020-09-20;RU;Russia;6043;79;1098958;19349
2020-09-21;RU;Russia;6090;71;1105048;19420
2020-09-22;RU;Russia;6109;155;1111157;19575
2020-09-23;RU;Russia;6330;145;1117487;19720
2020-09-24;RU;Russia;6489;147;1123976;19867
2020-09-25;RU;Russia;7112;106;1131088;19973
2020-09-26;RU;Russia;7421;167;1138509;20140
2020-09-27;RU;Russia;7764;99;1146273;20239
2020-09-28;RU;Russia;8026;60;1154299;20299
2020-09-29;RU;Russia;8129;157;1162428;20456
2020-09-30;RU;Russia;8371;174;1170799;20630
2020-10-01;RU;Russia;8835;166;1179634;20796
2020-10-02;RU;Russia;9294;185;1188928;20981
2020-10-03;RU;Russia;9735;172;1198663;21153
2020-10-04;RU;Russia;10376;107;1209039;21260
2020-10-05;RU;Russia;10757;115;1219796;21375
2020-10-06;RU;Russia;11481;184;1231277;21559
2020-10-07;RU;Russia;10981;196;1242258;21755
2020-10-08;RU;Russia;11345;184;1253603;21939
2020-10-09;RU;Russia;11969;198;1265572;22137
2020-10-10;RU;Russia;12673;194;1278245;22331
2020-10-11;RU;Russia;13442;140;1291687;22471
2020-10-12;RU;Russia;13406;123;1305093;22594
2020-10-13;RU;Russia;13690;240;1318783;22834
2020-10-14;RU;Russia;14041;235;1332824;23069
2020-10-15;RU;Russia;13556;281;1346380;23350
2020-10-16;RU;Russia;14937;230;1361317;23580
2020-10-17;RU;Russia;14703;277;1376020;23857
2020-10-18;RU;Russia;14804;182;1390824;24039
2020-10-19;RU;Russia;15843;166;1406667;24205
2020-10-20;RU;Russia;16108;268;1422775;24473
2020-10-21;RU;Russia;15444;313;1438219;24786
2020-10-22;RU;Russia;15704;286;1453923;25072
2020-10-23;RU;Russia;17077;281;1471000;25353
2020-10-24;RU;Russia;16260;294;1487260;25647
2020-10-25;RU;Russia;16392;228;1503652;25875
2020-10-26;RU;Russia;17148;217;1520800;26092
2020-10-27;RU;Russia;16342;317;1537142;26409
2020-10-28;RU;Russia;15886;343;1553028;26752
2020-10-29;RU;Russia;17418;359;1570446;27111
2020-10-30;RU;Russia;17987;351;1588433;27462
2020-10-31;RU;Russia;17834;325;1606267;27787
2020-11-01;RU;Russia;18381;239;1624648;28026
2020-11-02;RU;Russia;18017;238;1642665;28264
2020-11-03;RU;Russia;18431;347;1661096;28611
2020-11-04;RU;Russia;19483;385;1680579;28996
2020-11-05;RU;Russia;19116;289;1699695;29285
2020-11-06;RU;Russia;20368;369;1720063;29654
2020-11-07;RU;Russia;20109;356;1740172;30010
2020-11-08;RU;Russia;20248;282;1760420;30292
2020-11-09;RU;Russia;21577;254;1781997;30546
2020-11-10;RU;Russia;20765;353;1802762;30899
2020-11-11;RU;Russia;19583;427;1822345;31326
2020-11-12;RU;Russia;21333;429;1843678;31755
2020-11-13;RU;Russia;21717;401;1865395;32156
2020-11-14;RU;Russia;22441;380;1887836;32536
2020-11-15;RU;Russia;22313;349;1910149;32885
2020-11-16;RU;Russia;22562;299;1932711;33184
2020-11-17;RU;Russia;22201;435;1954912;33619
2020-11-18;RU;Russia;20717;449;1975629;34068
2020-11-19;RU;Russia;23337;457;1998966;34525
2020-11-20;RU;Russia;24059;455;2023025;34980
2020-11-21;RU;Russia;24538;462;2047563;35442
2020-11-22;RU;Russia;24295;396;2071858;35838
2020-11-23;RU;Russia;24891;354;2096749;36192
2020-11-24;RU;Russia;24087;483;2120836;36675
2020-11-25;RU;Russia;23393;498;2144229;37173
2020-11-26;RU;Russia;25195;515;2169424;37688
2020-11-27;RU;Russia;27267;487;2196691;38175
2020-11-28;RU;Russia;26809;501;2223500;38676
2020-11-29;RU;Russia;26390;451;2249890;39127
2020-11-30;RU;Russia;26046;364;2275936;39491
2020-12-01;RU;Russia;26126;559;2302062;40050
2020-12-02;RU;Russia;25043;580;2327105;40630
2020-12-03;RU;Russia;27829;543;2354934;41173
2020-12-04;RU;Russia;27078;557;2382012;41730
2020-12-05;RU;Russia;28450;498;2410462;42228
2020-12-06;RU;Russia;28701;447;2439163;42675
2020-12-07;RU;Russia;27798;447;2466961;43122
2020-12-08;RU;Russia;25752;552;2492713;43674
2020-12-09;RU;Russia;25838;546;2518551;44220
2020-12-10;RU;Russia;27562;549;2546113;44769
2020-12-11;RU;Russia;28206;601;2574319;45370
2020-12-12;RU;Russia;27729;553;2602048;45923
2020-12-13;RU;Russia;27651;481;2629699;46404
2020-12-14;RU;Russia;26902;442;2656601;46846
2020-12-15;RU;Russia;26265;564;2682866;47410
2020-12-16;RU;Russia;26074;584;2708940;47994
2020-12-17;RU;Russia;27787;574;2736727;48568
2020-12-18;RU;Russia;28116;602;2764843;49170
2020-12-19;RU;Russia;27772;574;2792615;49744
2020-12-20;RU;Russia;28510;498;2821125;50242
2020-12-21;RU;Russia;28917;481;2850042;50723
2020-12-22;RU;Russia;28340;551;2878382;51274
2020-12-23;RU;Russia;26814;536;2905196;51810
2020-12-24;RU;Russia;29499;624;2934695;52434
2020-12-25;RU;Russia;28595;551;2963290;52985
2020-12-26;RU;Russia;28833;554;2992123;53539
2020-12-27;RU;Russia;27849;541;3019972;54080
2020-12-28;RU;Russia;27363;479;3047335;54559
2020-12-29;RU;Russia;26588;548;3073923;55107
2020-12-30;RU;Russia;26095;585;3100018;55692
2020-12-31;RU;Russia;27329;579;3127347;56271
2021-01-01;RU;Russia;26613;527;3153960;56798
2021-01-02;RU;Russia;25938;437;3179898;57235
2021-01-03;RU;Russia;23845;495;3203743;57730
2021-01-04;RU;Russia;23015;473;3226758;58203
2021-01-05;RU;Russia;23955;503;3250713;58706
2021-01-06;RU;Russia;23902;431;3274615;59137
2021-01-07;RU;Russia;23218;491;3297833;59628
2021-01-08;RU;Russia;23330;439;3321163;60067
2021-01-09;RU;Russia;23012;456;3344175;60523
2021-01-10;RU;Russia;22540;440;3366715;60963
2021-01-11;RU;Russia;23018;426;3389733;61389
2021-01-12;RU;Russia;22657;519;3412390;61908
2021-01-13;RU;Russia;22544;555;3434934;62463
2021-01-14;RU;Russia;24303;553;3459237;63016
2021-01-15;RU;Russia;24294;542;3483531;63558
2021-01-16;RU;Russia;23670;576;3507201;64134
2021-01-17;RU;Russia;23178;467;3530379;64601
2021-01-18;RU;Russia;22509;458;3552888;65059
2021-01-19;RU;Russia;21442;573;3574330;65632
2021-01-20;RU;Russia;20806;582;3595136;66214
2021-01-21;RU;Russia;21544;596;3616680;66810
2021-01-22;RU;Russia;21182;566;3637862;67376
2021-01-23;RU;Russia;20585;543;3658447;67919
2021-01-24;RU;Russia;20800;478;3679247;68397
2021-01-25;RU;Russia;18999;444;3698246;68841
2021-01-26;RU;Russia;17982;550;3716228;69391
2021-01-27;RU;Russia;17464;580;3733692;69971
2021-01-28;RU;Russia;18856;562;3752548;70533
2021-01-29;RU;Russia;18966;521;3771514;71054
2021-01-30;RU;Russia;18751;502;3790265;71556
2021-01-31;RU;Russia;18083;473;3808348;72029
2021-02-01;RU;Russia;17391;427;3825739;72456
2021-02-02;RU;Russia;16406;526;3842145;72982
2021-02-03;RU;Russia;16222;515;3858367;73497
2021-02-04;RU;Russia;16463;508;3874830;74005
2021-02-05;RU;Russia;16444;515;3891274;74520
2021-02-06;RU;Russia;16379;490;3907653;75010
2021-02-07;RU;Russia;15808;420;3923461;75430
2021-02-08;RU;Russia;15701;398;3939162;75828
2021-02-09;RU;Russia;14808;519;3953970;76347
2021-02-10;RU;Russia;14258;526;3968228;76873
2021-02-11;RU;Russia;14803;542;3983031;77415
2021-02-12;RU;Russia;14867;496;3997898;77911
2021-02-13;RU;Russia;14640;492;4012538;78403
2021-02-14;RU;Russia;13968;422;4026506;78825
2021-02-15;RU;Russia;13999;385;4040505;79210
2021-02-16;RU;Russia;13030;449;4053535;79659
2021-02-17;RU;Russia;12629;459;4066164;80118
2021-02-18;RU;Russia;13243;469;4079407;80587
2021-02-19;RU;Russia;13242;461;4092649;81048
2021-02-20;RU;Russia;12775;469;4105424;81517
2021-02-21;RU;Russia;12568;409;4117992;81926
2021-02-22;RU;Russia;12455;329;4130447;82255
2021-02-23;RU;Russia;11679;411;4142126;82666
2021-02-24;RU;Russia;11609;378;4153735;83044
2021-02-25;RU;Russia;11067;437;4164802;83481
2021-02-26;RU;Russia;10955;419;4175757;83900
2021-02-27;RU;Russia;11409;430;4187166;84330
2021-02-28;RU;Russia;11234;370;4198400;84700
2021-03-01;RU;Russia;11450;325;4209850;85025
2021-03-02;RU;Russia;10441;433;4220291;85458
2021-03-03;RU;Russia;10416;443;4230707;85901
2021-03-04;RU;Russia;11263;467;4241970;86368
2021-03-05;RU;Russia;10906;453;4252876;86821
2021-03-06;RU;Russia;10909;432;4263785;87253
2021-03-07;RU;Russia;10478;361;4274263;87614
2021-03-08;RU;Russia;10145;371;4284408;87985
2021-03-09;RU;Russia;9342;330;4293750;88315
2021-03-10;RU;Russia;8976;458;4302726;88773
2021-03-11;RU;Russia;9167;451;4311893;89224
2021-03-12;RU;Russia;9695;477;4321588;89701
2021-03-13;RU;Russia;9808;468;4331396;90169
2021-03-14;RU;Russia;9985;389;4341381;90558
2021-03-15;RU;Russia;9347;400;4350728;90958
2021-03-16;RU;Russia;9305;437;4360033;91395
2021-03-17;RU;Russia;8910;420;4368943;91815
2021-03-18;RU;Russia;9713;451;4378656;92266
2021-03-19;RU;Russia;9612;438;4388268;92704
2021-03-20;RU;Russia;9548;386;4397816;93090
2021-03-21;RU;Russia;9215;367;4407031;93457
2021-03-22;RU;Russia;9195;355;4416226;93812
2021-03-23;RU;Russia;8369;419;4424595;94231
2021-03-24;RU;Russia;8769;393;4433364;94624
2021-03-25;RU;Russia;9128;386;4442492;95010
2021-03-26;RU;Russia;9073;400;4451565;95410
2021-03-27;RU;Russia;8783;382;4460348;95792
2021-03-28;RU;Russia;8979;331;4469327;96123
2021-03-29;RU;Russia;8589;290;4477916;96413
2021-03-30;RU;Russia;8162;404;4486078;96817
2021-03-31;RU;Russia;8156;402;4494234;97219
2021-04-01;RU;Russia;9057;375;4503291;97594
2021-04-02;RU;Russia;8682;392;4511973;97986
2021-04-03;RU;Russia;8906;377;4520879;98363
2021-04-04;RU;Russia;8697;350;4529576;98713
2021-04-05;RU;Russia;8525;336;4538101;99049
2021-04-06;RU;Russia;8206;382;4546307;99431
2021-04-07;RU;Russia;8174;369;4554481;99800
2021-04-08;RU;Russia;8545;358;4563026;100158
2021-04-09;RU;Russia;9027;396;4572053;100554
2021-04-10;RU;Russia;8580;395;4580633;100949
2021-04-11;RU;Russia;8576;333;4589209;101282
2021-04-12;RU;Russia;8191;270;4597400;101552
2021-04-13;RU;Russia;8044;330;4605444;101882
2021-04-14;RU;Russia;8202;393;4613646;102275
2021-04-15;RU;Russia;8818;392;4622464;102667
2021-04-16;RU;Russia;8872;392;4631336;103059
2021-04-17;RU;Russia;9201;392;4640537;103451
2021-04-18;RU;Russia;8507;383;4649044;103834
2021-04-19;RU;Russia;8465;339;4657509;104173
2021-04-20;RU;Russia;8044;372;4665553;104545
2021-04-21;RU;Russia;8146;392;4673699;104937
2021-04-22;RU;Russia;8874;391;4682573;105328
2021-04-23;RU;Russia;8717;390;4691290;105718
2021-04-24;RU;Russia;8698;390;4699988;106108
2021-04-25;RU;Russia;8652;326;4708640;106434
2021-04-26;RU;Russia;8681;349;4717321;106783
2021-04-27;RU;Russia;7931;384;4725252;107167
2021-04-28;RU;Russia;7729;380;4732981;107547
2021-04-29;RU;Russia;9161;355;4742142;107902
2021-04-30;RU;Russia;8613;388;4750755;108290
2021-05-01;RU;Russia;9147;385;4759902;108675
2021-05-02;RU;Russia;8574;336;4768476;109011
2021-05-03;RU;Russia;8368;330;4776844;109341
2021-05-04;RU;Russia;7653;329;4784497;109670
2021-05-05;RU;Russia;7857;352;4792354;110022
2021-05-06;RU;Russia;7518;344;4799872;110366
2021-05-07;RU;Russia;8261;369;4808133;110735
2021-05-08;RU;Russia;8198;362;4816331;111097
2021-05-09;RU;Russia;8290;328;4824621;111425
2021-05-10;RU;Russia;8338;315;4832959;111740
2021-05-11;RU;Russia;7989;323;4840948;112063
2021-05-12;RU;Russia;8096;347;4849044;112410
2021-05-13;RU;Russia;8259;385;4857303;112795
2021-05-14;RU;Russia;9338;387;4866641;113182
2021-05-15;RU;Russia;8667;359;4875308;113541
2021-05-16;RU;Russia;8426;386;4883734;113927
2021-05-17;RU;Russia;9204;336;4892938;114263
2021-05-18;RU;Russia;8057;356;4900995;114619
2021-05-19;RU;Russia;7799;384;4908794;115003
2021-05-20;RU;Russia;9112;390;4917906;115393
2021-05-21;RU;Russia;8811;371;4926717;115764
2021-05-22;RU;Russia;8585;380;4935302;116144
2021-05-23;RU;Russia;8827;353;4944129;116497
2021-05-24;RU;Russia;8283;315;4952412;116812
2021-05-25;RU;Russia;7762;385;4960174;117197
2021-05-26;RU;Russia;8247;398;4968421;117595
2021-05-27;RU;Russia;8911;395;4977332;117990
2021-05-28;RU;Russia;9126;396;4986458;118386
2021-05-29;RU;Russia;9155;395;4995613;118781
2021-05-30;RU;Russia;9558;349;5005171;119130
2021-05-31;RU;Russia;8341;334;5013512;119464
2021-06-01;RU;Russia;9369;366;5022881;119830
2021-06-02;RU;Russia;8702;387;5031583;120217
2021-06-03;RU;Russia;8807;387;5040390;120604
2021-06-04;RU;Russia;8820;370;5049210;120974
2021-06-05;RU;Russia;9011;391;5058221;121365
2021-06-06;RU;Russia;9025;346;5067246;121711
2021-06-07;RU;Russia;9297;326;5076543;122037
2021-06-08;RU;Russia;9843;372;5086386;122409
2021-06-09;RU;Russia;10271;393;5096657;122802
2021-06-10;RU;Russia;11560;376;5108217;123178
2021-06-11;RU;Russia;12361;390;5120578;123568
2021-06-12;RU;Russia;13360;393;5133938;123961
2021-06-13;RU;Russia;14561;353;5148499;124314
2021-06-14;RU;Russia;13550;367;5162049;124681
2021-06-15;RU;Russia;14002;374;5176051;125055
2021-06-16;RU;Russia;13209;388;5189260;125443
2021-06-17;RU;Russia;13857;410;5203117;125853
2021-06-18;RU;Russia;17051;447;5220168;126300
2021-06-19;RU;Russia;17679;461;5237847;126761
2021-06-20;RU;Russia;17367;445;5255214;127206
2021-06-21;RU;Russia;17114;435;5272328;127641
2021-06-22;RU;Russia;16438;539;5288766;128180
2021-06-23;RU;Russia;17303;539;5306069;128719
2021-06-24;RU;Russia;19871;559;5325940;129278
2021-06-25;RU;Russia;20065;591;5346005;129869
2021-06-26;RU;Russia;21312;610;5367317;130479
2021-06-27;RU;Russia;20169;591;5387486;131070
2021-06-28;RU;Russia;21258;601;5408744;131671
2021-06-29;RU;Russia;20217;643;5428961;132314
2021-06-30;RU;Russia;20633;659;5449594;132973
2021-07-01;RU;Russia;23128;660;5472722;133633
2020-03-14;RW;Rwanda;1;0;1;0
2020-03-15;RW;Rwanda;0;0;1;0
2020-03-16;RW;Rwanda;4;0;5;0
2020-03-17;RW;Rwanda;2;0;7;0
2020-03-18;RW;Rwanda;1;0;8;0
2020-03-19;RW;Rwanda;0;0;8;0
2020-03-20;RW;Rwanda;9;0;17;0
2020-03-21;RW;Rwanda;0;0;17;0
2020-03-22;RW;Rwanda;2;0;19;0
2020-03-23;RW;Rwanda;17;0;36;0
2020-03-24;RW;Rwanda;4;0;40;0
2020-03-25;RW;Rwanda;1;0;41;0
2020-03-26;RW;Rwanda;9;0;50;0
2020-03-27;RW;Rwanda;4;0;54;0
2020-03-28;RW;Rwanda;6;0;60;0
2020-03-29;RW;Rwanda;10;0;70;0
2020-03-30;RW;Rwanda;0;0;70;0
2020-03-31;RW;Rwanda;5;0;75;0
2020-04-01;RW;Rwanda;7;0;82;0
2020-04-02;RW;Rwanda;2;0;84;0
2020-04-03;RW;Rwanda;5;0;89;0
2020-04-04;RW;Rwanda;13;0;102;0
2020-04-05;RW;Rwanda;2;0;104;0
2020-04-06;RW;Rwanda;1;0;105;0
2020-04-07;RW;Rwanda;0;0;105;0
2020-04-08;RW;Rwanda;5;0;110;0
2020-04-09;RW;Rwanda;0;0;110;0
2020-04-10;RW;Rwanda;8;0;118;0
2020-04-11;RW;Rwanda;2;0;120;0
2020-04-12;RW;Rwanda;6;0;126;0
2020-04-13;RW;Rwanda;1;0;127;0
2020-04-14;RW;Rwanda;7;0;134;0
2020-04-15;RW;Rwanda;2;0;136;0
2020-04-16;RW;Rwanda;2;0;138;0
2020-04-17;RW;Rwanda;5;0;143;0
2020-04-18;RW;Rwanda;1;0;144;0
2020-04-19;RW;Rwanda;3;0;147;0
2020-04-20;RW;Rwanda;0;0;147;0
2020-04-21;RW;Rwanda;3;0;150;0
2020-04-22;RW;Rwanda;3;0;153;0
2020-04-23;RW;Rwanda;1;0;154;0
2020-04-24;RW;Rwanda;22;0;176;0
2020-04-25;RW;Rwanda;7;0;183;0
2020-04-26;RW;Rwanda;8;0;191;0
2020-04-27;RW;Rwanda;16;0;207;0
2020-04-28;RW;Rwanda;5;0;212;0
2020-04-29;RW;Rwanda;13;0;225;0
2020-04-30;RW;Rwanda;18;0;243;0
2020-05-01;RW;Rwanda;6;0;249;0
2020-05-02;RW;Rwanda;6;0;255;0
2020-05-03;RW;Rwanda;4;0;259;0
2020-05-04;RW;Rwanda;2;0;261;0
2020-05-05;RW;Rwanda;0;0;261;0
2020-05-06;RW;Rwanda;7;0;268;0
2020-05-07;RW;Rwanda;3;0;271;0
2020-05-08;RW;Rwanda;2;0;273;0
2020-05-09;RW;Rwanda;7;0;280;0
2020-05-10;RW;Rwanda;4;0;284;0
2020-05-11;RW;Rwanda;1;0;285;0
2020-05-12;RW;Rwanda;1;0;286;0
2020-05-13;RW;Rwanda;1;0;287;0
2020-05-14;RW;Rwanda;0;0;287;0
2020-05-15;RW;Rwanda;0;0;287;0
2020-05-16;RW;Rwanda;2;0;289;0
2020-05-17;RW;Rwanda;3;0;292;0
2020-05-18;RW;Rwanda;5;0;297;0
2020-05-19;RW;Rwanda;11;0;308;0
2020-05-20;RW;Rwanda;6;0;314;0
2020-05-21;RW;Rwanda;6;0;320;0
2020-05-22;RW;Rwanda;1;0;321;0
2020-05-23;RW;Rwanda;4;0;325;0
2020-05-24;RW;Rwanda;2;0;327;0
2020-05-25;RW;Rwanda;9;0;336;0
2020-05-26;RW;Rwanda;3;0;339;0
2020-05-27;RW;Rwanda;7;0;346;0
2020-05-28;RW;Rwanda;3;0;349;0
2020-05-29;RW;Rwanda;6;0;355;0
2020-05-30;RW;Rwanda;4;1;359;1
2020-05-31;RW;Rwanda;11;0;370;1
2020-06-01;RW;Rwanda;7;0;377;1
2020-06-02;RW;Rwanda;7;1;384;2
2020-06-03;RW;Rwanda;13;0;397;2
2020-06-04;RW;Rwanda;13;0;410;2
2020-06-05;RW;Rwanda;10;0;420;2
2020-06-06;RW;Rwanda;11;0;431;2
2020-06-07;RW;Rwanda;8;0;439;2
2020-06-08;RW;Rwanda;12;0;451;2
2020-06-09;RW;Rwanda;12;0;463;2
2020-06-10;RW;Rwanda;13;0;476;2
2020-06-11;RW;Rwanda;18;0;494;2
2020-06-12;RW;Rwanda;16;0;510;2
2020-06-13;RW;Rwanda;31;0;541;2
2020-06-14;RW;Rwanda;41;0;582;2
2020-06-15;RW;Rwanda;30;0;612;2
2020-06-16;RW;Rwanda;24;0;636;2
2020-06-17;RW;Rwanda;3;0;639;2
2020-06-18;RW;Rwanda;7;0;646;2
2020-06-19;RW;Rwanda;15;0;661;2
2020-06-20;RW;Rwanda;41;0;702;2
2020-06-21;RW;Rwanda;26;0;728;2
2020-06-22;RW;Rwanda;59;0;787;2
2020-06-23;RW;Rwanda;11;0;798;2
2020-06-24;RW;Rwanda;32;0;830;2
2020-06-25;RW;Rwanda;20;0;850;2
2020-06-26;RW;Rwanda;8;0;858;2
2020-06-27;RW;Rwanda;20;0;878;2
2020-06-28;RW;Rwanda;22;0;900;2
2020-06-29;RW;Rwanda;101;0;1001;2
2020-06-30;RW;Rwanda;24;0;1025;2
2020-07-01;RW;Rwanda;17;1;1042;3
2020-07-02;RW;Rwanda;21;0;1063;3
2020-07-03;RW;Rwanda;18;0;1081;3
2020-07-04;RW;Rwanda;11;0;1092;3
2020-07-05;RW;Rwanda;13;0;1105;3
2020-07-06;RW;Rwanda;8;0;1113;3
2020-07-07;RW;Rwanda;59;0;1172;3
2020-07-08;RW;Rwanda;22;0;1194;3
2020-07-09;RW;Rwanda;16;0;1210;3
2020-07-10;RW;Rwanda;42;0;1252;3
2020-07-11;RW;Rwanda;47;1;1299;4
2020-07-12;RW;Rwanda;38;0;1337;4
2020-07-13;RW;Rwanda;41;0;1378;4
2020-07-14;RW;Rwanda;38;0;1416;4
2020-07-15;RW;Rwanda;19;0;1435;4
2020-07-16;RW;Rwanda;38;0;1473;4
2020-07-17;RW;Rwanda;12;0;1485;4
2020-07-18;RW;Rwanda;54;1;1539;5
2020-07-19;RW;Rwanda;43;0;1582;5
2020-07-20;RW;Rwanda;47;0;1629;5
2020-07-21;RW;Rwanda;26;0;1655;5
2020-07-22;RW;Rwanda;34;0;1689;5
2020-07-23;RW;Rwanda;21;0;1710;5
2020-07-24;RW;Rwanda;19;0;1729;5
2020-07-25;RW;Rwanda;23;0;1752;5
2020-07-26;RW;Rwanda;69;0;1821;5
2020-07-27;RW;Rwanda;58;0;1879;5
2020-07-28;RW;Rwanda;47;0;1926;5
2020-07-29;RW;Rwanda;37;0;1963;5
2020-07-30;RW;Rwanda;31;0;1994;5
2020-07-31;RW;Rwanda;28;0;2022;5
2020-08-01;RW;Rwanda;20;0;2042;5
2020-08-02;RW;Rwanda;20;0;2062;5
2020-08-03;RW;Rwanda;30;0;2092;5
2020-08-04;RW;Rwanda;7;0;2099;5
2020-08-05;RW;Rwanda;5;0;2104;5
2020-08-06;RW;Rwanda;7;0;2111;5
2020-08-07;RW;Rwanda;17;0;2128;5
2020-08-08;RW;Rwanda;6;1;2134;6
2020-08-09;RW;Rwanda;6;1;2140;7
2020-08-10;RW;Rwanda;12;0;2152;7
2020-08-11;RW;Rwanda;19;0;2171;7
2020-08-12;RW;Rwanda;18;1;2189;8
2020-08-13;RW;Rwanda;11;0;2200;8
2020-08-14;RW;Rwanda;93;0;2293;8
2020-08-15;RW;Rwanda;59;0;2352;8
2020-08-16;RW;Rwanda;101;0;2453;8
2020-08-17;RW;Rwanda;87;0;2540;8
2020-08-18;RW;Rwanda;37;2;2577;10
2020-08-19;RW;Rwanda;67;0;2644;10
2020-08-20;RW;Rwanda;73;1;2717;11
2020-08-21;RW;Rwanda;63;0;2780;11
2020-08-22;RW;Rwanda;109;0;2889;11
2020-08-23;RW;Rwanda;200;1;3089;12
2020-08-24;RW;Rwanda;217;2;3306;14
2020-08-25;RW;Rwanda;231;1;3537;15
2020-08-26;RW;Rwanda;88;0;3625;15
2020-08-27;RW;Rwanda;47;0;3672;15
2020-08-28;RW;Rwanda;70;1;3742;16
2020-08-29;RW;Rwanda;101;0;3843;16
2020-08-30;RW;Rwanda;177;0;4020;16
2020-08-31;RW;Rwanda;43;0;4063;16
2020-09-01;RW;Rwanda;79;0;4142;16
2020-09-02;RW;Rwanda;76;1;4218;17
2020-09-03;RW;Rwanda;37;1;4255;18
2020-09-04;RW;Rwanda;49;0;4304;18
2020-09-05;RW;Rwanda;45;0;4349;18
2020-09-06;RW;Rwanda;25;1;4374;19
2020-09-07;RW;Rwanda;35;0;4409;19
2020-09-08;RW;Rwanda;30;1;4439;20
2020-09-09;RW;Rwanda;21;1;4460;21
2020-09-10;RW;Rwanda;19;1;4479;22
2020-09-11;RW;Rwanda;55;0;4534;22
2020-09-12;RW;Rwanda;31;0;4565;22
2020-09-13;RW;Rwanda;26;0;4591;22
2020-09-14;RW;Rwanda;11;0;4602;22
2020-09-15;RW;Rwanda;22;0;4624;22
2020-09-16;RW;Rwanda;10;0;4634;22
2020-09-17;RW;Rwanda;19;1;4653;23
2020-09-18;RW;Rwanda;18;2;4671;25
2020-09-19;RW;Rwanda;18;1;4689;26
2020-09-20;RW;Rwanda;22;0;4711;26
2020-09-21;RW;Rwanda;11;1;4722;27
2020-09-22;RW;Rwanda;16;0;4738;27
2020-09-23;RW;Rwanda;41;0;4779;27
2020-09-24;RW;Rwanda;10;0;4789;27
2020-09-25;RW;Rwanda;9;2;4798;29
2020-09-26;RW;Rwanda;13;0;4811;29
2020-09-27;RW;Rwanda;9;0;4820;29
2020-09-28;RW;Rwanda;12;0;4832;29
2020-09-29;RW;Rwanda;4;0;4836;29
2020-09-30;RW;Rwanda;4;0;4840;29
2020-10-01;RW;Rwanda;3;0;4843;29
2020-10-02;RW;Rwanda;4;0;4847;29
2020-10-03;RW;Rwanda;5;0;4852;29
2020-10-04;RW;Rwanda;14;0;4866;29
2020-10-05;RW;Rwanda;1;0;4867;29
2020-10-06;RW;Rwanda;6;0;4873;29
2020-10-07;RW;Rwanda;10;0;4883;29
2020-10-08;RW;Rwanda;2;0;4885;29
2020-10-09;RW;Rwanda;5;1;4890;30
2020-10-10;RW;Rwanda;2;0;4892;30
2020-10-11;RW;Rwanda;4;1;4896;31
2020-10-12;RW;Rwanda;9;1;4905;32
2020-10-13;RW;Rwanda;3;0;4908;32
2020-10-14;RW;Rwanda;32;1;4940;33
2020-10-15;RW;Rwanda;13;0;4953;33
2020-10-16;RW;Rwanda;12;1;4965;34
2020-10-17;RW;Rwanda;6;0;4971;34
2020-10-18;RW;Rwanda;3;0;4974;34
2020-10-19;RW;Rwanda;18;0;4992;34
2020-10-20;RW;Rwanda;4;0;4996;34
2020-10-21;RW;Rwanda;16;0;5012;34
2020-10-22;RW;Rwanda;5;0;5017;34
2020-10-23;RW;Rwanda;35;0;5052;34
2020-10-24;RW;Rwanda;8;0;5060;34
2020-10-25;RW;Rwanda;6;0;5066;34
2020-10-26;RW;Rwanda;7;0;5073;34
2020-10-27;RW;Rwanda;11;1;5084;35
2020-10-28;RW;Rwanda;45;0;5129;35
2020-10-29;RW;Rwanda;2;0;5131;35
2020-10-30;RW;Rwanda;3;0;5134;35
2020-10-31;RW;Rwanda;3;0;5137;35
2020-11-01;RW;Rwanda;9;0;5146;35
2020-11-02;RW;Rwanda;9;0;5155;35
2020-11-03;RW;Rwanda;7;0;5162;35
2020-11-04;RW;Rwanda;12;0;5174;35
2020-11-05;RW;Rwanda;18;1;5192;36
2020-11-06;RW;Rwanda;16;0;5208;36
2020-11-07;RW;Rwanda;5;0;5213;36
2020-11-08;RW;Rwanda;9;0;5222;36
2020-11-09;RW;Rwanda;20;2;5242;38
2020-11-10;RW;Rwanda;20;2;5262;40
2020-11-11;RW;Rwanda;50;1;5312;41
2020-11-12;RW;Rwanda;7;0;5319;41
2020-11-13;RW;Rwanda;43;1;5362;42
2020-11-14;RW;Rwanda;32;0;5394;42
2020-11-15;RW;Rwanda;61;3;5455;45
2020-11-16;RW;Rwanda;36;0;5491;45
2020-11-17;RW;Rwanda;16;1;5507;46
2020-11-18;RW;Rwanda;36;0;5543;46
2020-11-19;RW;Rwanda;29;0;5572;46
2020-11-20;RW;Rwanda;14;0;5586;46
2020-11-21;RW;Rwanda;34;0;5620;46
2020-11-22;RW;Rwanda;45;1;5665;47
2020-11-23;RW;Rwanda;61;0;5726;47
2020-11-24;RW;Rwanda;24;0;5750;47
2020-11-25;RW;Rwanda;29;0;5779;47
2020-11-26;RW;Rwanda;72;0;5851;47
2020-11-27;RW;Rwanda;21;0;5872;47
2020-11-28;RW;Rwanda;19;0;5891;47
2020-11-29;RW;Rwanda;28;1;5919;48
2020-11-30;RW;Rwanda;15;1;5934;49
2020-12-01;RW;Rwanda;14;0;5948;49
2020-12-02;RW;Rwanda;46;1;5994;50
2020-12-03;RW;Rwanda;17;0;6011;50
2020-12-04;RW;Rwanda;32;1;6043;51
2020-12-05;RW;Rwanda;41;0;6084;51
2020-12-06;RW;Rwanda;45;0;6129;51
2020-12-07;RW;Rwanda;62;0;6191;51
2020-12-08;RW;Rwanda;46;0;6237;51
2020-12-09;RW;Rwanda;41;2;6278;53
2020-12-10;RW;Rwanda;71;0;6349;53
2020-12-11;RW;Rwanda;79;1;6428;54
2020-12-12;RW;Rwanda;100;2;6528;56
2020-12-13;RW;Rwanda;131;0;6659;56
2020-12-14;RW;Rwanda;88;0;6747;56
2020-12-15;RW;Rwanda;85;1;6832;57
2020-12-16;RW;Rwanda;122;0;6954;57
2020-12-17;RW;Rwanda;78;0;7032;57
2020-12-18;RW;Rwanda;73;0;7105;57
2020-12-19;RW;Rwanda;127;2;7232;59
2020-12-20;RW;Rwanda;61;4;7293;63
2020-12-21;RW;Rwanda;109;2;7402;65
2020-12-22;RW;Rwanda;109;1;7511;66
2020-12-23;RW;Rwanda;87;0;7598;66
2020-12-24;RW;Rwanda;72;3;7670;69
2020-12-25;RW;Rwanda;73;0;7743;69
2020-12-26;RW;Rwanda;74;3;7817;72
2020-12-27;RW;Rwanda;153;2;7970;74
2020-12-28;RW;Rwanda;51;1;8021;75
2020-12-29;RW;Rwanda;107;4;8128;79
2020-12-30;RW;Rwanda;122;7;8250;86
2020-12-31;RW;Rwanda;133;6;8383;92
2021-01-01;RW;Rwanda;77;2;8460;94
2021-01-02;RW;Rwanda;107;4;8567;98
2021-01-03;RW;Rwanda;109;3;8676;101
2021-01-04;RW;Rwanda;172;4;8848;105
2021-01-05;RW;Rwanda;107;5;8955;110
2021-01-06;RW;Rwanda;103;2;9058;112
2021-01-07;RW;Rwanda;167;1;9225;113
2021-01-08;RW;Rwanda;143;2;9368;115
2021-01-09;RW;Rwanda;93;3;9461;118
2021-01-10;RW;Rwanda;169;2;9630;120
2021-01-11;RW;Rwanda;154;4;9784;124
2021-01-12;RW;Rwanda;166;1;9950;125
2021-01-13;RW;Rwanda;172;3;10122;128
2021-01-14;RW;Rwanda;194;5;10316;133
2021-01-15;RW;Rwanda;257;5;10573;138
2021-01-16;RW;Rwanda;277;2;10850;140
2021-01-17;RW;Rwanda;182;2;11032;142
2021-01-18;RW;Rwanda;227;4;11259;146
2021-01-19;RW;Rwanda;289;2;11548;148
2021-01-20;RW;Rwanda;312;5;11860;153
2021-01-21;RW;Rwanda;310;9;12170;162
2021-01-22;RW;Rwanda;273;3;12443;165
2021-01-23;RW;Rwanda;204;7;12647;172
2021-01-24;RW;Rwanda;328;2;12975;174
2021-01-25;RW;Rwanda;336;3;13311;177
2021-01-26;RW;Rwanda;574;4;13885;181
2021-01-27;RW;Rwanda;281;2;14166;183
2021-01-28;RW;Rwanda;363;3;14529;186
2021-01-29;RW;Rwanda;255;2;14784;188
2021-01-30;RW;Rwanda;334;5;15118;193
2021-01-31;RW;Rwanda;186;3;15304;196
2021-02-01;RW;Rwanda;155;2;15459;198
2021-02-02;RW;Rwanda;229;7;15688;205
2021-02-03;RW;Rwanda;146;3;15834;208
2021-02-04;RW;Rwanda;154;2;15988;210
2021-02-05;RW;Rwanda;198;3;16186;213
2021-02-06;RW;Rwanda;151;4;16337;217
2021-02-07;RW;Rwanda;114;3;16451;220
2021-02-08;RW;Rwanda;170;3;16621;223
2021-02-09;RW;Rwanda;190;3;16811;226
2021-02-10;RW;Rwanda;130;3;16941;229
2021-02-11;RW;Rwanda;127;2;17068;231
2021-02-12;RW;Rwanda;132;5;17200;236
2021-02-13;RW;Rwanda;67;0;17267;236
2021-02-14;RW;Rwanda;76;3;17343;239
2021-02-15;RW;Rwanda;141;0;17484;239
2021-02-16;RW;Rwanda;110;1;17594;240
2021-02-17;RW;Rwanda;122;3;17716;243
2021-02-18;RW;Rwanda;119;0;17835;243
2021-02-19;RW;Rwanda;94;2;17929;245
2021-02-20;RW;Rwanda;59;2;17988;247
2021-02-21;RW;Rwanda;65;2;18053;249
2021-02-22;RW;Rwanda;146;3;18199;252
2021-02-23;RW;Rwanda;126;1;18325;253
2021-02-24;RW;Rwanda;118;1;18443;254
2021-02-25;RW;Rwanda;110;4;18553;258
2021-02-26;RW;Rwanda;136;0;18689;258
2021-02-27;RW;Rwanda;101;3;18790;261
2021-02-28;RW;Rwanda;60;0;18850;261
2021-03-01;RW;Rwanda;136;3;18986;264
2021-03-02;RW;Rwanda;125;1;19111;265
2021-03-03;RW;Rwanda;87;0;19198;265
2021-03-04;RW;Rwanda;136;1;19334;266
2021-03-05;RW;Rwanda;92;1;19426;267
2021-03-06;RW;Rwanda;83;0;19509;267
2021-03-07;RW;Rwanda;42;1;19551;268
2021-03-08;RW;Rwanda;108;0;19659;268
2021-03-09;RW;Rwanda;120;2;19779;270
2021-03-10;RW;Rwanda;67;1;19846;271
2021-03-11;RW;Rwanda;99;2;19945;273
2021-03-12;RW;Rwanda;112;2;20057;275
2021-03-13;RW;Rwanda;86;1;20143;276
2021-03-14;RW;Rwanda;43;4;20186;280
2021-03-15;RW;Rwanda;116;2;20302;282
2021-03-16;RW;Rwanda;110;0;20412;282
2021-03-17;RW;Rwanda;68;1;20480;283
2021-03-18;RW;Rwanda;71;1;20551;284
2021-03-19;RW;Rwanda;130;3;20681;287
2021-03-20;RW;Rwanda;80;0;20761;287
2021-03-21;RW;Rwanda;67;3;20828;290
2021-03-22;RW;Rwanda;68;2;20896;292
2021-03-23;RW;Rwanda;79;3;20975;295
2021-03-24;RW;Rwanda;131;2;21106;297
2021-03-25;RW;Rwanda;104;1;21210;298
2021-03-26;RW;Rwanda;99;2;21309;300
2021-03-27;RW;Rwanda;61;1;21370;301
2021-03-28;RW;Rwanda;49;0;21419;301
2021-03-29;RW;Rwanda;71;4;21490;305
2021-03-30;RW;Rwanda;155;1;21645;306
2021-03-31;RW;Rwanda;138;1;21783;307
2021-04-01;RW;Rwanda;135;1;21918;308
2021-04-02;RW;Rwanda;249;2;22167;310
2021-04-03;RW;Rwanda;76;1;22243;311
2021-04-04;RW;Rwanda;239;0;22482;311
2021-04-05;RW;Rwanda;202;0;22684;311
2021-04-06;RW;Rwanda;178;3;22862;314
2021-04-07;RW;Rwanda;179;0;23041;314
2021-04-08;RW;Rwanda;111;0;23152;314
2021-04-09;RW;Rwanda;108;0;23260;314
2021-04-10;RW;Rwanda;83;0;23343;314
2021-04-11;RW;Rwanda;83;1;23426;315
2021-04-12;RW;Rwanda;109;1;23535;316
2021-04-13;RW;Rwanda;68;0;23603;316
2021-04-14;RW;Rwanda;69;1;23672;317
2021-04-15;RW;Rwanda;72;4;23744;321
2021-04-16;RW;Rwanda;68;1;23812;322
2021-04-17;RW;Rwanda;54;0;23866;322
2021-04-18;RW;Rwanda;22;3;23888;325
2021-04-19;RW;Rwanda;46;1;23934;326
2021-04-20;RW;Rwanda;71;1;24005;327
2021-04-21;RW;Rwanda;107;0;24112;327
2021-04-22;RW;Rwanda;150;1;24262;328
2021-04-23;RW;Rwanda;197;0;24459;328
2021-04-24;RW;Rwanda;76;0;24535;328
2021-04-25;RW;Rwanda;58;2;24593;330
2021-04-26;RW;Rwanda;84;0;24677;330
2021-04-27;RW;Rwanda;137;1;24814;331
2021-04-28;RW;Rwanda;74;1;24888;332
2021-04-29;RW;Rwanda;107;1;24995;333
2021-04-30;RW;Rwanda;121;2;25116;335
2021-05-01;RW;Rwanda;109;0;25225;335
2021-05-02;RW;Rwanda;28;2;25253;337
2021-05-03;RW;Rwanda;58;0;25311;337
2021-05-04;RW;Rwanda;40;0;25351;337
2021-05-05;RW;Rwanda;70;1;25421;338
2021-05-06;RW;Rwanda;65;0;25486;338
2021-05-07;RW;Rwanda;53;0;25539;338
2021-05-08;RW;Rwanda;47;0;25586;338
2021-05-09;RW;Rwanda;66;0;25652;338
2021-05-10;RW;Rwanda;62;0;25714;338
2021-05-11;RW;Rwanda;59;2;25773;340
2021-05-12;RW;Rwanda;73;0;25846;340
2021-05-13;RW;Rwanda;88;2;25934;342
2021-05-14;RW;Rwanda;99;1;26033;343
2021-05-15;RW;Rwanda;66;0;26099;343
2021-05-16;RW;Rwanda;42;1;26141;344
2021-05-17;RW;Rwanda;74;1;26215;345
2021-05-18;RW;Rwanda;129;1;26344;346
2021-05-19;RW;Rwanda;80;2;26424;348
2021-05-20;RW;Rwanda;105;1;26529;349
2021-05-21;RW;Rwanda;72;0;26601;349
2021-05-22;RW;Rwanda;57;0;26658;349
2021-05-23;RW;Rwanda;30;0;26688;349
2021-05-24;RW;Rwanda;42;0;26730;349
2021-05-25;RW;Rwanda;50;0;26780;349
2021-05-26;RW;Rwanda;37;1;26817;350
2021-05-27;RW;Rwanda;26;1;26843;351
2021-05-28;RW;Rwanda;35;1;26878;352
2021-05-29;RW;Rwanda;14;0;26892;352
2021-05-30;RW;Rwanda;26;0;26918;352
2021-05-31;RW;Rwanda;45;1;26963;353
2021-06-01;RW;Rwanda;60;4;27023;357
2021-06-02;RW;Rwanda;41;1;27064;358
2021-06-03;RW;Rwanda;55;0;27119;358
2021-06-04;RW;Rwanda;43;1;27162;359
2021-06-05;RW;Rwanda;49;0;27211;359
2021-06-06;RW;Rwanda;34;1;27245;360
2021-06-07;RW;Rwanda;62;0;27307;360
2021-06-08;RW;Rwanda;127;4;27434;364
2021-06-09;RW;Rwanda;114;1;27548;365
2021-06-10;RW;Rwanda;112;1;27660;366
2021-06-11;RW;Rwanda;202;2;27862;368
2021-06-12;RW;Rwanda;284;2;28146;370
2021-06-13;RW;Rwanda;227;0;28373;370
2021-06-14;RW;Rwanda;241;2;28614;372
2021-06-15;RW;Rwanda;298;0;28912;372
2021-06-16;RW;Rwanda;263;4;29175;376
2021-06-17;RW;Rwanda;422;1;29597;377
2021-06-18;RW;Rwanda;451;1;30048;378
2021-06-19;RW;Rwanda;469;1;30517;379
2021-06-20;RW;Rwanda;296;3;30813;382
2021-06-21;RW;Rwanda;622;6;31435;388
2021-06-22;RW;Rwanda;861;4;32296;392
2021-06-23;RW;Rwanda;964;5;33260;397
2021-06-24;RW;Rwanda;883;5;34143;402
2021-06-25;RW;Rwanda;875;2;35018;404
2021-06-26;RW;Rwanda;868;7;35886;411
2021-06-27;RW;Rwanda;741;9;36627;420
2021-06-28;RW;Rwanda;757;7;37384;427
2021-06-29;RW;Rwanda;814;4;38198;431
2021-06-30;RW;Rwanda;849;7;39047;438
2021-07-01;RW;Rwanda;867;10;39914;448
2021-02-03;SH;Saint Helena;0;0;0;0
2021-02-04;SH;Saint Helena;0;0;0;0
2021-02-05;SH;Saint Helena;0;0;0;0
2021-02-06;SH;Saint Helena;0;0;0;0
2021-02-07;SH;Saint Helena;0;0;0;0
2021-02-08;SH;Saint Helena;0;0;0;0
2021-02-09;SH;Saint Helena;0;0;0;0
2021-02-10;SH;Saint Helena;0;0;0;0
2021-02-11;SH;Saint Helena;0;0;0;0
2021-02-12;SH;Saint Helena;0;0;0;0
2021-02-13;SH;Saint Helena;0;0;0;0
2021-02-14;SH;Saint Helena;0;0;0;0
2021-02-15;SH;Saint Helena;0;0;0;0
2021-02-16;SH;Saint Helena;0;0;0;0
2021-02-17;SH;Saint Helena;0;0;0;0
2021-02-18;SH;Saint Helena;0;0;0;0
2021-02-19;SH;Saint Helena;0;0;0;0
2021-02-20;SH;Saint Helena;0;0;0;0
2021-02-21;SH;Saint Helena;0;0;0;0
2021-02-22;SH;Saint Helena;0;0;0;0
2021-02-23;SH;Saint Helena;0;0;0;0
2021-02-24;SH;Saint Helena;0;0;0;0
2021-02-25;SH;Saint Helena;0;0;0;0
2021-02-26;SH;Saint Helena;0;0;0;0
2021-02-27;SH;Saint Helena;0;0;0;0
2021-02-28;SH;Saint Helena;0;0;0;0
2021-03-01;SH;Saint Helena;0;0;0;0
2021-03-02;SH;Saint Helena;0;0;0;0
2021-03-03;SH;Saint Helena;0;0;0;0
2021-03-04;SH;Saint Helena;0;0;0;0
2021-03-05;SH;Saint Helena;0;0;0;0
2021-03-06;SH;Saint Helena;0;0;0;0
2021-03-07;SH;Saint Helena;0;0;0;0
2021-03-08;SH;Saint Helena;0;0;0;0
2021-03-09;SH;Saint Helena;0;0;0;0
2021-03-10;SH;Saint Helena;0;0;0;0
2021-03-11;SH;Saint Helena;0;0;0;0
2021-03-12;SH;Saint Helena;0;0;0;0
2021-03-13;SH;Saint Helena;0;0;0;0
2021-03-14;SH;Saint Helena;0;0;0;0
2021-03-15;SH;Saint Helena;0;0;0;0
2021-03-16;SH;Saint Helena;0;0;0;0
2021-03-17;SH;Saint Helena;0;0;0;0
2021-03-18;SH;Saint Helena;0;0;0;0
2021-03-19;SH;Saint Helena;0;0;0;0
2021-03-20;SH;Saint Helena;0;0;0;0
2021-03-21;SH;Saint Helena;0;0;0;0
2021-03-22;SH;Saint Helena;0;0;0;0
2021-03-23;SH;Saint Helena;0;0;0;0
2021-03-24;SH;Saint Helena;0;0;0;0
2021-03-25;SH;Saint Helena;0;0;0;0
2021-03-26;SH;Saint Helena;0;0;0;0
2021-03-27;SH;Saint Helena;0;0;0;0
2021-03-28;SH;Saint Helena;0;0;0;0
2021-03-29;SH;Saint Helena;0;0;0;0
2021-03-30;SH;Saint Helena;0;0;0;0
2021-03-31;SH;Saint Helena;0;0;0;0
2021-04-01;SH;Saint Helena;0;0;0;0
2021-04-02;SH;Saint Helena;0;0;0;0
2021-04-03;SH;Saint Helena;0;0;0;0
2021-04-04;SH;Saint Helena;0;0;0;0
2021-04-05;SH;Saint Helena;0;0;0;0
2021-04-06;SH;Saint Helena;0;0;0;0
2021-04-07;SH;Saint Helena;0;0;0;0
2021-04-08;SH;Saint Helena;0;0;0;0
2021-04-09;SH;Saint Helena;0;0;0;0
2021-04-10;SH;Saint Helena;0;0;0;0
2021-04-11;SH;Saint Helena;0;0;0;0
2021-04-12;SH;Saint Helena;0;0;0;0
2021-04-13;SH;Saint Helena;0;0;0;0
2021-04-14;SH;Saint Helena;0;0;0;0
2021-04-15;SH;Saint Helena;0;0;0;0
2021-04-16;SH;Saint Helena;0;0;0;0
2021-04-17;SH;Saint Helena;0;0;0;0
2021-04-18;SH;Saint Helena;0;0;0;0
2021-04-19;SH;Saint Helena;0;0;0;0
2021-04-20;SH;Saint Helena;0;0;0;0
2021-04-21;SH;Saint Helena;0;0;0;0
2021-04-22;SH;Saint Helena;0;0;0;0
2021-04-23;SH;Saint Helena;0;0;0;0
2021-04-24;SH;Saint Helena;0;0;0;0
2021-04-25;SH;Saint Helena;0;0;0;0
2021-04-26;SH;Saint Helena;0;0;0;0
2021-04-27;SH;Saint Helena;0;0;0;0
2021-04-28;SH;Saint Helena;0;0;0;0
2021-04-29;SH;Saint Helena;0;0;0;0
2021-04-30;SH;Saint Helena;0;0;0;0
2021-05-01;SH;Saint Helena;0;0;0;0
2021-05-02;SH;Saint Helena;0;0;0;0
2021-05-03;SH;Saint Helena;0;0;0;0
2021-05-04;SH;Saint Helena;0;0;0;0
2021-05-05;SH;Saint Helena;0;0;0;0
2020-03-25;KN;Saint Kitts and Nevis;2;0;2;0
2020-03-26;KN;Saint Kitts and Nevis;0;0;2;0
2020-03-27;KN;Saint Kitts and Nevis;0;0;2;0
2020-03-28;KN;Saint Kitts and Nevis;0;0;2;0
2020-03-29;KN;Saint Kitts and Nevis;0;0;2;0
2020-03-30;KN;Saint Kitts and Nevis;5;0;7;0
2020-03-31;KN;Saint Kitts and Nevis;1;0;8;0
2020-04-01;KN;Saint Kitts and Nevis;0;0;8;0
2020-04-02;KN;Saint Kitts and Nevis;1;0;9;0
2020-04-03;KN;Saint Kitts and Nevis;0;0;9;0
2020-04-04;KN;Saint Kitts and Nevis;0;0;9;0
2020-04-05;KN;Saint Kitts and Nevis;1;0;10;0
2020-04-06;KN;Saint Kitts and Nevis;0;0;10;0
2020-04-07;KN;Saint Kitts and Nevis;1;0;11;0
2020-04-08;KN;Saint Kitts and Nevis;0;0;11;0
2020-04-09;KN;Saint Kitts and Nevis;0;0;11;0
2020-04-10;KN;Saint Kitts and Nevis;1;0;12;0
2020-04-11;KN;Saint Kitts and Nevis;0;0;12;0
2020-04-12;KN;Saint Kitts and Nevis;0;0;12;0
2020-04-13;KN;Saint Kitts and Nevis;0;0;12;0
2020-04-14;KN;Saint Kitts and Nevis;2;0;14;0
2020-04-15;KN;Saint Kitts and Nevis;0;0;14;0
2020-04-16;KN;Saint Kitts and Nevis;0;0;14;0
2020-04-17;KN;Saint Kitts and Nevis;0;0;14;0
2020-04-18;KN;Saint Kitts and Nevis;0;0;14;0
2020-04-19;KN;Saint Kitts and Nevis;0;0;14;0
2020-04-20;KN;Saint Kitts and Nevis;1;0;15;0
2020-04-21;KN;Saint Kitts and Nevis;0;0;15;0
2020-04-22;KN;Saint Kitts and Nevis;0;0;15;0
2020-04-23;KN;Saint Kitts and Nevis;0;0;15;0
2020-04-24;KN;Saint Kitts and Nevis;0;0;15;0
2020-04-25;KN;Saint Kitts and Nevis;0;0;15;0
2020-04-26;KN;Saint Kitts and Nevis;0;0;15;0
2020-04-27;KN;Saint Kitts and Nevis;0;0;15;0
2020-04-28;KN;Saint Kitts and Nevis;0;0;15;0
2020-04-29;KN;Saint Kitts and Nevis;0;0;15;0
2020-04-30;KN;Saint Kitts and Nevis;0;0;15;0
2020-05-01;KN;Saint Kitts and Nevis;0;0;15;0
2020-05-02;KN;Saint Kitts and Nevis;0;0;15;0
2020-05-03;KN;Saint Kitts and Nevis;0;0;15;0
2020-05-04;KN;Saint Kitts and Nevis;0;0;15;0
2020-05-05;KN;Saint Kitts and Nevis;0;0;15;0
2020-05-06;KN;Saint Kitts and Nevis;0;0;15;0
2020-05-07;KN;Saint Kitts and Nevis;0;0;15;0
2020-05-08;KN;Saint Kitts and Nevis;0;0;15;0
2020-05-09;KN;Saint Kitts and Nevis;0;0;15;0
2020-05-10;KN;Saint Kitts and Nevis;0;0;15;0
2020-05-11;KN;Saint Kitts and Nevis;0;0;15;0
2020-05-12;KN;Saint Kitts and Nevis;0;0;15;0
2020-05-13;KN;Saint Kitts and Nevis;0;0;15;0
2020-05-14;KN;Saint Kitts and Nevis;0;0;15;0
2020-05-15;KN;Saint Kitts and Nevis;0;0;15;0
2020-05-16;KN;Saint Kitts and Nevis;0;0;15;0
2020-05-17;KN;Saint Kitts and Nevis;0;0;15;0
2020-05-18;KN;Saint Kitts and Nevis;0;0;15;0
2020-05-19;KN;Saint Kitts and Nevis;0;0;15;0
2020-05-20;KN;Saint Kitts and Nevis;0;0;15;0
2020-05-21;KN;Saint Kitts and Nevis;0;0;15;0
2020-05-22;KN;Saint Kitts and Nevis;0;0;15;0
2020-05-23;KN;Saint Kitts and Nevis;0;0;15;0
2020-05-24;KN;Saint Kitts and Nevis;0;0;15;0
2020-05-25;KN;Saint Kitts and Nevis;0;0;15;0
2020-05-26;KN;Saint Kitts and Nevis;0;0;15;0
2020-05-27;KN;Saint Kitts and Nevis;0;0;15;0
2020-05-28;KN;Saint Kitts and Nevis;0;0;15;0
2020-05-29;KN;Saint Kitts and Nevis;0;0;15;0
2020-05-30;KN;Saint Kitts and Nevis;0;0;15;0
2020-05-31;KN;Saint Kitts and Nevis;0;0;15;0
2020-06-01;KN;Saint Kitts and Nevis;0;0;15;0
2020-06-02;KN;Saint Kitts and Nevis;0;0;15;0
2020-06-03;KN;Saint Kitts and Nevis;0;0;15;0
2020-06-04;KN;Saint Kitts and Nevis;0;0;15;0
2020-06-05;KN;Saint Kitts and Nevis;0;0;15;0
2020-06-06;KN;Saint Kitts and Nevis;0;0;15;0
2020-06-07;KN;Saint Kitts and Nevis;0;0;15;0
2020-06-08;KN;Saint Kitts and Nevis;0;0;15;0
2020-06-09;KN;Saint Kitts and Nevis;0;0;15;0
2020-06-10;KN;Saint Kitts and Nevis;0;0;15;0
2020-06-11;KN;Saint Kitts and Nevis;0;0;15;0
2020-06-12;KN;Saint Kitts and Nevis;0;0;15;0
2020-06-13;KN;Saint Kitts and Nevis;0;0;15;0
2020-06-14;KN;Saint Kitts and Nevis;0;0;15;0
2020-06-15;KN;Saint Kitts and Nevis;0;0;15;0
2020-06-16;KN;Saint Kitts and Nevis;0;0;15;0
2020-06-17;KN;Saint Kitts and Nevis;0;0;15;0
2020-06-18;KN;Saint Kitts and Nevis;0;0;15;0
2020-06-19;KN;Saint Kitts and Nevis;0;0;15;0
2020-06-20;KN;Saint Kitts and Nevis;0;0;15;0
2020-06-21;KN;Saint Kitts and Nevis;0;0;15;0
2020-06-22;KN;Saint Kitts and Nevis;0;0;15;0
2020-06-23;KN;Saint Kitts and Nevis;0;0;15;0
2020-06-24;KN;Saint Kitts and Nevis;0;0;15;0
2020-06-25;KN;Saint Kitts and Nevis;0;0;15;0
2020-06-26;KN;Saint Kitts and Nevis;0;0;15;0
2020-06-27;KN;Saint Kitts and Nevis;0;0;15;0
2020-06-28;KN;Saint Kitts and Nevis;0;0;15;0
2020-06-29;KN;Saint Kitts and Nevis;0;0;15;0
2020-06-30;KN;Saint Kitts and Nevis;0;0;15;0
2020-07-01;KN;Saint Kitts and Nevis;0;0;15;0
2020-07-02;KN;Saint Kitts and Nevis;0;0;15;0
2020-07-03;KN;Saint Kitts and Nevis;0;0;15;0
2020-07-04;KN;Saint Kitts and Nevis;1;0;16;0
2020-07-05;KN;Saint Kitts and Nevis;0;0;16;0
2020-07-06;KN;Saint Kitts and Nevis;0;0;16;0
2020-07-07;KN;Saint Kitts and Nevis;0;0;16;0
2020-07-08;KN;Saint Kitts and Nevis;0;0;16;0
2020-07-09;KN;Saint Kitts and Nevis;0;0;16;0
2020-07-10;KN;Saint Kitts and Nevis;1;0;17;0
2020-07-11;KN;Saint Kitts and Nevis;0;0;17;0
2020-07-12;KN;Saint Kitts and Nevis;0;0;17;0
2020-07-13;KN;Saint Kitts and Nevis;0;0;17;0
2020-07-14;KN;Saint Kitts and Nevis;0;0;17;0
2020-07-15;KN;Saint Kitts and Nevis;0;0;17;0
2020-07-16;KN;Saint Kitts and Nevis;0;0;17;0
2020-07-17;KN;Saint Kitts and Nevis;0;0;17;0
2020-07-18;KN;Saint Kitts and Nevis;0;0;17;0
2020-07-19;KN;Saint Kitts and Nevis;0;0;17;0
2020-07-20;KN;Saint Kitts and Nevis;0;0;17;0
2020-07-21;KN;Saint Kitts and Nevis;0;0;17;0
2020-07-22;KN;Saint Kitts and Nevis;0;0;17;0
2020-07-23;KN;Saint Kitts and Nevis;0;0;17;0
2020-07-24;KN;Saint Kitts and Nevis;0;0;17;0
2020-07-25;KN;Saint Kitts and Nevis;0;0;17;0
2020-07-26;KN;Saint Kitts and Nevis;0;0;17;0
2020-07-27;KN;Saint Kitts and Nevis;0;0;17;0
2020-07-28;KN;Saint Kitts and Nevis;0;0;17;0
2020-07-29;KN;Saint Kitts and Nevis;0;0;17;0
2020-07-30;KN;Saint Kitts and Nevis;0;0;17;0
2020-07-31;KN;Saint Kitts and Nevis;0;0;17;0
2020-08-01;KN;Saint Kitts and Nevis;0;0;17;0
2020-08-02;KN;Saint Kitts and Nevis;0;0;17;0
2020-08-03;KN;Saint Kitts and Nevis;0;0;17;0
2020-08-04;KN;Saint Kitts and Nevis;0;0;17;0
2020-08-05;KN;Saint Kitts and Nevis;0;0;17;0
2020-08-06;KN;Saint Kitts and Nevis;0;0;17;0
2020-08-07;KN;Saint Kitts and Nevis;0;0;17;0
2020-08-08;KN;Saint Kitts and Nevis;0;0;17;0
2020-08-09;KN;Saint Kitts and Nevis;0;0;17;0
2020-08-10;KN;Saint Kitts and Nevis;0;0;17;0
2020-08-11;KN;Saint Kitts and Nevis;0;0;17;0
2020-08-12;KN;Saint Kitts and Nevis;0;0;17;0
2020-08-13;KN;Saint Kitts and Nevis;0;0;17;0
2020-08-14;KN;Saint Kitts and Nevis;0;0;17;0
2020-08-15;KN;Saint Kitts and Nevis;0;0;17;0
2020-08-16;KN;Saint Kitts and Nevis;0;0;17;0
2020-08-17;KN;Saint Kitts and Nevis;0;0;17;0
2020-08-18;KN;Saint Kitts and Nevis;0;0;17;0
2020-08-19;KN;Saint Kitts and Nevis;0;0;17;0
2020-08-20;KN;Saint Kitts and Nevis;0;0;17;0
2020-08-21;KN;Saint Kitts and Nevis;0;0;17;0
2020-08-22;KN;Saint Kitts and Nevis;0;0;17;0
2020-08-23;KN;Saint Kitts and Nevis;0;0;17;0
2020-08-24;KN;Saint Kitts and Nevis;0;0;17;0
2020-08-25;KN;Saint Kitts and Nevis;0;0;17;0
2020-08-26;KN;Saint Kitts and Nevis;0;0;17;0
2020-08-27;KN;Saint Kitts and Nevis;0;0;17;0
2020-08-28;KN;Saint Kitts and Nevis;0;0;17;0
2020-08-29;KN;Saint Kitts and Nevis;0;0;17;0
2020-08-30;KN;Saint Kitts and Nevis;0;0;17;0
2020-08-31;KN;Saint Kitts and Nevis;0;0;17;0
2020-09-01;KN;Saint Kitts and Nevis;0;0;17;0
2020-09-02;KN;Saint Kitts and Nevis;0;0;17;0
2020-09-03;KN;Saint Kitts and Nevis;0;0;17;0
2020-09-04;KN;Saint Kitts and Nevis;0;0;17;0
2020-09-05;KN;Saint Kitts and Nevis;0;0;17;0
2020-09-06;KN;Saint Kitts and Nevis;0;0;17;0
2020-09-07;KN;Saint Kitts and Nevis;0;0;17;0
2020-09-08;KN;Saint Kitts and Nevis;0;0;17;0
2020-09-09;KN;Saint Kitts and Nevis;0;0;17;0
2020-09-10;KN;Saint Kitts and Nevis;0;0;17;0
2020-09-11;KN;Saint Kitts and Nevis;0;0;17;0
2020-09-12;KN;Saint Kitts and Nevis;0;0;17;0
2020-09-13;KN;Saint Kitts and Nevis;0;0;17;0
2020-09-14;KN;Saint Kitts and Nevis;0;0;17;0
2020-09-15;KN;Saint Kitts and Nevis;0;0;17;0
2020-09-16;KN;Saint Kitts and Nevis;0;0;17;0
2020-09-17;KN;Saint Kitts and Nevis;0;0;17;0
2020-09-18;KN;Saint Kitts and Nevis;0;0;17;0
2020-09-19;KN;Saint Kitts and Nevis;0;0;17;0
2020-09-20;KN;Saint Kitts and Nevis;0;0;17;0
2020-09-21;KN;Saint Kitts and Nevis;2;0;19;0
2020-09-22;KN;Saint Kitts and Nevis;0;0;19;0
2020-09-23;KN;Saint Kitts and Nevis;0;0;19;0
2020-09-24;KN;Saint Kitts and Nevis;0;0;19;0
2020-09-25;KN;Saint Kitts and Nevis;0;0;19;0
2020-09-26;KN;Saint Kitts and Nevis;0;0;19;0
2020-09-27;KN;Saint Kitts and Nevis;0;0;19;0
2020-09-28;KN;Saint Kitts and Nevis;0;0;19;0
2020-09-29;KN;Saint Kitts and Nevis;0;0;19;0
2020-09-30;KN;Saint Kitts and Nevis;0;0;19;0
2020-10-01;KN;Saint Kitts and Nevis;0;0;19;0
2020-10-02;KN;Saint Kitts and Nevis;0;0;19;0
2020-10-03;KN;Saint Kitts and Nevis;0;0;19;0
2020-10-04;KN;Saint Kitts and Nevis;0;0;19;0
2020-10-05;KN;Saint Kitts and Nevis;0;0;19;0
2020-10-06;KN;Saint Kitts and Nevis;0;0;19;0
2020-10-07;KN;Saint Kitts and Nevis;0;0;19;0
2020-10-08;KN;Saint Kitts and Nevis;0;0;19;0
2020-10-09;KN;Saint Kitts and Nevis;0;0;19;0
2020-10-10;KN;Saint Kitts and Nevis;0;0;19;0
2020-10-11;KN;Saint Kitts and Nevis;0;0;19;0
2020-10-12;KN;Saint Kitts and Nevis;0;0;19;0
2020-10-13;KN;Saint Kitts and Nevis;0;0;19;0
2020-10-14;KN;Saint Kitts and Nevis;0;0;19;0
2020-10-15;KN;Saint Kitts and Nevis;0;0;19;0
2020-10-16;KN;Saint Kitts and Nevis;0;0;19;0
2020-10-17;KN;Saint Kitts and Nevis;0;0;19;0
2020-10-18;KN;Saint Kitts and Nevis;0;0;19;0
2020-10-19;KN;Saint Kitts and Nevis;0;0;19;0
2020-10-20;KN;Saint Kitts and Nevis;0;0;19;0
2020-10-21;KN;Saint Kitts and Nevis;0;0;19;0
2020-10-22;KN;Saint Kitts and Nevis;0;0;19;0
2020-10-23;KN;Saint Kitts and Nevis;0;0;19;0
2020-10-24;KN;Saint Kitts and Nevis;0;0;19;0
2020-10-25;KN;Saint Kitts and Nevis;0;0;19;0
2020-10-26;KN;Saint Kitts and Nevis;0;0;19;0
2020-10-27;KN;Saint Kitts and Nevis;0;0;19;0
2020-10-28;KN;Saint Kitts and Nevis;0;0;19;0
2020-10-29;KN;Saint Kitts and Nevis;0;0;19;0
2020-10-30;KN;Saint Kitts and Nevis;0;0;19;0
2020-10-31;KN;Saint Kitts and Nevis;0;0;19;0
2020-11-01;KN;Saint Kitts and Nevis;0;0;19;0
2020-11-02;KN;Saint Kitts and Nevis;0;0;19;0
2020-11-03;KN;Saint Kitts and Nevis;0;0;19;0
2020-11-04;KN;Saint Kitts and Nevis;0;0;19;0
2020-11-05;KN;Saint Kitts and Nevis;0;0;19;0
2020-11-06;KN;Saint Kitts and Nevis;0;0;19;0
2020-11-07;KN;Saint Kitts and Nevis;0;0;19;0
2020-11-08;KN;Saint Kitts and Nevis;0;0;19;0
2020-11-09;KN;Saint Kitts and Nevis;0;0;19;0
2020-11-10;KN;Saint Kitts and Nevis;0;0;19;0
2020-11-11;KN;Saint Kitts and Nevis;0;0;19;0
2020-11-12;KN;Saint Kitts and Nevis;0;0;19;0
2020-11-13;KN;Saint Kitts and Nevis;0;0;19;0
2020-11-14;KN;Saint Kitts and Nevis;0;0;19;0
2020-11-15;KN;Saint Kitts and Nevis;0;0;19;0
2020-11-16;KN;Saint Kitts and Nevis;0;0;19;0
2020-11-17;KN;Saint Kitts and Nevis;0;0;19;0
2020-11-18;KN;Saint Kitts and Nevis;0;0;19;0
2020-11-19;KN;Saint Kitts and Nevis;0;0;19;0
2020-11-20;KN;Saint Kitts and Nevis;0;0;19;0
2020-11-21;KN;Saint Kitts and Nevis;0;0;19;0
2020-11-22;KN;Saint Kitts and Nevis;1;0;20;0
2020-11-23;KN;Saint Kitts and Nevis;0;0;20;0
2020-11-24;KN;Saint Kitts and Nevis;2;0;22;0
2020-11-25;KN;Saint Kitts and Nevis;0;0;22;0
2020-11-26;KN;Saint Kitts and Nevis;0;0;22;0
2020-11-27;KN;Saint Kitts and Nevis;0;0;22;0
2020-11-28;KN;Saint Kitts and Nevis;0;0;22;0
2020-11-29;KN;Saint Kitts and Nevis;0;0;22;0
2020-11-30;KN;Saint Kitts and Nevis;0;0;22;0
2020-12-01;KN;Saint Kitts and Nevis;0;0;22;0
2020-12-02;KN;Saint Kitts and Nevis;0;0;22;0
2020-12-03;KN;Saint Kitts and Nevis;0;0;22;0
2020-12-04;KN;Saint Kitts and Nevis;0;0;22;0
2020-12-05;KN;Saint Kitts and Nevis;3;0;25;0
2020-12-06;KN;Saint Kitts and Nevis;0;0;25;0
2020-12-07;KN;Saint Kitts and Nevis;0;0;25;0
2020-12-08;KN;Saint Kitts and Nevis;0;0;25;0
2020-12-09;KN;Saint Kitts and Nevis;0;0;25;0
2020-12-10;KN;Saint Kitts and Nevis;1;0;26;0
2020-12-11;KN;Saint Kitts and Nevis;1;0;27;0
2020-12-12;KN;Saint Kitts and Nevis;0;0;27;0
2020-12-13;KN;Saint Kitts and Nevis;0;0;27;0
2020-12-14;KN;Saint Kitts and Nevis;1;0;28;0
2020-12-15;KN;Saint Kitts and Nevis;0;0;28;0
2020-12-16;KN;Saint Kitts and Nevis;0;0;28;0
2020-12-17;KN;Saint Kitts and Nevis;0;0;28;0
2020-12-18;KN;Saint Kitts and Nevis;2;0;30;0
2020-12-19;KN;Saint Kitts and Nevis;0;0;30;0
2020-12-20;KN;Saint Kitts and Nevis;0;0;30;0
2020-12-21;KN;Saint Kitts and Nevis;0;0;30;0
2020-12-22;KN;Saint Kitts and Nevis;0;0;30;0
2020-12-23;KN;Saint Kitts and Nevis;0;0;30;0
2020-12-24;KN;Saint Kitts and Nevis;0;0;30;0
2020-12-25;KN;Saint Kitts and Nevis;0;0;30;0
2020-12-26;KN;Saint Kitts and Nevis;0;0;30;0
2020-12-27;KN;Saint Kitts and Nevis;2;0;32;0
2020-12-28;KN;Saint Kitts and Nevis;0;0;32;0
2020-12-29;KN;Saint Kitts and Nevis;0;0;32;0
2020-12-30;KN;Saint Kitts and Nevis;0;0;32;0
2020-12-31;KN;Saint Kitts and Nevis;0;0;32;0
2021-01-01;KN;Saint Kitts and Nevis;0;0;32;0
2021-01-02;KN;Saint Kitts and Nevis;1;0;33;0
2021-01-03;KN;Saint Kitts and Nevis;0;0;33;0
2021-01-04;KN;Saint Kitts and Nevis;0;0;33;0
2021-01-05;KN;Saint Kitts and Nevis;0;0;33;0
2021-01-06;KN;Saint Kitts and Nevis;0;0;33;0
2021-01-07;KN;Saint Kitts and Nevis;0;0;33;0
2021-01-08;KN;Saint Kitts and Nevis;1;0;34;0
2021-01-09;KN;Saint Kitts and Nevis;0;0;34;0
2021-01-10;KN;Saint Kitts and Nevis;0;0;34;0
2021-01-11;KN;Saint Kitts and Nevis;0;0;34;0
2021-01-12;KN;Saint Kitts and Nevis;0;0;34;0
2021-01-13;KN;Saint Kitts and Nevis;0;0;34;0
2021-01-14;KN;Saint Kitts and Nevis;0;0;34;0
2021-01-15;KN;Saint Kitts and Nevis;0;0;34;0
2021-01-16;KN;Saint Kitts and Nevis;0;0;34;0
2021-01-17;KN;Saint Kitts and Nevis;0;0;34;0
2021-01-18;KN;Saint Kitts and Nevis;1;0;35;0
2021-01-19;KN;Saint Kitts and Nevis;0;0;35;0
2021-01-20;KN;Saint Kitts and Nevis;0;0;35;0
2021-01-21;KN;Saint Kitts and Nevis;0;0;35;0
2021-01-22;KN;Saint Kitts and Nevis;0;0;35;0
2021-01-23;KN;Saint Kitts and Nevis;0;0;35;0
2021-01-24;KN;Saint Kitts and Nevis;0;0;35;0
2021-01-25;KN;Saint Kitts and Nevis;0;0;35;0
2021-01-26;KN;Saint Kitts and Nevis;2;0;37;0
2021-01-27;KN;Saint Kitts and Nevis;0;0;37;0
2021-01-28;KN;Saint Kitts and Nevis;0;0;37;0
2021-01-29;KN;Saint Kitts and Nevis;0;0;37;0
2021-01-30;KN;Saint Kitts and Nevis;0;0;37;0
2021-01-31;KN;Saint Kitts and Nevis;0;0;37;0
2021-02-01;KN;Saint Kitts and Nevis;1;0;38;0
2021-02-02;KN;Saint Kitts and Nevis;1;0;39;0
2021-02-03;KN;Saint Kitts and Nevis;0;0;39;0
2021-02-04;KN;Saint Kitts and Nevis;0;0;39;0
2021-02-05;KN;Saint Kitts and Nevis;1;0;40;0
2021-02-06;KN;Saint Kitts and Nevis;0;0;40;0
2021-02-07;KN;Saint Kitts and Nevis;0;0;40;0
2021-02-08;KN;Saint Kitts and Nevis;0;0;40;0
2021-02-09;KN;Saint Kitts and Nevis;0;0;40;0
2021-02-10;KN;Saint Kitts and Nevis;0;0;40;0
2021-02-11;KN;Saint Kitts and Nevis;0;0;40;0
2021-02-12;KN;Saint Kitts and Nevis;0;0;40;0
2021-02-13;KN;Saint Kitts and Nevis;0;0;40;0
2021-02-14;KN;Saint Kitts and Nevis;1;0;41;0
2021-02-15;KN;Saint Kitts and Nevis;0;0;41;0
2021-02-16;KN;Saint Kitts and Nevis;0;0;41;0
2021-02-17;KN;Saint Kitts and Nevis;0;0;41;0
2021-02-18;KN;Saint Kitts and Nevis;0;0;41;0
2021-02-19;KN;Saint Kitts and Nevis;0;0;41;0
2021-02-20;KN;Saint Kitts and Nevis;0;0;41;0
2021-02-21;KN;Saint Kitts and Nevis;0;0;41;0
2021-02-22;KN;Saint Kitts and Nevis;0;0;41;0
2021-02-23;KN;Saint Kitts and Nevis;0;0;41;0
2021-02-24;KN;Saint Kitts and Nevis;0;0;41;0
2021-02-25;KN;Saint Kitts and Nevis;0;0;41;0
2021-02-26;KN;Saint Kitts and Nevis;0;0;41;0
2021-02-27;KN;Saint Kitts and Nevis;0;0;41;0
2021-02-28;KN;Saint Kitts and Nevis;0;0;41;0
2021-03-01;KN;Saint Kitts and Nevis;0;0;41;0
2021-03-02;KN;Saint Kitts and Nevis;0;0;41;0
2021-03-03;KN;Saint Kitts and Nevis;0;0;41;0
2021-03-04;KN;Saint Kitts and Nevis;0;0;41;0
2021-03-05;KN;Saint Kitts and Nevis;0;0;41;0
2021-03-06;KN;Saint Kitts and Nevis;0;0;41;0
2021-03-07;KN;Saint Kitts and Nevis;0;0;41;0
2021-03-08;KN;Saint Kitts and Nevis;0;0;41;0
2021-03-09;KN;Saint Kitts and Nevis;0;0;41;0
2021-03-10;KN;Saint Kitts and Nevis;0;0;41;0
2021-03-11;KN;Saint Kitts and Nevis;1;0;42;0
2021-03-12;KN;Saint Kitts and Nevis;0;0;42;0
2021-03-13;KN;Saint Kitts and Nevis;1;0;43;0
2021-03-14;KN;Saint Kitts and Nevis;0;0;43;0
2021-03-15;KN;Saint Kitts and Nevis;0;0;43;0
2021-03-16;KN;Saint Kitts and Nevis;0;0;43;0
2021-03-17;KN;Saint Kitts and Nevis;0;0;43;0
2021-03-18;KN;Saint Kitts and Nevis;1;0;44;0
2021-03-19;KN;Saint Kitts and Nevis;0;0;44;0
2021-03-20;KN;Saint Kitts and Nevis;0;0;44;0
2021-03-21;KN;Saint Kitts and Nevis;0;0;44;0
2021-03-22;KN;Saint Kitts and Nevis;0;0;44;0
2021-03-23;KN;Saint Kitts and Nevis;0;0;44;0
2021-03-24;KN;Saint Kitts and Nevis;0;0;44;0
2021-03-25;KN;Saint Kitts and Nevis;0;0;44;0
2021-03-26;KN;Saint Kitts and Nevis;0;0;44;0
2021-03-27;KN;Saint Kitts and Nevis;0;0;44;0
2021-03-28;KN;Saint Kitts and Nevis;0;0;44;0
2021-03-29;KN;Saint Kitts and Nevis;0;0;44;0
2021-03-30;KN;Saint Kitts and Nevis;0;0;44;0
2021-03-31;KN;Saint Kitts and Nevis;0;0;44;0
2021-04-01;KN;Saint Kitts and Nevis;0;0;44;0
2021-04-02;KN;Saint Kitts and Nevis;0;0;44;0
2021-04-03;KN;Saint Kitts and Nevis;0;0;44;0
2021-04-04;KN;Saint Kitts and Nevis;0;0;44;0
2021-04-05;KN;Saint Kitts and Nevis;0;0;44;0
2021-04-06;KN;Saint Kitts and Nevis;0;0;44;0
2021-04-07;KN;Saint Kitts and Nevis;0;0;44;0
2021-04-08;KN;Saint Kitts and Nevis;0;0;44;0
2021-04-09;KN;Saint Kitts and Nevis;0;0;44;0
2021-04-10;KN;Saint Kitts and Nevis;0;0;44;0
2021-04-11;KN;Saint Kitts and Nevis;0;0;44;0
2021-04-12;KN;Saint Kitts and Nevis;0;0;44;0
2021-04-13;KN;Saint Kitts and Nevis;0;0;44;0
2021-04-14;KN;Saint Kitts and Nevis;0;0;44;0
2021-04-15;KN;Saint Kitts and Nevis;0;0;44;0
2021-04-16;KN;Saint Kitts and Nevis;0;0;44;0
2021-04-17;KN;Saint Kitts and Nevis;0;0;44;0
2021-04-18;KN;Saint Kitts and Nevis;0;0;44;0
2021-04-19;KN;Saint Kitts and Nevis;0;0;44;0
2021-04-20;KN;Saint Kitts and Nevis;0;0;44;0
2021-04-21;KN;Saint Kitts and Nevis;0;0;44;0
2021-04-22;KN;Saint Kitts and Nevis;0;0;44;0
2021-04-23;KN;Saint Kitts and Nevis;0;0;44;0
2021-04-24;KN;Saint Kitts and Nevis;0;0;44;0
2021-04-25;KN;Saint Kitts and Nevis;0;0;44;0
2021-04-26;KN;Saint Kitts and Nevis;0;0;44;0
2021-04-27;KN;Saint Kitts and Nevis;0;0;44;0
2021-04-28;KN;Saint Kitts and Nevis;0;0;44;0
2021-04-29;KN;Saint Kitts and Nevis;0;0;44;0
2021-04-30;KN;Saint Kitts and Nevis;0;0;44;0
2021-05-01;KN;Saint Kitts and Nevis;1;0;45;0
2021-05-02;KN;Saint Kitts and Nevis;0;0;45;0
2021-05-03;KN;Saint Kitts and Nevis;0;0;45;0
2021-05-04;KN;Saint Kitts and Nevis;0;0;45;0
2021-05-05;KN;Saint Kitts and Nevis;0;0;45;0
2021-05-06;KN;Saint Kitts and Nevis;0;0;45;0
2021-05-07;KN;Saint Kitts and Nevis;0;0;45;0
2021-05-08;KN;Saint Kitts and Nevis;0;0;45;0
2021-05-09;KN;Saint Kitts and Nevis;0;0;45;0
2021-05-10;KN;Saint Kitts and Nevis;0;0;45;0
2021-05-11;KN;Saint Kitts and Nevis;0;0;45;0
2021-05-12;KN;Saint Kitts and Nevis;0;0;45;0
2021-05-13;KN;Saint Kitts and Nevis;0;0;45;0
2021-05-14;KN;Saint Kitts and Nevis;0;0;45;0
2021-05-15;KN;Saint Kitts and Nevis;0;0;45;0
2021-05-16;KN;Saint Kitts and Nevis;0;0;45;0
2021-05-17;KN;Saint Kitts and Nevis;0;0;45;0
2021-05-18;KN;Saint Kitts and Nevis;0;0;45;0
2021-05-19;KN;Saint Kitts and Nevis;0;0;45;0
2021-05-20;KN;Saint Kitts and Nevis;1;0;46;0
2021-05-21;KN;Saint Kitts and Nevis;0;0;46;0
2021-05-22;KN;Saint Kitts and Nevis;0;0;46;0
2021-05-23;KN;Saint Kitts and Nevis;4;0;50;0
2021-05-24;KN;Saint Kitts and Nevis;10;0;60;0
2021-05-25;KN;Saint Kitts and Nevis;0;0;60;0
2021-05-26;KN;Saint Kitts and Nevis;0;0;60;0
2021-05-27;KN;Saint Kitts and Nevis;4;0;64;0
2021-05-28;KN;Saint Kitts and Nevis;4;0;68;0
2021-05-29;KN;Saint Kitts and Nevis;0;0;68;0
2021-05-30;KN;Saint Kitts and Nevis;0;0;68;0
2021-05-31;KN;Saint Kitts and Nevis;0;0;68;0
2021-06-01;KN;Saint Kitts and Nevis;5;0;73;0
2021-06-02;KN;Saint Kitts and Nevis;0;0;73;0
2021-06-03;KN;Saint Kitts and Nevis;2;0;75;0
2021-06-04;KN;Saint Kitts and Nevis;3;0;78;0
2021-06-05;KN;Saint Kitts and Nevis;5;0;83;0
2021-06-06;KN;Saint Kitts and Nevis;0;0;83;0
2021-06-07;KN;Saint Kitts and Nevis;0;0;83;0
2021-06-08;KN;Saint Kitts and Nevis;0;0;83;0
2021-06-09;KN;Saint Kitts and Nevis;0;0;83;0
2021-06-10;KN;Saint Kitts and Nevis;0;0;83;0
2021-06-11;KN;Saint Kitts and Nevis;0;0;83;0
2021-06-12;KN;Saint Kitts and Nevis;72;0;155;0
2021-06-13;KN;Saint Kitts and Nevis;0;0;155;0
2021-06-14;KN;Saint Kitts and Nevis;0;0;155;0
2021-06-15;KN;Saint Kitts and Nevis;54;0;209;0
2021-06-16;KN;Saint Kitts and Nevis;35;0;244;0
2021-06-17;KN;Saint Kitts and Nevis;35;1;279;1
2021-06-18;KN;Saint Kitts and Nevis;25;0;304;1
2021-06-19;KN;Saint Kitts and Nevis;26;0;330;1
2021-06-20;KN;Saint Kitts and Nevis;11;0;341;1
2021-06-21;KN;Saint Kitts and Nevis;9;1;350;2
2021-06-22;KN;Saint Kitts and Nevis;27;1;377;3
2021-06-23;KN;Saint Kitts and Nevis;19;0;396;3
2021-06-24;KN;Saint Kitts and Nevis;29;0;425;3
2021-06-25;KN;Saint Kitts and Nevis;0;0;425;3
2021-06-26;KN;Saint Kitts and Nevis;3;0;428;3
2021-06-27;KN;Saint Kitts and Nevis;1;0;429;3
2021-06-28;KN;Saint Kitts and Nevis;10;0;439;3
2021-06-29;KN;Saint Kitts and Nevis;4;0;443;3
2021-06-30;KN;Saint Kitts and Nevis;3;0;446;3
2021-07-01;KN;Saint Kitts and Nevis;11;0;457;3
2020-03-14;LC;Saint Lucia;1;0;1;0
2020-03-15;LC;Saint Lucia;1;0;2;0
2020-03-16;LC;Saint Lucia;0;0;2;0
2020-03-17;LC;Saint Lucia;0;0;2;0
2020-03-18;LC;Saint Lucia;0;0;2;0
2020-03-19;LC;Saint Lucia;0;0;2;0
2020-03-20;LC;Saint Lucia;0;0;2;0
2020-03-21;LC;Saint Lucia;0;0;2;0
2020-03-22;LC;Saint Lucia;0;0;2;0
2020-03-23;LC;Saint Lucia;1;0;3;0
2020-03-24;LC;Saint Lucia;0;0;3;0
2020-03-25;LC;Saint Lucia;0;0;3;0
2020-03-26;LC;Saint Lucia;0;0;3;0
2020-03-27;LC;Saint Lucia;0;0;3;0
2020-03-28;LC;Saint Lucia;0;0;3;0
2020-03-29;LC;Saint Lucia;6;0;9;0
2020-03-30;LC;Saint Lucia;0;0;9;0
2020-03-31;LC;Saint Lucia;4;0;13;0
2020-04-01;LC;Saint Lucia;0;0;13;0
2020-04-02;LC;Saint Lucia;0;0;13;0
2020-04-03;LC;Saint Lucia;0;0;13;0
2020-04-04;LC;Saint Lucia;1;0;14;0
2020-04-05;LC;Saint Lucia;0;0;14;0
2020-04-06;LC;Saint Lucia;0;0;14;0
2020-04-07;LC;Saint Lucia;0;0;14;0
2020-04-08;LC;Saint Lucia;0;0;14;0
2020-04-09;LC;Saint Lucia;0;0;14;0
2020-04-10;LC;Saint Lucia;1;0;15;0
2020-04-11;LC;Saint Lucia;0;0;15;0
2020-04-12;LC;Saint Lucia;0;0;15;0
2020-04-13;LC;Saint Lucia;0;0;15;0
2020-04-14;LC;Saint Lucia;0;0;15;0
2020-04-15;LC;Saint Lucia;0;0;15;0
2020-04-16;LC;Saint Lucia;0;0;15;0
2020-04-17;LC;Saint Lucia;0;0;15;0
2020-04-18;LC;Saint Lucia;0;0;15;0
2020-04-19;LC;Saint Lucia;0;0;15;0
2020-04-20;LC;Saint Lucia;0;0;15;0
2020-04-21;LC;Saint Lucia;0;0;15;0
2020-04-22;LC;Saint Lucia;0;0;15;0
2020-04-23;LC;Saint Lucia;0;0;15;0
2020-04-24;LC;Saint Lucia;0;0;15;0
2020-04-25;LC;Saint Lucia;0;0;15;0
2020-04-26;LC;Saint Lucia;0;0;15;0
2020-04-27;LC;Saint Lucia;0;0;15;0
2020-04-28;LC;Saint Lucia;0;0;15;0
2020-04-29;LC;Saint Lucia;2;0;17;0
2020-04-30;LC;Saint Lucia;0;0;17;0
2020-05-01;LC;Saint Lucia;0;0;17;0
2020-05-02;LC;Saint Lucia;0;0;17;0
2020-05-03;LC;Saint Lucia;1;0;18;0
2020-05-04;LC;Saint Lucia;0;0;18;0
2020-05-05;LC;Saint Lucia;0;0;18;0
2020-05-06;LC;Saint Lucia;0;0;18;0
2020-05-07;LC;Saint Lucia;0;0;18;0
2020-05-08;LC;Saint Lucia;0;0;18;0
2020-05-09;LC;Saint Lucia;0;0;18;0
2020-05-10;LC;Saint Lucia;0;0;18;0
2020-05-11;LC;Saint Lucia;0;0;18;0
2020-05-12;LC;Saint Lucia;0;0;18;0
2020-05-13;LC;Saint Lucia;0;0;18;0
2020-05-14;LC;Saint Lucia;0;0;18;0
2020-05-15;LC;Saint Lucia;0;0;18;0
2020-05-16;LC;Saint Lucia;0;0;18;0
2020-05-17;LC;Saint Lucia;0;0;18;0
2020-05-18;LC;Saint Lucia;0;0;18;0
2020-05-19;LC;Saint Lucia;0;0;18;0
2020-05-20;LC;Saint Lucia;0;0;18;0
2020-05-21;LC;Saint Lucia;0;0;18;0
2020-05-22;LC;Saint Lucia;0;0;18;0
2020-05-23;LC;Saint Lucia;0;0;18;0
2020-05-24;LC;Saint Lucia;0;0;18;0
2020-05-25;LC;Saint Lucia;0;0;18;0
2020-05-26;LC;Saint Lucia;0;0;18;0
2020-05-27;LC;Saint Lucia;0;0;18;0
2020-05-28;LC;Saint Lucia;0;0;18;0
2020-05-29;LC;Saint Lucia;0;0;18;0
2020-05-30;LC;Saint Lucia;0;0;18;0
2020-05-31;LC;Saint Lucia;0;0;18;0
2020-06-01;LC;Saint Lucia;0;0;18;0
2020-06-02;LC;Saint Lucia;0;0;18;0
2020-06-03;LC;Saint Lucia;0;0;18;0
2020-06-04;LC;Saint Lucia;1;0;19;0
2020-06-05;LC;Saint Lucia;0;0;19;0
2020-06-06;LC;Saint Lucia;0;0;19;0
2020-06-07;LC;Saint Lucia;0;0;19;0
2020-06-08;LC;Saint Lucia;0;0;19;0
2020-06-09;LC;Saint Lucia;0;0;19;0
2020-06-10;LC;Saint Lucia;0;0;19;0
2020-06-11;LC;Saint Lucia;0;0;19;0
2020-06-12;LC;Saint Lucia;0;0;19;0
2020-06-13;LC;Saint Lucia;0;0;19;0
2020-06-14;LC;Saint Lucia;0;0;19;0
2020-06-15;LC;Saint Lucia;0;0;19;0
2020-06-16;LC;Saint Lucia;0;0;19;0
2020-06-17;LC;Saint Lucia;0;0;19;0
2020-06-18;LC;Saint Lucia;0;0;19;0
2020-06-19;LC;Saint Lucia;0;0;19;0
2020-06-20;LC;Saint Lucia;0;0;19;0
2020-06-21;LC;Saint Lucia;0;0;19;0
2020-06-22;LC;Saint Lucia;0;0;19;0
2020-06-23;LC;Saint Lucia;0;0;19;0
2020-06-24;LC;Saint Lucia;0;0;19;0
2020-06-25;LC;Saint Lucia;0;0;19;0
2020-06-26;LC;Saint Lucia;0;0;19;0
2020-06-27;LC;Saint Lucia;0;0;19;0
2020-06-28;LC;Saint Lucia;0;0;19;0
2020-06-29;LC;Saint Lucia;0;0;19;0
2020-06-30;LC;Saint Lucia;0;0;19;0
2020-07-01;LC;Saint Lucia;0;0;19;0
2020-07-02;LC;Saint Lucia;0;0;19;0
2020-07-03;LC;Saint Lucia;3;0;22;0
2020-07-04;LC;Saint Lucia;0;0;22;0
2020-07-05;LC;Saint Lucia;0;0;22;0
2020-07-06;LC;Saint Lucia;0;0;22;0
2020-07-07;LC;Saint Lucia;0;0;22;0
2020-07-08;LC;Saint Lucia;0;0;22;0
2020-07-09;LC;Saint Lucia;0;0;22;0
2020-07-10;LC;Saint Lucia;0;0;22;0
2020-07-11;LC;Saint Lucia;0;0;22;0
2020-07-12;LC;Saint Lucia;0;0;22;0
2020-07-13;LC;Saint Lucia;0;0;22;0
2020-07-14;LC;Saint Lucia;0;0;22;0
2020-07-15;LC;Saint Lucia;0;0;22;0
2020-07-16;LC;Saint Lucia;1;0;23;0
2020-07-17;LC;Saint Lucia;0;0;23;0
2020-07-18;LC;Saint Lucia;0;0;23;0
2020-07-19;LC;Saint Lucia;0;0;23;0
2020-07-20;LC;Saint Lucia;0;0;23;0
2020-07-21;LC;Saint Lucia;0;0;23;0
2020-07-22;LC;Saint Lucia;0;0;23;0
2020-07-23;LC;Saint Lucia;1;0;24;0
2020-07-24;LC;Saint Lucia;0;0;24;0
2020-07-25;LC;Saint Lucia;0;0;24;0
2020-07-26;LC;Saint Lucia;0;0;24;0
2020-07-27;LC;Saint Lucia;0;0;24;0
2020-07-28;LC;Saint Lucia;0;0;24;0
2020-07-29;LC;Saint Lucia;0;0;24;0
2020-07-30;LC;Saint Lucia;1;0;25;0
2020-07-31;LC;Saint Lucia;0;0;25;0
2020-08-01;LC;Saint Lucia;0;0;25;0
2020-08-02;LC;Saint Lucia;0;0;25;0
2020-08-03;LC;Saint Lucia;0;0;25;0
2020-08-04;LC;Saint Lucia;0;0;25;0
2020-08-05;LC;Saint Lucia;0;0;25;0
2020-08-06;LC;Saint Lucia;0;0;25;0
2020-08-07;LC;Saint Lucia;0;0;25;0
2020-08-08;LC;Saint Lucia;0;0;25;0
2020-08-09;LC;Saint Lucia;0;0;25;0
2020-08-10;LC;Saint Lucia;0;0;25;0
2020-08-11;LC;Saint Lucia;0;0;25;0
2020-08-12;LC;Saint Lucia;0;0;25;0
2020-08-13;LC;Saint Lucia;0;0;25;0
2020-08-14;LC;Saint Lucia;0;0;25;0
2020-08-15;LC;Saint Lucia;0;0;25;0
2020-08-16;LC;Saint Lucia;0;0;25;0
2020-08-17;LC;Saint Lucia;0;0;25;0
2020-08-18;LC;Saint Lucia;1;0;26;0
2020-08-19;LC;Saint Lucia;0;0;26;0
2020-08-20;LC;Saint Lucia;0;0;26;0
2020-08-21;LC;Saint Lucia;0;0;26;0
2020-08-22;LC;Saint Lucia;0;0;26;0
2020-08-23;LC;Saint Lucia;0;0;26;0
2020-08-24;LC;Saint Lucia;0;0;26;0
2020-08-25;LC;Saint Lucia;0;0;26;0
2020-08-26;LC;Saint Lucia;0;0;26;0
2020-08-27;LC;Saint Lucia;0;0;26;0
2020-08-28;LC;Saint Lucia;0;0;26;0
2020-08-29;LC;Saint Lucia;0;0;26;0
2020-08-30;LC;Saint Lucia;0;0;26;0
2020-08-31;LC;Saint Lucia;0;0;26;0
2020-09-01;LC;Saint Lucia;0;0;26;0
2020-09-02;LC;Saint Lucia;0;0;26;0
2020-09-03;LC;Saint Lucia;0;0;26;0
2020-09-04;LC;Saint Lucia;0;0;26;0
2020-09-05;LC;Saint Lucia;0;0;26;0
2020-09-06;LC;Saint Lucia;0;0;26;0
2020-09-07;LC;Saint Lucia;0;0;26;0
2020-09-08;LC;Saint Lucia;0;0;26;0
2020-09-09;LC;Saint Lucia;1;0;27;0
2020-09-10;LC;Saint Lucia;0;0;27;0
2020-09-11;LC;Saint Lucia;0;0;27;0
2020-09-12;LC;Saint Lucia;0;0;27;0
2020-09-13;LC;Saint Lucia;0;0;27;0
2020-09-14;LC;Saint Lucia;0;0;27;0
2020-09-15;LC;Saint Lucia;0;0;27;0
2020-09-16;LC;Saint Lucia;0;0;27;0
2020-09-17;LC;Saint Lucia;0;0;27;0
2020-09-18;LC;Saint Lucia;0;0;27;0
2020-09-19;LC;Saint Lucia;0;0;27;0
2020-09-20;LC;Saint Lucia;0;0;27;0
2020-09-21;LC;Saint Lucia;0;0;27;0
2020-09-22;LC;Saint Lucia;0;0;27;0
2020-09-23;LC;Saint Lucia;0;0;27;0
2020-09-24;LC;Saint Lucia;0;0;27;0
2020-09-25;LC;Saint Lucia;0;0;27;0
2020-09-26;LC;Saint Lucia;0;0;27;0
2020-09-27;LC;Saint Lucia;0;0;27;0
2020-09-28;LC;Saint Lucia;0;0;27;0
2020-09-29;LC;Saint Lucia;0;0;27;0
2020-09-30;LC;Saint Lucia;0;0;27;0
2020-10-01;LC;Saint Lucia;0;0;27;0
2020-10-02;LC;Saint Lucia;0;0;27;0
2020-10-03;LC;Saint Lucia;0;0;27;0
2020-10-04;LC;Saint Lucia;0;0;27;0
2020-10-05;LC;Saint Lucia;0;0;27;0
2020-10-06;LC;Saint Lucia;0;0;27;0
2020-10-07;LC;Saint Lucia;0;0;27;0
2020-10-08;LC;Saint Lucia;1;0;28;0
2020-10-09;LC;Saint Lucia;0;0;28;0
2020-10-10;LC;Saint Lucia;1;0;29;0
2020-10-11;LC;Saint Lucia;0;0;29;0
2020-10-12;LC;Saint Lucia;0;0;29;0
2020-10-13;LC;Saint Lucia;0;0;29;0
2020-10-14;LC;Saint Lucia;2;0;31;0
2020-10-15;LC;Saint Lucia;0;0;31;0
2020-10-16;LC;Saint Lucia;1;0;32;0
2020-10-17;LC;Saint Lucia;1;0;33;0
2020-10-18;LC;Saint Lucia;0;0;33;0
2020-10-19;LC;Saint Lucia;3;0;36;0
2020-10-20;LC;Saint Lucia;0;0;36;0
2020-10-21;LC;Saint Lucia;2;0;38;0
2020-10-22;LC;Saint Lucia;4;0;42;0
2020-10-23;LC;Saint Lucia;6;0;48;0
2020-10-24;LC;Saint Lucia;4;0;52;0
2020-10-25;LC;Saint Lucia;2;0;54;0
2020-10-26;LC;Saint Lucia;9;0;63;0
2020-10-27;LC;Saint Lucia;2;0;65;0
2020-10-28;LC;Saint Lucia;2;0;67;0
2020-10-29;LC;Saint Lucia;9;0;76;0
2020-10-30;LC;Saint Lucia;2;0;78;0
2020-10-31;LC;Saint Lucia;0;0;78;0
2020-11-01;LC;Saint Lucia;6;0;84;0
2020-11-02;LC;Saint Lucia;0;0;84;0
2020-11-03;LC;Saint Lucia;13;0;97;0
2020-11-04;LC;Saint Lucia;8;0;105;0
2020-11-05;LC;Saint Lucia;1;0;106;0
2020-11-06;LC;Saint Lucia;4;0;110;0
2020-11-07;LC;Saint Lucia;13;0;123;0
2020-11-08;LC;Saint Lucia;8;0;131;0
2020-11-09;LC;Saint Lucia;10;0;141;0
2020-11-10;LC;Saint Lucia;7;1;148;1
2020-11-11;LC;Saint Lucia;0;1;148;2
2020-11-12;LC;Saint Lucia;0;0;148;2
2020-11-13;LC;Saint Lucia;8;0;156;2
2020-11-14;LC;Saint Lucia;4;0;160;2
2020-11-15;LC;Saint Lucia;2;0;162;2
2020-11-16;LC;Saint Lucia;9;0;171;2
2020-11-17;LC;Saint Lucia;7;0;178;2
2020-11-18;LC;Saint Lucia;5;0;183;2
2020-11-19;LC;Saint Lucia;20;0;203;2
2020-11-20;LC;Saint Lucia;0;0;203;2
2020-11-21;LC;Saint Lucia;1;0;204;2
2020-11-22;LC;Saint Lucia;16;0;220;2
2020-11-23;LC;Saint Lucia;3;0;223;2
2020-11-24;LC;Saint Lucia;3;0;226;2
2020-11-25;LC;Saint Lucia;9;0;235;2
2020-11-26;LC;Saint Lucia;3;0;238;2
2020-11-27;LC;Saint Lucia;8;0;246;2
2020-11-28;LC;Saint Lucia;6;0;252;2
2020-11-29;LC;Saint Lucia;5;0;257;2
2020-11-30;LC;Saint Lucia;2;0;259;2
2020-12-01;LC;Saint Lucia;0;0;259;2
2020-12-02;LC;Saint Lucia;2;0;261;2
2020-12-03;LC;Saint Lucia;1;0;262;2
2020-12-04;LC;Saint Lucia;0;0;262;2
2020-12-05;LC;Saint Lucia;3;0;265;2
2020-12-06;LC;Saint Lucia;0;0;265;2
2020-12-07;LC;Saint Lucia;5;0;270;2
2020-12-08;LC;Saint Lucia;0;0;270;2
2020-12-09;LC;Saint Lucia;0;0;270;2
2020-12-10;LC;Saint Lucia;0;0;270;2
2020-12-11;LC;Saint Lucia;4;2;274;4
2020-12-12;LC;Saint Lucia;0;0;274;4
2020-12-13;LC;Saint Lucia;1;0;275;4
2020-12-14;LC;Saint Lucia;3;0;278;4
2020-12-15;LC;Saint Lucia;0;0;278;4
2020-12-16;LC;Saint Lucia;0;0;278;4
2020-12-17;LC;Saint Lucia;1;1;279;5
2020-12-18;LC;Saint Lucia;1;0;280;5
2020-12-19;LC;Saint Lucia;2;0;282;5
2020-12-20;LC;Saint Lucia;5;0;287;5
2020-12-21;LC;Saint Lucia;0;0;287;5
2020-12-22;LC;Saint Lucia;16;0;303;5
2020-12-23;LC;Saint Lucia;2;0;305;5
2020-12-24;LC;Saint Lucia;0;0;305;5
2020-12-25;LC;Saint Lucia;0;0;305;5
2020-12-26;LC;Saint Lucia;0;0;305;5
2020-12-27;LC;Saint Lucia;0;0;305;5
2020-12-28;LC;Saint Lucia;26;0;331;5
2020-12-29;LC;Saint Lucia;0;0;331;5
2020-12-30;LC;Saint Lucia;9;0;340;5
2020-12-31;LC;Saint Lucia;13;0;353;5
2021-01-01;LC;Saint Lucia;0;0;353;5
2021-01-02;LC;Saint Lucia;0;0;353;5
2021-01-03;LC;Saint Lucia;0;0;353;5
2021-01-04;LC;Saint Lucia;7;0;360;5
2021-01-05;LC;Saint Lucia;20;0;380;5
2021-01-06;LC;Saint Lucia;2;0;382;5
2021-01-07;LC;Saint Lucia;1;0;383;5
2021-01-08;LC;Saint Lucia;12;0;395;5
2021-01-09;LC;Saint Lucia;43;0;438;5
2021-01-10;LC;Saint Lucia;0;0;438;5
2021-01-11;LC;Saint Lucia;24;0;462;5
2021-01-12;LC;Saint Lucia;28;0;490;5
2021-01-13;LC;Saint Lucia;12;1;502;6
2021-01-14;LC;Saint Lucia;41;0;543;6
2021-01-15;LC;Saint Lucia;33;0;576;6
2021-01-16;LC;Saint Lucia;35;2;611;8
2021-01-17;LC;Saint Lucia;0;0;611;8
2021-01-18;LC;Saint Lucia;10;0;621;8
2021-01-19;LC;Saint Lucia;35;0;656;8
2021-01-20;LC;Saint Lucia;57;0;713;8
2021-01-21;LC;Saint Lucia;5;1;718;9
2021-01-22;LC;Saint Lucia;37;1;755;10
2021-01-23;LC;Saint Lucia;15;0;770;10
2021-01-24;LC;Saint Lucia;40;1;810;11
2021-01-25;LC;Saint Lucia;76;0;886;11
2021-01-26;LC;Saint Lucia;35;2;921;13
2021-01-27;LC;Saint Lucia;48;0;969;13
2021-01-28;LC;Saint Lucia;60;0;1029;13
2021-01-29;LC;Saint Lucia;166;0;1195;13
2021-01-30;LC;Saint Lucia;0;0;1195;13
2021-01-31;LC;Saint Lucia;0;0;1195;13
2021-02-01;LC;Saint Lucia;216;2;1411;15
2021-02-02;LC;Saint Lucia;59;1;1470;16
2021-02-03;LC;Saint Lucia;9;0;1479;16
2021-02-04;LC;Saint Lucia;77;2;1556;18
2021-02-05;LC;Saint Lucia;0;0;1556;18
2021-02-06;LC;Saint Lucia;257;0;1813;18
2021-02-07;LC;Saint Lucia;0;0;1813;18
2021-02-08;LC;Saint Lucia;214;1;2027;19
2021-02-09;LC;Saint Lucia;0;0;2027;19
2021-02-10;LC;Saint Lucia;0;0;2027;19
2021-02-11;LC;Saint Lucia;388;3;2415;22
2021-02-12;LC;Saint Lucia;72;1;2487;23
2021-02-13;LC;Saint Lucia;0;0;2487;23
2021-02-14;LC;Saint Lucia;32;0;2519;23
2021-02-15;LC;Saint Lucia;0;0;2519;23
2021-02-16;LC;Saint Lucia;30;0;2549;23
2021-02-17;LC;Saint Lucia;27;1;2576;24
2021-02-18;LC;Saint Lucia;44;1;2620;25
2021-02-19;LC;Saint Lucia;0;0;2620;25
2021-02-20;LC;Saint Lucia;240;3;2860;28
2021-02-21;LC;Saint Lucia;218;3;3078;31
2021-02-22;LC;Saint Lucia;57;1;3135;32
2021-02-23;LC;Saint Lucia;7;0;3142;32
2021-02-24;LC;Saint Lucia;7;2;3149;34
2021-02-25;LC;Saint Lucia;0;0;3149;34
2021-02-26;LC;Saint Lucia;207;1;3356;35
2021-02-27;LC;Saint Lucia;0;0;3356;35
2021-02-28;LC;Saint Lucia;34;0;3390;35
2021-03-01;LC;Saint Lucia;0;1;3390;36
2021-03-02;LC;Saint Lucia;389;1;3779;37
2021-03-03;LC;Saint Lucia;24;2;3803;39
2021-03-04;LC;Saint Lucia;11;4;3814;43
2021-03-05;LC;Saint Lucia;0;0;3814;43
2021-03-06;LC;Saint Lucia;29;0;3843;43
2021-03-07;LC;Saint Lucia;23;0;3866;43
2021-03-08;LC;Saint Lucia;5;3;3871;46
2021-03-09;LC;Saint Lucia;31;0;3902;46
2021-03-10;LC;Saint Lucia;39;1;3941;47
2021-03-11;LC;Saint Lucia;25;0;3966;47
2021-03-12;LC;Saint Lucia;23;1;3989;48
2021-03-13;LC;Saint Lucia;0;0;3989;48
2021-03-14;LC;Saint Lucia;42;3;4031;51
2021-03-15;LC;Saint Lucia;22;4;4053;55
2021-03-16;LC;Saint Lucia;16;0;4069;55
2021-03-17;LC;Saint Lucia;14;0;4083;55
2021-03-18;LC;Saint Lucia;14;0;4097;55
2021-03-19;LC;Saint Lucia;16;0;4113;55
2021-03-20;LC;Saint Lucia;0;0;4113;55
2021-03-21;LC;Saint Lucia;8;0;4121;55
2021-03-22;LC;Saint Lucia;11;0;4132;55
2021-03-23;LC;Saint Lucia;17;2;4149;57
2021-03-24;LC;Saint Lucia;12;1;4161;58
2021-03-25;LC;Saint Lucia;11;0;4172;58
2021-03-26;LC;Saint Lucia;19;0;4191;58
2021-03-27;LC;Saint Lucia;0;0;4191;58
2021-03-28;LC;Saint Lucia;0;0;4191;58
2021-03-29;LC;Saint Lucia;11;0;4202;58
2021-03-30;LC;Saint Lucia;26;1;4228;59
2021-03-31;LC;Saint Lucia;10;1;4238;60
2021-04-01;LC;Saint Lucia;7;1;4245;61
2021-04-02;LC;Saint Lucia;20;0;4265;61
2021-04-03;LC;Saint Lucia;8;0;4273;61
2021-04-04;LC;Saint Lucia;0;0;4273;61
2021-04-05;LC;Saint Lucia;0;0;4273;61
2021-04-06;LC;Saint Lucia;24;2;4297;63
2021-04-07;LC;Saint Lucia;7;0;4304;63
2021-04-08;LC;Saint Lucia;8;0;4312;63
2021-04-09;LC;Saint Lucia;17;1;4329;64
2021-04-10;LC;Saint Lucia;18;0;4347;64
2021-04-11;LC;Saint Lucia;1;0;4348;64
2021-04-12;LC;Saint Lucia;7;0;4355;64
2021-04-13;LC;Saint Lucia;0;0;4355;64
2021-04-14;LC;Saint Lucia;0;0;4355;64
2021-04-15;LC;Saint Lucia;0;0;4355;64
2021-04-16;LC;Saint Lucia;43;1;4398;65
2021-04-17;LC;Saint Lucia;3;2;4401;67
2021-04-18;LC;Saint Lucia;0;0;4401;67
2021-04-19;LC;Saint Lucia;18;2;4419;69
2021-04-20;LC;Saint Lucia;0;0;4419;69
2021-04-21;LC;Saint Lucia;25;1;4444;70
2021-04-22;LC;Saint Lucia;11;0;4455;70
2021-04-23;LC;Saint Lucia;0;0;4455;70
2021-04-24;LC;Saint Lucia;8;0;4463;70
2021-04-25;LC;Saint Lucia;23;0;4486;70
2021-04-26;LC;Saint Lucia;16;3;4502;73
2021-04-27;LC;Saint Lucia;6;1;4508;74
2021-04-28;LC;Saint Lucia;0;0;4508;74
2021-04-29;LC;Saint Lucia;26;0;4534;74
2021-04-30;LC;Saint Lucia;18;0;4552;74
2021-05-01;LC;Saint Lucia;8;0;4560;74
2021-05-02;LC;Saint Lucia;0;0;4560;74
2021-05-03;LC;Saint Lucia;0;0;4560;74
2021-05-04;LC;Saint Lucia;13;0;4573;74
2021-05-05;LC;Saint Lucia;12;0;4585;74
2021-05-06;LC;Saint Lucia;22;1;4607;75
2021-05-07;LC;Saint Lucia;0;0;4607;75
2021-05-08;LC;Saint Lucia;47;0;4654;75
2021-05-09;LC;Saint Lucia;0;0;4654;75
2021-05-10;LC;Saint Lucia;36;0;4690;75
2021-05-11;LC;Saint Lucia;10;0;4700;75
2021-05-12;LC;Saint Lucia;25;0;4725;75
2021-05-13;LC;Saint Lucia;0;0;4725;75
2021-05-14;LC;Saint Lucia;63;0;4788;75
2021-05-15;LC;Saint Lucia;30;0;4818;75
2021-05-16;LC;Saint Lucia;0;0;4818;75
2021-05-17;LC;Saint Lucia;0;1;4818;76
2021-05-18;LC;Saint Lucia;53;1;4871;77
2021-05-19;LC;Saint Lucia;35;0;4906;77
2021-05-20;LC;Saint Lucia;17;0;4923;77
2021-05-21;LC;Saint Lucia;12;0;4935;77
2021-05-22;LC;Saint Lucia;0;0;4935;77
2021-05-23;LC;Saint Lucia;10;0;4945;77
2021-05-24;LC;Saint Lucia;0;0;4945;77
2021-05-25;LC;Saint Lucia;23;0;4968;77
2021-05-26;LC;Saint Lucia;12;0;4980;77
2021-05-27;LC;Saint Lucia;22;0;5002;77
2021-05-28;LC;Saint Lucia;33;0;5035;77
2021-05-29;LC;Saint Lucia;0;0;5035;77
2021-05-30;LC;Saint Lucia;18;0;5053;77
2021-05-31;LC;Saint Lucia;14;2;5067;79
2021-06-01;LC;Saint Lucia;5;0;5072;79
2021-06-02;LC;Saint Lucia;0;1;5072;80
2021-06-03;LC;Saint Lucia;30;0;5102;80
2021-06-04;LC;Saint Lucia;6;0;5108;80
2021-06-05;LC;Saint Lucia;0;0;5108;80
2021-06-06;LC;Saint Lucia;25;0;5133;80
2021-06-07;LC;Saint Lucia;5;0;5138;80
2021-06-08;LC;Saint Lucia;10;0;5148;80
2021-06-09;LC;Saint Lucia;8;0;5156;80
2021-06-10;LC;Saint Lucia;4;0;5160;80
2021-06-11;LC;Saint Lucia;8;0;5168;80
2021-06-12;LC;Saint Lucia;11;0;5179;80
2021-06-13;LC;Saint Lucia;0;0;5179;80
2021-06-14;LC;Saint Lucia;1;0;5180;80
2021-06-15;LC;Saint Lucia;6;0;5186;80
2021-06-16;LC;Saint Lucia;2;0;5188;80
2021-06-17;LC;Saint Lucia;0;0;5188;80
2021-06-18;LC;Saint Lucia;18;0;5206;80
2021-06-19;LC;Saint Lucia;5;0;5211;80
2021-06-20;LC;Saint Lucia;5;0;5216;80
2021-06-21;LC;Saint Lucia;2;0;5218;80
2021-06-22;LC;Saint Lucia;9;4;5227;84
2021-06-23;LC;Saint Lucia;11;0;5238;84
2021-06-24;LC;Saint Lucia;0;0;5238;84
2021-06-25;LC;Saint Lucia;24;0;5262;84
2021-06-26;LC;Saint Lucia;7;0;5269;84
2021-06-27;LC;Saint Lucia;9;0;5278;84
2021-06-28;LC;Saint Lucia;6;0;5284;84
2021-06-29;LC;Saint Lucia;8;0;5292;84
2021-06-30;LC;Saint Lucia;4;0;5296;84
2021-07-01;LC;Saint Lucia;6;0;5302;84
2020-03-14;VC;Saint Vincent and the Grenadines;1;0;1;0
2020-03-15;VC;Saint Vincent and the Grenadines;0;0;1;0
2020-03-16;VC;Saint Vincent and the Grenadines;0;0;1;0
2020-03-17;VC;Saint Vincent and the Grenadines;0;0;1;0
2020-03-18;VC;Saint Vincent and the Grenadines;0;0;1;0
2020-03-19;VC;Saint Vincent and the Grenadines;0;0;1;0
2020-03-20;VC;Saint Vincent and the Grenadines;0;0;1;0
2020-03-21;VC;Saint Vincent and the Grenadines;0;0;1;0
2020-03-22;VC;Saint Vincent and the Grenadines;0;0;1;0
2020-03-23;VC;Saint Vincent and the Grenadines;0;0;1;0
2020-03-24;VC;Saint Vincent and the Grenadines;0;0;1;0
2020-03-25;VC;Saint Vincent and the Grenadines;0;0;1;0
2020-03-26;VC;Saint Vincent and the Grenadines;0;0;1;0
2020-03-27;VC;Saint Vincent and the Grenadines;0;0;1;0
2020-03-28;VC;Saint Vincent and the Grenadines;0;0;1;0
2020-03-29;VC;Saint Vincent and the Grenadines;0;0;1;0
2020-03-30;VC;Saint Vincent and the Grenadines;0;0;1;0
2020-03-31;VC;Saint Vincent and the Grenadines;0;0;1;0
2020-04-01;VC;Saint Vincent and the Grenadines;0;0;1;0
2020-04-02;VC;Saint Vincent and the Grenadines;1;0;2;0
2020-04-03;VC;Saint Vincent and the Grenadines;1;0;3;0
2020-04-04;VC;Saint Vincent and the Grenadines;4;0;7;0
2020-04-05;VC;Saint Vincent and the Grenadines;0;0;7;0
2020-04-06;VC;Saint Vincent and the Grenadines;0;0;7;0
2020-04-07;VC;Saint Vincent and the Grenadines;1;0;8;0
2020-04-08;VC;Saint Vincent and the Grenadines;0;0;8;0
2020-04-09;VC;Saint Vincent and the Grenadines;4;0;12;0
2020-04-10;VC;Saint Vincent and the Grenadines;0;0;12;0
2020-04-11;VC;Saint Vincent and the Grenadines;0;0;12;0
2020-04-12;VC;Saint Vincent and the Grenadines;0;0;12;0
2020-04-13;VC;Saint Vincent and the Grenadines;0;0;12;0
2020-04-14;VC;Saint Vincent and the Grenadines;0;0;12;0
2020-04-15;VC;Saint Vincent and the Grenadines;0;0;12;0
2020-04-16;VC;Saint Vincent and the Grenadines;0;0;12;0
2020-04-17;VC;Saint Vincent and the Grenadines;0;0;12;0
2020-04-18;VC;Saint Vincent and the Grenadines;0;0;12;0
2020-04-19;VC;Saint Vincent and the Grenadines;0;0;12;0
2020-04-20;VC;Saint Vincent and the Grenadines;0;0;12;0
2020-04-21;VC;Saint Vincent and the Grenadines;0;0;12;0
2020-04-22;VC;Saint Vincent and the Grenadines;1;0;13;0
2020-04-23;VC;Saint Vincent and the Grenadines;0;0;13;0
2020-04-24;VC;Saint Vincent and the Grenadines;1;0;14;0
2020-04-25;VC;Saint Vincent and the Grenadines;0;0;14;0
2020-04-26;VC;Saint Vincent and the Grenadines;0;0;14;0
2020-04-27;VC;Saint Vincent and the Grenadines;1;0;15;0
2020-04-28;VC;Saint Vincent and the Grenadines;0;0;15;0
2020-04-29;VC;Saint Vincent and the Grenadines;1;0;16;0
2020-04-30;VC;Saint Vincent and the Grenadines;0;0;16;0
2020-05-01;VC;Saint Vincent and the Grenadines;0;0;16;0
2020-05-02;VC;Saint Vincent and the Grenadines;0;0;16;0
2020-05-03;VC;Saint Vincent and the Grenadines;0;0;16;0
2020-05-04;VC;Saint Vincent and the Grenadines;1;0;17;0
2020-05-05;VC;Saint Vincent and the Grenadines;0;0;17;0
2020-05-06;VC;Saint Vincent and the Grenadines;0;0;17;0
2020-05-07;VC;Saint Vincent and the Grenadines;0;0;17;0
2020-05-08;VC;Saint Vincent and the Grenadines;0;0;17;0
2020-05-09;VC;Saint Vincent and the Grenadines;0;0;17;0
2020-05-10;VC;Saint Vincent and the Grenadines;0;0;17;0
2020-05-11;VC;Saint Vincent and the Grenadines;0;0;17;0
2020-05-12;VC;Saint Vincent and the Grenadines;0;0;17;0
2020-05-13;VC;Saint Vincent and the Grenadines;0;0;17;0
2020-05-14;VC;Saint Vincent and the Grenadines;0;0;17;0
2020-05-15;VC;Saint Vincent and the Grenadines;0;0;17;0
2020-05-16;VC;Saint Vincent and the Grenadines;0;0;17;0
2020-05-17;VC;Saint Vincent and the Grenadines;0;0;17;0
2020-05-18;VC;Saint Vincent and the Grenadines;0;0;17;0
2020-05-19;VC;Saint Vincent and the Grenadines;0;0;17;0
2020-05-20;VC;Saint Vincent and the Grenadines;1;0;18;0
2020-05-21;VC;Saint Vincent and the Grenadines;0;0;18;0
2020-05-22;VC;Saint Vincent and the Grenadines;0;0;18;0
2020-05-23;VC;Saint Vincent and the Grenadines;0;0;18;0
2020-05-24;VC;Saint Vincent and the Grenadines;0;0;18;0
2020-05-25;VC;Saint Vincent and the Grenadines;0;0;18;0
2020-05-26;VC;Saint Vincent and the Grenadines;0;0;18;0
2020-05-27;VC;Saint Vincent and the Grenadines;0;0;18;0
2020-05-28;VC;Saint Vincent and the Grenadines;7;0;25;0
2020-05-29;VC;Saint Vincent and the Grenadines;1;0;26;0
2020-05-30;VC;Saint Vincent and the Grenadines;0;0;26;0
2020-05-31;VC;Saint Vincent and the Grenadines;0;0;26;0
2020-06-01;VC;Saint Vincent and the Grenadines;0;0;26;0
2020-06-02;VC;Saint Vincent and the Grenadines;0;0;26;0
2020-06-03;VC;Saint Vincent and the Grenadines;0;0;26;0
2020-06-04;VC;Saint Vincent and the Grenadines;0;0;26;0
2020-06-05;VC;Saint Vincent and the Grenadines;0;0;26;0
2020-06-06;VC;Saint Vincent and the Grenadines;0;0;26;0
2020-06-07;VC;Saint Vincent and the Grenadines;1;0;27;0
2020-06-08;VC;Saint Vincent and the Grenadines;0;0;27;0
2020-06-09;VC;Saint Vincent and the Grenadines;0;0;27;0
2020-06-10;VC;Saint Vincent and the Grenadines;0;0;27;0
2020-06-11;VC;Saint Vincent and the Grenadines;0;0;27;0
2020-06-12;VC;Saint Vincent and the Grenadines;0;0;27;0
2020-06-13;VC;Saint Vincent and the Grenadines;0;0;27;0
2020-06-14;VC;Saint Vincent and the Grenadines;0;0;27;0
2020-06-15;VC;Saint Vincent and the Grenadines;0;0;27;0
2020-06-16;VC;Saint Vincent and the Grenadines;2;0;29;0
2020-06-17;VC;Saint Vincent and the Grenadines;0;0;29;0
2020-06-18;VC;Saint Vincent and the Grenadines;0;0;29;0
2020-06-19;VC;Saint Vincent and the Grenadines;0;0;29;0
2020-06-20;VC;Saint Vincent and the Grenadines;0;0;29;0
2020-06-21;VC;Saint Vincent and the Grenadines;0;0;29;0
2020-06-22;VC;Saint Vincent and the Grenadines;0;0;29;0
2020-06-23;VC;Saint Vincent and the Grenadines;0;0;29;0
2020-06-24;VC;Saint Vincent and the Grenadines;0;0;29;0
2020-06-25;VC;Saint Vincent and the Grenadines;0;0;29;0
2020-06-26;VC;Saint Vincent and the Grenadines;0;0;29;0
2020-06-27;VC;Saint Vincent and the Grenadines;0;0;29;0
2020-06-28;VC;Saint Vincent and the Grenadines;0;0;29;0
2020-06-29;VC;Saint Vincent and the Grenadines;0;0;29;0
2020-06-30;VC;Saint Vincent and the Grenadines;0;0;29;0
2020-07-01;VC;Saint Vincent and the Grenadines;0;0;29;0
2020-07-02;VC;Saint Vincent and the Grenadines;0;0;29;0
2020-07-03;VC;Saint Vincent and the Grenadines;0;0;29;0
2020-07-04;VC;Saint Vincent and the Grenadines;0;0;29;0
2020-07-05;VC;Saint Vincent and the Grenadines;0;0;29;0
2020-07-06;VC;Saint Vincent and the Grenadines;0;0;29;0
2020-07-07;VC;Saint Vincent and the Grenadines;0;0;29;0
2020-07-08;VC;Saint Vincent and the Grenadines;0;0;29;0
2020-07-09;VC;Saint Vincent and the Grenadines;0;0;29;0
2020-07-10;VC;Saint Vincent and the Grenadines;0;0;29;0
2020-07-11;VC;Saint Vincent and the Grenadines;0;0;29;0
2020-07-12;VC;Saint Vincent and the Grenadines;6;0;35;0
2020-07-13;VC;Saint Vincent and the Grenadines;0;0;35;0
2020-07-14;VC;Saint Vincent and the Grenadines;0;0;35;0
2020-07-15;VC;Saint Vincent and the Grenadines;0;0;35;0
2020-07-16;VC;Saint Vincent and the Grenadines;0;0;35;0
2020-07-17;VC;Saint Vincent and the Grenadines;0;0;35;0
2020-07-18;VC;Saint Vincent and the Grenadines;3;0;38;0
2020-07-19;VC;Saint Vincent and the Grenadines;6;0;44;0
2020-07-20;VC;Saint Vincent and the Grenadines;6;0;50;0
2020-07-21;VC;Saint Vincent and the Grenadines;0;0;50;0
2020-07-22;VC;Saint Vincent and the Grenadines;2;0;52;0
2020-07-23;VC;Saint Vincent and the Grenadines;0;0;52;0
2020-07-24;VC;Saint Vincent and the Grenadines;0;0;52;0
2020-07-25;VC;Saint Vincent and the Grenadines;0;0;52;0
2020-07-26;VC;Saint Vincent and the Grenadines;0;0;52;0
2020-07-27;VC;Saint Vincent and the Grenadines;0;0;52;0
2020-07-28;VC;Saint Vincent and the Grenadines;0;0;52;0
2020-07-29;VC;Saint Vincent and the Grenadines;0;0;52;0
2020-07-30;VC;Saint Vincent and the Grenadines;0;0;52;0
2020-07-31;VC;Saint Vincent and the Grenadines;2;0;54;0
2020-08-01;VC;Saint Vincent and the Grenadines;0;0;54;0
2020-08-02;VC;Saint Vincent and the Grenadines;1;0;55;0
2020-08-03;VC;Saint Vincent and the Grenadines;0;0;55;0
2020-08-04;VC;Saint Vincent and the Grenadines;0;0;55;0
2020-08-05;VC;Saint Vincent and the Grenadines;1;0;56;0
2020-08-06;VC;Saint Vincent and the Grenadines;0;0;56;0
2020-08-07;VC;Saint Vincent and the Grenadines;0;0;56;0
2020-08-08;VC;Saint Vincent and the Grenadines;0;0;56;0
2020-08-09;VC;Saint Vincent and the Grenadines;1;0;57;0
2020-08-10;VC;Saint Vincent and the Grenadines;0;0;57;0
2020-08-11;VC;Saint Vincent and the Grenadines;0;0;57;0
2020-08-12;VC;Saint Vincent and the Grenadines;0;0;57;0
2020-08-13;VC;Saint Vincent and the Grenadines;0;0;57;0
2020-08-14;VC;Saint Vincent and the Grenadines;0;0;57;0
2020-08-15;VC;Saint Vincent and the Grenadines;0;0;57;0
2020-08-16;VC;Saint Vincent and the Grenadines;0;0;57;0
2020-08-17;VC;Saint Vincent and the Grenadines;1;0;58;0
2020-08-18;VC;Saint Vincent and the Grenadines;0;0;58;0
2020-08-19;VC;Saint Vincent and the Grenadines;0;0;58;0
2020-08-20;VC;Saint Vincent and the Grenadines;0;0;58;0
2020-08-21;VC;Saint Vincent and the Grenadines;0;0;58;0
2020-08-22;VC;Saint Vincent and the Grenadines;0;0;58;0
2020-08-23;VC;Saint Vincent and the Grenadines;0;0;58;0
2020-08-24;VC;Saint Vincent and the Grenadines;0;0;58;0
2020-08-25;VC;Saint Vincent and the Grenadines;0;0;58;0
2020-08-26;VC;Saint Vincent and the Grenadines;0;0;58;0
2020-08-27;VC;Saint Vincent and the Grenadines;2;0;60;0
2020-08-28;VC;Saint Vincent and the Grenadines;0;0;60;0
2020-08-29;VC;Saint Vincent and the Grenadines;0;0;60;0
2020-08-30;VC;Saint Vincent and the Grenadines;0;0;60;0
2020-08-31;VC;Saint Vincent and the Grenadines;0;0;60;0
2020-09-01;VC;Saint Vincent and the Grenadines;1;0;61;0
2020-09-02;VC;Saint Vincent and the Grenadines;0;0;61;0
2020-09-03;VC;Saint Vincent and the Grenadines;0;0;61;0
2020-09-04;VC;Saint Vincent and the Grenadines;0;0;61;0
2020-09-05;VC;Saint Vincent and the Grenadines;0;0;61;0
2020-09-06;VC;Saint Vincent and the Grenadines;0;0;61;0
2020-09-07;VC;Saint Vincent and the Grenadines;1;0;62;0
2020-09-08;VC;Saint Vincent and the Grenadines;0;0;62;0
2020-09-09;VC;Saint Vincent and the Grenadines;0;0;62;0
2020-09-10;VC;Saint Vincent and the Grenadines;0;0;62;0
2020-09-11;VC;Saint Vincent and the Grenadines;2;0;64;0
2020-09-12;VC;Saint Vincent and the Grenadines;0;0;64;0
2020-09-13;VC;Saint Vincent and the Grenadines;0;0;64;0
2020-09-14;VC;Saint Vincent and the Grenadines;0;0;64;0
2020-09-15;VC;Saint Vincent and the Grenadines;0;0;64;0
2020-09-16;VC;Saint Vincent and the Grenadines;0;0;64;0
2020-09-17;VC;Saint Vincent and the Grenadines;0;0;64;0
2020-09-18;VC;Saint Vincent and the Grenadines;0;0;64;0
2020-09-19;VC;Saint Vincent and the Grenadines;0;0;64;0
2020-09-20;VC;Saint Vincent and the Grenadines;0;0;64;0
2020-09-21;VC;Saint Vincent and the Grenadines;0;0;64;0
2020-09-22;VC;Saint Vincent and the Grenadines;0;0;64;0
2020-09-23;VC;Saint Vincent and the Grenadines;0;0;64;0
2020-09-24;VC;Saint Vincent and the Grenadines;0;0;64;0
2020-09-25;VC;Saint Vincent and the Grenadines;0;0;64;0
2020-09-26;VC;Saint Vincent and the Grenadines;0;0;64;0
2020-09-27;VC;Saint Vincent and the Grenadines;0;0;64;0
2020-09-28;VC;Saint Vincent and the Grenadines;0;0;64;0
2020-09-29;VC;Saint Vincent and the Grenadines;0;0;64;0
2020-09-30;VC;Saint Vincent and the Grenadines;0;0;64;0
2020-10-01;VC;Saint Vincent and the Grenadines;0;0;64;0
2020-10-02;VC;Saint Vincent and the Grenadines;0;0;64;0
2020-10-03;VC;Saint Vincent and the Grenadines;0;0;64;0
2020-10-04;VC;Saint Vincent and the Grenadines;0;0;64;0
2020-10-05;VC;Saint Vincent and the Grenadines;0;0;64;0
2020-10-06;VC;Saint Vincent and the Grenadines;0;0;64;0
2020-10-07;VC;Saint Vincent and the Grenadines;0;0;64;0
2020-10-08;VC;Saint Vincent and the Grenadines;0;0;64;0
2020-10-09;VC;Saint Vincent and the Grenadines;0;0;64;0
2020-10-10;VC;Saint Vincent and the Grenadines;0;0;64;0
2020-10-11;VC;Saint Vincent and the Grenadines;0;0;64;0
2020-10-12;VC;Saint Vincent and the Grenadines;0;0;64;0
2020-10-13;VC;Saint Vincent and the Grenadines;0;0;64;0
2020-10-14;VC;Saint Vincent and the Grenadines;0;0;64;0
2020-10-15;VC;Saint Vincent and the Grenadines;0;0;64;0
2020-10-16;VC;Saint Vincent and the Grenadines;1;0;65;0
2020-10-17;VC;Saint Vincent and the Grenadines;2;0;67;0
2020-10-18;VC;Saint Vincent and the Grenadines;0;0;67;0
2020-10-19;VC;Saint Vincent and the Grenadines;0;0;67;0
2020-10-20;VC;Saint Vincent and the Grenadines;1;0;68;0
2020-10-21;VC;Saint Vincent and the Grenadines;0;0;68;0
2020-10-22;VC;Saint Vincent and the Grenadines;0;0;68;0
2020-10-23;VC;Saint Vincent and the Grenadines;5;0;73;0
2020-10-24;VC;Saint Vincent and the Grenadines;0;0;73;0
2020-10-25;VC;Saint Vincent and the Grenadines;0;0;73;0
2020-10-26;VC;Saint Vincent and the Grenadines;0;0;73;0
2020-10-27;VC;Saint Vincent and the Grenadines;1;0;74;0
2020-10-28;VC;Saint Vincent and the Grenadines;0;0;74;0
2020-10-29;VC;Saint Vincent and the Grenadines;0;0;74;0
2020-10-30;VC;Saint Vincent and the Grenadines;0;0;74;0
2020-10-31;VC;Saint Vincent and the Grenadines;0;0;74;0
2020-11-01;VC;Saint Vincent and the Grenadines;1;0;75;0
2020-11-02;VC;Saint Vincent and the Grenadines;0;0;75;0
2020-11-03;VC;Saint Vincent and the Grenadines;0;0;75;0
2020-11-04;VC;Saint Vincent and the Grenadines;0;0;75;0
2020-11-05;VC;Saint Vincent and the Grenadines;1;0;76;0
2020-11-06;VC;Saint Vincent and the Grenadines;0;0;76;0
2020-11-07;VC;Saint Vincent and the Grenadines;0;0;76;0
2020-11-08;VC;Saint Vincent and the Grenadines;0;0;76;0
2020-11-09;VC;Saint Vincent and the Grenadines;0;0;76;0
2020-11-10;VC;Saint Vincent and the Grenadines;0;0;76;0
2020-11-11;VC;Saint Vincent and the Grenadines;1;0;77;0
2020-11-12;VC;Saint Vincent and the Grenadines;0;0;77;0
2020-11-13;VC;Saint Vincent and the Grenadines;1;0;78;0
2020-11-14;VC;Saint Vincent and the Grenadines;0;0;78;0
2020-11-15;VC;Saint Vincent and the Grenadines;0;0;78;0
2020-11-16;VC;Saint Vincent and the Grenadines;0;0;78;0
2020-11-17;VC;Saint Vincent and the Grenadines;5;0;83;0
2020-11-18;VC;Saint Vincent and the Grenadines;0;0;83;0
2020-11-19;VC;Saint Vincent and the Grenadines;1;0;84;0
2020-11-20;VC;Saint Vincent and the Grenadines;0;0;84;0
2020-11-21;VC;Saint Vincent and the Grenadines;0;0;84;0
2020-11-22;VC;Saint Vincent and the Grenadines;0;0;84;0
2020-11-23;VC;Saint Vincent and the Grenadines;0;0;84;0
2020-11-24;VC;Saint Vincent and the Grenadines;0;0;84;0
2020-11-25;VC;Saint Vincent and the Grenadines;0;0;84;0
2020-11-26;VC;Saint Vincent and the Grenadines;0;0;84;0
2020-11-27;VC;Saint Vincent and the Grenadines;1;0;85;0
2020-11-28;VC;Saint Vincent and the Grenadines;0;0;85;0
2020-11-29;VC;Saint Vincent and the Grenadines;0;0;85;0
2020-11-30;VC;Saint Vincent and the Grenadines;0;0;85;0
2020-12-01;VC;Saint Vincent and the Grenadines;0;0;85;0
2020-12-02;VC;Saint Vincent and the Grenadines;0;0;85;0
2020-12-03;VC;Saint Vincent and the Grenadines;2;0;87;0
2020-12-04;VC;Saint Vincent and the Grenadines;0;0;87;0
2020-12-05;VC;Saint Vincent and the Grenadines;0;0;87;0
2020-12-06;VC;Saint Vincent and the Grenadines;0;0;87;0
2020-12-07;VC;Saint Vincent and the Grenadines;0;0;87;0
2020-12-08;VC;Saint Vincent and the Grenadines;0;0;87;0
2020-12-09;VC;Saint Vincent and the Grenadines;3;0;90;0
2020-12-10;VC;Saint Vincent and the Grenadines;1;0;91;0
2020-12-11;VC;Saint Vincent and the Grenadines;3;0;94;0
2020-12-12;VC;Saint Vincent and the Grenadines;0;0;94;0
2020-12-13;VC;Saint Vincent and the Grenadines;4;0;98;0
2020-12-14;VC;Saint Vincent and the Grenadines;0;0;98;0
2020-12-15;VC;Saint Vincent and the Grenadines;0;0;98;0
2020-12-16;VC;Saint Vincent and the Grenadines;2;0;100;0
2020-12-17;VC;Saint Vincent and the Grenadines;0;0;100;0
2020-12-18;VC;Saint Vincent and the Grenadines;0;0;100;0
2020-12-19;VC;Saint Vincent and the Grenadines;0;0;100;0
2020-12-20;VC;Saint Vincent and the Grenadines;4;0;104;0
2020-12-21;VC;Saint Vincent and the Grenadines;0;0;104;0
2020-12-22;VC;Saint Vincent and the Grenadines;3;0;107;0
2020-12-23;VC;Saint Vincent and the Grenadines;1;0;108;0
2020-12-24;VC;Saint Vincent and the Grenadines;0;0;108;0
2020-12-25;VC;Saint Vincent and the Grenadines;0;0;108;0
2020-12-26;VC;Saint Vincent and the Grenadines;1;0;109;0
2020-12-27;VC;Saint Vincent and the Grenadines;0;0;109;0
2020-12-28;VC;Saint Vincent and the Grenadines;0;0;109;0
2020-12-29;VC;Saint Vincent and the Grenadines;4;0;113;0
2020-12-30;VC;Saint Vincent and the Grenadines;2;0;115;0
2020-12-31;VC;Saint Vincent and the Grenadines;6;0;121;0
2021-01-01;VC;Saint Vincent and the Grenadines;0;0;121;0
2021-01-02;VC;Saint Vincent and the Grenadines;1;0;122;0
2021-01-03;VC;Saint Vincent and the Grenadines;2;0;124;0
2021-01-04;VC;Saint Vincent and the Grenadines;0;0;124;0
2021-01-05;VC;Saint Vincent and the Grenadines;9;0;133;0
2021-01-06;VC;Saint Vincent and the Grenadines;16;0;149;0
2021-01-07;VC;Saint Vincent and the Grenadines;0;0;149;0
2021-01-08;VC;Saint Vincent and the Grenadines;0;0;149;0
2021-01-09;VC;Saint Vincent and the Grenadines;76;0;225;0
2021-01-10;VC;Saint Vincent and the Grenadines;24;0;249;0
2021-01-11;VC;Saint Vincent and the Grenadines;0;0;249;0
2021-01-12;VC;Saint Vincent and the Grenadines;35;0;284;0
2021-01-13;VC;Saint Vincent and the Grenadines;0;0;284;0
2021-01-14;VC;Saint Vincent and the Grenadines;56;0;340;0
2021-01-15;VC;Saint Vincent and the Grenadines;110;1;450;1
2021-01-16;VC;Saint Vincent and the Grenadines;0;0;450;1
2021-01-17;VC;Saint Vincent and the Grenadines;28;0;478;1
2021-01-18;VC;Saint Vincent and the Grenadines;16;0;494;1
2021-01-19;VC;Saint Vincent and the Grenadines;108;1;602;2
2021-01-20;VC;Saint Vincent and the Grenadines;0;0;602;2
2021-01-21;VC;Saint Vincent and the Grenadines;88;0;690;2
2021-01-22;VC;Saint Vincent and the Grenadines;0;0;690;2
2021-01-23;VC;Saint Vincent and the Grenadines;30;0;720;2
2021-01-24;VC;Saint Vincent and the Grenadines;18;0;738;2
2021-01-25;VC;Saint Vincent and the Grenadines;8;0;746;2
2021-01-26;VC;Saint Vincent and the Grenadines;0;0;746;2
2021-01-27;VC;Saint Vincent and the Grenadines;81;0;827;2
2021-01-28;VC;Saint Vincent and the Grenadines;0;0;827;2
2021-01-29;VC;Saint Vincent and the Grenadines;69;0;896;2
2021-01-30;VC;Saint Vincent and the Grenadines;0;0;896;2
2021-01-31;VC;Saint Vincent and the Grenadines;5;0;901;2
2021-02-01;VC;Saint Vincent and the Grenadines;0;0;901;2
2021-02-02;VC;Saint Vincent and the Grenadines;158;0;1059;2
2021-02-03;VC;Saint Vincent and the Grenadines;0;0;1059;2
2021-02-04;VC;Saint Vincent and the Grenadines;8;1;1067;3
2021-02-05;VC;Saint Vincent and the Grenadines;103;0;1170;3
2021-02-06;VC;Saint Vincent and the Grenadines;32;0;1202;3
2021-02-07;VC;Saint Vincent and the Grenadines;67;1;1269;4
2021-02-08;VC;Saint Vincent and the Grenadines;14;0;1283;4
2021-02-09;VC;Saint Vincent and the Grenadines;0;0;1283;4
2021-02-10;VC;Saint Vincent and the Grenadines;57;2;1340;6
2021-02-11;VC;Saint Vincent and the Grenadines;30;0;1370;6
2021-02-12;VC;Saint Vincent and the Grenadines;0;0;1370;6
2021-02-13;VC;Saint Vincent and the Grenadines;48;0;1418;6
2021-02-14;VC;Saint Vincent and the Grenadines;0;0;1418;6
2021-02-15;VC;Saint Vincent and the Grenadines;35;0;1453;6
2021-02-16;VC;Saint Vincent and the Grenadines;4;0;1457;6
2021-02-17;VC;Saint Vincent and the Grenadines;5;0;1462;6
2021-02-18;VC;Saint Vincent and the Grenadines;0;0;1462;6
2021-02-19;VC;Saint Vincent and the Grenadines;32;0;1494;6
2021-02-20;VC;Saint Vincent and the Grenadines;4;0;1498;6
2021-02-21;VC;Saint Vincent and the Grenadines;5;0;1503;6
2021-02-22;VC;Saint Vincent and the Grenadines;0;0;1503;6
2021-02-23;VC;Saint Vincent and the Grenadines;8;0;1511;6
2021-02-24;VC;Saint Vincent and the Grenadines;8;0;1519;6
2021-02-25;VC;Saint Vincent and the Grenadines;0;0;1519;6
2021-02-26;VC;Saint Vincent and the Grenadines;0;0;1519;6
2021-02-27;VC;Saint Vincent and the Grenadines;37;2;1556;8
2021-02-28;VC;Saint Vincent and the Grenadines;0;0;1556;8
2021-03-01;VC;Saint Vincent and the Grenadines;72;0;1628;8
2021-03-02;VC;Saint Vincent and the Grenadines;0;0;1628;8
2021-03-03;VC;Saint Vincent and the Grenadines;17;0;1645;8
2021-03-04;VC;Saint Vincent and the Grenadines;0;0;1645;8
2021-03-05;VC;Saint Vincent and the Grenadines;0;0;1645;8
2021-03-06;VC;Saint Vincent and the Grenadines;0;0;1645;8
2021-03-07;VC;Saint Vincent and the Grenadines;18;0;1663;8
2021-03-08;VC;Saint Vincent and the Grenadines;0;0;1663;8
2021-03-09;VC;Saint Vincent and the Grenadines;0;0;1663;8
2021-03-10;VC;Saint Vincent and the Grenadines;7;0;1670;8
2021-03-11;VC;Saint Vincent and the Grenadines;4;0;1674;8
2021-03-12;VC;Saint Vincent and the Grenadines;0;0;1674;8
2021-03-13;VC;Saint Vincent and the Grenadines;6;0;1680;8
2021-03-14;VC;Saint Vincent and the Grenadines;0;1;1680;9
2021-03-15;VC;Saint Vincent and the Grenadines;0;0;1680;9
2021-03-16;VC;Saint Vincent and the Grenadines;1;0;1681;9
2021-03-17;VC;Saint Vincent and the Grenadines;0;0;1681;9
2021-03-18;VC;Saint Vincent and the Grenadines;3;0;1684;9
2021-03-19;VC;Saint Vincent and the Grenadines;8;0;1692;9
2021-03-20;VC;Saint Vincent and the Grenadines;4;0;1696;9
2021-03-21;VC;Saint Vincent and the Grenadines;0;0;1696;9
2021-03-22;VC;Saint Vincent and the Grenadines;0;0;1696;9
2021-03-23;VC;Saint Vincent and the Grenadines;0;0;1696;9
2021-03-24;VC;Saint Vincent and the Grenadines;7;1;1703;10
2021-03-25;VC;Saint Vincent and the Grenadines;12;0;1715;10
2021-03-26;VC;Saint Vincent and the Grenadines;6;0;1721;10
2021-03-27;VC;Saint Vincent and the Grenadines;2;0;1723;10
2021-03-28;VC;Saint Vincent and the Grenadines;15;0;1738;10
2021-03-29;VC;Saint Vincent and the Grenadines;1;0;1739;10
2021-03-30;VC;Saint Vincent and the Grenadines;0;0;1739;10
2021-03-31;VC;Saint Vincent and the Grenadines;9;0;1748;10
2021-04-01;VC;Saint Vincent and the Grenadines;2;0;1750;10
2021-04-02;VC;Saint Vincent and the Grenadines;4;0;1754;10
2021-04-03;VC;Saint Vincent and the Grenadines;1;0;1755;10
2021-04-04;VC;Saint Vincent and the Grenadines;3;0;1758;10
2021-04-05;VC;Saint Vincent and the Grenadines;6;0;1764;10
2021-04-06;VC;Saint Vincent and the Grenadines;1;0;1765;10
2021-04-07;VC;Saint Vincent and the Grenadines;1;0;1766;10
2021-04-08;VC;Saint Vincent and the Grenadines;8;0;1774;10
2021-04-09;VC;Saint Vincent and the Grenadines;15;0;1789;10
2021-04-10;VC;Saint Vincent and the Grenadines;1;0;1790;10
2021-04-11;VC;Saint Vincent and the Grenadines;2;0;1792;10
2021-04-12;VC;Saint Vincent and the Grenadines;14;0;1806;10
2021-04-13;VC;Saint Vincent and the Grenadines;0;0;1806;10
2021-04-14;VC;Saint Vincent and the Grenadines;6;0;1812;10
2021-04-15;VC;Saint Vincent and the Grenadines;6;0;1818;10
2021-04-16;VC;Saint Vincent and the Grenadines;1;0;1819;10
2021-04-17;VC;Saint Vincent and the Grenadines;0;0;1819;10
2021-04-18;VC;Saint Vincent and the Grenadines;0;0;1819;10
2021-04-19;VC;Saint Vincent and the Grenadines;0;0;1819;10
2021-04-20;VC;Saint Vincent and the Grenadines;0;0;1819;10
2021-04-21;VC;Saint Vincent and the Grenadines;8;0;1827;10
2021-04-22;VC;Saint Vincent and the Grenadines;0;0;1827;10
2021-04-23;VC;Saint Vincent and the Grenadines;0;0;1827;10
2021-04-24;VC;Saint Vincent and the Grenadines;3;0;1830;10
2021-04-25;VC;Saint Vincent and the Grenadines;0;0;1830;10
2021-04-26;VC;Saint Vincent and the Grenadines;9;0;1839;10
2021-04-27;VC;Saint Vincent and the Grenadines;5;1;1844;11
2021-04-28;VC;Saint Vincent and the Grenadines;6;0;1850;11
2021-04-29;VC;Saint Vincent and the Grenadines;5;0;1855;11
2021-04-30;VC;Saint Vincent and the Grenadines;9;0;1864;11
2021-05-01;VC;Saint Vincent and the Grenadines;0;0;1864;11
2021-05-02;VC;Saint Vincent and the Grenadines;18;0;1882;11
2021-05-03;VC;Saint Vincent and the Grenadines;0;0;1882;11
2021-05-04;VC;Saint Vincent and the Grenadines;0;0;1882;11
2021-05-05;VC;Saint Vincent and the Grenadines;0;0;1882;11
2021-05-06;VC;Saint Vincent and the Grenadines;7;1;1889;12
2021-05-07;VC;Saint Vincent and the Grenadines;6;0;1895;12
2021-05-08;VC;Saint Vincent and the Grenadines;17;0;1912;12
2021-05-09;VC;Saint Vincent and the Grenadines;0;0;1912;12
2021-05-10;VC;Saint Vincent and the Grenadines;10;0;1922;12
2021-05-11;VC;Saint Vincent and the Grenadines;0;0;1922;12
2021-05-12;VC;Saint Vincent and the Grenadines;4;0;1926;12
2021-05-13;VC;Saint Vincent and the Grenadines;2;0;1928;12
2021-05-14;VC;Saint Vincent and the Grenadines;4;0;1932;12
2021-05-15;VC;Saint Vincent and the Grenadines;0;0;1932;12
2021-05-16;VC;Saint Vincent and the Grenadines;5;0;1937;12
2021-05-17;VC;Saint Vincent and the Grenadines;0;0;1937;12
2021-05-18;VC;Saint Vincent and the Grenadines;3;0;1940;12
2021-05-19;VC;Saint Vincent and the Grenadines;9;0;1949;12
2021-05-20;VC;Saint Vincent and the Grenadines;5;0;1954;12
2021-05-21;VC;Saint Vincent and the Grenadines;8;0;1962;12
2021-05-22;VC;Saint Vincent and the Grenadines;11;0;1973;12
2021-05-23;VC;Saint Vincent and the Grenadines;0;0;1973;12
2021-05-24;VC;Saint Vincent and the Grenadines;5;0;1978;12
2021-05-25;VC;Saint Vincent and the Grenadines;11;0;1989;12
2021-05-26;VC;Saint Vincent and the Grenadines;17;0;2006;12
2021-05-27;VC;Saint Vincent and the Grenadines;0;0;2006;12
2021-05-28;VC;Saint Vincent and the Grenadines;8;0;2014;12
2021-05-29;VC;Saint Vincent and the Grenadines;13;0;2027;12
2021-05-30;VC;Saint Vincent and the Grenadines;0;0;2027;12
2021-05-31;VC;Saint Vincent and the Grenadines;8;0;2035;12
2021-06-01;VC;Saint Vincent and the Grenadines;9;0;2044;12
2021-06-02;VC;Saint Vincent and the Grenadines;0;0;2044;12
2021-06-03;VC;Saint Vincent and the Grenadines;0;0;2044;12
2021-06-04;VC;Saint Vincent and the Grenadines;21;0;2065;12
2021-06-05;VC;Saint Vincent and the Grenadines;3;0;2068;12
2021-06-06;VC;Saint Vincent and the Grenadines;8;0;2076;12
2021-06-07;VC;Saint Vincent and the Grenadines;0;0;2076;12
2021-06-08;VC;Saint Vincent and the Grenadines;16;0;2092;12
2021-06-09;VC;Saint Vincent and the Grenadines;0;0;2092;12
2021-06-10;VC;Saint Vincent and the Grenadines;40;0;2132;12
2021-06-11;VC;Saint Vincent and the Grenadines;0;0;2132;12
2021-06-12;VC;Saint Vincent and the Grenadines;15;0;2147;12
2021-06-13;VC;Saint Vincent and the Grenadines;9;0;2156;12
2021-06-14;VC;Saint Vincent and the Grenadines;0;0;2156;12
2021-06-15;VC;Saint Vincent and the Grenadines;2;0;2158;12
2021-06-16;VC;Saint Vincent and the Grenadines;14;0;2172;12
2021-06-17;VC;Saint Vincent and the Grenadines;6;0;2178;12
2021-06-18;VC;Saint Vincent and the Grenadines;5;0;2183;12
2021-06-19;VC;Saint Vincent and the Grenadines;9;0;2192;12
2021-06-20;VC;Saint Vincent and the Grenadines;3;0;2195;12
2021-06-21;VC;Saint Vincent and the Grenadines;1;0;2196;12
2021-06-22;VC;Saint Vincent and the Grenadines;11;0;2207;12
2021-06-23;VC;Saint Vincent and the Grenadines;0;0;2207;12
2021-06-24;VC;Saint Vincent and the Grenadines;9;0;2216;12
2021-06-25;VC;Saint Vincent and the Grenadines;0;0;2216;12
2021-06-26;VC;Saint Vincent and the Grenadines;2;0;2218;12
2021-06-27;VC;Saint Vincent and the Grenadines;1;0;2219;12
2021-06-28;VC;Saint Vincent and the Grenadines;0;0;2219;12
2021-06-29;VC;Saint Vincent and the Grenadines;6;0;2225;12
2021-06-30;VC;Saint Vincent and the Grenadines;0;0;2225;12
2021-07-01;VC;Saint Vincent and the Grenadines;2;0;2227;12
2020-11-18;WS;Samoa;1;0;1;0
2020-11-19;WS;Samoa;0;0;1;0
2020-11-20;WS;Samoa;0;0;1;0
2020-11-21;WS;Samoa;0;0;1;0
2020-11-22;WS;Samoa;0;0;1;0
2020-11-23;WS;Samoa;0;0;1;0
2020-11-24;WS;Samoa;0;0;1;0
2020-11-25;WS;Samoa;0;0;1;0
2020-11-26;WS;Samoa;0;0;1;0
2020-11-27;WS;Samoa;1;0;2;0
2020-11-28;WS;Samoa;0;0;2;0
2020-11-29;WS;Samoa;0;0;2;0
2020-11-30;WS;Samoa;0;0;2;0
2020-12-01;WS;Samoa;0;0;2;0
2020-12-02;WS;Samoa;0;0;2;0
2020-12-03;WS;Samoa;0;0;2;0
2020-12-04;WS;Samoa;0;0;2;0
2020-12-05;WS;Samoa;0;0;2;0
2020-12-06;WS;Samoa;0;0;2;0
2020-12-07;WS;Samoa;0;0;2;0
2020-12-08;WS;Samoa;0;0;2;0
2020-12-09;WS;Samoa;0;0;2;0
2020-12-10;WS;Samoa;0;0;2;0
2020-12-11;WS;Samoa;0;0;2;0
2020-12-12;WS;Samoa;0;0;2;0
2020-12-13;WS;Samoa;0;0;2;0
2020-12-14;WS;Samoa;0;0;2;0
2020-12-15;WS;Samoa;0;0;2;0
2020-12-16;WS;Samoa;0;0;2;0
2020-12-17;WS;Samoa;0;0;2;0
2020-12-18;WS;Samoa;0;0;2;0
2020-12-19;WS;Samoa;0;0;2;0
2020-12-20;WS;Samoa;0;0;2;0
2020-12-21;WS;Samoa;0;0;2;0
2020-12-22;WS;Samoa;0;0;2;0
2020-12-23;WS;Samoa;0;0;2;0
2020-12-24;WS;Samoa;0;0;2;0
2020-12-25;WS;Samoa;0;0;2;0
2020-12-26;WS;Samoa;0;0;2;0
2020-12-27;WS;Samoa;0;0;2;0
2020-12-28;WS;Samoa;0;0;2;0
2020-12-29;WS;Samoa;0;0;2;0
2020-12-30;WS;Samoa;0;0;2;0
2020-12-31;WS;Samoa;0;0;2;0
2021-01-01;WS;Samoa;0;0;2;0
2021-01-02;WS;Samoa;0;0;2;0
2021-01-03;WS;Samoa;0;0;2;0
2021-01-04;WS;Samoa;0;0;2;0
2021-01-05;WS;Samoa;0;0;2;0
2021-01-06;WS;Samoa;0;0;2;0
2021-01-07;WS;Samoa;0;0;2;0
2021-01-08;WS;Samoa;0;0;2;0
2021-01-09;WS;Samoa;0;0;2;0
2021-01-10;WS;Samoa;0;0;2;0
2021-01-11;WS;Samoa;0;0;2;0
2021-01-12;WS;Samoa;0;0;2;0
2021-01-13;WS;Samoa;0;0;2;0
2021-01-14;WS;Samoa;0;0;2;0
2021-01-15;WS;Samoa;0;0;2;0
2021-01-16;WS;Samoa;0;0;2;0
2021-01-17;WS;Samoa;0;0;2;0
2021-01-18;WS;Samoa;0;0;2;0
2021-01-19;WS;Samoa;0;0;2;0
2021-01-20;WS;Samoa;0;0;2;0
2021-01-21;WS;Samoa;0;0;2;0
2021-01-22;WS;Samoa;0;0;2;0
2021-01-23;WS;Samoa;0;0;2;0
2021-01-24;WS;Samoa;0;0;2;0
2021-01-25;WS;Samoa;0;0;2;0
2021-01-26;WS;Samoa;0;0;2;0
2021-01-27;WS;Samoa;0;0;2;0
2021-01-28;WS;Samoa;0;0;2;0
2021-01-29;WS;Samoa;0;0;2;0
2021-01-30;WS;Samoa;0;0;2;0
2021-01-31;WS;Samoa;0;0;2;0
2021-02-01;WS;Samoa;0;0;2;0
2021-02-02;WS;Samoa;0;0;2;0
2021-02-03;WS;Samoa;0;0;2;0
2021-02-04;WS;Samoa;0;0;2;0
2021-02-05;WS;Samoa;0;0;2;0
2021-02-06;WS;Samoa;0;0;2;0
2021-02-07;WS;Samoa;0;0;2;0
2021-02-08;WS;Samoa;0;0;2;0
2021-02-09;WS;Samoa;0;0;2;0
2021-02-10;WS;Samoa;0;0;2;0
2021-02-11;WS;Samoa;0;0;2;0
2021-02-12;WS;Samoa;0;0;2;0
2021-02-13;WS;Samoa;0;0;2;0
2021-02-14;WS;Samoa;0;0;2;0
2021-02-15;WS;Samoa;1;0;3;0
2021-02-16;WS;Samoa;0;0;3;0
2021-02-17;WS;Samoa;0;0;3;0
2021-02-18;WS;Samoa;0;0;3;0
2021-02-19;WS;Samoa;0;0;3;0
2021-02-20;WS;Samoa;0;0;3;0
2021-02-21;WS;Samoa;0;0;3;0
2021-02-22;WS;Samoa;0;0;3;0
2021-02-23;WS;Samoa;0;0;3;0
2021-02-24;WS;Samoa;0;0;3;0
2021-02-25;WS;Samoa;0;0;3;0
2021-02-26;WS;Samoa;0;0;3;0
2021-02-27;WS;Samoa;0;0;3;0
2021-02-28;WS;Samoa;0;0;3;0
2021-03-01;WS;Samoa;0;0;3;0
2021-03-02;WS;Samoa;0;0;3;0
2021-03-03;WS;Samoa;0;0;3;0
2021-03-04;WS;Samoa;0;0;3;0
2021-03-05;WS;Samoa;0;0;3;0
2021-03-06;WS;Samoa;0;0;3;0
2021-03-07;WS;Samoa;0;0;3;0
2021-03-08;WS;Samoa;0;0;3;0
2021-03-09;WS;Samoa;0;0;3;0
2021-03-10;WS;Samoa;0;0;3;0
2021-03-11;WS;Samoa;0;0;3;0
2021-03-12;WS;Samoa;0;0;3;0
2021-03-13;WS;Samoa;0;0;3;0
2021-03-14;WS;Samoa;0;0;3;0
2021-03-15;WS;Samoa;0;0;3;0
2021-03-16;WS;Samoa;0;0;3;0
2021-03-17;WS;Samoa;0;0;3;0
2021-03-18;WS;Samoa;0;0;3;0
2021-03-19;WS;Samoa;0;0;3;0
2021-03-20;WS;Samoa;0;0;3;0
2021-03-21;WS;Samoa;0;0;3;0
2021-03-22;WS;Samoa;0;0;3;0
2021-03-23;WS;Samoa;0;0;3;0
2021-03-24;WS;Samoa;0;0;3;0
2021-03-25;WS;Samoa;0;0;3;0
2021-03-26;WS;Samoa;0;0;3;0
2021-03-27;WS;Samoa;0;0;3;0
2021-03-28;WS;Samoa;0;0;3;0
2021-03-29;WS;Samoa;0;0;3;0
2021-03-30;WS;Samoa;0;0;3;0
2021-03-31;WS;Samoa;0;0;3;0
2021-04-01;WS;Samoa;0;0;3;0
2021-04-02;WS;Samoa;0;0;3;0
2021-04-03;WS;Samoa;0;0;3;0
2021-04-04;WS;Samoa;0;0;3;0
2021-04-05;WS;Samoa;0;0;3;0
2021-04-06;WS;Samoa;0;0;3;0
2021-04-07;WS;Samoa;0;0;3;0
2021-04-08;WS;Samoa;0;0;3;0
2021-04-09;WS;Samoa;0;0;3;0
2021-04-10;WS;Samoa;0;0;3;0
2021-04-11;WS;Samoa;0;0;3;0
2021-04-12;WS;Samoa;0;0;3;0
2021-04-13;WS;Samoa;0;0;3;0
2021-04-14;WS;Samoa;0;0;3;0
2021-04-15;WS;Samoa;0;0;3;0
2021-04-16;WS;Samoa;0;0;3;0
2021-04-17;WS;Samoa;0;0;3;0
2021-04-18;WS;Samoa;0;0;3;0
2021-04-19;WS;Samoa;0;0;3;0
2021-04-20;WS;Samoa;0;0;3;0
2021-04-21;WS;Samoa;0;0;3;0
2021-04-22;WS;Samoa;0;0;3;0
2021-04-23;WS;Samoa;0;0;3;0
2021-04-24;WS;Samoa;0;0;3;0
2021-04-25;WS;Samoa;0;0;3;0
2021-04-26;WS;Samoa;0;0;3;0
2021-04-27;WS;Samoa;0;0;3;0
2021-04-28;WS;Samoa;0;0;3;0
2021-04-29;WS;Samoa;0;0;3;0
2021-04-30;WS;Samoa;0;0;3;0
2021-05-01;WS;Samoa;0;0;3;0
2021-05-02;WS;Samoa;0;0;3;0
2021-05-03;WS;Samoa;0;0;3;0
2021-05-04;WS;Samoa;0;0;3;0
2021-05-05;WS;Samoa;0;0;3;0
2021-05-06;WS;Samoa;0;0;3;0
2021-05-07;WS;Samoa;0;0;3;0
2021-05-08;WS;Samoa;0;0;3;0
2021-05-09;WS;Samoa;0;0;3;0
2021-05-10;WS;Samoa;0;0;3;0
2021-05-11;WS;Samoa;0;0;3;0
2021-05-12;WS;Samoa;0;0;3;0
2021-05-13;WS;Samoa;0;0;3;0
2021-05-14;WS;Samoa;0;0;3;0
2021-05-15;WS;Samoa;0;0;3;0
2021-05-16;WS;Samoa;0;0;3;0
2021-05-17;WS;Samoa;0;0;3;0
2021-05-18;WS;Samoa;0;0;3;0
2021-05-19;WS;Samoa;0;0;3;0
2021-05-20;WS;Samoa;0;0;3;0
2021-05-21;WS;Samoa;0;0;3;0
2021-05-22;WS;Samoa;0;0;3;0
2021-05-23;WS;Samoa;0;0;3;0
2021-05-24;WS;Samoa;0;0;3;0
2021-05-25;WS;Samoa;0;0;3;0
2021-05-26;WS;Samoa;0;0;3;0
2021-05-27;WS;Samoa;0;0;3;0
2021-05-28;WS;Samoa;0;0;3;0
2021-05-29;WS;Samoa;0;0;3;0
2021-05-30;WS;Samoa;0;0;3;0
2021-05-31;WS;Samoa;0;0;3;0
2021-06-01;WS;Samoa;0;0;3;0
2021-06-02;WS;Samoa;0;0;3;0
2021-06-03;WS;Samoa;0;0;3;0
2021-06-04;WS;Samoa;0;0;3;0
2021-06-05;WS;Samoa;0;0;3;0
2021-06-06;WS;Samoa;0;0;3;0
2021-06-07;WS;Samoa;0;0;3;0
2021-06-08;WS;Samoa;0;0;3;0
2021-06-09;WS;Samoa;0;0;3;0
2021-06-10;WS;Samoa;0;0;3;0
2021-06-11;WS;Samoa;0;0;3;0
2021-06-12;WS;Samoa;0;0;3;0
2021-06-13;WS;Samoa;0;0;3;0
2021-06-14;WS;Samoa;0;0;3;0
2021-06-15;WS;Samoa;0;0;3;0
2021-06-16;WS;Samoa;0;0;3;0
2021-06-17;WS;Samoa;0;0;3;0
2021-06-18;WS;Samoa;0;0;3;0
2021-06-19;WS;Samoa;0;0;3;0
2021-06-20;WS;Samoa;0;0;3;0
2021-06-21;WS;Samoa;0;0;3;0
2021-06-22;WS;Samoa;0;0;3;0
2021-06-23;WS;Samoa;0;0;3;0
2021-06-24;WS;Samoa;0;0;3;0
2021-06-25;WS;Samoa;0;0;3;0
2021-06-26;WS;Samoa;0;0;3;0
2021-06-27;WS;Samoa;0;0;3;0
2021-06-28;WS;Samoa;0;0;3;0
2021-06-29;WS;Samoa;0;0;3;0
2021-06-30;WS;Samoa;0;0;3;0
2021-07-01;WS;Samoa;0;0;3;0
2020-02-27;SM;San Marino;1;0;1;0
2020-02-28;SM;San Marino;0;0;1;0
2020-02-29;SM;San Marino;0;0;1;0
2020-03-01;SM;San Marino;0;0;1;0
2020-03-02;SM;San Marino;7;0;8;0
2020-03-03;SM;San Marino;2;1;10;1
2020-03-04;SM;San Marino;6;0;16;1
2020-03-05;SM;San Marino;5;0;21;1
2020-03-06;SM;San Marino;0;0;21;1
2020-03-07;SM;San Marino;2;0;23;1
2020-03-08;SM;San Marino;13;0;36;1
2020-03-09;SM;San Marino;0;0;36;1
2020-03-10;SM;San Marino;15;1;51;2
2020-03-11;SM;San Marino;11;0;62;2
2020-03-12;SM;San Marino;7;1;69;3
2020-03-13;SM;San Marino;11;2;80;5
2020-03-14;SM;San Marino;0;0;80;5
2020-03-15;SM;San Marino;21;0;101;5
2020-03-16;SM;San Marino;8;2;109;7
2020-03-17;SM;San Marino;0;0;109;7
2020-03-18;SM;San Marino;10;4;119;11
2020-03-19;SM;San Marino;0;0;119;11
2020-03-20;SM;San Marino;25;3;144;14
2020-03-21;SM;San Marino;0;6;144;20
2020-03-22;SM;San Marino;31;0;175;20
2020-03-23;SM;San Marino;12;0;187;20
2020-03-24;SM;San Marino;0;1;187;21
2020-03-25;SM;San Marino;21;0;208;21
2020-03-26;SM;San Marino;0;0;208;21
2020-03-27;SM;San Marino;15;0;223;21
2020-03-28;SM;San Marino;1;1;224;22
2020-03-29;SM;San Marino;0;0;224;22
2020-03-30;SM;San Marino;6;3;230;25
2020-03-31;SM;San Marino;6;1;236;26
2020-04-01;SM;San Marino;0;0;236;26
2020-04-02;SM;San Marino;9;4;245;30
2020-04-03;SM;San Marino;0;0;245;30
2020-04-04;SM;San Marino;14;2;259;32
2020-04-05;SM;San Marino;7;0;266;32
2020-04-06;SM;San Marino;0;0;266;32
2020-04-07;SM;San Marino;13;2;279;34
2020-04-08;SM;San Marino;0;0;279;34
2020-04-09;SM;San Marino;54;0;333;34
2020-04-10;SM;San Marino;11;0;344;34
2020-04-11;SM;San Marino;12;1;356;35
2020-04-12;SM;San Marino;0;0;356;35
2020-04-13;SM;San Marino;0;0;356;35
2020-04-14;SM;San Marino;15;1;371;36
2020-04-15;SM;San Marino;1;0;372;36
2020-04-16;SM;San Marino;54;2;426;38
2020-04-17;SM;San Marino;9;1;435;39
2020-04-18;SM;San Marino;20;0;455;39
2020-04-19;SM;San Marino;6;0;461;39
2020-04-20;SM;San Marino;1;0;462;39
2020-04-21;SM;San Marino;14;1;476;40
2020-04-22;SM;San Marino;12;0;488;40
2020-04-23;SM;San Marino;13;0;501;40
2020-04-24;SM;San Marino;12;0;513;40
2020-04-25;SM;San Marino;0;0;513;40
2020-04-26;SM;San Marino;25;1;538;41
2020-04-27;SM;San Marino;0;0;538;41
2020-04-28;SM;San Marino;15;0;553;41
2020-04-29;SM;San Marino;10;0;563;41
2020-04-30;SM;San Marino;6;0;569;41
2020-05-01;SM;San Marino;11;0;580;41
2020-05-02;SM;San Marino;0;0;580;41
2020-05-03;SM;San Marino;2;0;582;41
2020-05-04;SM;San Marino;0;0;582;41
2020-05-05;SM;San Marino;7;0;589;41
2020-05-06;SM;San Marino;19;0;608;41
2020-05-07;SM;San Marino;14;0;622;41
2020-05-08;SM;San Marino;1;0;623;41
2020-05-09;SM;San Marino;14;0;637;41
2020-05-10;SM;San Marino;-9;0;628;41
2020-05-11;SM;San Marino;0;0;628;41
2020-05-12;SM;San Marino;10;0;638;41
2020-05-13;SM;San Marino;5;0;643;41
2020-05-14;SM;San Marino;5;0;648;41
2020-05-15;SM;San Marino;4;0;652;41
2020-05-16;SM;San Marino;1;0;653;41
2020-05-17;SM;San Marino;1;0;654;41
2020-05-18;SM;San Marino;0;0;654;41
2020-05-19;SM;San Marino;1;0;655;41
2020-05-20;SM;San Marino;1;0;656;41
2020-05-21;SM;San Marino;2;0;658;41
2020-05-22;SM;San Marino;3;0;661;41
2020-05-23;SM;San Marino;4;1;665;42
2020-05-24;SM;San Marino;0;0;665;42
2020-05-25;SM;San Marino;1;0;666;42
2020-05-26;SM;San Marino;0;0;666;42
2020-05-27;SM;San Marino;1;0;667;42
2020-05-28;SM;San Marino;3;0;670;42
2020-05-29;SM;San Marino;1;0;671;42
2020-05-30;SM;San Marino;0;0;671;42
2020-05-31;SM;San Marino;0;0;671;42
2020-06-01;SM;San Marino;0;0;671;42
2020-06-02;SM;San Marino;1;0;672;42
2020-06-03;SM;San Marino;2;0;674;42
2020-06-04;SM;San Marino;4;0;678;42
2020-06-05;SM;San Marino;2;0;680;42
2020-06-06;SM;San Marino;0;0;680;42
2020-06-07;SM;San Marino;0;0;680;42
2020-06-08;SM;San Marino;7;0;687;42
2020-06-09;SM;San Marino;1;0;688;42
2020-06-10;SM;San Marino;3;0;691;42
2020-06-11;SM;San Marino;0;0;691;42
2020-06-12;SM;San Marino;3;0;694;42
2020-06-13;SM;San Marino;0;0;694;42
2020-06-14;SM;San Marino;0;0;694;42
2020-06-15;SM;San Marino;0;0;694;42
2020-06-16;SM;San Marino;0;0;694;42
2020-06-17;SM;San Marino;2;0;696;42
2020-06-18;SM;San Marino;0;0;696;42
2020-06-19;SM;San Marino;0;0;696;42
2020-06-20;SM;San Marino;0;0;696;42
2020-06-21;SM;San Marino;0;0;696;42
2020-06-22;SM;San Marino;1;0;697;42
2020-06-23;SM;San Marino;1;0;698;42
2020-06-24;SM;San Marino;0;0;698;42
2020-06-25;SM;San Marino;0;0;698;42
2020-06-26;SM;San Marino;0;0;698;42
2020-06-27;SM;San Marino;0;0;698;42
2020-06-28;SM;San Marino;0;0;698;42
2020-06-29;SM;San Marino;0;0;698;42
2020-06-30;SM;San Marino;0;0;698;42
2020-07-01;SM;San Marino;0;0;698;42
2020-07-02;SM;San Marino;0;0;698;42
2020-07-03;SM;San Marino;0;0;698;42
2020-07-04;SM;San Marino;0;0;698;42
2020-07-05;SM;San Marino;0;0;698;42
2020-07-06;SM;San Marino;0;0;698;42
2020-07-07;SM;San Marino;0;0;698;42
2020-07-08;SM;San Marino;0;0;698;42
2020-07-09;SM;San Marino;1;0;699;42
2020-07-10;SM;San Marino;0;0;699;42
2020-07-11;SM;San Marino;0;0;699;42
2020-07-12;SM;San Marino;0;0;699;42
2020-07-13;SM;San Marino;0;0;699;42
2020-07-14;SM;San Marino;0;0;699;42
2020-07-15;SM;San Marino;0;0;699;42
2020-07-16;SM;San Marino;0;0;699;42
2020-07-17;SM;San Marino;0;0;699;42
2020-07-18;SM;San Marino;0;0;699;42
2020-07-19;SM;San Marino;0;0;699;42
2020-07-20;SM;San Marino;0;0;699;42
2020-07-21;SM;San Marino;0;0;699;42
2020-07-22;SM;San Marino;0;0;699;42
2020-07-23;SM;San Marino;0;0;699;42
2020-07-24;SM;San Marino;0;0;699;42
2020-07-25;SM;San Marino;0;0;699;42
2020-07-26;SM;San Marino;0;0;699;42
2020-07-27;SM;San Marino;0;0;699;42
2020-07-28;SM;San Marino;0;0;699;42
2020-07-29;SM;San Marino;0;0;699;42
2020-07-30;SM;San Marino;0;0;699;42
2020-07-31;SM;San Marino;0;0;699;42
2020-08-01;SM;San Marino;0;0;699;42
2020-08-02;SM;San Marino;0;0;699;42
2020-08-03;SM;San Marino;0;0;699;42
2020-08-04;SM;San Marino;0;0;699;42
2020-08-05;SM;San Marino;0;0;699;42
2020-08-06;SM;San Marino;0;0;699;42
2020-08-07;SM;San Marino;0;0;699;42
2020-08-08;SM;San Marino;0;0;699;42
2020-08-09;SM;San Marino;0;0;699;42
2020-08-10;SM;San Marino;0;0;699;42
2020-08-11;SM;San Marino;0;0;699;42
2020-08-12;SM;San Marino;0;0;699;42
2020-08-13;SM;San Marino;0;0;699;42
2020-08-14;SM;San Marino;0;0;699;42
2020-08-15;SM;San Marino;0;0;699;42
2020-08-16;SM;San Marino;0;0;699;42
2020-08-17;SM;San Marino;0;0;699;42
2020-08-18;SM;San Marino;3;0;702;42
2020-08-19;SM;San Marino;2;0;704;42
2020-08-20;SM;San Marino;0;0;704;42
2020-08-21;SM;San Marino;0;0;704;42
2020-08-22;SM;San Marino;0;0;704;42
2020-08-23;SM;San Marino;0;0;704;42
2020-08-24;SM;San Marino;0;0;704;42
2020-08-25;SM;San Marino;6;0;710;42
2020-08-26;SM;San Marino;0;0;710;42
2020-08-27;SM;San Marino;0;0;710;42
2020-08-28;SM;San Marino;0;0;710;42
2020-08-29;SM;San Marino;0;0;710;42
2020-08-30;SM;San Marino;0;0;710;42
2020-08-31;SM;San Marino;5;0;715;42
2020-09-01;SM;San Marino;0;0;715;42
2020-09-02;SM;San Marino;20;0;735;42
2020-09-03;SM;San Marino;0;0;735;42
2020-09-04;SM;San Marino;0;0;735;42
2020-09-05;SM;San Marino;-19;0;716;42
2020-09-06;SM;San Marino;0;0;716;42
2020-09-07;SM;San Marino;0;0;716;42
2020-09-08;SM;San Marino;0;0;716;42
2020-09-09;SM;San Marino;6;0;722;42
2020-09-10;SM;San Marino;0;0;722;42
2020-09-11;SM;San Marino;0;0;722;42
2020-09-12;SM;San Marino;0;0;722;42
2020-09-13;SM;San Marino;0;0;722;42
2020-09-14;SM;San Marino;0;0;722;42
2020-09-15;SM;San Marino;1;0;723;42
2020-09-16;SM;San Marino;0;0;723;42
2020-09-17;SM;San Marino;0;0;723;42
2020-09-18;SM;San Marino;0;0;723;42
2020-09-19;SM;San Marino;0;0;723;42
2020-09-20;SM;San Marino;0;0;723;42
2020-09-21;SM;San Marino;0;0;723;42
2020-09-22;SM;San Marino;0;0;723;42
2020-09-23;SM;San Marino;0;0;723;42
2020-09-24;SM;San Marino;4;0;727;42
2020-09-25;SM;San Marino;0;0;727;42
2020-09-26;SM;San Marino;0;0;727;42
2020-09-27;SM;San Marino;0;0;727;42
2020-09-28;SM;San Marino;0;0;727;42
2020-09-29;SM;San Marino;0;0;727;42
2020-09-30;SM;San Marino;5;0;732;42
2020-10-01;SM;San Marino;0;0;732;42
2020-10-02;SM;San Marino;0;0;732;42
2020-10-03;SM;San Marino;0;0;732;42
2020-10-04;SM;San Marino;0;0;732;42
2020-10-05;SM;San Marino;0;0;732;42
2020-10-06;SM;San Marino;0;0;732;42
2020-10-07;SM;San Marino;0;0;732;42
2020-10-08;SM;San Marino;9;0;741;42
2020-10-09;SM;San Marino;0;0;741;42
2020-10-10;SM;San Marino;0;0;741;42
2020-10-11;SM;San Marino;0;0;741;42
2020-10-12;SM;San Marino;0;0;741;42
2020-10-13;SM;San Marino;0;0;741;42
2020-10-14;SM;San Marino;0;0;741;42
2020-10-15;SM;San Marino;18;0;759;42
2020-10-16;SM;San Marino;0;0;759;42
2020-10-17;SM;San Marino;0;0;759;42
2020-10-18;SM;San Marino;0;0;759;42
2020-10-19;SM;San Marino;7;0;766;42
2020-10-20;SM;San Marino;0;0;766;42
2020-10-21;SM;San Marino;8;0;774;42
2020-10-22;SM;San Marino;28;0;802;42
2020-10-23;SM;San Marino;17;0;819;42
2020-10-24;SM;San Marino;0;0;819;42
2020-10-25;SM;San Marino;0;0;819;42
2020-10-26;SM;San Marino;33;0;852;42
2020-10-27;SM;San Marino;0;0;852;42
2020-10-28;SM;San Marino;0;0;852;42
2020-10-29;SM;San Marino;76;0;928;42
2020-10-30;SM;San Marino;0;0;928;42
2020-10-31;SM;San Marino;0;0;928;42
2020-11-01;SM;San Marino;0;0;928;42
2020-11-02;SM;San Marino;0;0;928;42
2020-11-03;SM;San Marino;66;0;994;42
2020-11-04;SM;San Marino;0;0;994;42
2020-11-05;SM;San Marino;49;0;1043;42
2020-11-06;SM;San Marino;0;0;1043;42
2020-11-07;SM;San Marino;0;0;1043;42
2020-11-08;SM;San Marino;0;0;1043;42
2020-11-09;SM;San Marino;71;0;1114;42
2020-11-10;SM;San Marino;0;0;1114;42
2020-11-11;SM;San Marino;76;0;1190;42
2020-11-12;SM;San Marino;0;0;1190;42
2020-11-13;SM;San Marino;63;0;1253;42
2020-11-14;SM;San Marino;0;0;1253;42
2020-11-15;SM;San Marino;0;0;1253;42
2020-11-16;SM;San Marino;37;0;1290;42
2020-11-17;SM;San Marino;0;0;1290;42
2020-11-18;SM;San Marino;68;1;1358;43
2020-11-19;SM;San Marino;0;0;1358;43
2020-11-20;SM;San Marino;37;0;1395;43
2020-11-21;SM;San Marino;0;0;1395;43
2020-11-22;SM;San Marino;0;0;1395;43
2020-11-23;SM;San Marino;33;1;1428;44
2020-11-24;SM;San Marino;0;0;1428;44
2020-11-25;SM;San Marino;64;0;1492;44
2020-11-26;SM;San Marino;22;0;1514;44
2020-11-27;SM;San Marino;40;0;1554;44
2020-11-28;SM;San Marino;32;1;1586;45
2020-11-29;SM;San Marino;0;0;1586;45
2020-11-30;SM;San Marino;26;1;1612;46
2020-12-01;SM;San Marino;38;0;1650;46
2020-12-02;SM;San Marino;37;0;1687;46
2020-12-03;SM;San Marino;27;0;1714;46
2020-12-04;SM;San Marino;42;1;1756;47
2020-12-05;SM;San Marino;33;1;1789;48
2020-12-06;SM;San Marino;0;0;1789;48
2020-12-07;SM;San Marino;11;0;1800;48
2020-12-08;SM;San Marino;0;0;1800;48
2020-12-09;SM;San Marino;34;1;1834;49
2020-12-10;SM;San Marino;34;0;1868;49
2020-12-11;SM;San Marino;40;1;1908;50
2020-12-12;SM;San Marino;24;1;1932;51
2020-12-13;SM;San Marino;0;0;1932;51
2020-12-14;SM;San Marino;2;0;1934;51
2020-12-15;SM;San Marino;48;1;1982;52
2020-12-16;SM;San Marino;43;2;2025;54
2020-12-17;SM;San Marino;24;0;2049;54
2020-12-18;SM;San Marino;23;1;2072;55
2020-12-19;SM;San Marino;35;0;2107;55
2020-12-20;SM;San Marino;0;0;2107;55
2020-12-21;SM;San Marino;28;0;2135;55
2020-12-22;SM;San Marino;41;1;2176;56
2020-12-23;SM;San Marino;29;0;2205;56
2020-12-24;SM;San Marino;26;0;2231;56
2020-12-25;SM;San Marino;0;0;2231;56
2020-12-26;SM;San Marino;0;0;2231;56
2020-12-27;SM;San Marino;0;0;2231;56
2020-12-28;SM;San Marino;44;1;2275;57
2020-12-29;SM;San Marino;58;2;2333;59
2020-12-30;SM;San Marino;51;0;2384;59
2020-12-31;SM;San Marino;44;0;2428;59
2021-01-01;SM;San Marino;0;0;2428;59
2021-01-02;SM;San Marino;0;0;2428;59
2021-01-03;SM;San Marino;0;0;2428;59
2021-01-04;SM;San Marino;65;3;2493;62
2021-01-05;SM;San Marino;56;0;2549;62
2021-01-06;SM;San Marino;0;0;2549;62
2021-01-07;SM;San Marino;34;2;2583;64
2021-01-08;SM;San Marino;45;0;2628;64
2021-01-09;SM;San Marino;0;0;2628;64
2021-01-10;SM;San Marino;0;0;2628;64
2021-01-11;SM;San Marino;39;0;2667;64
2021-01-12;SM;San Marino;39;1;2706;65
2021-01-13;SM;San Marino;17;0;2723;65
2021-01-14;SM;San Marino;14;0;2737;65
2021-01-15;SM;San Marino;30;0;2767;65
2021-01-16;SM;San Marino;11;0;2778;65
2021-01-17;SM;San Marino;0;0;2778;65
2021-01-18;SM;San Marino;9;0;2787;65
2021-01-19;SM;San Marino;16;0;2803;65
2021-01-20;SM;San Marino;12;0;2815;65
2021-01-21;SM;San Marino;18;0;2833;65
2021-01-22;SM;San Marino;28;0;2861;65
2021-01-23;SM;San Marino;13;0;2874;65
2021-01-24;SM;San Marino;0;0;2874;65
2021-01-25;SM;San Marino;15;0;2889;65
2021-01-26;SM;San Marino;26;0;2915;65
2021-01-27;SM;San Marino;26;0;2941;65
2021-01-28;SM;San Marino;28;0;2969;65
2021-01-29;SM;San Marino;27;0;2996;65
2021-01-30;SM;San Marino;0;0;2996;65
2021-01-31;SM;San Marino;29;2;3025;67
2021-02-01;SM;San Marino;0;0;3025;67
2021-02-02;SM;San Marino;41;0;3066;67
2021-02-03;SM;San Marino;28;1;3094;68
2021-02-04;SM;San Marino;17;0;3111;68
2021-02-05;SM;San Marino;0;0;3111;68
2021-02-06;SM;San Marino;16;1;3127;69
2021-02-07;SM;San Marino;0;0;3127;69
2021-02-08;SM;San Marino;10;0;3137;69
2021-02-09;SM;San Marino;50;2;3187;71
2021-02-10;SM;San Marino;26;0;3213;71
2021-02-11;SM;San Marino;34;1;3247;72
2021-02-12;SM;San Marino;31;0;3278;72
2021-02-13;SM;San Marino;0;0;3278;72
2021-02-14;SM;San Marino;0;0;3278;72
2021-02-15;SM;San Marino;39;0;3317;72
2021-02-16;SM;San Marino;35;0;3352;72
2021-02-17;SM;San Marino;42;0;3394;72
2021-02-18;SM;San Marino;26;0;3420;72
2021-02-19;SM;San Marino;20;0;3440;72
2021-02-20;SM;San Marino;32;0;3472;72
2021-02-21;SM;San Marino;0;0;3472;72
2021-02-22;SM;San Marino;22;0;3494;72
2021-02-23;SM;San Marino;44;1;3538;73
2021-02-24;SM;San Marino;47;0;3585;73
2021-02-25;SM;San Marino;36;0;3621;73
2021-02-26;SM;San Marino;50;0;3671;73
2021-02-27;SM;San Marino;45;1;3716;74
2021-02-28;SM;San Marino;0;0;3716;74
2021-03-01;SM;San Marino;30;0;3746;74
2021-03-02;SM;San Marino;45;0;3791;74
2021-03-03;SM;San Marino;38;1;3829;75
2021-03-04;SM;San Marino;38;0;3867;75
2021-03-05;SM;San Marino;29;1;3896;76
2021-03-06;SM;San Marino;26;0;3922;76
2021-03-07;SM;San Marino;0;0;3922;76
2021-03-08;SM;San Marino;13;0;3935;76
2021-03-09;SM;San Marino;49;1;3984;77
2021-03-10;SM;San Marino;46;0;4030;77
2021-03-11;SM;San Marino;32;0;4062;77
2021-03-12;SM;San Marino;34;0;4096;77
2021-03-13;SM;San Marino;30;0;4126;77
2021-03-14;SM;San Marino;0;0;4126;77
2021-03-15;SM;San Marino;25;0;4151;77
2021-03-16;SM;San Marino;53;0;4204;77
2021-03-17;SM;San Marino;45;0;4249;77
2021-03-18;SM;San Marino;43;1;4292;78
2021-03-19;SM;San Marino;36;1;4328;79
2021-03-20;SM;San Marino;28;0;4356;79
2021-03-21;SM;San Marino;0;0;4356;79
2021-03-22;SM;San Marino;32;0;4388;79
2021-03-23;SM;San Marino;44;1;4432;80
2021-03-24;SM;San Marino;52;2;4484;82
2021-03-25;SM;San Marino;0;0;4484;82
2021-03-26;SM;San Marino;63;2;4547;84
2021-03-27;SM;San Marino;56;0;4603;84
2021-03-28;SM;San Marino;0;0;4603;84
2021-03-29;SM;San Marino;28;0;4631;84
2021-03-30;SM;San Marino;47;0;4678;84
2021-03-31;SM;San Marino;52;0;4730;84
2021-04-01;SM;San Marino;0;0;4730;84
2021-04-02;SM;San Marino;45;0;4775;84
2021-04-03;SM;San Marino;0;0;4775;84
2021-04-04;SM;San Marino;0;0;4775;84
2021-04-05;SM;San Marino;0;0;4775;84
2021-04-06;SM;San Marino;89;1;4864;85
2021-04-07;SM;San Marino;40;0;4904;85
2021-04-08;SM;San Marino;28;0;4932;85
2021-04-09;SM;San Marino;12;0;4944;85
2021-04-10;SM;San Marino;12;0;4956;85
2021-04-11;SM;San Marino;0;0;4956;85
2021-04-12;SM;San Marino;6;1;4962;86
2021-04-13;SM;San Marino;23;0;4985;86
2021-04-14;SM;San Marino;19;0;5004;86
2021-04-15;SM;San Marino;6;0;5010;86
2021-04-16;SM;San Marino;6;1;5016;87
2021-04-17;SM;San Marino;10;0;5026;87
2021-04-18;SM;San Marino;0;0;5026;87
2021-04-19;SM;San Marino;4;1;5030;88
2021-04-20;SM;San Marino;10;0;5040;88
2021-04-21;SM;San Marino;4;0;5044;88
2021-04-22;SM;San Marino;1;0;5045;88
2021-04-23;SM;San Marino;2;1;5047;89
2021-04-24;SM;San Marino;0;0;5047;89
2021-04-25;SM;San Marino;0;0;5047;89
2021-04-26;SM;San Marino;8;1;5055;90
2021-04-27;SM;San Marino;3;0;5058;90
2021-04-28;SM;San Marino;1;0;5059;90
2021-04-29;SM;San Marino;1;0;5060;90
2021-04-30;SM;San Marino;6;0;5066;90
2021-05-01;SM;San Marino;0;0;5066;90
2021-05-02;SM;San Marino;0;0;5066;90
2021-05-03;SM;San Marino;1;0;5067;90
2021-05-04;SM;San Marino;0;0;5067;90
2021-05-05;SM;San Marino;0;0;5067;90
2021-05-06;SM;San Marino;0;0;5067;90
2021-05-07;SM;San Marino;0;0;5067;90
2021-05-08;SM;San Marino;0;0;5067;90
2021-05-09;SM;San Marino;0;0;5067;90
2021-05-10;SM;San Marino;16;0;5083;90
2021-05-11;SM;San Marino;0;0;5083;90
2021-05-12;SM;San Marino;0;0;5083;90
2021-05-13;SM;San Marino;0;0;5083;90
2021-05-14;SM;San Marino;0;0;5083;90
2021-05-15;SM;San Marino;0;0;5083;90
2021-05-16;SM;San Marino;0;0;5083;90
2021-05-17;SM;San Marino;4;0;5087;90
2021-05-18;SM;San Marino;0;0;5087;90
2021-05-19;SM;San Marino;0;0;5087;90
2021-05-20;SM;San Marino;0;0;5087;90
2021-05-21;SM;San Marino;0;0;5087;90
2021-05-22;SM;San Marino;0;0;5087;90
2021-05-23;SM;San Marino;0;0;5087;90
2021-05-24;SM;San Marino;2;0;5089;90
2021-05-25;SM;San Marino;0;0;5089;90
2021-05-26;SM;San Marino;0;0;5089;90
2021-05-27;SM;San Marino;0;0;5089;90
2021-05-28;SM;San Marino;0;0;5089;90
2021-05-29;SM;San Marino;0;0;5089;90
2021-05-30;SM;San Marino;0;0;5089;90
2021-05-31;SM;San Marino;1;0;5090;90
2021-06-01;SM;San Marino;0;0;5090;90
2021-06-02;SM;San Marino;0;0;5090;90
2021-06-03;SM;San Marino;0;0;5090;90
2021-06-04;SM;San Marino;0;0;5090;90
2021-06-05;SM;San Marino;0;0;5090;90
2021-06-06;SM;San Marino;0;0;5090;90
2021-06-07;SM;San Marino;0;0;5090;90
2021-06-08;SM;San Marino;0;0;5090;90
2021-06-09;SM;San Marino;0;0;5090;90
2021-06-10;SM;San Marino;0;0;5090;90
2021-06-11;SM;San Marino;0;0;5090;90
2021-06-12;SM;San Marino;0;0;5090;90
2021-06-13;SM;San Marino;0;0;5090;90
2021-06-14;SM;San Marino;0;0;5090;90
2021-06-15;SM;San Marino;0;0;5090;90
2021-06-16;SM;San Marino;0;0;5090;90
2021-06-17;SM;San Marino;0;0;5090;90
2021-06-18;SM;San Marino;0;0;5090;90
2021-06-19;SM;San Marino;0;0;5090;90
2021-06-20;SM;San Marino;0;0;5090;90
2021-06-21;SM;San Marino;0;0;5090;90
2021-06-22;SM;San Marino;0;0;5090;90
2021-06-23;SM;San Marino;0;0;5090;90
2021-06-24;SM;San Marino;0;0;5090;90
2021-06-25;SM;San Marino;0;0;5090;90
2021-06-26;SM;San Marino;0;0;5090;90
2021-06-27;SM;San Marino;0;0;5090;90
2021-06-28;SM;San Marino;1;0;5091;90
2021-06-29;SM;San Marino;0;0;5091;90
2021-06-30;SM;San Marino;0;0;5091;90
2021-07-01;SM;San Marino;0;0;5091;90
2020-04-06;ST;Sao Tome and Principe;4;0;4;0
2020-04-07;ST;Sao Tome and Principe;0;0;4;0
2020-04-08;ST;Sao Tome and Principe;0;0;4;0
2020-04-09;ST;Sao Tome and Principe;0;0;4;0
2020-04-10;ST;Sao Tome and Principe;0;0;4;0
2020-04-11;ST;Sao Tome and Principe;0;0;4;0
2020-04-12;ST;Sao Tome and Principe;0;0;4;0
2020-04-13;ST;Sao Tome and Principe;0;0;4;0
2020-04-14;ST;Sao Tome and Principe;0;0;4;0
2020-04-15;ST;Sao Tome and Principe;0;0;4;0
2020-04-16;ST;Sao Tome and Principe;0;0;4;0
2020-04-17;ST;Sao Tome and Principe;0;0;4;0
2020-04-18;ST;Sao Tome and Principe;0;0;4;0
2020-04-19;ST;Sao Tome and Principe;0;0;4;0
2020-04-20;ST;Sao Tome and Principe;0;0;4;0
2020-04-21;ST;Sao Tome and Principe;0;0;4;0
2020-04-22;ST;Sao Tome and Principe;0;0;4;0
2020-04-23;ST;Sao Tome and Principe;0;0;4;0
2020-04-24;ST;Sao Tome and Principe;0;0;4;0
2020-04-25;ST;Sao Tome and Principe;0;0;4;0
2020-04-26;ST;Sao Tome and Principe;0;0;4;0
2020-04-27;ST;Sao Tome and Principe;0;0;4;0
2020-04-28;ST;Sao Tome and Principe;4;0;8;0
2020-04-29;ST;Sao Tome and Principe;0;0;8;0
2020-04-30;ST;Sao Tome and Principe;6;0;14;0
2020-05-01;ST;Sao Tome and Principe;2;1;16;1
2020-05-02;ST;Sao Tome and Principe;0;0;16;1
2020-05-03;ST;Sao Tome and Principe;0;0;16;1
2020-05-04;ST;Sao Tome and Principe;7;2;23;3
2020-05-05;ST;Sao Tome and Principe;151;0;174;3
2020-05-06;ST;Sao Tome and Principe;0;0;174;3
2020-05-07;ST;Sao Tome and Principe;13;1;187;4
2020-05-08;ST;Sao Tome and Principe;21;1;208;5
2020-05-09;ST;Sao Tome and Principe;0;0;208;5
2020-05-10;ST;Sao Tome and Principe;0;0;208;5
2020-05-11;ST;Sao Tome and Principe;0;0;208;5
2020-05-12;ST;Sao Tome and Principe;0;0;208;5
2020-05-13;ST;Sao Tome and Principe;12;1;220;6
2020-05-14;ST;Sao Tome and Principe;15;1;235;7
2020-05-15;ST;Sao Tome and Principe;0;0;235;7
2020-05-16;ST;Sao Tome and Principe;0;0;235;7
2020-05-17;ST;Sao Tome and Principe;0;0;235;7
2020-05-18;ST;Sao Tome and Principe;11;0;246;7
2020-05-19;ST;Sao Tome and Principe;5;1;251;8
2020-05-20;ST;Sao Tome and Principe;0;0;251;8
2020-05-21;ST;Sao Tome and Principe;0;0;251;8
2020-05-22;ST;Sao Tome and Principe;0;0;251;8
2020-05-23;ST;Sao Tome and Principe;0;0;251;8
2020-05-24;ST;Sao Tome and Principe;0;0;251;8
2020-05-25;ST;Sao Tome and Principe;48;3;299;11
2020-05-26;ST;Sao Tome and Principe;142;1;441;12
2020-05-27;ST;Sao Tome and Principe;2;0;443;12
2020-05-28;ST;Sao Tome and Principe;15;0;458;12
2020-05-29;ST;Sao Tome and Principe;5;0;463;12
2020-05-30;ST;Sao Tome and Principe;16;0;479;12
2020-05-31;ST;Sao Tome and Principe;4;0;483;12
2020-06-01;ST;Sao Tome and Principe;1;0;484;12
2020-06-02;ST;Sao Tome and Principe;0;0;484;12
2020-06-03;ST;Sao Tome and Principe;0;0;484;12
2020-06-04;ST;Sao Tome and Principe;1;0;485;12
2020-06-05;ST;Sao Tome and Principe;14;0;499;12
2020-06-06;ST;Sao Tome and Principe;0;0;499;12
2020-06-07;ST;Sao Tome and Principe;14;0;513;12
2020-06-08;ST;Sao Tome and Principe;0;0;513;12
2020-06-09;ST;Sao Tome and Principe;1;0;514;12
2020-06-10;ST;Sao Tome and Principe;97;0;611;12
2020-06-11;ST;Sao Tome and Principe;21;0;632;12
2020-06-12;ST;Sao Tome and Principe;7;0;639;12
2020-06-13;ST;Sao Tome and Principe;20;0;659;12
2020-06-14;ST;Sao Tome and Principe;2;0;661;12
2020-06-15;ST;Sao Tome and Principe;1;0;662;12
2020-06-16;ST;Sao Tome and Principe;9;0;671;12
2020-06-17;ST;Sao Tome and Principe;12;0;683;12
2020-06-18;ST;Sao Tome and Principe;5;0;688;12
2020-06-19;ST;Sao Tome and Principe;5;0;693;12
2020-06-20;ST;Sao Tome and Principe;5;0;698;12
2020-06-21;ST;Sao Tome and Principe;0;0;698;12
2020-06-22;ST;Sao Tome and Principe;4;0;702;12
2020-06-23;ST;Sao Tome and Principe;5;0;707;12
2020-06-24;ST;Sao Tome and Principe;3;1;710;13
2020-06-25;ST;Sao Tome and Principe;1;0;711;13
2020-06-26;ST;Sao Tome and Principe;1;0;712;13
2020-06-27;ST;Sao Tome and Principe;1;0;713;13
2020-06-28;ST;Sao Tome and Principe;0;0;713;13
2020-06-29;ST;Sao Tome and Principe;0;0;713;13
2020-06-30;ST;Sao Tome and Principe;1;0;714;13
2020-07-01;ST;Sao Tome and Principe;1;0;715;13
2020-07-02;ST;Sao Tome and Principe;2;0;717;13
2020-07-03;ST;Sao Tome and Principe;2;0;719;13
2020-07-04;ST;Sao Tome and Principe;0;0;719;13
2020-07-05;ST;Sao Tome and Principe;1;0;720;13
2020-07-06;ST;Sao Tome and Principe;1;0;721;13
2020-07-07;ST;Sao Tome and Principe;3;0;724;13
2020-07-08;ST;Sao Tome and Principe;0;0;724;13
2020-07-09;ST;Sao Tome and Principe;2;1;726;14
2020-07-10;ST;Sao Tome and Principe;1;0;727;14
2020-07-11;ST;Sao Tome and Principe;0;0;727;14
2020-07-12;ST;Sao Tome and Principe;2;0;729;14
2020-07-13;ST;Sao Tome and Principe;3;0;732;14
2020-07-14;ST;Sao Tome and Principe;0;0;732;14
2020-07-15;ST;Sao Tome and Principe;5;0;737;14
2020-07-16;ST;Sao Tome and Principe;3;0;740;14
2020-07-17;ST;Sao Tome and Principe;1;0;741;14
2020-07-18;ST;Sao Tome and Principe;2;0;743;14
2020-07-19;ST;Sao Tome and Principe;3;0;746;14
2020-07-20;ST;Sao Tome and Principe;0;0;746;14
2020-07-21;ST;Sao Tome and Principe;0;0;746;14
2020-07-22;ST;Sao Tome and Principe;1;0;747;14
2020-07-23;ST;Sao Tome and Principe;2;0;749;14
2020-07-24;ST;Sao Tome and Principe;111;0;860;14
2020-07-25;ST;Sao Tome and Principe;2;0;862;14
2020-07-26;ST;Sao Tome and Principe;1;0;863;14
2020-07-27;ST;Sao Tome and Principe;2;0;865;14
2020-07-28;ST;Sao Tome and Principe;2;0;867;14
2020-07-29;ST;Sao Tome and Principe;1;1;868;15
2020-07-30;ST;Sao Tome and Principe;2;0;870;15
2020-07-31;ST;Sao Tome and Principe;1;0;871;15
2020-08-01;ST;Sao Tome and Principe;3;0;874;15
2020-08-02;ST;Sao Tome and Principe;0;0;874;15
2020-08-03;ST;Sao Tome and Principe;0;0;874;15
2020-08-04;ST;Sao Tome and Principe;1;0;875;15
2020-08-05;ST;Sao Tome and Principe;3;0;878;15
2020-08-06;ST;Sao Tome and Principe;0;0;878;15
2020-08-07;ST;Sao Tome and Principe;0;0;878;15
2020-08-08;ST;Sao Tome and Principe;0;0;878;15
2020-08-09;ST;Sao Tome and Principe;0;0;878;15
2020-08-10;ST;Sao Tome and Principe;0;0;878;15
2020-08-11;ST;Sao Tome and Principe;3;0;881;15
2020-08-12;ST;Sao Tome and Principe;1;0;882;15
2020-08-13;ST;Sao Tome and Principe;1;0;883;15
2020-08-14;ST;Sao Tome and Principe;2;0;885;15
2020-08-15;ST;Sao Tome and Principe;0;0;885;15
2020-08-16;ST;Sao Tome and Principe;0;0;885;15
2020-08-17;ST;Sao Tome and Principe;0;0;885;15
2020-08-18;ST;Sao Tome and Principe;0;0;885;15
2020-08-19;ST;Sao Tome and Principe;0;0;885;15
2020-08-20;ST;Sao Tome and Principe;3;0;888;15
2020-08-21;ST;Sao Tome and Principe;3;0;891;15
2020-08-22;ST;Sao Tome and Principe;1;0;892;15
2020-08-23;ST;Sao Tome and Principe;0;0;892;15
2020-08-24;ST;Sao Tome and Principe;0;0;892;15
2020-08-25;ST;Sao Tome and Principe;0;0;892;15
2020-08-26;ST;Sao Tome and Principe;0;0;892;15
2020-08-27;ST;Sao Tome and Principe;2;0;894;15
2020-08-28;ST;Sao Tome and Principe;1;0;895;15
2020-08-29;ST;Sao Tome and Principe;0;0;895;15
2020-08-30;ST;Sao Tome and Principe;1;0;896;15
2020-08-31;ST;Sao Tome and Principe;0;0;896;15
2020-09-01;ST;Sao Tome and Principe;0;0;896;15
2020-09-02;ST;Sao Tome and Principe;0;0;896;15
2020-09-03;ST;Sao Tome and Principe;1;0;897;15
2020-09-04;ST;Sao Tome and Principe;0;0;897;15
2020-09-05;ST;Sao Tome and Principe;1;0;898;15
2020-09-06;ST;Sao Tome and Principe;0;0;898;15
2020-09-07;ST;Sao Tome and Principe;0;0;898;15
2020-09-08;ST;Sao Tome and Principe;0;0;898;15
2020-09-09;ST;Sao Tome and Principe;0;0;898;15
2020-09-10;ST;Sao Tome and Principe;3;0;901;15
2020-09-11;ST;Sao Tome and Principe;5;0;906;15
2020-09-12;ST;Sao Tome and Principe;0;0;906;15
2020-09-13;ST;Sao Tome and Principe;0;0;906;15
2020-09-14;ST;Sao Tome and Principe;0;0;906;15
2020-09-15;ST;Sao Tome and Principe;1;0;907;15
2020-09-16;ST;Sao Tome and Principe;0;0;907;15
2020-09-17;ST;Sao Tome and Principe;0;0;907;15
2020-09-18;ST;Sao Tome and Principe;1;0;908;15
2020-09-19;ST;Sao Tome and Principe;0;0;908;15
2020-09-20;ST;Sao Tome and Principe;0;0;908;15
2020-09-21;ST;Sao Tome and Principe;0;0;908;15
2020-09-22;ST;Sao Tome and Principe;0;0;908;15
2020-09-23;ST;Sao Tome and Principe;0;0;908;15
2020-09-24;ST;Sao Tome and Principe;2;0;910;15
2020-09-25;ST;Sao Tome and Principe;1;0;911;15
2020-09-26;ST;Sao Tome and Principe;0;0;911;15
2020-09-27;ST;Sao Tome and Principe;0;0;911;15
2020-09-28;ST;Sao Tome and Principe;0;0;911;15
2020-09-29;ST;Sao Tome and Principe;0;0;911;15
2020-09-30;ST;Sao Tome and Principe;0;0;911;15
2020-10-01;ST;Sao Tome and Principe;0;0;911;15
2020-10-02;ST;Sao Tome and Principe;0;0;911;15
2020-10-03;ST;Sao Tome and Principe;2;0;913;15
2020-10-04;ST;Sao Tome and Principe;0;0;913;15
2020-10-05;ST;Sao Tome and Principe;0;0;913;15
2020-10-06;ST;Sao Tome and Principe;1;0;914;15
2020-10-07;ST;Sao Tome and Principe;0;0;914;15
2020-10-08;ST;Sao Tome and Principe;7;0;921;15
2020-10-09;ST;Sao Tome and Principe;1;0;922;15
2020-10-10;ST;Sao Tome and Principe;0;0;922;15
2020-10-11;ST;Sao Tome and Principe;7;0;929;15
2020-10-12;ST;Sao Tome and Principe;0;0;929;15
2020-10-13;ST;Sao Tome and Principe;0;0;929;15
2020-10-14;ST;Sao Tome and Principe;0;0;929;15
2020-10-15;ST;Sao Tome and Principe;0;0;929;15
2020-10-16;ST;Sao Tome and Principe;3;0;932;15
2020-10-17;ST;Sao Tome and Principe;0;0;932;15
2020-10-18;ST;Sao Tome and Principe;1;0;933;15
2020-10-19;ST;Sao Tome and Principe;0;0;933;15
2020-10-20;ST;Sao Tome and Principe;0;0;933;15
2020-10-21;ST;Sao Tome and Principe;2;0;935;15
2020-10-22;ST;Sao Tome and Principe;0;0;935;15
2020-10-23;ST;Sao Tome and Principe;3;0;938;15
2020-10-24;ST;Sao Tome and Principe;2;0;940;15
2020-10-25;ST;Sao Tome and Principe;0;0;940;15
2020-10-26;ST;Sao Tome and Principe;1;0;941;15
2020-10-27;ST;Sao Tome and Principe;0;0;941;15
2020-10-28;ST;Sao Tome and Principe;2;0;943;15
2020-10-29;ST;Sao Tome and Principe;1;1;944;16
2020-10-30;ST;Sao Tome and Principe;1;0;945;16
2020-10-31;ST;Sao Tome and Principe;0;0;945;16
2020-11-01;ST;Sao Tome and Principe;4;0;949;16
2020-11-02;ST;Sao Tome and Principe;0;0;949;16
2020-11-03;ST;Sao Tome and Principe;5;0;954;16
2020-11-04;ST;Sao Tome and Principe;4;0;958;16
2020-11-05;ST;Sao Tome and Principe;0;0;958;16
2020-11-06;ST;Sao Tome and Principe;2;0;960;16
2020-11-07;ST;Sao Tome and Principe;2;0;962;16
2020-11-08;ST;Sao Tome and Principe;0;0;962;16
2020-11-09;ST;Sao Tome and Principe;0;0;962;16
2020-11-10;ST;Sao Tome and Principe;0;0;962;16
2020-11-11;ST;Sao Tome and Principe;0;0;962;16
2020-11-12;ST;Sao Tome and Principe;1;0;963;16
2020-11-13;ST;Sao Tome and Principe;0;0;963;16
2020-11-14;ST;Sao Tome and Principe;1;0;964;16
2020-11-15;ST;Sao Tome and Principe;1;0;965;16
2020-11-16;ST;Sao Tome and Principe;0;0;965;16
2020-11-17;ST;Sao Tome and Principe;2;0;967;16
2020-11-18;ST;Sao Tome and Principe;0;0;967;16
2020-11-19;ST;Sao Tome and Principe;7;0;974;16
2020-11-20;ST;Sao Tome and Principe;0;1;974;17
2020-11-21;ST;Sao Tome and Principe;5;0;979;17
2020-11-22;ST;Sao Tome and Principe;0;0;979;17
2020-11-23;ST;Sao Tome and Principe;2;0;981;17
2020-11-24;ST;Sao Tome and Principe;0;0;981;17
2020-11-25;ST;Sao Tome and Principe;1;0;982;17
2020-11-26;ST;Sao Tome and Principe;3;0;985;17
2020-11-27;ST;Sao Tome and Principe;0;0;985;17
2020-11-28;ST;Sao Tome and Principe;4;0;989;17
2020-11-29;ST;Sao Tome and Principe;0;0;989;17
2020-11-30;ST;Sao Tome and Principe;2;0;991;17
2020-12-01;ST;Sao Tome and Principe;5;0;996;17
2020-12-02;ST;Sao Tome and Principe;1;0;997;17
2020-12-03;ST;Sao Tome and Principe;0;0;997;17
2020-12-04;ST;Sao Tome and Principe;2;0;999;17
2020-12-05;ST;Sao Tome and Principe;0;0;999;17
2020-12-06;ST;Sao Tome and Principe;0;0;999;17
2020-12-07;ST;Sao Tome and Principe;3;0;1002;17
2020-12-08;ST;Sao Tome and Principe;3;0;1005;17
2020-12-09;ST;Sao Tome and Principe;0;0;1005;17
2020-12-10;ST;Sao Tome and Principe;4;0;1009;17
2020-12-11;ST;Sao Tome and Principe;0;0;1009;17
2020-12-12;ST;Sao Tome and Principe;0;0;1009;17
2020-12-13;ST;Sao Tome and Principe;0;0;1009;17
2020-12-14;ST;Sao Tome and Principe;1;0;1010;17
2020-12-15;ST;Sao Tome and Principe;0;0;1010;17
2020-12-16;ST;Sao Tome and Principe;0;0;1010;17
2020-12-17;ST;Sao Tome and Principe;1;0;1011;17
2020-12-18;ST;Sao Tome and Principe;0;0;1011;17
2020-12-19;ST;Sao Tome and Principe;1;0;1012;17
2020-12-20;ST;Sao Tome and Principe;0;0;1012;17
2020-12-21;ST;Sao Tome and Principe;0;0;1012;17
2020-12-22;ST;Sao Tome and Principe;0;0;1012;17
2020-12-23;ST;Sao Tome and Principe;0;0;1012;17
2020-12-24;ST;Sao Tome and Principe;0;0;1012;17
2020-12-25;ST;Sao Tome and Principe;2;0;1014;17
2020-12-26;ST;Sao Tome and Principe;0;0;1014;17
2020-12-27;ST;Sao Tome and Principe;0;0;1014;17
2020-12-28;ST;Sao Tome and Principe;0;0;1014;17
2020-12-29;ST;Sao Tome and Principe;0;0;1014;17
2020-12-30;ST;Sao Tome and Principe;0;0;1014;17
2020-12-31;ST;Sao Tome and Principe;0;0;1014;17
2021-01-01;ST;Sao Tome and Principe;8;0;1022;17
2021-01-02;ST;Sao Tome and Principe;2;0;1024;17
2021-01-03;ST;Sao Tome and Principe;0;0;1024;17
2021-01-04;ST;Sao Tome and Principe;0;0;1024;17
2021-01-05;ST;Sao Tome and Principe;0;0;1024;17
2021-01-06;ST;Sao Tome and Principe;1;0;1025;17
2021-01-07;ST;Sao Tome and Principe;10;0;1035;17
2021-01-08;ST;Sao Tome and Principe;19;0;1054;17
2021-01-09;ST;Sao Tome and Principe;12;0;1066;17
2021-01-10;ST;Sao Tome and Principe;0;0;1066;17
2021-01-11;ST;Sao Tome and Principe;0;0;1066;17
2021-01-12;ST;Sao Tome and Principe;24;0;1090;17
2021-01-13;ST;Sao Tome and Principe;15;0;1105;17
2021-01-14;ST;Sao Tome and Principe;14;0;1119;17
2021-01-15;ST;Sao Tome and Principe;6;0;1125;17
2021-01-16;ST;Sao Tome and Principe;5;0;1130;17
2021-01-17;ST;Sao Tome and Principe;12;0;1142;17
2021-01-18;ST;Sao Tome and Principe;0;0;1142;17
2021-01-19;ST;Sao Tome and Principe;9;0;1151;17
2021-01-20;ST;Sao Tome and Principe;19;0;1170;17
2021-01-21;ST;Sao Tome and Principe;1;0;1171;17
2021-01-22;ST;Sao Tome and Principe;11;0;1182;17
2021-01-23;ST;Sao Tome and Principe;6;0;1188;17
2021-01-24;ST;Sao Tome and Principe;0;0;1188;17
2021-01-25;ST;Sao Tome and Principe;1;0;1189;17
2021-01-26;ST;Sao Tome and Principe;21;0;1210;17
2021-01-27;ST;Sao Tome and Principe;11;0;1221;17
2021-01-28;ST;Sao Tome and Principe;11;0;1232;17
2021-01-29;ST;Sao Tome and Principe;13;0;1245;17
2021-01-30;ST;Sao Tome and Principe;11;0;1256;17
2021-01-31;ST;Sao Tome and Principe;1;0;1257;17
2021-02-01;ST;Sao Tome and Principe;2;0;1259;17
2021-02-02;ST;Sao Tome and Principe;24;0;1283;17
2021-02-03;ST;Sao Tome and Principe;4;0;1287;17
2021-02-04;ST;Sao Tome and Principe;11;0;1298;17
2021-02-05;ST;Sao Tome and Principe;48;1;1346;18
2021-02-06;ST;Sao Tome and Principe;5;0;1351;18
2021-02-07;ST;Sao Tome and Principe;0;0;1351;18
2021-02-08;ST;Sao Tome and Principe;4;0;1355;18
2021-02-09;ST;Sao Tome and Principe;30;0;1385;18
2021-02-10;ST;Sao Tome and Principe;45;0;1430;18
2021-02-11;ST;Sao Tome and Principe;1;1;1431;19
2021-02-12;ST;Sao Tome and Principe;47;0;1478;19
2021-02-13;ST;Sao Tome and Principe;4;0;1482;19
2021-02-14;ST;Sao Tome and Principe;0;0;1482;19
2021-02-15;ST;Sao Tome and Principe;0;0;1482;19
2021-02-16;ST;Sao Tome and Principe;38;0;1520;19
2021-02-17;ST;Sao Tome and Principe;15;1;1535;20
2021-02-18;ST;Sao Tome and Principe;13;0;1548;20
2021-02-19;ST;Sao Tome and Principe;30;0;1578;20
2021-02-20;ST;Sao Tome and Principe;0;1;1578;21
2021-02-21;ST;Sao Tome and Principe;32;0;1610;21
2021-02-22;ST;Sao Tome and Principe;18;1;1628;22
2021-02-23;ST;Sao Tome and Principe;27;4;1655;26
2021-02-24;ST;Sao Tome and Principe;17;1;1672;27
2021-02-25;ST;Sao Tome and Principe;47;0;1719;27
2021-02-26;ST;Sao Tome and Principe;26;1;1745;28
2021-02-27;ST;Sao Tome and Principe;41;0;1786;28
2021-02-28;ST;Sao Tome and Principe;0;1;1786;29
2021-03-01;ST;Sao Tome and Principe;42;1;1828;30
2021-03-02;ST;Sao Tome and Principe;12;0;1840;30
2021-03-03;ST;Sao Tome and Principe;41;0;1881;30
2021-03-04;ST;Sao Tome and Principe;17;0;1898;30
2021-03-05;ST;Sao Tome and Principe;25;1;1923;31
2021-03-06;ST;Sao Tome and Principe;21;0;1944;31
2021-03-07;ST;Sao Tome and Principe;6;1;1950;32
2021-03-08;ST;Sao Tome and Principe;11;0;1961;32
2021-03-09;ST;Sao Tome and Principe;16;0;1977;32
2021-03-10;ST;Sao Tome and Principe;33;0;2010;32
2021-03-11;ST;Sao Tome and Principe;25;0;2035;32
2021-03-12;ST;Sao Tome and Principe;22;0;2057;32
2021-03-13;ST;Sao Tome and Principe;21;0;2078;32
2021-03-14;ST;Sao Tome and Principe;0;0;2078;32
2021-03-15;ST;Sao Tome and Principe;6;0;2084;32
2021-03-16;ST;Sao Tome and Principe;1;0;2085;32
2021-03-17;ST;Sao Tome and Principe;22;1;2107;33
2021-03-18;ST;Sao Tome and Principe;7;1;2114;34
2021-03-19;ST;Sao Tome and Principe;9;0;2123;34
2021-03-20;ST;Sao Tome and Principe;19;0;2142;34
2021-03-21;ST;Sao Tome and Principe;3;0;2145;34
2021-03-22;ST;Sao Tome and Principe;12;0;2157;34
2021-03-23;ST;Sao Tome and Principe;2;0;2159;34
2021-03-24;ST;Sao Tome and Principe;15;0;2174;34
2021-03-25;ST;Sao Tome and Principe;3;0;2177;34
2021-03-26;ST;Sao Tome and Principe;19;0;2196;34
2021-03-27;ST;Sao Tome and Principe;14;0;2210;34
2021-03-28;ST;Sao Tome and Principe;2;0;2212;34
2021-03-29;ST;Sao Tome and Principe;3;0;2215;34
2021-03-30;ST;Sao Tome and Principe;6;0;2221;34
2021-03-31;ST;Sao Tome and Principe;2;0;2223;34
2021-04-01;ST;Sao Tome and Principe;9;0;2232;34
2021-04-02;ST;Sao Tome and Principe;4;0;2236;34
2021-04-03;ST;Sao Tome and Principe;4;1;2240;35
2021-04-04;ST;Sao Tome and Principe;0;0;2240;35
2021-04-05;ST;Sao Tome and Principe;4;0;2244;35
2021-04-06;ST;Sao Tome and Principe;4;0;2248;35
2021-04-07;ST;Sao Tome and Principe;7;0;2255;35
2021-04-08;ST;Sao Tome and Principe;0;0;2255;35
2021-04-09;ST;Sao Tome and Principe;6;0;2261;35
2021-04-10;ST;Sao Tome and Principe;2;0;2263;35
2021-04-11;ST;Sao Tome and Principe;3;0;2266;35
2021-04-12;ST;Sao Tome and Principe;1;0;2267;35
2021-04-13;ST;Sao Tome and Principe;1;0;2268;35
2021-04-14;ST;Sao Tome and Principe;1;0;2269;35
2021-04-15;ST;Sao Tome and Principe;2;0;2271;35
2021-04-16;ST;Sao Tome and Principe;1;0;2272;35
2021-04-17;ST;Sao Tome and Principe;3;0;2275;35
2021-04-18;ST;Sao Tome and Principe;0;0;2275;35
2021-04-19;ST;Sao Tome and Principe;0;0;2275;35
2021-04-20;ST;Sao Tome and Principe;8;0;2283;35
2021-04-21;ST;Sao Tome and Principe;5;0;2288;35
2021-04-22;ST;Sao Tome and Principe;4;0;2292;35
2021-04-23;ST;Sao Tome and Principe;0;0;2292;35
2021-04-24;ST;Sao Tome and Principe;5;0;2297;35
2021-04-25;ST;Sao Tome and Principe;1;0;2298;35
2021-04-26;ST;Sao Tome and Principe;1;0;2299;35
2021-04-27;ST;Sao Tome and Principe;0;0;2299;35
2021-04-28;ST;Sao Tome and Principe;2;0;2301;35
2021-04-29;ST;Sao Tome and Principe;0;0;2301;35
2021-04-30;ST;Sao Tome and Principe;1;0;2302;35
2021-05-01;ST;Sao Tome and Principe;0;0;2302;35
2021-05-02;ST;Sao Tome and Principe;8;0;2310;35
2021-05-03;ST;Sao Tome and Principe;0;0;2310;35
2021-05-04;ST;Sao Tome and Principe;1;0;2311;35
2021-05-05;ST;Sao Tome and Principe;3;0;2314;35
2021-05-06;ST;Sao Tome and Principe;3;0;2317;35
2021-05-07;ST;Sao Tome and Principe;0;0;2317;35
2021-05-08;ST;Sao Tome and Principe;1;0;2318;35
2021-05-09;ST;Sao Tome and Principe;0;0;2318;35
2021-05-10;ST;Sao Tome and Principe;0;0;2318;35
2021-05-11;ST;Sao Tome and Principe;2;0;2320;35
2021-05-12;ST;Sao Tome and Principe;0;0;2320;35
2021-05-13;ST;Sao Tome and Principe;0;0;2320;35
2021-05-14;ST;Sao Tome and Principe;4;0;2324;35
2021-05-15;ST;Sao Tome and Principe;3;0;2327;35
2021-05-16;ST;Sao Tome and Principe;0;0;2327;35
2021-05-17;ST;Sao Tome and Principe;3;0;2330;35
2021-05-18;ST;Sao Tome and Principe;2;0;2332;35
2021-05-19;ST;Sao Tome and Principe;1;0;2333;35
2021-05-20;ST;Sao Tome and Principe;1;0;2334;35
2021-05-21;ST;Sao Tome and Principe;1;0;2335;35
2021-05-22;ST;Sao Tome and Principe;3;1;2338;36
2021-05-23;ST;Sao Tome and Principe;0;1;2338;37
2021-05-24;ST;Sao Tome and Principe;0;0;2338;37
2021-05-25;ST;Sao Tome and Principe;0;0;2338;37
2021-05-26;ST;Sao Tome and Principe;0;0;2338;37
2021-05-27;ST;Sao Tome and Principe;0;0;2338;37
2021-05-28;ST;Sao Tome and Principe;6;0;2344;37
2021-05-29;ST;Sao Tome and Principe;1;0;2345;37
2021-05-30;ST;Sao Tome and Principe;0;0;2345;37
2021-05-31;ST;Sao Tome and Principe;0;1;2345;38
2021-06-01;ST;Sao Tome and Principe;0;3;2345;41
2021-06-02;ST;Sao Tome and Principe;2;0;2347;41
2021-06-03;ST;Sao Tome and Principe;2;-4;2349;37
2021-06-04;ST;Sao Tome and Principe;4;0;2353;37
2021-06-05;ST;Sao Tome and Principe;0;0;2353;37
2021-06-06;ST;Sao Tome and Principe;0;0;2353;37
2021-06-07;ST;Sao Tome and Principe;0;0;2353;37
2021-06-08;ST;Sao Tome and Principe;0;0;2353;37
2021-06-09;ST;Sao Tome and Principe;1;0;2354;37
2021-06-10;ST;Sao Tome and Principe;1;0;2355;37
2021-06-11;ST;Sao Tome and Principe;1;0;2356;37
2021-06-12;ST;Sao Tome and Principe;1;0;2357;37
2021-06-13;ST;Sao Tome and Principe;1;0;2358;37
2021-06-14;ST;Sao Tome and Principe;0;0;2358;37
2021-06-15;ST;Sao Tome and Principe;0;0;2358;37
2021-06-16;ST;Sao Tome and Principe;0;0;2358;37
2021-06-17;ST;Sao Tome and Principe;0;0;2358;37
2021-06-18;ST;Sao Tome and Principe;2;0;2360;37
2021-06-19;ST;Sao Tome and Principe;2;0;2362;37
2021-06-20;ST;Sao Tome and Principe;0;0;2362;37
2021-06-21;ST;Sao Tome and Principe;0;0;2362;37
2021-06-22;ST;Sao Tome and Principe;1;0;2363;37
2021-06-23;ST;Sao Tome and Principe;0;0;2363;37
2021-06-24;ST;Sao Tome and Principe;1;0;2364;37
2021-06-25;ST;Sao Tome and Principe;1;0;2365;37
2021-06-26;ST;Sao Tome and Principe;0;0;2365;37
2021-06-27;ST;Sao Tome and Principe;0;0;2365;37
2021-06-28;ST;Sao Tome and Principe;0;0;2365;37
2021-06-29;ST;Sao Tome and Principe;1;0;2366;37
2021-06-30;ST;Sao Tome and Principe;0;0;2366;37
2021-07-01;ST;Sao Tome and Principe;3;0;2369;37
2020-03-02;SA;Saudi Arabia;1;0;1;0
2020-03-03;SA;Saudi Arabia;0;0;1;0
2020-03-04;SA;Saudi Arabia;0;0;1;0
2020-03-05;SA;Saudi Arabia;4;0;5;0
2020-03-06;SA;Saudi Arabia;0;0;5;0
2020-03-07;SA;Saudi Arabia;0;0;5;0
2020-03-08;SA;Saudi Arabia;6;0;11;0
2020-03-09;SA;Saudi Arabia;4;0;15;0
2020-03-10;SA;Saudi Arabia;5;0;20;0
2020-03-11;SA;Saudi Arabia;1;0;21;0
2020-03-12;SA;Saudi Arabia;24;0;45;0
2020-03-13;SA;Saudi Arabia;41;0;86;0
2020-03-14;SA;Saudi Arabia;17;0;103;0
2020-03-15;SA;Saudi Arabia;0;0;103;0
2020-03-16;SA;Saudi Arabia;15;0;118;0
2020-03-17;SA;Saudi Arabia;53;0;171;0
2020-03-18;SA;Saudi Arabia;0;0;171;0
2020-03-19;SA;Saudi Arabia;103;0;274;0
2020-03-20;SA;Saudi Arabia;70;0;344;0
2020-03-21;SA;Saudi Arabia;48;0;392;0
2020-03-22;SA;Saudi Arabia;119;0;511;0
2020-03-23;SA;Saudi Arabia;51;0;562;0
2020-03-24;SA;Saudi Arabia;205;1;767;1
2020-03-25;SA;Saudi Arabia;133;1;900;2
2020-03-26;SA;Saudi Arabia;112;1;1012;3
2020-03-27;SA;Saudi Arabia;92;0;1104;3
2020-03-28;SA;Saudi Arabia;99;1;1203;4
2020-03-29;SA;Saudi Arabia;96;4;1299;8
2020-03-30;SA;Saudi Arabia;154;0;1453;8
2020-03-31;SA;Saudi Arabia;110;2;1563;10
2020-04-01;SA;Saudi Arabia;157;6;1720;16
2020-04-02;SA;Saudi Arabia;165;5;1885;21
2020-04-03;SA;Saudi Arabia;154;4;2039;25
2020-04-04;SA;Saudi Arabia;140;4;2179;29
2020-04-05;SA;Saudi Arabia;223;5;2402;34
2020-04-06;SA;Saudi Arabia;203;4;2605;38
2020-04-07;SA;Saudi Arabia;190;3;2795;41
2020-04-08;SA;Saudi Arabia;137;0;2932;41
2020-04-09;SA;Saudi Arabia;355;3;3287;44
2020-04-10;SA;Saudi Arabia;364;3;3651;47
2020-04-11;SA;Saudi Arabia;382;5;4033;52
2020-04-12;SA;Saudi Arabia;429;7;4462;59
2020-04-13;SA;Saudi Arabia;472;6;4934;65
2020-04-14;SA;Saudi Arabia;435;8;5369;73
2020-04-15;SA;Saudi Arabia;493;6;5862;79
2020-04-16;SA;Saudi Arabia;518;4;6380;83
2020-04-17;SA;Saudi Arabia;762;4;7142;87
2020-04-18;SA;Saudi Arabia;1132;5;8274;92
2020-04-19;SA;Saudi Arabia;1088;5;9362;97
2020-04-20;SA;Saudi Arabia;1122;6;10484;103
2020-04-21;SA;Saudi Arabia;1147;6;11631;109
2020-04-22;SA;Saudi Arabia;1141;5;12772;114
2020-04-23;SA;Saudi Arabia;1158;7;13930;121
2020-04-24;SA;Saudi Arabia;1172;6;15102;127
2020-04-25;SA;Saudi Arabia;1197;9;16299;136
2020-04-26;SA;Saudi Arabia;1223;3;17522;139
2020-04-27;SA;Saudi Arabia;1289;5;18811;144
2020-04-28;SA;Saudi Arabia;1266;8;20077;152
2020-04-29;SA;Saudi Arabia;1325;5;21402;157
2020-04-30;SA;Saudi Arabia;1351;5;22753;162
2020-05-01;SA;Saudi Arabia;1344;7;24097;169
2020-05-02;SA;Saudi Arabia;1362;7;25459;176
2020-05-03;SA;Saudi Arabia;1552;8;27011;184
2020-05-04;SA;Saudi Arabia;1645;7;28656;191
2020-05-05;SA;Saudi Arabia;1595;9;30251;200
2020-05-06;SA;Saudi Arabia;1687;9;31938;209
2020-05-07;SA;Saudi Arabia;1793;10;33731;219
2020-05-08;SA;Saudi Arabia;1701;10;35432;229
2020-05-09;SA;Saudi Arabia;1704;10;37136;239
2020-05-10;SA;Saudi Arabia;1912;7;39048;246
2020-05-11;SA;Saudi Arabia;1966;9;41014;255
2020-05-12;SA;Saudi Arabia;1911;9;42925;264
2020-05-13;SA;Saudi Arabia;1905;9;44830;273
2020-05-14;SA;Saudi Arabia;2039;10;46869;283
2020-05-15;SA;Saudi Arabia;2307;9;49176;292
2020-05-16;SA;Saudi Arabia;2840;10;52016;302
2020-05-17;SA;Saudi Arabia;2736;10;54752;312
2020-05-18;SA;Saudi Arabia;2593;8;57345;320
2020-05-19;SA;Saudi Arabia;2509;9;59854;329
2020-05-20;SA;Saudi Arabia;2691;10;62545;339
2020-05-21;SA;Saudi Arabia;2532;12;65077;351
2020-05-22;SA;Saudi Arabia;2642;13;67719;364
2020-05-23;SA;Saudi Arabia;2442;15;70161;379
2020-05-24;SA;Saudi Arabia;2399;11;72560;390
2020-05-25;SA;Saudi Arabia;2235;9;74795;399
2020-05-26;SA;Saudi Arabia;1931;12;76726;411
2020-05-27;SA;Saudi Arabia;1815;14;78541;425
2020-05-28;SA;Saudi Arabia;1644;16;80185;441
2020-05-29;SA;Saudi Arabia;1581;17;81766;458
2020-05-30;SA;Saudi Arabia;1618;22;83384;480
2020-05-31;SA;Saudi Arabia;1877;23;85261;503
2020-06-01;SA;Saudi Arabia;1881;22;87142;525
2020-06-02;SA;Saudi Arabia;1869;24;89011;549
2020-06-03;SA;Saudi Arabia;2171;30;91182;579
2020-06-04;SA;Saudi Arabia;1975;32;93157;611
2020-06-05;SA;Saudi Arabia;2591;31;95748;642
2020-06-06;SA;Saudi Arabia;3121;34;98869;676
2020-06-07;SA;Saudi Arabia;3045;36;101914;712
2020-06-08;SA;Saudi Arabia;3369;34;105283;746
2020-06-09;SA;Saudi Arabia;3288;37;108571;783
2020-06-10;SA;Saudi Arabia;3717;36;112288;819
2020-06-11;SA;Saudi Arabia;3733;38;116021;857
2020-06-12;SA;Saudi Arabia;3921;36;119942;893
2020-06-13;SA;Saudi Arabia;3366;39;123308;932
2020-06-14;SA;Saudi Arabia;4233;40;127541;972
2020-06-15;SA;Saudi Arabia;4507;39;132048;1011
2020-06-16;SA;Saudi Arabia;4267;41;136315;1052
2020-06-17;SA;Saudi Arabia;4919;39;141234;1091
2020-06-18;SA;Saudi Arabia;4757;48;145991;1139
2020-06-19;SA;Saudi Arabia;4301;45;150292;1184
2020-06-20;SA;Saudi Arabia;3941;46;154233;1230
2020-06-21;SA;Saudi Arabia;3379;37;157612;1267
2020-06-22;SA;Saudi Arabia;3393;40;161005;1307
2020-06-23;SA;Saudi Arabia;3139;39;164144;1346
2020-06-24;SA;Saudi Arabia;3123;41;167267;1387
2020-06-25;SA;Saudi Arabia;3372;41;170639;1428
2020-06-26;SA;Saudi Arabia;3938;46;174577;1474
2020-06-27;SA;Saudi Arabia;3927;37;178504;1511
2020-06-28;SA;Saudi Arabia;3989;40;182493;1551
2020-06-29;SA;Saudi Arabia;3943;48;186436;1599
2020-06-30;SA;Saudi Arabia;4387;50;190823;1649
2020-07-01;SA;Saudi Arabia;3402;49;194225;1698
2020-07-02;SA;Saudi Arabia;3383;54;197608;1752
2020-07-03;SA;Saudi Arabia;4193;50;201801;1802
2020-07-04;SA;Saudi Arabia;4128;56;205929;1858
2020-07-05;SA;Saudi Arabia;3580;58;209509;1916
2020-07-06;SA;Saudi Arabia;4207;52;213716;1968
2020-07-07;SA;Saudi Arabia;3392;49;217108;2017
2020-07-08;SA;Saudi Arabia;3036;42;220144;2059
2020-07-09;SA;Saudi Arabia;3183;41;223327;2100
2020-07-10;SA;Saudi Arabia;3159;51;226486;2151
2020-07-11;SA;Saudi Arabia;2994;30;229480;2181
2020-07-12;SA;Saudi Arabia;2779;42;232259;2223
2020-07-13;SA;Saudi Arabia;2852;20;235111;2243
2020-07-14;SA;Saudi Arabia;2692;40;237803;2283
2020-07-15;SA;Saudi Arabia;2671;42;240474;2325
2020-07-16;SA;Saudi Arabia;2764;45;243238;2370
2020-07-17;SA;Saudi Arabia;2613;37;245851;2407
2020-07-18;SA;Saudi Arabia;2565;40;248416;2447
2020-07-19;SA;Saudi Arabia;2504;39;250920;2486
2020-07-20;SA;Saudi Arabia;2429;37;253349;2523
2020-07-21;SA;Saudi Arabia;2476;34;255825;2557
2020-07-22;SA;Saudi Arabia;2331;44;258156;2601
2020-07-23;SA;Saudi Arabia;2238;34;260394;2635
2020-07-24;SA;Saudi Arabia;2378;37;262772;2672
2020-07-25;SA;Saudi Arabia;2201;31;264973;2703
2020-07-26;SA;Saudi Arabia;1968;30;266941;2733
2020-07-27;SA;Saudi Arabia;1993;27;268934;2760
2020-07-28;SA;Saudi Arabia;1897;29;270831;2789
2020-07-29;SA;Saudi Arabia;1759;27;272590;2816
2020-07-30;SA;Saudi Arabia;1629;26;274219;2842
2020-07-31;SA;Saudi Arabia;1686;24;275905;2866
2020-08-01;SA;Saudi Arabia;1573;21;277478;2887
2020-08-02;SA;Saudi Arabia;1357;30;278835;2917
2020-08-03;SA;Saudi Arabia;1258;32;280093;2949
2020-08-04;SA;Saudi Arabia;1363;35;281456;2984
2020-08-05;SA;Saudi Arabia;1368;36;282824;3020
2020-08-06;SA;Saudi Arabia;1402;35;284226;3055
2020-08-07;SA;Saudi Arabia;1567;38;285793;3093
2020-08-08;SA;Saudi Arabia;1469;37;287262;3130
2020-08-09;SA;Saudi Arabia;1428;37;288690;3167
2020-08-10;SA;Saudi Arabia;1257;32;289947;3199
2020-08-11;SA;Saudi Arabia;1521;34;291468;3233
2020-08-12;SA;Saudi Arabia;1569;36;293037;3269
2020-08-13;SA;Saudi Arabia;1482;34;294519;3303
2020-08-14;SA;Saudi Arabia;1383;35;295902;3338
2020-08-15;SA;Saudi Arabia;1413;31;297315;3369
2020-08-16;SA;Saudi Arabia;1227;39;298542;3408
2020-08-17;SA;Saudi Arabia;1372;28;299914;3436
2020-08-18;SA;Saudi Arabia;1409;34;301323;3470
2020-08-19;SA;Saudi Arabia;1363;36;302686;3506
2020-08-20;SA;Saudi Arabia;1287;42;303973;3548
2020-08-21;SA;Saudi Arabia;1213;32;305186;3580
2020-08-22;SA;Saudi Arabia;1184;39;306370;3619
2020-08-23;SA;Saudi Arabia;1109;30;307479;3649
2020-08-24;SA;Saudi Arabia;1175;42;308654;3691
2020-08-25;SA;Saudi Arabia;1114;31;309768;3722
2020-08-26;SA;Saudi Arabia;1068;33;310836;3755
2020-08-27;SA;Saudi Arabia;1019;30;311855;3785
2020-08-28;SA;Saudi Arabia;1069;28;312924;3813
2020-08-29;SA;Saudi Arabia;987;27;313911;3840
2020-08-30;SA;Saudi Arabia;910;30;314821;3870
2020-08-31;SA;Saudi Arabia;951;27;315772;3897
2020-09-01;SA;Saudi Arabia;898;32;316670;3929
2020-09-02;SA;Saudi Arabia;816;27;317486;3956
2020-09-03;SA;Saudi Arabia;833;26;318319;3982
2020-09-04;SA;Saudi Arabia;822;33;319141;4015
2020-09-05;SA;Saudi Arabia;791;34;319932;4049
2020-09-06;SA;Saudi Arabia;756;32;320688;4081
2020-09-07;SA;Saudi Arabia;768;26;321456;4107
2020-09-08;SA;Saudi Arabia;781;30;322237;4137
2020-09-09;SA;Saudi Arabia;775;28;323012;4165
2020-09-10;SA;Saudi Arabia;708;24;323720;4189
2020-09-11;SA;Saudi Arabia;687;24;324407;4213
2020-09-12;SA;Saudi Arabia;643;27;325050;4240
2020-09-13;SA;Saudi Arabia;601;28;325651;4268
2020-09-14;SA;Saudi Arabia;607;37;326258;4305
2020-09-15;SA;Saudi Arabia;672;33;326930;4338
2020-09-16;SA;Saudi Arabia;621;31;327551;4369
2020-09-17;SA;Saudi Arabia;593;30;328144;4399
2020-09-18;SA;Saudi Arabia;576;31;328720;4430
2020-09-19;SA;Saudi Arabia;551;28;329271;4458
2020-09-20;SA;Saudi Arabia;483;27;329754;4485
2020-09-21;SA;Saudi Arabia;492;27;330246;4512
2020-09-22;SA;Saudi Arabia;552;30;330798;4542
2020-09-23;SA;Saudi Arabia;561;27;331359;4569
2020-09-24;SA;Saudi Arabia;498;30;331857;4599
2020-09-25;SA;Saudi Arabia;472;26;332329;4625
2020-09-26;SA;Saudi Arabia;461;30;332790;4655
2020-09-27;SA;Saudi Arabia;403;28;333193;4683
2020-09-28;SA;Saudi Arabia;455;29;333648;4712
2020-09-29;SA;Saudi Arabia;539;27;334187;4739
2020-09-30;SA;Saudi Arabia;418;29;334605;4768
2020-10-01;SA;Saudi Arabia;492;26;335097;4794
2020-10-02;SA;Saudi Arabia;481;29;335578;4823
2020-10-03;SA;Saudi Arabia;419;27;335997;4850
2020-10-04;SA;Saudi Arabia;390;25;336387;4875
2020-10-05;SA;Saudi Arabia;379;23;336766;4898
2020-10-06;SA;Saudi Arabia;477;25;337243;4923
2020-10-07;SA;Saudi Arabia;468;24;337711;4947
2020-10-08;SA;Saudi Arabia;421;25;338132;4972
2020-10-09;SA;Saudi Arabia;407;24;338539;4996
2020-10-10;SA;Saudi Arabia;405;22;338944;5018
2020-10-11;SA;Saudi Arabia;323;25;339267;5043
2020-10-12;SA;Saudi Arabia;348;25;339615;5068
2020-10-13;SA;Saudi Arabia;474;19;340089;5087
2020-10-14;SA;Saudi Arabia;501;21;340590;5108
2020-10-15;SA;Saudi Arabia;472;19;341062;5127
2020-10-16;SA;Saudi Arabia;433;17;341495;5144
2020-10-17;SA;Saudi Arabia;359;21;341854;5165
2020-10-18;SA;Saudi Arabia;348;20;342202;5185
2020-10-19;SA;Saudi Arabia;381;16;342583;5201
2020-10-20;SA;Saudi Arabia;385;16;342968;5217
2020-10-21;SA;Saudi Arabia;405;18;343373;5235
2020-10-22;SA;Saudi Arabia;401;15;343774;5250
2020-10-23;SA;Saudi Arabia;383;14;344157;5264
2020-10-24;SA;Saudi Arabia;395;17;344552;5281
2020-10-25;SA;Saudi Arabia;323;15;344875;5296
2020-10-26;SA;Saudi Arabia;357;17;345232;5313
2020-10-27;SA;Saudi Arabia;399;16;345631;5329
2020-10-28;SA;Saudi Arabia;416;19;346047;5348
2020-10-29;SA;Saudi Arabia;435;15;346482;5363
2020-10-30;SA;Saudi Arabia;398;20;346880;5383
2020-10-31;SA;Saudi Arabia;402;19;347282;5402
2020-11-01;SA;Saudi Arabia;374;18;347656;5420
2020-11-02;SA;Saudi Arabia;381;17;348037;5437
2020-11-03;SA;Saudi Arabia;473;19;348510;5456
2020-11-04;SA;Saudi Arabia;426;15;348936;5471
2020-11-05;SA;Saudi Arabia;450;18;349386;5489
2020-11-06;SA;Saudi Arabia;436;17;349822;5506
2020-11-07;SA;Saudi Arabia;407;19;350229;5525
2020-11-08;SA;Saudi Arabia;363;15;350592;5540
2020-11-09;SA;Saudi Arabia;392;19;350984;5559
2020-11-10;SA;Saudi Arabia;471;17;351455;5576
2020-11-11;SA;Saudi Arabia;394;14;351849;5590
2020-11-12;SA;Saudi Arabia;311;15;352160;5605
2020-11-13;SA;Saudi Arabia;441;20;352601;5625
2020-11-14;SA;Saudi Arabia;349;16;352950;5641
2020-11-15;SA;Saudi Arabia;305;16;353255;5657
2020-11-16;SA;Saudi Arabia;301;19;353556;5676
2020-11-17;SA;Saudi Arabia;362;16;353918;5692
2020-11-18;SA;Saudi Arabia;290;18;354208;5710
2020-11-19;SA;Saudi Arabia;319;19;354527;5729
2020-11-20;SA;Saudi Arabia;286;16;354813;5745
2020-11-21;SA;Saudi Arabia;221;16;355034;5761
2020-11-22;SA;Saudi Arabia;224;19;355258;5780
2020-11-23;SA;Saudi Arabia;231;16;355489;5796
2020-11-24;SA;Saudi Arabia;252;15;355741;5811
2020-11-25;SA;Saudi Arabia;326;14;356067;5825
2020-11-26;SA;Saudi Arabia;322;15;356389;5840
2020-11-27;SA;Saudi Arabia;302;17;356691;5857
2020-11-28;SA;Saudi Arabia;220;13;356911;5870
2020-11-29;SA;Saudi Arabia;217;14;357128;5884
2020-11-30;SA;Saudi Arabia;232;12;357360;5896
2020-12-01;SA;Saudi Arabia;263;11;357623;5907
2020-12-02;SA;Saudi Arabia;249;12;357872;5919
2020-12-03;SA;Saudi Arabia;230;11;358102;5930
2020-12-04;SA;Saudi Arabia;234;10;358336;5940
2020-12-05;SA;Saudi Arabia;190;14;358526;5954
2020-12-06;SA;Saudi Arabia;187;11;358713;5965
2020-12-07;SA;Saudi Arabia;209;12;358922;5977
2020-12-08;SA;Saudi Arabia;193;12;359115;5989
2020-12-09;SA;Saudi Arabia;159;13;359274;6002
2020-12-10;SA;Saudi Arabia;141;10;359415;6012
2020-12-11;SA;Saudi Arabia;168;11;359583;6023
2020-12-12;SA;Saudi Arabia;166;13;359749;6036
2020-12-13;SA;Saudi Arabia;139;12;359888;6048
2020-12-14;SA;Saudi Arabia;125;11;360013;6059
2020-12-15;SA;Saudi Arabia;142;10;360155;6069
2020-12-16;SA;Saudi Arabia;180;11;360335;6080
2020-12-17;SA;Saudi Arabia;181;11;360516;6091
2020-12-18;SA;Saudi Arabia;174;10;360690;6101
2020-12-19;SA;Saudi Arabia;158;11;360848;6112
2020-12-20;SA;Saudi Arabia;162;10;361010;6122
2020-12-21;SA;Saudi Arabia;168;9;361178;6131
2020-12-22;SA;Saudi Arabia;181;8;361359;6139
2020-12-23;SA;Saudi Arabia;177;9;361536;6148
2020-12-24;SA;Saudi Arabia;189;11;361725;6159
2020-12-25;SA;Saudi Arabia;178;9;361903;6168
2020-12-26;SA;Saudi Arabia;163;8;362066;6176
2020-12-27;SA;Saudi Arabia;154;9;362220;6185
2020-12-28;SA;Saudi Arabia;119;11;362339;6196
2020-12-29;SA;Saudi Arabia;149;8;362488;6204
2020-12-30;SA;Saudi Arabia;113;10;362601;6214
2020-12-31;SA;Saudi Arabia;140;9;362741;6223
2021-01-01;SA;Saudi Arabia;137;7;362878;6230
2021-01-02;SA;Saudi Arabia;101;9;362979;6239
2021-01-03;SA;Saudi Arabia;82;7;363061;6246
2021-01-04;SA;Saudi Arabia;94;10;363155;6256
2021-01-05;SA;Saudi Arabia;104;9;363259;6265
2021-01-06;SA;Saudi Arabia;118;7;363377;6272
2021-01-07;SA;Saudi Arabia;108;6;363485;6278
2021-01-08;SA;Saudi Arabia;97;4;363582;6282
2021-01-09;SA;Saudi Arabia;110;4;363692;6286
2021-01-10;SA;Saudi Arabia;117;5;363809;6291
2021-01-11;SA;Saudi Arabia;140;4;363949;6295
2021-01-12;SA;Saudi Arabia;147;5;364096;6300
2021-01-13;SA;Saudi Arabia;175;4;364271;6304
2021-01-14;SA;Saudi Arabia;169;6;364440;6310
2021-01-15;SA;Saudi Arabia;173;3;364613;6313
2021-01-16;SA;Saudi Arabia;140;5;364753;6318
2021-01-17;SA;Saudi Arabia;176;5;364929;6323
2021-01-18;SA;Saudi Arabia;170;6;365099;6329
2021-01-19;SA;Saudi Arabia;226;6;365325;6335
2021-01-20;SA;Saudi Arabia;238;3;365563;6338
2021-01-21;SA;Saudi Arabia;212;4;365775;6342
2021-01-22;SA;Saudi Arabia;213;4;365988;6346
2021-01-23;SA;Saudi Arabia;197;4;366185;6350
2021-01-24;SA;Saudi Arabia;186;2;366371;6352
2021-01-25;SA;Saudi Arabia;213;3;366584;6355
2021-01-26;SA;Saudi Arabia;223;4;366807;6359
2021-01-27;SA;Saudi Arabia;216;4;367023;6363
2021-01-28;SA;Saudi Arabia;253;3;367276;6366
2021-01-29;SA;Saudi Arabia;267;2;367543;6368
2021-01-30;SA;Saudi Arabia;270;4;367813;6372
2021-01-31;SA;Saudi Arabia;261;3;368074;6375
2021-02-01;SA;Saudi Arabia;255;4;368329;6379
2021-02-02;SA;Saudi Arabia;310;4;368639;6383
2021-02-03;SA;Saudi Arabia;306;3;368945;6386
2021-02-04;SA;Saudi Arabia;303;3;369248;6389
2021-02-05;SA;Saudi Arabia;327;4;369575;6393
2021-02-06;SA;Saudi Arabia;386;4;369961;6397
2021-02-07;SA;Saudi Arabia;317;5;370278;6402
2021-02-08;SA;Saudi Arabia;356;4;370634;6406
2021-02-09;SA;Saudi Arabia;353;4;370987;6410
2021-02-10;SA;Saudi Arabia;369;5;371356;6415
2021-02-11;SA;Saudi Arabia;364;5;371720;6420
2021-02-12;SA;Saudi Arabia;353;4;372073;6424
2021-02-13;SA;Saudi Arabia;337;5;372410;6429
2021-02-14;SA;Saudi Arabia;322;4;372732;6433
2021-02-15;SA;Saudi Arabia;314;5;373046;6438
2021-02-16;SA;Saudi Arabia;322;3;373368;6441
2021-02-17;SA;Saudi Arabia;334;4;373702;6445
2021-02-18;SA;Saudi Arabia;327;5;374029;6450
2021-02-19;SA;Saudi Arabia;337;4;374366;6454
2021-02-20;SA;Saudi Arabia;325;3;374691;6457
2021-02-21;SA;Saudi Arabia;315;4;375006;6461
2021-02-22;SA;Saudi Arabia;327;5;375333;6466
2021-02-23;SA;Saudi Arabia;335;4;375668;6470
2021-02-24;SA;Saudi Arabia;353;5;376021;6475
2021-02-25;SA;Saudi Arabia;356;5;376377;6480
2021-02-26;SA;Saudi Arabia;346;3;376723;6483
2021-02-27;SA;Saudi Arabia;338;5;377061;6488
2021-02-28;SA;Saudi Arabia;322;6;377383;6494
2021-03-01;SA;Saudi Arabia;317;6;377700;6500
2021-03-02;SA;Saudi Arabia;302;5;378002;6505
2021-03-03;SA;Saudi Arabia;331;5;378333;6510
2021-03-04;SA;Saudi Arabia;375;4;378708;6514
2021-03-05;SA;Saudi Arabia;384;5;379092;6519
2021-03-06;SA;Saudi Arabia;382;5;379474;6524
2021-03-07;SA;Saudi Arabia;357;4;379831;6528
2021-03-08;SA;Saudi Arabia;351;6;380182;6534
2021-03-09;SA;Saudi Arabia;390;5;380572;6539
2021-03-10;SA;Saudi Arabia;386;6;380958;6545
2021-03-11;SA;Saudi Arabia;390;6;381348;6551
2021-03-12;SA;Saudi Arabia;360;5;381708;6556
2021-03-13;SA;Saudi Arabia;351;7;382059;6563
2021-03-14;SA;Saudi Arabia;348;4;382407;6567
2021-03-15;SA;Saudi Arabia;345;6;382752;6573
2021-03-16;SA;Saudi Arabia;354;5;383106;6578
2021-03-17;SA;Saudi Arabia;393;7;383499;6585
2021-03-18;SA;Saudi Arabia;381;6;383880;6591
2021-03-19;SA;Saudi Arabia;391;5;384271;6596
2021-03-20;SA;Saudi Arabia;382;6;384653;6602
2021-03-21;SA;Saudi Arabia;367;7;385020;6609
2021-03-22;SA;Saudi Arabia;404;4;385424;6613
2021-03-23;SA;Saudi Arabia;410;5;385834;6618
2021-03-24;SA;Saudi Arabia;466;6;386300;6624
2021-03-25;SA;Saudi Arabia;482;6;386782;6630
2021-03-26;SA;Saudi Arabia;510;7;387292;6637
2021-03-27;SA;Saudi Arabia;502;6;387794;6643
2021-03-28;SA;Saudi Arabia;531;7;388325;6650
2021-03-29;SA;Saudi Arabia;541;6;388866;6656
2021-03-30;SA;Saudi Arabia;556;7;389422;6663
2021-03-31;SA;Saudi Arabia;585;6;390007;6669
2021-04-01;SA;Saudi Arabia;590;7;390597;6676
2021-04-02;SA;Saudi Arabia;728;8;391325;6684
2021-04-03;SA;Saudi Arabia;684;6;392009;6690
2021-04-04;SA;Saudi Arabia;673;7;392682;6697
2021-04-05;SA;Saudi Arabia;695;7;393377;6704
2021-04-06;SA;Saudi Arabia;792;7;394169;6711
2021-04-07;SA;Saudi Arabia;783;8;394952;6719
2021-04-08;SA;Saudi Arabia;902;9;395854;6728
2021-04-09;SA;Saudi Arabia;904;9;396758;6737
2021-04-10;SA;Saudi Arabia;878;10;397636;6747
2021-04-11;SA;Saudi Arabia;799;7;398435;6754
2021-04-12;SA;Saudi Arabia;842;11;399277;6765
2021-04-13;SA;Saudi Arabia;951;8;400228;6773
2021-04-14;SA;Saudi Arabia;929;8;401157;6781
2021-04-15;SA;Saudi Arabia;985;10;402142;6791
2021-04-16;SA;Saudi Arabia;964;10;403106;6801
2021-04-17;SA;Saudi Arabia;948;9;404054;6810
2021-04-18;SA;Saudi Arabia;916;13;404970;6823
2021-04-19;SA;Saudi Arabia;970;11;405940;6834
2021-04-20;SA;Saudi Arabia;1070;12;407010;6846
2021-04-21;SA;Saudi Arabia;1028;12;408038;6858
2021-04-22;SA;Saudi Arabia;1055;11;409093;6869
2021-04-23;SA;Saudi Arabia;1098;9;410191;6878
2021-04-24;SA;Saudi Arabia;1072;9;411263;6887
2021-04-25;SA;Saudi Arabia;953;13;412216;6900
2021-04-26;SA;Saudi Arabia;958;13;413174;6913
2021-04-27;SA;Saudi Arabia;1045;9;414219;6922
2021-04-28;SA;Saudi Arabia;1062;13;415281;6935
2021-04-29;SA;Saudi Arabia;1026;11;416307;6946
2021-04-30;SA;Saudi Arabia;1056;11;417363;6957
2021-05-01;SA;Saudi Arabia;1048;11;418411;6968
2021-05-02;SA;Saudi Arabia;937;11;419348;6979
2021-05-03;SA;Saudi Arabia;953;13;420301;6992
2021-05-04;SA;Saudi Arabia;999;14;421300;7006
2021-05-05;SA;Saudi Arabia;1016;12;422316;7018
2021-05-06;SA;Saudi Arabia;1090;14;423406;7032
2021-05-07;SA;Saudi Arabia;1039;13;424445;7045
2021-05-08;SA;Saudi Arabia;997;14;425442;7059
2021-05-09;SA;Saudi Arabia;942;13;426384;7072
2021-05-10;SA;Saudi Arabia;986;13;427370;7085
2021-05-11;SA;Saudi Arabia;999;13;428369;7098
2021-05-12;SA;Saudi Arabia;1020;13;429389;7111
2021-05-13;SA;Saudi Arabia;1116;11;430505;7122
2021-05-14;SA;Saudi Arabia;927;12;431432;7134
2021-05-15;SA;Saudi Arabia;837;13;432269;7147
2021-05-16;SA;Saudi Arabia;825;15;433094;7162
2021-05-17;SA;Saudi Arabia;886;12;433980;7174
2021-05-18;SA;Saudi Arabia;1047;14;435027;7188
2021-05-19;SA;Saudi Arabia;1212;13;436239;7201
2021-05-20;SA;Saudi Arabia;1330;13;437569;7214
2021-05-21;SA;Saudi Arabia;1136;10;438705;7224
2021-05-22;SA;Saudi Arabia;1142;13;439847;7237
2021-05-23;SA;Saudi Arabia;1067;12;440914;7249
2021-05-24;SA;Saudi Arabia;1157;15;442071;7264
2021-05-25;SA;Saudi Arabia;1389;14;443460;7278
2021-05-26;SA;Saudi Arabia;1320;17;444780;7295
2021-05-27;SA;Saudi Arabia;1183;14;445963;7309
2021-05-28;SA;Saudi Arabia;1215;11;447178;7320
2021-05-29;SA;Saudi Arabia;1106;14;448284;7334
2021-05-30;SA;Saudi Arabia;907;13;449191;7347
2021-05-31;SA;Saudi Arabia;1245;15;450436;7362
2021-06-01;SA;Saudi Arabia;1251;15;451687;7377
2021-06-02;SA;Saudi Arabia;1269;16;452956;7393
2021-06-03;SA;Saudi Arabia;1261;15;454217;7408
2021-06-04;SA;Saudi Arabia;1201;16;455418;7424
2021-06-05;SA;Saudi Arabia;1144;16;456562;7440
2021-06-06;SA;Saudi Arabia;984;16;457546;7456
2021-06-07;SA;Saudi Arabia;1161;15;458707;7471
2021-06-08;SA;Saudi Arabia;1261;17;459968;7488
2021-06-09;SA;Saudi Arabia;1274;15;461242;7503
2021-06-10;SA;Saudi Arabia;0;0;461242;7503
2021-06-11;SA;Saudi Arabia;2461;34;463703;7537
2021-06-12;SA;Saudi Arabia;1077;16;464780;7553
2021-06-13;SA;Saudi Arabia;1017;19;465797;7572
2021-06-14;SA;Saudi Arabia;1109;18;466906;7590
2021-06-15;SA;Saudi Arabia;1269;16;468175;7606
2021-06-16;SA;Saudi Arabia;1239;15;469414;7621
2021-06-17;SA;Saudi Arabia;1309;14;470723;7635
2021-06-18;SA;Saudi Arabia;1236;15;471959;7650
2021-06-19;SA;Saudi Arabia;1153;13;473112;7663
2021-06-20;SA;Saudi Arabia;1079;14;474191;7677
2021-06-21;SA;Saudi Arabia;1212;14;475403;7691
2021-06-22;SA;Saudi Arabia;1479;12;476882;7703
2021-06-23;SA;Saudi Arabia;1253;13;478135;7716
2021-06-24;SA;Saudi Arabia;1255;14;479390;7730
2021-06-25;SA;Saudi Arabia;1312;13;480702;7743
2021-06-26;SA;Saudi Arabia;1301;17;482003;7760
2021-06-27;SA;Saudi Arabia;1218;15;483221;7775
2021-06-28;SA;Saudi Arabia;1318;14;484539;7789
2021-06-29;SA;Saudi Arabia;1567;15;486106;7804
2021-06-30;SA;Saudi Arabia;0;0;486106;7804
2021-07-01;SA;Saudi Arabia;0;0;486106;7804
2020-02-28;SN;Senegal;0;0;0;0
2020-02-29;SN;Senegal;0;0;0;0
2020-03-01;SN;Senegal;0;0;0;0
2020-03-02;SN;Senegal;1;0;1;0
2020-03-03;SN;Senegal;1;0;2;0
2020-03-04;SN;Senegal;2;0;4;0
2020-03-05;SN;Senegal;0;0;4;0
2020-03-06;SN;Senegal;0;0;4;0
2020-03-07;SN;Senegal;0;0;4;0
2020-03-08;SN;Senegal;0;0;4;0
2020-03-09;SN;Senegal;0;0;4;0
2020-03-10;SN;Senegal;0;0;4;0
2020-03-11;SN;Senegal;0;0;4;0
2020-03-12;SN;Senegal;0;0;4;0
2020-03-13;SN;Senegal;6;0;10;0
2020-03-14;SN;Senegal;0;0;10;0
2020-03-15;SN;Senegal;14;0;24;0
2020-03-16;SN;Senegal;0;0;24;0
2020-03-17;SN;Senegal;2;0;26;0
2020-03-18;SN;Senegal;5;0;31;0
2020-03-19;SN;Senegal;0;0;31;0
2020-03-20;SN;Senegal;7;0;38;0
2020-03-21;SN;Senegal;9;0;47;0
2020-03-22;SN;Senegal;20;0;67;0
2020-03-23;SN;Senegal;12;0;79;0
2020-03-24;SN;Senegal;7;0;86;0
2020-03-25;SN;Senegal;13;0;99;0
2020-03-26;SN;Senegal;6;0;105;0
2020-03-27;SN;Senegal;14;0;119;0
2020-03-28;SN;Senegal;11;0;130;0
2020-03-29;SN;Senegal;12;0;142;0
2020-03-30;SN;Senegal;20;0;162;0
2020-03-31;SN;Senegal;13;0;175;0
2020-04-01;SN;Senegal;15;1;190;1
2020-04-02;SN;Senegal;5;0;195;1
2020-04-03;SN;Senegal;12;0;207;1
2020-04-04;SN;Senegal;12;1;219;2
2020-04-05;SN;Senegal;3;0;222;2
2020-04-06;SN;Senegal;4;0;226;2
2020-04-07;SN;Senegal;11;0;237;2
2020-04-08;SN;Senegal;7;0;244;2
2020-04-09;SN;Senegal;6;0;250;2
2020-04-10;SN;Senegal;15;0;265;2
2020-04-11;SN;Senegal;13;0;278;2
2020-04-12;SN;Senegal;2;0;280;2
2020-04-13;SN;Senegal;11;0;291;2
2020-04-14;SN;Senegal;8;0;299;2
2020-04-15;SN;Senegal;15;0;314;2
2020-04-16;SN;Senegal;21;0;335;2
2020-04-17;SN;Senegal;7;0;342;2
2020-04-18;SN;Senegal;8;1;350;3
2020-04-19;SN;Senegal;17;0;367;3
2020-04-20;SN;Senegal;10;2;377;5
2020-04-21;SN;Senegal;35;0;412;5
2020-04-22;SN;Senegal;30;1;442;6
2020-04-23;SN;Senegal;37;0;479;6
2020-04-24;SN;Senegal;66;1;545;7
2020-04-25;SN;Senegal;69;0;614;7
2020-04-26;SN;Senegal;57;2;671;9
2020-04-27;SN;Senegal;65;0;736;9
2020-04-28;SN;Senegal;87;0;823;9
2020-04-29;SN;Senegal;59;0;882;9
2020-04-30;SN;Senegal;51;0;933;9
2020-05-01;SN;Senegal;91;0;1024;9
2020-05-02;SN;Senegal;91;0;1115;9
2020-05-03;SN;Senegal;67;0;1182;9
2020-05-04;SN;Senegal;89;1;1271;10
2020-05-05;SN;Senegal;58;1;1329;11
2020-05-06;SN;Senegal;104;1;1433;12
2020-05-07;SN;Senegal;59;1;1492;13
2020-05-08;SN;Senegal;59;0;1551;13
2020-05-09;SN;Senegal;83;4;1634;17
2020-05-10;SN;Senegal;75;2;1709;19
2020-05-11;SN;Senegal;177;0;1886;19
2020-05-12;SN;Senegal;109;0;1995;19
2020-05-13;SN;Senegal;110;2;2105;21
2020-05-14;SN;Senegal;84;2;2189;23
2020-05-15;SN;Senegal;121;2;2310;25
2020-05-16;SN;Senegal;119;0;2429;25
2020-05-17;SN;Senegal;51;0;2480;25
2020-05-18;SN;Senegal;64;1;2544;26
2020-05-19;SN;Senegal;73;4;2617;30
2020-05-20;SN;Senegal;97;0;2714;30
2020-05-21;SN;Senegal;98;3;2812;33
2020-05-22;SN;Senegal;97;0;2909;33
2020-05-23;SN;Senegal;67;1;2976;34
2020-05-24;SN;Senegal;71;1;3047;35
2020-05-25;SN;Senegal;83;0;3130;35
2020-05-26;SN;Senegal;31;1;3161;36
2020-05-27;SN;Senegal;92;2;3253;38
2020-05-28;SN;Senegal;95;1;3348;39
2020-05-29;SN;Senegal;81;2;3429;41
2020-05-30;SN;Senegal;106;1;3535;42
2020-05-31;SN;Senegal;110;0;3645;42
2020-06-01;SN;Senegal;94;0;3739;42
2020-06-02;SN;Senegal;97;1;3836;43
2020-06-03;SN;Senegal;96;2;3932;45
2020-06-04;SN;Senegal;89;0;4021;45
2020-06-05;SN;Senegal;134;0;4155;45
2020-06-06;SN;Senegal;94;2;4249;47
2020-06-07;SN;Senegal;79;2;4328;49
2020-06-08;SN;Senegal;99;0;4427;49
2020-06-09;SN;Senegal;89;3;4516;52
2020-06-10;SN;Senegal;124;0;4640;52
2020-06-11;SN;Senegal;119;3;4759;55
2020-06-12;SN;Senegal;92;1;4851;56
2020-06-13;SN;Senegal;145;4;4996;60
2020-06-14;SN;Senegal;94;0;5090;60
2020-06-15;SN;Senegal;83;4;5173;64
2020-06-16;SN;Senegal;74;6;5247;70
2020-06-17;SN;Senegal;122;3;5369;73
2020-06-18;SN;Senegal;106;3;5475;76
2020-06-19;SN;Senegal;164;3;5639;79
2020-06-20;SN;Senegal;144;3;5783;82
2020-06-21;SN;Senegal;105;2;5888;84
2020-06-22;SN;Senegal;82;2;5970;86
2020-06-23;SN;Senegal;64;3;6034;89
2020-06-24;SN;Senegal;95;4;6129;93
2020-06-25;SN;Senegal;104;1;6233;94
2020-06-26;SN;Senegal;121;4;6354;98
2020-06-27;SN;Senegal;105;4;6459;102
2020-06-28;SN;Senegal;127;3;6586;105
2020-06-29;SN;Senegal;112;3;6698;108
2020-06-30;SN;Senegal;95;4;6793;112
2020-07-01;SN;Senegal;132;4;6925;116
2020-07-02;SN;Senegal;129;5;7054;121
2020-07-03;SN;Senegal;110;4;7164;125
2020-07-04;SN;Senegal;108;4;7272;129
2020-07-05;SN;Senegal;128;4;7400;133
2020-07-06;SN;Senegal;78;3;7478;136
2020-07-07;SN;Senegal;69;1;7547;137
2020-07-08;SN;Senegal;110;4;7657;141
2020-07-09;SN;Senegal;127;2;7784;143
2020-07-10;SN;Senegal;98;2;7882;145
2020-07-11;SN;Senegal;132;0;8014;145
2020-07-12;SN;Senegal;121;3;8135;148
2020-07-13;SN;Senegal;63;2;8198;150
2020-07-14;SN;Senegal;45;0;8243;150
2020-07-15;SN;Senegal;126;3;8369;153
2020-07-16;SN;Senegal;112;3;8481;156
2020-07-17;SN;Senegal;63;4;8544;160
2020-07-18;SN;Senegal;125;3;8669;163
2020-07-19;SN;Senegal;141;4;8810;167
2020-07-20;SN;Senegal;138;3;8948;170
2020-07-21;SN;Senegal;37;4;8985;174
2020-07-22;SN;Senegal;136;3;9121;177
2020-07-23;SN;Senegal;145;1;9266;178
2020-07-24;SN;Senegal;156;4;9422;182
2020-07-25;SN;Senegal;130;5;9552;187
2020-07-26;SN;Senegal;129;4;9681;191
2020-07-27;SN;Senegal;83;3;9764;194
2020-07-28;SN;Senegal;41;4;9805;198
2020-07-29;SN;Senegal;156;2;9961;200
2020-07-30;SN;Senegal;145;4;10106;204
2020-07-31;SN;Senegal;126;1;10232;205
2020-08-01;SN;Senegal;52;4;10284;209
2020-08-02;SN;Senegal;60;0;10344;209
2020-08-03;SN;Senegal;42;2;10386;211
2020-08-04;SN;Senegal;46;3;10432;214
2020-08-05;SN;Senegal;106;4;10538;218
2020-08-06;SN;Senegal;177;5;10715;223
2020-08-07;SN;Senegal;172;2;10887;225
2020-08-08;SN;Senegal;116;4;11003;229
2020-08-09;SN;Senegal;172;3;11175;232
2020-08-10;SN;Senegal;137;4;11312;236
2020-08-11;SN;Senegal;68;2;11380;238
2020-08-12;SN;Senegal;207;4;11587;242
2020-08-13;SN;Senegal;153;2;11740;244
2020-08-14;SN;Senegal;132;5;11872;249
2020-08-15;SN;Senegal;160;2;12032;251
2020-08-16;SN;Senegal;130;2;12162;253
2020-08-17;SN;Senegal;75;3;12237;256
2020-08-18;SN;Senegal;68;0;12305;256
2020-08-19;SN;Senegal;141;2;12446;258
2020-08-20;SN;Senegal;113;3;12559;261
2020-08-21;SN;Senegal;130;1;12689;262
2020-08-22;SN;Senegal;161;4;12850;266
2020-08-23;SN;Senegal;99;3;12949;269
2020-08-24;SN;Senegal;64;3;13013;272
2020-08-25;SN;Senegal;43;2;13056;274
2020-08-26;SN;Senegal;130;1;13186;275
2020-08-27;SN;Senegal;108;2;13294;277
2020-08-28;SN;Senegal;90;2;13384;279
2020-08-29;SN;Senegal;72;3;13456;282
2020-08-30;SN;Senegal;100;2;13556;284
2020-08-31;SN;Senegal;55;0;13611;284
2020-09-01;SN;Senegal;44;0;13655;284
2020-09-02;SN;Senegal;88;3;13743;287
2020-09-03;SN;Senegal;83;0;13826;287
2020-09-04;SN;Senegal;55;2;13881;289
2020-09-05;SN;Senegal;67;1;13948;290
2020-09-06;SN;Senegal;39;0;13987;290
2020-09-07;SN;Senegal;27;1;14014;291
2020-09-08;SN;Senegal;30;1;14044;292
2020-09-09;SN;Senegal;58;1;14102;293
2020-09-10;SN;Senegal;48;0;14150;293
2020-09-11;SN;Senegal;43;0;14193;293
2020-09-12;SN;Senegal;44;2;14237;295
2020-09-13;SN;Senegal;43;2;14280;297
2020-09-14;SN;Senegal;26;0;14306;297
2020-09-15;SN;Senegal;223;1;14529;298
2020-09-16;SN;Senegal;39;1;14568;299
2020-09-17;SN;Senegal;50;1;14618;300
2020-09-18;SN;Senegal;27;1;14645;301
2020-09-19;SN;Senegal;43;1;14688;302
2020-09-20;SN;Senegal;26;0;14714;302
2020-09-21;SN;Senegal;24;0;14738;302
2020-09-22;SN;Senegal;21;0;14759;302
2020-09-23;SN;Senegal;36;1;14795;303
2020-09-24;SN;Senegal;21;1;14816;304
2020-09-25;SN;Senegal;23;0;14839;304
2020-09-26;SN;Senegal;30;2;14869;306
2020-09-27;SN;Senegal;40;2;14909;308
2020-09-28;SN;Senegal;10;1;14919;309
2020-09-29;SN;Senegal;26;1;14945;310
2020-09-30;SN;Senegal;37;1;14982;311
2020-10-01;SN;Senegal;37;0;15019;311
2020-10-02;SN;Senegal;32;1;15051;312
2020-10-03;SN;Senegal;17;0;15068;312
2020-10-04;SN;Senegal;26;0;15094;312
2020-10-05;SN;Senegal;28;0;15122;312
2020-10-06;SN;Senegal;19;0;15141;312
2020-10-07;SN;Senegal;33;1;15174;313
2020-10-08;SN;Senegal;16;0;15190;313
2020-10-09;SN;Senegal;23;0;15213;313
2020-10-10;SN;Senegal;31;1;15244;314
2020-10-11;SN;Senegal;24;0;15268;314
2020-10-12;SN;Senegal;24;1;15292;315
2020-10-13;SN;Senegal;15;0;15307;315
2020-10-14;SN;Senegal;24;1;15331;316
2020-10-15;SN;Senegal;17;0;15348;316
2020-10-16;SN;Senegal;20;1;15368;317
2020-10-17;SN;Senegal;24;0;15392;317
2020-10-18;SN;Senegal;26;0;15418;317
2020-10-19;SN;Senegal;14;2;15432;319
2020-10-20;SN;Senegal;27;1;15459;320
2020-10-21;SN;Senegal;25;1;15484;321
2020-10-22;SN;Senegal;24;0;15508;321
2020-10-23;SN;Senegal;17;0;15525;321
2020-10-24;SN;Senegal;18;0;15543;321
2020-10-25;SN;Senegal;8;0;15551;321
2020-10-26;SN;Senegal;14;1;15565;322
2020-10-27;SN;Senegal;6;0;15571;322
2020-10-28;SN;Senegal;11;0;15582;322
2020-10-29;SN;Senegal;11;1;15593;323
2020-10-30;SN;Senegal;12;0;15605;323
2020-10-31;SN;Senegal;11;1;15616;324
2020-11-01;SN;Senegal;14;1;15630;325
2020-11-02;SN;Senegal;7;0;15637;325
2020-11-03;SN;Senegal;3;1;15640;326
2020-11-04;SN;Senegal;10;0;15650;326
2020-11-05;SN;Senegal;18;0;15668;326
2020-11-06;SN;Senegal;8;0;15676;326
2020-11-07;SN;Senegal;17;0;15693;326
2020-11-08;SN;Senegal;15;0;15708;326
2020-11-09;SN;Senegal;3;0;15711;326
2020-11-10;SN;Senegal;9;0;15720;326
2020-11-11;SN;Senegal;15;0;15735;326
2020-11-12;SN;Senegal;9;0;15744;326
2020-11-13;SN;Senegal;11;0;15755;326
2020-11-14;SN;Senegal;24;1;15779;327
2020-11-15;SN;Senegal;14;1;15793;328
2020-11-16;SN;Senegal;8;1;15801;329
2020-11-17;SN;Senegal;5;0;15806;329
2020-11-18;SN;Senegal;17;0;15823;329
2020-11-19;SN;Senegal;12;0;15835;329
2020-11-20;SN;Senegal;13;1;15848;330
2020-11-21;SN;Senegal;17;0;15865;330
2020-11-22;SN;Senegal;17;0;15882;330
2020-11-23;SN;Senegal;15;0;15897;330
2020-11-24;SN;Senegal;11;1;15908;331
2020-11-25;SN;Senegal;19;0;15927;331
2020-11-26;SN;Senegal;33;0;15960;331
2020-11-27;SN;Senegal;21;1;15981;332
2020-11-28;SN;Senegal;46;0;16027;332
2020-11-29;SN;Senegal;48;1;16075;333
2020-11-30;SN;Senegal;14;0;16089;333
2020-12-01;SN;Senegal;18;0;16107;333
2020-12-02;SN;Senegal;66;1;16173;334
2020-12-03;SN;Senegal;44;1;16217;335
2020-12-04;SN;Senegal;80;1;16297;336
2020-12-05;SN;Senegal;100;1;16397;337
2020-12-06;SN;Senegal;80;1;16477;338
2020-12-07;SN;Senegal;76;2;16553;340
2020-12-08;SN;Senegal;43;0;16596;340
2020-12-09;SN;Senegal;69;1;16665;341
2020-12-10;SN;Senegal;101;2;16766;343
2020-12-11;SN;Senegal;127;2;16893;345
2020-12-12;SN;Senegal;168;4;17061;349
2020-12-13;SN;Senegal;14;0;17075;349
2020-12-14;SN;Senegal;71;1;17146;350
2020-12-15;SN;Senegal;70;0;17216;350
2020-12-16;SN;Senegal;120;2;17336;352
2020-12-17;SN;Senegal;115;3;17451;355
2020-12-18;SN;Senegal;108;2;17559;357
2020-12-19;SN;Senegal;111;4;17670;361
2020-12-20;SN;Senegal;88;4;17758;365
2020-12-21;SN;Senegal;121;6;17879;371
2020-12-22;SN;Senegal;66;1;17945;372
2020-12-23;SN;Senegal;98;6;18043;378
2020-12-24;SN;Senegal;157;3;18200;381
2020-12-25;SN;Senegal;169;5;18369;386
2020-12-26;SN;Senegal;154;1;18523;387
2020-12-27;SN;Senegal;86;1;18609;388
2020-12-28;SN;Senegal;119;2;18728;390
2020-12-29;SN;Senegal;78;5;18806;395
2020-12-30;SN;Senegal;139;7;18945;402
2020-12-31;SN;Senegal;195;8;19140;410
2021-01-01;SN;Senegal;224;0;19364;410
2021-01-02;SN;Senegal;147;6;19511;416
2021-01-03;SN;Senegal;186;5;19697;421
2021-01-04;SN;Senegal;106;3;19803;424
2021-01-05;SN;Senegal;161;4;19964;428
2021-01-06;SN;Senegal;192;5;20156;433
2021-01-07;SN;Senegal;220;5;20376;438
2021-01-08;SN;Senegal;296;8;20672;446
2021-01-09;SN;Senegal;328;13;21000;459
2021-01-10;SN;Senegal;245;6;21245;465
2021-01-11;SN;Senegal;288;4;21533;469
2021-01-12;SN;Senegal;152;11;21685;480
2021-01-13;SN;Senegal;198;9;21883;489
2021-01-14;SN;Senegal;295;7;22178;496
2021-01-15;SN;Senegal;218;10;22396;506
2021-01-16;SN;Senegal;342;3;22738;509
2021-01-17;SN;Senegal;290;6;23028;515
2021-01-18;SN;Senegal;196;11;23224;526
2021-01-19;SN;Senegal;168;10;23392;536
2021-01-20;SN;Senegal;250;10;23642;546
2021-01-21;SN;Senegal;267;6;23909;552
2021-01-22;SN;Senegal;300;9;24209;561
2021-01-23;SN;Senegal;250;8;24459;569
2021-01-24;SN;Senegal;268;6;24727;575
2021-01-25;SN;Senegal;266;7;24993;582
2021-01-26;SN;Senegal;134;10;25127;592
2021-01-27;SN;Senegal;280;9;25407;601
2021-01-28;SN;Senegal;304;13;25711;614
2021-01-29;SN;Senegal;184;3;25895;617
2021-01-30;SN;Senegal;318;4;26213;621
2021-01-31;SN;Senegal;310;7;26523;628
2021-02-01;SN;Senegal;404;10;26927;638
2021-02-02;SN;Senegal;153;3;27080;641
2021-02-03;SN;Senegal;285;7;27365;648
2021-02-04;SN;Senegal;368;11;27733;659
2021-02-05;SN;Senegal;373;7;28106;666
2021-02-06;SN;Senegal;383;9;28489;675
2021-02-07;SN;Senegal;271;7;28760;682
2021-02-08;SN;Senegal;297;7;29057;689
2021-02-09;SN;Senegal;188;11;29245;700
2021-02-10;SN;Senegal;276;12;29521;712
2021-02-11;SN;Senegal;393;12;29914;724
2021-02-12;SN;Senegal;462;11;30376;735
2021-02-13;SN;Senegal;265;6;30641;741
2021-02-14;SN;Senegal;366;7;31007;748
2021-02-15;SN;Senegal;268;6;31275;754
2021-02-16;SN;Senegal;201;6;31476;760
2021-02-17;SN;Senegal;295;9;31771;769
2021-02-18;SN;Senegal;328;12;32099;781
2021-02-19;SN;Senegal;279;6;32378;787
2021-02-20;SN;Senegal;252;8;32630;795
2021-02-21;SN;Senegal;297;13;32927;808
2021-02-22;SN;Senegal;172;6;33099;814
2021-02-23;SN;Senegal;143;18;33242;832
2021-02-24;SN;Senegal;211;8;33453;840
2021-02-25;SN;Senegal;288;12;33741;852
2021-02-26;SN;Senegal;290;5;34031;857
2021-02-27;SN;Senegal;224;9;34255;866
2021-02-28;SN;Senegal;265;6;34520;872
2021-03-01;SN;Senegal;212;8;34732;880
2021-03-02;SN;Senegal;100;8;34832;888
2021-03-03;SN;Senegal;205;8;35037;896
2021-03-04;SN;Senegal;210;2;35247;898
2021-03-05;SN;Senegal;221;5;35468;903
2021-03-06;SN;Senegal;164;4;35632;907
2021-03-07;SN;Senegal;225;12;35857;919
2021-03-08;SN;Senegal;102;6;35959;925
2021-03-09;SN;Senegal;80;5;36039;930
2021-03-10;SN;Senegal;156;5;36195;935
2021-03-11;SN;Senegal;176;6;36371;941
2021-03-12;SN;Senegal;198;10;36569;951
2021-03-13;SN;Senegal;157;4;36726;955
2021-03-14;SN;Senegal;166;8;36892;963
2021-03-15;SN;Senegal;104;15;36996;978
2021-03-16;SN;Senegal;66;3;37062;981
2021-03-17;SN;Senegal;192;9;37254;990
2021-03-18;SN;Senegal;174;5;37428;995
2021-03-19;SN;Senegal;113;8;37541;1003
2021-03-20;SN;Senegal;152;4;37693;1007
2021-03-21;SN;Senegal;140;6;37833;1013
2021-03-22;SN;Senegal;87;3;37920;1016
2021-03-23;SN;Senegal;38;4;37958;1020
2021-03-24;SN;Senegal;176;3;38134;1023
2021-03-25;SN;Senegal;121;5;38255;1028
2021-03-26;SN;Senegal;99;3;38354;1031
2021-03-27;SN;Senegal;102;3;38456;1034
2021-03-28;SN;Senegal;64;3;38520;1037
2021-03-29;SN;Senegal;46;7;38566;1044
2021-03-30;SN;Senegal;52;5;38618;1049
2021-03-31;SN;Senegal;87;2;38705;1051
2021-04-01;SN;Senegal;77;3;38782;1054
2021-04-02;SN;Senegal;107;2;38889;1056
2021-04-03;SN;Senegal;64;7;38953;1063
2021-04-04;SN;Senegal;71;0;39024;1063
2021-04-05;SN;Senegal;69;0;39093;1063
2021-04-06;SN;Senegal;34;2;39127;1065
2021-04-07;SN;Senegal;37;5;39164;1070
2021-04-08;SN;Senegal;73;3;39237;1073
2021-04-09;SN;Senegal;70;1;39307;1074
2021-04-10;SN;Senegal;57;3;39364;1077
2021-04-11;SN;Senegal;67;1;39431;1078
2021-04-12;SN;Senegal;34;1;39465;1079
2021-04-13;SN;Senegal;30;2;39495;1081
2021-04-14;SN;Senegal;65;3;39560;1084
2021-04-15;SN;Senegal;46;1;39606;1085
2021-04-16;SN;Senegal;58;2;39664;1087
2021-04-17;SN;Senegal;67;3;39731;1090
2021-04-18;SN;Senegal;51;1;39782;1091
2021-04-19;SN;Senegal;39;0;39821;1091
2021-04-20;SN;Senegal;15;4;39836;1095
2021-04-21;SN;Senegal;74;1;39910;1096
2021-04-22;SN;Senegal;65;1;39975;1097
2021-04-23;SN;Senegal;47;0;40022;1097
2021-04-24;SN;Senegal;60;2;40082;1099
2021-04-25;SN;Senegal;53;3;40135;1102
2021-04-26;SN;Senegal;31;2;40166;1104
2021-04-27;SN;Senegal;27;2;40193;1106
2021-04-28;SN;Senegal;56;1;40249;1107
2021-04-29;SN;Senegal;46;0;40295;1107
2021-04-30;SN;Senegal;49;0;40344;1107
2021-05-01;SN;Senegal;44;2;40388;1109
2021-05-02;SN;Senegal;45;1;40433;1110
2021-05-03;SN;Senegal;31;1;40464;1111
2021-05-04;SN;Senegal;28;0;40492;1111
2021-05-05;SN;Senegal;52;3;40544;1114
2021-05-06;SN;Senegal;34;2;40578;1116
2021-05-07;SN;Senegal;43;0;40621;1116
2021-05-08;SN;Senegal;44;1;40665;1117
2021-05-09;SN;Senegal;27;2;40692;1119
2021-05-10;SN;Senegal;22;1;40714;1120
2021-05-11;SN;Senegal;15;0;40729;1120
2021-05-12;SN;Senegal;33;1;40762;1121
2021-05-13;SN;Senegal;28;1;40790;1122
2021-05-14;SN;Senegal;16;0;40806;1122
2021-05-15;SN;Senegal;22;2;40828;1124
2021-05-16;SN;Senegal;22;1;40850;1125
2021-05-17;SN;Senegal;22;2;40872;1127
2021-05-18;SN;Senegal;24;1;40896;1128
2021-05-19;SN;Senegal;29;0;40925;1128
2021-05-20;SN;Senegal;36;0;40961;1128
2021-05-21;SN;Senegal;62;1;41023;1129
2021-05-22;SN;Senegal;39;1;41062;1130
2021-05-23;SN;Senegal;28;2;41090;1132
2021-05-24;SN;Senegal;52;0;41142;1132
2021-05-25;SN;Senegal;16;2;41158;1134
2021-05-26;SN;Senegal;23;1;41181;1135
2021-05-27;SN;Senegal;67;1;41248;1136
2021-05-28;SN;Senegal;48;2;41296;1138
2021-05-29;SN;Senegal;35;0;41331;1138
2021-05-30;SN;Senegal;56;0;41387;1138
2021-05-31;SN;Senegal;29;1;41416;1139
2021-06-01;SN;Senegal;17;1;41433;1140
2021-06-02;SN;Senegal;61;2;41494;1142
2021-06-03;SN;Senegal;45;2;41539;1144
2021-06-04;SN;Senegal;42;0;41581;1144
2021-06-05;SN;Senegal;50;1;41631;1145
2021-06-06;SN;Senegal;49;1;41680;1146
2021-06-07;SN;Senegal;33;2;41713;1148
2021-06-08;SN;Senegal;12;2;41725;1150
2021-06-09;SN;Senegal;71;0;41796;1150
2021-06-10;SN;Senegal;54;0;41850;1150
2021-06-11;SN;Senegal;50;0;41900;1150
2021-06-12;SN;Senegal;52;0;41952;1150
2021-06-13;SN;Senegal;46;4;41998;1154
2021-06-14;SN;Senegal;25;1;42023;1155
2021-06-15;SN;Senegal;27;1;42050;1156
2021-06-16;SN;Senegal;68;0;42118;1156
2021-06-17;SN;Senegal;88;2;42206;1158
2021-06-18;SN;Senegal;53;0;42259;1158
2021-06-19;SN;Senegal;74;0;42333;1158
2021-06-20;SN;Senegal;71;0;42404;1158
2021-06-21;SN;Senegal;33;0;42437;1158
2021-06-22;SN;Senegal;35;1;42472;1159
2021-06-23;SN;Senegal;118;0;42590;1159
2021-06-24;SN;Senegal;87;0;42677;1159
2021-06-25;SN;Senegal;70;2;42747;1161
2021-06-26;SN;Senegal;104;2;42851;1163
2021-06-27;SN;Senegal;53;1;42904;1164
2021-06-28;SN;Senegal;25;0;42929;1164
2021-06-29;SN;Senegal;28;2;42957;1166
2021-06-30;SN;Senegal;171;0;43128;1166
2021-07-01;SN;Senegal;140;2;43268;1168
2020-02-26;RS;Serbia;0;0;0;0
2020-02-27;RS;Serbia;0;0;0;0
2020-02-28;RS;Serbia;0;0;0;0
2020-02-29;RS;Serbia;0;0;0;0
2020-03-01;RS;Serbia;0;0;0;0
2020-03-02;RS;Serbia;0;0;0;0
2020-03-03;RS;Serbia;0;0;0;0
2020-03-04;RS;Serbia;0;0;0;0
2020-03-05;RS;Serbia;0;0;0;0
2020-03-06;RS;Serbia;1;0;1;0
2020-03-07;RS;Serbia;0;0;1;0
2020-03-08;RS;Serbia;0;0;1;0
2020-03-09;RS;Serbia;0;0;1;0
2020-03-10;RS;Serbia;4;0;5;0
2020-03-11;RS;Serbia;7;0;12;0
2020-03-12;RS;Serbia;7;0;19;0
2020-03-13;RS;Serbia;16;0;35;0
2020-03-14;RS;Serbia;11;0;46;0
2020-03-15;RS;Serbia;2;0;48;0
2020-03-16;RS;Serbia;7;0;55;0
2020-03-17;RS;Serbia;10;0;65;0
2020-03-18;RS;Serbia;18;0;83;0
2020-03-19;RS;Serbia;20;0;103;0
2020-03-20;RS;Serbia;32;1;135;1
2020-03-21;RS;Serbia;36;0;171;1
2020-03-22;RS;Serbia;51;1;222;2
2020-03-23;RS;Serbia;27;1;249;3
2020-03-24;RS;Serbia;54;0;303;3
2020-03-25;RS;Serbia;81;1;384;4
2020-03-26;RS;Serbia;0;-3;384;1
2020-03-27;RS;Serbia;73;0;457;1
2020-03-28;RS;Serbia;202;9;659;10
2020-03-29;RS;Serbia;82;3;741;13
2020-03-30;RS;Serbia;44;3;785;16
2020-03-31;RS;Serbia;115;0;900;16
2020-04-01;RS;Serbia;160;12;1060;28
2020-04-02;RS;Serbia;111;3;1171;31
2020-04-03;RS;Serbia;305;8;1476;39
2020-04-04;RS;Serbia;148;5;1624;44
2020-04-05;RS;Serbia;284;7;1908;51
2020-04-06;RS;Serbia;292;7;2200;58
2020-04-07;RS;Serbia;247;3;2447;61
2020-04-08;RS;Serbia;219;4;2666;65
2020-04-09;RS;Serbia;201;1;2867;66
2020-04-10;RS;Serbia;238;5;3105;71
2020-04-11;RS;Serbia;275;3;3380;74
2020-04-12;RS;Serbia;250;6;3630;80
2020-04-13;RS;Serbia;424;5;4054;85
2020-04-14;RS;Serbia;411;9;4465;94
2020-04-15;RS;Serbia;408;5;4873;99
2020-04-16;RS;Serbia;445;4;5318;103
2020-04-17;RS;Serbia;372;7;5690;110
2020-04-18;RS;Serbia;304;7;5994;117
2020-04-19;RS;Serbia;324;5;6318;122
2020-04-20;RS;Serbia;312;3;6630;125
2020-04-21;RS;Serbia;260;5;6890;130
2020-04-22;RS;Serbia;254;4;7144;134
2020-04-23;RS;Serbia;132;5;7276;139
2020-04-24;RS;Serbia;207;5;7483;144
2020-04-25;RS;Serbia;296;7;7779;151
2020-04-26;RS;Serbia;263;5;8042;156
2020-04-27;RS;Serbia;233;6;8275;162
2020-04-28;RS;Serbia;222;6;8497;168
2020-04-29;RS;Serbia;227;5;8724;173
2020-04-30;RS;Serbia;285;6;9009;179
2020-05-01;RS;Serbia;0;0;9009;179
2020-05-02;RS;Serbia;353;10;9362;189
2020-05-03;RS;Serbia;102;4;9464;193
2020-05-04;RS;Serbia;93;4;9557;197
2020-05-05;RS;Serbia;120;3;9677;200
2020-05-06;RS;Serbia;114;3;9791;203
2020-05-07;RS;Serbia;57;3;9848;206
2020-05-08;RS;Serbia;95;3;9943;209
2020-05-09;RS;Serbia;89;6;10032;215
2020-05-10;RS;Serbia;0;0;10032;215
2020-05-11;RS;Serbia;144;3;10176;218
2020-05-12;RS;Serbia;67;2;10243;220
2020-05-13;RS;Serbia;52;2;10295;222
2020-05-14;RS;Serbia;79;2;10374;224
2020-05-15;RS;Serbia;64;1;10438;225
2020-05-16;RS;Serbia;58;3;10496;228
2020-05-17;RS;Serbia;114;2;10610;230
2020-05-18;RS;Serbia;89;1;10699;231
2020-05-19;RS;Serbia;34;3;10733;234
2020-05-20;RS;Serbia;100;1;10833;235
2020-05-21;RS;Serbia;86;2;10919;237
2020-05-22;RS;Serbia;105;0;11024;237
2020-05-23;RS;Serbia;68;1;11092;238
2020-05-24;RS;Serbia;67;0;11159;238
2020-05-25;RS;Serbia;34;1;11193;239
2020-05-26;RS;Serbia;34;0;11227;239
2020-05-27;RS;Serbia;48;1;11275;240
2020-05-28;RS;Serbia;25;1;11300;241
2020-05-29;RS;Serbia;54;1;11354;242
2020-05-30;RS;Serbia;27;0;11381;242
2020-05-31;RS;Serbia;31;1;11412;243
2020-06-01;RS;Serbia;18;1;11430;244
2020-06-02;RS;Serbia;24;1;11454;245
2020-06-03;RS;Serbia;69;0;11523;245
2020-06-04;RS;Serbia;48;1;11571;246
2020-06-05;RS;Serbia;96;1;11667;247
2020-06-06;RS;Serbia;74;1;11741;248
2020-06-07;RS;Serbia;82;1;11823;249
2020-06-08;RS;Serbia;73;1;11896;250
2020-06-09;RS;Serbia;69;0;11965;250
2020-06-10;RS;Serbia;66;1;12031;251
2020-06-11;RS;Serbia;71;1;12102;252
2020-06-12;RS;Serbia;73;0;12175;252
2020-06-13;RS;Serbia;76;1;12251;253
2020-06-14;RS;Serbia;59;1;12310;254
2020-06-15;RS;Serbia;57;1;12367;255
2020-06-16;RS;Serbia;59;1;12426;256
2020-06-17;RS;Serbia;96;1;12522;257
2020-06-18;RS;Serbia;94;1;12616;258
2020-06-19;RS;Serbia;93;1;12709;259
2020-06-20;RS;Serbia;94;1;12803;260
2020-06-21;RS;Serbia;91;1;12894;261
2020-06-22;RS;Serbia;96;1;12990;262
2020-06-23;RS;Serbia;102;1;13092;263
2020-06-24;RS;Serbia;143;0;13235;263
2020-06-25;RS;Serbia;137;1;13372;264
2020-06-26;RS;Serbia;193;1;13565;265
2020-06-27;RS;Serbia;227;2;13792;267
2020-06-28;RS;Serbia;254;3;14046;270
2020-06-29;RS;Serbia;242;4;14288;274
2020-06-30;RS;Serbia;276;3;14564;277
2020-07-01;RS;Serbia;272;4;14836;281
2020-07-02;RS;Serbia;359;6;15195;287
2020-07-03;RS;Serbia;309;11;15504;298
2020-07-04;RS;Serbia;325;8;15829;306
2020-07-05;RS;Serbia;302;5;16131;311
2020-07-06;RS;Serbia;289;6;16420;317
2020-07-07;RS;Serbia;299;13;16719;330
2020-07-08;RS;Serbia;357;11;17076;341
2020-07-09;RS;Serbia;266;11;17342;352
2020-07-10;RS;Serbia;386;18;17728;370
2020-07-11;RS;Serbia;345;12;18073;382
2020-07-12;RS;Serbia;287;11;18360;393
2020-07-13;RS;Serbia;279;12;18639;405
2020-07-14;RS;Serbia;344;13;18983;418
2020-07-15;RS;Serbia;351;11;19334;429
2020-07-16;RS;Serbia;383;13;19717;442
2020-07-17;RS;Serbia;392;10;20109;452
2020-07-18;RS;Serbia;389;9;20498;461
2020-07-19;RS;Serbia;396;11;20894;472
2020-07-20;RS;Serbia;359;10;21253;482
2020-07-21;RS;Serbia;352;9;21605;491
2020-07-22;RS;Serbia;426;8;22031;499
2020-07-23;RS;Serbia;412;9;22443;508
2020-07-24;RS;Serbia;409;10;22852;518
2020-07-25;RS;Serbia;0;0;22852;518
2020-07-26;RS;Serbia;878;16;23730;534
2020-07-27;RS;Serbia;411;9;24141;543
2020-07-28;RS;Serbia;379;8;24520;551
2020-07-29;RS;Serbia;372;7;24892;558
2020-07-30;RS;Serbia;321;7;25213;565
2020-07-31;RS;Serbia;339;8;25552;573
2020-08-01;RS;Serbia;330;9;25882;582
2020-08-02;RS;Serbia;311;8;26193;590
2020-08-03;RS;Serbia;258;8;26451;598
2020-08-04;RS;Serbia;287;7;26738;605
2020-08-05;RS;Serbia;295;9;27033;614
2020-08-06;RS;Serbia;299;7;27332;621
2020-08-07;RS;Serbia;276;5;27608;626
2020-08-08;RS;Serbia;255;6;27863;632
2020-08-09;RS;Serbia;236;9;28099;641
2020-08-10;RS;Serbia;163;5;28262;646
2020-08-11;RS;Serbia;235;6;28497;652
2020-08-12;RS;Serbia;254;6;28751;658
2020-08-13;RS;Serbia;247;3;28998;661
2020-08-14;RS;Serbia;235;4;29233;665
2020-08-15;RS;Serbia;238;5;29471;670
2020-08-16;RS;Serbia;211;4;29682;674
2020-08-17;RS;Serbia;100;3;29782;677
2020-08-18;RS;Serbia;108;4;29890;681
2020-08-19;RS;Serbia;158;3;30048;684
2020-08-20;RS;Serbia;161;5;30209;689
2020-08-21;RS;Serbia;169;3;30378;692
2020-08-22;RS;Serbia;170;3;30548;695
2020-08-23;RS;Serbia;109;3;30657;698
2020-08-24;RS;Serbia;57;3;30714;701
2020-08-25;RS;Serbia;106;4;30820;705
2020-08-26;RS;Serbia;154;2;30974;707
2020-08-27;RS;Serbia;125;0;31099;707
2020-08-28;RS;Serbia;108;2;31207;709
2020-08-29;RS;Serbia;75;1;31282;710
2020-08-30;RS;Serbia;83;1;31365;711
2020-08-31;RS;Serbia;41;2;31406;713
2020-09-01;RS;Serbia;76;2;31482;715
2020-09-02;RS;Serbia;99;1;31581;716
2020-09-03;RS;Serbia;95;2;31676;718
2020-09-04;RS;Serbia;96;3;31772;721
2020-09-05;RS;Serbia;77;2;31849;723
2020-09-06;RS;Serbia;56;1;31905;724
2020-09-07;RS;Serbia;36;1;31941;725
2020-09-08;RS;Serbia;53;2;31994;727
2020-09-09;RS;Serbia;84;1;32078;728
2020-09-10;RS;Serbia;58;1;32136;729
2020-09-11;RS;Serbia;92;1;32228;730
2020-09-12;RS;Serbia;72;1;32300;731
2020-09-13;RS;Serbia;108;2;32408;733
2020-09-14;RS;Serbia;29;0;32437;733
2020-09-15;RS;Serbia;74;2;32511;735
2020-09-16;RS;Serbia;102;1;32613;736
2020-09-17;RS;Serbia;82;2;32695;738
2020-09-18;RS;Serbia;62;1;32757;739
2020-09-19;RS;Serbia;83;1;32840;740
2020-09-20;RS;Serbia;68;1;32908;741
2020-09-21;RS;Serbia;30;2;32938;743
2020-09-22;RS;Serbia;61;0;32999;743
2020-09-23;RS;Serbia;81;1;33080;744
2020-09-24;RS;Serbia;83;1;33163;745
2020-09-25;RS;Serbia;75;1;33238;746
2020-09-26;RS;Serbia;74;0;33312;746
2020-09-27;RS;Serbia;72;1;33384;747
2020-09-28;RS;Serbia;30;1;33414;748
2020-09-29;RS;Serbia;65;1;33479;749
2020-09-30;RS;Serbia;72;0;33551;749
2020-10-01;RS;Serbia;111;1;33662;750
2020-10-02;RS;Serbia;73;1;33735;751
2020-10-03;RS;Serbia;107;2;33842;753
2020-10-04;RS;Serbia;59;1;33901;754
2020-10-05;RS;Serbia;51;2;33952;756
2020-10-06;RS;Serbia;120;1;34072;757
2020-10-07;RS;Serbia;121;1;34193;758
2020-10-08;RS;Serbia;151;2;34344;760
2020-10-09;RS;Serbia;173;1;34517;761
2020-10-10;RS;Serbia;168;1;34685;762
2020-10-11;RS;Serbia;102;1;34787;763
2020-10-12;RS;Serbia;67;2;34854;765
2020-10-13;RS;Serbia;152;2;35006;767
2020-10-14;RS;Serbia;245;1;35251;768
2020-10-15;RS;Serbia;203;2;35454;770
2020-10-16;RS;Serbia;265;2;35719;772
2020-10-17;RS;Serbia;227;2;35946;774
2020-10-18;RS;Serbia;214;2;36160;776
2020-10-19;RS;Serbia;122;2;36282;778
2020-10-20;RS;Serbia;326;2;36608;780
2020-10-21;RS;Serbia;512;0;37120;780
2020-10-22;RS;Serbia;416;3;37536;783
2020-10-23;RS;Serbia;579;3;38115;786
2020-10-24;RS;Serbia;757;3;38872;789
2020-10-25;RS;Serbia;614;3;39486;792
2020-10-26;RS;Serbia;341;1;39827;793
2020-10-27;RS;Serbia;1053;5;40880;798
2020-10-28;RS;Serbia;1328;5;42208;803
2020-10-29;RS;Serbia;1384;6;43592;809
2020-10-30;RS;Serbia;1545;5;45137;814
2020-10-31;RS;Serbia;1817;6;46954;820
2020-11-01;RS;Serbia;1449;6;48403;826
2020-11-02;RS;Serbia;802;7;49205;833
2020-11-03;RS;Serbia;1878;11;51083;844
2020-11-04;RS;Serbia;2412;6;53495;850
2020-11-05;RS;Serbia;2181;11;55676;861
2020-11-06;RS;Serbia;2282;10;57958;871
2020-11-07;RS;Serbia;2677;9;60635;880
2020-11-08;RS;Serbia;2112;10;62747;890
2020-11-09;RS;Serbia;1318;11;64065;901
2020-11-10;RS;Serbia;2823;14;66888;915
2020-11-11;RS;Serbia;3536;21;70424;936
2020-11-12;RS;Serbia;3341;19;73765;955
2020-11-13;RS;Serbia;3499;17;77264;972
2020-11-14;RS;Serbia;3822;17;81086;989
2020-11-15;RS;Serbia;3482;20;84568;1009
2020-11-16;RS;Serbia;2813;21;87381;1030
2020-11-17;RS;Serbia;4994;24;92375;1054
2020-11-18;RS;Serbia;5613;27;97988;1081
2020-11-19;RS;Serbia;6109;29;104097;1110
2020-11-20;RS;Serbia;6254;30;110351;1140
2020-11-21;RS;Serbia;5774;28;116125;1168
2020-11-22;RS;Serbia;4995;31;121120;1199
2020-11-23;RS;Serbia;5067;38;126187;1237
2020-11-24;RS;Serbia;6842;37;133029;1274
2020-11-25;RS;Serbia;7579;41;140608;1315
2020-11-26;RS;Serbia;7606;51;148214;1366
2020-11-27;RS;Serbia;7780;57;155994;1423
2020-11-28;RS;Serbia;7041;61;163035;1484
2020-11-29;RS;Serbia;6179;65;169214;1549
2020-11-30;RS;Serbia;6224;55;175438;1604
2020-12-01;RS;Serbia;7999;48;183437;1652
2020-12-02;RS;Serbia;7919;52;191356;1704
2020-12-03;RS;Serbia;7802;61;199158;1765
2020-12-04;RS;Serbia;7782;69;206940;1834
2020-12-05;RS;Serbia;6903;57;213843;1891
2020-12-06;RS;Serbia;5809;58;219652;1949
2020-12-07;RS;Serbia;6557;56;226209;2005
2020-12-08;RS;Serbia;7818;57;234027;2062
2020-12-09;RS;Serbia;7804;54;241831;2116
2020-12-10;RS;Serbia;7393;56;249224;2172
2020-12-11;RS;Serbia;6534;55;255758;2227
2020-12-12;RS;Serbia;5679;48;261437;2275
2020-12-13;RS;Serbia;4995;56;266432;2331
2020-12-14;RS;Serbia;4932;49;271364;2380
2020-12-15;RS;Serbia;5884;53;277248;2433
2020-12-16;RS;Serbia;5353;49;282601;2482
2020-12-17;RS;Serbia;5129;47;287730;2529
2020-12-18;RS;Serbia;4910;51;292640;2580
2020-12-19;RS;Serbia;3888;52;296528;2632
2020-12-20;RS;Serbia;3534;54;300062;2686
2020-12-21;RS;Serbia;3685;47;303747;2733
2020-12-22;RS;Serbia;4080;49;307827;2782
2020-12-23;RS;Serbia;4426;51;312253;2833
2020-12-24;RS;Serbia;4091;49;316344;2882
2020-12-25;RS;Serbia;3823;49;320167;2931
2020-12-26;RS;Serbia;3200;52;323367;2983
2020-12-27;RS;Serbia;2693;47;326060;3030
2020-12-28;RS;Serbia;2559;43;328619;3073
2020-12-29;RS;Serbia;3136;46;331755;3119
2020-12-30;RS;Serbia;3236;44;334991;3163
2020-12-31;RS;Serbia;2932;48;337923;3211
2021-01-01;RS;Serbia;2074;39;339997;3250
2021-01-02;RS;Serbia;1907;38;341904;3288
2021-01-03;RS;Serbia;1966;37;343870;3325
2021-01-04;RS;Serbia;2715;39;346585;3364
2021-01-05;RS;Serbia;2653;41;349238;3405
2021-01-06;RS;Serbia;2882;39;352120;3444
2021-01-07;RS;Serbia;1787;35;353907;3479
2021-01-08;RS;Serbia;2218;34;356125;3513
2021-01-09;RS;Serbia;0;0;356125;3513
2021-01-10;RS;Serbia;3564;69;359689;3582
2021-01-11;RS;Serbia;2093;28;361782;3610
2021-01-12;RS;Serbia;2142;29;363924;3639
2021-01-13;RS;Serbia;2267;25;366191;3664
2021-01-14;RS;Serbia;1881;23;368072;3687
2021-01-15;RS;Serbia;1751;21;369823;3708
2021-01-16;RS;Serbia;1393;22;371216;3730
2021-01-17;RS;Serbia;1317;20;372533;3750
2021-01-18;RS;Serbia;1578;21;374111;3771
2021-01-19;RS;Serbia;1688;20;375799;3791
2021-01-20;RS;Serbia;1646;19;377445;3810
2021-01-21;RS;Serbia;1648;20;379093;3830
2021-01-22;RS;Serbia;1709;19;380802;3849
2021-01-23;RS;Serbia;1483;19;382285;3868
2021-01-24;RS;Serbia;1318;18;383603;3886
2021-01-25;RS;Serbia;1523;19;385126;3905
2021-01-26;RS;Serbia;2080;19;387206;3924
2021-01-27;RS;Serbia;1839;20;389045;3944
2021-01-28;RS;Serbia;1592;21;390637;3965
2021-01-29;RS;Serbia;1717;18;392354;3983
2021-01-30;RS;Serbia;1543;17;393897;4000
2021-01-31;RS;Serbia;1366;20;395263;4020
2021-02-01;RS;Serbia;1739;18;397002;4038
2021-02-02;RS;Serbia;1903;18;398905;4056
2021-02-03;RS;Serbia;1932;15;400837;4071
2021-02-04;RS;Serbia;1863;14;402700;4085
2021-02-05;RS;Serbia;1968;14;404668;4099
2021-02-06;RS;Serbia;1684;13;406352;4112
2021-02-07;RS;Serbia;1529;14;407881;4126
2021-02-08;RS;Serbia;1960;13;409841;4139
2021-02-09;RS;Serbia;2014;15;411855;4154
2021-02-10;RS;Serbia;2088;14;413943;4168
2021-02-11;RS;Serbia;2000;15;415943;4183
2021-02-12;RS;Serbia;1928;16;417871;4199
2021-02-13;RS;Serbia;1622;15;419493;4214
2021-02-14;RS;Serbia;1386;16;420879;4230
2021-02-15;RS;Serbia;1331;15;422210;4245
2021-02-16;RS;Serbia;1810;16;424020;4261
2021-02-17;RS;Serbia;2467;16;426487;4277
2021-02-18;RS;Serbia;2561;15;429048;4292
2021-02-19;RS;Serbia;2632;14;431680;4306
2021-02-20;RS;Serbia;2442;15;434122;4321
2021-02-21;RS;Serbia;2518;16;436640;4337
2021-02-22;RS;Serbia;2956;14;439596;4351
2021-02-23;RS;Serbia;3257;15;442853;4366
2021-02-24;RS;Serbia;3460;17;446313;4383
2021-02-25;RS;Serbia;3588;15;449901;4398
2021-02-26;RS;Serbia;3339;16;453240;4414
2021-02-27;RS;Serbia;3210;15;456450;4429
2021-02-28;RS;Serbia;2809;14;459259;4443
2021-03-01;RS;Serbia;3469;16;462728;4459
2021-03-02;RS;Serbia;4157;16;466885;4475
2021-03-03;RS;Serbia;4056;16;470941;4491
2021-03-04;RS;Serbia;3866;17;474807;4508
2021-03-05;RS;Serbia;4071;17;478878;4525
2021-03-06;RS;Serbia;3519;17;482397;4542
2021-03-07;RS;Serbia;3042;20;485439;4562
2021-03-08;RS;Serbia;4091;17;489530;4579
2021-03-09;RS;Serbia;4576;20;494106;4599
2021-03-10;RS;Serbia;4590;21;498696;4620
2021-03-11;RS;Serbia;4595;24;503291;4644
2021-03-12;RS;Serbia;4668;26;507959;4670
2021-03-13;RS;Serbia;4092;24;512051;4694
2021-03-14;RS;Serbia;4226;25;516277;4719
2021-03-15;RS;Serbia;4634;28;520911;4747
2021-03-16;RS;Serbia;5201;31;526112;4778
2021-03-17;RS;Serbia;5446;32;531558;4810
2021-03-18;RS;Serbia;5346;30;536904;4840
2021-03-19;RS;Serbia;5305;29;542209;4869
2021-03-20;RS;Serbia;4687;31;546896;4900
2021-03-21;RS;Serbia;4232;34;551128;4934
2021-03-22;RS;Serbia;4769;32;555897;4966
2021-03-23;RS;Serbia;5475;36;561372;5002
2021-03-24;RS;Serbia;5297;37;566669;5039
2021-03-25;RS;Serbia;5226;36;571895;5075
2021-03-26;RS;Serbia;0;0;571895;5075
2021-03-27;RS;Serbia;9722;76;581617;5151
2021-03-28;RS;Serbia;3889;39;585506;5190
2021-03-29;RS;Serbia;0;0;585506;5190
2021-03-30;RS;Serbia;9983;80;595489;5270
2021-03-31;RS;Serbia;5107;38;600596;5308
2021-04-01;RS;Serbia;4810;37;605406;5345
2021-04-02;RS;Serbia;4826;39;610232;5384
2021-04-03;RS;Serbia;4133;38;614365;5422
2021-04-04;RS;Serbia;3304;36;617669;5458
2021-04-05;RS;Serbia;3706;39;621375;5497
2021-04-06;RS;Serbia;4398;40;625773;5537
2021-04-07;RS;Serbia;3615;42;629388;5579
2021-04-08;RS;Serbia;3625;41;633013;5620
2021-04-09;RS;Serbia;3405;39;636418;5659
2021-04-10;RS;Serbia;3058;41;639476;5700
2021-04-11;RS;Serbia;2732;35;642208;5735
2021-04-12;RS;Serbia;2965;38;645173;5773
2021-04-13;RS;Serbia;3572;35;648745;5808
2021-04-14;RS;Serbia;3154;38;651899;5846
2021-04-15;RS;Serbia;2971;35;654870;5881
2021-04-16;RS;Serbia;2846;39;657716;5920
2021-04-17;RS;Serbia;2583;34;660299;5954
2021-04-18;RS;Serbia;2069;37;662368;5991
2021-04-19;RS;Serbia;2604;35;664972;6026
2021-04-20;RS;Serbia;2965;32;667937;6058
2021-04-21;RS;Serbia;2864;37;670801;6095
2021-04-22;RS;Serbia;2719;35;673520;6130
2021-04-23;RS;Serbia;2384;34;675904;6164
2021-04-24;RS;Serbia;2068;32;677972;6196
2021-04-25;RS;Serbia;1695;31;679667;6227
2021-04-26;RS;Serbia;1987;30;681654;6257
2021-04-27;RS;Serbia;2145;29;683799;6286
2021-04-28;RS;Serbia;2138;26;685937;6312
2021-04-29;RS;Serbia;2007;25;687944;6337
2021-04-30;RS;Serbia;1613;25;689557;6362
2021-05-01;RS;Serbia;1374;24;690931;6386
2021-05-02;RS;Serbia;989;23;691920;6409
2021-05-03;RS;Serbia;1249;23;693169;6432
2021-05-04;RS;Serbia;1304;24;694473;6456
2021-05-05;RS;Serbia;1402;22;695875;6478
2021-05-06;RS;Serbia;1366;21;697241;6499
2021-05-07;RS;Serbia;1277;20;698518;6519
2021-05-08;RS;Serbia;0;0;698518;6519
2021-05-09;RS;Serbia;1890;39;700408;6558
2021-05-10;RS;Serbia;918;18;701326;6576
2021-05-11;RS;Serbia;1125;18;702451;6594
2021-05-12;RS;Serbia;1046;17;703497;6611
2021-05-13;RS;Serbia;0;0;703497;6611
2021-05-14;RS;Serbia;1688;35;705185;6646
2021-05-15;RS;Serbia;705;18;705890;6664
2021-05-16;RS;Serbia;568;17;706458;6681
2021-05-17;RS;Serbia;575;15;707033;6696
2021-05-18;RS;Serbia;686;14;707719;6710
2021-05-19;RS;Serbia;609;15;708328;6725
2021-05-20;RS;Serbia;550;14;708878;6739
2021-05-21;RS;Serbia;391;13;709269;6752
2021-05-22;RS;Serbia;404;14;709673;6766
2021-05-23;RS;Serbia;266;11;709939;6777
2021-05-24;RS;Serbia;376;11;710315;6788
2021-05-25;RS;Serbia;414;13;710729;6801
2021-05-26;RS;Serbia;387;10;711116;6811
2021-05-27;RS;Serbia;326;12;711442;6823
2021-05-28;RS;Serbia;330;11;711772;6834
2021-05-29;RS;Serbia;274;10;712046;6844
2021-05-30;RS;Serbia;178;10;712224;6854
2021-05-31;RS;Serbia;248;11;712472;6865
2021-06-01;RS;Serbia;230;7;712702;6872
2021-06-02;RS;Serbia;287;9;712989;6881
2021-06-03;RS;Serbia;218;9;713207;6890
2021-06-04;RS;Serbia;210;10;713417;6900
2021-06-05;RS;Serbia;145;9;713562;6909
2021-06-06;RS;Serbia;116;8;713678;6917
2021-06-07;RS;Serbia;162;7;713840;6924
2021-06-08;RS;Serbia;214;6;714054;6930
2021-06-09;RS;Serbia;198;8;714252;6938
2021-06-10;RS;Serbia;210;7;714462;6945
2021-06-11;RS;Serbia;172;6;714634;6951
2021-06-12;RS;Serbia;119;7;714753;6958
2021-06-13;RS;Serbia;138;4;714891;6962
2021-06-14;RS;Serbia;124;8;715015;6970
2021-06-15;RS;Serbia;132;6;715147;6976
2021-06-16;RS;Serbia;160;4;715307;6980
2021-06-17;RS;Serbia;135;5;715442;6985
2021-06-18;RS;Serbia;162;5;715604;6990
2021-06-19;RS;Serbia;89;7;715693;6997
2021-06-20;RS;Serbia;60;4;715753;7001
2021-06-21;RS;Serbia;88;3;715841;7004
2021-06-22;RS;Serbia;72;6;715913;7010
2021-06-23;RS;Serbia;103;3;716016;7013
2021-06-24;RS;Serbia;80;6;716096;7019
2021-06-25;RS;Serbia;76;5;716172;7024
2021-06-26;RS;Serbia;66;5;716238;7029
2021-06-27;RS;Serbia;63;2;716301;7031
2021-06-28;RS;Serbia;84;8;716385;7039
2021-06-29;RS;Serbia;73;4;716458;7043
2021-06-30;RS;Serbia;104;4;716562;7047
2021-07-01;RS;Serbia;81;0;716643;7047
2020-03-14;SC;Seychelles;2;0;2;0
2020-03-15;SC;Seychelles;0;0;2;0
2020-03-16;SC;Seychelles;1;0;3;0
2020-03-17;SC;Seychelles;1;0;4;0
2020-03-18;SC;Seychelles;0;0;4;0
2020-03-19;SC;Seychelles;2;0;6;0
2020-03-20;SC;Seychelles;1;0;7;0
2020-03-21;SC;Seychelles;0;0;7;0
2020-03-22;SC;Seychelles;0;0;7;0
2020-03-23;SC;Seychelles;0;0;7;0
2020-03-24;SC;Seychelles;0;0;7;0
2020-03-25;SC;Seychelles;0;0;7;0
2020-03-26;SC;Seychelles;0;0;7;0
2020-03-27;SC;Seychelles;0;0;7;0
2020-03-28;SC;Seychelles;1;0;8;0
2020-03-29;SC;Seychelles;0;0;8;0
2020-03-30;SC;Seychelles;0;0;8;0
2020-03-31;SC;Seychelles;2;0;10;0
2020-04-01;SC;Seychelles;0;0;10;0
2020-04-02;SC;Seychelles;0;0;10;0
2020-04-03;SC;Seychelles;0;0;10;0
2020-04-04;SC;Seychelles;0;0;10;0
2020-04-05;SC;Seychelles;0;0;10;0
2020-04-06;SC;Seychelles;1;0;11;0
2020-04-07;SC;Seychelles;0;0;11;0
2020-04-08;SC;Seychelles;0;0;11;0
2020-04-09;SC;Seychelles;0;0;11;0
2020-04-10;SC;Seychelles;0;0;11;0
2020-04-11;SC;Seychelles;0;0;11;0
2020-04-12;SC;Seychelles;0;0;11;0
2020-04-13;SC;Seychelles;0;0;11;0
2020-04-14;SC;Seychelles;0;0;11;0
2020-04-15;SC;Seychelles;0;0;11;0
2020-04-16;SC;Seychelles;0;0;11;0
2020-04-17;SC;Seychelles;0;0;11;0
2020-04-18;SC;Seychelles;0;0;11;0
2020-04-19;SC;Seychelles;0;0;11;0
2020-04-20;SC;Seychelles;0;0;11;0
2020-04-21;SC;Seychelles;0;0;11;0
2020-04-22;SC;Seychelles;0;0;11;0
2020-04-23;SC;Seychelles;0;0;11;0
2020-04-24;SC;Seychelles;0;0;11;0
2020-04-25;SC;Seychelles;0;0;11;0
2020-04-26;SC;Seychelles;0;0;11;0
2020-04-27;SC;Seychelles;0;0;11;0
2020-04-28;SC;Seychelles;0;0;11;0
2020-04-29;SC;Seychelles;0;0;11;0
2020-04-30;SC;Seychelles;0;0;11;0
2020-05-01;SC;Seychelles;0;0;11;0
2020-05-02;SC;Seychelles;0;0;11;0
2020-05-03;SC;Seychelles;0;0;11;0
2020-05-04;SC;Seychelles;0;0;11;0
2020-05-05;SC;Seychelles;0;0;11;0
2020-05-06;SC;Seychelles;0;0;11;0
2020-05-07;SC;Seychelles;0;0;11;0
2020-05-08;SC;Seychelles;0;0;11;0
2020-05-09;SC;Seychelles;0;0;11;0
2020-05-10;SC;Seychelles;0;0;11;0
2020-05-11;SC;Seychelles;0;0;11;0
2020-05-12;SC;Seychelles;0;0;11;0
2020-05-13;SC;Seychelles;0;0;11;0
2020-05-14;SC;Seychelles;0;0;11;0
2020-05-15;SC;Seychelles;0;0;11;0
2020-05-16;SC;Seychelles;0;0;11;0
2020-05-17;SC;Seychelles;0;0;11;0
2020-05-18;SC;Seychelles;0;0;11;0
2020-05-19;SC;Seychelles;0;0;11;0
2020-05-20;SC;Seychelles;0;0;11;0
2020-05-21;SC;Seychelles;0;0;11;0
2020-05-22;SC;Seychelles;0;0;11;0
2020-05-23;SC;Seychelles;0;0;11;0
2020-05-24;SC;Seychelles;0;0;11;0
2020-05-25;SC;Seychelles;0;0;11;0
2020-05-26;SC;Seychelles;0;0;11;0
2020-05-27;SC;Seychelles;0;0;11;0
2020-05-28;SC;Seychelles;0;0;11;0
2020-05-29;SC;Seychelles;0;0;11;0
2020-05-30;SC;Seychelles;0;0;11;0
2020-05-31;SC;Seychelles;0;0;11;0
2020-06-01;SC;Seychelles;0;0;11;0
2020-06-02;SC;Seychelles;0;0;11;0
2020-06-03;SC;Seychelles;0;0;11;0
2020-06-04;SC;Seychelles;0;0;11;0
2020-06-05;SC;Seychelles;0;0;11;0
2020-06-06;SC;Seychelles;0;0;11;0
2020-06-07;SC;Seychelles;0;0;11;0
2020-06-08;SC;Seychelles;0;0;11;0
2020-06-09;SC;Seychelles;0;0;11;0
2020-06-10;SC;Seychelles;0;0;11;0
2020-06-11;SC;Seychelles;0;0;11;0
2020-06-12;SC;Seychelles;0;0;11;0
2020-06-13;SC;Seychelles;0;0;11;0
2020-06-14;SC;Seychelles;0;0;11;0
2020-06-15;SC;Seychelles;0;0;11;0
2020-06-16;SC;Seychelles;0;0;11;0
2020-06-17;SC;Seychelles;0;0;11;0
2020-06-18;SC;Seychelles;0;0;11;0
2020-06-19;SC;Seychelles;0;0;11;0
2020-06-20;SC;Seychelles;0;0;11;0
2020-06-21;SC;Seychelles;0;0;11;0
2020-06-22;SC;Seychelles;0;0;11;0
2020-06-23;SC;Seychelles;0;0;11;0
2020-06-24;SC;Seychelles;0;0;11;0
2020-06-25;SC;Seychelles;0;0;11;0
2020-06-26;SC;Seychelles;0;0;11;0
2020-06-27;SC;Seychelles;9;0;20;0
2020-06-28;SC;Seychelles;50;0;70;0
2020-06-29;SC;Seychelles;7;0;77;0
2020-06-30;SC;Seychelles;4;0;81;0
2020-07-01;SC;Seychelles;0;0;81;0
2020-07-02;SC;Seychelles;0;0;81;0
2020-07-03;SC;Seychelles;0;0;81;0
2020-07-04;SC;Seychelles;0;0;81;0
2020-07-05;SC;Seychelles;0;0;81;0
2020-07-06;SC;Seychelles;0;0;81;0
2020-07-07;SC;Seychelles;0;0;81;0
2020-07-08;SC;Seychelles;10;0;91;0
2020-07-09;SC;Seychelles;3;0;94;0
2020-07-10;SC;Seychelles;6;0;100;0
2020-07-11;SC;Seychelles;0;0;100;0
2020-07-12;SC;Seychelles;0;0;100;0
2020-07-13;SC;Seychelles;0;0;100;0
2020-07-14;SC;Seychelles;0;0;100;0
2020-07-15;SC;Seychelles;0;0;100;0
2020-07-16;SC;Seychelles;8;0;108;0
2020-07-17;SC;Seychelles;0;0;108;0
2020-07-18;SC;Seychelles;0;0;108;0
2020-07-19;SC;Seychelles;0;0;108;0
2020-07-20;SC;Seychelles;0;0;108;0
2020-07-21;SC;Seychelles;0;0;108;0
2020-07-22;SC;Seychelles;0;0;108;0
2020-07-23;SC;Seychelles;0;0;108;0
2020-07-24;SC;Seychelles;0;0;108;0
2020-07-25;SC;Seychelles;6;0;114;0
2020-07-26;SC;Seychelles;0;0;114;0
2020-07-27;SC;Seychelles;0;0;114;0
2020-07-28;SC;Seychelles;0;0;114;0
2020-07-29;SC;Seychelles;0;0;114;0
2020-07-30;SC;Seychelles;0;0;114;0
2020-07-31;SC;Seychelles;0;0;114;0
2020-08-01;SC;Seychelles;0;0;114;0
2020-08-02;SC;Seychelles;0;0;114;0
2020-08-03;SC;Seychelles;0;0;114;0
2020-08-04;SC;Seychelles;0;0;114;0
2020-08-05;SC;Seychelles;12;0;126;0
2020-08-06;SC;Seychelles;0;0;126;0
2020-08-07;SC;Seychelles;0;0;126;0
2020-08-08;SC;Seychelles;0;0;126;0
2020-08-09;SC;Seychelles;0;0;126;0
2020-08-10;SC;Seychelles;0;0;126;0
2020-08-11;SC;Seychelles;1;0;127;0
2020-08-12;SC;Seychelles;0;0;127;0
2020-08-13;SC;Seychelles;0;0;127;0
2020-08-14;SC;Seychelles;0;0;127;0
2020-08-15;SC;Seychelles;0;0;127;0
2020-08-16;SC;Seychelles;0;0;127;0
2020-08-17;SC;Seychelles;0;0;127;0
2020-08-18;SC;Seychelles;0;0;127;0
2020-08-19;SC;Seychelles;5;0;132;0
2020-08-20;SC;Seychelles;0;0;132;0
2020-08-21;SC;Seychelles;0;0;132;0
2020-08-22;SC;Seychelles;0;0;132;0
2020-08-23;SC;Seychelles;0;0;132;0
2020-08-24;SC;Seychelles;0;0;132;0
2020-08-25;SC;Seychelles;4;0;136;0
2020-08-26;SC;Seychelles;0;0;136;0
2020-08-27;SC;Seychelles;0;0;136;0
2020-08-28;SC;Seychelles;0;0;136;0
2020-08-29;SC;Seychelles;0;0;136;0
2020-08-30;SC;Seychelles;0;0;136;0
2020-08-31;SC;Seychelles;0;0;136;0
2020-09-01;SC;Seychelles;0;0;136;0
2020-09-02;SC;Seychelles;0;0;136;0
2020-09-03;SC;Seychelles;0;0;136;0
2020-09-04;SC;Seychelles;0;0;136;0
2020-09-05;SC;Seychelles;0;0;136;0
2020-09-06;SC;Seychelles;0;0;136;0
2020-09-07;SC;Seychelles;1;0;137;0
2020-09-08;SC;Seychelles;0;0;137;0
2020-09-09;SC;Seychelles;0;0;137;0
2020-09-10;SC;Seychelles;0;0;137;0
2020-09-11;SC;Seychelles;1;0;138;0
2020-09-12;SC;Seychelles;1;0;139;0
2020-09-13;SC;Seychelles;0;0;139;0
2020-09-14;SC;Seychelles;1;0;140;0
2020-09-15;SC;Seychelles;0;0;140;0
2020-09-16;SC;Seychelles;0;0;140;0
2020-09-17;SC;Seychelles;1;0;141;0
2020-09-18;SC;Seychelles;0;0;141;0
2020-09-19;SC;Seychelles;0;0;141;0
2020-09-20;SC;Seychelles;0;0;141;0
2020-09-21;SC;Seychelles;2;0;143;0
2020-09-22;SC;Seychelles;0;0;143;0
2020-09-23;SC;Seychelles;0;0;143;0
2020-09-24;SC;Seychelles;0;0;143;0
2020-09-25;SC;Seychelles;0;0;143;0
2020-09-26;SC;Seychelles;0;0;143;0
2020-09-27;SC;Seychelles;0;0;143;0
2020-09-28;SC;Seychelles;0;0;143;0
2020-09-29;SC;Seychelles;0;0;143;0
2020-09-30;SC;Seychelles;1;0;144;0
2020-10-01;SC;Seychelles;0;0;144;0
2020-10-02;SC;Seychelles;1;0;145;0
2020-10-03;SC;Seychelles;1;0;146;0
2020-10-04;SC;Seychelles;0;0;146;0
2020-10-05;SC;Seychelles;0;0;146;0
2020-10-06;SC;Seychelles;2;0;148;0
2020-10-07;SC;Seychelles;0;0;148;0
2020-10-08;SC;Seychelles;0;0;148;0
2020-10-09;SC;Seychelles;0;0;148;0
2020-10-10;SC;Seychelles;0;0;148;0
2020-10-11;SC;Seychelles;0;0;148;0
2020-10-12;SC;Seychelles;0;0;148;0
2020-10-13;SC;Seychelles;0;0;148;0
2020-10-14;SC;Seychelles;0;0;148;0
2020-10-15;SC;Seychelles;0;0;148;0
2020-10-16;SC;Seychelles;1;0;149;0
2020-10-17;SC;Seychelles;0;0;149;0
2020-10-18;SC;Seychelles;0;0;149;0
2020-10-19;SC;Seychelles;0;0;149;0
2020-10-20;SC;Seychelles;0;0;149;0
2020-10-21;SC;Seychelles;2;0;151;0
2020-10-22;SC;Seychelles;0;0;151;0
2020-10-23;SC;Seychelles;2;0;153;0
2020-10-24;SC;Seychelles;0;0;153;0
2020-10-25;SC;Seychelles;0;0;153;0
2020-10-26;SC;Seychelles;0;0;153;0
2020-10-27;SC;Seychelles;0;0;153;0
2020-10-28;SC;Seychelles;0;0;153;0
2020-10-29;SC;Seychelles;0;0;153;0
2020-10-30;SC;Seychelles;0;0;153;0
2020-10-31;SC;Seychelles;0;0;153;0
2020-11-01;SC;Seychelles;0;0;153;0
2020-11-02;SC;Seychelles;0;0;153;0
2020-11-03;SC;Seychelles;4;0;157;0
2020-11-04;SC;Seychelles;0;0;157;0
2020-11-05;SC;Seychelles;0;0;157;0
2020-11-06;SC;Seychelles;1;0;158;0
2020-11-07;SC;Seychelles;0;0;158;0
2020-11-08;SC;Seychelles;0;0;158;0
2020-11-09;SC;Seychelles;0;0;158;0
2020-11-10;SC;Seychelles;0;0;158;0
2020-11-11;SC;Seychelles;0;0;158;0
2020-11-12;SC;Seychelles;2;0;160;0
2020-11-13;SC;Seychelles;0;0;160;0
2020-11-14;SC;Seychelles;0;0;160;0
2020-11-15;SC;Seychelles;0;0;160;0
2020-11-16;SC;Seychelles;0;0;160;0
2020-11-17;SC;Seychelles;0;0;160;0
2020-11-18;SC;Seychelles;0;0;160;0
2020-11-19;SC;Seychelles;3;0;163;0
2020-11-20;SC;Seychelles;0;0;163;0
2020-11-21;SC;Seychelles;0;0;163;0
2020-11-22;SC;Seychelles;0;0;163;0
2020-11-23;SC;Seychelles;3;0;166;0
2020-11-24;SC;Seychelles;0;0;166;0
2020-11-25;SC;Seychelles;0;0;166;0
2020-11-26;SC;Seychelles;0;0;166;0
2020-11-27;SC;Seychelles;7;0;173;0
2020-11-28;SC;Seychelles;0;0;173;0
2020-11-29;SC;Seychelles;0;0;173;0
2020-11-30;SC;Seychelles;10;0;183;0
2020-12-01;SC;Seychelles;0;0;183;0
2020-12-02;SC;Seychelles;0;0;183;0
2020-12-03;SC;Seychelles;0;0;183;0
2020-12-04;SC;Seychelles;1;0;184;0
2020-12-05;SC;Seychelles;0;0;184;0
2020-12-06;SC;Seychelles;0;0;184;0
2020-12-07;SC;Seychelles;0;0;184;0
2020-12-08;SC;Seychelles;0;0;184;0
2020-12-09;SC;Seychelles;0;0;184;0
2020-12-10;SC;Seychelles;0;0;184;0
2020-12-11;SC;Seychelles;3;0;187;0
2020-12-12;SC;Seychelles;0;0;187;0
2020-12-13;SC;Seychelles;0;0;187;0
2020-12-14;SC;Seychelles;0;0;187;0
2020-12-15;SC;Seychelles;15;0;202;0
2020-12-16;SC;Seychelles;0;0;202;0
2020-12-17;SC;Seychelles;0;0;202;0
2020-12-18;SC;Seychelles;0;0;202;0
2020-12-19;SC;Seychelles;0;0;202;0
2020-12-20;SC;Seychelles;0;0;202;0
2020-12-21;SC;Seychelles;3;0;205;0
2020-12-22;SC;Seychelles;0;0;205;0
2020-12-23;SC;Seychelles;0;0;205;0
2020-12-24;SC;Seychelles;0;0;205;0
2020-12-25;SC;Seychelles;0;0;205;0
2020-12-26;SC;Seychelles;0;0;205;0
2020-12-27;SC;Seychelles;0;0;205;0
2020-12-28;SC;Seychelles;12;0;217;0
2020-12-29;SC;Seychelles;0;0;217;0
2020-12-30;SC;Seychelles;39;0;256;0
2020-12-31;SC;Seychelles;0;0;256;0
2021-01-01;SC;Seychelles;0;0;256;0
2021-01-02;SC;Seychelles;29;0;285;0
2021-01-03;SC;Seychelles;12;0;297;0
2021-01-04;SC;Seychelles;25;1;322;1
2021-01-05;SC;Seychelles;32;0;354;1
2021-01-06;SC;Seychelles;19;0;373;1
2021-01-07;SC;Seychelles;0;0;373;1
2021-01-08;SC;Seychelles;78;0;451;1
2021-01-09;SC;Seychelles;57;0;508;1
2021-01-10;SC;Seychelles;23;0;531;1
2021-01-11;SC;Seychelles;52;0;583;1
2021-01-12;SC;Seychelles;18;0;601;1
2021-01-13;SC;Seychelles;11;0;612;1
2021-01-14;SC;Seychelles;15;0;627;1
2021-01-15;SC;Seychelles;29;0;656;1
2021-01-16;SC;Seychelles;40;1;696;2
2021-01-17;SC;Seychelles;9;0;705;2
2021-01-18;SC;Seychelles;41;0;746;2
2021-01-19;SC;Seychelles;0;0;746;2
2021-01-20;SC;Seychelles;16;0;762;2
2021-01-21;SC;Seychelles;0;0;762;2
2021-01-22;SC;Seychelles;210;1;972;3
2021-01-23;SC;Seychelles;61;0;1033;3
2021-01-24;SC;Seychelles;0;0;1033;3
2021-01-25;SC;Seychelles;36;0;1069;3
2021-01-26;SC;Seychelles;47;0;1116;3
2021-01-27;SC;Seychelles;13;0;1129;3
2021-01-28;SC;Seychelles;20;0;1149;3
2021-01-29;SC;Seychelles;13;0;1162;3
2021-01-30;SC;Seychelles;24;1;1186;4
2021-01-31;SC;Seychelles;19;0;1205;4
2021-02-01;SC;Seychelles;18;1;1223;5
2021-02-02;SC;Seychelles;20;0;1243;5
2021-02-03;SC;Seychelles;36;0;1279;5
2021-02-04;SC;Seychelles;10;0;1289;5
2021-02-05;SC;Seychelles;0;0;1289;5
2021-02-06;SC;Seychelles;215;1;1504;6
2021-02-07;SC;Seychelles;9;1;1513;7
2021-02-08;SC;Seychelles;62;0;1575;7
2021-02-09;SC;Seychelles;120;0;1695;7
2021-02-10;SC;Seychelles;0;0;1695;7
2021-02-11;SC;Seychelles;73;0;1768;7
2021-02-12;SC;Seychelles;34;0;1802;7
2021-02-13;SC;Seychelles;90;1;1892;8
2021-02-14;SC;Seychelles;0;0;1892;8
2021-02-15;SC;Seychelles;18;0;1910;8
2021-02-16;SC;Seychelles;148;2;2058;10
2021-02-17;SC;Seychelles;153;0;2211;10
2021-02-18;SC;Seychelles;69;0;2280;10
2021-02-19;SC;Seychelles;25;0;2305;10
2021-02-20;SC;Seychelles;23;0;2328;10
2021-02-21;SC;Seychelles;73;0;2401;10
2021-02-22;SC;Seychelles;63;1;2464;11
2021-02-23;SC;Seychelles;50;0;2514;11
2021-02-24;SC;Seychelles;48;0;2562;11
2021-02-25;SC;Seychelles;0;0;2562;11
2021-02-26;SC;Seychelles;30;0;2592;11
2021-02-27;SC;Seychelles;0;0;2592;11
2021-02-28;SC;Seychelles;26;0;2618;11
2021-03-01;SC;Seychelles;70;0;2688;11
2021-03-02;SC;Seychelles;161;0;2849;11
2021-03-03;SC;Seychelles;41;2;2890;13
2021-03-04;SC;Seychelles;38;0;2928;13
2021-03-05;SC;Seychelles;22;2;2950;15
2021-03-06;SC;Seychelles;29;0;2979;15
2021-03-07;SC;Seychelles;0;0;2979;15
2021-03-08;SC;Seychelles;21;0;3000;15
2021-03-09;SC;Seychelles;32;0;3032;15
2021-03-10;SC;Seychelles;0;0;3032;15
2021-03-11;SC;Seychelles;100;1;3132;16
2021-03-12;SC;Seychelles;41;0;3173;16
2021-03-13;SC;Seychelles;0;0;3173;16
2021-03-14;SC;Seychelles;142;0;3315;16
2021-03-15;SC;Seychelles;27;0;3342;16
2021-03-16;SC;Seychelles;12;0;3354;16
2021-03-17;SC;Seychelles;132;0;3486;16
2021-03-18;SC;Seychelles;80;0;3566;16
2021-03-19;SC;Seychelles;50;0;3616;16
2021-03-20;SC;Seychelles;154;0;3770;16
2021-03-21;SC;Seychelles;0;0;3770;16
2021-03-22;SC;Seychelles;28;0;3798;16
2021-03-23;SC;Seychelles;0;0;3798;16
2021-03-24;SC;Seychelles;84;2;3882;18
2021-03-25;SC;Seychelles;0;0;3882;18
2021-03-26;SC;Seychelles;114;2;3996;20
2021-03-27;SC;Seychelles;0;0;3996;20
2021-03-28;SC;Seychelles;88;0;4084;20
2021-03-29;SC;Seychelles;30;0;4114;20
2021-03-30;SC;Seychelles;0;0;4114;20
2021-03-31;SC;Seychelles;21;2;4135;22
2021-04-01;SC;Seychelles;0;0;4135;22
2021-04-02;SC;Seychelles;124;2;4259;24
2021-04-03;SC;Seychelles;31;0;4290;24
2021-04-04;SC;Seychelles;0;0;4290;24
2021-04-05;SC;Seychelles;30;0;4320;24
2021-04-06;SC;Seychelles;0;0;4320;24
2021-04-07;SC;Seychelles;12;0;4332;24
2021-04-08;SC;Seychelles;63;0;4395;24
2021-04-09;SC;Seychelles;0;0;4395;24
2021-04-10;SC;Seychelles;0;0;4395;24
2021-04-11;SC;Seychelles;35;0;4430;24
2021-04-12;SC;Seychelles;14;1;4444;25
2021-04-13;SC;Seychelles;189;0;4633;25
2021-04-14;SC;Seychelles;0;0;4633;25
2021-04-15;SC;Seychelles;132;0;4765;25
2021-04-16;SC;Seychelles;69;0;4834;25
2021-04-17;SC;Seychelles;41;0;4875;25
2021-04-18;SC;Seychelles;47;0;4922;25
2021-04-19;SC;Seychelles;54;0;4976;25
2021-04-20;SC;Seychelles;36;0;5012;25
2021-04-21;SC;Seychelles;4;0;5016;25
2021-04-22;SC;Seychelles;154;1;5170;26
2021-04-23;SC;Seychelles;36;0;5206;26
2021-04-24;SC;Seychelles;0;0;5206;26
2021-04-25;SC;Seychelles;78;0;5284;26
2021-04-26;SC;Seychelles;70;0;5354;26
2021-04-27;SC;Seychelles;0;0;5354;26
2021-04-28;SC;Seychelles;102;0;5456;26
2021-04-29;SC;Seychelles;103;0;5559;26
2021-04-30;SC;Seychelles;314;2;5873;28
2021-05-01;SC;Seychelles;0;0;5873;28
2021-05-02;SC;Seychelles;0;0;5873;28
2021-05-03;SC;Seychelles;500;0;6373;28
2021-05-04;SC;Seychelles;0;0;6373;28
2021-05-05;SC;Seychelles;0;0;6373;28
2021-05-06;SC;Seychelles;0;0;6373;28
2021-05-07;SC;Seychelles;0;0;6373;28
2021-05-08;SC;Seychelles;0;0;6373;28
2021-05-09;SC;Seychelles;0;0;6373;28
2021-05-10;SC;Seychelles;1799;0;8172;28
2021-05-11;SC;Seychelles;0;0;8172;28
2021-05-12;SC;Seychelles;0;0;8172;28
2021-05-13;SC;Seychelles;1012;4;9184;32
2021-05-14;SC;Seychelles;0;0;9184;32
2021-05-15;SC;Seychelles;0;0;9184;32
2021-05-16;SC;Seychelles;0;0;9184;32
2021-05-17;SC;Seychelles;580;3;9764;35
2021-05-18;SC;Seychelles;0;0;9764;35
2021-05-19;SC;Seychelles;0;0;9764;35
2021-05-20;SC;Seychelles;0;0;9764;35
2021-05-21;SC;Seychelles;0;0;9764;35
2021-05-22;SC;Seychelles;0;0;9764;35
2021-05-23;SC;Seychelles;0;0;9764;35
2021-05-24;SC;Seychelles;976;3;10740;38
2021-05-25;SC;Seychelles;0;0;10740;38
2021-05-26;SC;Seychelles;0;0;10740;38
2021-05-27;SC;Seychelles;405;2;11145;40
2021-05-28;SC;Seychelles;0;0;11145;40
2021-05-29;SC;Seychelles;0;0;11145;40
2021-05-30;SC;Seychelles;0;0;11145;40
2021-05-31;SC;Seychelles;476;2;11621;42
2021-06-01;SC;Seychelles;0;0;11621;42
2021-06-02;SC;Seychelles;0;0;11621;42
2021-06-03;SC;Seychelles;0;0;11621;42
2021-06-04;SC;Seychelles;537;0;12158;42
2021-06-05;SC;Seychelles;0;0;12158;42
2021-06-06;SC;Seychelles;0;0;12158;42
2021-06-07;SC;Seychelles;308;4;12466;46
2021-06-08;SC;Seychelles;0;0;12466;46
2021-06-09;SC;Seychelles;0;0;12466;46
2021-06-10;SC;Seychelles;0;0;12466;46
2021-06-11;SC;Seychelles;507;0;12973;46
2021-06-12;SC;Seychelles;0;0;12973;46
2021-06-13;SC;Seychelles;0;0;12973;46
2021-06-14;SC;Seychelles;657;4;13630;50
2021-06-15;SC;Seychelles;0;0;13630;50
2021-06-16;SC;Seychelles;0;0;13630;50
2021-06-17;SC;Seychelles;493;5;14123;55
2021-06-18;SC;Seychelles;0;0;14123;55
2021-06-19;SC;Seychelles;0;0;14123;55
2021-06-20;SC;Seychelles;0;0;14123;55
2021-06-21;SC;Seychelles;0;0;14123;55
2021-06-22;SC;Seychelles;497;4;14620;59
2021-06-23;SC;Seychelles;0;0;14620;59
2021-06-24;SC;Seychelles;0;0;14620;59
2021-06-25;SC;Seychelles;496;4;15116;63
2021-06-26;SC;Seychelles;0;0;15116;63
2021-06-27;SC;Seychelles;0;0;15116;63
2021-06-28;SC;Seychelles;463;5;15579;68
2021-06-29;SC;Seychelles;0;0;15579;68
2021-06-30;SC;Seychelles;0;0;15579;68
2021-07-01;SC;Seychelles;0;0;15579;68
2020-03-31;SL;Sierra Leone;1;0;1;0
2020-04-01;SL;Sierra Leone;1;0;2;0
2020-04-02;SL;Sierra Leone;0;0;2;0
2020-04-03;SL;Sierra Leone;0;0;2;0
2020-04-04;SL;Sierra Leone;2;0;4;0
2020-04-05;SL;Sierra Leone;2;0;6;0
2020-04-06;SL;Sierra Leone;0;0;6;0
2020-04-07;SL;Sierra Leone;0;0;6;0
2020-04-08;SL;Sierra Leone;1;0;7;0
2020-04-09;SL;Sierra Leone;0;0;7;0
2020-04-10;SL;Sierra Leone;1;0;8;0
2020-04-11;SL;Sierra Leone;0;0;8;0
2020-04-12;SL;Sierra Leone;2;0;10;0
2020-04-13;SL;Sierra Leone;0;0;10;0
2020-04-14;SL;Sierra Leone;1;0;11;0
2020-04-15;SL;Sierra Leone;2;0;13;0
2020-04-16;SL;Sierra Leone;2;0;15;0
2020-04-17;SL;Sierra Leone;11;0;26;0
2020-04-18;SL;Sierra Leone;4;0;30;0
2020-04-19;SL;Sierra Leone;5;0;35;0
2020-04-20;SL;Sierra Leone;8;0;43;0
2020-04-21;SL;Sierra Leone;7;0;50;0
2020-04-22;SL;Sierra Leone;11;0;61;0
2020-04-23;SL;Sierra Leone;3;1;64;1
2020-04-24;SL;Sierra Leone;18;1;82;2
2020-04-25;SL;Sierra Leone;0;0;82;2
2020-04-26;SL;Sierra Leone;11;2;93;4
2020-04-27;SL;Sierra Leone;0;0;93;4
2020-04-28;SL;Sierra Leone;11;0;104;4
2020-04-29;SL;Sierra Leone;0;0;104;4
2020-04-30;SL;Sierra Leone;20;3;124;7
2020-05-01;SL;Sierra Leone;12;0;136;7
2020-05-02;SL;Sierra Leone;19;1;155;8
2020-05-03;SL;Sierra Leone;11;0;166;8
2020-05-04;SL;Sierra Leone;12;1;178;9
2020-05-05;SL;Sierra Leone;21;2;199;11
2020-05-06;SL;Sierra Leone;26;3;225;14
2020-05-07;SL;Sierra Leone;6;2;231;16
2020-05-08;SL;Sierra Leone;26;1;257;17
2020-05-09;SL;Sierra Leone;34;1;291;18
2020-05-10;SL;Sierra Leone;16;0;307;18
2020-05-11;SL;Sierra Leone;31;1;338;19
2020-05-12;SL;Sierra Leone;0;0;338;19
2020-05-13;SL;Sierra Leone;49;7;387;26
2020-05-14;SL;Sierra Leone;21;0;408;26
2020-05-15;SL;Sierra Leone;39;1;447;27
2020-05-16;SL;Sierra Leone;15;2;462;29
2020-05-17;SL;Sierra Leone;43;3;505;32
2020-05-18;SL;Sierra Leone;14;1;519;33
2020-05-19;SL;Sierra Leone;15;0;534;33
2020-05-20;SL;Sierra Leone;36;1;570;34
2020-05-21;SL;Sierra Leone;15;1;585;35
2020-05-22;SL;Sierra Leone;21;3;606;38
2020-05-23;SL;Sierra Leone;15;1;621;39
2020-05-24;SL;Sierra Leone;86;1;707;40
2020-05-25;SL;Sierra Leone;28;2;735;42
2020-05-26;SL;Sierra Leone;19;2;754;44
2020-05-27;SL;Sierra Leone;28;1;782;45
2020-05-28;SL;Sierra Leone;30;0;812;45
2020-05-29;SL;Sierra Leone;17;0;829;45
2020-05-30;SL;Sierra Leone;23;1;852;46
2020-05-31;SL;Sierra Leone;9;0;861;46
2020-06-01;SL;Sierra Leone;4;0;865;46
2020-06-02;SL;Sierra Leone;31;0;896;46
2020-06-03;SL;Sierra Leone;13;1;909;47
2020-06-04;SL;Sierra Leone;5;0;914;47
2020-06-05;SL;Sierra Leone;15;0;929;47
2020-06-06;SL;Sierra Leone;17;1;946;48
2020-06-07;SL;Sierra Leone;23;0;969;48
2020-06-08;SL;Sierra Leone;32;1;1001;49
2020-06-09;SL;Sierra Leone;24;1;1025;50
2020-06-10;SL;Sierra Leone;37;0;1062;50
2020-06-11;SL;Sierra Leone;23;0;1085;50
2020-06-12;SL;Sierra Leone;18;1;1103;51
2020-06-13;SL;Sierra Leone;29;0;1132;51
2020-06-14;SL;Sierra Leone;37;0;1169;51
2020-06-15;SL;Sierra Leone;7;0;1176;51
2020-06-16;SL;Sierra Leone;49;0;1225;51
2020-06-17;SL;Sierra Leone;24;0;1249;51
2020-06-18;SL;Sierra Leone;23;0;1272;51
2020-06-19;SL;Sierra Leone;26;2;1298;53
2020-06-20;SL;Sierra Leone;11;0;1309;53
2020-06-21;SL;Sierra Leone;18;2;1327;55
2020-06-22;SL;Sierra Leone;13;0;1340;55
2020-06-23;SL;Sierra Leone;7;0;1347;55
2020-06-24;SL;Sierra Leone;7;0;1354;55
2020-06-25;SL;Sierra Leone;0;1;1354;56
2020-06-26;SL;Sierra Leone;40;3;1394;59
2020-06-27;SL;Sierra Leone;16;0;1410;59
2020-06-28;SL;Sierra Leone;17;1;1427;60
2020-06-29;SL;Sierra Leone;23;0;1450;60
2020-06-30;SL;Sierra Leone;12;0;1462;60
2020-07-01;SL;Sierra Leone;36;0;1498;60
2020-07-02;SL;Sierra Leone;20;0;1518;60
2020-07-03;SL;Sierra Leone;6;2;1524;62
2020-07-04;SL;Sierra Leone;9;0;1533;62
2020-07-05;SL;Sierra Leone;9;0;1542;62
2020-07-06;SL;Sierra Leone;5;0;1547;62
2020-07-07;SL;Sierra Leone;25;1;1572;63
2020-07-08;SL;Sierra Leone;12;0;1584;63
2020-07-09;SL;Sierra Leone;14;0;1598;63
2020-07-10;SL;Sierra Leone;15;0;1613;63
2020-07-11;SL;Sierra Leone;5;0;1618;63
2020-07-12;SL;Sierra Leone;17;0;1635;63
2020-07-13;SL;Sierra Leone;7;0;1642;63
2020-07-14;SL;Sierra Leone;9;1;1651;64
2020-07-15;SL;Sierra Leone;17;0;1668;64
2020-07-16;SL;Sierra Leone;10;0;1678;64
2020-07-17;SL;Sierra Leone;10;1;1688;65
2020-07-18;SL;Sierra Leone;13;0;1701;65
2020-07-19;SL;Sierra Leone;10;0;1711;65
2020-07-20;SL;Sierra Leone;0;1;1711;66
2020-07-21;SL;Sierra Leone;16;0;1727;66
2020-07-22;SL;Sierra Leone;4;0;1731;66
2020-07-23;SL;Sierra Leone;21;0;1752;66
2020-07-24;SL;Sierra Leone;13;0;1765;66
2020-07-25;SL;Sierra Leone;3;0;1768;66
2020-07-26;SL;Sierra Leone;15;0;1783;66
2020-07-27;SL;Sierra Leone;0;0;1783;66
2020-07-28;SL;Sierra Leone;3;0;1786;66
2020-07-29;SL;Sierra Leone;17;1;1803;67
2020-07-30;SL;Sierra Leone;15;0;1818;67
2020-07-31;SL;Sierra Leone;5;0;1823;67
2020-08-01;SL;Sierra Leone;0;0;1823;67
2020-08-02;SL;Sierra Leone;20;0;1843;67
2020-08-03;SL;Sierra Leone;5;0;1848;67
2020-08-04;SL;Sierra Leone;7;0;1855;67
2020-08-05;SL;Sierra Leone;5;0;1860;67
2020-08-06;SL;Sierra Leone;17;0;1877;67
2020-08-07;SL;Sierra Leone;10;1;1887;68
2020-08-08;SL;Sierra Leone;8;0;1895;68
2020-08-09;SL;Sierra Leone;21;0;1916;68
2020-08-10;SL;Sierra Leone;1;1;1917;69
2020-08-11;SL;Sierra Leone;15;0;1932;69
2020-08-12;SL;Sierra Leone;5;0;1937;69
2020-08-13;SL;Sierra Leone;3;0;1940;69
2020-08-14;SL;Sierra Leone;7;0;1947;69
2020-08-15;SL;Sierra Leone;7;0;1954;69
2020-08-16;SL;Sierra Leone;2;0;1956;69
2020-08-17;SL;Sierra Leone;0;0;1956;69
2020-08-18;SL;Sierra Leone;3;0;1959;69
2020-08-19;SL;Sierra Leone;2;0;1961;69
2020-08-20;SL;Sierra Leone;8;0;1969;69
2020-08-21;SL;Sierra Leone;3;0;1972;69
2020-08-22;SL;Sierra Leone;8;0;1980;69
2020-08-23;SL;Sierra Leone;12;0;1992;69
2020-08-24;SL;Sierra Leone;5;0;1997;69
2020-08-25;SL;Sierra Leone;4;0;2001;69
2020-08-26;SL;Sierra Leone;2;0;2003;69
2020-08-27;SL;Sierra Leone;10;1;2013;70
2020-08-28;SL;Sierra Leone;0;0;2013;70
2020-08-29;SL;Sierra Leone;6;0;2019;70
2020-08-30;SL;Sierra Leone;3;0;2022;70
2020-08-31;SL;Sierra Leone;0;0;2022;70
2020-09-01;SL;Sierra Leone;6;1;2028;71
2020-09-02;SL;Sierra Leone;1;0;2029;71
2020-09-03;SL;Sierra Leone;6;0;2035;71
2020-09-04;SL;Sierra Leone;6;0;2041;71
2020-09-05;SL;Sierra Leone;0;0;2041;71
2020-09-06;SL;Sierra Leone;13;0;2054;71
2020-09-07;SL;Sierra Leone;1;0;2055;71
2020-09-08;SL;Sierra Leone;9;1;2064;72
2020-09-09;SL;Sierra Leone;3;0;2067;72
2020-09-10;SL;Sierra Leone;2;0;2069;72
2020-09-11;SL;Sierra Leone;18;0;2087;72
2020-09-12;SL;Sierra Leone;9;0;2096;72
2020-09-13;SL;Sierra Leone;13;0;2109;72
2020-09-14;SL;Sierra Leone;2;0;2111;72
2020-09-15;SL;Sierra Leone;15;0;2126;72
2020-09-16;SL;Sierra Leone;7;0;2133;72
2020-09-17;SL;Sierra Leone;0;0;2133;72
2020-09-18;SL;Sierra Leone;20;0;2153;72
2020-09-19;SL;Sierra Leone;6;0;2159;72
2020-09-20;SL;Sierra Leone;9;0;2168;72
2020-09-21;SL;Sierra Leone;0;0;2168;72
2020-09-22;SL;Sierra Leone;6;0;2174;72
2020-09-23;SL;Sierra Leone;9;0;2183;72
2020-09-24;SL;Sierra Leone;5;0;2188;72
2020-09-25;SL;Sierra Leone;11;0;2199;72
2020-09-26;SL;Sierra Leone;9;0;2208;72
2020-09-27;SL;Sierra Leone;7;0;2215;72
2020-09-28;SL;Sierra Leone;0;0;2215;72
2020-09-29;SL;Sierra Leone;7;0;2222;72
2020-09-30;SL;Sierra Leone;9;0;2231;72
2020-10-01;SL;Sierra Leone;7;0;2238;72
2020-10-02;SL;Sierra Leone;14;0;2252;72
2020-10-03;SL;Sierra Leone;7;0;2259;72
2020-10-04;SL;Sierra Leone;10;0;2269;72
2020-10-05;SL;Sierra Leone;0;0;2269;72
2020-10-06;SL;Sierra Leone;8;0;2277;72
2020-10-07;SL;Sierra Leone;10;0;2287;72
2020-10-08;SL;Sierra Leone;6;0;2293;72
2020-10-09;SL;Sierra Leone;2;0;2295;72
2020-10-10;SL;Sierra Leone;5;0;2300;72
2020-10-11;SL;Sierra Leone;6;0;2306;72
2020-10-12;SL;Sierra Leone;0;0;2306;72
2020-10-13;SL;Sierra Leone;3;0;2309;72
2020-10-14;SL;Sierra Leone;6;1;2315;73
2020-10-15;SL;Sierra Leone;8;0;2323;73
2020-10-16;SL;Sierra Leone;2;0;2325;73
2020-10-17;SL;Sierra Leone;2;0;2327;73
2020-10-18;SL;Sierra Leone;3;0;2330;73
2020-10-19;SL;Sierra Leone;1;0;2331;73
2020-10-20;SL;Sierra Leone;5;0;2336;73
2020-10-21;SL;Sierra Leone;1;0;2337;73
2020-10-22;SL;Sierra Leone;3;0;2340;73
2020-10-23;SL;Sierra Leone;3;1;2343;74
2020-10-24;SL;Sierra Leone;2;0;2345;74
2020-10-25;SL;Sierra Leone;1;0;2346;74
2020-10-26;SL;Sierra Leone;0;0;2346;74
2020-10-27;SL;Sierra Leone;4;0;2350;74
2020-10-28;SL;Sierra Leone;4;0;2354;74
2020-10-29;SL;Sierra Leone;8;0;2362;74
2020-10-30;SL;Sierra Leone;3;0;2365;74
2020-10-31;SL;Sierra Leone;1;0;2366;74
2020-11-01;SL;Sierra Leone;0;0;2366;74
2020-11-02;SL;Sierra Leone;0;0;2366;74
2020-11-03;SL;Sierra Leone;2;0;2368;74
2020-11-04;SL;Sierra Leone;1;0;2369;74
2020-11-05;SL;Sierra Leone;2;0;2371;74
2020-11-06;SL;Sierra Leone;2;0;2373;74
2020-11-07;SL;Sierra Leone;8;0;2381;74
2020-11-08;SL;Sierra Leone;0;0;2381;74
2020-11-09;SL;Sierra Leone;4;0;2385;74
2020-11-10;SL;Sierra Leone;1;0;2386;74
2020-11-11;SL;Sierra Leone;0;0;2386;74
2020-11-12;SL;Sierra Leone;1;0;2387;74
2020-11-13;SL;Sierra Leone;2;0;2389;74
2020-11-14;SL;Sierra Leone;2;0;2391;74
2020-11-15;SL;Sierra Leone;0;0;2391;74
2020-11-16;SL;Sierra Leone;0;0;2391;74
2020-11-17;SL;Sierra Leone;1;0;2392;74
2020-11-18;SL;Sierra Leone;5;0;2397;74
2020-11-19;SL;Sierra Leone;0;0;2397;74
2020-11-20;SL;Sierra Leone;2;0;2399;74
2020-11-21;SL;Sierra Leone;6;0;2405;74
2020-11-22;SL;Sierra Leone;0;0;2405;74
2020-11-23;SL;Sierra Leone;1;0;2406;74
2020-11-24;SL;Sierra Leone;0;0;2406;74
2020-11-25;SL;Sierra Leone;2;0;2408;74
2020-11-26;SL;Sierra Leone;1;0;2409;74
2020-11-27;SL;Sierra Leone;1;0;2410;74
2020-11-28;SL;Sierra Leone;0;0;2410;74
2020-11-29;SL;Sierra Leone;1;0;2411;74
2020-11-30;SL;Sierra Leone;1;0;2412;74
2020-12-01;SL;Sierra Leone;1;0;2413;74
2020-12-02;SL;Sierra Leone;3;0;2416;74
2020-12-03;SL;Sierra Leone;0;0;2416;74
2020-12-04;SL;Sierra Leone;4;0;2420;74
2020-12-05;SL;Sierra Leone;0;0;2420;74
2020-12-06;SL;Sierra Leone;6;0;2426;74
2020-12-07;SL;Sierra Leone;2;0;2428;74
2020-12-08;SL;Sierra Leone;0;0;2428;74
2020-12-09;SL;Sierra Leone;6;0;2434;74
2020-12-10;SL;Sierra Leone;1;0;2435;74
2020-12-11;SL;Sierra Leone;3;1;2438;75
2020-12-12;SL;Sierra Leone;2;0;2440;75
2020-12-13;SL;Sierra Leone;0;0;2440;75
2020-12-14;SL;Sierra Leone;5;0;2445;75
2020-12-15;SL;Sierra Leone;6;0;2451;75
2020-12-16;SL;Sierra Leone;9;0;2460;75
2020-12-17;SL;Sierra Leone;4;0;2464;75
2020-12-18;SL;Sierra Leone;22;0;2486;75
2020-12-19;SL;Sierra Leone;11;0;2497;75
2020-12-20;SL;Sierra Leone;12;0;2509;75
2020-12-21;SL;Sierra Leone;0;0;2509;75
2020-12-22;SL;Sierra Leone;9;0;2518;75
2020-12-23;SL;Sierra Leone;6;1;2524;76
2020-12-24;SL;Sierra Leone;7;0;2531;76
2020-12-25;SL;Sierra Leone;18;0;2549;76
2020-12-26;SL;Sierra Leone;0;0;2549;76
2020-12-27;SL;Sierra Leone;11;0;2560;76
2020-12-28;SL;Sierra Leone;0;0;2560;76
2020-12-29;SL;Sierra Leone;9;0;2569;76
2020-12-30;SL;Sierra Leone;14;0;2583;76
2020-12-31;SL;Sierra Leone;28;0;2611;76
2021-01-01;SL;Sierra Leone;24;0;2635;76
2021-01-02;SL;Sierra Leone;11;0;2646;76
2021-01-03;SL;Sierra Leone;27;0;2673;76
2021-01-04;SL;Sierra Leone;0;0;2673;76
2021-01-05;SL;Sierra Leone;51;0;2724;76
2021-01-06;SL;Sierra Leone;15;0;2739;76
2021-01-07;SL;Sierra Leone;18;1;2757;77
2021-01-08;SL;Sierra Leone;25;0;2782;77
2021-01-09;SL;Sierra Leone;21;0;2803;77
2021-01-10;SL;Sierra Leone;31;0;2834;77
2021-01-11;SL;Sierra Leone;12;0;2846;77
2021-01-12;SL;Sierra Leone;18;0;2864;77
2021-01-13;SL;Sierra Leone;23;0;2887;77
2021-01-14;SL;Sierra Leone;46;0;2933;77
2021-01-15;SL;Sierra Leone;26;0;2959;77
2021-01-16;SL;Sierra Leone;11;0;2970;77
2021-01-17;SL;Sierra Leone;36;0;3006;77
2021-01-18;SL;Sierra Leone;8;0;3014;77
2021-01-19;SL;Sierra Leone;16;0;3030;77
2021-01-20;SL;Sierra Leone;0;0;3030;77
2021-01-21;SL;Sierra Leone;51;0;3081;77
2021-01-22;SL;Sierra Leone;12;0;3093;77
2021-01-23;SL;Sierra Leone;27;0;3120;77
2021-01-24;SL;Sierra Leone;19;0;3139;77
2021-01-25;SL;Sierra Leone;34;0;3173;77
2021-01-26;SL;Sierra Leone;21;0;3194;77
2021-01-27;SL;Sierra Leone;42;0;3236;77
2021-01-28;SL;Sierra Leone;46;0;3282;77
2021-01-29;SL;Sierra Leone;100;2;3382;79
2021-01-30;SL;Sierra Leone;146;0;3528;79
2021-01-31;SL;Sierra Leone;65;0;3593;79
2021-02-01;SL;Sierra Leone;41;0;3634;79
2021-02-02;SL;Sierra Leone;26;0;3660;79
2021-02-03;SL;Sierra Leone;39;0;3699;79
2021-02-04;SL;Sierra Leone;29;0;3728;79
2021-02-05;SL;Sierra Leone;31;0;3759;79
2021-02-06;SL;Sierra Leone;13;0;3772;79
2021-02-07;SL;Sierra Leone;13;0;3785;79
2021-02-08;SL;Sierra Leone;4;0;3789;79
2021-02-09;SL;Sierra Leone;12;0;3801;79
2021-02-10;SL;Sierra Leone;2;0;3803;79
2021-02-11;SL;Sierra Leone;10;0;3813;79
2021-02-12;SL;Sierra Leone;4;0;3817;79
2021-02-13;SL;Sierra Leone;4;0;3821;79
2021-02-14;SL;Sierra Leone;0;0;3821;79
2021-02-15;SL;Sierra Leone;2;0;3823;79
2021-02-16;SL;Sierra Leone;2;0;3825;79
2021-02-17;SL;Sierra Leone;0;0;3825;79
2021-02-18;SL;Sierra Leone;4;0;3829;79
2021-02-19;SL;Sierra Leone;12;0;3841;79
2021-02-20;SL;Sierra Leone;8;0;3849;79
2021-02-21;SL;Sierra Leone;6;0;3855;79
2021-02-22;SL;Sierra Leone;2;0;3857;79
2021-02-23;SL;Sierra Leone;5;0;3862;79
2021-02-24;SL;Sierra Leone;18;0;3880;79
2021-02-25;SL;Sierra Leone;4;0;3884;79
2021-02-26;SL;Sierra Leone;0;0;3884;79
2021-02-27;SL;Sierra Leone;3;0;3887;79
2021-02-28;SL;Sierra Leone;0;0;3887;79
2021-03-01;SL;Sierra Leone;0;0;3887;79
2021-03-02;SL;Sierra Leone;2;0;3889;79
2021-03-03;SL;Sierra Leone;11;0;3900;79
2021-03-04;SL;Sierra Leone;0;0;3900;79
2021-03-05;SL;Sierra Leone;9;0;3909;79
2021-03-06;SL;Sierra Leone;9;0;3918;79
2021-03-07;SL;Sierra Leone;2;0;3920;79
2021-03-08;SL;Sierra Leone;1;0;3921;79
2021-03-09;SL;Sierra Leone;1;0;3922;79
2021-03-10;SL;Sierra Leone;6;0;3928;79
2021-03-11;SL;Sierra Leone;4;0;3932;79
2021-03-12;SL;Sierra Leone;2;0;3934;79
2021-03-13;SL;Sierra Leone;3;0;3937;79
2021-03-14;SL;Sierra Leone;0;0;3937;79
2021-03-15;SL;Sierra Leone;1;0;3938;79
2021-03-16;SL;Sierra Leone;1;0;3939;79
2021-03-17;SL;Sierra Leone;3;0;3942;79
2021-03-18;SL;Sierra Leone;5;0;3947;79
2021-03-19;SL;Sierra Leone;0;0;3947;79
2021-03-20;SL;Sierra Leone;1;0;3948;79
2021-03-21;SL;Sierra Leone;0;0;3948;79
2021-03-22;SL;Sierra Leone;0;0;3948;79
2021-03-23;SL;Sierra Leone;1;0;3949;79
2021-03-24;SL;Sierra Leone;4;0;3953;79
2021-03-25;SL;Sierra Leone;0;0;3953;79
2021-03-26;SL;Sierra Leone;9;0;3962;79
2021-03-27;SL;Sierra Leone;0;0;3962;79
2021-03-28;SL;Sierra Leone;8;0;3970;79
2021-03-29;SL;Sierra Leone;0;0;3970;79
2021-03-30;SL;Sierra Leone;0;0;3970;79
2021-03-31;SL;Sierra Leone;10;0;3980;79
2021-04-01;SL;Sierra Leone;1;0;3981;79
2021-04-02;SL;Sierra Leone;6;0;3987;79
2021-04-03;SL;Sierra Leone;0;0;3987;79
2021-04-04;SL;Sierra Leone;1;0;3988;79
2021-04-05;SL;Sierra Leone;1;0;3989;79
2021-04-06;SL;Sierra Leone;1;0;3990;79
2021-04-07;SL;Sierra Leone;3;0;3993;79
2021-04-08;SL;Sierra Leone;0;0;3993;79
2021-04-09;SL;Sierra Leone;2;0;3995;79
2021-04-10;SL;Sierra Leone;0;0;3995;79
2021-04-11;SL;Sierra Leone;10;0;4005;79
2021-04-12;SL;Sierra Leone;3;0;4008;79
2021-04-13;SL;Sierra Leone;1;0;4009;79
2021-04-14;SL;Sierra Leone;4;0;4013;79
2021-04-15;SL;Sierra Leone;3;0;4016;79
2021-04-16;SL;Sierra Leone;0;0;4016;79
2021-04-17;SL;Sierra Leone;4;0;4020;79
2021-04-18;SL;Sierra Leone;8;0;4028;79
2021-04-19;SL;Sierra Leone;10;0;4038;79
2021-04-20;SL;Sierra Leone;3;0;4041;79
2021-04-21;SL;Sierra Leone;1;0;4042;79
2021-04-22;SL;Sierra Leone;2;0;4044;79
2021-04-23;SL;Sierra Leone;0;0;4044;79
2021-04-24;SL;Sierra Leone;0;0;4044;79
2021-04-25;SL;Sierra Leone;0;0;4044;79
2021-04-26;SL;Sierra Leone;2;0;4046;79
2021-04-27;SL;Sierra Leone;0;0;4046;79
2021-04-28;SL;Sierra Leone;3;0;4049;79
2021-04-29;SL;Sierra Leone;4;0;4053;79
2021-04-30;SL;Sierra Leone;1;0;4054;79
2021-05-01;SL;Sierra Leone;3;0;4057;79
2021-05-02;SL;Sierra Leone;5;0;4062;79
2021-05-03;SL;Sierra Leone;0;0;4062;79
2021-05-04;SL;Sierra Leone;6;0;4068;79
2021-05-05;SL;Sierra Leone;0;0;4068;79
2021-05-06;SL;Sierra Leone;0;0;4068;79
2021-05-07;SL;Sierra Leone;0;0;4068;79
2021-05-08;SL;Sierra Leone;0;0;4068;79
2021-05-09;SL;Sierra Leone;0;0;4068;79
2021-05-10;SL;Sierra Leone;21;0;4089;79
2021-05-11;SL;Sierra Leone;0;0;4089;79
2021-05-12;SL;Sierra Leone;0;0;4089;79
2021-05-13;SL;Sierra Leone;7;0;4096;79
2021-05-14;SL;Sierra Leone;7;0;4103;79
2021-05-15;SL;Sierra Leone;0;0;4103;79
2021-05-16;SL;Sierra Leone;4;0;4107;79
2021-05-17;SL;Sierra Leone;0;0;4107;79
2021-05-18;SL;Sierra Leone;0;0;4107;79
2021-05-19;SL;Sierra Leone;0;0;4107;79
2021-05-20;SL;Sierra Leone;8;0;4115;79
2021-05-21;SL;Sierra Leone;0;0;4115;79
2021-05-22;SL;Sierra Leone;6;0;4121;79
2021-05-23;SL;Sierra Leone;0;0;4121;79
2021-05-24;SL;Sierra Leone;0;0;4121;79
2021-05-25;SL;Sierra Leone;0;0;4121;79
2021-05-26;SL;Sierra Leone;0;0;4121;79
2021-05-27;SL;Sierra Leone;12;0;4133;79
2021-05-28;SL;Sierra Leone;7;0;4140;79
2021-05-29;SL;Sierra Leone;1;0;4141;79
2021-05-30;SL;Sierra Leone;6;0;4147;79
2021-05-31;SL;Sierra Leone;0;0;4147;79
2021-06-01;SL;Sierra Leone;1;0;4148;79
2021-06-02;SL;Sierra Leone;8;0;4156;79
2021-06-03;SL;Sierra Leone;6;0;4162;79
2021-06-04;SL;Sierra Leone;6;0;4168;79
2021-06-05;SL;Sierra Leone;20;0;4188;79
2021-06-06;SL;Sierra Leone;13;0;4201;79
2021-06-07;SL;Sierra Leone;7;0;4208;79
2021-06-08;SL;Sierra Leone;11;3;4219;82
2021-06-09;SL;Sierra Leone;32;0;4251;82
2021-06-10;SL;Sierra Leone;38;0;4289;82
2021-06-11;SL;Sierra Leone;23;0;4312;82
2021-06-12;SL;Sierra Leone;37;0;4349;82
2021-06-13;SL;Sierra Leone;39;0;4388;82
2021-06-14;SL;Sierra Leone;45;0;4433;82
2021-06-15;SL;Sierra Leone;16;0;4449;82
2021-06-16;SL;Sierra Leone;56;0;4505;82
2021-06-17;SL;Sierra Leone;48;0;4553;82
2021-06-18;SL;Sierra Leone;78;0;4631;82
2021-06-19;SL;Sierra Leone;71;0;4702;82
2021-06-20;SL;Sierra Leone;114;0;4816;82
2021-06-21;SL;Sierra Leone;63;0;4879;82
2021-06-22;SL;Sierra Leone;84;2;4963;84
2021-06-23;SL;Sierra Leone;0;0;4963;84
2021-06-24;SL;Sierra Leone;192;3;5155;87
2021-06-25;SL;Sierra Leone;98;0;5253;87
2021-06-26;SL;Sierra Leone;53;6;5306;93
2021-06-27;SL;Sierra Leone;75;1;5381;94
2021-06-28;SL;Sierra Leone;62;3;5443;97
2021-06-29;SL;Sierra Leone;52;1;5495;98
2021-06-30;SL;Sierra Leone;80;2;5575;100
2021-07-01;SL;Sierra Leone;77;2;5652;102
2020-01-23;SG;Singapore;1;0;1;0
2020-01-24;SG;Singapore;2;0;3;0
2020-01-25;SG;Singapore;0;0;3;0
2020-01-26;SG;Singapore;1;0;4;0
2020-01-27;SG;Singapore;1;0;5;0
2020-01-28;SG;Singapore;2;0;7;0
2020-01-29;SG;Singapore;0;0;7;0
2020-01-30;SG;Singapore;3;0;10;0
2020-01-31;SG;Singapore;3;0;13;0
2020-02-01;SG;Singapore;3;0;16;0
2020-02-02;SG;Singapore;2;0;18;0
2020-02-03;SG;Singapore;0;0;18;0
2020-02-04;SG;Singapore;6;0;24;0
2020-02-05;SG;Singapore;4;0;28;0
2020-02-06;SG;Singapore;0;0;28;0
2020-02-07;SG;Singapore;2;0;30;0
2020-02-08;SG;Singapore;3;0;33;0
2020-02-09;SG;Singapore;7;0;40;0
2020-02-10;SG;Singapore;5;0;45;0
2020-02-11;SG;Singapore;2;0;47;0
2020-02-12;SG;Singapore;3;0;50;0
2020-02-13;SG;Singapore;8;0;58;0
2020-02-14;SG;Singapore;9;0;67;0
2020-02-15;SG;Singapore;5;0;72;0
2020-02-16;SG;Singapore;3;0;75;0
2020-02-17;SG;Singapore;2;0;77;0
2020-02-18;SG;Singapore;4;0;81;0
2020-02-19;SG;Singapore;3;0;84;0
2020-02-20;SG;Singapore;0;0;84;0
2020-02-21;SG;Singapore;1;0;85;0
2020-02-22;SG;Singapore;0;0;85;0
2020-02-23;SG;Singapore;4;0;89;0
2020-02-24;SG;Singapore;0;0;89;0
2020-02-25;SG;Singapore;2;0;91;0
2020-02-26;SG;Singapore;2;0;93;0
2020-02-27;SG;Singapore;0;0;93;0
2020-02-28;SG;Singapore;0;0;93;0
2020-02-29;SG;Singapore;9;0;102;0
2020-03-01;SG;Singapore;4;0;106;0
2020-03-02;SG;Singapore;2;0;108;0
2020-03-03;SG;Singapore;2;0;110;0
2020-03-04;SG;Singapore;0;0;110;0
2020-03-05;SG;Singapore;7;0;117;0
2020-03-06;SG;Singapore;13;0;130;0
2020-03-07;SG;Singapore;8;0;138;0
2020-03-08;SG;Singapore;12;0;150;0
2020-03-09;SG;Singapore;0;0;150;0
2020-03-10;SG;Singapore;10;0;160;0
2020-03-11;SG;Singapore;18;0;178;0
2020-03-12;SG;Singapore;0;0;178;0
2020-03-13;SG;Singapore;22;0;200;0
2020-03-14;SG;Singapore;12;0;212;0
2020-03-15;SG;Singapore;14;0;226;0
2020-03-16;SG;Singapore;17;0;243;0
2020-03-17;SG;Singapore;23;0;266;0
2020-03-18;SG;Singapore;47;0;313;0
2020-03-19;SG;Singapore;32;0;345;0
2020-03-20;SG;Singapore;40;0;385;0
2020-03-21;SG;Singapore;47;2;432;2
2020-03-22;SG;Singapore;23;0;455;2
2020-03-23;SG;Singapore;54;0;509;2
2020-03-24;SG;Singapore;49;0;558;2
2020-03-25;SG;Singapore;73;0;631;2
2020-03-26;SG;Singapore;52;0;683;2
2020-03-27;SG;Singapore;49;0;732;2
2020-03-28;SG;Singapore;70;0;802;2
2020-03-29;SG;Singapore;42;1;844;3
2020-03-30;SG;Singapore;35;0;879;3
2020-03-31;SG;Singapore;47;0;926;3
2020-04-01;SG;Singapore;74;0;1000;3
2020-04-02;SG;Singapore;49;1;1049;4
2020-04-03;SG;Singapore;65;1;1114;5
2020-04-04;SG;Singapore;75;1;1189;6
2020-04-05;SG;Singapore;120;0;1309;6
2020-04-06;SG;Singapore;66;0;1375;6
2020-04-07;SG;Singapore;106;0;1481;6
2020-04-08;SG;Singapore;142;0;1623;6
2020-04-09;SG;Singapore;287;0;1910;6
2020-04-10;SG;Singapore;198;1;2108;7
2020-04-11;SG;Singapore;191;1;2299;8
2020-04-12;SG;Singapore;233;0;2532;8
2020-04-13;SG;Singapore;386;1;2918;9
2020-04-14;SG;Singapore;334;1;3252;10
2020-04-15;SG;Singapore;447;0;3699;10
2020-04-16;SG;Singapore;728;0;4427;10
2020-04-17;SG;Singapore;623;1;5050;11
2020-04-18;SG;Singapore;942;0;5992;11
2020-04-19;SG;Singapore;596;0;6588;11
2020-04-20;SG;Singapore;1426;0;8014;11
2020-04-21;SG;Singapore;1111;0;9125;11
2020-04-22;SG;Singapore;1016;1;10141;12
2020-04-23;SG;Singapore;1037;0;11178;12
2020-04-24;SG;Singapore;897;0;12075;12
2020-04-25;SG;Singapore;618;0;12693;12
2020-04-26;SG;Singapore;931;0;13624;12
2020-04-27;SG;Singapore;799;2;14423;14
2020-04-28;SG;Singapore;528;0;14951;14
2020-04-29;SG;Singapore;690;0;15641;14
2020-04-30;SG;Singapore;528;1;16169;15
2020-05-01;SG;Singapore;932;1;17101;16
2020-05-02;SG;Singapore;447;1;17548;17
2020-05-03;SG;Singapore;657;1;18205;18
2020-05-04;SG;Singapore;573;0;18778;18
2020-05-05;SG;Singapore;632;0;19410;18
2020-05-06;SG;Singapore;788;2;20198;20
2020-05-07;SG;Singapore;741;0;20939;20
2020-05-08;SG;Singapore;768;0;21707;20
2020-05-09;SG;Singapore;753;0;22460;20
2020-05-10;SG;Singapore;876;0;23336;20
2020-05-11;SG;Singapore;486;1;23822;21
2020-05-12;SG;Singapore;849;0;24671;21
2020-05-13;SG;Singapore;675;0;25346;21
2020-05-14;SG;Singapore;752;0;26098;21
2020-05-15;SG;Singapore;793;0;26891;21
2020-05-16;SG;Singapore;465;1;27356;22
2020-05-17;SG;Singapore;682;0;28038;22
2020-05-18;SG;Singapore;305;0;28343;22
2020-05-19;SG;Singapore;451;0;28794;22
2020-05-20;SG;Singapore;570;0;29364;22
2020-05-21;SG;Singapore;448;1;29812;23
2020-05-22;SG;Singapore;614;0;30426;23
2020-05-23;SG;Singapore;642;0;31068;23
2020-05-24;SG;Singapore;548;0;31616;23
2020-05-25;SG;Singapore;344;0;31960;23
2020-05-26;SG;Singapore;383;0;32343;23
2020-05-27;SG;Singapore;533;0;32876;23
2020-05-28;SG;Singapore;373;0;33249;23
2020-05-29;SG;Singapore;611;0;33860;23
2020-05-30;SG;Singapore;506;0;34366;23
2020-05-31;SG;Singapore;518;0;34884;23
2020-06-01;SG;Singapore;408;1;35292;24
2020-06-02;SG;Singapore;544;0;35836;24
2020-06-03;SG;Singapore;569;0;36405;24
2020-06-04;SG;Singapore;517;0;36922;24
2020-06-05;SG;Singapore;261;0;37183;24
2020-06-06;SG;Singapore;344;1;37527;25
2020-06-07;SG;Singapore;383;0;37910;25
2020-06-08;SG;Singapore;386;0;38296;25
2020-06-09;SG;Singapore;218;0;38514;25
2020-06-10;SG;Singapore;451;0;38965;25
2020-06-11;SG;Singapore;422;0;39387;25
2020-06-12;SG;Singapore;463;0;39850;25
2020-06-13;SG;Singapore;347;1;40197;26
2020-06-14;SG;Singapore;407;0;40604;26
2020-06-15;SG;Singapore;214;0;40818;26
2020-06-16;SG;Singapore;151;0;40969;26
2020-06-17;SG;Singapore;247;0;41216;26
2020-06-18;SG;Singapore;257;0;41473;26
2020-06-19;SG;Singapore;142;0;41615;26
2020-06-20;SG;Singapore;218;0;41833;26
2020-06-21;SG;Singapore;262;0;42095;26
2020-06-22;SG;Singapore;218;0;42313;26
2020-06-23;SG;Singapore;119;0;42432;26
2020-06-24;SG;Singapore;191;0;42623;26
2020-06-25;SG;Singapore;113;0;42736;26
2020-06-26;SG;Singapore;219;0;42955;26
2020-06-27;SG;Singapore;291;0;43246;26
2020-06-28;SG;Singapore;213;0;43459;26
2020-06-29;SG;Singapore;202;0;43661;26
2020-06-30;SG;Singapore;246;0;43907;26
2020-07-01;SG;Singapore;215;0;44122;26
2020-07-02;SG;Singapore;188;0;44310;26
2020-07-03;SG;Singapore;169;0;44479;26
2020-07-04;SG;Singapore;185;0;44664;26
2020-07-05;SG;Singapore;136;0;44800;26
2020-07-06;SG;Singapore;183;0;44983;26
2020-07-07;SG;Singapore;157;0;45140;26
2020-07-08;SG;Singapore;158;0;45298;26
2020-07-09;SG;Singapore;125;0;45423;26
2020-07-10;SG;Singapore;191;0;45614;26
2020-07-11;SG;Singapore;169;0;45783;26
2020-07-12;SG;Singapore;178;0;45961;26
2020-07-13;SG;Singapore;322;0;46283;26
2020-07-14;SG;Singapore;347;1;46630;27
2020-07-15;SG;Singapore;248;0;46878;27
2020-07-16;SG;Singapore;248;0;47126;27
2020-07-17;SG;Singapore;327;0;47453;27
2020-07-18;SG;Singapore;202;0;47655;27
2020-07-19;SG;Singapore;257;0;47912;27
2020-07-20;SG;Singapore;123;0;48035;27
2020-07-21;SG;Singapore;399;0;48434;27
2020-07-22;SG;Singapore;310;0;48744;27
2020-07-23;SG;Singapore;354;0;49098;27
2020-07-24;SG;Singapore;277;0;49375;27
2020-07-25;SG;Singapore;513;0;49888;27
2020-07-26;SG;Singapore;481;0;50369;27
2020-07-27;SG;Singapore;469;0;50838;27
2020-07-28;SG;Singapore;359;0;51197;27
2020-07-29;SG;Singapore;334;0;51531;27
2020-07-30;SG;Singapore;278;0;51809;27
2020-07-31;SG;Singapore;396;0;52205;27
2020-08-01;SG;Singapore;307;0;52512;27
2020-08-02;SG;Singapore;313;0;52825;27
2020-08-03;SG;Singapore;226;0;53051;27
2020-08-04;SG;Singapore;295;0;53346;27
2020-08-05;SG;Singapore;908;0;54254;27
2020-08-06;SG;Singapore;301;0;54555;27
2020-08-07;SG;Singapore;242;0;54797;27
2020-08-08;SG;Singapore;132;0;54929;27
2020-08-09;SG;Singapore;175;0;55104;27
2020-08-10;SG;Singapore;188;0;55292;27
2020-08-11;SG;Singapore;61;0;55353;27
2020-08-12;SG;Singapore;42;0;55395;27
2020-08-13;SG;Singapore;102;0;55497;27
2020-08-14;SG;Singapore;83;0;55580;27
2020-08-15;SG;Singapore;81;0;55661;27
2020-08-16;SG;Singapore;86;0;55747;27
2020-08-17;SG;Singapore;91;0;55838;27
2020-08-18;SG;Singapore;100;0;55938;27
2020-08-19;SG;Singapore;93;0;56031;27
2020-08-20;SG;Singapore;68;0;56099;27
2020-08-21;SG;Singapore;117;0;56216;27
2020-08-22;SG;Singapore;50;0;56266;27
2020-08-23;SG;Singapore;87;0;56353;27
2020-08-24;SG;Singapore;51;0;56404;27
2020-08-25;SG;Singapore;31;0;56435;27
2020-08-26;SG;Singapore;60;0;56495;27
2020-08-27;SG;Singapore;77;0;56572;27
2020-08-28;SG;Singapore;94;0;56666;27
2020-08-29;SG;Singapore;51;0;56717;27
2020-08-30;SG;Singapore;54;0;56771;27
2020-08-31;SG;Singapore;41;0;56812;27
2020-09-01;SG;Singapore;40;0;56852;27
2020-09-02;SG;Singapore;8;0;56860;27
2020-09-03;SG;Singapore;48;0;56908;27
2020-09-04;SG;Singapore;40;0;56948;27
2020-09-05;SG;Singapore;34;0;56982;27
2020-09-06;SG;Singapore;40;0;57022;27
2020-09-07;SG;Singapore;22;0;57044;27
2020-09-08;SG;Singapore;47;0;57091;27
2020-09-09;SG;Singapore;75;0;57166;27
2020-09-10;SG;Singapore;63;0;57229;27
2020-09-11;SG;Singapore;86;0;57315;27
2020-09-12;SG;Singapore;42;0;57357;27
2020-09-13;SG;Singapore;49;0;57406;27
2020-09-14;SG;Singapore;48;0;57454;27
2020-09-15;SG;Singapore;34;0;57488;27
2020-09-16;SG;Singapore;26;0;57514;27
2020-09-17;SG;Singapore;18;0;57532;27
2020-09-18;SG;Singapore;11;0;57543;27
2020-09-19;SG;Singapore;15;0;57558;27
2020-09-20;SG;Singapore;18;0;57576;27
2020-09-21;SG;Singapore;30;0;57606;27
2020-09-22;SG;Singapore;21;0;57627;27
2020-09-23;SG;Singapore;12;0;57639;27
2020-09-24;SG;Singapore;15;0;57654;27
2020-09-25;SG;Singapore;11;0;57665;27
2020-09-26;SG;Singapore;20;0;57685;27
2020-09-27;SG;Singapore;15;0;57700;27
2020-09-28;SG;Singapore;15;0;57715;27
2020-09-29;SG;Singapore;27;0;57742;27
2020-09-30;SG;Singapore;23;0;57765;27
2020-10-01;SG;Singapore;19;0;57784;27
2020-10-02;SG;Singapore;10;0;57794;27
2020-10-03;SG;Singapore;6;0;57800;27
2020-10-04;SG;Singapore;12;0;57812;27
2020-10-05;SG;Singapore;7;0;57819;27
2020-10-06;SG;Singapore;11;0;57830;27
2020-10-07;SG;Singapore;10;0;57840;27
2020-10-08;SG;Singapore;9;0;57849;27
2020-10-09;SG;Singapore;10;0;57859;27
2020-10-10;SG;Singapore;7;0;57866;27
2020-10-11;SG;Singapore;10;0;57876;27
2020-10-12;SG;Singapore;4;1;57880;28
2020-10-13;SG;Singapore;4;0;57884;28
2020-10-14;SG;Singapore;5;0;57889;28
2020-10-15;SG;Singapore;3;0;57892;28
2020-10-16;SG;Singapore;9;0;57901;28
2020-10-17;SG;Singapore;3;0;57904;28
2020-10-18;SG;Singapore;7;0;57911;28
2020-10-19;SG;Singapore;4;0;57915;28
2020-10-20;SG;Singapore;6;0;57921;28
2020-10-21;SG;Singapore;12;0;57933;28
2020-10-22;SG;Singapore;8;0;57941;28
2020-10-23;SG;Singapore;10;0;57951;28
2020-10-24;SG;Singapore;14;0;57965;28
2020-10-25;SG;Singapore;5;0;57970;28
2020-10-26;SG;Singapore;3;0;57973;28
2020-10-27;SG;Singapore;7;0;57980;28
2020-10-28;SG;Singapore;7;0;57987;28
2020-10-29;SG;Singapore;7;0;57994;28
2020-10-30;SG;Singapore;9;0;58003;28
2020-10-31;SG;Singapore;12;0;58015;28
2020-11-01;SG;Singapore;4;0;58019;28
2020-11-02;SG;Singapore;1;0;58020;28
2020-11-03;SG;Singapore;9;0;58029;28
2020-11-04;SG;Singapore;7;0;58036;28
2020-11-05;SG;Singapore;7;0;58043;28
2020-11-06;SG;Singapore;4;0;58047;28
2020-11-07;SG;Singapore;7;0;58054;28
2020-11-08;SG;Singapore;2;0;58056;28
2020-11-09;SG;Singapore;8;0;58064;28
2020-11-10;SG;Singapore;9;0;58073;28
2020-11-11;SG;Singapore;18;0;58091;28
2020-11-12;SG;Singapore;11;0;58102;28
2020-11-13;SG;Singapore;12;0;58114;28
2020-11-14;SG;Singapore;2;0;58116;28
2020-11-15;SG;Singapore;3;0;58119;28
2020-11-16;SG;Singapore;5;0;58124;28
2020-11-17;SG;Singapore;6;0;58130;28
2020-11-18;SG;Singapore;5;0;58135;28
2020-11-19;SG;Singapore;4;0;58139;28
2020-11-20;SG;Singapore;4;0;58143;28
2020-11-21;SG;Singapore;5;0;58148;28
2020-11-22;SG;Singapore;12;0;58160;28
2020-11-23;SG;Singapore;5;0;58165;28
2020-11-24;SG;Singapore;18;0;58183;28
2020-11-25;SG;Singapore;7;0;58190;28
2020-11-26;SG;Singapore;5;0;58195;28
2020-11-27;SG;Singapore;4;0;58199;28
2020-11-28;SG;Singapore;6;1;58205;29
2020-11-29;SG;Singapore;8;0;58213;29
2020-11-30;SG;Singapore;5;0;58218;29
2020-12-01;SG;Singapore;10;0;58228;29
2020-12-02;SG;Singapore;2;0;58230;29
2020-12-03;SG;Singapore;9;0;58239;29
2020-12-04;SG;Singapore;3;0;58242;29
2020-12-05;SG;Singapore;13;0;58255;29
2020-12-06;SG;Singapore;5;0;58260;29
2020-12-07;SG;Singapore;13;0;58273;29
2020-12-08;SG;Singapore;12;0;58285;29
2020-12-09;SG;Singapore;6;0;58291;29
2020-12-10;SG;Singapore;6;0;58297;29
2020-12-11;SG;Singapore;8;0;58305;29
2020-12-12;SG;Singapore;8;0;58313;29
2020-12-13;SG;Singapore;7;0;58320;29
2020-12-14;SG;Singapore;5;0;58325;29
2020-12-15;SG;Singapore;16;0;58341;29
2020-12-16;SG;Singapore;12;0;58353;29
2020-12-17;SG;Singapore;24;0;58377;29
2020-12-18;SG;Singapore;9;0;58386;29
2020-12-19;SG;Singapore;17;0;58403;29
2020-12-20;SG;Singapore;19;0;58422;29
2020-12-21;SG;Singapore;10;0;58432;29
2020-12-22;SG;Singapore;29;0;58461;29
2020-12-23;SG;Singapore;21;0;58482;29
2020-12-24;SG;Singapore;13;0;58495;29
2020-12-25;SG;Singapore;14;0;58509;29
2020-12-26;SG;Singapore;10;0;58519;29
2020-12-27;SG;Singapore;5;0;58524;29
2020-12-28;SG;Singapore;5;0;58529;29
2020-12-29;SG;Singapore;13;0;58542;29
2020-12-30;SG;Singapore;27;0;58569;29
2020-12-31;SG;Singapore;30;0;58599;29
2021-01-01;SG;Singapore;30;0;58629;29
2021-01-02;SG;Singapore;33;0;58662;29
2021-01-03;SG;Singapore;35;0;58697;29
2021-01-04;SG;Singapore;24;0;58721;29
2021-01-05;SG;Singapore;28;0;58749;29
2021-01-06;SG;Singapore;31;0;58780;29
2021-01-07;SG;Singapore;33;0;58813;29
2021-01-08;SG;Singapore;23;0;58836;29
2021-01-09;SG;Singapore;29;0;58865;29
2021-01-10;SG;Singapore;42;0;58907;29
2021-01-11;SG;Singapore;22;0;58929;29
2021-01-12;SG;Singapore;17;0;58946;29
2021-01-13;SG;Singapore;38;0;58984;29
2021-01-14;SG;Singapore;45;0;59029;29
2021-01-15;SG;Singapore;30;0;59059;29
2021-01-16;SG;Singapore;24;0;59083;29
2021-01-17;SG;Singapore;30;0;59113;29
2021-01-18;SG;Singapore;14;0;59127;29
2021-01-19;SG;Singapore;30;0;59157;29
2021-01-20;SG;Singapore;40;0;59197;29
2021-01-21;SG;Singapore;38;0;59235;29
2021-01-22;SG;Singapore;15;0;59250;29
2021-01-23;SG;Singapore;10;0;59260;29
2021-01-24;SG;Singapore;48;0;59308;29
2021-01-25;SG;Singapore;44;0;59352;29
2021-01-26;SG;Singapore;14;0;59366;29
2021-01-27;SG;Singapore;25;0;59391;29
2021-01-28;SG;Singapore;34;0;59425;29
2021-01-29;SG;Singapore;24;0;59449;29
2021-01-30;SG;Singapore;58;0;59507;29
2021-01-31;SG;Singapore;29;0;59536;29
2021-02-01;SG;Singapore;29;0;59565;29
2021-02-02;SG;Singapore;19;0;59584;29
2021-02-03;SG;Singapore;18;0;59602;29
2021-02-04;SG;Singapore;22;0;59624;29
2021-02-05;SG;Singapore;25;0;59649;29
2021-02-06;SG;Singapore;26;0;59675;29
2021-02-07;SG;Singapore;24;0;59699;29
2021-02-08;SG;Singapore;22;0;59721;29
2021-02-09;SG;Singapore;11;0;59732;29
2021-02-10;SG;Singapore;15;0;59747;29
2021-02-11;SG;Singapore;12;0;59759;29
2021-02-12;SG;Singapore;18;0;59777;29
2021-02-13;SG;Singapore;9;0;59786;29
2021-02-14;SG;Singapore;14;0;59800;29
2021-02-15;SG;Singapore;9;0;59809;29
2021-02-16;SG;Singapore;1;0;59810;29
2021-02-17;SG;Singapore;11;0;59821;29
2021-02-18;SG;Singapore;11;0;59832;29
2021-02-19;SG;Singapore;14;0;59846;29
2021-02-20;SG;Singapore;12;0;59858;29
2021-02-21;SG;Singapore;11;0;59869;29
2021-02-22;SG;Singapore;10;0;59879;29
2021-02-23;SG;Singapore;4;0;59883;29
2021-02-24;SG;Singapore;7;0;59890;29
2021-02-25;SG;Singapore;10;0;59900;29
2021-02-26;SG;Singapore;13;0;59913;29
2021-02-27;SG;Singapore;12;0;59925;29
2021-02-28;SG;Singapore;11;0;59936;29
2021-03-01;SG;Singapore;12;0;59948;29
2021-03-02;SG;Singapore;8;0;59956;29
2021-03-03;SG;Singapore;23;0;59979;29
2021-03-04;SG;Singapore;19;0;59998;29
2021-03-05;SG;Singapore;9;0;60007;29
2021-03-06;SG;Singapore;13;0;60020;29
2021-03-07;SG;Singapore;13;0;60033;29
2021-03-08;SG;Singapore;13;0;60046;29
2021-03-09;SG;Singapore;6;0;60052;29
2021-03-10;SG;Singapore;10;0;60062;29
2021-03-11;SG;Singapore;8;0;60070;29
2021-03-12;SG;Singapore;10;0;60080;29
2021-03-13;SG;Singapore;8;1;60088;30
2021-03-14;SG;Singapore;17;0;60105;30
2021-03-15;SG;Singapore;12;0;60117;30
2021-03-16;SG;Singapore;11;0;60128;30
2021-03-17;SG;Singapore;9;0;60137;30
2021-03-18;SG;Singapore;15;0;60152;30
2021-03-19;SG;Singapore;15;0;60167;30
2021-03-20;SG;Singapore;17;0;60184;30
2021-03-21;SG;Singapore;12;0;60196;30
2021-03-22;SG;Singapore;12;0;60208;30
2021-03-23;SG;Singapore;13;0;60221;30
2021-03-24;SG;Singapore;15;0;60236;30
2021-03-25;SG;Singapore;17;0;60253;30
2021-03-26;SG;Singapore;12;0;60265;30
2021-03-27;SG;Singapore;23;0;60288;30
2021-03-28;SG;Singapore;12;0;60300;30
2021-03-29;SG;Singapore;21;0;60321;30
2021-03-30;SG;Singapore;26;0;60347;30
2021-03-31;SG;Singapore;34;0;60381;30
2021-04-01;SG;Singapore;26;0;60407;30
2021-04-02;SG;Singapore;43;0;60450;30
2021-04-03;SG;Singapore;18;0;60468;30
2021-04-04;SG;Singapore;10;0;60478;30
2021-04-05;SG;Singapore;17;0;60495;30
2021-04-06;SG;Singapore;24;0;60519;30
2021-04-07;SG;Singapore;35;0;60554;30
2021-04-08;SG;Singapore;21;0;60575;30
2021-04-09;SG;Singapore;26;0;60601;30
2021-04-10;SG;Singapore;32;0;60633;30
2021-04-11;SG;Singapore;20;0;60653;30
2021-04-12;SG;Singapore;25;0;60678;30
2021-04-13;SG;Singapore;14;0;60692;30
2021-04-14;SG;Singapore;27;0;60719;30
2021-04-15;SG;Singapore;16;0;60735;30
2021-04-16;SG;Singapore;34;0;60769;30
2021-04-17;SG;Singapore;39;0;60808;30
2021-04-18;SG;Singapore;23;0;60831;30
2021-04-19;SG;Singapore;20;0;60851;30
2021-04-20;SG;Singapore;14;0;60865;30
2021-04-21;SG;Singapore;15;0;60880;30
2021-04-22;SG;Singapore;24;0;60904;30
2021-04-23;SG;Singapore;39;0;60943;30
2021-04-24;SG;Singapore;23;0;60966;30
2021-04-25;SG;Singapore;40;0;61006;30
2021-04-26;SG;Singapore;45;0;61051;30
2021-04-27;SG;Singapore;12;0;61063;30
2021-04-28;SG;Singapore;23;0;61086;30
2021-04-29;SG;Singapore;35;0;61121;30
2021-04-30;SG;Singapore;24;0;61145;30
2021-05-01;SG;Singapore;34;1;61179;31
2021-05-02;SG;Singapore;39;0;61218;31
2021-05-03;SG;Singapore;17;0;61235;31
2021-05-04;SG;Singapore;17;0;61252;31
2021-05-05;SG;Singapore;16;0;61268;31
2021-05-06;SG;Singapore;18;0;61286;31
2021-05-07;SG;Singapore;25;0;61311;31
2021-05-08;SG;Singapore;20;0;61331;31
2021-05-09;SG;Singapore;28;0;61359;31
2021-05-10;SG;Singapore;19;0;61378;31
2021-05-11;SG;Singapore;25;0;61403;31
2021-05-12;SG;Singapore;16;0;61419;31
2021-05-13;SG;Singapore;34;0;61453;31
2021-05-14;SG;Singapore;52;0;61505;31
2021-05-15;SG;Singapore;31;0;61536;31
2021-05-16;SG;Singapore;49;0;61585;31
2021-05-17;SG;Singapore;28;0;61613;31
2021-05-18;SG;Singapore;38;0;61651;31
2021-05-19;SG;Singapore;38;0;61689;31
2021-05-20;SG;Singapore;41;1;61730;32
2021-05-21;SG;Singapore;40;0;61770;32
2021-05-22;SG;Singapore;29;0;61799;32
2021-05-23;SG;Singapore;25;0;61824;32
2021-05-24;SG;Singapore;36;0;61860;32
2021-05-25;SG;Singapore;30;0;61890;32
2021-05-26;SG;Singapore;26;0;61916;32
2021-05-27;SG;Singapore;24;0;61940;32
2021-05-28;SG;Singapore;30;0;61970;32
2021-05-29;SG;Singapore;33;0;62003;32
2021-05-30;SG;Singapore;25;1;62028;33
2021-05-31;SG;Singapore;23;0;62051;33
2021-06-01;SG;Singapore;18;0;62069;33
2021-06-02;SG;Singapore;31;0;62100;33
2021-06-03;SG;Singapore;45;0;62145;33
2021-06-04;SG;Singapore;13;0;62158;33
2021-06-05;SG;Singapore;18;0;62176;33
2021-06-06;SG;Singapore;20;0;62196;33
2021-06-07;SG;Singapore;14;0;62210;33
2021-06-08;SG;Singapore;9;1;62219;34
2021-06-09;SG;Singapore;4;0;62223;34
2021-06-10;SG;Singapore;13;0;62236;34
2021-06-11;SG;Singapore;9;0;62245;34
2021-06-12;SG;Singapore;18;0;62263;34
2021-06-13;SG;Singapore;13;0;62276;34
2021-06-14;SG;Singapore;25;0;62301;34
2021-06-15;SG;Singapore;14;0;62315;34
2021-06-16;SG;Singapore;24;0;62339;34
2021-06-17;SG;Singapore;27;0;62366;34
2021-06-18;SG;Singapore;16;0;62382;34
2021-06-19;SG;Singapore;21;0;62403;34
2021-06-20;SG;Singapore;11;0;62414;34
2021-06-21;SG;Singapore;16;1;62430;35
2021-06-22;SG;Singapore;18;0;62448;35
2021-06-23;SG;Singapore;22;0;62470;35
2021-06-24;SG;Singapore;23;0;62493;35
2021-06-25;SG;Singapore;20;0;62513;35
2021-06-26;SG;Singapore;17;1;62530;36
2021-06-27;SG;Singapore;14;0;62544;36
2021-06-28;SG;Singapore;9;0;62553;36
2021-06-29;SG;Singapore;354;0;62907;36
2021-06-30;SG;Singapore;-328;0;62579;36
2021-07-01;SG;Singapore;10;0;62589;36
2021-05-07;SX;Sint Maarten (Dutch part);0;0;0;0
2021-05-08;SX;Sint Maarten (Dutch part);0;0;0;0
2021-05-09;SX;Sint Maarten (Dutch part);0;0;0;0
2021-05-10;SX;Sint Maarten (Dutch part);0;0;0;0
2021-05-11;SX;Sint Maarten (Dutch part);0;0;0;0
2021-05-12;SX;Sint Maarten (Dutch part);0;0;0;0
2021-05-13;SX;Sint Maarten (Dutch part);0;0;0;0
2021-05-14;SX;Sint Maarten (Dutch part);0;0;0;0
2021-05-15;SX;Sint Maarten (Dutch part);0;0;0;0
2021-05-16;SX;Sint Maarten (Dutch part);0;0;0;0
2021-05-17;SX;Sint Maarten (Dutch part);0;0;0;0
2021-05-18;SX;Sint Maarten (Dutch part);0;0;0;0
2021-05-19;SX;Sint Maarten (Dutch part);0;0;0;0
2021-05-20;SX;Sint Maarten (Dutch part);0;0;0;0
2021-05-21;SX;Sint Maarten (Dutch part);0;0;0;0
2021-05-22;SX;Sint Maarten (Dutch part);0;0;0;0
2021-05-23;SX;Sint Maarten (Dutch part);0;0;0;0
2021-05-24;SX;Sint Maarten (Dutch part);0;0;0;0
2021-05-25;SX;Sint Maarten (Dutch part);0;0;0;0
2021-05-26;SX;Sint Maarten (Dutch part);0;0;0;0
2021-05-27;SX;Sint Maarten (Dutch part);0;0;0;0
2021-05-28;SX;Sint Maarten (Dutch part);0;0;0;0
2021-05-29;SX;Sint Maarten (Dutch part);0;0;0;0
2021-05-30;SX;Sint Maarten (Dutch part);0;0;0;0
2021-05-31;SX;Sint Maarten (Dutch part);0;0;0;0
2021-06-01;SX;Sint Maarten (Dutch part);0;0;0;0
2021-06-02;SX;Sint Maarten (Dutch part);0;0;0;0
2021-06-03;SX;Sint Maarten (Dutch part);0;0;0;0
2021-06-04;SX;Sint Maarten (Dutch part);0;0;0;0
2021-06-05;SX;Sint Maarten (Dutch part);0;0;0;0
2021-06-06;SX;Sint Maarten (Dutch part);0;0;0;0
2021-06-07;SX;Sint Maarten (Dutch part);0;0;0;0
2021-06-08;SX;Sint Maarten (Dutch part);0;0;0;0
2021-06-09;SX;Sint Maarten (Dutch part);0;0;0;0
2021-06-10;SX;Sint Maarten (Dutch part);0;0;0;0
2021-06-11;SX;Sint Maarten (Dutch part);0;0;0;0
2021-06-12;SX;Sint Maarten (Dutch part);0;0;0;0
2021-06-13;SX;Sint Maarten (Dutch part);0;0;0;0
2021-06-14;SX;Sint Maarten (Dutch part);0;0;0;0
2021-06-15;SX;Sint Maarten (Dutch part);0;0;0;0
2021-06-16;SX;Sint Maarten (Dutch part);0;0;0;0
2021-06-17;SX;Sint Maarten (Dutch part);0;0;0;0
2021-06-18;SX;Sint Maarten (Dutch part);0;0;0;0
2021-06-19;SX;Sint Maarten (Dutch part);0;0;0;0
2021-06-20;SX;Sint Maarten (Dutch part);0;0;0;0
2021-06-21;SX;Sint Maarten (Dutch part);0;0;0;0
2021-06-22;SX;Sint Maarten (Dutch part);0;0;0;0
2021-06-23;SX;Sint Maarten (Dutch part);0;0;0;0
2021-06-24;SX;Sint Maarten (Dutch part);0;0;0;0
2021-06-25;SX;Sint Maarten (Dutch part);0;0;0;0
2020-03-06;SK;Slovakia;1;0;1;0
2020-03-07;SK;Slovakia;0;0;1;0
2020-03-08;SK;Slovakia;2;0;3;0
2020-03-09;SK;Slovakia;0;0;3;0
2020-03-10;SK;Slovakia;4;0;7;0
2020-03-11;SK;Slovakia;3;0;10;0
2020-03-12;SK;Slovakia;6;0;16;0
2020-03-13;SK;Slovakia;16;0;32;0
2020-03-14;SK;Slovakia;12;0;44;0
2020-03-15;SK;Slovakia;10;0;54;0
2020-03-16;SK;Slovakia;9;0;63;0
2020-03-17;SK;Slovakia;9;0;72;0
2020-03-18;SK;Slovakia;33;0;105;0
2020-03-19;SK;Slovakia;18;0;123;0
2020-03-20;SK;Slovakia;14;0;137;0
2020-03-21;SK;Slovakia;41;0;178;0
2020-03-22;SK;Slovakia;7;0;185;0
2020-03-23;SK;Slovakia;1;0;186;0
2020-03-24;SK;Slovakia;18;0;204;0
2020-03-25;SK;Slovakia;12;0;216;0
2020-03-26;SK;Slovakia;10;0;226;0
2020-03-27;SK;Slovakia;43;0;269;0
2020-03-28;SK;Slovakia;23;0;292;0
2020-03-29;SK;Slovakia;22;0;314;0
2020-03-30;SK;Slovakia;22;0;336;0
2020-03-31;SK;Slovakia;27;0;363;0
2020-04-01;SK;Slovakia;37;1;400;1
2020-04-02;SK;Slovakia;26;0;426;1
2020-04-03;SK;Slovakia;24;0;450;1
2020-04-04;SK;Slovakia;21;0;471;1
2020-04-05;SK;Slovakia;14;0;485;1
2020-04-06;SK;Slovakia;49;1;534;2
2020-04-07;SK;Slovakia;47;0;581;2
2020-04-08;SK;Slovakia;101;0;682;2
2020-04-09;SK;Slovakia;19;0;701;2
2020-04-10;SK;Slovakia;14;0;715;2
2020-04-11;SK;Slovakia;13;0;728;2
2020-04-12;SK;Slovakia;14;0;742;2
2020-04-13;SK;Slovakia;27;0;769;2
2020-04-14;SK;Slovakia;66;0;835;2
2020-04-15;SK;Slovakia;28;4;863;6
2020-04-16;SK;Slovakia;114;2;977;8
2020-04-17;SK;Slovakia;72;1;1049;9
2020-04-18;SK;Slovakia;40;2;1089;11
2020-04-19;SK;Slovakia;72;1;1161;12
2020-04-20;SK;Slovakia;12;1;1173;13
2020-04-21;SK;Slovakia;26;1;1199;14
2020-04-22;SK;Slovakia;45;0;1244;14
2020-04-23;SK;Slovakia;81;1;1325;15
2020-04-24;SK;Slovakia;35;2;1360;17
2020-04-25;SK;Slovakia;13;0;1373;17
2020-04-26;SK;Slovakia;6;1;1379;18
2020-04-27;SK;Slovakia;2;0;1381;18
2020-04-28;SK;Slovakia;3;2;1384;20
2020-04-29;SK;Slovakia;7;2;1391;22
2020-04-30;SK;Slovakia;5;1;1396;23
2020-05-01;SK;Slovakia;7;0;1403;23
2020-05-02;SK;Slovakia;4;1;1407;24
2020-05-03;SK;Slovakia;1;0;1408;24
2020-05-04;SK;Slovakia;5;1;1413;25
2020-05-05;SK;Slovakia;8;0;1421;25
2020-05-06;SK;Slovakia;8;0;1429;25
2020-05-07;SK;Slovakia;16;1;1445;26
2020-05-08;SK;Slovakia;10;0;1455;26
2020-05-09;SK;Slovakia;0;0;1455;26
2020-05-10;SK;Slovakia;2;0;1457;26
2020-05-11;SK;Slovakia;0;0;1457;26
2020-05-12;SK;Slovakia;8;1;1465;27
2020-05-13;SK;Slovakia;4;0;1469;27
2020-05-14;SK;Slovakia;8;0;1477;27
2020-05-15;SK;Slovakia;3;0;1480;27
2020-05-16;SK;Slovakia;13;1;1493;28
2020-05-17;SK;Slovakia;1;0;1494;28
2020-05-18;SK;Slovakia;1;0;1495;28
2020-05-19;SK;Slovakia;0;0;1495;28
2020-05-20;SK;Slovakia;1;0;1496;28
2020-05-21;SK;Slovakia;6;0;1502;28
2020-05-22;SK;Slovakia;1;0;1503;28
2020-05-23;SK;Slovakia;1;0;1504;28
2020-05-24;SK;Slovakia;5;0;1509;28
2020-05-25;SK;Slovakia;2;0;1511;28
2020-05-26;SK;Slovakia;2;0;1513;28
2020-05-27;SK;Slovakia;2;0;1515;28
2020-05-28;SK;Slovakia;5;0;1520;28
2020-05-29;SK;Slovakia;0;0;1520;28
2020-05-30;SK;Slovakia;1;0;1521;28
2020-05-31;SK;Slovakia;0;0;1521;28
2020-06-01;SK;Slovakia;1;0;1522;28
2020-06-02;SK;Slovakia;0;0;1522;28
2020-06-03;SK;Slovakia;3;0;1525;28
2020-06-04;SK;Slovakia;1;0;1526;28
2020-06-05;SK;Slovakia;0;0;1526;28
2020-06-06;SK;Slovakia;2;0;1528;28
2020-06-07;SK;Slovakia;0;0;1528;28
2020-06-08;SK;Slovakia;2;0;1530;28
2020-06-09;SK;Slovakia;1;0;1531;28
2020-06-10;SK;Slovakia;2;0;1533;28
2020-06-11;SK;Slovakia;8;0;1541;28
2020-06-12;SK;Slovakia;1;0;1542;28
2020-06-13;SK;Slovakia;3;0;1545;28
2020-06-14;SK;Slovakia;3;0;1548;28
2020-06-15;SK;Slovakia;4;0;1552;28
2020-06-16;SK;Slovakia;0;0;1552;28
2020-06-17;SK;Slovakia;9;0;1561;28
2020-06-18;SK;Slovakia;1;0;1562;28
2020-06-19;SK;Slovakia;14;0;1576;28
2020-06-20;SK;Slovakia;10;0;1586;28
2020-06-21;SK;Slovakia;1;0;1587;28
2020-06-22;SK;Slovakia;1;0;1588;28
2020-06-23;SK;Slovakia;1;0;1589;28
2020-06-24;SK;Slovakia;18;0;1607;28
2020-06-25;SK;Slovakia;23;0;1630;28
2020-06-26;SK;Slovakia;13;0;1643;28
2020-06-27;SK;Slovakia;14;0;1657;28
2020-06-28;SK;Slovakia;7;0;1664;28
2020-06-29;SK;Slovakia;1;0;1665;28
2020-06-30;SK;Slovakia;2;0;1667;28
2020-07-01;SK;Slovakia;20;0;1687;28
2020-07-02;SK;Slovakia;13;0;1700;28
2020-07-03;SK;Slovakia;20;0;1720;28
2020-07-04;SK;Slovakia;29;0;1749;28
2020-07-05;SK;Slovakia;15;0;1764;28
2020-07-06;SK;Slovakia;1;0;1765;28
2020-07-07;SK;Slovakia;2;0;1767;28
2020-07-08;SK;Slovakia;31;0;1798;28
2020-07-09;SK;Slovakia;53;0;1851;28
2020-07-10;SK;Slovakia;19;0;1870;28
2020-07-11;SK;Slovakia;23;0;1893;28
2020-07-12;SK;Slovakia;8;0;1901;28
2020-07-13;SK;Slovakia;1;0;1902;28
2020-07-14;SK;Slovakia;6;0;1908;28
2020-07-15;SK;Slovakia;19;0;1927;28
2020-07-16;SK;Slovakia;24;0;1951;28
2020-07-17;SK;Slovakia;14;0;1965;28
2020-07-18;SK;Slovakia;11;0;1976;28
2020-07-19;SK;Slovakia;3;0;1979;28
2020-07-20;SK;Slovakia;1;0;1980;28
2020-07-21;SK;Slovakia;41;0;2021;28
2020-07-22;SK;Slovakia;37;0;2058;28
2020-07-23;SK;Slovakia;31;0;2089;28
2020-07-24;SK;Slovakia;29;0;2118;28
2020-07-25;SK;Slovakia;23;0;2141;28
2020-07-26;SK;Slovakia;38;0;2179;28
2020-07-27;SK;Slovakia;2;0;2181;28
2020-07-28;SK;Slovakia;23;0;2204;28
2020-07-29;SK;Slovakia;41;0;2245;28
2020-07-30;SK;Slovakia;20;0;2265;28
2020-07-31;SK;Slovakia;27;1;2292;29
2020-08-01;SK;Slovakia;45;0;2337;29
2020-08-02;SK;Slovakia;7;0;2344;29
2020-08-03;SK;Slovakia;10;0;2354;29
2020-08-04;SK;Slovakia;14;0;2368;29
2020-08-05;SK;Slovakia;49;0;2417;29
2020-08-06;SK;Slovakia;63;0;2480;29
2020-08-07;SK;Slovakia;43;2;2523;31
2020-08-08;SK;Slovakia;43;0;2566;31
2020-08-09;SK;Slovakia;30;0;2596;31
2020-08-10;SK;Slovakia;3;0;2599;31
2020-08-11;SK;Slovakia;16;0;2615;31
2020-08-12;SK;Slovakia;75;0;2690;31
2020-08-13;SK;Slovakia;49;0;2739;31
2020-08-14;SK;Slovakia;62;0;2801;31
2020-08-15;SK;Slovakia;54;0;2855;31
2020-08-16;SK;Slovakia;47;0;2902;31
2020-08-17;SK;Slovakia;5;0;2907;31
2020-08-18;SK;Slovakia;15;0;2922;31
2020-08-19;SK;Slovakia;100;2;3022;33
2020-08-20;SK;Slovakia;80;0;3102;33
2020-08-21;SK;Slovakia;123;0;3225;33
2020-08-22;SK;Slovakia;91;0;3316;33
2020-08-23;SK;Slovakia;40;0;3356;33
2020-08-24;SK;Slovakia;68;0;3424;33
2020-08-25;SK;Slovakia;28;0;3452;33
2020-08-26;SK;Slovakia;84;0;3536;33
2020-08-27;SK;Slovakia;90;0;3626;33
2020-08-28;SK;Slovakia;102;0;3728;33
2020-08-29;SK;Slovakia;114;0;3842;33
2020-08-30;SK;Slovakia;34;0;3876;33
2020-08-31;SK;Slovakia;41;0;3917;33
2020-09-01;SK;Slovakia;72;0;3989;33
2020-09-02;SK;Slovakia;53;0;4042;33
2020-09-03;SK;Slovakia;121;4;4163;37
2020-09-04;SK;Slovakia;137;0;4300;37
2020-09-05;SK;Slovakia;226;0;4526;37
2020-09-06;SK;Slovakia;88;0;4614;37
2020-09-07;SK;Slovakia;22;0;4636;37
2020-09-08;SK;Slovakia;91;0;4727;37
2020-09-09;SK;Slovakia;161;0;4888;37
2020-09-10;SK;Slovakia;178;0;5066;37
2020-09-11;SK;Slovakia;186;0;5252;37
2020-09-12;SK;Slovakia;201;1;5453;38
2020-09-13;SK;Slovakia;79;0;5532;38
2020-09-14;SK;Slovakia;48;0;5580;38
2020-09-15;SK;Slovakia;188;0;5768;38
2020-09-16;SK;Slovakia;92;0;5860;38
2020-09-17;SK;Slovakia;161;1;6021;39
2020-09-18;SK;Slovakia;235;0;6256;39
2020-09-19;SK;Slovakia;290;0;6546;39
2020-09-20;SK;Slovakia;131;0;6677;39
2020-09-21;SK;Slovakia;79;0;6756;39
2020-09-22;SK;Slovakia;175;1;6931;40
2020-09-23;SK;Slovakia;338;1;7269;41
2020-09-24;SK;Slovakia;360;0;7629;41
2020-09-25;SK;Slovakia;419;0;8048;41
2020-09-26;SK;Slovakia;552;3;8600;44
2020-09-27;SK;Slovakia;478;0;9078;44
2020-09-28;SK;Slovakia;265;0;9343;44
2020-09-29;SK;Slovakia;231;1;9574;45
2020-09-30;SK;Slovakia;567;3;10141;48
2020-10-01;SK;Slovakia;797;0;10938;48
2020-10-02;SK;Slovakia;679;6;11617;54
2020-10-03;SK;Slovakia;704;0;12321;54
2020-10-04;SK;Slovakia;818;1;13139;55
2020-10-05;SK;Slovakia;353;0;13492;55
2020-10-06;SK;Slovakia;320;0;13812;55
2020-10-07;SK;Slovakia;877;0;14689;55
2020-10-08;SK;Slovakia;1037;2;15726;57
2020-10-09;SK;Slovakia;1184;0;16910;57
2020-10-10;SK;Slovakia;1887;4;18797;61
2020-10-11;SK;Slovakia;1054;0;19851;61
2020-10-12;SK;Slovakia;504;0;20355;61
2020-10-13;SK;Slovakia;531;0;20886;61
2020-10-14;SK;Slovakia;1410;5;22296;66
2020-10-15;SK;Slovakia;1929;5;24225;71
2020-10-16;SK;Slovakia;2075;0;26300;71
2020-10-17;SK;Slovakia;1968;11;28268;82
2020-10-18;SK;Slovakia;1567;6;29835;88
2020-10-19;SK;Slovakia;860;4;30695;92
2020-10-20;SK;Slovakia;705;6;31400;98
2020-10-21;SK;Slovakia;2202;0;33602;98
2020-10-22;SK;Slovakia;1728;17;35330;115
2020-10-23;SK;Slovakia;2581;19;37911;134
2020-10-24;SK;Slovakia;2890;25;40801;159
2020-10-25;SK;Slovakia;3042;0;43843;159
2020-10-26;SK;Slovakia;1312;6;45155;165
2020-10-27;SK;Slovakia;901;11;46056;176
2020-10-28;SK;Slovakia;2887;8;48943;184
2020-10-29;SK;Slovakia;2785;16;51728;200
2020-10-30;SK;Slovakia;3363;12;55091;212
2020-10-31;SK;Slovakia;2573;7;57664;219
2020-11-01;SK;Slovakia;2282;0;59946;219
2020-11-02;SK;Slovakia;1883;0;61829;219
2020-11-03;SK;Slovakia;1727;16;63556;235
2020-11-04;SK;Slovakia;3216;26;66772;261
2020-11-05;SK;Slovakia;1962;25;68734;286
2020-11-06;SK;Slovakia;2354;31;71088;317
2020-11-07;SK;Slovakia;2579;34;73667;351
2020-11-08;SK;Slovakia;1828;0;75495;351
2020-11-09;SK;Slovakia;577;15;76072;366
2020-11-10;SK;Slovakia;1051;24;77123;390
2020-11-11;SK;Slovakia;2058;24;79181;414
2020-11-12;SK;Slovakia;2591;50;81772;464
2020-11-13;SK;Slovakia;2024;27;83796;491
2020-11-14;SK;Slovakia;1771;19;85567;510
2020-11-15;SK;Slovakia;1200;0;86767;510
2020-11-16;SK;Slovakia;509;16;87276;526
2020-11-17;SK;Slovakia;1326;31;88602;557
2020-11-18;SK;Slovakia;1311;22;89913;579
2020-11-19;SK;Slovakia;1665;0;91578;579
2020-11-20;SK;Slovakia;1818;35;93396;614
2020-11-21;SK;Slovakia;1861;30;95257;644
2020-11-22;SK;Slovakia;984;27;96241;671
2020-11-23;SK;Slovakia;231;22;96472;693
2020-11-24;SK;Slovakia;1021;16;97493;709
2020-11-25;SK;Slovakia;1811;23;99304;732
2020-11-26;SK;Slovakia;1953;17;101257;749
2020-11-27;SK;Slovakia;1849;22;103106;771
2020-11-28;SK;Slovakia;1526;27;104632;798
2020-11-29;SK;Slovakia;1101;18;105733;816
2020-11-30;SK;Slovakia;196;23;105929;839
2020-12-01;SK;Slovakia;1254;29;107183;868
2020-12-02;SK;Slovakia;2043;30;109226;898
2020-12-03;SK;Slovakia;1982;32;111208;930
2020-12-04;SK;Slovakia;2184;27;113392;957
2020-12-05;SK;Slovakia;2070;24;115462;981
2020-12-06;SK;Slovakia;1269;15;116731;996
2020-12-07;SK;Slovakia;552;22;117283;1018
2020-12-08;SK;Slovakia;1949;28;119232;1046
2020-12-09;SK;Slovakia;2564;38;121796;1084
2020-12-10;SK;Slovakia;3125;20;124921;1104
2020-12-11;SK;Slovakia;2166;18;127087;1122
2020-12-12;SK;Slovakia;3707;26;130794;1148
2020-12-13;SK;Slovakia;2190;27;132984;1175
2020-12-14;SK;Slovakia;505;30;133489;1205
2020-12-15;SK;Slovakia;2034;46;135523;1251
2020-12-16;SK;Slovakia;3565;58;139088;1309
2020-12-17;SK;Slovakia;3045;69;142133;1378
2020-12-18;SK;Slovakia;3991;62;146124;1440
2020-12-19;SK;Slovakia;3151;70;149275;1510
2020-12-20;SK;Slovakia;2061;45;151336;1555
2020-12-21;SK;Slovakia;1219;63;152555;1618
2020-12-22;SK;Slovakia;2663;0;155218;1618
2020-12-23;SK;Slovakia;3687;68;158905;1686
2020-12-24;SK;Slovakia;2657;46;161562;1732
2020-12-25;SK;Slovakia;4046;0;165608;1732
2020-12-26;SK;Slovakia;1041;0;166649;1732
2020-12-27;SK;Slovakia;874;41;167523;1773
2020-12-28;SK;Slovakia;569;106;168092;1879
2020-12-29;SK;Slovakia;2095;104;170187;1983
2020-12-30;SK;Slovakia;3041;82;173228;2065
2020-12-31;SK;Slovakia;6315;73;179543;2138
2021-01-01;SK;Slovakia;4965;112;184508;2250
2021-01-02;SK;Slovakia;1736;0;186244;2250
2021-01-03;SK;Slovakia;1219;67;187463;2317
2021-01-04;SK;Slovakia;636;204;188099;2521
2021-01-05;SK;Slovakia;2989;82;191088;2603
2021-01-06;SK;Slovakia;4959;54;196047;2657
2021-01-07;SK;Slovakia;2137;60;198184;2717
2021-01-08;SK;Slovakia;2980;71;201164;2788
2021-01-09;SK;Slovakia;4072;48;205236;2836
2021-01-10;SK;Slovakia;2973;82;208209;2918
2021-01-11;SK;Slovakia;860;89;209069;3007
2021-01-12;SK;Slovakia;2410;95;211479;3102
2021-01-13;SK;Slovakia;3576;61;215055;3163
2021-01-14;SK;Slovakia;2923;97;217978;3260
2021-01-15;SK;Slovakia;2729;102;220707;3362
2021-01-16;SK;Slovakia;2045;55;222752;3417
2021-01-17;SK;Slovakia;573;57;223325;3474
2021-01-18;SK;Slovakia;1060;52;224385;3526
2021-01-19;SK;Slovakia;1909;111;226294;3637
2021-01-20;SK;Slovakia;2484;100;228778;3737
2021-01-21;SK;Slovakia;2464;64;231242;3801
2021-01-22;SK;Slovakia;1785;93;233027;3894
2021-01-23;SK;Slovakia;1544;71;234571;3965
2021-01-24;SK;Slovakia;1905;103;236476;4068
2021-01-25;SK;Slovakia;551;0;237027;4068
2021-01-26;SK;Slovakia;1590;192;238617;4260
2021-01-27;SK;Slovakia;2775;101;241392;4361
2021-01-28;SK;Slovakia;2035;50;243427;4411
2021-01-29;SK;Slovakia;2581;84;246008;4495
2021-01-30;SK;Slovakia;2182;70;248190;4565
2021-01-31;SK;Slovakia;1723;77;249913;4642
2021-02-01;SK;Slovakia;444;69;250357;4711
2021-02-02;SK;Slovakia;1737;73;252094;4784
2021-02-03;SK;Slovakia;2732;105;254826;4889
2021-02-04;SK;Slovakia;2077;87;256903;4976
2021-02-05;SK;Slovakia;2630;74;259533;5050
2021-02-06;SK;Slovakia;2241;85;261774;5135
2021-02-07;SK;Slovakia;1552;64;263326;5199
2021-02-08;SK;Slovakia;757;72;264083;5271
2021-02-09;SK;Slovakia;1724;111;265807;5382
2021-02-10;SK;Slovakia;3179;120;268986;5502
2021-02-11;SK;Slovakia;2487;127;271473;5629
2021-02-12;SK;Slovakia;2431;104;273904;5733
2021-02-13;SK;Slovakia;2330;79;276234;5812
2021-02-14;SK;Slovakia;1448;73;277682;5885
2021-02-15;SK;Slovakia;572;67;278254;5952
2021-02-16;SK;Slovakia;1442;111;279696;6063
2021-02-17;SK;Slovakia;3168;105;282864;6168
2021-02-18;SK;Slovakia;2555;103;285419;6271
2021-02-19;SK;Slovakia;2333;79;287752;6350
2021-02-20;SK;Slovakia;2705;74;290457;6424
2021-02-21;SK;Slovakia;1686;81;292143;6505
2021-02-22;SK;Slovakia;649;72;292792;6577
2021-02-23;SK;Slovakia;1998;94;294790;6671
2021-02-24;SK;Slovakia;3547;104;298337;6775
2021-02-25;SK;Slovakia;2438;84;300775;6859
2021-02-26;SK;Slovakia;2645;107;303420;6966
2021-02-27;SK;Slovakia;2848;109;306268;7075
2021-02-28;SK;Slovakia;1815;114;308083;7189
2021-03-01;SK;Slovakia;842;81;308925;7270
2021-03-02;SK;Slovakia;2077;118;311002;7388
2021-03-03;SK;Slovakia;3357;101;314359;7489
2021-03-04;SK;Slovakia;2800;71;317159;7560
2021-03-05;SK;Slovakia;2423;105;319582;7665
2021-03-06;SK;Slovakia;2522;74;322104;7739
2021-03-07;SK;Slovakia;1286;97;323390;7836
2021-03-08;SK;Slovakia;396;85;323786;7921
2021-03-09;SK;Slovakia;2207;116;325993;8037
2021-03-10;SK;Slovakia;3600;109;329593;8146
2021-03-11;SK;Slovakia;1978;98;331571;8244
2021-03-12;SK;Slovakia;2301;102;333872;8346
2021-03-13;SK;Slovakia;2363;94;336235;8440
2021-03-14;SK;Slovakia;1268;88;337503;8528
2021-03-15;SK;Slovakia;457;77;337960;8605
2021-03-16;SK;Slovakia;1578;64;339538;8669
2021-03-17;SK;Slovakia;2892;69;342430;8738
2021-03-18;SK;Slovakia;2040;76;344470;8814
2021-03-19;SK;Slovakia;1679;80;346149;8894
2021-03-20;SK;Slovakia;1795;84;347944;8978
2021-03-21;SK;Slovakia;925;66;348869;9044
2021-03-22;SK;Slovakia;401;60;349270;9104
2021-03-23;SK;Slovakia;1281;86;350551;9190
2021-03-24;SK;Slovakia;1977;71;352528;9261
2021-03-25;SK;Slovakia;1654;52;354182;9313
2021-03-26;SK;Slovakia;1272;60;355454;9373
2021-03-27;SK;Slovakia;1531;53;356985;9426
2021-03-28;SK;Slovakia;925;70;357910;9496
2021-03-29;SK;Slovakia;205;46;358115;9542
2021-03-30;SK;Slovakia;1215;82;359330;9624
2021-03-31;SK;Slovakia;1855;95;361185;9719
2021-04-01;SK;Slovakia;1304;71;362489;9790
2021-04-02;SK;Slovakia;1385;87;363874;9877
2021-04-03;SK;Slovakia;748;71;364622;9948
2021-04-04;SK;Slovakia;620;77;365242;10025
2021-04-05;SK;Slovakia;158;69;365400;10094
2021-04-06;SK;Slovakia;333;0;365733;10094
2021-04-07;SK;Slovakia;1161;149;366894;10243
2021-04-08;SK;Slovakia;1576;79;368470;10322
2021-04-09;SK;Slovakia;923;89;369393;10411
2021-04-10;SK;Slovakia;1080;76;370473;10487
2021-04-11;SK;Slovakia;589;78;371062;10565
2021-04-12;SK;Slovakia;106;65;371168;10630
2021-04-13;SK;Slovakia;870;86;372038;10716
2021-04-14;SK;Slovakia;1069;82;373107;10798
2021-04-15;SK;Slovakia;843;79;373950;10877
2021-04-16;SK;Slovakia;636;93;374586;10970
2021-04-17;SK;Slovakia;750;73;375336;11043
2021-04-18;SK;Slovakia;638;63;375974;11106
2021-04-19;SK;Slovakia;93;66;376067;11172
2021-04-20;SK;Slovakia;642;72;376709;11244
2021-04-21;SK;Slovakia;764;60;377473;11304
2021-04-22;SK;Slovakia;677;53;378150;11357
2021-04-23;SK;Slovakia;485;48;378635;11405
2021-04-24;SK;Slovakia;841;53;379476;11458
2021-04-25;SK;Slovakia;435;37;379911;11495
2021-04-26;SK;Slovakia;99;36;380010;11531
2021-04-27;SK;Slovakia;488;41;380498;11572
2021-04-28;SK;Slovakia;682;39;381180;11611
2021-04-29;SK;Slovakia;564;36;381744;11647
2021-04-30;SK;Slovakia;467;37;382211;11684
2021-05-01;SK;Slovakia;509;48;382720;11732
2021-05-02;SK;Slovakia;378;34;383098;11766
2021-05-03;SK;Slovakia;130;41;383228;11807
2021-05-04;SK;Slovakia;381;48;383609;11855
2021-05-05;SK;Slovakia;708;31;384317;11886
2021-05-06;SK;Slovakia;343;34;384660;11920
2021-05-07;SK;Slovakia;362;26;385022;11946
2021-05-08;SK;Slovakia;373;44;385395;11990
2021-05-09;SK;Slovakia;80;29;385475;12019
2021-05-10;SK;Slovakia;311;32;385786;12051
2021-05-11;SK;Slovakia;350;26;386136;12077
2021-05-12;SK;Slovakia;404;19;386540;12096
2021-05-13;SK;Slovakia;328;39;386868;12135
2021-05-14;SK;Slovakia;294;33;387162;12168
2021-05-15;SK;Slovakia;258;35;387420;12203
2021-05-16;SK;Slovakia;103;21;387523;12224
2021-05-17;SK;Slovakia;136;14;387659;12238
2021-05-18;SK;Slovakia;233;10;387892;12248
2021-05-19;SK;Slovakia;246;14;388138;12262
2021-05-20;SK;Slovakia;253;10;388391;12272
2021-05-21;SK;Slovakia;138;8;388529;12280
2021-05-22;SK;Slovakia;190;6;388719;12286
2021-05-23;SK;Slovakia;116;6;388835;12292
2021-05-24;SK;Slovakia;19;4;388854;12296
2021-05-25;SK;Slovakia;132;5;388986;12301
2021-05-26;SK;Slovakia;190;11;389176;12312
2021-05-27;SK;Slovakia;168;8;389344;12320
2021-05-28;SK;Slovakia;96;13;389440;12333
2021-05-29;SK;Slovakia;0;0;389440;12333
2021-05-30;SK;Slovakia;250;6;389690;12339
2021-05-31;SK;Slovakia;31;4;389721;12343
2021-06-01;SK;Slovakia;145;10;389866;12353
2021-06-02;SK;Slovakia;124;13;389990;12366
2021-06-03;SK;Slovakia;139;9;390129;12375
2021-06-04;SK;Slovakia;94;7;390223;12382
2021-06-05;SK;Slovakia;117;13;390340;12395
2021-06-06;SK;Slovakia;96;9;390436;12404
2021-06-07;SK;Slovakia;15;10;390451;12414
2021-06-08;SK;Slovakia;95;9;390546;12423
2021-06-09;SK;Slovakia;147;7;390693;12430
2021-06-10;SK;Slovakia;116;3;390809;12433
2021-06-11;SK;Slovakia;84;0;390893;12433
2021-06-12;SK;Slovakia;91;3;390984;12436
2021-06-13;SK;Slovakia;42;3;391026;12439
2021-06-14;SK;Slovakia;12;2;391038;12441
2021-06-15;SK;Slovakia;49;5;391087;12446
2021-06-16;SK;Slovakia;62;10;391149;12456
2021-06-17;SK;Slovakia;61;8;391210;12464
2021-06-18;SK;Slovakia;38;14;391248;12478
2021-06-19;SK;Slovakia;0;0;391248;12478
2021-06-20;SK;Slovakia;0;0;391248;12478
2021-06-21;SK;Slovakia;78;18;391326;12496
2021-06-22;SK;Slovakia;59;6;391385;12502
2021-06-23;SK;Slovakia;35;0;391420;12502
2021-06-24;SK;Slovakia;36;0;391456;12502
2021-06-25;SK;Slovakia;34;3;391490;12505
2021-06-26;SK;Slovakia;41;0;391531;12505
2021-06-27;SK;Slovakia;20;0;391551;12505
2021-06-28;SK;Slovakia;15;4;391566;12509
2021-06-29;SK;Slovakia;43;1;391609;12510
2021-06-30;SK;Slovakia;33;0;391642;12510
2021-07-01;SK;Slovakia;17;1;391659;12511
2020-02-02;SI;Slovenia;0;0;0;0
2020-02-03;SI;Slovenia;0;0;0;0
2020-02-04;SI;Slovenia;0;0;0;0
2020-02-05;SI;Slovenia;0;0;0;0
2020-02-06;SI;Slovenia;0;0;0;0
2020-02-07;SI;Slovenia;0;0;0;0
2020-02-08;SI;Slovenia;0;0;0;0
2020-02-09;SI;Slovenia;0;0;0;0
2020-02-10;SI;Slovenia;0;0;0;0
2020-02-11;SI;Slovenia;0;0;0;0
2020-02-12;SI;Slovenia;0;0;0;0
2020-02-13;SI;Slovenia;0;0;0;0
2020-02-14;SI;Slovenia;0;0;0;0
2020-02-15;SI;Slovenia;0;0;0;0
2020-02-16;SI;Slovenia;0;0;0;0
2020-02-17;SI;Slovenia;0;0;0;0
2020-02-18;SI;Slovenia;0;0;0;0
2020-02-19;SI;Slovenia;0;0;0;0
2020-02-20;SI;Slovenia;0;0;0;0
2020-02-21;SI;Slovenia;0;0;0;0
2020-02-22;SI;Slovenia;0;0;0;0
2020-02-23;SI;Slovenia;0;0;0;0
2020-02-24;SI;Slovenia;0;0;0;0
2020-02-25;SI;Slovenia;0;0;0;0
2020-02-26;SI;Slovenia;0;0;0;0
2020-02-27;SI;Slovenia;0;0;0;0
2020-02-28;SI;Slovenia;0;0;0;0
2020-02-29;SI;Slovenia;0;0;0;0
2020-03-01;SI;Slovenia;0;0;0;0
2020-03-02;SI;Slovenia;0;0;0;0
2020-03-03;SI;Slovenia;0;0;0;0
2020-03-04;SI;Slovenia;0;0;0;0
2020-03-05;SI;Slovenia;2;0;2;0
2020-03-06;SI;Slovenia;5;0;7;0
2020-03-07;SI;Slovenia;0;0;7;0
2020-03-08;SI;Slovenia;9;0;16;0
2020-03-09;SI;Slovenia;0;0;16;0
2020-03-10;SI;Slovenia;15;0;31;0
2020-03-11;SI;Slovenia;26;0;57;0
2020-03-12;SI;Slovenia;32;0;89;0
2020-03-13;SI;Slovenia;52;0;141;0
2020-03-14;SI;Slovenia;40;1;181;1
2020-03-15;SI;Slovenia;38;0;219;1
2020-03-16;SI;Slovenia;34;0;253;1
2020-03-17;SI;Slovenia;22;0;275;1
2020-03-18;SI;Slovenia;0;0;275;1
2020-03-19;SI;Slovenia;11;0;286;1
2020-03-20;SI;Slovenia;55;0;341;1
2020-03-21;SI;Slovenia;42;0;383;1
2020-03-22;SI;Slovenia;31;1;414;2
2020-03-23;SI;Slovenia;28;1;442;3
2020-03-24;SI;Slovenia;38;1;480;4
2020-03-25;SI;Slovenia;48;1;528;5
2020-03-26;SI;Slovenia;34;1;562;6
2020-03-27;SI;Slovenia;70;3;632;9
2020-03-28;SI;Slovenia;52;0;684;9
2020-03-29;SI;Slovenia;46;2;730;11
2020-03-30;SI;Slovenia;26;0;756;11
2020-03-31;SI;Slovenia;46;4;802;15
2020-04-01;SI;Slovenia;39;0;841;15
2020-04-02;SI;Slovenia;56;2;897;17
2020-04-03;SI;Slovenia;37;3;934;20
2020-04-04;SI;Slovenia;43;2;977;22
2020-04-05;SI;Slovenia;20;6;997;28
2020-04-06;SI;Slovenia;24;2;1021;30
2020-04-07;SI;Slovenia;38;6;1059;36
2020-04-08;SI;Slovenia;32;4;1091;40
2020-04-09;SI;Slovenia;33;3;1124;43
2020-04-10;SI;Slovenia;36;2;1160;45
2020-04-11;SI;Slovenia;28;5;1188;50
2020-04-12;SI;Slovenia;17;3;1205;53
2020-04-13;SI;Slovenia;7;2;1212;55
2020-04-14;SI;Slovenia;8;1;1220;56
2020-04-15;SI;Slovenia;28;5;1248;61
2020-04-16;SI;Slovenia;20;0;1268;61
2020-04-17;SI;Slovenia;36;5;1304;66
2020-04-18;SI;Slovenia;13;4;1317;70
2020-04-19;SI;Slovenia;13;4;1330;74
2020-04-20;SI;Slovenia;5;3;1335;77
2020-04-21;SI;Slovenia;9;0;1344;77
2020-04-22;SI;Slovenia;9;2;1353;79
2020-04-23;SI;Slovenia;13;0;1366;79
2020-04-24;SI;Slovenia;7;1;1373;80
2020-04-25;SI;Slovenia;15;1;1388;81
2020-04-26;SI;Slovenia;8;1;1396;82
2020-04-27;SI;Slovenia;6;1;1402;83
2020-04-28;SI;Slovenia;6;3;1408;86
2020-04-29;SI;Slovenia;10;3;1418;89
2020-04-30;SI;Slovenia;11;2;1429;91
2020-05-01;SI;Slovenia;5;1;1434;92
2020-05-02;SI;Slovenia;5;2;1439;94
2020-05-03;SI;Slovenia;0;2;1439;96
2020-05-04;SI;Slovenia;0;1;1439;97
2020-05-05;SI;Slovenia;6;1;1445;98
2020-05-06;SI;Slovenia;3;1;1448;99
2020-05-07;SI;Slovenia;1;0;1449;99
2020-05-08;SI;Slovenia;1;1;1450;100
2020-05-09;SI;Slovenia;4;1;1454;101
2020-05-10;SI;Slovenia;3;1;1457;102
2020-05-11;SI;Slovenia;3;0;1460;102
2020-05-12;SI;Slovenia;1;0;1461;102
2020-05-13;SI;Slovenia;2;1;1463;103
2020-05-14;SI;Slovenia;1;0;1464;103
2020-05-15;SI;Slovenia;1;0;1465;103
2020-05-16;SI;Slovenia;0;0;1465;103
2020-05-17;SI;Slovenia;1;1;1466;104
2020-05-18;SI;Slovenia;0;0;1466;104
2020-05-19;SI;Slovenia;1;0;1467;104
2020-05-20;SI;Slovenia;1;1;1468;105
2020-05-21;SI;Slovenia;0;1;1468;106
2020-05-22;SI;Slovenia;0;0;1468;106
2020-05-23;SI;Slovenia;0;0;1468;106
2020-05-24;SI;Slovenia;0;1;1468;107
2020-05-25;SI;Slovenia;1;0;1469;107
2020-05-26;SI;Slovenia;0;1;1469;108
2020-05-27;SI;Slovenia;2;0;1471;108
2020-05-28;SI;Slovenia;2;0;1473;108
2020-05-29;SI;Slovenia;0;0;1473;108
2020-05-30;SI;Slovenia;0;0;1473;108
2020-05-31;SI;Slovenia;0;0;1473;108
2020-06-01;SI;Slovenia;0;1;1473;109
2020-06-02;SI;Slovenia;2;0;1475;109
2020-06-03;SI;Slovenia;2;0;1477;109
2020-06-04;SI;Slovenia;0;0;1477;109
2020-06-05;SI;Slovenia;2;0;1479;109
2020-06-06;SI;Slovenia;5;0;1484;109
2020-06-07;SI;Slovenia;1;0;1485;109
2020-06-08;SI;Slovenia;0;0;1485;109
2020-06-09;SI;Slovenia;1;0;1486;109
2020-06-10;SI;Slovenia;2;0;1488;109
2020-06-11;SI;Slovenia;0;0;1488;109
2020-06-12;SI;Slovenia;2;0;1490;109
2020-06-13;SI;Slovenia;2;0;1492;109
2020-06-14;SI;Slovenia;3;0;1495;109
2020-06-15;SI;Slovenia;1;0;1496;109
2020-06-16;SI;Slovenia;3;0;1499;109
2020-06-17;SI;Slovenia;4;0;1503;109
2020-06-18;SI;Slovenia;8;0;1511;109
2020-06-19;SI;Slovenia;2;0;1513;109
2020-06-20;SI;Slovenia;6;0;1519;109
2020-06-21;SI;Slovenia;1;0;1520;109
2020-06-22;SI;Slovenia;1;0;1521;109
2020-06-23;SI;Slovenia;13;0;1534;109
2020-06-24;SI;Slovenia;7;0;1541;109
2020-06-25;SI;Slovenia;6;0;1547;109
2020-06-26;SI;Slovenia;11;0;1558;109
2020-06-27;SI;Slovenia;14;0;1572;109
2020-06-28;SI;Slovenia;9;2;1581;111
2020-06-29;SI;Slovenia;4;0;1585;111
2020-06-30;SI;Slovenia;15;0;1600;111
2020-07-01;SI;Slovenia;13;0;1613;111
2020-07-02;SI;Slovenia;21;0;1634;111
2020-07-03;SI;Slovenia;16;0;1650;111
2020-07-04;SI;Slovenia;29;0;1679;111
2020-07-05;SI;Slovenia;21;0;1700;111
2020-07-06;SI;Slovenia;16;0;1716;111
2020-07-07;SI;Slovenia;23;0;1739;111
2020-07-08;SI;Slovenia;24;0;1763;111
2020-07-09;SI;Slovenia;13;0;1776;111
2020-07-10;SI;Slovenia;17;0;1793;111
2020-07-11;SI;Slovenia;34;0;1827;111
2020-07-12;SI;Slovenia;14;0;1841;111
2020-07-13;SI;Slovenia;8;0;1849;111
2020-07-14;SI;Slovenia;10;0;1859;111
2020-07-15;SI;Slovenia;19;0;1878;111
2020-07-16;SI;Slovenia;19;0;1897;111
2020-07-17;SI;Slovenia;19;0;1916;111
2020-07-18;SI;Slovenia;24;0;1940;111
2020-07-19;SI;Slovenia;6;1;1946;112
2020-07-20;SI;Slovenia;7;1;1953;113
2020-07-21;SI;Slovenia;24;1;1977;114
2020-07-22;SI;Slovenia;29;1;2006;115
2020-07-23;SI;Slovenia;27;0;2033;115
2020-07-24;SI;Slovenia;19;0;2052;115
2020-07-25;SI;Slovenia;14;1;2066;116
2020-07-26;SI;Slovenia;16;0;2082;116
2020-07-27;SI;Slovenia;5;0;2087;116
2020-07-28;SI;Slovenia;14;1;2101;117
2020-07-29;SI;Slovenia;14;0;2115;117
2020-07-30;SI;Slovenia;24;0;2139;117
2020-07-31;SI;Slovenia;17;2;2156;119
2020-08-01;SI;Slovenia;15;0;2171;119
2020-08-02;SI;Slovenia;9;1;2180;120
2020-08-03;SI;Slovenia;1;2;2181;122
2020-08-04;SI;Slovenia;9;1;2190;123
2020-08-05;SI;Slovenia;18;1;2208;124
2020-08-06;SI;Slovenia;15;1;2223;125
2020-08-07;SI;Slovenia;10;0;2233;125
2020-08-08;SI;Slovenia;14;1;2247;126
2020-08-09;SI;Slovenia;2;1;2249;127
2020-08-10;SI;Slovenia;6;1;2255;128
2020-08-11;SI;Slovenia;17;1;2272;129
2020-08-12;SI;Slovenia;31;0;2303;129
2020-08-13;SI;Slovenia;29;0;2332;129
2020-08-14;SI;Slovenia;37;0;2369;129
2020-08-15;SI;Slovenia;32;0;2401;129
2020-08-16;SI;Slovenia;15;0;2416;129
2020-08-17;SI;Slovenia;13;0;2429;129
2020-08-18;SI;Slovenia;27;0;2456;129
2020-08-19;SI;Slovenia;37;0;2493;129
2020-08-20;SI;Slovenia;43;0;2536;129
2020-08-21;SI;Slovenia;38;1;2574;130
2020-08-22;SI;Slovenia;43;1;2617;131
2020-08-23;SI;Slovenia;34;0;2651;131
2020-08-24;SI;Slovenia;14;2;2665;133
2020-08-25;SI;Slovenia;21;0;2686;133
2020-08-26;SI;Slovenia;36;0;2722;133
2020-08-27;SI;Slovenia;33;0;2755;133
2020-08-28;SI;Slovenia;42;0;2797;133
2020-08-29;SI;Slovenia;37;0;2834;133
2020-08-30;SI;Slovenia;31;0;2865;133
2020-08-31;SI;Slovenia;18;0;2883;133
2020-09-01;SI;Slovenia;41;0;2924;133
2020-09-02;SI;Slovenia;55;1;2979;134
2020-09-03;SI;Slovenia;53;0;3032;134
2020-09-04;SI;Slovenia;47;0;3079;134
2020-09-05;SI;Slovenia;43;1;3122;135
2020-09-06;SI;Slovenia;43;0;3165;135
2020-09-07;SI;Slovenia;25;0;3190;135
2020-09-08;SI;Slovenia;42;0;3232;135
2020-09-09;SI;Slovenia;80;0;3312;135
2020-09-10;SI;Slovenia;77;0;3389;135
2020-09-11;SI;Slovenia;108;0;3497;135
2020-09-12;SI;Slovenia;106;0;3603;135
2020-09-13;SI;Slovenia;99;0;3702;135
2020-09-14;SI;Slovenia;47;0;3749;135
2020-09-15;SI;Slovenia;82;0;3831;135
2020-09-16;SI;Slovenia;123;0;3954;135
2020-09-17;SI;Slovenia;104;1;4058;136
2020-09-18;SI;Slovenia;137;4;4195;140
2020-09-19;SI;Slovenia;114;1;4309;141
2020-09-20;SI;Slovenia;111;1;4420;142
2020-09-21;SI;Slovenia;50;0;4470;142
2020-09-22;SI;Slovenia;88;0;4558;142
2020-09-23;SI;Slovenia;136;1;4694;143
2020-09-24;SI;Slovenia;122;2;4816;145
2020-09-25;SI;Slovenia;191;0;5007;145
2020-09-26;SI;Slovenia;184;1;5191;146
2020-09-27;SI;Slovenia;159;1;5350;147
2020-09-28;SI;Slovenia;38;2;5388;149
2020-09-29;SI;Slovenia;99;0;5487;149
2020-09-30;SI;Slovenia;203;1;5690;150
2020-10-01;SI;Slovenia;175;2;5865;152
2020-10-02;SI;Slovenia;238;2;6103;154
2020-10-03;SI;Slovenia;227;1;6330;155
2020-10-04;SI;Slovenia;168;0;6498;155
2020-10-05;SI;Slovenia;175;1;6673;156
2020-10-06;SI;Slovenia;91;3;6764;159
2020-10-07;SI;Slovenia;356;0;7120;159
2020-10-08;SI;Slovenia;387;1;7507;160
2020-10-09;SI;Slovenia;365;5;7872;165
2020-10-10;SI;Slovenia;380;2;8252;167
2020-10-11;SI;Slovenia;411;0;8663;167
2020-10-12;SI;Slovenia;169;2;8832;169
2020-10-13;SI;Slovenia;399;4;9231;173
2020-10-14;SI;Slovenia;707;2;9938;175
2020-10-15;SI;Slovenia;745;1;10683;176
2020-10-16;SI;Slovenia;834;4;11517;180
2020-10-17;SI;Slovenia;899;4;12416;184
2020-10-18;SI;Slovenia;726;4;13142;188
2020-10-19;SI;Slovenia;537;2;13679;190
2020-10-20;SI;Slovenia;794;2;14473;192
2020-10-21;SI;Slovenia;1509;8;15982;200
2020-10-22;SI;Slovenia;1664;11;17646;211
2020-10-23;SI;Slovenia;1661;3;19307;214
2020-10-24;SI;Slovenia;1967;21;21274;235
2020-10-25;SI;Slovenia;1676;5;22950;240
2020-10-26;SI;Slovenia;1130;11;24080;251
2020-10-27;SI;Slovenia;1523;13;25603;264
2020-10-28;SI;Slovenia;2612;14;28215;278
2020-10-29;SI;Slovenia;2490;14;30705;292
2020-10-30;SI;Slovenia;1798;23;32503;315
2020-10-31;SI;Slovenia;1804;23;34307;338
2020-11-01;SI;Slovenia;1342;25;35649;363
2020-11-02;SI;Slovenia;557;25;36206;388
2020-11-03;SI;Slovenia;1176;24;37382;412
2020-11-04;SI;Slovenia;2026;29;39408;441
2020-11-05;SI;Slovenia;1686;30;41094;471
2020-11-06;SI;Slovenia;1564;26;42658;497
2020-11-07;SI;Slovenia;1612;34;44270;531
2020-11-08;SI;Slovenia;891;23;45161;554
2020-11-09;SI;Slovenia;464;24;45625;578
2020-11-10;SI;Slovenia;1092;27;46717;605
2020-11-11;SI;Slovenia;2222;40;48939;645
2020-11-12;SI;Slovenia;1931;41;50870;686
2020-11-13;SI;Slovenia;1515;38;52385;724
2020-11-14;SI;Slovenia;1737;41;54122;765
2020-11-15;SI;Slovenia;920;32;55042;797
2020-11-16;SI;Slovenia;502;34;55544;831
2020-11-17;SI;Slovenia;1393;45;56937;876
2020-11-18;SI;Slovenia;2027;43;58964;919
2020-11-19;SI;Slovenia;2070;45;61034;964
2020-11-20;SI;Slovenia;1546;31;62580;995
2020-11-21;SI;Slovenia;1704;31;64284;1026
2020-11-22;SI;Slovenia;1024;26;65308;1052
2020-11-23;SI;Slovenia;470;45;65778;1097
2020-11-24;SI;Slovenia;1302;59;67080;1156
2020-11-25;SI;Slovenia;2226;43;69306;1199
2020-11-26;SI;Slovenia;1767;46;71073;1245
2020-11-27;SI;Slovenia;1601;48;72674;1293
2020-11-28;SI;Slovenia;1583;43;74257;1336
2020-11-29;SI;Slovenia;1124;48;75381;1384
2020-11-30;SI;Slovenia;433;51;75814;1435
2020-12-01;SI;Slovenia;1321;55;77135;1490
2020-12-02;SI;Slovenia;2431;57;79566;1547
2020-12-03;SI;Slovenia;1783;45;81349;1592
2020-12-04;SI;Slovenia;1784;61;83133;1653
2020-12-05;SI;Slovenia;1642;47;84775;1700
2020-12-06;SI;Slovenia;1030;44;85805;1744
2020-12-07;SI;Slovenia;483;52;86288;1796
2020-12-08;SI;Slovenia;1648;66;87936;1862
2020-12-09;SI;Slovenia;2139;38;90075;1900
2020-12-10;SI;Slovenia;1847;49;91922;1949
2020-12-11;SI;Slovenia;1815;49;93737;1998
2020-12-12;SI;Slovenia;1744;43;95481;2041
2020-12-13;SI;Slovenia;833;22;96314;2063
2020-12-14;SI;Slovenia;431;44;96745;2107
2020-12-15;SI;Slovenia;1536;42;98281;2149
2020-12-16;SI;Slovenia;2120;41;100401;2190
2020-12-17;SI;Slovenia;1642;43;102043;2233
2020-12-18;SI;Slovenia;1512;41;103555;2274
2020-12-19;SI;Slovenia;1458;40;105013;2314
2020-12-20;SI;Slovenia;886;39;105899;2353
2020-12-21;SI;Slovenia;395;26;106294;2379
2020-12-22;SI;Slovenia;1511;39;107805;2418
2020-12-23;SI;Slovenia;2129;36;109934;2454
2020-12-24;SI;Slovenia;2087;25;112021;2479
2020-12-25;SI;Slovenia;1794;28;113815;2507
2020-12-26;SI;Slovenia;369;25;114184;2532
2020-12-27;SI;Slovenia;622;33;114806;2565
2020-12-28;SI;Slovenia;521;30;115327;2595
2020-12-29;SI;Slovenia;1978;36;117305;2631
2020-12-30;SI;Slovenia;2435;34;119740;2665
2020-12-31;SI;Slovenia;2412;32;122152;2697
2021-01-01;SI;Slovenia;1798;31;123950;2728
2021-01-02;SI;Slovenia;393;46;124343;2774
2021-01-03;SI;Slovenia;743;29;125086;2803
2021-01-04;SI;Slovenia;772;35;125858;2838
2021-01-05;SI;Slovenia;2512;30;128370;2868
2021-01-06;SI;Slovenia;3354;31;131724;2899
2021-01-07;SI;Slovenia;2821;23;134545;2922
2021-01-08;SI;Slovenia;2084;25;136629;2947
2021-01-09;SI;Slovenia;1889;26;138518;2973
2021-01-10;SI;Slovenia;763;25;139281;2998
2021-01-11;SI;Slovenia;432;24;139713;3022
2021-01-12;SI;Slovenia;1874;31;141587;3053
2021-01-13;SI;Slovenia;2092;17;143679;3070
2021-01-14;SI;Slovenia;1793;23;145472;3093
2021-01-15;SI;Slovenia;1544;28;147016;3121
2021-01-16;SI;Slovenia;1540;19;148556;3140
2021-01-17;SI;Slovenia;569;40;149125;3180
2021-01-18;SI;Slovenia;299;26;149424;3206
2021-01-19;SI;Slovenia;1713;25;151137;3231
2021-01-20;SI;Slovenia;1714;26;152851;3257
2021-01-21;SI;Slovenia;1455;27;154306;3284
2021-01-22;SI;Slovenia;1446;25;155752;3309
2021-01-23;SI;Slovenia;1541;20;157293;3329
2021-01-24;SI;Slovenia;537;31;157830;3360
2021-01-25;SI;Slovenia;301;19;158131;3379
2021-01-26;SI;Slovenia;1681;27;159812;3406
2021-01-27;SI;Slovenia;1850;19;161662;3425
2021-01-28;SI;Slovenia;1573;23;163235;3448
2021-01-29;SI;Slovenia;1294;20;164529;3468
2021-01-30;SI;Slovenia;1358;22;165887;3490
2021-01-31;SI;Slovenia;586;13;166473;3503
2021-02-01;SI;Slovenia;363;19;166836;3522
2021-02-02;SI;Slovenia;1650;19;168486;3541
2021-02-03;SI;Slovenia;1615;23;170101;3564
2021-02-04;SI;Slovenia;1239;16;171340;3580
2021-02-05;SI;Slovenia;959;15;172299;3595
2021-02-06;SI;Slovenia;902;17;173201;3612
2021-02-07;SI;Slovenia;501;11;173702;3623
2021-02-08;SI;Slovenia;298;12;174000;3635
2021-02-09;SI;Slovenia;364;19;174364;3654
2021-02-10;SI;Slovenia;1431;13;175795;3667
2021-02-11;SI;Slovenia;1345;10;177140;3677
2021-02-12;SI;Slovenia;993;15;178133;3692
2021-02-13;SI;Slovenia;1015;13;179148;3705
2021-02-14;SI;Slovenia;329;12;179477;3717
2021-02-15;SI;Slovenia;303;11;179780;3728
2021-02-16;SI;Slovenia;740;5;180520;3733
2021-02-17;SI;Slovenia;1086;12;181606;3745
2021-02-18;SI;Slovenia;878;10;182484;3755
2021-02-19;SI;Slovenia;912;7;183396;3762
2021-02-20;SI;Slovenia;956;7;184352;3769
2021-02-21;SI;Slovenia;415;7;184767;3776
2021-02-22;SI;Slovenia;247;8;185014;3784
2021-02-23;SI;Slovenia;902;8;185916;3792
2021-02-24;SI;Slovenia;1089;10;187005;3802
2021-02-25;SI;Slovenia;757;7;187762;3809
2021-02-26;SI;Slovenia;914;14;188676;3823
2021-02-27;SI;Slovenia;951;13;189627;3836
2021-02-28;SI;Slovenia;454;0;190081;3836
2021-03-01;SI;Slovenia;243;18;190324;3854
2021-03-02;SI;Slovenia;732;9;191056;3863
2021-03-03;SI;Slovenia;1210;11;192266;3874
2021-03-04;SI;Slovenia;1019;4;193285;3878
2021-03-05;SI;Slovenia;880;4;194165;3882
2021-03-06;SI;Slovenia;921;6;195086;3888
2021-03-07;SI;Slovenia;382;3;195468;3891
2021-03-08;SI;Slovenia;210;6;195678;3897
2021-03-09;SI;Slovenia;743;7;196421;3904
2021-03-10;SI;Slovenia;953;4;197374;3908
2021-03-11;SI;Slovenia;860;10;198234;3918
2021-03-12;SI;Slovenia;770;8;199004;3926
2021-03-13;SI;Slovenia;850;3;199854;3929
2021-03-14;SI;Slovenia;520;5;200374;3934
2021-03-15;SI;Slovenia;205;4;200579;3938
2021-03-16;SI;Slovenia;918;3;201497;3941
2021-03-17;SI;Slovenia;1076;7;202573;3948
2021-03-18;SI;Slovenia;971;3;203544;3951
2021-03-19;SI;Slovenia;938;10;204482;3961
2021-03-20;SI;Slovenia;1027;6;205509;3967
2021-03-21;SI;Slovenia;517;5;206026;3972
2021-03-22;SI;Slovenia;291;4;206317;3976
2021-03-23;SI;Slovenia;981;9;207298;3985
2021-03-24;SI;Slovenia;1290;9;208588;3994
2021-03-25;SI;Slovenia;1165;4;209753;3998
2021-03-26;SI;Slovenia;1032;10;210785;4008
2021-03-27;SI;Slovenia;1255;3;212040;4011
2021-03-28;SI;Slovenia;638;7;212678;4018
2021-03-29;SI;Slovenia;288;6;212966;4024
2021-03-30;SI;Slovenia;1079;16;214045;4040
2021-03-31;SI;Slovenia;1557;7;215602;4047
2021-04-01;SI;Slovenia;1337;7;216939;4054
2021-04-02;SI;Slovenia;1175;9;218114;4063
2021-04-03;SI;Slovenia;1306;5;219420;4068
2021-04-04;SI;Slovenia;721;7;220141;4075
2021-04-05;SI;Slovenia;284;7;220425;4082
2021-04-06;SI;Slovenia;273;7;220698;4089
2021-04-07;SI;Slovenia;1192;3;221890;4092
2021-04-08;SI;Slovenia;1526;5;223416;4097
2021-04-09;SI;Slovenia;1283;3;224699;4100
2021-04-10;SI;Slovenia;1251;12;225950;4112
2021-04-11;SI;Slovenia;549;7;226499;4119
2021-04-12;SI;Slovenia;287;7;226786;4126
2021-04-13;SI;Slovenia;1050;4;227836;4130
2021-04-14;SI;Slovenia;1240;5;229076;4135
2021-04-15;SI;Slovenia;891;7;229967;4142
2021-04-16;SI;Slovenia;859;5;230826;4147
2021-04-17;SI;Slovenia;767;6;231593;4153
2021-04-18;SI;Slovenia;478;6;232071;4159
2021-04-19;SI;Slovenia;240;8;232311;4167
2021-04-20;SI;Slovenia;720;5;233031;4172
2021-04-21;SI;Slovenia;1036;4;234067;4176
2021-04-22;SI;Slovenia;744;11;234811;4187
2021-04-23;SI;Slovenia;900;8;235711;4195
2021-04-24;SI;Slovenia;902;8;236613;4203
2021-04-25;SI;Slovenia;415;5;237028;4208
2021-04-26;SI;Slovenia;191;6;237219;4214
2021-04-27;SI;Slovenia;804;7;238023;4221
2021-04-28;SI;Slovenia;398;15;238421;4236
2021-04-29;SI;Slovenia;918;7;239339;4243
2021-04-30;SI;Slovenia;953;7;240292;4250
2021-05-01;SI;Slovenia;1017;8;241309;4258
2021-05-02;SI;Slovenia;363;5;241672;4263
2021-05-03;SI;Slovenia;211;6;241883;4269
2021-05-04;SI;Slovenia;894;4;242777;4273
2021-05-05;SI;Slovenia;942;6;243719;4279
2021-05-06;SI;Slovenia;837;3;244556;4282
2021-05-07;SI;Slovenia;603;3;245159;4285
2021-05-08;SI;Slovenia;634;1;245793;4286
2021-05-09;SI;Slovenia;289;7;246082;4293
2021-05-10;SI;Slovenia;149;6;246231;4299
2021-05-11;SI;Slovenia;494;3;246725;4302
2021-05-12;SI;Slovenia;724;2;247449;4304
2021-05-13;SI;Slovenia;597;4;248046;4308
2021-05-14;SI;Slovenia;474;6;248520;4314
2021-05-15;SI;Slovenia;494;6;249014;4320
2021-05-16;SI;Slovenia;296;4;249310;4324
2021-05-17;SI;Slovenia;114;3;249424;4327
2021-05-18;SI;Slovenia;497;6;249921;4333
2021-05-19;SI;Slovenia;532;5;250453;4338
2021-05-20;SI;Slovenia;358;7;250811;4345
2021-05-21;SI;Slovenia;337;3;251148;4348
2021-05-22;SI;Slovenia;383;1;251531;4349
2021-05-23;SI;Slovenia;159;4;251690;4353
2021-05-24;SI;Slovenia;83;2;251773;4355
2021-05-25;SI;Slovenia;325;3;252098;4358
2021-05-26;SI;Slovenia;388;5;252486;4363
2021-05-27;SI;Slovenia;362;3;252848;4366
2021-05-28;SI;Slovenia;292;4;253140;4370
2021-05-29;SI;Slovenia;353;2;253493;4372
2021-05-30;SI;Slovenia;138;2;253631;4374
2021-05-31;SI;Slovenia;91;1;253722;4375
2021-06-01;SI;Slovenia;323;1;254045;4376
2021-06-02;SI;Slovenia;374;4;254419;4380
2021-06-03;SI;Slovenia;273;3;254692;4383
2021-06-04;SI;Slovenia;281;2;254973;4385
2021-06-05;SI;Slovenia;245;2;255218;4387
2021-06-06;SI;Slovenia;157;1;255375;4388
2021-06-07;SI;Slovenia;57;2;255432;4390
2021-06-08;SI;Slovenia;220;1;255652;4391
2021-06-09;SI;Slovenia;255;1;255907;4392
2021-06-10;SI;Slovenia;196;1;256103;4393
2021-06-11;SI;Slovenia;121;5;256224;4398
2021-06-12;SI;Slovenia;128;3;256352;4401
2021-06-13;SI;Slovenia;91;3;256443;4404
2021-06-14;SI;Slovenia;24;2;256467;4406
2021-06-15;SI;Slovenia;114;2;256581;4408
2021-06-16;SI;Slovenia;120;1;256701;4409
2021-06-17;SI;Slovenia;83;0;256784;4409
2021-06-18;SI;Slovenia;87;2;256871;4411
2021-06-19;SI;Slovenia;85;1;256956;4412
2021-06-20;SI;Slovenia;26;0;256982;4412
2021-06-21;SI;Slovenia;19;3;257001;4415
2021-06-22;SI;Slovenia;65;1;257066;4416
2021-06-23;SI;Slovenia;50;1;257116;4417
2021-06-24;SI;Slovenia;48;0;257164;4417
2021-06-25;SI;Slovenia;46;0;257210;4417
2021-06-26;SI;Slovenia;11;2;257221;4419
2021-06-27;SI;Slovenia;19;0;257240;4419
2021-06-28;SI;Slovenia;12;0;257252;4419
2021-06-29;SI;Slovenia;35;0;257287;4419
2021-06-30;SI;Slovenia;48;0;257335;4419
2021-07-01;SI;Slovenia;23;0;257358;4419
2020-10-12;SB;Solomon Islands;2;0;2;0
2020-10-13;SB;Solomon Islands;0;0;2;0
2020-10-14;SB;Solomon Islands;0;0;2;0
2020-10-15;SB;Solomon Islands;1;0;3;0
2020-10-16;SB;Solomon Islands;0;0;3;0
2020-10-17;SB;Solomon Islands;0;0;3;0
2020-10-18;SB;Solomon Islands;0;0;3;0
2020-10-19;SB;Solomon Islands;0;0;3;0
2020-10-20;SB;Solomon Islands;0;0;3;0
2020-10-21;SB;Solomon Islands;0;0;3;0
2020-10-22;SB;Solomon Islands;1;0;4;0
2020-10-23;SB;Solomon Islands;0;0;4;0
2020-10-24;SB;Solomon Islands;0;0;4;0
2020-10-25;SB;Solomon Islands;0;0;4;0
2020-10-26;SB;Solomon Islands;0;0;4;0
2020-10-27;SB;Solomon Islands;4;0;8;0
2020-10-28;SB;Solomon Islands;0;0;8;0
2020-10-29;SB;Solomon Islands;0;0;8;0
2020-10-30;SB;Solomon Islands;0;0;8;0
2020-10-31;SB;Solomon Islands;0;0;8;0
2020-11-01;SB;Solomon Islands;0;0;8;0
2020-11-02;SB;Solomon Islands;5;0;13;0
2020-11-03;SB;Solomon Islands;0;0;13;0
2020-11-04;SB;Solomon Islands;0;0;13;0
2020-11-05;SB;Solomon Islands;0;0;13;0
2020-11-06;SB;Solomon Islands;0;0;13;0
2020-11-07;SB;Solomon Islands;0;0;13;0
2020-11-08;SB;Solomon Islands;0;0;13;0
2020-11-09;SB;Solomon Islands;3;0;16;0
2020-11-10;SB;Solomon Islands;0;0;16;0
2020-11-11;SB;Solomon Islands;0;0;16;0
2020-11-12;SB;Solomon Islands;0;0;16;0
2020-11-13;SB;Solomon Islands;0;0;16;0
2020-11-14;SB;Solomon Islands;0;0;16;0
2020-11-15;SB;Solomon Islands;0;0;16;0
2020-11-16;SB;Solomon Islands;0;0;16;0
2020-11-17;SB;Solomon Islands;0;0;16;0
2020-11-18;SB;Solomon Islands;0;0;16;0
2020-11-19;SB;Solomon Islands;0;0;16;0
2020-11-20;SB;Solomon Islands;0;0;16;0
2020-11-21;SB;Solomon Islands;0;0;16;0
2020-11-22;SB;Solomon Islands;0;0;16;0
2020-11-23;SB;Solomon Islands;0;0;16;0
2020-11-24;SB;Solomon Islands;1;0;17;0
2020-11-25;SB;Solomon Islands;0;0;17;0
2020-11-26;SB;Solomon Islands;0;0;17;0
2020-11-27;SB;Solomon Islands;0;0;17;0
2020-11-28;SB;Solomon Islands;0;0;17;0
2020-11-29;SB;Solomon Islands;0;0;17;0
2020-11-30;SB;Solomon Islands;0;0;17;0
2020-12-01;SB;Solomon Islands;0;0;17;0
2020-12-02;SB;Solomon Islands;0;0;17;0
2020-12-03;SB;Solomon Islands;0;0;17;0
2020-12-04;SB;Solomon Islands;0;0;17;0
2020-12-05;SB;Solomon Islands;0;0;17;0
2020-12-06;SB;Solomon Islands;0;0;17;0
2020-12-07;SB;Solomon Islands;0;0;17;0
2020-12-08;SB;Solomon Islands;0;0;17;0
2020-12-09;SB;Solomon Islands;0;0;17;0
2020-12-10;SB;Solomon Islands;0;0;17;0
2020-12-11;SB;Solomon Islands;0;0;17;0
2020-12-12;SB;Solomon Islands;0;0;17;0
2020-12-13;SB;Solomon Islands;0;0;17;0
2020-12-14;SB;Solomon Islands;0;0;17;0
2020-12-15;SB;Solomon Islands;0;0;17;0
2020-12-16;SB;Solomon Islands;0;0;17;0
2020-12-17;SB;Solomon Islands;0;0;17;0
2020-12-18;SB;Solomon Islands;0;0;17;0
2020-12-19;SB;Solomon Islands;0;0;17;0
2020-12-20;SB;Solomon Islands;0;0;17;0
2020-12-21;SB;Solomon Islands;0;0;17;0
2020-12-22;SB;Solomon Islands;0;0;17;0
2020-12-23;SB;Solomon Islands;0;0;17;0
2020-12-24;SB;Solomon Islands;0;0;17;0
2020-12-25;SB;Solomon Islands;0;0;17;0
2020-12-26;SB;Solomon Islands;0;0;17;0
2020-12-27;SB;Solomon Islands;0;0;17;0
2020-12-28;SB;Solomon Islands;0;0;17;0
2020-12-29;SB;Solomon Islands;0;0;17;0
2020-12-30;SB;Solomon Islands;0;0;17;0
2020-12-31;SB;Solomon Islands;0;0;17;0
2021-01-01;SB;Solomon Islands;0;0;17;0
2021-01-02;SB;Solomon Islands;0;0;17;0
2021-01-03;SB;Solomon Islands;0;0;17;0
2021-01-04;SB;Solomon Islands;0;0;17;0
2021-01-05;SB;Solomon Islands;0;0;17;0
2021-01-06;SB;Solomon Islands;0;0;17;0
2021-01-07;SB;Solomon Islands;0;0;17;0
2021-01-08;SB;Solomon Islands;0;0;17;0
2021-01-09;SB;Solomon Islands;0;0;17;0
2021-01-10;SB;Solomon Islands;0;0;17;0
2021-01-11;SB;Solomon Islands;0;0;17;0
2021-01-12;SB;Solomon Islands;0;0;17;0
2021-01-13;SB;Solomon Islands;0;0;17;0
2021-01-14;SB;Solomon Islands;0;0;17;0
2021-01-15;SB;Solomon Islands;0;0;17;0
2021-01-16;SB;Solomon Islands;0;0;17;0
2021-01-17;SB;Solomon Islands;0;0;17;0
2021-01-18;SB;Solomon Islands;0;0;17;0
2021-01-19;SB;Solomon Islands;0;0;17;0
2021-01-20;SB;Solomon Islands;0;0;17;0
2021-01-21;SB;Solomon Islands;0;0;17;0
2021-01-22;SB;Solomon Islands;0;0;17;0
2021-01-23;SB;Solomon Islands;0;0;17;0
2021-01-24;SB;Solomon Islands;0;0;17;0
2021-01-25;SB;Solomon Islands;0;0;17;0
2021-01-26;SB;Solomon Islands;0;0;17;0
2021-01-27;SB;Solomon Islands;0;0;17;0
2021-01-28;SB;Solomon Islands;0;0;17;0
2021-01-29;SB;Solomon Islands;0;0;17;0
2021-01-30;SB;Solomon Islands;0;0;17;0
2021-01-31;SB;Solomon Islands;0;0;17;0
2021-02-01;SB;Solomon Islands;0;0;17;0
2021-02-02;SB;Solomon Islands;0;0;17;0
2021-02-03;SB;Solomon Islands;0;0;17;0
2021-02-04;SB;Solomon Islands;0;0;17;0
2021-02-05;SB;Solomon Islands;0;0;17;0
2021-02-06;SB;Solomon Islands;0;0;17;0
2021-02-07;SB;Solomon Islands;0;0;17;0
2021-02-08;SB;Solomon Islands;0;0;17;0
2021-02-09;SB;Solomon Islands;0;0;17;0
2021-02-10;SB;Solomon Islands;1;0;18;0
2021-02-11;SB;Solomon Islands;0;0;18;0
2021-02-12;SB;Solomon Islands;0;0;18;0
2021-02-13;SB;Solomon Islands;0;0;18;0
2021-02-14;SB;Solomon Islands;0;0;18;0
2021-02-15;SB;Solomon Islands;0;0;18;0
2021-02-16;SB;Solomon Islands;0;0;18;0
2021-02-17;SB;Solomon Islands;0;0;18;0
2021-02-18;SB;Solomon Islands;0;0;18;0
2021-02-19;SB;Solomon Islands;0;0;18;0
2021-02-20;SB;Solomon Islands;0;0;18;0
2021-02-21;SB;Solomon Islands;0;0;18;0
2021-02-22;SB;Solomon Islands;0;0;18;0
2021-02-23;SB;Solomon Islands;0;0;18;0
2021-02-24;SB;Solomon Islands;0;0;18;0
2021-02-25;SB;Solomon Islands;0;0;18;0
2021-02-26;SB;Solomon Islands;0;0;18;0
2021-02-27;SB;Solomon Islands;0;0;18;0
2021-02-28;SB;Solomon Islands;0;0;18;0
2021-03-01;SB;Solomon Islands;0;0;18;0
2021-03-02;SB;Solomon Islands;0;0;18;0
2021-03-03;SB;Solomon Islands;0;0;18;0
2021-03-04;SB;Solomon Islands;0;0;18;0
2021-03-05;SB;Solomon Islands;0;0;18;0
2021-03-06;SB;Solomon Islands;0;0;18;0
2021-03-07;SB;Solomon Islands;0;0;18;0
2021-03-08;SB;Solomon Islands;0;0;18;0
2021-03-09;SB;Solomon Islands;0;0;18;0
2021-03-10;SB;Solomon Islands;0;0;18;0
2021-03-11;SB;Solomon Islands;0;0;18;0
2021-03-12;SB;Solomon Islands;0;0;18;0
2021-03-13;SB;Solomon Islands;0;0;18;0
2021-03-14;SB;Solomon Islands;0;0;18;0
2021-03-15;SB;Solomon Islands;0;0;18;0
2021-03-16;SB;Solomon Islands;0;0;18;0
2021-03-17;SB;Solomon Islands;0;0;18;0
2021-03-18;SB;Solomon Islands;0;0;18;0
2021-03-19;SB;Solomon Islands;0;0;18;0
2021-03-20;SB;Solomon Islands;0;0;18;0
2021-03-21;SB;Solomon Islands;0;0;18;0
2021-03-22;SB;Solomon Islands;0;0;18;0
2021-03-23;SB;Solomon Islands;0;0;18;0
2021-03-24;SB;Solomon Islands;0;0;18;0
2021-03-25;SB;Solomon Islands;0;0;18;0
2021-03-26;SB;Solomon Islands;0;0;18;0
2021-03-27;SB;Solomon Islands;0;0;18;0
2021-03-28;SB;Solomon Islands;0;0;18;0
2021-03-29;SB;Solomon Islands;0;0;18;0
2021-03-30;SB;Solomon Islands;0;0;18;0
2021-03-31;SB;Solomon Islands;1;0;19;0
2021-04-01;SB;Solomon Islands;0;0;19;0
2021-04-02;SB;Solomon Islands;0;0;19;0
2021-04-03;SB;Solomon Islands;0;0;19;0
2021-04-04;SB;Solomon Islands;0;0;19;0
2021-04-05;SB;Solomon Islands;0;0;19;0
2021-04-06;SB;Solomon Islands;0;0;19;0
2021-04-07;SB;Solomon Islands;0;0;19;0
2021-04-08;SB;Solomon Islands;0;0;19;0
2021-04-09;SB;Solomon Islands;0;0;19;0
2021-04-10;SB;Solomon Islands;0;0;19;0
2021-04-11;SB;Solomon Islands;0;0;19;0
2021-04-12;SB;Solomon Islands;0;0;19;0
2021-04-13;SB;Solomon Islands;0;0;19;0
2021-04-14;SB;Solomon Islands;0;0;19;0
2021-04-15;SB;Solomon Islands;0;0;19;0
2021-04-16;SB;Solomon Islands;1;0;20;0
2021-04-17;SB;Solomon Islands;0;0;20;0
2021-04-18;SB;Solomon Islands;0;0;20;0
2021-04-19;SB;Solomon Islands;0;0;20;0
2021-04-20;SB;Solomon Islands;0;0;20;0
2021-04-21;SB;Solomon Islands;0;0;20;0
2021-04-22;SB;Solomon Islands;0;0;20;0
2021-04-23;SB;Solomon Islands;0;0;20;0
2021-04-24;SB;Solomon Islands;0;0;20;0
2021-04-25;SB;Solomon Islands;0;0;20;0
2021-04-26;SB;Solomon Islands;0;0;20;0
2021-04-27;SB;Solomon Islands;0;0;20;0
2021-04-28;SB;Solomon Islands;0;0;20;0
2021-04-29;SB;Solomon Islands;0;0;20;0
2021-04-30;SB;Solomon Islands;0;0;20;0
2021-05-01;SB;Solomon Islands;0;0;20;0
2021-05-02;SB;Solomon Islands;0;0;20;0
2021-05-03;SB;Solomon Islands;0;0;20;0
2021-05-04;SB;Solomon Islands;0;0;20;0
2021-05-05;SB;Solomon Islands;0;0;20;0
2021-05-06;SB;Solomon Islands;0;0;20;0
2021-05-07;SB;Solomon Islands;0;0;20;0
2021-05-08;SB;Solomon Islands;0;0;20;0
2021-05-09;SB;Solomon Islands;0;0;20;0
2021-05-10;SB;Solomon Islands;0;0;20;0
2021-05-11;SB;Solomon Islands;0;0;20;0
2021-05-12;SB;Solomon Islands;0;0;20;0
2021-05-13;SB;Solomon Islands;0;0;20;0
2021-05-14;SB;Solomon Islands;0;0;20;0
2021-05-15;SB;Solomon Islands;0;0;20;0
2021-05-16;SB;Solomon Islands;0;0;20;0
2021-05-17;SB;Solomon Islands;0;0;20;0
2021-05-18;SB;Solomon Islands;0;0;20;0
2021-05-19;SB;Solomon Islands;0;0;20;0
2021-05-20;SB;Solomon Islands;0;0;20;0
2021-05-21;SB;Solomon Islands;0;0;20;0
2021-05-22;SB;Solomon Islands;0;0;20;0
2021-05-23;SB;Solomon Islands;0;0;20;0
2021-05-24;SB;Solomon Islands;0;0;20;0
2021-05-25;SB;Solomon Islands;0;0;20;0
2021-05-26;SB;Solomon Islands;0;0;20;0
2021-05-27;SB;Solomon Islands;0;0;20;0
2021-05-28;SB;Solomon Islands;0;0;20;0
2021-05-29;SB;Solomon Islands;0;0;20;0
2021-05-30;SB;Solomon Islands;0;0;20;0
2021-05-31;SB;Solomon Islands;0;0;20;0
2021-06-01;SB;Solomon Islands;0;0;20;0
2021-06-02;SB;Solomon Islands;0;0;20;0
2021-06-03;SB;Solomon Islands;0;0;20;0
2021-06-04;SB;Solomon Islands;0;0;20;0
2021-06-05;SB;Solomon Islands;0;0;20;0
2021-06-06;SB;Solomon Islands;0;0;20;0
2021-06-07;SB;Solomon Islands;0;0;20;0
2021-06-08;SB;Solomon Islands;0;0;20;0
2021-06-09;SB;Solomon Islands;0;0;20;0
2021-06-10;SB;Solomon Islands;0;0;20;0
2021-06-11;SB;Solomon Islands;0;0;20;0
2021-06-12;SB;Solomon Islands;0;0;20;0
2021-06-13;SB;Solomon Islands;0;0;20;0
2021-06-14;SB;Solomon Islands;0;0;20;0
2021-06-15;SB;Solomon Islands;0;0;20;0
2021-06-16;SB;Solomon Islands;0;0;20;0
2021-06-17;SB;Solomon Islands;0;0;20;0
2021-06-18;SB;Solomon Islands;0;0;20;0
2021-06-19;SB;Solomon Islands;0;0;20;0
2021-06-20;SB;Solomon Islands;0;0;20;0
2021-06-21;SB;Solomon Islands;0;0;20;0
2021-06-22;SB;Solomon Islands;0;0;20;0
2021-06-23;SB;Solomon Islands;0;0;20;0
2021-06-24;SB;Solomon Islands;0;0;20;0
2021-06-25;SB;Solomon Islands;0;0;20;0
2021-06-26;SB;Solomon Islands;0;0;20;0
2021-06-27;SB;Solomon Islands;0;0;20;0
2021-06-28;SB;Solomon Islands;0;0;20;0
2021-06-29;SB;Solomon Islands;0;0;20;0
2021-06-30;SB;Solomon Islands;0;0;20;0
2021-07-01;SB;Solomon Islands;0;0;20;0
2020-03-16;SO;Somalia;1;0;1;0
2020-03-17;SO;Somalia;0;0;1;0
2020-03-18;SO;Somalia;0;0;1;0
2020-03-19;SO;Somalia;0;0;1;0
2020-03-20;SO;Somalia;0;0;1;0
2020-03-21;SO;Somalia;0;0;1;0
2020-03-22;SO;Somalia;0;0;1;0
2020-03-23;SO;Somalia;0;0;1;0
2020-03-24;SO;Somalia;0;0;1;0
2020-03-25;SO;Somalia;0;0;1;0
2020-03-26;SO;Somalia;1;0;2;0
2020-03-27;SO;Somalia;1;0;3;0
2020-03-28;SO;Somalia;0;0;3;0
2020-03-29;SO;Somalia;0;0;3;0
2020-03-30;SO;Somalia;0;0;3;0
2020-03-31;SO;Somalia;2;0;5;0
2020-04-01;SO;Somalia;0;0;5;0
2020-04-02;SO;Somalia;0;0;5;0
2020-04-03;SO;Somalia;2;0;7;0
2020-04-04;SO;Somalia;0;0;7;0
2020-04-05;SO;Somalia;0;0;7;0
2020-04-06;SO;Somalia;0;0;7;0
2020-04-07;SO;Somalia;1;0;8;0
2020-04-08;SO;Somalia;4;1;12;1
2020-04-09;SO;Somalia;0;0;12;1
2020-04-10;SO;Somalia;9;0;21;1
2020-04-11;SO;Somalia;0;0;21;1
2020-04-12;SO;Somalia;4;0;25;1
2020-04-13;SO;Somalia;35;1;60;2
2020-04-14;SO;Somalia;0;0;60;2
2020-04-15;SO;Somalia;20;3;80;5
2020-04-16;SO;Somalia;0;0;80;5
2020-04-17;SO;Somalia;36;1;116;6
2020-04-18;SO;Somalia;19;1;135;7
2020-04-19;SO;Somalia;29;0;164;7
2020-04-20;SO;Somalia;73;1;237;8
2020-04-21;SO;Somalia;49;0;286;8
2020-04-22;SO;Somalia;0;0;286;8
2020-04-23;SO;Somalia;42;8;328;16
2020-04-24;SO;Somalia;0;0;328;16
2020-04-25;SO;Somalia;62;2;390;18
2020-04-26;SO;Somalia;46;5;436;23
2020-04-27;SO;Somalia;44;3;480;26
2020-04-28;SO;Somalia;48;2;528;28
2020-04-29;SO;Somalia;54;0;582;28
2020-04-30;SO;Somalia;19;0;601;28
2020-05-01;SO;Somalia;0;0;601;28
2020-05-02;SO;Somalia;70;3;671;31
2020-05-03;SO;Somalia;51;1;722;32
2020-05-04;SO;Somalia;34;3;756;35
2020-05-05;SO;Somalia;79;3;835;38
2020-05-06;SO;Somalia;38;1;873;39
2020-05-07;SO;Somalia;55;5;928;44
2020-05-08;SO;Somalia;0;0;928;44
2020-05-09;SO;Somalia;69;4;997;48
2020-05-10;SO;Somalia;57;3;1054;51
2020-05-11;SO;Somalia;35;1;1089;52
2020-05-12;SO;Somalia;81;0;1170;52
2020-05-13;SO;Somalia;49;0;1219;52
2020-05-14;SO;Somalia;65;1;1284;53
2020-05-15;SO;Somalia;0;0;1284;53
2020-05-16;SO;Somalia;73;2;1357;55
2020-05-17;SO;Somalia;64;1;1421;56
2020-05-18;SO;Somalia;34;1;1455;57
2020-05-19;SO;Somalia;47;2;1502;59
2020-05-20;SO;Somalia;71;2;1573;61
2020-05-21;SO;Somalia;21;0;1594;61
2020-05-22;SO;Somalia;0;0;1594;61
2020-05-23;SO;Somalia;0;0;1594;61
2020-05-24;SO;Somalia;0;0;1594;61
2020-05-25;SO;Somalia;95;5;1689;66
2020-05-26;SO;Somalia;22;1;1711;67
2020-05-27;SO;Somalia;20;0;1731;67
2020-05-28;SO;Somalia;97;5;1828;72
2020-05-29;SO;Somalia;0;0;1828;72
2020-05-30;SO;Somalia;88;1;1916;73
2020-05-31;SO;Somalia;60;5;1976;78
2020-06-01;SO;Somalia;47;1;2023;79
2020-06-02;SO;Somalia;66;0;2089;79
2020-06-03;SO;Somalia;57;0;2146;79
2020-06-04;SO;Somalia;58;0;2204;79
2020-06-05;SO;Somalia;0;0;2204;79
2020-06-06;SO;Somalia;85;3;2289;82
2020-06-07;SO;Somalia;45;1;2334;83
2020-06-08;SO;Somalia;34;1;2368;84
2020-06-09;SO;Somalia;48;1;2416;85
2020-06-10;SO;Somalia;36;0;2452;85
2020-06-11;SO;Somalia;61;0;2513;85
2020-06-12;SO;Somalia;0;0;2513;85
2020-06-13;SO;Somalia;66;2;2579;87
2020-06-14;SO;Somalia;39;1;2618;88
2020-06-15;SO;Somalia;24;0;2642;88
2020-06-16;SO;Somalia;16;0;2658;88
2020-06-17;SO;Somalia;38;0;2696;88
2020-06-18;SO;Somalia;23;0;2719;88
2020-06-19;SO;Somalia;0;0;2719;88
2020-06-20;SO;Somalia;36;0;2755;88
2020-06-21;SO;Somalia;24;2;2779;90
2020-06-22;SO;Somalia;33;0;2812;90
2020-06-23;SO;Somalia;0;0;2812;90
2020-06-24;SO;Somalia;23;0;2835;90
2020-06-25;SO;Somalia;43;0;2878;90
2020-06-26;SO;Somalia;0;0;2878;90
2020-06-27;SO;Somalia;0;0;2878;90
2020-06-28;SO;Somalia;16;0;2894;90
2020-06-29;SO;Somalia;10;0;2904;90
2020-06-30;SO;Somalia;20;0;2924;90
2020-07-01;SO;Somalia;0;0;2924;90
2020-07-02;SO;Somalia;20;0;2944;90
2020-07-03;SO;Somalia;0;0;2944;90
2020-07-04;SO;Somalia;17;2;2961;92
2020-07-05;SO;Somalia;36;0;2997;92
2020-07-06;SO;Somalia;9;0;3006;92
2020-07-07;SO;Somalia;9;0;3015;92
2020-07-08;SO;Somalia;13;0;3028;92
2020-07-09;SO;Somalia;10;0;3038;92
2020-07-10;SO;Somalia;0;0;3038;92
2020-07-11;SO;Somalia;13;0;3051;92
2020-07-12;SO;Somalia;8;1;3059;93
2020-07-13;SO;Somalia;13;0;3072;93
2020-07-14;SO;Somalia;4;0;3076;93
2020-07-15;SO;Somalia;7;0;3083;93
2020-07-16;SO;Somalia;23;0;3106;93
2020-07-17;SO;Somalia;0;0;3106;93
2020-07-18;SO;Somalia;5;0;3111;93
2020-07-19;SO;Somalia;8;0;3119;93
2020-07-20;SO;Somalia;11;0;3130;93
2020-07-21;SO;Somalia;5;0;3135;93
2020-07-22;SO;Somalia;26;0;3161;93
2020-07-23;SO;Somalia;10;0;3171;93
2020-07-24;SO;Somalia;0;0;3171;93
2020-07-25;SO;Somalia;7;0;3178;93
2020-07-26;SO;Somalia;0;0;3178;93
2020-07-27;SO;Somalia;18;0;3196;93
2020-07-28;SO;Somalia;16;0;3212;93
2020-07-29;SO;Somalia;0;0;3212;93
2020-07-30;SO;Somalia;0;0;3212;93
2020-07-31;SO;Somalia;0;0;3212;93
2020-08-01;SO;Somalia;0;0;3212;93
2020-08-02;SO;Somalia;8;0;3220;93
2020-08-03;SO;Somalia;0;0;3220;93
2020-08-04;SO;Somalia;0;0;3220;93
2020-08-05;SO;Somalia;7;0;3227;93
2020-08-06;SO;Somalia;0;0;3227;93
2020-08-07;SO;Somalia;0;0;3227;93
2020-08-08;SO;Somalia;0;0;3227;93
2020-08-09;SO;Somalia;0;0;3227;93
2020-08-10;SO;Somalia;0;0;3227;93
2020-08-11;SO;Somalia;0;0;3227;93
2020-08-12;SO;Somalia;0;0;3227;93
2020-08-13;SO;Somalia;0;0;3227;93
2020-08-14;SO;Somalia;23;0;3250;93
2020-08-15;SO;Somalia;0;0;3250;93
2020-08-16;SO;Somalia;6;0;3256;93
2020-08-17;SO;Somalia;1;0;3257;93
2020-08-18;SO;Somalia;0;0;3257;93
2020-08-19;SO;Somalia;8;0;3265;93
2020-08-20;SO;Somalia;0;0;3265;93
2020-08-21;SO;Somalia;0;0;3265;93
2020-08-22;SO;Somalia;4;0;3269;93
2020-08-23;SO;Somalia;0;0;3269;93
2020-08-24;SO;Somalia;0;0;3269;93
2020-08-25;SO;Somalia;6;2;3275;95
2020-08-26;SO;Somalia;0;0;3275;95
2020-08-27;SO;Somalia;0;0;3275;95
2020-08-28;SO;Somalia;0;0;3275;95
2020-08-29;SO;Somalia;35;2;3310;97
2020-08-30;SO;Somalia;0;1;3310;98
2020-08-31;SO;Somalia;0;0;3310;98
2020-09-01;SO;Somalia;0;0;3310;98
2020-09-02;SO;Somalia;0;0;3310;98
2020-09-03;SO;Somalia;0;0;3310;98
2020-09-04;SO;Somalia;22;-1;3332;97
2020-09-05;SO;Somalia;0;0;3332;97
2020-09-06;SO;Somalia;30;0;3362;97
2020-09-07;SO;Somalia;0;0;3362;97
2020-09-08;SO;Somalia;9;0;3371;97
2020-09-09;SO;Somalia;0;0;3371;97
2020-09-10;SO;Somalia;0;0;3371;97
2020-09-11;SO;Somalia;5;1;3376;98
2020-09-12;SO;Somalia;0;0;3376;98
2020-09-13;SO;Somalia;13;0;3389;98
2020-09-14;SO;Somalia;0;0;3389;98
2020-09-15;SO;Somalia;1;0;3390;98
2020-09-16;SO;Somalia;0;0;3390;98
2020-09-17;SO;Somalia;0;0;3390;98
2020-09-18;SO;Somalia;0;0;3390;98
2020-09-19;SO;Somalia;11;0;3401;98
2020-09-20;SO;Somalia;41;0;3442;98
2020-09-21;SO;Somalia;23;0;3465;98
2020-09-22;SO;Somalia;0;0;3465;98
2020-09-23;SO;Somalia;0;0;3465;98
2020-09-24;SO;Somalia;0;0;3465;98
2020-09-25;SO;Somalia;0;0;3465;98
2020-09-26;SO;Somalia;123;1;3588;99
2020-09-27;SO;Somalia;0;0;3588;99
2020-09-28;SO;Somalia;0;0;3588;99
2020-09-29;SO;Somalia;0;0;3588;99
2020-09-30;SO;Somalia;0;0;3588;99
2020-10-01;SO;Somalia;5;0;3593;99
2020-10-02;SO;Somalia;0;0;3593;99
2020-10-03;SO;Somalia;0;0;3593;99
2020-10-04;SO;Somalia;152;0;3745;99
2020-10-05;SO;Somalia;0;0;3745;99
2020-10-06;SO;Somalia;0;0;3745;99
2020-10-07;SO;Somalia;0;0;3745;99
2020-10-08;SO;Somalia;0;0;3745;99
2020-10-09;SO;Somalia;0;0;3745;99
2020-10-10;SO;Somalia;102;0;3847;99
2020-10-11;SO;Somalia;17;0;3864;99
2020-10-12;SO;Somalia;0;0;3864;99
2020-10-13;SO;Somalia;0;0;3864;99
2020-10-14;SO;Somalia;0;0;3864;99
2020-10-15;SO;Somalia;0;0;3864;99
2020-10-16;SO;Somalia;0;0;3864;99
2020-10-17;SO;Somalia;0;0;3864;99
2020-10-18;SO;Somalia;0;0;3864;99
2020-10-19;SO;Somalia;26;0;3890;99
2020-10-20;SO;Somalia;0;2;3890;101
2020-10-21;SO;Somalia;0;0;3890;101
2020-10-22;SO;Somalia;7;1;3897;102
2020-10-23;SO;Somalia;0;0;3897;102
2020-10-24;SO;Somalia;0;0;3897;102
2020-10-25;SO;Somalia;44;2;3941;104
2020-10-26;SO;Somalia;0;0;3941;104
2020-10-27;SO;Somalia;0;0;3941;104
2020-10-28;SO;Somalia;0;0;3941;104
2020-10-29;SO;Somalia;0;0;3941;104
2020-10-30;SO;Somalia;0;0;3941;104
2020-10-31;SO;Somalia;0;0;3941;104
2020-11-01;SO;Somalia;0;0;3941;104
2020-11-02;SO;Somalia;0;0;3941;104
2020-11-03;SO;Somalia;288;3;4229;107
2020-11-04;SO;Somalia;0;0;4229;107
2020-11-05;SO;Somalia;0;0;4229;107
2020-11-06;SO;Somalia;0;0;4229;107
2020-11-07;SO;Somalia;0;0;4229;107
2020-11-08;SO;Somalia;0;0;4229;107
2020-11-09;SO;Somalia;72;0;4301;107
2020-11-10;SO;Somalia;0;0;4301;107
2020-11-11;SO;Somalia;0;0;4301;107
2020-11-12;SO;Somalia;0;0;4301;107
2020-11-13;SO;Somalia;0;0;4301;107
2020-11-14;SO;Somalia;0;0;4301;107
2020-11-15;SO;Somalia;0;0;4301;107
2020-11-16;SO;Somalia;0;0;4301;107
2020-11-17;SO;Somalia;81;1;4382;108
2020-11-18;SO;Somalia;0;0;4382;108
2020-11-19;SO;Somalia;0;0;4382;108
2020-11-20;SO;Somalia;0;0;4382;108
2020-11-21;SO;Somalia;0;0;4382;108
2020-11-22;SO;Somalia;63;5;4445;113
2020-11-23;SO;Somalia;0;0;4445;113
2020-11-24;SO;Somalia;0;0;4445;113
2020-11-25;SO;Somalia;0;0;4445;113
2020-11-26;SO;Somalia;6;0;4451;113
2020-11-27;SO;Somalia;0;0;4451;113
2020-11-28;SO;Somalia;0;0;4451;113
2020-11-29;SO;Somalia;0;0;4451;113
2020-11-30;SO;Somalia;0;0;4451;113
2020-12-01;SO;Somalia;0;0;4451;113
2020-12-02;SO;Somalia;74;8;4525;121
2020-12-03;SO;Somalia;0;0;4525;121
2020-12-04;SO;Somalia;0;0;4525;121
2020-12-05;SO;Somalia;0;0;4525;121
2020-12-06;SO;Somalia;0;0;4525;121
2020-12-07;SO;Somalia;54;0;4579;121
2020-12-08;SO;Somalia;0;0;4579;121
2020-12-09;SO;Somalia;0;0;4579;121
2020-12-10;SO;Somalia;0;0;4579;121
2020-12-11;SO;Somalia;0;0;4579;121
2020-12-12;SO;Somalia;0;0;4579;121
2020-12-13;SO;Somalia;0;0;4579;121
2020-12-14;SO;Somalia;0;0;4579;121
2020-12-15;SO;Somalia;0;0;4579;121
2020-12-16;SO;Somalia;0;0;4579;121
2020-12-17;SO;Somalia;83;3;4662;124
2020-12-18;SO;Somalia;0;0;4662;124
2020-12-19;SO;Somalia;0;0;4662;124
2020-12-20;SO;Somalia;0;0;4662;124
2020-12-21;SO;Somalia;0;0;4662;124
2020-12-22;SO;Somalia;28;3;4690;127
2020-12-23;SO;Somalia;0;0;4690;127
2020-12-24;SO;Somalia;0;0;4690;127
2020-12-25;SO;Somalia;0;0;4690;127
2020-12-26;SO;Somalia;0;0;4690;127
2020-12-27;SO;Somalia;0;0;4690;127
2020-12-28;SO;Somalia;0;0;4690;127
2020-12-29;SO;Somalia;0;0;4690;127
2020-12-30;SO;Somalia;24;3;4714;130
2020-12-31;SO;Somalia;0;0;4714;130
2021-01-01;SO;Somalia;0;0;4714;130
2021-01-02;SO;Somalia;0;0;4714;130
2021-01-03;SO;Somalia;0;0;4714;130
2021-01-04;SO;Somalia;0;0;4714;130
2021-01-05;SO;Somalia;0;0;4714;130
2021-01-06;SO;Somalia;12;0;4726;130
2021-01-07;SO;Somalia;0;0;4726;130
2021-01-08;SO;Somalia;0;0;4726;130
2021-01-09;SO;Somalia;0;0;4726;130
2021-01-10;SO;Somalia;0;0;4726;130
2021-01-11;SO;Somalia;0;0;4726;130
2021-01-12;SO;Somalia;0;0;4726;130
2021-01-13;SO;Somalia;0;0;4726;130
2021-01-14;SO;Somalia;18;0;4744;130
2021-01-15;SO;Somalia;0;0;4744;130
2021-01-16;SO;Somalia;0;0;4744;130
2021-01-17;SO;Somalia;0;0;4744;130
2021-01-18;SO;Somalia;0;0;4744;130
2021-01-19;SO;Somalia;0;0;4744;130
2021-01-20;SO;Somalia;0;0;4744;130
2021-01-21;SO;Somalia;0;0;4744;130
2021-01-22;SO;Somalia;0;0;4744;130
2021-01-23;SO;Somalia;10;0;4754;130
2021-01-24;SO;Somalia;0;0;4754;130
2021-01-25;SO;Somalia;0;0;4754;130
2021-01-26;SO;Somalia;0;0;4754;130
2021-01-27;SO;Somalia;0;0;4754;130
2021-01-28;SO;Somalia;30;0;4784;130
2021-01-29;SO;Somalia;0;0;4784;130
2021-01-30;SO;Somalia;0;0;4784;130
2021-01-31;SO;Somalia;0;0;4784;130
2021-02-01;SO;Somalia;0;0;4784;130
2021-02-02;SO;Somalia;0;0;4784;130
2021-02-03;SO;Somalia;30;2;4814;132
2021-02-04;SO;Somalia;0;0;4814;132
2021-02-05;SO;Somalia;0;0;4814;132
2021-02-06;SO;Somalia;40;2;4854;134
2021-02-07;SO;Somalia;8;0;4862;134
2021-02-08;SO;Somalia;0;0;4862;134
2021-02-09;SO;Somalia;0;0;4862;134
2021-02-10;SO;Somalia;73;5;4935;139
2021-02-11;SO;Somalia;78;5;5013;144
2021-02-12;SO;Somalia;62;2;5075;146
2021-02-13;SO;Somalia;17;2;5092;148
2021-02-14;SO;Somalia;91;4;5183;152
2021-02-15;SO;Somalia;90;2;5273;154
2021-02-16;SO;Somalia;100;9;5373;163
2021-02-17;SO;Somalia;127;9;5500;172
2021-02-18;SO;Somalia;132;7;5632;179
2021-02-19;SO;Somalia;0;0;5632;179
2021-02-20;SO;Somalia;257;15;5889;194
2021-02-21;SO;Somalia;128;8;6017;202
2021-02-22;SO;Somalia;229;6;6246;208
2021-02-23;SO;Somalia;0;0;6246;208
2021-02-24;SO;Somalia;303;10;6549;218
2021-02-25;SO;Somalia;138;5;6687;223
2021-02-26;SO;Somalia;0;0;6687;223
2021-02-27;SO;Somalia;304;8;6991;231
2021-02-28;SO;Somalia;266;8;7257;239
2021-03-01;SO;Somalia;135;4;7392;243
2021-03-02;SO;Somalia;126;6;7518;249
2021-03-03;SO;Somalia;209;11;7727;260
2021-03-04;SO;Somalia;123;14;7850;274
2021-03-05;SO;Somalia;0;0;7850;274
2021-03-06;SO;Somalia;191;20;8041;294
2021-03-07;SO;Somalia;280;8;8321;302
2021-03-08;SO;Somalia;117;5;8438;307
2021-03-09;SO;Somalia;139;12;8577;319
2021-03-10;SO;Somalia;136;8;8713;327
2021-03-11;SO;Somalia;107;11;8820;338
2021-03-12;SO;Somalia;0;0;8820;338
2021-03-13;SO;Somalia;126;11;8946;349
2021-03-14;SO;Somalia;244;18;9190;367
2021-03-15;SO;Somalia;138;12;9328;379
2021-03-16;SO;Somalia;109;6;9437;385
2021-03-17;SO;Somalia;163;7;9600;392
2021-03-18;SO;Somalia;0;0;9600;392
2021-03-19;SO;Somalia;325;22;9925;414
2021-03-20;SO;Somalia;43;5;9968;419
2021-03-21;SO;Somalia;117;10;10085;429
2021-03-22;SO;Somalia;129;12;10214;441
2021-03-23;SO;Somalia;155;12;10369;453
2021-03-24;SO;Somalia;0;0;10369;453
2021-03-25;SO;Somalia;295;18;10664;471
2021-03-26;SO;Somalia;0;0;10664;471
2021-03-27;SO;Somalia;174;17;10838;488
2021-03-28;SO;Somalia;139;8;10977;496
2021-03-29;SO;Somalia;187;14;11164;510
2021-03-30;SO;Somalia;128;11;11292;521
2021-03-31;SO;Somalia;106;8;11398;529
2021-04-01;SO;Somalia;101;8;11499;537
2021-04-02;SO;Somalia;0;0;11499;537
2021-04-03;SO;Somalia;5;0;11504;537
2021-04-04;SO;Somalia;279;20;11783;557
2021-04-05;SO;Somalia;125;11;11908;568
2021-04-06;SO;Somalia;70;8;11978;576
2021-04-07;SO;Somalia;0;0;11978;576
2021-04-08;SO;Somalia;293;29;12271;605
2021-04-09;SO;Somalia;0;0;12271;605
2021-04-10;SO;Somalia;0;0;12271;605
2021-04-11;SO;Somalia;135;13;12406;618
2021-04-12;SO;Somalia;160;0;12566;618
2021-04-13;SO;Somalia;0;0;12566;618
2021-04-14;SO;Somalia;271;38;12837;656
2021-04-15;SO;Somalia;0;0;12837;656
2021-04-16;SO;Somalia;0;0;12837;656
2021-04-17;SO;Somalia;0;0;12837;656
2021-04-18;SO;Somalia;242;14;13079;670
2021-04-19;SO;Somalia;245;8;13324;678
2021-04-20;SO;Somalia;0;0;13324;678
2021-04-21;SO;Somalia;135;11;13459;689
2021-04-22;SO;Somalia;0;0;13459;689
2021-04-23;SO;Somalia;0;0;13459;689
2021-04-24;SO;Somalia;0;0;13459;689
2021-04-25;SO;Somalia;211;9;13670;698
2021-04-26;SO;Somalia;142;4;13812;702
2021-04-27;SO;Somalia;103;11;13915;713
2021-04-28;SO;Somalia;0;0;13915;713
2021-04-29;SO;Somalia;0;0;13915;713
2021-04-30;SO;Somalia;0;0;13915;713
2021-05-01;SO;Somalia;0;0;13915;713
2021-05-02;SO;Somalia;0;0;13915;713
2021-05-03;SO;Somalia;0;0;13915;713
2021-05-04;SO;Somalia;206;8;14121;721
2021-05-05;SO;Somalia;0;0;14121;721
2021-05-06;SO;Somalia;247;24;14368;745
2021-05-07;SO;Somalia;0;0;14368;745
2021-05-08;SO;Somalia;47;2;14415;747
2021-05-09;SO;Somalia;0;0;14415;747
2021-05-10;SO;Somalia;0;0;14415;747
2021-05-11;SO;Somalia;71;6;14486;753
2021-05-12;SO;Somalia;0;0;14486;753
2021-05-13;SO;Somalia;0;0;14486;753
2021-05-14;SO;Somalia;0;0;14486;753
2021-05-15;SO;Somalia;0;0;14486;753
2021-05-16;SO;Somalia;0;0;14486;753
2021-05-17;SO;Somalia;0;0;14486;753
2021-05-18;SO;Somalia;89;9;14575;762
2021-05-19;SO;Somalia;0;0;14575;762
2021-05-20;SO;Somalia;19;5;14594;767
2021-05-21;SO;Somalia;0;0;14594;767
2021-05-22;SO;Somalia;29;0;14623;767
2021-05-23;SO;Somalia;9;0;14632;767
2021-05-24;SO;Somalia;0;0;14632;767
2021-05-25;SO;Somalia;0;0;14632;767
2021-05-26;SO;Somalia;0;0;14632;767
2021-05-27;SO;Somalia;15;1;14647;768
2021-05-28;SO;Somalia;0;0;14647;768
2021-05-29;SO;Somalia;6;0;14653;768
2021-05-30;SO;Somalia;7;1;14660;769
2021-05-31;SO;Somalia;2;0;14662;769
2021-06-01;SO;Somalia;5;0;14667;769
2021-06-02;SO;Somalia;24;1;14691;770
2021-06-03;SO;Somalia;8;1;14699;771
2021-06-04;SO;Somalia;0;0;14699;771
2021-06-05;SO;Somalia;30;2;14729;773
2021-06-06;SO;Somalia;19;0;14748;773
2021-06-07;SO;Somalia;20;0;14768;773
2021-06-08;SO;Somalia;8;0;14776;773
2021-06-09;SO;Somalia;3;1;14779;774
2021-06-10;SO;Somalia;0;0;14779;774
2021-06-11;SO;Somalia;0;0;14779;774
2021-06-12;SO;Somalia;0;0;14779;774
2021-06-13;SO;Somalia;38;0;14817;774
2021-06-14;SO;Somalia;0;0;14817;774
2021-06-15;SO;Somalia;6;1;14823;775
2021-06-16;SO;Somalia;4;0;14827;775
2021-06-17;SO;Somalia;14;0;14841;775
2021-06-18;SO;Somalia;0;0;14841;775
2021-06-19;SO;Somalia;11;0;14852;775
2021-06-20;SO;Somalia;0;0;14852;775
2021-06-21;SO;Somalia;15;0;14867;775
2021-06-22;SO;Somalia;1;0;14868;775
2021-06-23;SO;Somalia;0;0;14868;775
2021-06-24;SO;Somalia;7;0;14875;775
2021-06-25;SO;Somalia;0;0;14875;775
2021-06-26;SO;Somalia;17;0;14892;775
2021-06-27;SO;Somalia;0;0;14892;775
2021-06-28;SO;Somalia;41;0;14933;775
2021-06-29;SO;Somalia;0;0;14933;775
2021-06-30;SO;Somalia;13;0;14946;775
2021-07-01;SO;Somalia;0;0;14946;775
2020-02-07;ZA;South Africa;0;0;0;0
2020-02-08;ZA;South Africa;0;0;0;0
2020-02-09;ZA;South Africa;0;0;0;0
2020-02-10;ZA;South Africa;0;0;0;0
2020-02-11;ZA;South Africa;0;0;0;0
2020-02-12;ZA;South Africa;0;0;0;0
2020-02-13;ZA;South Africa;0;0;0;0
2020-02-14;ZA;South Africa;0;0;0;0
2020-02-15;ZA;South Africa;0;0;0;0
2020-02-16;ZA;South Africa;0;0;0;0
2020-02-17;ZA;South Africa;0;0;0;0
2020-02-18;ZA;South Africa;0;0;0;0
2020-02-19;ZA;South Africa;0;0;0;0
2020-02-20;ZA;South Africa;0;0;0;0
2020-02-21;ZA;South Africa;0;0;0;0
2020-02-22;ZA;South Africa;0;0;0;0
2020-02-23;ZA;South Africa;0;0;0;0
2020-02-24;ZA;South Africa;0;0;0;0
2020-02-25;ZA;South Africa;0;0;0;0
2020-02-26;ZA;South Africa;0;0;0;0
2020-02-27;ZA;South Africa;0;0;0;0
2020-02-28;ZA;South Africa;0;0;0;0
2020-02-29;ZA;South Africa;0;0;0;0
2020-03-01;ZA;South Africa;0;0;0;0
2020-03-02;ZA;South Africa;0;0;0;0
2020-03-03;ZA;South Africa;0;0;0;0
2020-03-04;ZA;South Africa;0;0;0;0
2020-03-05;ZA;South Africa;1;0;1;0
2020-03-06;ZA;South Africa;0;0;1;0
2020-03-07;ZA;South Africa;0;0;1;0
2020-03-08;ZA;South Africa;2;0;3;0
2020-03-09;ZA;South Africa;0;0;3;0
2020-03-10;ZA;South Africa;4;0;7;0
2020-03-11;ZA;South Africa;6;0;13;0
2020-03-12;ZA;South Africa;4;0;17;0
2020-03-13;ZA;South Africa;7;0;24;0
2020-03-14;ZA;South Africa;14;0;38;0
2020-03-15;ZA;South Africa;13;0;51;0
2020-03-16;ZA;South Africa;11;0;62;0
2020-03-17;ZA;South Africa;0;0;62;0
2020-03-18;ZA;South Africa;54;0;116;0
2020-03-19;ZA;South Africa;34;0;150;0
2020-03-20;ZA;South Africa;52;0;202;0
2020-03-21;ZA;South Africa;38;0;240;0
2020-03-22;ZA;South Africa;34;0;274;0
2020-03-23;ZA;South Africa;128;0;402;0
2020-03-24;ZA;South Africa;152;0;554;0
2020-03-25;ZA;South Africa;155;0;709;0
2020-03-26;ZA;South Africa;218;0;927;0
2020-03-27;ZA;South Africa;243;1;1170;1
2020-03-28;ZA;South Africa;17;0;1187;1
2020-03-29;ZA;South Africa;93;1;1280;2
2020-03-30;ZA;South Africa;46;1;1326;3
2020-03-31;ZA;South Africa;27;2;1353;5
2020-04-01;ZA;South Africa;27;0;1380;5
2020-04-02;ZA;South Africa;82;0;1462;5
2020-04-03;ZA;South Africa;43;4;1505;9
2020-04-04;ZA;South Africa;80;0;1585;9
2020-04-05;ZA;South Africa;70;2;1655;11
2020-04-06;ZA;South Africa;31;1;1686;12
2020-04-07;ZA;South Africa;63;1;1749;13
2020-04-08;ZA;South Africa;96;5;1845;18
2020-04-09;ZA;South Africa;89;0;1934;18
2020-04-10;ZA;South Africa;69;6;2003;24
2020-04-11;ZA;South Africa;25;1;2028;25
2020-04-12;ZA;South Africa;145;0;2173;25
2020-04-13;ZA;South Africa;99;2;2272;27
2020-04-14;ZA;South Africa;143;0;2415;27
2020-04-15;ZA;South Africa;91;7;2506;34
2020-04-16;ZA;South Africa;99;14;2605;48
2020-04-17;ZA;South Africa;178;2;2783;50
2020-04-18;ZA;South Africa;251;2;3034;52
2020-04-19;ZA;South Africa;124;2;3158;54
2020-04-20;ZA;South Africa;142;4;3300;58
2020-04-21;ZA;South Africa;165;0;3465;58
2020-04-22;ZA;South Africa;170;7;3635;65
2020-04-23;ZA;South Africa;318;10;3953;75
2020-04-24;ZA;South Africa;267;4;4220;79
2020-04-25;ZA;South Africa;141;7;4361;86
2020-04-26;ZA;South Africa;185;1;4546;87
2020-04-27;ZA;South Africa;247;3;4793;90
2020-04-28;ZA;South Africa;203;3;4996;93
2020-04-29;ZA;South Africa;354;10;5350;103
2020-04-30;ZA;South Africa;297;0;5647;103
2020-05-01;ZA;South Africa;304;13;5951;116
2020-05-02;ZA;South Africa;385;7;6336;123
2020-05-03;ZA;South Africa;447;8;6783;131
2020-05-04;ZA;South Africa;437;7;7220;138
2020-05-05;ZA;South Africa;352;10;7572;148
2020-05-06;ZA;South Africa;236;5;7808;153
2020-05-07;ZA;South Africa;424;8;8232;161
2020-05-08;ZA;South Africa;663;17;8895;178
2020-05-09;ZA;South Africa;525;8;9420;186
2020-05-10;ZA;South Africa;595;8;10015;194
2020-05-11;ZA;South Africa;637;12;10652;206
2020-05-12;ZA;South Africa;698;0;11350;206
2020-05-13;ZA;South Africa;724;13;12074;219
2020-05-14;ZA;South Africa;665;19;12739;238
2020-05-15;ZA;South Africa;785;9;13524;247
2020-05-16;ZA;South Africa;831;14;14355;261
2020-05-17;ZA;South Africa;1160;3;15515;264
2020-05-18;ZA;South Africa;918;22;16433;286
2020-05-19;ZA;South Africa;767;26;17200;312
2020-05-20;ZA;South Africa;803;27;18003;339
2020-05-21;ZA;South Africa;1134;30;19137;369
2020-05-22;ZA;South Africa;988;28;20125;397
2020-05-23;ZA;South Africa;1218;10;21343;407
2020-05-24;ZA;South Africa;1240;22;22583;429
2020-05-25;ZA;South Africa;1032;52;23615;481
2020-05-26;ZA;South Africa;649;43;24264;524
2020-05-27;ZA;South Africa;1673;28;25937;552
2020-05-28;ZA;South Africa;1466;25;27403;577
2020-05-29;ZA;South Africa;1837;34;29240;611
2020-05-30;ZA;South Africa;1727;32;30967;643
2020-05-31;ZA;South Africa;1716;40;32683;683
2020-06-01;ZA;South Africa;1674;22;34357;705
2020-06-02;ZA;South Africa;1455;50;35812;755
2020-06-03;ZA;South Africa;1713;37;37525;792
2020-06-04;ZA;South Africa;3267;56;40792;848
2020-06-05;ZA;South Africa;2642;60;43434;908
2020-06-06;ZA;South Africa;2539;44;45973;952
2020-06-07;ZA;South Africa;2312;46;48285;998
2020-06-08;ZA;South Africa;2594;82;50879;1080
2020-06-09;ZA;South Africa;2112;82;52991;1162
2020-06-10;ZA;South Africa;2430;48;55421;1210
2020-06-11;ZA;South Africa;3147;74;58568;1284
2020-06-12;ZA;South Africa;3359;70;61927;1354
2020-06-13;ZA;South Africa;3809;69;65736;1423
2020-06-14;ZA;South Africa;4302;57;70038;1480
2020-06-15;ZA;South Africa;3495;88;73533;1568
2020-06-16;ZA;South Africa;2801;57;76334;1625
2020-06-17;ZA;South Africa;4078;49;80412;1674
2020-06-18;ZA;South Africa;3478;63;83890;1737
2020-06-19;ZA;South Africa;3825;94;87715;1831
2020-06-20;ZA;South Africa;4966;46;92681;1877
2020-06-21;ZA;South Africa;4621;53;97302;1930
2020-06-22;ZA;South Africa;4288;61;101590;1991
2020-06-23;ZA;South Africa;4518;111;106108;2102
2020-06-24;ZA;South Africa;5688;103;111796;2205
2020-06-25;ZA;South Africa;6579;87;118375;2292
2020-06-26;ZA;South Africa;6215;48;124590;2340
2020-06-27;ZA;South Africa;7210;73;131800;2413
2020-06-28;ZA;South Africa;6334;43;138134;2456
2020-06-29;ZA;South Africa;6130;73;144264;2529
2020-06-30;ZA;South Africa;6945;128;151209;2657
2020-07-01;ZA;South Africa;8124;92;159333;2749
2020-07-02;ZA;South Africa;8728;95;168061;2844
2020-07-03;ZA;South Africa;9063;108;177124;2952
2020-07-04;ZA;South Africa;10853;74;187977;3026
2020-07-05;ZA;South Africa;8773;173;196750;3199
2020-07-06;ZA;South Africa;8971;111;205721;3310
2020-07-07;ZA;South Africa;10134;192;215855;3502
2020-07-08;ZA;South Africa;8810;100;224665;3602
2020-07-09;ZA;South Africa;13674;118;238339;3720
2020-07-10;ZA;South Africa;12348;140;250687;3860
2020-07-11;ZA;South Africa;13497;111;264184;3971
2020-07-12;ZA;South Africa;12058;108;276242;4079
2020-07-13;ZA;South Africa;11554;93;287796;4172
2020-07-14;ZA;South Africa;10496;174;298292;4346
2020-07-15;ZA;South Africa;12757;107;311049;4453
2020-07-16;ZA;South Africa;13172;216;324221;4669
2020-07-17;ZA;South Africa;13373;135;337594;4804
2020-07-18;ZA;South Africa;13285;144;350879;4948
2020-07-19;ZA;South Africa;13449;85;364328;5033
2020-07-20;ZA;South Africa;9300;140;373628;5173
2020-07-21;ZA;South Africa;8170;195;381798;5368
2020-07-22;ZA;South Africa;13150;572;394948;5940
2020-07-23;ZA;South Africa;13104;153;408052;6093
2020-07-24;ZA;South Africa;13944;250;421996;6343
2020-07-25;ZA;South Africa;12204;312;434200;6655
2020-07-26;ZA;South Africa;11233;114;445433;6769
2020-07-27;ZA;South Africa;7096;298;452529;7067
2020-07-28;ZA;South Africa;7232;190;459761;7257
2020-07-29;ZA;South Africa;11362;240;471123;7497
2020-07-30;ZA;South Africa;11046;315;482169;7812
2020-07-31;ZA;South Africa;11014;193;493183;8005
2020-08-01;ZA;South Africa;10107;148;503290;8153
2020-08-02;ZA;South Africa;8195;213;511485;8366
2020-08-03;ZA;South Africa;5377;173;516862;8539
2020-08-04;ZA;South Africa;4456;345;521318;8884
2020-08-05;ZA;South Africa;8559;414;529877;9298
2020-08-06;ZA;South Africa;8307;306;538184;9604
2020-08-07;ZA;South Africa;7292;305;545476;9909
2020-08-08;ZA;South Africa;7712;301;553188;10210
2020-08-09;ZA;South Africa;6671;198;559859;10408
2020-08-10;ZA;South Africa;3739;213;563598;10621
2020-08-11;ZA;South Africa;2511;130;566109;10751
2020-08-12;ZA;South Africa;2810;259;568919;11010
2020-08-13;ZA;South Africa;3946;260;572865;11270
2020-08-14;ZA;South Africa;6275;286;579140;11556
2020-08-15;ZA;South Africa;4513;121;583653;11677
2020-08-16;ZA;South Africa;3692;162;587345;11839
2020-08-17;ZA;South Africa;2541;143;589886;11982
2020-08-18;ZA;South Africa;2258;282;592144;12264
2020-08-19;ZA;South Africa;3916;159;596060;12423
2020-08-20;ZA;South Africa;3880;195;599940;12618
2020-08-21;ZA;South Africa;3398;225;603338;12843
2020-08-22;ZA;South Africa;3707;144;607045;12987
2020-08-23;ZA;South Africa;2728;72;609773;13059
2020-08-24;ZA;South Africa;1677;100;611450;13159
2020-08-25;ZA;South Africa;1567;149;613017;13308
2020-08-26;ZA;South Africa;2684;194;615701;13502
2020-08-27;ZA;South Africa;2585;126;618286;13628
2020-08-28;ZA;South Africa;1846;115;620132;13743
2020-08-29;ZA;South Africa;2419;238;622551;13981
2020-08-30;ZA;South Africa;2505;47;625056;14028
2020-08-31;ZA;South Africa;1985;121;627041;14149
2020-09-01;ZA;South Africa;1218;114;628259;14263
2020-09-02;ZA;South Africa;2336;126;630595;14389
2020-09-03;ZA;South Africa;2420;174;633015;14563
2020-09-04;ZA;South Africa;2063;115;635078;14678
2020-09-05;ZA;South Africa;1806;101;636884;14779
2020-09-06;ZA;South Africa;1633;110;638517;14889
2020-09-07;ZA;South Africa;845;115;639362;15004
2020-09-08;ZA;South Africa;1079;82;640441;15086
2020-09-09;ZA;South Africa;1990;82;642431;15168
2020-09-10;ZA;South Africa;2007;97;644438;15265
2020-09-11;ZA;South Africa;1960;113;646398;15378
2020-09-12;ZA;South Africa;1816;49;648214;15427
2020-09-13;ZA;South Africa;1579;20;649793;15447
2020-09-14;ZA;South Africa;956;52;650749;15499
2020-09-15;ZA;South Africa;772;142;651521;15641
2020-09-16;ZA;South Africa;1923;64;653444;15705
2020-09-17;ZA;South Africa;2128;67;655572;15772
2020-09-18;ZA;South Africa;2055;85;657627;15857
2020-09-19;ZA;South Africa;2029;83;659656;15940
2020-09-20;ZA;South Africa;1555;13;661211;15953
2020-09-21;ZA;South Africa;725;39;661936;15992
2020-09-22;ZA;South Africa;1346;126;663282;16118
2020-09-23;ZA;South Africa;1906;88;665188;16206
2020-09-24;ZA;South Africa;1861;77;667049;16283
2020-09-25;ZA;South Africa;1480;29;668529;16312
2020-09-26;ZA;South Africa;969;64;669498;16376
2020-09-27;ZA;South Africa;1268;22;670766;16398
2020-09-28;ZA;South Africa;903;188;671669;16586
2020-09-29;ZA;South Africa;903;81;672572;16667
2020-09-30;ZA;South Africa;1767;67;674339;16734
2020-10-01;ZA;South Africa;1745;132;676084;16866
2020-10-02;ZA;South Africa;1749;43;677833;16909
2020-10-03;ZA;South Africa;1883;29;679716;16938
2020-10-04;ZA;South Africa;1573;38;681289;16976
2020-10-05;ZA;South Africa;926;40;682215;17016
2020-10-06;ZA;South Africa;1027;87;683242;17103
2020-10-07;ZA;South Africa;1913;145;685155;17248
2020-10-08;ZA;South Africa;1736;160;686891;17408
2020-10-09;ZA;South Africa;1461;139;688352;17547
2020-10-10;ZA;South Africa;2544;126;690896;17673
2020-10-11;ZA;South Africa;1575;107;692471;17780
2020-10-12;ZA;South Africa;888;83;693359;17863
2020-10-13;ZA;South Africa;1178;165;694537;18028
2020-10-14;ZA;South Africa;1877;123;696414;18151
2020-10-15;ZA;South Africa;1770;158;698184;18309
2020-10-16;ZA;South Africa;2019;61;700203;18370
2020-10-17;ZA;South Africa;1928;38;702131;18408
2020-10-18;ZA;South Africa;1662;63;703793;18471
2020-10-19;ZA;South Africa;1461;21;705254;18492
2020-10-20;ZA;South Africa;1050;164;706304;18656
2020-10-21;ZA;South Africa;2055;85;708359;18741
2020-10-22;ZA;South Africa;2156;102;710515;18843
2020-10-23;ZA;South Africa;1897;48;712412;18891
2020-10-24;ZA;South Africa;1834;53;714246;18944
2020-10-25;ZA;South Africa;1622;24;715868;18968
2020-10-26;ZA;South Africa;891;40;716759;19008
2020-10-27;ZA;South Africa;1092;45;717851;19053
2020-10-28;ZA;South Africa;1863;58;719714;19111
2020-10-29;ZA;South Africa;2056;53;721770;19164
2020-10-30;ZA;South Africa;1912;66;723682;19230
2020-10-31;ZA;South Africa;1770;46;725452;19276
2020-11-01;ZA;South Africa;1371;135;726823;19411
2020-11-02;ZA;South Africa;772;54;727595;19465
2020-11-03;ZA;South Africa;1241;74;728836;19539
2020-11-04;ZA;South Africa;1712;46;730548;19585
2020-11-05;ZA;South Africa;1866;92;732414;19677
2020-11-06;ZA;South Africa;1761;72;734175;19749
2020-11-07;ZA;South Africa;1731;40;735906;19789
2020-11-08;ZA;South Africa;1372;20;737278;19809
2020-11-09;ZA;South Africa;1247;36;738525;19845
2020-11-10;ZA;South Africa;1729;106;740254;19951
2020-11-11;ZA;South Africa;2140;60;742394;20011
2020-11-12;ZA;South Africa;2338;65;744732;20076
2020-11-13;ZA;South Africa;2213;77;746945;20153
2020-11-14;ZA;South Africa;2237;53;749182;20206
2020-11-15;ZA;South Africa;1842;35;751024;20241
2020-11-16;ZA;South Africa;1245;73;752269;20314
2020-11-17;ZA;South Africa;1987;118;754256;20432
2020-11-18;ZA;South Africa;2888;124;757144;20556
2020-11-19;ZA;South Africa;2514;115;759658;20671
2020-11-20;ZA;South Africa;3105;88;762763;20759
2020-11-21;ZA;South Africa;2646;86;765409;20845
2020-11-22;ZA;South Africa;2270;58;767679;20903
2020-11-23;ZA;South Africa;2080;65;769759;20968
2020-11-24;ZA;South Africa;2493;115;772252;21083
2020-11-25;ZA;South Africa;3250;118;775502;21201
2020-11-26;ZA;South Africa;3069;88;778571;21289
2020-11-27;ZA;South Africa;3370;89;781941;21378
2020-11-28;ZA;South Africa;3198;61;785139;21439
2020-11-29;ZA;South Africa;2563;38;787702;21477
2020-11-30;ZA;South Africa;2302;58;790004;21535
2020-12-01;ZA;South Africa;2295;109;792299;21644
2020-12-02;ZA;South Africa;4173;65;796472;21709
2020-12-03;ZA;South Africa;4400;94;800872;21803
2020-12-04;ZA;South Africa;4932;160;805804;21963
2020-12-05;ZA;South Africa;4645;104;810449;22067
2020-12-06;ZA;South Africa;4116;139;814565;22206
2020-12-07;ZA;South Africa;3313;43;817878;22249
2020-12-08;ZA;South Africa;4011;183;821889;22432
2020-12-09;ZA;South Africa;6709;142;828598;22574
2020-12-10;ZA;South Africa;8166;173;836764;22747
2020-12-11;ZA;South Africa;8319;205;845083;22952
2020-12-12;ZA;South Africa;7882;154;852965;23106
2020-12-13;ZA;South Africa;7999;170;860964;23276
2020-12-14;ZA;South Africa;5163;175;866127;23451
2020-12-15;ZA;South Africa;7552;210;873679;23661
2020-12-16;ZA;South Africa;10008;166;883687;23827
2020-12-17;ZA;South Africa;9126;184;892813;24011
2020-12-18;ZA;South Africa;8725;274;901538;24285
2020-12-19;ZA;South Africa;10939;254;912477;24539
2020-12-20;ZA;South Africa;9445;152;921922;24691
2020-12-21;ZA;South Africa;8789;216;930711;24907
2020-12-22;ZA;South Africa;9501;339;940212;25246
2020-12-23;ZA;South Africa;14046;411;954258;25657
2020-12-24;ZA;South Africa;14305;326;968563;25983
2020-12-25;ZA;South Africa;14796;293;983359;26276
2020-12-26;ZA;South Africa;11552;245;994911;26521
2020-12-27;ZA;South Africa;9502;214;1004413;26735
2020-12-28;ZA;South Africa;7458;336;1011871;27071
2020-12-29;ZA;South Africa;9580;497;1021451;27568
2020-12-30;ZA;South Africa;17710;465;1039161;28033
2020-12-31;ZA;South Africa;18000;436;1057161;28469
2021-01-01;ZA;South Africa;16726;418;1073887;28887
2021-01-02;ZA;South Africa;15002;288;1088889;29175
2021-01-03;ZA;South Africa;11859;402;1100748;29577
2021-01-04;ZA;South Africa;12601;434;1113349;30011
2021-01-05;ZA;South Africa;14410;513;1127759;30524
2021-01-06;ZA;South Africa;21832;844;1149591;31368
2021-01-07;ZA;South Africa;20999;441;1170590;31809
2021-01-08;ZA;South Africa;21980;616;1192570;32425
2021-01-09;ZA;South Africa;21606;399;1214176;32824
2021-01-10;ZA;South Africa;17421;339;1231597;33163
2021-01-11;ZA;South Africa;15046;416;1246643;33579
2021-01-12;ZA;South Africa;13105;755;1259748;34334
2021-01-13;ZA;South Africa;18555;806;1278303;35140
2021-01-14;ZA;South Africa;18503;712;1296806;35852
2021-01-15;ZA;South Africa;14880;615;1311686;36467
2021-01-16;ZA;South Africa;13973;384;1325659;36851
2021-01-17;ZA;South Africa;12267;254;1337926;37105
2021-01-18;ZA;South Africa;9010;344;1346936;37449
2021-01-19;ZA;South Africa;9780;839;1356716;38288
2021-01-20;ZA;South Africa;12710;566;1369426;38854
2021-01-21;ZA;South Africa;11381;647;1380807;39501
2021-01-22;ZA;South Africa;11761;575;1392568;40076
2021-01-23;ZA;South Africa;12271;498;1404839;40574
2021-01-24;ZA;South Africa;8147;300;1412986;40874
2021-01-25;ZA;South Africa;4551;243;1417537;41117
2021-01-26;ZA;South Africa;6041;680;1423578;41797
2021-01-27;ZA;South Africa;7070;753;1430648;42550
2021-01-28;ZA;South Africa;7150;555;1437798;43105
2021-01-29;ZA;South Africa;6141;528;1443939;43633
2021-01-30;ZA;South Africa;5297;318;1449236;43951
2021-01-31;ZA;South Africa;4525;213;1453761;44164
2021-02-01;ZA;South Africa;2548;235;1456309;44399
2021-02-02;ZA;South Africa;2649;547;1458958;44946
2021-02-03;ZA;South Africa;4058;398;1463016;45344
2021-02-04;ZA;South Africa;3751;261;1466767;45605
2021-02-05;ZA;South Africa;3749;297;1470516;45902
2021-02-06;ZA;South Africa;3184;278;1473700;46180
2021-02-07;ZA;South Africa;2435;110;1476135;46290
2021-02-08;ZA;South Africa;1376;183;1477511;46473
2021-02-09;ZA;South Africa;1742;396;1479253;46869
2021-02-10;ZA;South Africa;3159;276;1482412;47145
2021-02-11;ZA;South Africa;2488;237;1484900;47382
2021-02-12;ZA;South Africa;2781;288;1487681;47670
2021-02-13;ZA;South Africa;2382;151;1490063;47821
2021-02-14;ZA;South Africa;1744;78;1491807;47899
2021-02-15;ZA;South Africa;1102;195;1492909;48094
2021-02-16;ZA;South Africa;1210;219;1494119;48313
2021-02-17;ZA;South Africa;2320;165;1496439;48478
2021-02-18;ZA;South Africa;2327;230;1498766;48708
2021-02-19;ZA;South Africa;1911;151;1500677;48859
2021-02-20;ZA;South Africa;1690;81;1502367;48940
2021-02-21;ZA;South Africa;1429;113;1503796;49053
2021-02-22;ZA;South Africa;792;97;1504588;49150
2021-02-23;ZA;South Africa;998;263;1505586;49413
2021-02-24;ZA;South Africa;1862;110;1507448;49523
2021-02-25;ZA;South Africa;1676;144;1509124;49667
2021-02-26;ZA;South Africa;1654;117;1510778;49784
2021-02-27;ZA;South Africa;1447;157;1512225;49941
2021-02-28;ZA;South Africa;1168;52;1513393;49993
2021-03-01;ZA;South Africa;566;84;1513959;50077
2021-03-02;ZA;South Africa;856;194;1514815;50271
2021-03-03;ZA;South Africa;1447;95;1516262;50366
2021-03-04;ZA;South Africa;1404;96;1517666;50462
2021-03-05;ZA;South Africa;1313;104;1518979;50566
2021-03-06;ZA;South Africa;1227;81;1520206;50647
2021-03-07;ZA;South Africa;862;31;1521068;50678
2021-03-08;ZA;South Africa;638;125;1521706;50803
2021-03-09;ZA;South Africa;991;103;1522697;50906
2021-03-10;ZA;South Africa;1477;109;1524174;51015
2021-03-11;ZA;South Africa;1474;95;1525648;51110
2021-03-12;ZA;South Africa;1225;69;1526873;51179
2021-03-13;ZA;South Africa;1541;82;1528414;51261
2021-03-14;ZA;South Africa;1006;65;1529420;51326
2021-03-15;ZA;South Africa;613;95;1530033;51421
2021-03-16;ZA;South Africa;933;139;1530966;51560
2021-03-17;ZA;South Africa;1531;74;1532497;51634
2021-03-18;ZA;South Africa;1464;90;1533961;51724
2021-03-19;ZA;South Africa;1462;311;1535423;52035
2021-03-20;ZA;South Africa;1378;47;1536801;52082
2021-03-21;ZA;South Africa;1051;29;1537852;52111
2021-03-22;ZA;South Africa;599;85;1538451;52196
2021-03-23;ZA;South Africa;510;55;1538961;52251
2021-03-24;ZA;South Africa;1048;121;1540009;52372
2021-03-25;ZA;South Africa;1554;163;1541563;52535
2021-03-26;ZA;South Africa;1516;67;1543079;52602
2021-03-27;ZA;South Africa;1387;46;1544466;52648
2021-03-28;ZA;South Africa;965;15;1545431;52663
2021-03-29;ZA;South Africa;548;47;1545979;52710
2021-03-30;ZA;South Africa;756;78;1546735;52788
2021-03-31;ZA;South Africa;1422;58;1548157;52846
2021-04-01;ZA;South Africa;1294;51;1549451;52897
2021-04-02;ZA;South Africa;1273;49;1550724;52946
2021-04-03;ZA;South Africa;777;8;1551501;52954
2021-04-04;ZA;South Africa;463;33;1551964;52987
2021-04-05;ZA;South Africa;452;8;1552416;52995
2021-04-06;ZA;South Africa;437;37;1552853;53032
2021-04-07;ZA;South Africa;756;79;1553609;53111
2021-04-08;ZA;South Africa;1366;62;1554975;53173
2021-04-09;ZA;South Africa;1267;53;1556242;53226
2021-04-10;ZA;South Africa;1285;30;1557527;53256
2021-04-11;ZA;South Africa;931;66;1558458;53322
2021-04-12;ZA;South Africa;655;34;1559113;53356
2021-04-13;ZA;South Africa;847;67;1559960;53423
2021-04-14;ZA;South Africa;1599;75;1561559;53498
2021-04-15;ZA;South Africa;1372;73;1562931;53571
2021-04-16;ZA;South Africa;1424;92;1564355;53663
2021-04-17;ZA;South Africa;1325;48;1565680;53711
2021-04-18;ZA;South Africa;1089;25;1566769;53736
2021-04-19;ZA;South Africa;744;21;1567513;53757
2021-04-20;ZA;South Africa;853;130;1568366;53887
2021-04-21;ZA;South Africa;1569;53;1569935;53940
2021-04-22;ZA;South Africa;1413;55;1571348;53995
2021-04-23;ZA;South Africa;1637;71;1572985;54066
2021-04-24;ZA;South Africa;1385;59;1574370;54125
2021-04-25;ZA;South Africa;1101;23;1575471;54148
2021-04-26;ZA;South Africa;849;38;1576320;54186
2021-04-27;ZA;South Africa;880;51;1577200;54237
2021-04-28;ZA;South Africa;1250;48;1578450;54285
2021-04-29;ZA;South Africa;1086;46;1579536;54331
2021-04-30;ZA;South Africa;1674;19;1581210;54350
2021-05-01;ZA;South Africa;1632;56;1582842;54406
2021-05-02;ZA;South Africa;1222;11;1584064;54417
2021-05-03;ZA;South Africa;897;35;1584961;54452
2021-05-04;ZA;South Africa;1187;59;1586148;54511
2021-05-05;ZA;South Africa;2073;46;1588221;54557
2021-05-06;ZA;South Africa;2149;63;1590370;54620
2021-05-07;ZA;South Africa;2256;67;1592626;54687
2021-05-08;ZA;South Africa;0;0;1592626;54687
2021-05-09;ZA;South Africa;3969;48;1596595;54735
2021-05-10;ZA;South Africa;1129;90;1597724;54825
2021-05-11;ZA;South Africa;1548;71;1599272;54896
2021-05-12;ZA;South Africa;2759;72;1602031;54968
2021-05-13;ZA;South Africa;3221;44;1605252;55012
2021-05-14;ZA;South Africa;3141;112;1608393;55124
2021-05-15;ZA;South Africa;2750;59;1611143;55183
2021-05-16;ZA;South Africa;2585;27;1613728;55210
2021-05-17;ZA;South Africa;1757;50;1615485;55260
2021-05-18;ZA;South Africa;2355;80;1617840;55340
2021-05-19;ZA;South Africa;3522;167;1621362;55507
2021-05-20;ZA;South Africa;3641;61;1625003;55568
2021-05-21;ZA;South Africa;3332;151;1628335;55719
2021-05-22;ZA;South Africa;4236;53;1632571;55772
2021-05-23;ZA;South Africa;2894;30;1635465;55802
2021-05-24;ZA;South Africa;2383;72;1637848;55874
2021-05-25;ZA;South Africa;0;102;1637848;55976
2021-05-26;ZA;South Africa;7707;101;1645555;56077
2021-05-27;ZA;South Africa;4422;93;1649977;56170
2021-05-28;ZA;South Africa;4574;123;1654551;56293
2021-05-29;ZA;South Africa;4519;70;1659070;56363
2021-05-30;ZA;South Africa;0;0;1659070;56363
2021-05-31;ZA;South Africa;6547;143;1665617;56506
2021-06-01;ZA;South Africa;3614;95;1669231;56601
2021-06-02;ZA;South Africa;5782;110;1675013;56711
2021-06-03;ZA;South Africa;5360;54;1680373;56765
2021-06-04;ZA;South Africa;5668;67;1686041;56832
2021-06-05;ZA;South Africa;5450;97;1691491;56929
2021-06-06;ZA;South Africa;5073;45;1696564;56974
2021-06-07;ZA;South Africa;3285;89;1699849;57063
2021-06-08;ZA;South Africa;4209;120;1704058;57183
2021-06-09;ZA;South Africa;8881;127;1712939;57310
2021-06-10;ZA;South Africa;9147;100;1722086;57410
2021-06-11;ZA;South Africa;8020;182;1730106;57592
2021-06-12;ZA;South Africa;9319;114;1739425;57706
2021-06-13;ZA;South Africa;7657;59;1747082;57765
2021-06-14;ZA;South Africa;5548;114;1752630;57879
2021-06-15;ZA;South Africa;8436;208;1761066;58087
2021-06-16;ZA;South Africa;13246;136;1774312;58223
2021-06-17;ZA;South Africa;11767;100;1786079;58323
2021-06-18;ZA;South Africa;10510;118;1796589;58441
2021-06-19;ZA;South Africa;13575;149;1810164;58590
2021-06-20;ZA;South Africa;13155;112;1823319;58702
2021-06-21;ZA;South Africa;9160;93;1832479;58795
2021-06-22;ZA;South Africa;11093;297;1843572;59092
2021-06-23;ZA;South Africa;17493;166;1861065;59258
2021-06-24;ZA;South Africa;16078;148;1877143;59406
2021-06-25;ZA;South Africa;18762;215;1895905;59621
2021-06-26;ZA;South Africa;17956;157;1913861;59778
2021-06-27;ZA;South Africa;15036;122;1928897;59900
2021-06-28;ZA;South Africa;12222;138;1941119;60038
2021-06-29;ZA;South Africa;13347;226;1954466;60264
2021-06-30;ZA;South Africa;19506;383;1973972;60647
2021-07-01;ZA;South Africa;21584;382;1995556;61029
2020-02-22;;South America;0;0;0;0
2020-02-23;;South America;2;0;2;0
2020-02-24;;South America;0;0;2;0
2020-02-25;;South America;0;0;2;0
2020-02-26;;South America;1;0;3;0
2020-02-27;;South America;0;0;3;0
2020-02-28;;South America;0;0;3;0
2020-02-29;;South America;1;0;4;0
2020-03-01;;South America;13;0;17;0
2020-03-02;;South America;0;0;17;0
2020-03-03;;South America;3;0;20;0
2020-03-04;;South America;5;0;25;0
2020-03-05;;South America;6;0;31;0
2020-03-06;;South America;12;1;43;1
2020-03-07;;South America;6;0;49;1
2020-03-08;;South America;25;2;74;3
2020-03-09;;South America;7;0;81;3
2020-03-10;;South America;22;0;103;3
2020-03-11;;South America;33;0;136;3
2020-03-12;;South America;19;2;155;5
2020-03-13;;South America;154;1;309;6
2020-03-14;;South America;78;2;387;8
2020-03-15;;South America;65;2;452;10
2020-03-16;;South America;236;0;688;10
2020-03-17;;South America;290;5;978;15
2020-03-18;;South America;242;8;1220;23
2020-03-19;;South America;471;10;1691;33
2020-03-20;;South America;641;13;2332;46
2020-03-21;;South America;712;12;3044;58
2020-03-22;;South America;1136;24;4180;82
2020-03-23;;South America;812;20;4992;102
2020-03-24;;South America;836;30;5828;132
2020-03-25;;South America;823;31;6651;163
2020-03-26;;South America;1113;34;7764;197
2020-03-27;;South America;1183;31;8947;228
2020-03-28;;South America;1332;54;10279;282
2020-03-29;;South America;1029;51;11308;333
2020-03-30;;South America;988;54;12296;387
2020-03-31;;South America;2196;97;14492;484
2020-04-01;;South America;2377;88;16869;572
2020-04-02;;South America;2300;152;19169;724
2020-04-03;;South America;2021;103;21190;827
2020-04-04;;South America;2416;180;23606;1007
2020-04-05;;South America;1912;120;25518;1127
2020-04-06;;South America;2010;153;27528;1280
2020-04-07;;South America;2866;208;30394;1488
2020-04-08;;South America;5076;252;35470;1740
2020-04-09;;South America;4106;295;39576;2035
2020-04-10;;South America;5372;244;44948;2279
2020-04-11;;South America;3073;218;48021;2497
2020-04-12;;South America;2876;237;50897;2734
2020-04-13;;South America;4074;249;54971;2983
2020-04-14;;South America;3060;359;58031;3342
2020-04-15;;South America;5195;379;63226;3721
2020-04-16;;South America;4351;365;67577;4086
2020-04-17;;South America;5292;422;72869;4508
2020-04-18;;South America;5720;415;78589;4923
2020-04-19;;South America;4333;310;82922;5233
2020-04-20;;South America;4205;383;87127;5616
2020-04-21;;South America;4777;406;91904;6022
2020-04-22;;South America;5353;433;97257;6455
2020-04-23;;South America;7416;730;104673;7185
2020-04-24;;South America;17393;663;122066;7848
2020-04-25;;South America;10863;669;132929;8517
2020-04-26;;South America;6881;551;139810;9068
2020-04-27;;South America;6942;735;146752;9803
2020-04-28;;South America;10381;1038;157133;10841
2020-04-29;;South America;10612;815;167745;11656
2020-04-30;;South America;12490;885;180235;12541
2020-05-01;;South America;11624;1001;191859;13542
2020-05-02;;South America;11347;1105;203206;14647
2020-05-03;;South America;12072;941;215278;15588
2020-05-04;;South America;12088;807;227366;16395
2020-05-05;;South America;12953;1034;240319;17429
2020-05-06;;South America;16464;1195;256783;18624
2020-05-07;;South America;13711;1153;270494;19777
2020-05-08;;South America;15492;1377;285986;21154
2020-05-09;;South America;16974;1171;302960;22325
2020-05-10;;South America;12061;1431;315021;23756
2020-05-11;;South America;10654;1108;325675;24864
2020-05-12;;South America;15526;1543;341201;26407
2020-05-13;;South America;20060;1304;361261;27711
2020-05-14;;South America;21211;1352;382472;29063
2020-05-15;;South America;25660;1828;408132;30891
2020-05-16;;South America;25411;1354;433543;32245
2020-05-17;;South America;15279;1062;448822;33307
2020-05-18;;South America;20915;1392;469737;34699
2020-05-19;;South America;26626;1863;496363;36562
2020-05-20;;South America;30723;1525;527086;38087
2020-05-21;;South America;29298;1879;556384;39966
2020-05-22;;South America;30509;1748;586893;41714
2020-05-23;;South America;33011;1613;619904;43327
2020-05-24;;South America;26430;1292;646334;44619
2020-05-25;;South America;23035;1567;669369;46186
2020-05-26;;South America;28208;1721;697577;47907
2020-05-27;;South America;34323;1786;731900;49693
2020-05-28;;South America;40078;1867;771978;51560
2020-05-29;;South America;39679;1937;811657;53497
2020-05-30;;South America;57197;1567;868854;55064
2020-05-31;;South America;32830;1223;901684;56287
2020-06-01;;South America;25038;1331;926722;57618
2020-06-02;;South America;44796;2164;971518;59782
2020-06-03;;South America;38205;2098;1009723;61880
2020-06-04;;South America;43338;2185;1053061;64065
2020-06-05;;South America;42755;1854;1095816;65919
2020-06-06;;South America;49777;1761;1145593;67680
2020-06-07;;South America;32862;1324;1178455;69004
2020-06-08;;South America;26516;1984;1204971;70988
2020-06-09;;South America;43991;2053;1248962;73041
2020-06-10;;South America;47816;2195;1296778;75236
2020-06-11;;South America;45943;2133;1342721;77369
2020-06-12;;South America;37984;1943;1380705;79312
2020-06-13;;South America;40798;1834;1421503;81146
2020-06-14;;South America;37637;1600;1459140;82746
2020-06-15;;South America;33675;1397;1492815;84143
2020-06-16;;South America;48883;2101;1541698;86244
2020-06-17;;South America;42963;2267;1584661;88511
2020-06-18;;South America;37418;2287;1622079;90798
2020-06-19;;South America;71461;2193;1693540;92991
2020-06-20;;South America;48701;1959;1742241;94950
2020-06-21;;South America;31526;1795;1773767;96745
2020-06-22;;South America;36206;1211;1809973;97956
2020-06-23;;South America;53336;2121;1863309;100077
2020-06-24;;South America;57883;2119;1921192;102196
2020-06-25;;South America;56930;2137;1978122;104333
2020-06-26;;South America;63653;1947;2041775;106280
2020-06-27;;South America;55925;2120;2097700;108400
2020-06-28;;South America;45398;1563;2143098;109963
2020-06-29;;South America;37951;1574;2181049;111537
2020-06-30;;South America;47374;2054;2228423;113591
2020-07-01;;South America;62588;1968;2291011;115559
2020-07-02;;South America;63759;2297;2354770;117856
2020-07-03;;South America;58420;2269;2413190;120125
2020-07-04;;South America;54039;2148;2467229;122273
2020-07-05;;South America;41675;1455;2508904;123728
2020-07-06;;South America;33971;1578;2542875;125306
2020-07-07;;South America;60799;2182;2603674;127488
2020-07-08;;South America;59862;2171;2663536;129659
2020-07-09;;South America;60874;2199;2724410;131858
2020-07-10;;South America;64296;2204;2788706;134062
2020-07-11;;South America;57449;2125;2846155;136187
2020-07-12;;South America;40999;1603;2887154;137790
2020-07-13;;South America;35600;1652;2922754;139442
2020-07-14;;South America;59865;2277;2982619;141719
2020-07-15;;South America;57732;2289;3040351;144008
2020-07-16;;South America;67035;2415;3107386;146423
2020-07-17;;South America;57853;3217;3165239;149640
2020-07-18;;South America;50195;2557;3215434;152197
2020-07-19;;South America;43134;1899;3258568;154096
2020-07-20;;South America;39740;1161;3298308;155257
2020-07-21;;South America;63003;2305;3361311;157562
2020-07-22;;South America;90682;2345;3451993;159907
2020-07-23;;South America;83589;2587;3535582;162494
2020-07-24;;South America;78925;2346;3614507;164840
2020-07-25;;South America;69177;2383;3683684;167223
2020-07-26;;South America;41691;1624;3725375;168847
2020-07-27;;South America;55109;1773;3780484;170620
2020-07-28;;South America;67227;2173;3847711;172793
2020-07-29;;South America;93856;2869;3941567;175662
2020-07-30;;South America;80068;2448;4021635;178110
2020-07-31;;South America;80202;2425;4101837;180535
2020-08-01;;South America;67335;2203;4169172;182738
2020-08-02;;South America;68500;1756;4237672;184494
2020-08-03;;South America;40855;1882;4278527;186376
2020-08-04;;South America;77152;2460;4355679;188836
2020-08-05;;South America;88371;2691;4444050;191527
2020-08-06;;South America;86714;2519;4530764;194046
2020-08-07;;South America;81859;2335;4612623;196381
2020-08-08;;South America;71856;2114;4684479;198495
2020-08-09;;South America;57485;1745;4741964;200240
2020-08-10;;South America;49965;1912;4791929;202152
2020-08-11;;South America;84255;2599;4876184;204751
2020-08-12;;South America;81498;2261;4957682;207012
2020-08-13;;South America;94021;2745;5051703;209757
2020-08-14;;South America;92442;2376;5144145;212133
2020-08-15;;South America;65829;1970;5209974;214103
2020-08-16;;South America;55470;1696;5265444;215799
2020-08-17;;South America;46514;1775;5311958;217574
2020-08-18;;South America;78533;2579;5390491;220153
2020-08-19;;South America;83446;2573;5473937;222726
2020-08-20;;South America;79585;2346;5553522;225072
2020-08-21;;South America;61345;2339;5614867;227411
2020-08-22;;South America;82637;2123;5697504;229534
2020-08-23;;South America;50277;1673;5747781;231207
2020-08-24;;South America;50100;1935;5797881;233142
2020-08-25;;South America;76997;2450;5874878;235592
2020-08-26;;South America;80296;2342;5955174;237934
2020-08-27;;South America;75004;2161;6030178;240095
2020-08-28;;South America;77981;2037;6108159;242132
2020-08-29;;South America;73475;1818;6181634;243950
2020-08-30;;South America;45833;1526;6227467;245476
2020-08-31;;South America;74216;1577;6301683;247053
2020-09-01;;South America;71438;2440;6373121;249493
2020-09-02;;South America;77668;2245;6450789;251738
2020-09-03;;South America;69480;1965;6520269;253703
2020-09-04;;South America;87779;1969;6608048;255672
2020-09-05;;South America;62266;1638;6670314;257310
2020-09-06;;South America;40814;1265;6711128;258575
2020-09-07;;South America;27784;6734;6738912;265309
2020-09-08;;South America;40410;1460;6779322;266769
2020-09-09;;South America;66107;2047;6845429;268816
2020-09-10;;South America;72175;1972;6917604;270788
2020-09-11;;South America;76099;1895;6993703;272683
2020-09-12;;South America;64323;1588;7058026;274271
2020-09-13;;South America;43850;1145;7101876;275416
2020-09-14;;South America;41897;1332;7143773;276748
2020-09-15;;South America;64463;1893;7208236;278641
2020-09-16;;South America;66234;1829;7274470;280470
2020-09-17;;South America;67771;1798;7342241;282268
2020-09-18;;South America;70160;1458;7412401;283726
2020-09-19;;South America;62092;1672;7474493;285398
2020-09-20;;South America;41896;1168;7516389;286566
2020-09-21;;South America;37065;1316;7553454;287882
2020-09-22;;South America;56546;1672;7610000;289554
2020-09-23;;South America;33032;1149;7643032;290703
2020-09-24;;South America;97989;2541;7741021;293244
2020-09-25;;South America;70285;1887;7811306;295131
2020-09-26;;South America;52759;1776;7864065;296907
2020-09-27;;South America;40306;1078;7904371;297985
2020-09-28;;South America;39182;1125;7943553;299110
2020-09-29;;South America;59230;1778;8002783;300888
2020-09-30;;South America;61646;1912;8064429;302800
2020-10-01;;South America;64592;4653;8129021;307453
2020-10-02;;South America;29400;878;8158421;308331
2020-10-03;;South America;85444;2035;8243865;310366
2020-10-04;;South America;27402;1074;8271267;311440
2020-10-05;;South America;40344;1234;8311611;312674
2020-10-06;;South America;70408;1629;8382019;314303
2020-10-07;;South America;63196;1600;8445215;315903
2020-10-08;;South America;59363;1938;8504578;317841
2020-10-09;;South America;58133;1825;8562711;319666
2020-10-10;;South America;59668;1365;8622379;321031
2020-10-11;;South America;38097;988;8660476;322019
2020-10-12;;South America;30751;937;8691227;322956
2020-10-13;;South America;35443;1082;8726670;324038
2020-10-14;;South America;51799;1513;8778469;325551
2020-10-15;;South America;62073;1541;8840542;327092
2020-10-16;;South America;60347;1624;8900889;328716
2020-10-17;;South America;51153;1303;8952042;330019
2020-10-18;;South America;24696;545;8976738;330564
2020-10-19;;South America;51373;1294;9028111;331858
2020-10-20;;South America;53767;1454;9081878;333312
2020-10-21;;South America;58044;1440;9139922;334752
2020-10-22;;South America;59308;1401;9199230;336153
2020-10-23;;South America;59251;1355;9258481;337508
2020-10-24;;South America;55404;1122;9313885;338630
2020-10-25;;South America;41186;875;9355071;339505
2020-10-26;;South America;39813;1077;9394884;340582
2020-10-27;;South America;57120;1388;9452004;341970
2020-10-28;;South America;57403;1220;9509407;343190
2020-10-29;;South America;57324;1308;9566731;344498
2020-10-30;;South America;51811;1253;9618542;345751
2020-10-31;;South America;46243;1040;9664785;346791
2020-11-01;;South America;31791;703;9696576;347494
2020-11-02;;South America;30565;1006;9727141;348500
2020-11-03;;South America;32714;1022;9759855;349522
2020-11-04;;South America;56035;1396;9815890;350918
2020-11-05;;South America;27054;682;9842944;351600
2020-11-06;;South America;66587;1675;9909531;353275
2020-11-07;;South America;45519;888;9955050;354163
2020-11-08;;South America;29823;705;9984873;354868
2020-11-09;;South America;29186;944;10014059;355812
2020-11-10;;South America;45924;771;10059983;356583
2020-11-11;;South America;74428;1328;10134411;357911
2020-11-12;;South America;60059;1550;10194470;359461
2020-11-13;;South America;55975;1088;10250445;360549
2020-11-14;;South America;62151;1547;10312596;362096
2020-11-15;;South America;32500;658;10345096;362754
2020-11-16;;South America;32722;851;10377818;363605
2020-11-17;;South America;55811;1368;10433629;364973
2020-11-18;;South America;56349;1347;10489978;366320
2020-11-19;;South America;57455;1191;10547433;367511
2020-11-20;;South America;63259;1154;10610692;368665
2020-11-21;;South America;55035;850;10665727;369515
2020-11-22;;South America;34238;695;10699965;370210
2020-11-23;;South America;31410;783;10731375;370993
2020-11-24;;South America;49597;1334;10780972;372327
2020-11-25;;South America;70274;1277;10851246;373604
2020-11-26;;South America;59953;1319;10911199;374923
2020-11-27;;South America;60440;1194;10971639;376117
2020-11-28;;South America;75483;1045;11047122;377162
2020-11-29;;South America;44850;803;11091972;377965
2020-11-30;;South America;38304;926;11130276;378891
2020-12-01;;South America;71691;1261;11201967;380152
2020-12-02;;South America;70791;1307;11272758;381459
2020-12-03;;South America;75261;1360;11348019;382819
2020-12-04;;South America;67234;1293;11415253;384112
2020-12-05;;South America;65732;1176;11480985;385288
2020-12-06;;South America;44050;806;11525035;386094
2020-12-07;;South America;34394;850;11559429;386944
2020-12-08;;South America;65780;1294;11625209;388238
2020-12-09;;South America;72452;1340;11697661;389578
2020-12-10;;South America;75453;1400;11773114;390978
2020-12-11;;South America;74752;1174;11847866;392152
2020-12-12;;South America;63702;1163;11911568;393315
2020-12-13;;South America;38789;753;11950357;394068
2020-12-14;;South America;46533;1034;11996890;395102
2020-12-15;;South America;65129;1477;12062019;396579
2020-12-16;;South America;94006;1468;12156025;398047
2020-12-17;;South America;97694;1691;12253719;399738
2020-12-18;;South America;78625;1406;12332344;401144
2020-12-19;;South America;75655;1254;12407999;402398
2020-12-20;;South America;51422;877;12459421;403275
2020-12-21;;South America;47983;1110;12507404;404385
2020-12-22;;South America;80634;1649;12588038;406034
2020-12-23;;South America;76482;1460;12664520;407494
2020-12-24;;South America;80599;1298;12745119;408792
2020-12-25;;South America;58441;1050;12803560;409842
2020-12-26;;South America;37537;851;12841097;410693
2020-12-27;;South America;36568;936;12877665;411629
2020-12-28;;South America;44152;1019;12921817;412648
2020-12-29;;South America;88184;1760;13010001;414408
2020-12-30;;South America;87977;1833;13097978;416241
2020-12-31;;South America;96181;1800;13194159;418041
2021-01-01;;South America;47568;1073;13241727;419114
2021-01-02;;South America;39297;896;13281024;420010
2021-01-03;;South America;39702;874;13320726;420884
2021-01-04;;South America;45506;1145;13366232;422029
2021-01-05;;South America;94346;1877;13460578;423906
2021-01-06;;South America;103776;2053;13564354;425959
2021-01-07;;South America;128346;2352;13692700;428311
2021-01-08;;South America;97114;1813;13789814;430124
2021-01-09;;South America;98686;2024;13888500;432148
2021-01-10;;South America;61587;1210;13950087;433358
2021-01-11;;South America;66290;1384;14016377;434742
2021-01-12;;South America;102425;1985;14118802;436727
2021-01-13;;South America;101853;2117;14220655;438844
2021-01-14;;South America;109505;2126;14330160;440970
2021-01-15;;South America;129021;2078;14459181;443048
2021-01-16;;South America;103838;2003;14563019;445051
2021-01-17;;South America;70576;1502;14633595;446553
2021-01-18;;South America;53879;1720;14687474;448273
2021-01-19;;South America;98987;2377;14786461;450650
2021-01-20;;South America;117692;2451;14904153;453101
2021-01-21;;South America;97257;2521;15001410;455622
2021-01-22;;South America;102569;2370;15103979;457992
2021-01-23;;South America;95726;2394;15199705;460386
2021-01-24;;South America;67306;1765;15267011;462151
2021-01-25;;South America;54378;1857;15321389;464008
2021-01-26;;South America;107741;2761;15429130;466769
2021-01-27;;South America;97912;2514;15527042;469283
2021-01-28;;South America;101514;2528;15628556;471811
2021-01-29;;South America;95548;2632;15724104;474443
2021-01-30;;South America;99075;2332;15823179;476775
2021-01-31;;South America;54657;1859;15877836;478634
2021-02-01;;South America;47615;1829;15925451;480463
2021-02-02;;South America;85644;2455;16011095;482918
2021-02-03;;South America;99539;2555;16110634;485473
2021-02-04;;South America;83830;2299;16194464;487772
2021-02-05;;South America;82693;2804;16277157;490576
2021-02-06;;South America;31921;1048;16309078;491624
2021-02-07;;South America;108156;2608;16417234;494232
2021-02-08;;South America;16115;1366;16433349;495598
2021-02-09;;South America;105715;3394;16539064;498992
2021-02-10;;South America;80298;2338;16619362;501330
2021-02-11;;South America;84166;2759;16703528;504089
2021-02-12;;South America;81631;2556;16785159;506645
2021-02-13;;South America;72617;2390;16857776;509035
2021-02-14;;South America;56239;1840;16914015;510875
2021-02-15;;South America;48263;1666;16962278;512541
2021-02-16;;South America;68630;2245;17030908;514786
2021-02-17;;South America;79346;2329;17110254;517115
2021-02-18;;South America;80686;2789;17190940;519904
2021-02-19;;South America;84031;2658;17274971;522562
2021-02-20;;South America;82808;2242;17357779;524804
2021-02-21;;South America;58614;1808;17416393;526612
2021-02-22;;South America;42452;1576;17458845;528188
2021-02-23;;South America;84162;2494;17543007;530682
2021-02-24;;South America;94848;2517;17637855;533199
2021-02-25;;South America;95751;2727;17733606;535926
2021-02-26;;South America;99192;2612;17832798;538538
2021-02-27;;South America;87048;2462;17919846;541000
2021-02-28;;South America;48219;1707;17968065;542707
2021-03-01;;South America;58038;2006;18026103;544713
2021-03-02;;South America;85389;2307;18111492;547020
2021-03-03;;South America;91956;3122;18203448;550142
2021-03-04;;South America;101514;2934;18304962;553076
2021-03-05;;South America;102156;3123;18407118;556199
2021-03-06;;South America;96954;2354;18504072;558553
2021-03-07;;South America;103091;2148;18607163;560701
2021-03-08;;South America;54248;1878;18661411;562579
2021-03-09;;South America;98878;3247;18760289;565826
2021-03-10;;South America;100681;2988;18860970;568814
2021-03-11;;South America;107161;3318;18968131;572132
2021-03-12;;South America;116743;3275;19084874;575407
2021-03-13;;South America;106177;2977;19191051;578384
2021-03-14;;South America;67136;2062;19258187;580446
2021-03-15;;South America;59365;2299;19317552;582745
2021-03-16;;South America;111720;4123;19429272;586868
2021-03-17;;South America;131576;3652;19560848;590520
2021-03-18;;South America;115463;3757;19676311;594277
2021-03-19;;South America;134153;4362;19810464;598639
2021-03-20;;South America;106408;3461;19916872;602100
2021-03-21;;South America;85356;1987;20002228;604087
2021-03-22;;South America;73197;2361;20075425;606448
2021-03-23;;South America;122724;4351;20198149;610799
2021-03-24;;South America;118704;3106;20316853;613905
2021-03-25;;South America;148476;4010;20465329;617915
2021-03-26;;South America;133387;5000;20598716;622915
2021-03-27;;South America;128218;4432;20726934;627347
2021-03-28;;South America;82297;3158;20809231;630505
2021-03-29;;South America;77088;3040;20886319;633545
2021-03-30;;South America;117245;4791;21003564;638336
2021-03-31;;South America;145976;5304;21149540;643640
2021-04-01;;South America;145939;5074;21295479;648714
2021-04-02;;South America;113379;4002;21408858;652716
2021-04-03;;South America;83881;3485;21492739;656201
2021-04-04;;South America;76525;2458;21569264;658659
2021-04-05;;South America;72844;2516;21642108;661175
2021-04-06;;South America;134012;5599;21776120;666774
2021-04-07;;South America;150165;5284;21926285;672058
2021-04-08;;South America;161096;5919;22087381;677977
2021-04-09;;South America;162919;5315;22250300;683292
2021-04-10;;South America;134690;4431;22384990;687723
2021-04-11;;South America;94170;3563;22479160;691286
2021-04-12;;South America;91010;3139;22570170;694425
2021-04-13;;South America;145510;5389;22715680;699814
2021-04-14;;South America;138754;5292;22854434;705106
2021-04-15;;South America;136479;5342;22990913;710448
2021-04-16;;South America;159134;4884;23150047;715332
2021-04-17;;South America;138332;5014;23288379;720346
2021-04-18;;South America;93152;2900;23381531;723246
2021-04-19;;South America;89380;3408;23470911;726654
2021-04-20;;South America;139760;4860;23610671;731514
2021-04-21;;South America;138359;5330;23749030;736844
2021-04-22;;South America;125475;4328;23874505;741172
2021-04-23;;South America;150956;5528;24025461;746700
2021-04-24;;South America;133541;4621;24159002;751321
2021-04-25;;South America;85478;3289;24244480;754610
2021-04-26;;South America;81311;3264;24325791;757874
2021-04-27;;South America;127984;4829;24453775;762703
2021-04-28;;South America;153470;5388;24607245;768091
2021-04-29;;South America;129537;5266;24736782;773357
2021-04-30;;South America;141434;4282;24878216;777639
2021-05-01;;South America;118314;4276;24996530;781915
2021-05-02;;South America;82147;2857;25078677;784772
2021-05-03;;South America;67868;3486;25146545;788258
2021-05-04;;South America;135243;4596;25281788;792854
2021-05-05;;South America;125704;4802;25407492;797656
2021-05-06;;South America;139795;4561;25547287;802217
2021-05-07;;South America;133801;4212;25681088;806429
2021-05-08;;South America;136863;4205;25817951;810634
2021-05-09;;South America;84755;2716;25902706;813350
2021-05-10;;South America;68845;2505;25971551;815855
2021-05-11;;South America;130558;4358;26102109;820213
2021-05-12;;South America;144901;4283;26247010;824496
2021-05-13;;South America;137465;4337;26384475;828833
2021-05-14;;South America;160304;4337;26544779;833170
2021-05-15;;South America;124396;3968;26669175;837138
2021-05-16;;South America;98636;2699;26767811;839837
2021-05-17;;South America;86124;2771;26853935;842608
2021-05-18;;South America;140027;4247;26993962;846855
2021-05-19;;South America;162198;4757;27156160;851612
2021-05-20;;South America;155760;4039;27311920;855651
2021-05-21;;South America;154846;4322;27466766;859973
2021-05-22;;South America;157777;3878;27624543;863851
2021-05-23;;South America;105021;2637;27729564;866488
2021-05-24;;South America;89991;2137;27819555;868625
2021-05-25;;South America;145835;4455;27965390;873080
2021-05-26;;South America;163536;4039;28128926;877119
2021-05-27;;South America;159553;4254;28288479;881373
2021-05-28;;South America;131168;4108;28419647;885481
2021-05-29;;South America;157449;3828;28577096;889309
2021-05-30;;South America;102939;2537;28680035;891846
2021-05-31;;South America;106848;2790;28786883;894636
2021-06-01;;South America;158451;4217;28945334;898853
2021-06-02;;South America;186027;4897;29131361;903750
2021-06-03;;South America;163589;3314;29294950;907064
2021-06-04;;South America;131002;3801;29425952;910865
2021-06-05;;South America;143681;3372;29569633;914237
2021-06-06;;South America;97841;2177;29667474;916414
2021-06-07;;South America;98653;3046;29766127;919460
2021-06-08;;South America;125006;4214;29891133;923674
2021-06-09;;South America;154951;4533;30046084;928207
2021-06-10;;South America;179479;5113;30225563;933320
2021-06-11;;South America;160981;4124;30386544;937444
2021-06-12;;South America;147471;3563;30534015;941007
2021-06-13;;South America;100544;3008;30634559;944015
2021-06-14;;South America;99896;2462;30734455;946477
2021-06-15;;South America;150562;4602;30885017;951079
2021-06-16;;South America;165300;4649;31050317;955728
2021-06-17;;South America;156881;4446;31207198;960174
2021-06-18;;South America;166734;4096;31373932;964270
2021-06-19;;South America;143147;3907;31517079;968177
2021-06-20;;South America;97985;2534;31615064;970711
2021-06-21;;South America;85271;2663;31700335;973374
2021-06-22;;South America;149151;3936;31849486;977310
2021-06-23;;South America;186399;4350;32035885;981660
2021-06-24;;South America;146538;3686;32182423;985346
2021-06-25;;South America;158434;4133;32340857;989479
2021-06-26;;South America;128686;3088;32469543;992567
2021-06-27;;South America;91406;2187;32560949;994754
2021-06-28;;South America;86411;2524;32647360;997278
2021-06-29;;South America;125620;3333;32772980;1000611
2021-06-30;;South America;108743;4104;32881723;1004715
2021-07-01;;South America;130064;3767;33011787;1008482
2020-01-21;KR;South Korea;0;0;0;0
2020-01-22;KR;South Korea;0;0;1;0
2020-01-23;KR;South Korea;0;0;1;0
2020-01-24;KR;South Korea;1;0;2;0
2020-01-25;KR;South Korea;0;0;2;0
2020-01-26;KR;South Korea;1;0;3;0
2020-01-27;KR;South Korea;1;0;4;0
2020-01-28;KR;South Korea;0;0;4;0
2020-01-29;KR;South Korea;0;0;4;0
2020-01-30;KR;South Korea;0;0;4;0
2020-01-31;KR;South Korea;7;0;11;0
2020-02-01;KR;South Korea;1;0;12;0
2020-02-02;KR;South Korea;3;0;15;0
2020-02-03;KR;South Korea;0;0;15;0
2020-02-04;KR;South Korea;1;0;16;0
2020-02-05;KR;South Korea;3;0;19;0
2020-02-06;KR;South Korea;4;0;23;0
2020-02-07;KR;South Korea;1;0;24;0
2020-02-08;KR;South Korea;0;0;24;0
2020-02-09;KR;South Korea;1;0;25;0
2020-02-10;KR;South Korea;2;0;27;0
2020-02-11;KR;South Korea;1;0;28;0
2020-02-12;KR;South Korea;0;0;28;0
2020-02-13;KR;South Korea;0;0;28;0
2020-02-14;KR;South Korea;0;0;28;0
2020-02-15;KR;South Korea;0;0;28;0
2020-02-16;KR;South Korea;1;0;29;0
2020-02-17;KR;South Korea;1;0;30;0
2020-02-18;KR;South Korea;1;0;31;0
2020-02-19;KR;South Korea;0;0;31;0
2020-02-20;KR;South Korea;73;1;104;1
2020-02-21;KR;South Korea;100;1;204;2
2020-02-22;KR;South Korea;229;0;433;2
2020-02-23;KR;South Korea;169;4;602;6
2020-02-24;KR;South Korea;231;2;833;8
2020-02-25;KR;South Korea;144;2;977;10
2020-02-26;KR;South Korea;284;2;1261;12
2020-02-27;KR;South Korea;505;1;1766;13
2020-02-28;KR;South Korea;571;0;2337;13
2020-02-29;KR;South Korea;813;3;3150;16
2020-03-01;KR;South Korea;586;1;3736;17
2020-03-02;KR;South Korea;599;11;4335;28
2020-03-03;KR;South Korea;851;0;5186;28
2020-03-04;KR;South Korea;435;7;5621;35
2020-03-05;KR;South Korea;467;0;6088;35
2020-03-06;KR;South Korea;505;7;6593;42
2020-03-07;KR;South Korea;448;2;7041;44
2020-03-08;KR;South Korea;273;6;7314;50
2020-03-09;KR;South Korea;164;3;7478;53
2020-03-10;KR;South Korea;35;1;7513;54
2020-03-11;KR;South Korea;242;6;7755;60
2020-03-12;KR;South Korea;114;6;7869;66
2020-03-13;KR;South Korea;110;0;7979;66
2020-03-14;KR;South Korea;107;6;8086;72
2020-03-15;KR;South Korea;76;3;8162;75
2020-03-16;KR;South Korea;74;0;8236;75
2020-03-17;KR;South Korea;84;6;8320;81
2020-03-18;KR;South Korea;93;3;8413;84
2020-03-19;KR;South Korea;152;7;8565;91
2020-03-20;KR;South Korea;87;3;8652;94
2020-03-21;KR;South Korea;147;8;8799;102
2020-03-22;KR;South Korea;162;9;8961;111
2020-03-23;KR;South Korea;0;0;8961;111
2020-03-24;KR;South Korea;76;9;9037;120
2020-03-25;KR;South Korea;100;6;9137;126
2020-03-26;KR;South Korea;104;5;9241;131
2020-03-27;KR;South Korea;91;8;9332;139
2020-03-28;KR;South Korea;146;5;9478;144
2020-03-29;KR;South Korea;105;8;9583;152
2020-03-30;KR;South Korea;78;6;9661;158
2020-03-31;KR;South Korea;125;4;9786;162
2020-04-01;KR;South Korea;101;3;9887;165
2020-04-02;KR;South Korea;89;4;9976;169
2020-04-03;KR;South Korea;86;5;10062;174
2020-04-04;KR;South Korea;94;3;10156;177
2020-04-05;KR;South Korea;81;6;10237;183
2020-04-06;KR;South Korea;47;3;10284;186
2020-04-07;KR;South Korea;47;6;10331;192
2020-04-08;KR;South Korea;53;8;10384;200
2020-04-09;KR;South Korea;39;4;10423;204
2020-04-10;KR;South Korea;27;4;10450;208
2020-04-11;KR;South Korea;30;3;10480;211
2020-04-12;KR;South Korea;32;3;10512;214
2020-04-13;KR;South Korea;25;3;10537;217
2020-04-14;KR;South Korea;27;5;10564;222
2020-04-15;KR;South Korea;27;3;10591;225
2020-04-16;KR;South Korea;22;4;10613;229
2020-04-17;KR;South Korea;22;1;10635;230
2020-04-18;KR;South Korea;18;2;10653;232
2020-04-19;KR;South Korea;8;2;10661;234
2020-04-20;KR;South Korea;13;2;10674;236
2020-04-21;KR;South Korea;9;1;10683;237
2020-04-22;KR;South Korea;11;1;10694;238
2020-04-23;KR;South Korea;14;2;10708;240
2020-04-24;KR;South Korea;10;0;10718;240
2020-04-25;KR;South Korea;10;2;10728;242
2020-04-26;KR;South Korea;10;1;10738;243
2020-04-27;KR;South Korea;14;1;10752;244
2020-04-28;KR;South Korea;9;2;10761;246
2020-04-29;KR;South Korea;4;1;10765;247
2020-04-30;KR;South Korea;9;1;10774;248
2020-05-01;KR;South Korea;6;2;10780;250
2020-05-02;KR;South Korea;13;0;10793;250
2020-05-03;KR;South Korea;8;2;10801;252
2020-05-04;KR;South Korea;3;2;10804;254
2020-05-05;KR;South Korea;2;1;10806;255
2020-05-06;KR;South Korea;4;1;10810;256
2020-05-07;KR;South Korea;12;0;10822;256
2020-05-08;KR;South Korea;18;0;10840;256
2020-05-09;KR;South Korea;34;0;10874;256
2020-05-10;KR;South Korea;35;0;10909;256
2020-05-11;KR;South Korea;27;2;10936;258
2020-05-12;KR;South Korea;26;1;10962;259
2020-05-13;KR;South Korea;29;1;10991;260
2020-05-14;KR;South Korea;27;0;11018;260
2020-05-15;KR;South Korea;19;2;11037;262
2020-05-16;KR;South Korea;13;0;11050;262
2020-05-17;KR;South Korea;15;1;11065;263
2020-05-18;KR;South Korea;13;0;11078;263
2020-05-19;KR;South Korea;32;0;11110;263
2020-05-20;KR;South Korea;12;1;11122;264
2020-05-21;KR;South Korea;20;0;11142;264
2020-05-22;KR;South Korea;23;2;11165;266
2020-05-23;KR;South Korea;25;0;11190;266
2020-05-24;KR;South Korea;16;1;11206;267
2020-05-25;KR;South Korea;19;2;11225;269
2020-05-26;KR;South Korea;40;0;11265;269
2020-05-27;KR;South Korea;79;0;11344;269
2020-05-28;KR;South Korea;58;0;11402;269
2020-05-29;KR;South Korea;39;0;11441;269
2020-05-30;KR;South Korea;27;1;11468;270
2020-05-31;KR;South Korea;35;1;11503;271
2020-06-01;KR;South Korea;38;1;11541;272
2020-06-02;KR;South Korea;49;1;11590;273
2020-06-03;KR;South Korea;39;0;11629;273
2020-06-04;KR;South Korea;39;0;11668;273
2020-06-05;KR;South Korea;51;0;11719;273
2020-06-06;KR;South Korea;57;0;11776;273
2020-06-07;KR;South Korea;38;0;11814;273
2020-06-08;KR;South Korea;38;1;11852;274
2020-06-09;KR;South Korea;50;2;11902;276
2020-06-10;KR;South Korea;45;0;11947;276
2020-06-11;KR;South Korea;56;1;12003;277
2020-06-12;KR;South Korea;48;0;12051;277
2020-06-13;KR;South Korea;34;0;12085;277
2020-06-14;KR;South Korea;36;0;12121;277
2020-06-15;KR;South Korea;34;1;12155;278
2020-06-16;KR;South Korea;43;1;12198;279
2020-06-17;KR;South Korea;59;1;12257;280
2020-06-18;KR;South Korea;49;0;12306;280
2020-06-19;KR;South Korea;67;0;12373;280
2020-06-20;KR;South Korea;48;0;12421;280
2020-06-21;KR;South Korea;17;0;12438;280
2020-06-22;KR;South Korea;46;1;12484;281
2020-06-23;KR;South Korea;51;0;12535;281
2020-06-24;KR;South Korea;28;1;12563;282
2020-06-25;KR;South Korea;39;0;12602;282
2020-06-26;KR;South Korea;51;0;12653;282
2020-06-27;KR;South Korea;62;0;12715;282
2020-06-28;KR;South Korea;42;0;12757;282
2020-06-29;KR;South Korea;43;0;12800;282
2020-06-30;KR;South Korea;50;0;12850;282
2020-07-01;KR;South Korea;54;0;12904;282
2020-07-02;KR;South Korea;63;0;12967;282
2020-07-03;KR;South Korea;63;1;13030;283
2020-07-04;KR;South Korea;61;0;13091;283
2020-07-05;KR;South Korea;46;1;13137;284
2020-07-06;KR;South Korea;44;1;13181;285
2020-07-07;KR;South Korea;63;0;13244;285
2020-07-08;KR;South Korea;49;2;13293;287
2020-07-09;KR;South Korea;45;1;13338;288
2020-07-10;KR;South Korea;35;0;13373;288
2020-07-11;KR;South Korea;44;1;13417;289
2020-07-12;KR;South Korea;62;0;13479;289
2020-07-13;KR;South Korea;33;0;13512;289
2020-07-14;KR;South Korea;39;0;13551;289
2020-07-15;KR;South Korea;61;2;13612;291
2020-07-16;KR;South Korea;60;2;13672;293
2020-07-17;KR;South Korea;39;1;13711;294
2020-07-18;KR;South Korea;34;1;13745;295
2020-07-19;KR;South Korea;26;1;13771;296
2020-07-20;KR;South Korea;45;0;13816;296
2020-07-21;KR;South Korea;63;1;13879;297
2020-07-22;KR;South Korea;59;0;13938;297
2020-07-23;KR;South Korea;41;1;13979;298
2020-07-24;KR;South Korea;113;0;14092;298
2020-07-25;KR;South Korea;58;0;14150;298
2020-07-26;KR;South Korea;25;1;14175;299
2020-07-27;KR;South Korea;28;1;14203;300
2020-07-28;KR;South Korea;48;0;14251;300
2020-07-29;KR;South Korea;18;0;14269;300
2020-07-30;KR;South Korea;36;1;14305;301
2020-07-31;KR;South Korea;31;0;14336;301
2020-08-01;KR;South Korea;30;0;14366;301
2020-08-02;KR;South Korea;23;0;14389;301
2020-08-03;KR;South Korea;34;0;14423;301
2020-08-04;KR;South Korea;33;1;14456;302
2020-08-05;KR;South Korea;43;0;14499;302
2020-08-06;KR;South Korea;20;1;14519;303
2020-08-07;KR;South Korea;43;1;14562;304
2020-08-08;KR;South Korea;36;1;14598;305
2020-08-09;KR;South Korea;28;0;14626;305
2020-08-10;KR;South Korea;34;0;14660;305
2020-08-11;KR;South Korea;54;0;14714;305
2020-08-12;KR;South Korea;56;0;14770;305
2020-08-13;KR;South Korea;103;0;14873;305
2020-08-14;KR;South Korea;166;0;15039;305
2020-08-15;KR;South Korea;279;0;15318;305
2020-08-16;KR;South Korea;197;0;15515;305
2020-08-17;KR;South Korea;246;1;15761;306
2020-08-18;KR;South Korea;297;0;16058;306
2020-08-19;KR;South Korea;288;1;16346;307
2020-08-20;KR;South Korea;324;2;16670;309
2020-08-21;KR;South Korea;332;0;17002;309
2020-08-22;KR;South Korea;397;0;17399;309
2020-08-23;KR;South Korea;266;0;17665;309
2020-08-24;KR;South Korea;280;1;17945;310
2020-08-25;KR;South Korea;320;2;18265;312
2020-08-26;KR;South Korea;441;1;18706;313
2020-08-27;KR;South Korea;371;3;19077;316
2020-08-28;KR;South Korea;323;5;19400;321
2020-08-29;KR;South Korea;299;2;19699;323
2020-08-30;KR;South Korea;248;1;19947;324
2020-08-31;KR;South Korea;235;0;20182;324
2020-09-01;KR;South Korea;267;2;20449;326
2020-09-02;KR;South Korea;195;3;20644;329
2020-09-03;KR;South Korea;198;2;20842;331
2020-09-04;KR;South Korea;168;2;21010;333
2020-09-05;KR;South Korea;167;1;21177;334
2020-09-06;KR;South Korea;119;2;21296;336
2020-09-07;KR;South Korea;136;5;21432;341
2020-09-08;KR;South Korea;156;3;21588;344
2020-09-09;KR;South Korea;155;2;21743;346
2020-09-10;KR;South Korea;176;4;21919;350
2020-09-11;KR;South Korea;136;5;22055;355
2020-09-12;KR;South Korea;121;3;22176;358
2020-09-13;KR;South Korea;109;5;22285;363
2020-09-14;KR;South Korea;106;4;22391;367
2020-09-15;KR;South Korea;113;0;22504;367
2020-09-16;KR;South Korea;153;5;22657;372
2020-09-17;KR;South Korea;126;5;22783;377
2020-09-18;KR;South Korea;110;1;22893;378
2020-09-19;KR;South Korea;82;5;22975;383
2020-09-20;KR;South Korea;70;2;23045;385
2020-09-21;KR;South Korea;61;3;23106;388
2020-09-22;KR;South Korea;110;0;23216;388
2020-09-23;KR;South Korea;125;5;23341;393
2020-09-24;KR;South Korea;114;2;23455;395
2020-09-25;KR;South Korea;61;4;23516;399
2020-09-26;KR;South Korea;95;2;23611;401
2020-09-27;KR;South Korea;50;5;23661;406
2020-09-28;KR;South Korea;38;1;23699;407
2020-09-29;KR;South Korea;113;6;23812;413
2020-09-30;KR;South Korea;77;2;23889;415
2020-10-01;KR;South Korea;63;1;23952;416
2020-10-02;KR;South Korea;75;4;24027;420
2020-10-03;KR;South Korea;64;1;24091;421
2020-10-04;KR;South Korea;73;1;24164;422
2020-10-05;KR;South Korea;75;0;24239;422
2020-10-06;KR;South Korea;114;3;24353;425
2020-10-07;KR;South Korea;69;2;24422;427
2020-10-08;KR;South Korea;54;1;24476;428
2020-10-09;KR;South Korea;72;2;24548;430
2020-10-10;KR;South Korea;58;2;24606;432
2020-10-11;KR;South Korea;97;1;24703;433
2020-10-12;KR;South Korea;102;1;24805;434
2020-10-13;KR;South Korea;84;4;24889;438
2020-10-14;KR;South Korea;99;1;24988;439
2020-10-15;KR;South Korea;47;2;25035;441
2020-10-16;KR;South Korea;73;2;25108;443
2020-10-17;KR;South Korea;91;1;25199;444
2020-10-18;KR;South Korea;76;0;25275;444
2020-10-19;KR;South Korea;58;3;25333;447
2020-10-20;KR;South Korea;91;3;25424;450
2020-10-21;KR;South Korea;119;3;25543;453
2020-10-22;KR;South Korea;155;2;25698;455
2020-10-23;KR;South Korea;77;2;25775;457
2020-10-24;KR;South Korea;61;0;25836;457
2020-10-25;KR;South Korea;119;0;25955;457
2020-10-26;KR;South Korea;88;3;26043;460
2020-10-27;KR;South Korea;103;1;26146;461
2020-10-28;KR;South Korea;125;1;26271;462
2020-10-29;KR;South Korea;114;1;26385;463
2020-10-30;KR;South Korea;126;1;26511;464
2020-10-31;KR;South Korea;124;2;26635;466
2020-11-01;KR;South Korea;97;2;26732;468
2020-11-02;KR;South Korea;75;4;26807;472
2020-11-03;KR;South Korea;118;2;26925;474
2020-11-04;KR;South Korea;125;1;27050;475
2020-11-05;KR;South Korea;145;1;27195;476
2020-11-06;KR;South Korea;89;1;27284;477
2020-11-07;KR;South Korea;143;1;27427;478
2020-11-08;KR;South Korea;126;2;27553;480
2020-11-09;KR;South Korea;100;5;27653;485
2020-11-10;KR;South Korea;146;2;27799;487
2020-11-11;KR;South Korea;143;0;27942;487
2020-11-12;KR;South Korea;191;1;28133;488
2020-11-13;KR;South Korea;205;4;28338;492
2020-11-14;KR;South Korea;208;1;28546;493
2020-11-15;KR;South Korea;223;1;28769;494
2020-11-16;KR;South Korea;229;0;28998;494
2020-11-17;KR;South Korea;313;2;29311;496
2020-11-18;KR;South Korea;343;2;29654;498
2020-11-19;KR;South Korea;363;3;30017;501
2020-11-20;KR;South Korea;386;2;30403;503
2020-11-21;KR;South Korea;330;2;30733;505
2020-11-22;KR;South Korea;271;4;31004;509
2020-11-23;KR;South Korea;349;1;31353;510
2020-11-24;KR;South Korea;382;3;31735;513
2020-11-25;KR;South Korea;583;2;32318;515
2020-11-26;KR;South Korea;569;1;32887;516
2020-11-27;KR;South Korea;488;6;33375;522
2020-11-28;KR;South Korea;449;1;33824;523
2020-11-29;KR;South Korea;377;3;34201;526
2020-11-30;KR;South Korea;451;0;34652;526
2020-12-01;KR;South Korea;511;0;35163;526
2020-12-02;KR;South Korea;540;3;35703;529
2020-12-03;KR;South Korea;629;7;36332;536
2020-12-04;KR;South Korea;583;4;36915;540
2020-12-05;KR;South Korea;631;5;37546;545
2020-12-06;KR;South Korea;615;4;38161;549
2020-12-07;KR;South Korea;594;3;38755;552
2020-12-08;KR;South Korea;677;4;39432;556
2020-12-09;KR;South Korea;666;8;40098;564
2020-12-10;KR;South Korea;688;8;40786;572
2020-12-11;KR;South Korea;950;6;41736;578
2020-12-12;KR;South Korea;1030;2;42766;580
2020-12-13;KR;South Korea;718;7;43484;587
2020-12-14;KR;South Korea;880;13;44364;600
2020-12-15;KR;South Korea;1078;12;45442;612
2020-12-16;KR;South Korea;1011;22;46453;634
2020-12-17;KR;South Korea;1062;11;47515;645
2020-12-18;KR;South Korea;1055;14;48570;659
2020-12-19;KR;South Korea;1095;15;49665;674
2020-12-20;KR;South Korea;926;24;50591;698
2020-12-21;KR;South Korea;869;24;51460;722
2020-12-22;KR;South Korea;1090;17;52550;739
2020-12-23;KR;South Korea;983;17;53533;756
2020-12-24;KR;South Korea;1237;17;54770;773
2020-12-25;KR;South Korea;1132;20;55902;793
2020-12-26;KR;South Korea;970;15;56872;808
2020-12-27;KR;South Korea;808;11;57680;819
2020-12-28;KR;South Korea;1045;40;58725;859
2020-12-29;KR;South Korea;1048;20;59773;879
2020-12-30;KR;South Korea;967;21;60740;900
2020-12-31;KR;South Korea;1029;17;61769;917
2021-01-01;KR;South Korea;824;25;62593;942
2021-01-02;KR;South Korea;651;20;63244;962
2021-01-03;KR;South Korea;1020;19;64264;981
2021-01-04;KR;South Korea;715;26;64979;1007
2021-01-05;KR;South Korea;839;20;65818;1027
2021-01-06;KR;South Korea;868;19;66686;1046
2021-01-07;KR;South Korea;672;35;67358;1081
2021-01-08;KR;South Korea;641;19;67999;1100
2021-01-09;KR;South Korea;665;25;68664;1125
2021-01-10;KR;South Korea;450;15;69114;1140
2021-01-11;KR;South Korea;537;25;69651;1165
2021-01-12;KR;South Korea;561;20;70212;1185
2021-01-13;KR;South Korea;516;10;70728;1195
2021-01-14;KR;South Korea;513;22;71241;1217
2021-01-15;KR;South Korea;579;19;71820;1236
2021-01-16;KR;South Korea;520;13;72340;1249
2021-01-17;KR;South Korea;389;15;72729;1264
2021-01-18;KR;South Korea;386;19;73115;1283
2021-01-19;KR;South Korea;403;17;73518;1300
2021-01-20;KR;South Korea;400;16;73918;1316
2021-01-21;KR;South Korea;344;12;74262;1328
2021-01-22;KR;South Korea;430;9;74692;1337
2021-01-23;KR;South Korea;392;12;75084;1349
2021-01-24;KR;South Korea;437;11;75521;1360
2021-01-25;KR;South Korea;354;11;75875;1371
2021-01-26;KR;South Korea;554;7;76429;1378
2021-01-27;KR;South Korea;497;8;76926;1386
2021-01-28;KR;South Korea;469;13;77395;1399
2021-01-29;KR;South Korea;455;15;77850;1414
2021-01-30;KR;South Korea;355;6;78205;1420
2021-01-31;KR;South Korea;303;5;78508;1425
2021-02-01;KR;South Korea;336;10;78844;1435
2021-02-02;KR;South Korea;467;6;79311;1441
2021-02-03;KR;South Korea;451;7;79762;1448
2021-02-04;KR;South Korea;369;11;80131;1459
2021-02-05;KR;South Korea;393;5;80524;1464
2021-02-06;KR;South Korea;372;7;80896;1471
2021-02-07;KR;South Korea;289;3;81185;1474
2021-02-08;KR;South Korea;302;8;81487;1482
2021-02-09;KR;South Korea;443;4;81930;1486
2021-02-10;KR;South Korea;504;10;82434;1496
2021-02-11;KR;South Korea;403;11;82837;1507
2021-02-12;KR;South Korea;362;7;83199;1514
2021-02-13;KR;South Korea;326;8;83525;1522
2021-02-14;KR;South Korea;344;5;83869;1527
2021-02-15;KR;South Korea;456;7;84325;1534
2021-02-16;KR;South Korea;621;4;84946;1538
2021-02-17;KR;South Korea;621;6;85567;1544
2021-02-18;KR;South Korea;561;6;86128;1550
2021-02-19;KR;South Korea;446;3;86574;1553
2021-02-20;KR;South Korea;418;4;86992;1557
2021-02-21;KR;South Korea;332;5;87324;1562
2021-02-22;KR;South Korea;357;11;87681;1573
2021-02-23;KR;South Korea;439;3;88120;1576
2021-02-24;KR;South Korea;396;5;88516;1581
2021-02-25;KR;South Korea;406;4;88922;1585
2021-02-26;KR;South Korea;399;10;89321;1595
2021-02-27;KR;South Korea;355;8;89676;1603
2021-02-28;KR;South Korea;355;2;90031;1605
2021-03-01;KR;South Korea;341;1;90372;1606
2021-03-02;KR;South Korea;444;6;90816;1612
2021-03-03;KR;South Korea;424;7;91240;1619
2021-03-04;KR;South Korea;398;8;91638;1627
2021-03-05;KR;South Korea;417;5;92055;1632
2021-03-06;KR;South Korea;416;2;92471;1634
2021-03-07;KR;South Korea;346;8;92817;1642
2021-03-08;KR;South Korea;446;3;93263;1645
2021-03-09;KR;South Korea;470;3;93733;1648
2021-03-10;KR;South Korea;465;4;94198;1652
2021-03-11;KR;South Korea;488;10;94686;1662
2021-03-12;KR;South Korea;490;5;95176;1667
2021-03-13;KR;South Korea;459;2;95635;1669
2021-03-14;KR;South Korea;382;6;96017;1675
2021-03-15;KR;South Korea;363;3;96380;1678
2021-03-16;KR;South Korea;469;8;96849;1686
2021-03-17;KR;South Korea;445;2;97294;1688
2021-03-18;KR;South Korea;463;2;97757;1690
2021-03-19;KR;South Korea;452;3;98209;1693
2021-03-20;KR;South Korea;456;3;98665;1696
2021-03-21;KR;South Korea;410;1;99075;1697
2021-03-22;KR;South Korea;346;7;99421;1704
2021-03-23;KR;South Korea;425;3;99846;1707
2021-03-24;KR;South Korea;430;2;100276;1709
2021-03-25;KR;South Korea;494;7;100770;1716
2021-03-26;KR;South Korea;505;5;101275;1721
2021-03-27;KR;South Korea;482;1;101757;1722
2021-03-28;KR;South Korea;384;4;102141;1726
2021-03-29;KR;South Korea;441;3;102582;1729
2021-03-30;KR;South Korea;506;2;103088;1731
2021-03-31;KR;South Korea;551;4;103639;1735
2021-04-01;KR;South Korea;555;2;104194;1737
2021-04-02;KR;South Korea;542;3;104736;1740
2021-04-03;KR;South Korea;543;4;105279;1744
2021-04-04;KR;South Korea;473;4;105752;1748
2021-04-05;KR;South Korea;478;4;106230;1752
2021-04-06;KR;South Korea;668;4;106898;1756
2021-04-07;KR;South Korea;700;2;107598;1758
2021-04-08;KR;South Korea;671;6;108269;1764
2021-04-09;KR;South Korea;676;1;108945;1765
2021-04-10;KR;South Korea;614;3;109559;1768
2021-04-11;KR;South Korea;587;2;110146;1770
2021-04-12;KR;South Korea;542;5;110688;1775
2021-04-13;KR;South Korea;731;7;111419;1782
2021-04-14;KR;South Korea;698;6;112117;1788
2021-04-15;KR;South Korea;672;2;112789;1790
2021-04-16;KR;South Korea;655;4;113444;1794
2021-04-17;KR;South Korea;671;3;114115;1797
2021-04-18;KR;South Korea;531;4;114646;1801
2021-04-19;KR;South Korea;549;1;115195;1802
2021-04-20;KR;South Korea;731;4;115926;1806
2021-04-21;KR;South Korea;735;2;116661;1808
2021-04-22;KR;South Korea;797;3;117458;1811
2021-04-23;KR;South Korea;785;1;118243;1812
2021-04-24;KR;South Korea;644;1;118887;1813
2021-04-25;KR;South Korea;500;4;119387;1817
2021-04-26;KR;South Korea;511;3;119898;1820
2021-04-27;KR;South Korea;775;1;120673;1821
2021-04-28;KR;South Korea;678;4;121351;1825
2021-04-29;KR;South Korea;656;3;122007;1828
2021-04-30;KR;South Korea;627;3;122634;1831
2021-05-01;KR;South Korea;606;2;123240;1833
2021-05-02;KR;South Korea;488;1;123728;1834
2021-05-03;KR;South Korea;541;6;124269;1840
2021-05-04;KR;South Korea;676;7;124945;1847
2021-05-05;KR;South Korea;574;4;125519;1851
2021-05-06;KR;South Korea;525;9;126044;1860
2021-05-07;KR;South Korea;701;5;126745;1865
2021-05-08;KR;South Korea;564;9;127309;1874
2021-05-09;KR;South Korea;463;1;127772;1875
2021-05-10;KR;South Korea;511;4;128283;1879
2021-05-11;KR;South Korea;635;5;128918;1884
2021-05-12;KR;South Korea;715;7;129633;1891
2021-05-13;KR;South Korea;747;2;130380;1893
2021-05-14;KR;South Korea;681;3;131061;1896
2021-05-15;KR;South Korea;610;4;131671;1900
2021-05-16;KR;South Korea;619;3;132290;1903
2021-05-17;KR;South Korea;528;1;132818;1904
2021-05-18;KR;South Korea;653;8;133471;1912
2021-05-19;KR;South Korea;646;4;134117;1916
2021-05-20;KR;South Korea;561;6;134678;1922
2021-05-21;KR;South Korea;666;4;135344;1926
2021-05-22;KR;South Korea;585;5;135929;1931
2021-05-23;KR;South Korea;538;3;136467;1934
2021-05-24;KR;South Korea;516;4;136983;1938
2021-05-25;KR;South Korea;699;2;137682;1940
2021-05-26;KR;South Korea;629;3;138311;1943
2021-05-27;KR;South Korea;587;3;138898;1946
2021-05-28;KR;South Korea;533;5;139431;1951
2021-05-29;KR;South Korea;479;6;139910;1957
2021-05-30;KR;South Korea;430;2;140340;1959
2021-05-31;KR;South Korea;459;4;140799;1963
2021-06-01;KR;South Korea;677;2;141476;1965
2021-06-02;KR;South Korea;681;3;142157;1968
2021-06-03;KR;South Korea;695;1;142852;1969
2021-06-04;KR;South Korea;744;2;143596;1971
2021-06-05;KR;South Korea;556;2;144152;1973
2021-06-06;KR;South Korea;485;1;144637;1974
2021-06-07;KR;South Korea;454;1;145091;1975
2021-06-08;KR;South Korea;601;2;145692;1977
2021-06-09;KR;South Korea;611;2;146303;1979
2021-06-10;KR;South Korea;556;2;146859;1981
2021-06-11;KR;South Korea;563;1;147422;1982
2021-06-12;KR;South Korea;452;3;147874;1985
2021-06-13;KR;South Korea;399;3;148273;1988
2021-06-14;KR;South Korea;374;4;148647;1992
2021-06-15;KR;South Korea;544;1;149191;1993
2021-06-16;KR;South Korea;540;1;149731;1994
2021-06-17;KR;South Korea;507;2;150238;1996
2021-06-18;KR;South Korea;482;1;150720;1997
2021-06-19;KR;South Korea;429;5;151149;2002
2021-06-20;KR;South Korea;357;2;151506;2004
2021-06-21;KR;South Korea;395;2;151901;2006
2021-06-22;KR;South Korea;644;1;152545;2007
2021-06-23;KR;South Korea;610;1;153155;2008
2021-06-24;KR;South Korea;634;1;153789;2009
2021-06-25;KR;South Korea;668;3;154457;2012
2021-06-26;KR;South Korea;614;1;155071;2013
2021-06-27;KR;South Korea;501;2;155572;2015
2021-06-28;KR;South Korea;595;2;156167;2017
2021-06-29;KR;South Korea;794;1;156961;2018
2021-06-30;KR;South Korea;762;3;157723;2021
2021-07-01;KR;South Korea;826;3;158549;2024
2020-04-05;SS;South Sudan;1;0;1;0
2020-04-06;SS;South Sudan;0;0;1;0
2020-04-07;SS;South Sudan;1;0;2;0
2020-04-08;SS;South Sudan;0;0;2;0
2020-04-09;SS;South Sudan;1;0;3;0
2020-04-10;SS;South Sudan;1;0;4;0
2020-04-11;SS;South Sudan;0;0;4;0
2020-04-12;SS;South Sudan;0;0;4;0
2020-04-13;SS;South Sudan;0;0;4;0
2020-04-14;SS;South Sudan;0;0;4;0
2020-04-15;SS;South Sudan;0;0;4;0
2020-04-16;SS;South Sudan;0;0;4;0
2020-04-17;SS;South Sudan;0;0;4;0
2020-04-18;SS;South Sudan;0;0;4;0
2020-04-19;SS;South Sudan;0;0;4;0
2020-04-20;SS;South Sudan;0;0;4;0
2020-04-21;SS;South Sudan;0;0;4;0
2020-04-22;SS;South Sudan;0;0;4;0
2020-04-23;SS;South Sudan;1;0;5;0
2020-04-24;SS;South Sudan;0;0;5;0
2020-04-25;SS;South Sudan;0;0;5;0
2020-04-26;SS;South Sudan;1;0;6;0
2020-04-27;SS;South Sudan;0;0;6;0
2020-04-28;SS;South Sudan;28;0;34;0
2020-04-29;SS;South Sudan;0;0;34;0
2020-04-30;SS;South Sudan;1;0;35;0
2020-05-01;SS;South Sudan;10;0;45;0
2020-05-02;SS;South Sudan;0;0;45;0
2020-05-03;SS;South Sudan;1;0;46;0
2020-05-04;SS;South Sudan;0;0;46;0
2020-05-05;SS;South Sudan;6;0;52;0
2020-05-06;SS;South Sudan;6;0;58;0
2020-05-07;SS;South Sudan;16;0;74;0
2020-05-08;SS;South Sudan;46;0;120;0
2020-05-09;SS;South Sudan;0;0;120;0
2020-05-10;SS;South Sudan;0;0;120;0
2020-05-11;SS;South Sudan;36;0;156;0
2020-05-12;SS;South Sudan;38;0;194;0
2020-05-13;SS;South Sudan;9;0;203;0
2020-05-14;SS;South Sudan;0;0;203;0
2020-05-15;SS;South Sudan;33;4;236;4
2020-05-16;SS;South Sudan;0;0;236;4
2020-05-17;SS;South Sudan;54;0;290;4
2020-05-18;SS;South Sudan;0;0;290;4
2020-05-19;SS;South Sudan;0;0;290;4
2020-05-20;SS;South Sudan;0;0;290;4
2020-05-21;SS;South Sudan;191;0;481;4
2020-05-22;SS;South Sudan;82;2;563;6
2020-05-23;SS;South Sudan;92;2;655;8
2020-05-24;SS;South Sudan;0;0;655;8
2020-05-25;SS;South Sudan;151;0;806;8
2020-05-26;SS;South Sudan;0;0;806;8
2020-05-27;SS;South Sudan;188;2;994;10
2020-05-28;SS;South Sudan;0;0;994;10
2020-05-29;SS;South Sudan;0;0;994;10
2020-05-30;SS;South Sudan;0;0;994;10
2020-05-31;SS;South Sudan;0;0;994;10
2020-06-01;SS;South Sudan;0;0;994;10
2020-06-02;SS;South Sudan;0;0;994;10
2020-06-03;SS;South Sudan;0;0;994;10
2020-06-04;SS;South Sudan;0;0;994;10
2020-06-05;SS;South Sudan;0;0;994;10
2020-06-06;SS;South Sudan;0;0;994;10
2020-06-07;SS;South Sudan;323;4;1317;14
2020-06-08;SS;South Sudan;287;5;1604;19
2020-06-09;SS;South Sudan;0;0;1604;19
2020-06-10;SS;South Sudan;0;0;1604;19
2020-06-11;SS;South Sudan;66;5;1670;24
2020-06-12;SS;South Sudan;0;0;1670;24
2020-06-13;SS;South Sudan;23;3;1693;27
2020-06-14;SS;South Sudan;0;0;1693;27
2020-06-15;SS;South Sudan;0;0;1693;27
2020-06-16;SS;South Sudan;83;3;1776;30
2020-06-17;SS;South Sudan;37;1;1813;31
2020-06-18;SS;South Sudan;17;1;1830;32
2020-06-19;SS;South Sudan;34;2;1864;34
2020-06-20;SS;South Sudan;18;0;1882;34
2020-06-21;SS;South Sudan;10;0;1892;34
2020-06-22;SS;South Sudan;24;1;1916;35
2020-06-23;SS;South Sudan;14;1;1930;36
2020-06-24;SS;South Sudan;12;0;1942;36
2020-06-25;SS;South Sudan;0;0;1942;36
2020-06-26;SS;South Sudan;0;0;1942;36
2020-06-27;SS;South Sudan;0;0;1942;36
2020-06-28;SS;South Sudan;47;0;1989;36
2020-06-29;SS;South Sudan;0;0;1989;36
2020-06-30;SS;South Sudan;18;2;2007;38
2020-07-01;SS;South Sudan;14;0;2021;38
2020-07-02;SS;South Sudan;0;0;2021;38
2020-07-03;SS;South Sudan;0;0;2021;38
2020-07-04;SS;South Sudan;0;0;2021;38
2020-07-05;SS;South Sudan;0;0;2021;38
2020-07-06;SS;South Sudan;0;0;2021;38
2020-07-07;SS;South Sudan;0;0;2021;38
2020-07-08;SS;South Sudan;0;0;2021;38
2020-07-09;SS;South Sudan;0;0;2021;38
2020-07-10;SS;South Sudan;0;0;2021;38
2020-07-11;SS;South Sudan;0;0;2021;38
2020-07-12;SS;South Sudan;0;0;2021;38
2020-07-13;SS;South Sudan;127;3;2148;41
2020-07-14;SS;South Sudan;0;0;2148;41
2020-07-15;SS;South Sudan;5;0;2153;41
2020-07-16;SS;South Sudan;18;0;2171;41
2020-07-17;SS;South Sudan;20;2;2191;43
2020-07-18;SS;South Sudan;0;0;2191;43
2020-07-19;SS;South Sudan;9;0;2200;43
2020-07-20;SS;South Sudan;11;2;2211;45
2020-07-21;SS;South Sudan;0;0;2211;45
2020-07-22;SS;South Sudan;0;0;2211;45
2020-07-23;SS;South Sudan;28;0;2239;45
2020-07-24;SS;South Sudan;19;0;2258;45
2020-07-25;SS;South Sudan;0;0;2258;45
2020-07-26;SS;South Sudan;4;0;2262;45
2020-07-27;SS;South Sudan;43;1;2305;46
2020-07-28;SS;South Sudan;0;0;2305;46
2020-07-29;SS;South Sudan;17;0;2322;46
2020-07-30;SS;South Sudan;0;0;2322;46
2020-07-31;SS;South Sudan;0;0;2322;46
2020-08-01;SS;South Sudan;30;0;2352;46
2020-08-02;SS;South Sudan;77;0;2429;46
2020-08-03;SS;South Sudan;0;0;2429;46
2020-08-04;SS;South Sudan;8;1;2437;47
2020-08-05;SS;South Sudan;0;0;2437;47
2020-08-06;SS;South Sudan;13;0;2450;47
2020-08-07;SS;South Sudan;0;0;2450;47
2020-08-08;SS;South Sudan;13;0;2463;47
2020-08-09;SS;South Sudan;7;0;2470;47
2020-08-10;SS;South Sudan;0;0;2470;47
2020-08-11;SS;South Sudan;2;0;2472;47
2020-08-12;SS;South Sudan;5;0;2477;47
2020-08-13;SS;South Sudan;1;0;2478;47
2020-08-14;SS;South Sudan;4;0;2482;47
2020-08-15;SS;South Sudan;6;0;2488;47
2020-08-16;SS;South Sudan;1;0;2489;47
2020-08-17;SS;South Sudan;1;0;2490;47
2020-08-18;SS;South Sudan;0;0;2490;47
2020-08-19;SS;South Sudan;4;0;2494;47
2020-08-20;SS;South Sudan;0;0;2494;47
2020-08-21;SS;South Sudan;3;0;2497;47
2020-08-22;SS;South Sudan;0;0;2497;47
2020-08-23;SS;South Sudan;2;0;2499;47
2020-08-24;SS;South Sudan;5;0;2504;47
2020-08-25;SS;South Sudan;3;0;2507;47
2020-08-26;SS;South Sudan;3;0;2510;47
2020-08-27;SS;South Sudan;4;0;2514;47
2020-08-28;SS;South Sudan;4;0;2518;47
2020-08-29;SS;South Sudan;1;0;2519;47
2020-08-30;SS;South Sudan;0;0;2519;47
2020-08-31;SS;South Sudan;8;0;2527;47
2020-09-01;SS;South Sudan;0;0;2527;47
2020-09-02;SS;South Sudan;5;0;2532;47
2020-09-03;SS;South Sudan;1;0;2533;47
2020-09-04;SS;South Sudan;3;0;2536;47
2020-09-05;SS;South Sudan;8;1;2544;48
2020-09-06;SS;South Sudan;0;0;2544;48
2020-09-07;SS;South Sudan;1;0;2545;48
2020-09-08;SS;South Sudan;7;1;2552;49
2020-09-09;SS;South Sudan;3;0;2555;49
2020-09-10;SS;South Sudan;0;0;2555;49
2020-09-11;SS;South Sudan;13;0;2568;49
2020-09-12;SS;South Sudan;10;0;2578;49
2020-09-13;SS;South Sudan;0;0;2578;49
2020-09-14;SS;South Sudan;9;0;2587;49
2020-09-15;SS;South Sudan;5;0;2592;49
2020-09-16;SS;South Sudan;2;0;2594;49
2020-09-17;SS;South Sudan;5;0;2599;49
2020-09-18;SS;South Sudan;10;0;2609;49
2020-09-19;SS;South Sudan;33;0;2642;49
2020-09-20;SS;South Sudan;0;0;2642;49
2020-09-21;SS;South Sudan;7;0;2649;49
2020-09-22;SS;South Sudan;11;0;2660;49
2020-09-23;SS;South Sudan;4;0;2664;49
2020-09-24;SS;South Sudan;5;0;2669;49
2020-09-25;SS;South Sudan;7;0;2676;49
2020-09-26;SS;South Sudan;0;0;2676;49
2020-09-27;SS;South Sudan;10;0;2686;49
2020-09-28;SS;South Sudan;6;0;2692;49
2020-09-29;SS;South Sudan;8;0;2700;49
2020-09-30;SS;South Sudan;4;0;2704;49
2020-10-01;SS;South Sudan;0;0;2704;49
2020-10-02;SS;South Sudan;11;1;2715;50
2020-10-03;SS;South Sudan;0;0;2715;50
2020-10-04;SS;South Sudan;11;0;2726;50
2020-10-05;SS;South Sudan;0;0;2726;50
2020-10-06;SS;South Sudan;8;0;2734;50
2020-10-07;SS;South Sudan;14;0;2748;50
2020-10-08;SS;South Sudan;1;3;2749;53
2020-10-09;SS;South Sudan;12;1;2761;54
2020-10-10;SS;South Sudan;0;0;2761;54
2020-10-11;SS;South Sudan;16;1;2777;55
2020-10-12;SS;South Sudan;10;0;2787;55
2020-10-13;SS;South Sudan;11;0;2798;55
2020-10-14;SS;South Sudan;0;0;2798;55
2020-10-15;SS;South Sudan;9;0;2807;55
2020-10-16;SS;South Sudan;10;0;2817;55
2020-10-17;SS;South Sudan;0;0;2817;55
2020-10-18;SS;South Sudan;25;0;2842;55
2020-10-19;SS;South Sudan;5;0;2847;55
2020-10-20;SS;South Sudan;0;0;2847;55
2020-10-21;SS;South Sudan;23;0;2870;55
2020-10-22;SS;South Sudan;2;0;2872;55
2020-10-23;SS;South Sudan;4;1;2876;56
2020-10-24;SS;South Sudan;2;0;2878;56
2020-10-25;SS;South Sudan;5;0;2883;56
2020-10-26;SS;South Sudan;0;0;2883;56
2020-10-27;SS;South Sudan;7;0;2890;56
2020-10-28;SS;South Sudan;0;0;2890;56
2020-10-29;SS;South Sudan;13;2;2903;58
2020-10-30;SS;South Sudan;0;0;2903;58
2020-10-31;SS;South Sudan;2;0;2905;58
2020-11-01;SS;South Sudan;21;1;2926;59
2020-11-02;SS;South Sudan;0;0;2926;59
2020-11-03;SS;South Sudan;14;0;2940;59
2020-11-04;SS;South Sudan;3;0;2943;59
2020-11-05;SS;South Sudan;0;0;2943;59
2020-11-06;SS;South Sudan;0;0;2943;59
2020-11-07;SS;South Sudan;0;0;2943;59
2020-11-08;SS;South Sudan;0;0;2943;59
2020-11-09;SS;South Sudan;17;0;2960;59
2020-11-10;SS;South Sudan;0;0;2960;59
2020-11-11;SS;South Sudan;0;0;2960;59
2020-11-12;SS;South Sudan;0;0;2960;59
2020-11-13;SS;South Sudan;20;0;2980;59
2020-11-14;SS;South Sudan;23;0;3003;59
2020-11-15;SS;South Sudan;0;0;3003;59
2020-11-16;SS;South Sudan;9;0;3012;59
2020-11-17;SS;South Sudan;4;0;3016;59
2020-11-18;SS;South Sudan;0;0;3016;59
2020-11-19;SS;South Sudan;0;0;3016;59
2020-11-20;SS;South Sudan;0;0;3016;59
2020-11-21;SS;South Sudan;31;1;3047;60
2020-11-22;SS;South Sudan;0;0;3047;60
2020-11-23;SS;South Sudan;0;0;3047;60
2020-11-24;SS;South Sudan;0;0;3047;60
2020-11-25;SS;South Sudan;26;1;3073;61
2020-11-26;SS;South Sudan;19;0;3092;61
2020-11-27;SS;South Sudan;12;0;3104;61
2020-11-28;SS;South Sudan;0;0;3104;61
2020-11-29;SS;South Sudan;5;0;3109;61
2020-11-30;SS;South Sudan;0;0;3109;61
2020-12-01;SS;South Sudan;2;0;3111;61
2020-12-02;SS;South Sudan;7;0;3118;61
2020-12-03;SS;South Sudan;36;1;3154;62
2020-12-04;SS;South Sudan;0;0;3154;62
2020-12-05;SS;South Sudan;12;0;3166;62
2020-12-06;SS;South Sudan;15;0;3181;62
2020-12-07;SS;South Sudan;0;0;3181;62
2020-12-08;SS;South Sudan;0;0;3181;62
2020-12-09;SS;South Sudan;0;0;3181;62
2020-12-10;SS;South Sudan;0;0;3181;62
2020-12-11;SS;South Sudan;0;0;3181;62
2020-12-12;SS;South Sudan;25;0;3206;62
2020-12-13;SS;South Sudan;0;0;3206;62
2020-12-14;SS;South Sudan;0;0;3206;62
2020-12-15;SS;South Sudan;16;0;3222;62
2020-12-16;SS;South Sudan;0;0;3222;62
2020-12-17;SS;South Sudan;0;0;3222;62
2020-12-18;SS;South Sudan;6;0;3228;62
2020-12-19;SS;South Sudan;0;0;3228;62
2020-12-20;SS;South Sudan;0;0;3228;62
2020-12-21;SS;South Sudan;6;0;3234;62
2020-12-22;SS;South Sudan;0;0;3234;62
2020-12-23;SS;South Sudan;221;0;3455;62
2020-12-24;SS;South Sudan;0;0;3455;62
2020-12-25;SS;South Sudan;0;0;3455;62
2020-12-26;SS;South Sudan;0;0;3455;62
2020-12-27;SS;South Sudan;35;0;3490;62
2020-12-28;SS;South Sudan;1;0;3491;62
2020-12-29;SS;South Sudan;20;1;3511;63
2020-12-30;SS;South Sudan;29;0;3540;63
2020-12-31;SS;South Sudan;18;0;3558;63
2021-01-01;SS;South Sudan;0;0;3558;63
2021-01-02;SS;South Sudan;0;0;3558;63
2021-01-03;SS;South Sudan;0;0;3558;63
2021-01-04;SS;South Sudan;31;0;3589;63
2021-01-05;SS;South Sudan;0;0;3589;63
2021-01-06;SS;South Sudan;0;0;3589;63
2021-01-07;SS;South Sudan;0;0;3589;63
2021-01-08;SS;South Sudan;0;0;3589;63
2021-01-09;SS;South Sudan;0;0;3589;63
2021-01-10;SS;South Sudan;60;0;3649;63
2021-01-11;SS;South Sudan;13;0;3662;63
2021-01-12;SS;South Sudan;8;0;3670;63
2021-01-13;SS;South Sudan;0;0;3670;63
2021-01-14;SS;South Sudan;0;0;3670;63
2021-01-15;SS;South Sudan;0;0;3670;63
2021-01-16;SS;South Sudan;0;0;3670;63
2021-01-17;SS;South Sudan;23;0;3693;63
2021-01-18;SS;South Sudan;10;0;3703;63
2021-01-19;SS;South Sudan;59;1;3762;64
2021-01-20;SS;South Sudan;11;0;3773;64
2021-01-21;SS;South Sudan;15;0;3788;64
2021-01-22;SS;South Sudan;0;0;3788;64
2021-01-23;SS;South Sudan;0;0;3788;64
2021-01-24;SS;South Sudan;0;0;3788;64
2021-01-25;SS;South Sudan;0;0;3788;64
2021-01-26;SS;South Sudan;0;0;3788;64
2021-01-27;SS;South Sudan;0;0;3788;64
2021-01-28;SS;South Sudan;141;0;3929;64
2021-01-29;SS;South Sudan;0;0;3929;64
2021-01-30;SS;South Sudan;0;0;3929;64
2021-01-31;SS;South Sudan;0;0;3929;64
2021-02-01;SS;South Sudan;0;0;3929;64
2021-02-02;SS;South Sudan;0;0;3929;64
2021-02-03;SS;South Sudan;0;0;3929;64
2021-02-04;SS;South Sudan;338;2;4267;66
2021-02-05;SS;South Sudan;88;0;4355;66
2021-02-06;SS;South Sudan;0;0;4355;66
2021-02-07;SS;South Sudan;0;0;4355;66
2021-02-08;SS;South Sudan;254;0;4609;66
2021-02-09;SS;South Sudan;195;3;4804;69
2021-02-10;SS;South Sudan;156;2;4960;71
2021-02-11;SS;South Sudan;0;0;4960;71
2021-02-12;SS;South Sudan;174;1;5134;72
2021-02-13;SS;South Sudan;176;2;5310;74
2021-02-14;SS;South Sudan;103;0;5413;74
2021-02-15;SS;South Sudan;149;3;5562;77
2021-02-16;SS;South Sudan;148;2;5710;79
2021-02-17;SS;South Sudan;212;0;5922;79
2021-02-18;SS;South Sudan;162;4;6084;83
2021-02-19;SS;South Sudan;193;0;6277;83
2021-02-20;SS;South Sudan;140;2;6417;85
2021-02-21;SS;South Sudan;166;1;6583;86
2021-02-22;SS;South Sudan;348;1;6931;87
2021-02-23;SS;South Sudan;167;0;7098;87
2021-02-24;SS;South Sudan;126;0;7224;87
2021-02-25;SS;South Sudan;125;0;7349;87
2021-02-26;SS;South Sudan;248;3;7597;90
2021-02-27;SS;South Sudan;174;3;7771;93
2021-02-28;SS;South Sudan;155;0;7926;93
2021-03-01;SS;South Sudan;84;1;8010;94
2021-03-02;SS;South Sudan;134;1;8144;95
2021-03-03;SS;South Sudan;161;2;8305;97
2021-03-04;SS;South Sudan;109;3;8414;100
2021-03-05;SS;South Sudan;113;0;8527;100
2021-03-06;SS;South Sudan;150;2;8677;102
2021-03-07;SS;South Sudan;89;0;8766;102
2021-03-08;SS;South Sudan;104;0;8870;102
2021-03-09;SS;South Sudan;0;0;8870;102
2021-03-10;SS;South Sudan;0;0;8870;102
2021-03-11;SS;South Sudan;335;1;9205;103
2021-03-12;SS;South Sudan;129;1;9334;104
2021-03-13;SS;South Sudan;95;0;9429;104
2021-03-14;SS;South Sudan;61;0;9490;104
2021-03-15;SS;South Sudan;64;0;9554;104
2021-03-16;SS;South Sudan;59;2;9613;106
2021-03-17;SS;South Sudan;81;0;9694;106
2021-03-18;SS;South Sudan;74;0;9768;106
2021-03-19;SS;South Sudan;41;0;9809;106
2021-03-20;SS;South Sudan;40;0;9849;106
2021-03-21;SS;South Sudan;30;0;9879;106
2021-03-22;SS;South Sudan;11;0;9890;106
2021-03-23;SS;South Sudan;29;0;9919;106
2021-03-24;SS;South Sudan;50;1;9969;107
2021-03-25;SS;South Sudan;79;1;10048;108
2021-03-26;SS;South Sudan;0;0;10048;108
2021-03-27;SS;South Sudan;31;0;10079;108
2021-03-28;SS;South Sudan;19;0;10098;108
2021-03-29;SS;South Sudan;21;0;10119;108
2021-03-30;SS;South Sudan;0;0;10119;108
2021-03-31;SS;South Sudan;46;1;10165;109
2021-04-01;SS;South Sudan;32;3;10197;112
2021-04-02;SS;South Sudan;22;0;10219;112
2021-04-03;SS;South Sudan;36;0;10255;112
2021-04-04;SS;South Sudan;12;1;10267;113
2021-04-05;SS;South Sudan;14;0;10281;113
2021-04-06;SS;South Sudan;5;0;10286;113
2021-04-07;SS;South Sudan;11;0;10297;113
2021-04-08;SS;South Sudan;27;1;10324;114
2021-04-09;SS;South Sudan;16;0;10340;114
2021-04-10;SS;South Sudan;19;0;10359;114
2021-04-11;SS;South Sudan;13;0;10372;114
2021-04-12;SS;South Sudan;9;0;10381;114
2021-04-13;SS;South Sudan;6;0;10387;114
2021-04-14;SS;South Sudan;16;0;10403;114
2021-04-15;SS;South Sudan;13;0;10416;114
2021-04-16;SS;South Sudan;16;0;10432;114
2021-04-17;SS;South Sudan;0;0;10432;114
2021-04-18;SS;South Sudan;41;0;10473;114
2021-04-19;SS;South Sudan;0;0;10473;114
2021-04-20;SS;South Sudan;5;0;10478;114
2021-04-21;SS;South Sudan;8;0;10486;114
2021-04-22;SS;South Sudan;18;0;10504;114
2021-04-23;SS;South Sudan;11;0;10515;114
2021-04-24;SS;South Sudan;0;0;10515;114
2021-04-25;SS;South Sudan;17;0;10532;114
2021-04-26;SS;South Sudan;6;0;10538;114
2021-04-27;SS;South Sudan;15;0;10553;114
2021-04-28;SS;South Sudan;0;0;10553;114
2021-04-29;SS;South Sudan;14;0;10567;114
2021-04-30;SS;South Sudan;16;1;10583;115
2021-05-01;SS;South Sudan;0;0;10583;115
2021-05-02;SS;South Sudan;0;0;10583;115
2021-05-03;SS;South Sudan;19;0;10602;115
2021-05-04;SS;South Sudan;11;0;10613;115
2021-05-05;SS;South Sudan;0;0;10613;115
2021-05-06;SS;South Sudan;7;0;10620;115
2021-05-07;SS;South Sudan;17;0;10637;115
2021-05-08;SS;South Sudan;0;0;10637;115
2021-05-09;SS;South Sudan;0;0;10637;115
2021-05-10;SS;South Sudan;4;0;10641;115
2021-05-11;SS;South Sudan;0;0;10641;115
2021-05-12;SS;South Sudan;0;0;10641;115
2021-05-13;SS;South Sudan;0;0;10641;115
2021-05-14;SS;South Sudan;10;0;10651;115
2021-05-15;SS;South Sudan;1;0;10652;115
2021-05-16;SS;South Sudan;0;0;10652;115
2021-05-17;SS;South Sudan;0;0;10652;115
2021-05-18;SS;South Sudan;0;0;10652;115
2021-05-19;SS;South Sudan;0;0;10652;115
2021-05-20;SS;South Sudan;0;0;10652;115
2021-05-21;SS;South Sudan;0;0;10652;115
2021-05-22;SS;South Sudan;0;0;10652;115
2021-05-23;SS;South Sudan;0;0;10652;115
2021-05-24;SS;South Sudan;0;0;10652;115
2021-05-25;SS;South Sudan;25;0;10677;115
2021-05-26;SS;South Sudan;0;0;10677;115
2021-05-27;SS;South Sudan;11;0;10688;115
2021-05-28;SS;South Sudan;0;0;10688;115
2021-05-29;SS;South Sudan;0;0;10688;115
2021-05-30;SS;South Sudan;0;0;10688;115
2021-05-31;SS;South Sudan;0;0;10688;115
2021-06-01;SS;South Sudan;0;0;10688;115
2021-06-02;SS;South Sudan;0;0;10688;115
2021-06-03;SS;South Sudan;0;0;10688;115
2021-06-04;SS;South Sudan;0;0;10688;115
2021-06-05;SS;South Sudan;0;0;10688;115
2021-06-06;SS;South Sudan;0;0;10688;115
2021-06-07;SS;South Sudan;0;0;10688;115
2021-06-08;SS;South Sudan;0;0;10688;115
2021-06-09;SS;South Sudan;0;0;10688;115
2021-06-10;SS;South Sudan;0;0;10688;115
2021-06-11;SS;South Sudan;0;0;10688;115
2021-06-12;SS;South Sudan;0;0;10688;115
2021-06-13;SS;South Sudan;0;0;10688;115
2021-06-14;SS;South Sudan;0;0;10688;115
2021-06-15;SS;South Sudan;0;0;10688;115
2021-06-16;SS;South Sudan;71;0;10759;115
2021-06-17;SS;South Sudan;5;0;10764;115
2021-06-18;SS;South Sudan;6;0;10770;115
2021-06-19;SS;South Sudan;0;0;10770;115
2021-06-20;SS;South Sudan;0;0;10770;115
2021-06-21;SS;South Sudan;16;0;10786;115
2021-06-22;SS;South Sudan;0;0;10786;115
2021-06-23;SS;South Sudan;0;0;10786;115
2021-06-24;SS;South Sudan;26;0;10812;115
2021-06-25;SS;South Sudan;0;0;10812;115
2021-06-26;SS;South Sudan;0;0;10812;115
2021-06-27;SS;South Sudan;0;0;10812;115
2021-06-28;SS;South Sudan;12;1;10824;116
2021-06-29;SS;South Sudan;10;1;10834;117
2021-06-30;SS;South Sudan;0;0;10834;117
2021-07-01;SS;South Sudan;12;0;10846;117
2020-02-01;ES;Spain;1;0;1;0
2020-02-02;ES;Spain;0;0;1;0
2020-02-03;ES;Spain;0;0;1;0
2020-02-04;ES;Spain;0;0;1;0
2020-02-05;ES;Spain;0;0;1;0
2020-02-06;ES;Spain;0;0;1;0
2020-02-07;ES;Spain;0;0;1;0
2020-02-08;ES;Spain;0;0;1;0
2020-02-09;ES;Spain;1;0;2;0
2020-02-10;ES;Spain;0;0;2;0
2020-02-11;ES;Spain;0;0;2;0
2020-02-12;ES;Spain;0;0;2;0
2020-02-13;ES;Spain;0;0;2;0
2020-02-14;ES;Spain;0;0;2;0
2020-02-15;ES;Spain;0;0;2;0
2020-02-16;ES;Spain;0;0;2;0
2020-02-17;ES;Spain;0;0;2;0
2020-02-18;ES;Spain;0;0;2;0
2020-02-19;ES;Spain;0;0;2;0
2020-02-20;ES;Spain;0;0;2;0
2020-02-21;ES;Spain;0;0;2;0
2020-02-22;ES;Spain;0;0;2;0
2020-02-23;ES;Spain;0;0;2;0
2020-02-24;ES;Spain;0;0;2;0
2020-02-25;ES;Spain;4;0;6;0
2020-02-26;ES;Spain;7;0;13;0
2020-02-27;ES;Spain;2;0;15;0
2020-02-28;ES;Spain;17;0;32;0
2020-02-29;ES;Spain;13;0;45;0
2020-03-01;ES;Spain;39;0;84;0
2020-03-02;ES;Spain;36;0;120;0
2020-03-03;ES;Spain;45;1;165;1
2020-03-04;ES;Spain;57;1;222;2
2020-03-05;ES;Spain;37;1;259;3
2020-03-06;ES;Spain;141;2;400;5
2020-03-07;ES;Spain;100;5;500;10
2020-03-08;ES;Spain;173;7;673;17
2020-03-09;ES;Spain;400;11;1073;28
2020-03-10;ES;Spain;622;7;1695;35
2020-03-11;ES;Spain;582;19;2277;54
2020-03-12;ES;Spain;0;1;2277;55
2020-03-13;ES;Spain;2955;78;5232;133
2020-03-14;ES;Spain;1159;62;6391;195
2020-03-15;ES;Spain;1407;94;7798;289
2020-03-16;ES;Spain;2144;53;9942;342
2020-03-17;ES;Spain;1806;191;11748;533
2020-03-18;ES;Spain;2162;90;13910;623
2020-03-19;ES;Spain;4053;207;17963;830
2020-03-20;ES;Spain;2447;213;20410;1043
2020-03-21;ES;Spain;4964;332;25374;1375
2020-03-22;ES;Spain;3394;397;28768;1772
2020-03-23;ES;Spain;6368;539;35136;2311
2020-03-24;ES;Spain;4749;497;39885;2808
2020-03-25;ES;Spain;9630;839;49515;3647
2020-03-26;ES;Spain;8271;718;57786;4365
2020-03-27;ES;Spain;7933;773;65719;5138
2020-03-28;ES;Spain;7516;844;73235;5982
2020-03-29;ES;Spain;6875;821;80110;6803
2020-03-30;ES;Spain;7846;913;87956;7716
2020-03-31;ES;Spain;7967;748;95923;8464
2020-04-01;ES;Spain;8195;923;104118;9387
2020-04-02;ES;Spain;7947;961;112065;10348
2020-04-03;ES;Spain;7134;850;119199;11198
2020-04-04;ES;Spain;6969;749;126168;11947
2020-04-05;ES;Spain;5478;694;131646;12641
2020-04-06;ES;Spain;5029;700;136675;13341
2020-04-07;ES;Spain;5267;704;141942;14045
2020-04-08;ES;Spain;6278;747;148220;14792
2020-04-09;ES;Spain;5002;655;153222;15447
2020-04-10;ES;Spain;5051;634;158273;16081
2020-04-11;ES;Spain;4754;525;163027;16606
2020-04-12;ES;Spain;3804;603;166831;17209
2020-04-13;ES;Spain;3268;547;170099;17756
2020-04-14;ES;Spain;2442;300;172541;18056
2020-04-15;ES;Spain;5103;652;177644;18708
2020-04-16;ES;Spain;7304;607;184948;19315
2020-04-17;ES;Spain;5891;687;190839;20002
2020-04-18;ES;Spain;887;41;191726;20043
2020-04-19;ES;Spain;6948;410;198674;20453
2020-04-20;ES;Spain;1536;399;200210;20852
2020-04-21;ES;Spain;3968;430;204178;21282
2020-04-22;ES;Spain;4211;435;208389;21717
2020-04-23;ES;Spain;4635;440;213024;22157
2020-04-24;ES;Spain;-10034;367;202990;22524
2020-04-25;ES;Spain;2915;378;205905;22902
2020-04-26;ES;Spain;1729;288;207634;23190
2020-04-27;ES;Spain;1831;331;209465;23521
2020-04-28;ES;Spain;1308;301;210773;23822
2020-04-29;ES;Spain;2144;453;212917;24275
2020-04-30;ES;Spain;518;268;213435;24543
2020-05-01;ES;Spain;1781;0;215216;24543
2020-05-02;ES;Spain;1366;557;216582;25100
2020-05-03;ES;Spain;884;164;217466;25264
2020-05-04;ES;Spain;545;164;218011;25428
2020-05-05;ES;Spain;1318;185;219329;25613
2020-05-06;ES;Spain;996;244;220325;25857
2020-05-07;ES;Spain;1122;213;221447;26070
2020-05-08;ES;Spain;1410;229;222857;26299
2020-05-09;ES;Spain;721;179;223578;26478
2020-05-10;ES;Spain;772;143;224350;26621
2020-05-11;ES;Spain;3086;123;227436;26744
2020-05-12;ES;Spain;594;176;228030;26920
2020-05-13;ES;Spain;661;184;228691;27104
2020-05-14;ES;Spain;849;217;229540;27321
2020-05-15;ES;Spain;643;138;230183;27459
2020-05-16;ES;Spain;515;104;230698;27563
2020-05-17;ES;Spain;0;0;230698;27563
2020-05-18;ES;Spain;908;146;231606;27709
2020-05-19;ES;Spain;431;69;232037;27778
2020-05-20;ES;Spain;518;110;232555;27888
2020-05-21;ES;Spain;482;52;233037;27940
2020-05-22;ES;Spain;1787;688;234824;28628
2020-05-23;ES;Spain;466;50;235290;28678
2020-05-24;ES;Spain;482;74;235772;28752
2020-05-25;ES;Spain;-372;-1918;235400;26834
2020-05-26;ES;Spain;859;283;236259;27117
2020-05-27;ES;Spain;0;0;236259;27117
2020-05-28;ES;Spain;1647;2;237906;27119
2020-05-29;ES;Spain;658;2;238564;27121
2020-05-30;ES;Spain;664;4;239228;27125
2020-05-31;ES;Spain;251;2;239479;27127
2020-06-01;ES;Spain;159;0;239638;27127
2020-06-02;ES;Spain;294;0;239932;27127
2020-06-03;ES;Spain;394;1;240326;27128
2020-06-04;ES;Spain;334;5;240660;27133
2020-06-05;ES;Spain;318;1;240978;27134
2020-06-06;ES;Spain;332;1;241310;27135
2020-06-07;ES;Spain;240;1;241550;27136
2020-06-08;ES;Spain;167;0;241717;27136
2020-06-09;ES;Spain;249;0;241966;27136
2020-06-10;ES;Spain;314;0;242280;27136
2020-06-11;ES;Spain;427;0;242707;27136
2020-06-12;ES;Spain;502;0;243209;27136
2020-06-13;ES;Spain;396;0;243605;27136
2020-06-14;ES;Spain;323;0;243928;27136
2020-06-15;ES;Spain;181;0;244109;27136
2020-06-16;ES;Spain;219;0;244328;27136
2020-06-17;ES;Spain;355;0;244683;27136
2020-06-18;ES;Spain;585;0;245268;27136
2020-06-19;ES;Spain;307;1179;245575;28315
2020-06-20;ES;Spain;363;7;245938;28322
2020-06-21;ES;Spain;334;1;246272;28323
2020-06-22;ES;Spain;232;1;246504;28324
2020-06-23;ES;Spain;248;1;246752;28325
2020-06-24;ES;Spain;334;2;247086;28327
2020-06-25;ES;Spain;400;3;247486;28330
2020-06-26;ES;Spain;419;8;247905;28338
2020-06-27;ES;Spain;564;3;248469;28341
2020-06-28;ES;Spain;301;2;248770;28343
2020-06-29;ES;Spain;200;3;248970;28346
2020-06-30;ES;Spain;301;9;249271;28355
2020-07-01;ES;Spain;388;9;249659;28364
2020-07-02;ES;Spain;444;4;250103;28368
2020-07-03;ES;Spain;442;17;250545;28385
2020-07-04;ES;Spain;0;0;250545;28385
2020-07-05;ES;Spain;0;0;250545;28385
2020-07-06;ES;Spain;1244;3;251789;28388
2020-07-07;ES;Spain;341;4;252130;28392
2020-07-08;ES;Spain;383;4;252513;28396
2020-07-09;ES;Spain;543;5;253056;28401
2020-07-10;ES;Spain;852;2;253908;28403
2020-07-11;ES;Spain;0;0;253908;28403
2020-07-12;ES;Spain;0;0;253908;28403
2020-07-13;ES;Spain;2045;3;255953;28406
2020-07-14;ES;Spain;666;3;256619;28409
2020-07-15;ES;Spain;875;4;257494;28413
2020-07-16;ES;Spain;1361;3;258855;28416
2020-07-17;ES;Spain;1400;4;260255;28420
2020-07-18;ES;Spain;0;0;260255;28420
2020-07-19;ES;Spain;0;0;260255;28420
2020-07-20;ES;Spain;4581;2;264836;28422
2020-07-21;ES;Spain;1358;2;266194;28424
2020-07-22;ES;Spain;1357;2;267551;28426
2020-07-23;ES;Spain;2615;3;270166;28429
2020-07-24;ES;Spain;2255;3;272421;28432
2020-07-25;ES;Spain;0;0;272421;28432
2020-07-26;ES;Spain;0;0;272421;28432
2020-07-27;ES;Spain;6361;2;278782;28434
2020-07-28;ES;Spain;1828;2;280610;28436
2020-07-29;ES;Spain;2031;5;282641;28441
2020-07-30;ES;Spain;2789;2;285430;28443
2020-07-31;ES;Spain;3092;2;288522;28445
2020-08-01;ES;Spain;0;0;288522;28445
2020-08-02;ES;Spain;0;0;288522;28445
2020-08-03;ES;Spain;8532;27;297054;28472
2020-08-04;ES;Spain;5760;26;302814;28498
2020-08-05;ES;Spain;2953;1;305767;28499
2020-08-06;ES;Spain;4088;1;309855;28500
2020-08-07;ES;Spain;4507;3;314362;28503
2020-08-08;ES;Spain;0;0;314362;28503
2020-08-09;ES;Spain;0;0;314362;28503
2020-08-10;ES;Spain;8618;73;322980;28576
2020-08-11;ES;Spain;3632;5;326612;28581
2020-08-12;ES;Spain;3172;-2;329784;28579
2020-08-13;ES;Spain;7550;26;337334;28605
2020-08-14;ES;Spain;5479;12;342813;28617
2020-08-15;ES;Spain;0;0;342813;28617
2020-08-16;ES;Spain;0;0;342813;28617
2020-08-17;ES;Spain;16269;29;359082;28646
2020-08-18;ES;Spain;5114;24;364196;28670
2020-08-19;ES;Spain;6671;127;370867;28797
2020-08-20;ES;Spain;7039;16;377906;28813
2020-08-21;ES;Spain;8148;25;386054;28838
2020-08-22;ES;Spain;0;0;386054;28838
2020-08-23;ES;Spain;0;0;386054;28838
2020-08-24;ES;Spain;19382;34;405436;28872
2020-08-25;ES;Spain;7117;52;412553;28924
2020-08-26;ES;Spain;7296;47;419849;28971
2020-08-27;ES;Spain;9658;25;429507;28996
2020-08-28;ES;Spain;9779;15;439286;29011
2020-08-29;ES;Spain;0;0;439286;29011
2020-08-30;ES;Spain;0;0;439286;29011
2020-08-31;ES;Spain;23572;83;462858;29094
2020-09-01;ES;Spain;8115;58;470973;29152
2020-09-02;ES;Spain;8581;42;479554;29194
2020-09-03;ES;Spain;8959;40;488513;29234
2020-09-04;ES;Spain;10476;184;498989;29418
2020-09-05;ES;Spain;0;0;498989;29418
2020-09-06;ES;Spain;0;0;498989;29418
2020-09-07;ES;Spain;26560;98;525549;29516
2020-09-08;ES;Spain;8964;78;534513;29594
2020-09-09;ES;Spain;8866;34;543379;29628
2020-09-10;ES;Spain;10764;71;554143;29699
2020-09-11;ES;Spain;12183;48;566326;29747
2020-09-12;ES;Spain;0;0;566326;29747
2020-09-13;ES;Spain;0;0;566326;29747
2020-09-14;ES;Spain;27404;101;593730;29848
2020-09-15;ES;Spain;9437;156;603167;30004
2020-09-16;ES;Spain;11193;239;614360;30243
2020-09-17;ES;Spain;11291;162;625651;30405
2020-09-18;ES;Spain;14389;90;640040;30495
2020-09-19;ES;Spain;0;0;640040;30495
2020-09-20;ES;Spain;0;0;640040;30495
2020-09-21;ES;Spain;31428;168;671468;30663
2020-09-22;ES;Spain;10799;241;682267;30904
2020-09-23;ES;Spain;11289;130;693556;31034
2020-09-24;ES;Spain;10653;84;704209;31118
2020-09-25;ES;Spain;12272;114;716481;31232
2020-09-26;ES;Spain;0;0;716481;31232
2020-09-27;ES;Spain;0;0;716481;31232
2020-09-28;ES;Spain;31785;179;748266;31411
2020-09-29;ES;Spain;0;0;748266;31411
2020-09-30;ES;Spain;20922;380;769188;31791
2020-10-01;ES;Spain;9419;182;778607;31973
2020-10-02;ES;Spain;11325;113;789932;32086
2020-10-03;ES;Spain;0;0;789932;32086
2020-10-04;ES;Spain;0;0;789932;32086
2020-10-05;ES;Spain;23480;139;813412;32225
2020-10-06;ES;Spain;11998;261;825410;32486
2020-10-07;ES;Spain;10491;76;835901;32562
2020-10-08;ES;Spain;12423;126;848324;32688
2020-10-09;ES;Spain;12788;241;861112;32929
2020-10-10;ES;Spain;0;0;861112;32929
2020-10-11;ES;Spain;0;0;861112;32929
2020-10-12;ES;Spain;27856;195;888968;33124
2020-10-13;ES;Spain;7118;80;896086;33204
2020-10-14;ES;Spain;11970;209;908056;33413
2020-10-15;ES;Spain;13318;140;921374;33553
2020-10-16;ES;Spain;15186;222;936560;33775
2020-10-17;ES;Spain;0;0;936560;33775
2020-10-18;ES;Spain;0;0;936560;33775
2020-10-19;ES;Spain;37889;217;974449;33992
2020-10-20;ES;Spain;13873;218;988322;34210
2020-10-21;ES;Spain;16973;156;1005295;34366
2020-10-22;ES;Spain;20986;155;1026281;34521
2020-10-23;ES;Spain;19851;231;1046132;34752
2020-10-24;ES;Spain;0;0;1046132;34752
2020-10-25;ES;Spain;0;0;1046132;34752
2020-10-26;ES;Spain;52188;279;1098320;35031
2020-10-27;ES;Spain;18418;267;1116738;35298
2020-10-28;ES;Spain;19765;168;1136503;35466
2020-10-29;ES;Spain;23580;173;1160083;35639
2020-10-30;ES;Spain;25595;239;1185678;35878
2020-10-31;ES;Spain;0;0;1185678;35878
2020-11-01;ES;Spain;0;0;1185678;35878
2020-11-02;ES;Spain;55019;379;1240697;36257
2020-11-03;ES;Spain;18669;238;1259366;36495
2020-11-04;ES;Spain;25042;1623;1284408;38118
2020-11-05;ES;Spain;21908;368;1306316;38486
2020-11-06;ES;Spain;22516;347;1328832;38833
2020-11-07;ES;Spain;0;0;1328832;38833
2020-11-08;ES;Spain;0;0;1328832;38833
2020-11-09;ES;Spain;52386;512;1381218;39345
2020-11-10;ES;Spain;0;0;1381218;39345
2020-11-11;ES;Spain;36491;760;1417709;40105
2020-11-12;ES;Spain;19511;356;1437220;40461
2020-11-13;ES;Spain;21371;308;1458591;40769
2020-11-14;ES;Spain;0;0;1458591;40769
2020-11-15;ES;Spain;0;0;1458591;40769
2020-11-16;ES;Spain;38273;484;1496864;41253
2020-11-17;ES;Spain;13159;435;1510023;41688
2020-11-18;ES;Spain;15318;351;1525341;42039
2020-11-19;ES;Spain;16233;252;1541574;42291
2020-11-20;ES;Spain;15156;328;1556730;42619
2020-11-21;ES;Spain;0;0;1556730;42619
2020-11-22;ES;Spain;0;0;1556730;42619
2020-11-23;ES;Spain;25886;512;1582616;43131
2020-11-24;ES;Spain;12228;537;1594844;43668
2020-11-25;ES;Spain;10222;369;1605066;44037
2020-11-26;ES;Spain;12289;337;1617355;44374
2020-11-27;ES;Spain;10853;294;1628208;44668
2020-11-28;ES;Spain;0;0;1628208;44668
2020-11-29;ES;Spain;0;0;1628208;44668
2020-11-30;ES;Spain;19979;401;1648187;45069
2020-12-01;ES;Spain;8257;442;1656444;45511
2020-12-02;ES;Spain;9331;273;1665775;45784
2020-12-03;ES;Spain;10127;254;1675902;46038
2020-12-04;ES;Spain;8745;214;1684647;46252
2020-12-05;ES;Spain;0;0;1684647;46252
2020-12-06;ES;Spain;0;0;1684647;46252
2020-12-07;ES;Spain;17681;394;1702328;46646
2020-12-08;ES;Spain;0;0;1702328;46646
2020-12-09;ES;Spain;9773;373;1712101;47019
2020-12-10;ES;Spain;7955;325;1720056;47344
2020-12-11;ES;Spain;10519;280;1730575;47624
2020-12-12;ES;Spain;0;0;1730575;47624
2020-12-13;ES;Spain;0;0;1730575;47624
2020-12-14;ES;Spain;21309;389;1751884;48013
2020-12-15;ES;Spain;10328;388;1762212;48401
2020-12-16;ES;Spain;11078;195;1773290;48596
2020-12-17;ES;Spain;12131;181;1785421;48777
2020-12-18;ES;Spain;11815;149;1797236;48926
2020-12-19;ES;Spain;0;0;1797236;48926
2020-12-20;ES;Spain;0;0;1797236;48926
2020-12-21;ES;Spain;22013;334;1819249;49260
2020-12-22;ES;Spain;10654;260;1829903;49520
2020-12-23;ES;Spain;12386;178;1842289;49698
2020-12-24;ES;Spain;12662;126;1854951;49824
2020-12-25;ES;Spain;0;0;1854951;49824
2020-12-26;ES;Spain;0;0;1854951;49824
2020-12-27;ES;Spain;0;0;1854951;49824
2020-12-28;ES;Spain;24462;298;1879413;50122
2020-12-29;ES;Spain;14089;320;1893502;50442
2020-12-30;ES;Spain;16716;247;1910218;50689
2020-12-31;ES;Spain;18047;148;1928265;50837
2021-01-01;ES;Spain;0;0;1928265;50837
2021-01-02;ES;Spain;0;0;1928265;50837
2021-01-03;ES;Spain;0;0;1928265;50837
2021-01-04;ES;Spain;30579;241;1958844;51078
2021-01-05;ES;Spain;23700;352;1982544;51430
2021-01-06;ES;Spain;0;0;1982544;51430
2021-01-07;ES;Spain;42360;245;2024904;51675
2021-01-08;ES;Spain;25456;199;2050360;51874
2021-01-09;ES;Spain;0;0;2050360;51874
2021-01-10;ES;Spain;0;0;2050360;51874
2021-01-11;ES;Spain;61422;401;2111782;52275
2021-01-12;ES;Spain;25438;408;2137220;52683
2021-01-13;ES;Spain;38869;195;2176089;52878
2021-01-14;ES;Spain;35878;201;2211967;53079
2021-01-15;ES;Spain;40197;235;2252164;53314
2021-01-16;ES;Spain;0;0;2252164;53314
2021-01-17;ES;Spain;0;0;2252164;53314
2021-01-18;ES;Spain;84287;455;2336451;53769
2021-01-19;ES;Spain;34291;404;2370742;54173
2021-01-20;ES;Spain;41576;464;2412318;54637
2021-01-21;ES;Spain;44357;404;2456675;55041
2021-01-22;ES;Spain;42885;400;2499560;55441
2021-01-23;ES;Spain;0;0;2499560;55441
2021-01-24;ES;Spain;0;0;2499560;55441
2021-01-25;ES;Spain;93822;767;2593382;56208
2021-01-26;ES;Spain;36435;586;2629817;56794
2021-01-27;ES;Spain;40285;497;2670102;57291
2021-01-28;ES;Spain;34899;515;2705001;57806
2021-01-29;ES;Spain;38118;513;2743119;58319
2021-01-30;ES;Spain;0;0;2743119;58319
2021-01-31;ES;Spain;0;0;2743119;58319
2021-02-01;ES;Spain;79686;762;2822805;59081
2021-02-02;ES;Spain;29064;724;2851869;59805
2021-02-03;ES;Spain;31596;565;2883465;60370
2021-02-04;ES;Spain;29960;432;2913425;60802
2021-02-05;ES;Spain;28565;584;2941990;61386
2021-02-06;ES;Spain;0;0;2941990;61386
2021-02-07;ES;Spain;0;0;2941990;61386
2021-02-08;ES;Spain;47095;909;2989085;62295
2021-02-09;ES;Spain;16402;766;3005487;63061
2021-02-10;ES;Spain;18114;643;3023601;63704
2021-02-11;ES;Spain;17853;513;3041454;64217
2021-02-12;ES;Spain;14581;530;3056035;64747
2021-02-13;ES;Spain;0;0;3056035;64747
2021-02-14;ES;Spain;0;0;3056035;64747
2021-02-15;ES;Spain;30251;702;3086286;65449
2021-02-16;ES;Spain;10057;530;3096343;65979
2021-02-17;ES;Spain;10829;337;3107172;66316
2021-02-18;ES;Spain;14515;388;3121687;66704
2021-02-19;ES;Spain;11435;397;3133122;67101
2021-02-20;ES;Spain;0;0;3133122;67101
2021-02-21;ES;Spain;0;0;3133122;67101
2021-02-22;ES;Spain;20849;535;3153971;67636
2021-02-23;ES;Spain;7461;443;3161432;68079
2021-02-24;ES;Spain;9212;389;3170644;68468
2021-02-25;ES;Spain;9568;345;3180212;68813
2021-02-26;ES;Spain;8341;329;3188553;69142
2021-02-27;ES;Spain;0;0;3188553;69142
2021-02-28;ES;Spain;0;0;3188553;69142
2021-03-01;ES;Spain;15978;467;3204531;69609
2021-03-02;ES;Spain;-74347;192;3130184;69801
2021-03-03;ES;Spain;6137;446;3136321;70247
2021-03-04;ES;Spain;6037;254;3142358;70501
2021-03-05;ES;Spain;6654;637;3149012;71138
2021-03-06;ES;Spain;0;0;3149012;71138
2021-03-07;ES;Spain;0;0;3149012;71138
2021-03-08;ES;Spain;11958;298;3160970;71436
2021-03-09;ES;Spain;4012;291;3164982;71727
2021-03-10;ES;Spain;7119;234;3172101;71961
2021-03-11;ES;Spain;6255;124;3178356;72085
2021-03-12;ES;Spain;5348;173;3183704;72258
2021-03-13;ES;Spain;0;0;3183704;72258
2021-03-14;ES;Spain;0;0;3183704;72258
2021-03-15;ES;Spain;11358;166;3195062;72424
2021-03-16;ES;Spain;4962;141;3200024;72565
2021-03-17;ES;Spain;6092;228;3206116;72793
2021-03-18;ES;Spain;6216;117;3212332;72910
2021-03-19;ES;Spain;0;0;3212332;72910
2021-03-20;ES;Spain;0;0;3212332;72910
2021-03-21;ES;Spain;0;0;3212332;72910
2021-03-22;ES;Spain;16471;633;3228803;73543
2021-03-23;ES;Spain;5516;201;3234319;73744
2021-03-24;ES;Spain;0;0;3234319;73744
2021-03-25;ES;Spain;13419;676;3247738;74420
2021-03-26;ES;Spain;7586;590;3255324;75010
2021-03-27;ES;Spain;0;0;3255324;75010
2021-03-28;ES;Spain;0;0;3255324;75010
2021-03-29;ES;Spain;15501;189;3270825;75199
2021-03-30;ES;Spain;4994;106;3275819;75305
2021-03-31;ES;Spain;8534;154;3284353;75459
2021-04-01;ES;Spain;7041;82;3291394;75541
2021-04-02;ES;Spain;0;0;3291394;75541
2021-04-03;ES;Spain;9571;157;3300965;75698
2021-04-04;ES;Spain;0;0;3300965;75698
2021-04-05;ES;Spain;10360;85;3311325;75783
2021-04-06;ES;Spain;6623;128;3317948;75911
2021-04-07;ES;Spain;8788;126;3326736;76037
2021-04-08;ES;Spain;9901;142;3336637;76179
2021-04-09;ES;Spain;10875;149;3347512;76328
2021-04-10;ES;Spain;0;0;3347512;76328
2021-04-11;ES;Spain;0;0;3347512;76328
2021-04-12;ES;Spain;22744;197;3370256;76525
2021-04-13;ES;Spain;6292;100;3376548;76625
2021-04-14;ES;Spain;10474;131;3387022;76756
2021-04-15;ES;Spain;9663;126;3396685;76882
2021-04-16;ES;Spain;10598;99;3407283;76981
2021-04-17;ES;Spain;0;0;3407283;76981
2021-04-18;ES;Spain;0;0;3407283;76981
2021-04-19;ES;Spain;21071;121;3428354;77102
2021-04-20;ES;Spain;0;0;3428354;77102
2021-04-21;ES;Spain;17718;262;3446072;77364
2021-04-22;ES;Spain;10814;132;3456886;77496
2021-04-23;ES;Spain;11731;95;3468617;77591
2021-04-24;ES;Spain;0;0;3468617;77591
2021-04-25;ES;Spain;0;0;3468617;77591
2021-04-26;ES;Spain;19852;147;3488469;77738
2021-04-27;ES;Spain;7665;117;3496134;77855
2021-04-28;ES;Spain;8665;88;3504799;77943
2021-04-29;ES;Spain;10143;137;3514942;78080
2021-04-30;ES;Spain;9135;136;3524077;78216
2021-05-01;ES;Spain;0;0;3524077;78216
2021-05-02;ES;Spain;0;0;3524077;78216
2021-05-03;ES;Spain;16353;77;3540430;78293
2021-05-04;ES;Spain;4515;106;3544945;78399
2021-05-05;ES;Spain;6317;167;3551262;78566
2021-05-06;ES;Spain;7960;160;3559222;78726
2021-05-07;ES;Spain;8186;66;3567408;78792
2021-05-08;ES;Spain;0;0;3567408;78792
2021-05-09;ES;Spain;0;0;3567408;78792
2021-05-10;ES;Spain;13984;103;3581392;78895
2021-05-11;ES;Spain;4941;205;3586333;79100
2021-05-12;ES;Spain;6418;108;3592751;79208
2021-05-13;ES;Spain;5701;73;3598452;79281
2021-05-14;ES;Spain;6347;58;3604799;79339
2021-05-15;ES;Spain;0;0;3604799;79339
2021-05-16;ES;Spain;0;0;3604799;79339
2021-05-17;ES;Spain;11061;93;3615860;79432
2021-05-18;ES;Spain;3988;70;3619848;79502
2021-05-19;ES;Spain;6080;66;3625928;79568
2021-05-20;ES;Spain;5733;33;3631661;79601
2021-05-21;ES;Spain;4792;19;3636453;79620
2021-05-22;ES;Spain;0;0;3636453;79620
2021-05-23;ES;Spain;0;0;3636453;79620
2021-05-24;ES;Spain;11067;91;3647520;79711
2021-05-25;ES;Spain;5359;90;3652879;79801
2021-05-26;ES;Spain;5007;54;3657886;79855
2021-05-27;ES;Spain;5290;33;3663176;79888
2021-05-28;ES;Spain;5482;17;3668658;79905
2021-05-29;ES;Spain;0;0;3668658;79905
2021-05-30;ES;Spain;0;0;3668658;79905
2021-05-31;ES;Spain;9732;48;3678390;79953
2021-06-01;ES;Spain;4388;30;3682778;79983
2021-06-02;ES;Spain;4984;66;3687762;80049
2021-06-03;ES;Spain;5250;0;3693012;80049
2021-06-04;ES;Spain;4969;146;3697981;80195
2021-06-05;ES;Spain;0;1;3697981;80196
2021-06-06;ES;Spain;0;0;3697981;80196
2021-06-07;ES;Spain;9542;40;3707523;80236
2021-06-08;ES;Spain;3504;73;3711027;80309
2021-06-09;ES;Spain;4427;23;3715454;80332
2021-06-10;ES;Spain;14004;133;3729458;80465
2021-06-11;ES;Spain;4142;36;3733600;80501
2021-06-12;ES;Spain;0;0;3733600;80501
2021-06-13;ES;Spain;0;0;3733600;80501
2021-06-14;ES;Spain;8167;16;3741767;80517
2021-06-15;ES;Spain;3432;62;3745199;80579
2021-06-16;ES;Spain;3832;36;3749031;80615
2021-06-17;ES;Spain;4197;19;3753228;80634
2021-06-18;ES;Spain;4214;18;3757442;80652
2021-06-19;ES;Spain;0;0;3757442;80652
2021-06-20;ES;Spain;0;0;3757442;80652
2021-06-21;ES;Spain;7209;37;3764651;80689
2021-06-22;ES;Spain;4040;30;3768691;80719
2021-06-23;ES;Spain;4341;29;3773032;80748
2021-06-24;ES;Spain;4507;18;3777539;80766
2021-06-25;ES;Spain;4924;13;3782463;80779
2021-06-26;ES;Spain;0;0;3782463;80779
2021-06-27;ES;Spain;0;0;3782463;80779
2021-06-28;ES;Spain;10179;10;3792642;80789
2021-06-29;ES;Spain;7091;40;3799733;80829
2021-06-30;ES;Spain;9227;46;3808960;80875
2021-07-01;ES;Spain;12345;8;3821305;80883
2020-01-27;LK;Sri Lanka;1;0;1;0
2020-01-28;LK;Sri Lanka;0;0;1;0
2020-01-29;LK;Sri Lanka;0;0;1;0
2020-01-30;LK;Sri Lanka;0;0;1;0
2020-01-31;LK;Sri Lanka;0;0;1;0
2020-02-01;LK;Sri Lanka;0;0;1;0
2020-02-02;LK;Sri Lanka;0;0;1;0
2020-02-03;LK;Sri Lanka;0;0;1;0
2020-02-04;LK;Sri Lanka;0;0;1;0
2020-02-05;LK;Sri Lanka;0;0;1;0
2020-02-06;LK;Sri Lanka;0;0;1;0
2020-02-07;LK;Sri Lanka;0;0;1;0
2020-02-08;LK;Sri Lanka;0;0;1;0
2020-02-09;LK;Sri Lanka;0;0;1;0
2020-02-10;LK;Sri Lanka;0;0;1;0
2020-02-11;LK;Sri Lanka;0;0;1;0
2020-02-12;LK;Sri Lanka;0;0;1;0
2020-02-13;LK;Sri Lanka;0;0;1;0
2020-02-14;LK;Sri Lanka;0;0;1;0
2020-02-15;LK;Sri Lanka;0;0;1;0
2020-02-16;LK;Sri Lanka;0;0;1;0
2020-02-17;LK;Sri Lanka;0;0;1;0
2020-02-18;LK;Sri Lanka;0;0;1;0
2020-02-19;LK;Sri Lanka;0;0;1;0
2020-02-20;LK;Sri Lanka;0;0;1;0
2020-02-21;LK;Sri Lanka;0;0;1;0
2020-02-22;LK;Sri Lanka;0;0;1;0
2020-02-23;LK;Sri Lanka;0;0;1;0
2020-02-24;LK;Sri Lanka;0;0;1;0
2020-02-25;LK;Sri Lanka;0;0;1;0
2020-02-26;LK;Sri Lanka;0;0;1;0
2020-02-27;LK;Sri Lanka;0;0;1;0
2020-02-28;LK;Sri Lanka;0;0;1;0
2020-02-29;LK;Sri Lanka;0;0;1;0
2020-03-01;LK;Sri Lanka;0;0;1;0
2020-03-02;LK;Sri Lanka;0;0;1;0
2020-03-03;LK;Sri Lanka;0;0;1;0
2020-03-04;LK;Sri Lanka;0;0;1;0
2020-03-05;LK;Sri Lanka;0;0;1;0
2020-03-06;LK;Sri Lanka;0;0;1;0
2020-03-07;LK;Sri Lanka;0;0;1;0
2020-03-08;LK;Sri Lanka;0;0;1;0
2020-03-09;LK;Sri Lanka;0;0;1;0
2020-03-10;LK;Sri Lanka;0;0;1;0
2020-03-11;LK;Sri Lanka;1;0;2;0
2020-03-12;LK;Sri Lanka;0;0;2;0
2020-03-13;LK;Sri Lanka;4;0;6;0
2020-03-14;LK;Sri Lanka;4;0;10;0
2020-03-15;LK;Sri Lanka;8;0;18;0
2020-03-16;LK;Sri Lanka;10;0;28;0
2020-03-17;LK;Sri Lanka;16;0;44;0
2020-03-18;LK;Sri Lanka;7;0;51;0
2020-03-19;LK;Sri Lanka;9;0;60;0
2020-03-20;LK;Sri Lanka;13;0;73;0
2020-03-21;LK;Sri Lanka;4;0;77;0
2020-03-22;LK;Sri Lanka;5;0;82;0
2020-03-23;LK;Sri Lanka;15;0;97;0
2020-03-24;LK;Sri Lanka;5;0;102;0
2020-03-25;LK;Sri Lanka;0;0;102;0
2020-03-26;LK;Sri Lanka;4;0;106;0
2020-03-27;LK;Sri Lanka;0;0;106;0
2020-03-28;LK;Sri Lanka;7;1;113;1
2020-03-29;LK;Sri Lanka;4;0;117;1
2020-03-30;LK;Sri Lanka;5;1;122;2
2020-03-31;LK;Sri Lanka;21;0;143;2
2020-04-01;LK;Sri Lanka;3;1;146;3
2020-04-02;LK;Sri Lanka;5;1;151;4
2020-04-03;LK;Sri Lanka;8;0;159;4
2020-04-04;LK;Sri Lanka;7;1;166;5
2020-04-05;LK;Sri Lanka;10;0;176;5
2020-04-06;LK;Sri Lanka;2;0;178;5
2020-04-07;LK;Sri Lanka;7;1;185;6
2020-04-08;LK;Sri Lanka;4;1;189;7
2020-04-09;LK;Sri Lanka;1;0;190;7
2020-04-10;LK;Sri Lanka;0;0;190;7
2020-04-11;LK;Sri Lanka;8;0;198;7
2020-04-12;LK;Sri Lanka;12;0;210;7
2020-04-13;LK;Sri Lanka;7;0;217;7
2020-04-14;LK;Sri Lanka;16;0;233;7
2020-04-15;LK;Sri Lanka;5;0;238;7
2020-04-16;LK;Sri Lanka;0;0;238;7
2020-04-17;LK;Sri Lanka;6;0;244;7
2020-04-18;LK;Sri Lanka;10;0;254;7
2020-04-19;LK;Sri Lanka;17;0;271;7
2020-04-20;LK;Sri Lanka;33;0;304;7
2020-04-21;LK;Sri Lanka;6;0;310;7
2020-04-22;LK;Sri Lanka;20;0;330;7
2020-04-23;LK;Sri Lanka;38;0;368;7
2020-04-24;LK;Sri Lanka;52;0;420;7
2020-04-25;LK;Sri Lanka;40;0;460;7
2020-04-26;LK;Sri Lanka;63;0;523;7
2020-04-27;LK;Sri Lanka;65;0;588;7
2020-04-28;LK;Sri Lanka;31;0;619;7
2020-04-29;LK;Sri Lanka;30;0;649;7
2020-04-30;LK;Sri Lanka;14;0;663;7
2020-05-01;LK;Sri Lanka;27;0;690;7
2020-05-02;LK;Sri Lanka;15;0;705;7
2020-05-03;LK;Sri Lanka;13;0;718;7
2020-05-04;LK;Sri Lanka;33;1;751;8
2020-05-05;LK;Sri Lanka;20;1;771;9
2020-05-06;LK;Sri Lanka;26;0;797;9
2020-05-07;LK;Sri Lanka;27;0;824;9
2020-05-08;LK;Sri Lanka;11;0;835;9
2020-05-09;LK;Sri Lanka;12;0;847;9
2020-05-10;LK;Sri Lanka;16;0;863;9
2020-05-11;LK;Sri Lanka;6;0;869;9
2020-05-12;LK;Sri Lanka;20;0;889;9
2020-05-13;LK;Sri Lanka;26;0;915;9
2020-05-14;LK;Sri Lanka;10;0;925;9
2020-05-15;LK;Sri Lanka;10;0;935;9
2020-05-16;LK;Sri Lanka;25;0;960;9
2020-05-17;LK;Sri Lanka;21;0;981;9
2020-05-18;LK;Sri Lanka;11;0;992;9
2020-05-19;LK;Sri Lanka;35;0;1027;9
2020-05-20;LK;Sri Lanka;1;0;1028;9
2020-05-21;LK;Sri Lanka;27;0;1055;9
2020-05-22;LK;Sri Lanka;13;0;1068;9
2020-05-23;LK;Sri Lanka;21;0;1089;9
2020-05-24;LK;Sri Lanka;52;0;1141;9
2020-05-25;LK;Sri Lanka;41;1;1182;10
2020-05-26;LK;Sri Lanka;137;0;1319;10
2020-05-27;LK;Sri Lanka;150;0;1469;10
2020-05-28;LK;Sri Lanka;61;0;1530;10
2020-05-29;LK;Sri Lanka;28;0;1558;10
2020-05-30;LK;Sri Lanka;62;0;1620;10
2020-05-31;LK;Sri Lanka;13;0;1633;10
2020-06-01;LK;Sri Lanka;10;1;1643;11
2020-06-02;LK;Sri Lanka;40;0;1683;11
2020-06-03;LK;Sri Lanka;66;0;1749;11
2020-06-04;LK;Sri Lanka;48;0;1797;11
2020-06-05;LK;Sri Lanka;4;0;1801;11
2020-06-06;LK;Sri Lanka;13;0;1814;11
2020-06-07;LK;Sri Lanka;21;0;1835;11
2020-06-08;LK;Sri Lanka;22;0;1857;11
2020-06-09;LK;Sri Lanka;2;0;1859;11
2020-06-10;LK;Sri Lanka;10;0;1869;11
2020-06-11;LK;Sri Lanka;8;0;1877;11
2020-06-12;LK;Sri Lanka;3;0;1880;11
2020-06-13;LK;Sri Lanka;4;0;1884;11
2020-06-14;LK;Sri Lanka;5;0;1889;11
2020-06-15;LK;Sri Lanka;16;0;1905;11
2020-06-16;LK;Sri Lanka;10;0;1915;11
2020-06-17;LK;Sri Lanka;9;0;1924;11
2020-06-18;LK;Sri Lanka;23;0;1947;11
2020-06-19;LK;Sri Lanka;3;0;1950;11
2020-06-20;LK;Sri Lanka;0;0;1950;11
2020-06-21;LK;Sri Lanka;0;0;1950;11
2020-06-22;LK;Sri Lanka;1;0;1951;11
2020-06-23;LK;Sri Lanka;40;0;1991;11
2020-06-24;LK;Sri Lanka;10;0;2001;11
2020-06-25;LK;Sri Lanka;9;0;2010;11
2020-06-26;LK;Sri Lanka;4;0;2014;11
2020-06-27;LK;Sri Lanka;19;0;2033;11
2020-06-28;LK;Sri Lanka;4;0;2037;11
2020-06-29;LK;Sri Lanka;2;0;2039;11
2020-06-30;LK;Sri Lanka;8;0;2047;11
2020-07-01;LK;Sri Lanka;7;0;2054;11
2020-07-02;LK;Sri Lanka;12;0;2066;11
2020-07-03;LK;Sri Lanka;3;0;2069;11
2020-07-04;LK;Sri Lanka;5;0;2074;11
2020-07-05;LK;Sri Lanka;2;0;2076;11
2020-07-06;LK;Sri Lanka;1;0;2077;11
2020-07-07;LK;Sri Lanka;4;0;2081;11
2020-07-08;LK;Sri Lanka;13;0;2094;11
2020-07-09;LK;Sri Lanka;60;0;2154;11
2020-07-10;LK;Sri Lanka;300;0;2454;11
2020-07-11;LK;Sri Lanka;57;0;2511;11
2020-07-12;LK;Sri Lanka;106;0;2617;11
2020-07-13;LK;Sri Lanka;29;0;2646;11
2020-07-14;LK;Sri Lanka;19;0;2665;11
2020-07-15;LK;Sri Lanka;6;0;2671;11
2020-07-16;LK;Sri Lanka;16;0;2687;11
2020-07-17;LK;Sri Lanka;10;0;2697;11
2020-07-18;LK;Sri Lanka;6;0;2703;11
2020-07-19;LK;Sri Lanka;21;0;2724;11
2020-07-20;LK;Sri Lanka;6;0;2730;11
2020-07-21;LK;Sri Lanka;0;0;2730;11
2020-07-22;LK;Sri Lanka;22;0;2752;11
2020-07-23;LK;Sri Lanka;1;0;2753;11
2020-07-24;LK;Sri Lanka;11;0;2764;11
2020-07-25;LK;Sri Lanka;6;0;2770;11
2020-07-26;LK;Sri Lanka;12;0;2782;11
2020-07-27;LK;Sri Lanka;23;0;2805;11
2020-07-28;LK;Sri Lanka;5;0;2810;11
2020-07-29;LK;Sri Lanka;0;0;2810;11
2020-07-30;LK;Sri Lanka;4;0;2814;11
2020-07-31;LK;Sri Lanka;1;0;2815;11
2020-08-01;LK;Sri Lanka;0;0;2815;11
2020-08-02;LK;Sri Lanka;8;0;2823;11
2020-08-03;LK;Sri Lanka;5;0;2828;11
2020-08-04;LK;Sri Lanka;6;0;2834;11
2020-08-05;LK;Sri Lanka;5;0;2839;11
2020-08-06;LK;Sri Lanka;0;0;2839;11
2020-08-07;LK;Sri Lanka;0;0;2839;11
2020-08-08;LK;Sri Lanka;2;0;2841;11
2020-08-09;LK;Sri Lanka;3;0;2844;11
2020-08-10;LK;Sri Lanka;27;0;2871;11
2020-08-11;LK;Sri Lanka;9;0;2880;11
2020-08-12;LK;Sri Lanka;1;0;2881;11
2020-08-13;LK;Sri Lanka;1;0;2882;11
2020-08-14;LK;Sri Lanka;4;0;2886;11
2020-08-15;LK;Sri Lanka;4;0;2890;11
2020-08-16;LK;Sri Lanka;3;0;2893;11
2020-08-17;LK;Sri Lanka;7;0;2900;11
2020-08-18;LK;Sri Lanka;2;0;2902;11
2020-08-19;LK;Sri Lanka;0;0;2902;11
2020-08-20;LK;Sri Lanka;16;0;2918;11
2020-08-21;LK;Sri Lanka;23;0;2941;11
2020-08-22;LK;Sri Lanka;6;1;2947;12
2020-08-23;LK;Sri Lanka;6;0;2953;12
2020-08-24;LK;Sri Lanka;6;0;2959;12
2020-08-25;LK;Sri Lanka;12;0;2971;12
2020-08-26;LK;Sri Lanka;13;0;2984;12
2020-08-27;LK;Sri Lanka;2;0;2986;12
2020-08-28;LK;Sri Lanka;3;0;2989;12
2020-08-29;LK;Sri Lanka;6;0;2995;12
2020-08-30;LK;Sri Lanka;17;0;3012;12
2020-08-31;LK;Sri Lanka;37;0;3049;12
2020-09-01;LK;Sri Lanka;43;0;3092;12
2020-09-02;LK;Sri Lanka;9;0;3101;12
2020-09-03;LK;Sri Lanka;10;0;3111;12
2020-09-04;LK;Sri Lanka;4;0;3115;12
2020-09-05;LK;Sri Lanka;6;0;3121;12
2020-09-06;LK;Sri Lanka;2;0;3123;12
2020-09-07;LK;Sri Lanka;0;0;3123;12
2020-09-08;LK;Sri Lanka;17;0;3140;12
2020-09-09;LK;Sri Lanka;7;0;3147;12
2020-09-10;LK;Sri Lanka;8;0;3155;12
2020-09-11;LK;Sri Lanka;14;0;3169;12
2020-09-12;LK;Sri Lanka;26;0;3195;12
2020-09-13;LK;Sri Lanka;39;0;3234;12
2020-09-14;LK;Sri Lanka;28;1;3262;13
2020-09-15;LK;Sri Lanka;9;0;3271;13
2020-09-16;LK;Sri Lanka;0;0;3271;13
2020-09-17;LK;Sri Lanka;5;0;3276;13
2020-09-18;LK;Sri Lanka;5;0;3281;13
2020-09-19;LK;Sri Lanka;2;0;3283;13
2020-09-20;LK;Sri Lanka;4;0;3287;13
2020-09-21;LK;Sri Lanka;12;0;3299;13
2020-09-22;LK;Sri Lanka;14;0;3313;13
2020-09-23;LK;Sri Lanka;11;0;3324;13
2020-09-24;LK;Sri Lanka;9;0;3333;13
2020-09-25;LK;Sri Lanka;12;0;3345;13
2020-09-26;LK;Sri Lanka;4;0;3349;13
2020-09-27;LK;Sri Lanka;11;0;3360;13
2020-09-28;LK;Sri Lanka;3;0;3363;13
2020-09-29;LK;Sri Lanka;11;0;3374;13
2020-09-30;LK;Sri Lanka;6;0;3380;13
2020-10-01;LK;Sri Lanka;2;0;3382;13
2020-10-02;LK;Sri Lanka;6;0;3388;13
2020-10-03;LK;Sri Lanka;7;0;3395;13
2020-10-04;LK;Sri Lanka;7;0;3402;13
2020-10-05;LK;Sri Lanka;111;0;3513;13
2020-10-06;LK;Sri Lanka;739;0;4252;13
2020-10-07;LK;Sri Lanka;207;0;4459;13
2020-10-08;LK;Sri Lanka;29;0;4488;13
2020-10-09;LK;Sri Lanka;35;0;4523;13
2020-10-10;LK;Sri Lanka;105;0;4628;13
2020-10-11;LK;Sri Lanka;124;0;4752;13
2020-10-12;LK;Sri Lanka;92;0;4844;13
2020-10-13;LK;Sri Lanka;194;0;5038;13
2020-10-14;LK;Sri Lanka;132;0;5170;13
2020-10-15;LK;Sri Lanka;74;0;5244;13
2020-10-16;LK;Sri Lanka;110;0;5354;13
2020-10-17;LK;Sri Lanka;121;0;5475;13
2020-10-18;LK;Sri Lanka;63;0;5538;13
2020-10-19;LK;Sri Lanka;87;0;5625;13
2020-10-20;LK;Sri Lanka;186;0;5811;13
2020-10-21;LK;Sri Lanka;167;0;5978;13
2020-10-22;LK;Sri Lanka;309;1;6287;14
2020-10-23;LK;Sri Lanka;866;0;7153;14
2020-10-24;LK;Sri Lanka;368;1;7521;15
2020-10-25;LK;Sri Lanka;351;1;7872;16
2020-10-26;LK;Sri Lanka;541;0;8413;16
2020-10-27;LK;Sri Lanka;457;3;8870;19
2020-10-28;LK;Sri Lanka;335;0;9205;19
2020-10-29;LK;Sri Lanka;586;0;9791;19
2020-10-30;LK;Sri Lanka;633;0;10424;19
2020-10-31;LK;Sri Lanka;239;1;10663;20
2020-11-01;LK;Sri Lanka;397;1;11060;21
2020-11-02;LK;Sri Lanka;275;0;11335;21
2020-11-03;LK;Sri Lanka;409;2;11744;23
2020-11-04;LK;Sri Lanka;443;1;12187;24
2020-11-05;LK;Sri Lanka;383;5;12570;29
2020-11-06;LK;Sri Lanka;400;1;12970;30
2020-11-07;LK;Sri Lanka;449;4;13419;34
2020-11-08;LK;Sri Lanka;510;1;13929;35
2020-11-09;LK;Sri Lanka;356;1;14285;36
2020-11-10;LK;Sri Lanka;430;5;14715;41
2020-11-11;LK;Sri Lanka;635;5;15350;46
2020-11-12;LK;Sri Lanka;373;2;15723;48
2020-11-13;LK;Sri Lanka;468;5;16191;53
2020-11-14;LK;Sri Lanka;392;0;16583;53
2020-11-15;LK;Sri Lanka;704;5;17287;58
2020-11-16;LK;Sri Lanka;387;3;17674;61
2020-11-17;LK;Sri Lanka;401;5;18075;66
2020-11-18;LK;Sri Lanka;327;3;18402;69
2020-11-19;LK;Sri Lanka;439;4;18841;73
2020-11-20;LK;Sri Lanka;439;1;19280;74
2020-11-21;LK;Sri Lanka;491;9;19771;83
2020-11-22;LK;Sri Lanka;400;4;20171;87
2020-11-23;LK;Sri Lanka;337;3;20508;90
2020-11-24;LK;Sri Lanka;459;4;20967;94
2020-11-25;LK;Sri Lanka;502;2;21469;96
2020-11-26;LK;Sri Lanka;559;3;22028;99
2020-11-27;LK;Sri Lanka;473;8;22501;107
2020-11-28;LK;Sri Lanka;487;2;22988;109
2020-11-29;LK;Sri Lanka;496;7;23484;116
2020-11-30;LK;Sri Lanka;503;2;23987;118
2020-12-01;LK;Sri Lanka;545;4;24532;122
2020-12-02;LK;Sri Lanka;878;2;25410;124
2020-12-03;LK;Sri Lanka;628;5;26038;129
2020-12-04;LK;Sri Lanka;521;1;26559;130
2020-12-05;LK;Sri Lanka;669;7;27228;137
2020-12-06;LK;Sri Lanka;649;3;27877;140
2020-12-07;LK;Sri Lanka;703;2;28580;142
2020-12-08;LK;Sri Lanka;798;0;29378;142
2020-12-09;LK;Sri Lanka;694;2;30072;144
2020-12-10;LK;Sri Lanka;541;2;30613;146
2020-12-11;LK;Sri Lanka;762;1;31375;147
2020-12-12;LK;Sri Lanka;760;2;32135;149
2020-12-13;LK;Sri Lanka;655;3;32790;152
2020-12-14;LK;Sri Lanka;688;2;33478;154
2020-12-15;LK;Sri Lanka;643;0;34121;154
2020-12-16;LK;Sri Lanka;616;6;34737;160
2020-12-17;LK;Sri Lanka;650;0;35387;160
2020-12-18;LK;Sri Lanka;662;5;36049;165
2020-12-19;LK;Sri Lanka;618;6;36667;171
2020-12-20;LK;Sri Lanka;594;5;37261;176
2020-12-21;LK;Sri Lanka;370;5;37631;181
2020-12-22;LK;Sri Lanka;428;2;38059;183
2020-12-23;LK;Sri Lanka;580;1;38639;184
2020-12-24;LK;Sri Lanka;592;1;39231;185
2020-12-25;LK;Sri Lanka;551;1;39782;186
2020-12-26;LK;Sri Lanka;598;1;40380;187
2020-12-27;LK;Sri Lanka;674;4;41054;191
2020-12-28;LK;Sri Lanka;549;3;41603;194
2020-12-29;LK;Sri Lanka;453;1;42056;195
2020-12-30;LK;Sri Lanka;646;4;42702;199
2020-12-31;LK;Sri Lanka;597;5;43299;204
2021-01-01;LK;Sri Lanka;557;4;43856;208
2021-01-02;LK;Sri Lanka;515;3;44371;211
2021-01-03;LK;Sri Lanka;403;0;44774;211
2021-01-04;LK;Sri Lanka;468;4;45242;215
2021-01-05;LK;Sri Lanka;484;2;45726;217
2021-01-06;LK;Sri Lanka;522;2;46248;219
2021-01-07;LK;Sri Lanka;532;3;46780;222
2021-01-08;LK;Sri Lanka;525;3;47305;225
2021-01-09;LK;Sri Lanka;535;4;47840;229
2021-01-10;LK;Sri Lanka;540;3;48380;232
2021-01-11;LK;Sri Lanka;569;8;48949;240
2021-01-12;LK;Sri Lanka;588;4;49537;244
2021-01-13;LK;Sri Lanka;692;3;50229;247
2021-01-14;LK;Sri Lanka;670;4;50899;251
2021-01-15;LK;Sri Lanka;695;4;51594;255
2021-01-16;LK;Sri Lanka;719;1;52313;256
2021-01-17;LK;Sri Lanka;749;8;53062;264
2021-01-18;LK;Sri Lanka;688;6;53750;270
2021-01-19;LK;Sri Lanka;669;3;54419;273
2021-01-20;LK;Sri Lanka;770;1;55189;274
2021-01-21;LK;Sri Lanka;887;2;56076;276
2021-01-22;LK;Sri Lanka;787;2;56863;278
2021-01-23;LK;Sri Lanka;724;2;57587;280
2021-01-24;LK;Sri Lanka;843;3;58430;283
2021-01-25;LK;Sri Lanka;737;4;59167;287
2021-01-26;LK;Sri Lanka;755;1;59922;288
2021-01-27;LK;Sri Lanka;772;2;60694;290
2021-01-28;LK;Sri Lanka;892;7;61586;297
2021-01-29;LK;Sri Lanka;859;8;62445;305
2021-01-30;LK;Sri Lanka;848;8;63293;313
2021-01-31;LK;Sri Lanka;864;3;64157;316
2021-02-01;LK;Sri Lanka;826;7;64983;323
2021-02-02;LK;Sri Lanka;715;7;65698;330
2021-02-03;LK;Sri Lanka;711;2;66409;332
2021-02-04;LK;Sri Lanka;706;7;67115;339
2021-02-05;LK;Sri Lanka;735;4;67850;343
2021-02-06;LK;Sri Lanka;726;8;68576;351
2021-02-07;LK;Sri Lanka;772;5;69348;356
2021-02-08;LK;Sri Lanka;887;9;70235;365
2021-02-09;LK;Sri Lanka;976;5;71211;370
2021-02-10;LK;Sri Lanka;963;5;72174;375
2021-02-11;LK;Sri Lanka;942;4;73116;379
2021-02-12;LK;Sri Lanka;940;5;74056;384
2021-02-13;LK;Sri Lanka;796;6;74852;390
2021-02-14;LK;Sri Lanka;802;7;75654;397
2021-02-15;LK;Sri Lanka;774;6;76428;403
2021-02-16;LK;Sri Lanka;756;6;77184;409
2021-02-17;LK;Sri Lanka;722;13;77906;422
2021-02-18;LK;Sri Lanka;514;8;78420;430
2021-02-19;LK;Sri Lanka;517;3;78937;433
2021-02-20;LK;Sri Lanka;543;2;79480;435
2021-02-21;LK;Sri Lanka;519;10;79999;445
2021-02-22;LK;Sri Lanka;518;5;80517;450
2021-02-23;LK;Sri Lanka;492;3;81009;453
2021-02-24;LK;Sri Lanka;458;4;81467;457
2021-02-25;LK;Sri Lanka;466;2;81933;459
2021-02-26;LK;Sri Lanka;497;5;82430;464
2021-02-27;LK;Sri Lanka;460;0;82890;464
2021-02-28;LK;Sri Lanka;204;0;83094;464
2021-03-01;LK;Sri Lanka;458;12;83552;476
2021-03-02;LK;Sri Lanka;318;7;83870;483
2021-03-03;LK;Sri Lanka;356;1;84226;484
2021-03-04;LK;Sri Lanka;384;5;84610;489
2021-03-05;LK;Sri Lanka;350;4;84960;493
2021-03-06;LK;Sri Lanka;190;0;85150;493
2021-03-07;LK;Sri Lanka;545;9;85695;502
2021-03-08;LK;Sri Lanka;344;5;86039;507
2021-03-09;LK;Sri Lanka;304;4;86343;511
2021-03-10;LK;Sri Lanka;342;0;86685;511
2021-03-11;LK;Sri Lanka;304;9;86989;520
2021-03-12;LK;Sri Lanka;297;5;87286;525
2021-03-13;LK;Sri Lanka;314;1;87600;526
2021-03-14;LK;Sri Lanka;307;1;87907;527
2021-03-15;LK;Sri Lanka;331;5;88238;532
2021-03-16;LK;Sri Lanka;154;0;88392;532
2021-03-17;LK;Sri Lanka;470;5;88862;537
2021-03-18;LK;Sri Lanka;162;0;89024;537
2021-03-19;LK;Sri Lanka;473;7;89497;544
2021-03-20;LK;Sri Lanka;158;0;89655;544
2021-03-21;LK;Sri Lanka;545;2;90200;546
2021-03-22;LK;Sri Lanka;314;5;90514;551
2021-03-23;LK;Sri Lanka;251;1;90765;552
2021-03-24;LK;Sri Lanka;253;0;91018;552
2021-03-25;LK;Sri Lanka;271;2;91289;554
2021-03-26;LK;Sri Lanka;272;3;91561;557
2021-03-27;LK;Sri Lanka;278;1;91839;558
2021-03-28;LK;Sri Lanka;249;3;92088;561
2021-03-29;LK;Sri Lanka;215;5;92303;566
2021-03-30;LK;Sri Lanka;139;0;92442;566
2021-03-31;LK;Sri Lanka;264;2;92706;568
2021-04-01;LK;Sri Lanka;211;3;92917;571
2021-04-02;LK;Sri Lanka;211;0;93128;571
2021-04-03;LK;Sri Lanka;167;4;93295;575
2021-04-04;LK;Sri Lanka;141;6;93436;581
2021-04-05;LK;Sri Lanka;159;0;93595;581
2021-04-06;LK;Sri Lanka;95;5;93690;586
2021-04-07;LK;Sri Lanka;220;2;93910;588
2021-04-08;LK;Sri Lanka;343;3;94253;591
2021-04-09;LK;Sri Lanka;311;2;94564;593
2021-04-10;LK;Sri Lanka;284;2;94848;595
2021-04-11;LK;Sri Lanka;283;3;95131;598
2021-04-12;LK;Sri Lanka;263;0;95394;598
2021-04-13;LK;Sri Lanka;226;4;95620;602
2021-04-14;LK;Sri Lanka;99;0;95719;602
2021-04-15;LK;Sri Lanka;230;6;95949;608
2021-04-16;LK;Sri Lanka;237;7;96186;615
2021-04-17;LK;Sri Lanka;168;0;96354;615
2021-04-18;LK;Sri Lanka;442;3;96796;618
2021-04-19;LK;Sri Lanka;309;2;97105;620
2021-04-20;LK;Sri Lanka;367;0;97472;620
2021-04-21;LK;Sri Lanka;578;10;98050;630
2021-04-22;LK;Sri Lanka;672;4;98722;634
2021-04-23;LK;Sri Lanka;796;0;99518;634
2021-04-24;LK;Sri Lanka;1068;4;100586;638
2021-04-25;LK;Sri Lanka;793;4;101379;642
2021-04-26;LK;Sri Lanka;997;5;102376;647
2021-04-27;LK;Sri Lanka;1111;0;103487;647
2021-04-28;LK;Sri Lanka;1466;14;104953;661
2021-04-29;LK;Sri Lanka;1531;0;106484;661
2021-04-30;LK;Sri Lanka;1662;17;108146;678
2021-05-01;LK;Sri Lanka;1716;9;109862;687
2021-05-02;LK;Sri Lanka;1891;9;111753;696
2021-05-03;LK;Sri Lanka;1923;13;113676;709
2021-05-04;LK;Sri Lanka;1914;0;115590;709
2021-05-05;LK;Sri Lanka;1939;25;117529;734
2021-05-06;LK;Sri Lanka;1895;11;119424;745
2021-05-07;LK;Sri Lanka;1914;19;121338;764
2021-05-08;LK;Sri Lanka;1896;22;123234;786
2021-05-09;LK;Sri Lanka;2672;15;125906;801
2021-05-10;LK;Sri Lanka;2624;26;128530;827
2021-05-11;LK;Sri Lanka;2568;23;131098;850
2021-05-12;LK;Sri Lanka;2429;0;133527;850
2021-05-13;LK;Sri Lanka;2269;42;135796;892
2021-05-14;LK;Sri Lanka;2289;31;138085;923
2021-05-15;LK;Sri Lanka;2386;18;140471;941
2021-05-16;LK;Sri Lanka;2275;21;142746;962
2021-05-17;LK;Sri Lanka;2456;19;145202;981
2021-05-18;LK;Sri Lanka;2518;34;147720;1015
2021-05-19;LK;Sri Lanka;3623;36;151343;1051
2021-05-20;LK;Sri Lanka;3443;0;154786;1051
2021-05-21;LK;Sri Lanka;3547;82;158333;1133
2021-05-22;LK;Sri Lanka;2909;45;161242;1178
2021-05-23;LK;Sri Lanka;2959;32;164201;1210
2021-05-24;LK;Sri Lanka;2971;33;167172;1243
2021-05-25;LK;Sri Lanka;2728;26;169900;1269
2021-05-26;LK;Sri Lanka;2377;29;172277;1298
2021-05-27;LK;Sri Lanka;2584;0;174861;1298
2021-05-28;LK;Sri Lanka;2850;65;177711;1363
2021-05-29;LK;Sri Lanka;2882;0;180593;1363
2021-05-30;LK;Sri Lanka;2859;78;183452;1441
2021-05-31;LK;Sri Lanka;2912;0;186364;1441
2021-06-01;LK;Sri Lanka;2877;43;189241;1484
2021-06-02;LK;Sri Lanka;3306;82;192547;1566
2021-06-03;LK;Sri Lanka;3297;42;195844;1608
2021-06-04;LK;Sri Lanka;3410;48;199254;1656
2021-06-05;LK;Sri Lanka;3103;0;202357;1656
2021-06-06;LK;Sri Lanka;2976;40;205333;1696
2021-06-07;LK;Sri Lanka;2646;93;207979;1789
2021-06-08;LK;Sri Lanka;2682;55;210661;1844
2021-06-09;LK;Sri Lanka;2735;66;213396;1910
2021-06-10;LK;Sri Lanka;2738;0;216134;1910
2021-06-11;LK;Sri Lanka;2232;101;218366;2011
2021-06-12;LK;Sri Lanka;2911;62;221277;2073
2021-06-13;LK;Sri Lanka;2361;63;223638;2136
2021-06-14;LK;Sri Lanka;2284;124;225922;2260
2021-06-15;LK;Sri Lanka;2334;55;228256;2315
2021-06-16;LK;Sri Lanka;2436;59;230692;2374
2021-06-17;LK;Sri Lanka;2372;51;233064;2425
2021-06-18;LK;Sri Lanka;2349;55;235413;2480
2021-06-19;LK;Sri Lanka;2248;54;237661;2534
2021-06-20;LK;Sri Lanka;2028;47;239689;2581
2021-06-21;LK;Sri Lanka;2131;52;241820;2633
2021-06-22;LK;Sri Lanka;2093;71;243913;2704
2021-06-23;LK;Sri Lanka;2196;65;246109;2769
2021-06-24;LK;Sri Lanka;1941;45;248050;2814
2021-06-25;LK;Sri Lanka;1876;48;249926;2862
2021-06-26;LK;Sri Lanka;1825;43;251751;2905
2021-06-27;LK;Sri Lanka;1867;39;253618;2944
2021-06-28;LK;Sri Lanka;1890;41;255508;2985
2021-06-29;LK;Sri Lanka;1717;45;257225;3030
2021-06-30;LK;Sri Lanka;1864;47;259089;3077
2021-07-01;LK;Sri Lanka;1883;43;260972;3120
2020-03-12;SD;Sudan;0;0;0;0
2020-03-13;SD;Sudan;0;1;0;1
2020-03-14;SD;Sudan;1;0;1;1
2020-03-15;SD;Sudan;0;0;1;1
2020-03-16;SD;Sudan;0;0;1;1
2020-03-17;SD;Sudan;0;0;1;1
2020-03-18;SD;Sudan;0;0;1;1
2020-03-19;SD;Sudan;0;0;1;1
2020-03-20;SD;Sudan;0;0;1;1
2020-03-21;SD;Sudan;1;0;2;1
2020-03-22;SD;Sudan;0;0;2;1
2020-03-23;SD;Sudan;0;0;2;1
2020-03-24;SD;Sudan;1;0;3;1
2020-03-25;SD;Sudan;0;0;3;1
2020-03-26;SD;Sudan;0;0;3;1
2020-03-27;SD;Sudan;0;0;3;1
2020-03-28;SD;Sudan;2;0;5;1
2020-03-29;SD;Sudan;0;0;5;1
2020-03-30;SD;Sudan;1;1;6;2
2020-03-31;SD;Sudan;1;0;7;2
2020-04-01;SD;Sudan;0;0;7;2
2020-04-02;SD;Sudan;0;0;7;2
2020-04-03;SD;Sudan;3;0;10;2
2020-04-04;SD;Sudan;0;0;10;2
2020-04-05;SD;Sudan;2;0;12;2
2020-04-06;SD;Sudan;0;0;12;2
2020-04-07;SD;Sudan;2;0;14;2
2020-04-08;SD;Sudan;0;0;14;2
2020-04-09;SD;Sudan;0;0;14;2
2020-04-10;SD;Sudan;1;0;15;2
2020-04-11;SD;Sudan;4;0;19;2
2020-04-12;SD;Sudan;0;0;19;2
2020-04-13;SD;Sudan;0;2;19;4
2020-04-14;SD;Sudan;10;1;29;5
2020-04-15;SD;Sudan;3;0;32;5
2020-04-16;SD;Sudan;0;0;32;5
2020-04-17;SD;Sudan;0;1;32;6
2020-04-18;SD;Sudan;34;4;66;10
2020-04-19;SD;Sudan;0;0;66;10
2020-04-20;SD;Sudan;26;2;92;12
2020-04-21;SD;Sudan;15;0;107;12
2020-04-22;SD;Sudan;33;1;140;13
2020-04-23;SD;Sudan;22;3;162;16
2020-04-24;SD;Sudan;12;0;174;16
2020-04-25;SD;Sudan;39;1;213;17
2020-04-26;SD;Sudan;24;4;237;21
2020-04-27;SD;Sudan;38;1;275;22
2020-04-28;SD;Sudan;43;3;318;25
2020-04-29;SD;Sudan;57;3;375;28
2020-04-30;SD;Sudan;0;3;375;31
2020-05-01;SD;Sudan;67;5;442;36
2020-05-02;SD;Sudan;91;5;533;41
2020-05-03;SD;Sudan;59;0;592;41
2020-05-04;SD;Sudan;86;0;678;41
2020-05-05;SD;Sudan;100;4;778;45
2020-05-06;SD;Sudan;74;4;852;49
2020-05-07;SD;Sudan;78;3;930;52
2020-05-08;SD;Sudan;0;7;930;59
2020-05-09;SD;Sudan;181;5;1111;64
2020-05-10;SD;Sudan;53;6;1164;70
2020-05-11;SD;Sudan;201;4;1365;74
2020-05-12;SD;Sudan;161;6;1526;80
2020-05-13;SD;Sudan;134;10;1660;90
2020-05-14;SD;Sudan;158;0;1818;90
2020-05-15;SD;Sudan;146;1;1964;91
2020-05-16;SD;Sudan;0;6;1964;97
2020-05-17;SD;Sudan;325;0;2289;97
2020-05-18;SD;Sudan;302;8;2591;105
2020-05-19;SD;Sudan;0;6;2591;111
2020-05-20;SD;Sudan;137;0;2728;111
2020-05-21;SD;Sudan;410;10;3138;121
2020-05-22;SD;Sudan;0;16;3138;137
2020-05-23;SD;Sudan;240;9;3378;146
2020-05-24;SD;Sudan;256;19;3634;165
2020-05-25;SD;Sudan;192;5;3826;170
2020-05-26;SD;Sudan;150;0;3976;170
2020-05-27;SD;Sudan;170;25;4146;195
2020-05-28;SD;Sudan;200;0;4346;195
2020-05-29;SD;Sudan;0;38;4346;233
2020-05-30;SD;Sudan;175;29;4521;262
2020-05-31;SD;Sudan;279;24;4800;286
2020-06-01;SD;Sudan;226;12;5026;298
2020-06-02;SD;Sudan;147;9;5173;307
2020-06-03;SD;Sudan;137;7;5310;314
2020-06-04;SD;Sudan;189;19;5499;333
2020-06-05;SD;Sudan;215;14;5714;347
2020-06-06;SD;Sudan;152;12;5866;359
2020-06-07;SD;Sudan;215;0;6081;359
2020-06-08;SD;Sudan;0;13;6081;372
2020-06-09;SD;Sudan;161;17;6242;389
2020-06-10;SD;Sudan;185;12;6427;401
2020-06-11;SD;Sudan;155;12;6582;413
2020-06-12;SD;Sudan;148;20;6730;433
2020-06-13;SD;Sudan;149;14;6879;447
2020-06-14;SD;Sudan;128;12;7007;459
2020-06-15;SD;Sudan;213;9;7220;468
2020-06-16;SD;Sudan;215;9;7435;477
2020-06-17;SD;Sudan;305;10;7740;487
2020-06-18;SD;Sudan;280;0;8020;487
2020-06-19;SD;Sudan;0;19;8020;506
2020-06-20;SD;Sudan;396;15;8416;521
2020-06-21;SD;Sudan;164;0;8580;521
2020-06-22;SD;Sudan;118;12;8698;533
2020-06-23;SD;Sudan;98;15;8796;548
2020-06-24;SD;Sudan;91;0;8887;548
2020-06-25;SD;Sudan;0;8;8887;556
2020-06-26;SD;Sudan;95;16;8982;572
2020-06-27;SD;Sudan;275;0;9257;572
2020-06-28;SD;Sudan;57;0;9314;572
2020-06-29;SD;Sudan;6;0;9320;572
2020-06-30;SD;Sudan;52;0;9372;572
2020-07-01;SD;Sudan;128;30;9500;602
2020-07-02;SD;Sudan;73;0;9573;602
2020-07-03;SD;Sudan;116;2;9689;604
2020-07-04;SD;Sudan;0;4;9689;608
2020-07-05;SD;Sudan;78;0;9767;608
2020-07-06;SD;Sudan;0;8;9767;616
2020-07-07;SD;Sudan;127;6;9894;622
2020-07-08;SD;Sudan;103;14;9997;636
2020-07-09;SD;Sudan;87;5;10084;641
2020-07-10;SD;Sudan;120;8;10204;649
2020-07-11;SD;Sudan;0;1;10204;650
2020-07-12;SD;Sudan;46;0;10250;650
2020-07-13;SD;Sudan;0;7;10250;657
2020-07-14;SD;Sudan;66;2;10316;659
2020-07-15;SD;Sudan;101;9;10417;668
2020-07-16;SD;Sudan;110;0;10527;668
2020-07-17;SD;Sudan;0;0;10527;668
2020-07-18;SD;Sudan;0;5;10527;673
2020-07-19;SD;Sudan;235;20;10762;693
2020-07-20;SD;Sudan;230;0;10992;693
2020-07-21;SD;Sudan;0;0;10992;693
2020-07-22;SD;Sudan;135;15;11127;708
2020-07-23;SD;Sudan;110;0;11237;708
2020-07-24;SD;Sudan;65;7;11302;715
2020-07-25;SD;Sudan;0;2;11302;717
2020-07-26;SD;Sudan;83;0;11385;717
2020-07-27;SD;Sudan;39;3;11424;720
2020-07-28;SD;Sudan;72;5;11496;725
2020-07-29;SD;Sudan;83;0;11579;725
2020-07-30;SD;Sudan;0;0;11579;725
2020-07-31;SD;Sudan;0;21;11579;746
2020-08-01;SD;Sudan;65;6;11644;752
2020-08-02;SD;Sudan;94;0;11738;752
2020-08-03;SD;Sudan;0;0;11738;752
2020-08-04;SD;Sudan;42;11;11780;763
2020-08-05;SD;Sudan;0;0;11780;763
2020-08-06;SD;Sudan;70;0;11850;763
2020-08-07;SD;Sudan;44;10;11894;773
2020-08-08;SD;Sudan;0;0;11894;773
2020-08-09;SD;Sudan;62;8;11956;781
2020-08-10;SD;Sudan;77;0;12033;781
2020-08-11;SD;Sudan;0;5;12033;786
2020-08-12;SD;Sudan;82;0;12115;786
2020-08-13;SD;Sudan;47;6;12162;792
2020-08-14;SD;Sudan;49;1;12211;793
2020-08-15;SD;Sudan;103;3;12314;796
2020-08-16;SD;Sudan;96;2;12410;798
2020-08-17;SD;Sudan;75;5;12485;803
2020-08-18;SD;Sudan;61;2;12546;805
2020-08-19;SD;Sudan;36;3;12582;808
2020-08-20;SD;Sudan;41;4;12623;812
2020-08-21;SD;Sudan;59;0;12682;812
2020-08-22;SD;Sudan;154;3;12836;815
2020-08-23;SD;Sudan;67;0;12903;815
2020-08-24;SD;Sudan;71;3;12974;818
2020-08-25;SD;Sudan;0;1;12974;819
2020-08-26;SD;Sudan;71;0;13045;819
2020-08-27;SD;Sudan;37;4;13082;823
2020-08-28;SD;Sudan;107;0;13189;823
2020-08-29;SD;Sudan;0;0;13189;823
2020-08-30;SD;Sudan;0;0;13189;823
2020-08-31;SD;Sudan;0;0;13189;823
2020-09-01;SD;Sudan;0;0;13189;823
2020-09-02;SD;Sudan;0;0;13189;823
2020-09-03;SD;Sudan;0;0;13189;823
2020-09-04;SD;Sudan;0;0;13189;823
2020-09-05;SD;Sudan;218;9;13407;832
2020-09-06;SD;Sudan;30;1;13437;833
2020-09-07;SD;Sudan;0;0;13437;833
2020-09-08;SD;Sudan;33;0;13470;833
2020-09-09;SD;Sudan;0;0;13470;833
2020-09-10;SD;Sudan;0;0;13470;833
2020-09-11;SD;Sudan;46;1;13516;834
2020-09-12;SD;Sudan;16;0;13532;834
2020-09-13;SD;Sudan;0;1;13532;835
2020-09-14;SD;Sudan;0;1;13532;836
2020-09-15;SD;Sudan;3;0;13535;836
2020-09-16;SD;Sudan;0;0;13535;836
2020-09-17;SD;Sudan;0;0;13535;836
2020-09-18;SD;Sudan;20;0;13555;836
2020-09-19;SD;Sudan;0;0;13555;836
2020-09-20;SD;Sudan;0;0;13555;836
2020-09-21;SD;Sudan;21;0;13576;836
2020-09-22;SD;Sudan;2;0;13578;836
2020-09-23;SD;Sudan;0;0;13578;836
2020-09-24;SD;Sudan;14;0;13592;836
2020-09-25;SD;Sudan;12;0;13604;836
2020-09-26;SD;Sudan;2;0;13606;836
2020-09-27;SD;Sudan;4;0;13610;836
2020-09-28;SD;Sudan;3;0;13613;836
2020-09-29;SD;Sudan;27;0;13640;836
2020-09-30;SD;Sudan;6;0;13646;836
2020-10-01;SD;Sudan;7;0;13653;836
2020-10-02;SD;Sudan;4;0;13657;836
2020-10-03;SD;Sudan;1;0;13658;836
2020-10-04;SD;Sudan;2;0;13660;836
2020-10-05;SD;Sudan;0;0;13660;836
2020-10-06;SD;Sudan;8;0;13668;836
2020-10-07;SD;Sudan;0;0;13668;836
2020-10-08;SD;Sudan;2;0;13670;836
2020-10-09;SD;Sudan;3;0;13673;836
2020-10-10;SD;Sudan;9;0;13682;836
2020-10-11;SD;Sudan;3;0;13685;836
2020-10-12;SD;Sudan;6;0;13691;836
2020-10-13;SD;Sudan;0;0;13691;836
2020-10-14;SD;Sudan;6;0;13697;836
2020-10-15;SD;Sudan;0;0;13697;836
2020-10-16;SD;Sudan;3;0;13700;836
2020-10-17;SD;Sudan;0;0;13700;836
2020-10-18;SD;Sudan;11;0;13711;836
2020-10-19;SD;Sudan;13;0;13724;836
2020-10-20;SD;Sudan;0;0;13724;836
2020-10-21;SD;Sudan;4;0;13728;836
2020-10-22;SD;Sudan;0;0;13728;836
2020-10-23;SD;Sudan;5;0;13733;836
2020-10-24;SD;Sudan;0;1;13733;837
2020-10-25;SD;Sudan;9;0;13742;837
2020-10-26;SD;Sudan;0;0;13742;837
2020-10-27;SD;Sudan;5;0;13747;837
2020-10-28;SD;Sudan;18;0;13765;837
2020-10-29;SD;Sudan;12;0;13777;837
2020-10-30;SD;Sudan;27;0;13804;837
2020-10-31;SD;Sudan;0;0;13804;837
2020-11-01;SD;Sudan;0;0;13804;837
2020-11-02;SD;Sudan;15;0;13819;837
2020-11-03;SD;Sudan;47;0;13866;837
2020-11-04;SD;Sudan;39;0;13905;837
2020-11-05;SD;Sudan;91;0;13996;837
2020-11-06;SD;Sudan;37;0;14033;837
2020-11-07;SD;Sudan;57;0;14090;837
2020-11-08;SD;Sudan;65;278;14155;1115
2020-11-09;SD;Sudan;50;1;14205;1116
2020-11-10;SD;Sudan;96;0;14301;1116
2020-11-11;SD;Sudan;45;0;14346;1116
2020-11-12;SD;Sudan;55;0;14401;1116
2020-11-13;SD;Sudan;97;0;14498;1116
2020-11-14;SD;Sudan;128;0;14626;1116
2020-11-15;SD;Sudan;102;0;14728;1116
2020-11-16;SD;Sudan;319;3;15047;1119
2020-11-17;SD;Sudan;106;56;15153;1175
2020-11-18;SD;Sudan;146;0;15299;1175
2020-11-19;SD;Sudan;231;4;15530;1179
2020-11-20;SD;Sudan;309;6;15839;1185
2020-11-21;SD;Sudan;213;8;16052;1193
2020-11-22;SD;Sudan;135;4;16187;1197
2020-11-23;SD;Sudan;244;0;16431;1197
2020-11-24;SD;Sudan;218;5;16649;1202
2020-11-25;SD;Sudan;215;8;16864;1210
2020-11-26;SD;Sudan;204;5;17068;1215
2020-11-27;SD;Sudan;336;0;17404;1215
2020-11-28;SD;Sudan;223;20;17627;1235
2020-11-29;SD;Sudan;183;0;17810;1235
2020-11-30;SD;Sudan;235;14;18045;1249
2020-12-01;SD;Sudan;209;6;18254;1255
2020-12-02;SD;Sudan;281;10;18535;1265
2020-12-03;SD;Sudan;349;6;18884;1271
2020-12-04;SD;Sudan;312;0;19196;1271
2020-12-05;SD;Sudan;272;19;19468;1290
2020-12-06;SD;Sudan;279;5;19747;1295
2020-12-07;SD;Sudan;337;6;20084;1301
2020-12-08;SD;Sudan;212;0;20296;1301
2020-12-09;SD;Sudan;172;6;20468;1307
2020-12-10;SD;Sudan;376;12;20844;1319
2020-12-11;SD;Sudan;303;21;21147;1340
2020-12-12;SD;Sudan;239;4;21386;1344
2020-12-13;SD;Sudan;205;3;21591;1347
2020-12-14;SD;Sudan;273;8;21864;1355
2020-12-15;SD;Sudan;218;17;22082;1372
2020-12-16;SD;Sudan;183;12;22265;1384
2020-12-17;SD;Sudan;356;24;22621;1408
2020-12-18;SD;Sudan;202;0;22823;1408
2020-12-19;SD;Sudan;167;17;22990;1425
2020-12-20;SD;Sudan;110;9;23100;1434
2020-12-21;SD;Sudan;216;16;23316;1450
2020-12-22;SD;Sudan;256;18;23572;1468
2020-12-23;SD;Sudan;274;0;23846;1468
2020-12-24;SD;Sudan;212;0;24058;1468
2020-12-25;SD;Sudan;283;0;24341;1468
2020-12-26;SD;Sudan;247;0;24588;1468
2020-12-27;SD;Sudan;106;0;24694;1468
2020-12-28;SD;Sudan;194;0;24888;1468
2020-12-29;SD;Sudan;172;0;25060;1468
2020-12-30;SD;Sudan;178;0;25238;1468
2020-12-31;SD;Sudan;262;0;25500;1468
2021-01-01;SD;Sudan;230;0;25730;1468
2021-01-02;SD;Sudan;152;0;25882;1468
2021-01-03;SD;Sudan;157;0;26039;1468
2021-01-04;SD;Sudan;240;0;26279;1468
2021-01-05;SD;Sudan;0;0;26279;1468
2021-01-06;SD;Sudan;0;0;26279;1468
2021-01-07;SD;Sudan;0;0;26279;1468
2021-01-08;SD;Sudan;0;0;26279;1468
2021-01-09;SD;Sudan;0;0;26279;1468
2021-01-10;SD;Sudan;1215;0;27494;1468
2021-01-11;SD;Sudan;125;0;27619;1468
2021-01-12;SD;Sudan;149;0;27768;1468
2021-01-13;SD;Sudan;59;108;27827;1576
2021-01-14;SD;Sudan;142;0;27969;1576
2021-01-15;SD;Sudan;128;0;28097;1576
2021-01-16;SD;Sudan;82;0;28179;1576
2021-01-17;SD;Sudan;54;27;28233;1603
2021-01-18;SD;Sudan;84;0;28317;1603
2021-01-19;SD;Sudan;133;0;28450;1603
2021-01-20;SD;Sudan;72;0;28522;1603
2021-01-21;SD;Sudan;0;0;28522;1603
2021-01-22;SD;Sudan;0;0;28522;1603
2021-01-23;SD;Sudan;0;0;28522;1603
2021-01-24;SD;Sudan;0;0;28522;1603
2021-01-25;SD;Sudan;0;135;28522;1738
2021-01-26;SD;Sudan;0;12;28522;1750
2021-01-27;SD;Sudan;472;10;28994;1760
2021-01-28;SD;Sudan;72;38;29066;1798
2021-01-29;SD;Sudan;225;0;29291;1798
2021-01-30;SD;Sudan;0;6;29291;1804
2021-01-31;SD;Sudan;89;3;29380;1807
2021-02-01;SD;Sudan;69;5;29449;1812
2021-02-02;SD;Sudan;39;17;29488;1829
2021-02-03;SD;Sudan;48;1;29536;1830
2021-02-04;SD;Sudan;41;1;29577;1831
2021-02-05;SD;Sudan;57;0;29634;1831
2021-02-06;SD;Sudan;0;0;29634;1831
2021-02-07;SD;Sudan;0;4;29634;1835
2021-02-08;SD;Sudan;131;0;29765;1835
2021-02-09;SD;Sudan;86;0;29851;1835
2021-02-10;SD;Sudan;0;14;29851;1849
2021-02-11;SD;Sudan;82;0;29933;1849
2021-02-12;SD;Sudan;0;0;29933;1849
2021-02-13;SD;Sudan;0;0;29933;1849
2021-02-14;SD;Sudan;0;0;29933;1849
2021-02-15;SD;Sudan;0;9;29933;1858
2021-02-16;SD;Sudan;119;5;30052;1863
2021-02-17;SD;Sudan;26;1;30078;1864
2021-02-18;SD;Sudan;37;0;30115;1864
2021-02-19;SD;Sudan;13;0;30128;1864
2021-02-20;SD;Sudan;0;0;30128;1864
2021-02-21;SD;Sudan;0;0;30128;1864
2021-02-22;SD;Sudan;0;7;30128;1871
2021-02-23;SD;Sudan;77;5;30205;1876
2021-02-24;SD;Sudan;31;0;30236;1876
2021-02-25;SD;Sudan;0;2;30236;1878
2021-02-26;SD;Sudan;48;0;30284;1878
2021-02-27;SD;Sudan;32;2;30316;1880
2021-02-28;SD;Sudan;31;0;30347;1880
2021-03-01;SD;Sudan;17;10;30364;1890
2021-03-02;SD;Sudan;53;5;30417;1895
2021-03-03;SD;Sudan;62;0;30479;1895
2021-03-04;SD;Sudan;0;0;30479;1895
2021-03-05;SD;Sudan;0;0;30479;1895
2021-03-06;SD;Sudan;0;0;30479;1895
2021-03-07;SD;Sudan;61;0;30540;1895
2021-03-08;SD;Sudan;0;20;30540;1915
2021-03-09;SD;Sudan;146;0;30686;1915
2021-03-10;SD;Sudan;0;0;30686;1915
2021-03-11;SD;Sudan;0;25;30686;1940
2021-03-12;SD;Sudan;187;0;30873;1940
2021-03-13;SD;Sudan;0;0;30873;1940
2021-03-14;SD;Sudan;0;0;30873;1940
2021-03-15;SD;Sudan;0;19;30873;1959
2021-03-16;SD;Sudan;116;0;30989;1959
2021-03-17;SD;Sudan;0;0;30989;1959
2021-03-18;SD;Sudan;0;0;30989;1959
2021-03-19;SD;Sudan;0;0;30989;1959
2021-03-20;SD;Sudan;0;0;30989;1959
2021-03-21;SD;Sudan;0;27;30989;1986
2021-03-22;SD;Sudan;158;0;31147;1986
2021-03-23;SD;Sudan;0;17;31147;2003
2021-03-24;SD;Sudan;135;25;31282;2028
2021-03-25;SD;Sudan;125;0;31407;2028
2021-03-26;SD;Sudan;0;0;31407;2028
2021-03-27;SD;Sudan;0;0;31407;2028
2021-03-28;SD;Sudan;0;0;31407;2028
2021-03-29;SD;Sudan;0;0;31407;2028
2021-03-30;SD;Sudan;0;13;31407;2041
2021-03-31;SD;Sudan;426;22;31833;2063
2021-04-01;SD;Sudan;0;0;31833;2063
2021-04-02;SD;Sudan;0;0;31833;2063
2021-04-03;SD;Sudan;0;0;31833;2063
2021-04-04;SD;Sudan;0;0;31833;2063
2021-04-05;SD;Sudan;0;0;31833;2063
2021-04-06;SD;Sudan;0;0;31833;2063
2021-04-07;SD;Sudan;0;0;31833;2063
2021-04-08;SD;Sudan;0;0;31833;2063
2021-04-09;SD;Sudan;0;0;31833;2063
2021-04-10;SD;Sudan;0;0;31833;2063
2021-04-11;SD;Sudan;0;0;31833;2063
2021-04-12;SD;Sudan;0;0;31833;2063
2021-04-13;SD;Sudan;0;131;31833;2194
2021-04-14;SD;Sudan;1099;14;32932;2208
2021-04-15;SD;Sudan;0;0;32932;2208
2021-04-16;SD;Sudan;90;0;33022;2208
2021-04-17;SD;Sudan;0;0;33022;2208
2021-04-18;SD;Sudan;0;0;33022;2208
2021-04-19;SD;Sudan;0;73;33022;2281
2021-04-20;SD;Sudan;61;6;33083;2287
2021-04-21;SD;Sudan;74;2;33157;2289
2021-04-22;SD;Sudan;442;11;33599;2300
2021-04-23;SD;Sudan;74;0;33673;2300
2021-04-24;SD;Sudan;0;0;33673;2300
2021-04-25;SD;Sudan;0;0;33673;2300
2021-04-26;SD;Sudan;0;40;33673;2340
2021-04-27;SD;Sudan;218;9;33891;2349
2021-04-28;SD;Sudan;53;0;33944;2349
2021-04-29;SD;Sudan;0;0;33944;2349
2021-04-30;SD;Sudan;0;0;33944;2349
2021-05-01;SD;Sudan;0;0;33944;2349
2021-05-02;SD;Sudan;0;0;33944;2349
2021-05-03;SD;Sudan;0;0;33944;2349
2021-05-04;SD;Sudan;0;16;33944;2365
2021-05-05;SD;Sudan;138;0;34082;2365
2021-05-06;SD;Sudan;379;0;34461;2365
2021-05-07;SD;Sudan;0;0;34461;2365
2021-05-08;SD;Sudan;0;0;34461;2365
2021-05-09;SD;Sudan;0;0;34461;2365
2021-05-10;SD;Sudan;428;81;34889;2446
2021-05-11;SD;Sudan;0;0;34889;2446
2021-05-12;SD;Sudan;0;0;34889;2446
2021-05-13;SD;Sudan;0;0;34889;2446
2021-05-14;SD;Sudan;0;0;34889;2446
2021-05-15;SD;Sudan;0;0;34889;2446
2021-05-16;SD;Sudan;0;0;34889;2446
2021-05-17;SD;Sudan;0;0;34889;2446
2021-05-18;SD;Sudan;0;0;34889;2446
2021-05-19;SD;Sudan;0;0;34889;2446
2021-05-20;SD;Sudan;0;122;34889;2568
2021-05-21;SD;Sudan;0;0;34889;2568
2021-05-22;SD;Sudan;0;0;34889;2568
2021-05-23;SD;Sudan;0;0;34889;2568
2021-05-24;SD;Sudan;0;32;34889;2600
2021-05-25;SD;Sudan;0;0;34889;2600
2021-05-26;SD;Sudan;0;0;34889;2600
2021-05-27;SD;Sudan;0;0;34889;2600
2021-05-28;SD;Sudan;400;0;35289;2600
2021-05-29;SD;Sudan;0;0;35289;2600
2021-05-30;SD;Sudan;0;30;35289;2630
2021-05-31;SD;Sudan;206;1;35495;2631
2021-06-01;SD;Sudan;17;31;35512;2662
2021-06-02;SD;Sudan;25;0;35537;2662
2021-06-03;SD;Sudan;119;0;35656;2662
2021-06-04;SD;Sudan;0;0;35656;2662
2021-06-05;SD;Sudan;0;0;35656;2662
2021-06-06;SD;Sudan;0;35;35656;2697
2021-06-07;SD;Sudan;348;0;36004;2697
2021-06-08;SD;Sudan;0;14;36004;2711
2021-06-09;SD;Sudan;118;8;36122;2719
2021-06-10;SD;Sudan;81;0;36203;2719
2021-06-11;SD;Sudan;0;0;36203;2719
2021-06-12;SD;Sudan;0;0;36203;2719
2021-06-13;SD;Sudan;0;13;36203;2732
2021-06-14;SD;Sudan;101;0;36304;2732
2021-06-15;SD;Sudan;0;0;36304;2732
2021-06-16;SD;Sudan;0;5;36304;2737
2021-06-17;SD;Sudan;43;0;36347;2737
2021-06-18;SD;Sudan;0;0;36347;2737
2021-06-19;SD;Sudan;0;0;36347;2737
2021-06-20;SD;Sudan;0;0;36347;2737
2021-06-21;SD;Sudan;0;0;36347;2737
2021-06-22;SD;Sudan;0;11;36347;2748
2021-06-23;SD;Sudan;175;2;36522;2750
2021-06-24;SD;Sudan;36;0;36558;2750
2021-06-25;SD;Sudan;16;0;36574;2750
2021-06-26;SD;Sudan;0;0;36574;2750
2021-06-27;SD;Sudan;0;4;36574;2754
2021-06-28;SD;Sudan;46;0;36620;2754
2021-06-29;SD;Sudan;0;0;36620;2754
2021-06-30;SD;Sudan;38;0;36658;2754
2021-07-01;SD;Sudan;0;6;36658;2760
2020-03-14;SR;Suriname;1;0;1;0
2020-03-15;SR;Suriname;0;0;1;0
2020-03-16;SR;Suriname;0;0;1;0
2020-03-17;SR;Suriname;0;0;1;0
2020-03-18;SR;Suriname;0;0;1;0
2020-03-19;SR;Suriname;0;0;1;0
2020-03-20;SR;Suriname;3;0;4;0
2020-03-21;SR;Suriname;0;0;4;0
2020-03-22;SR;Suriname;1;0;5;0
2020-03-23;SR;Suriname;0;0;5;0
2020-03-24;SR;Suriname;2;0;7;0
2020-03-25;SR;Suriname;1;0;8;0
2020-03-26;SR;Suriname;0;0;8;0
2020-03-27;SR;Suriname;0;0;8;0
2020-03-28;SR;Suriname;0;0;8;0
2020-03-29;SR;Suriname;0;0;8;0
2020-03-30;SR;Suriname;0;0;8;0
2020-03-31;SR;Suriname;1;0;9;0
2020-04-01;SR;Suriname;1;0;10;0
2020-04-02;SR;Suriname;0;0;10;0
2020-04-03;SR;Suriname;0;1;10;1
2020-04-04;SR;Suriname;0;0;10;1
2020-04-05;SR;Suriname;0;0;10;1
2020-04-06;SR;Suriname;0;0;10;1
2020-04-07;SR;Suriname;0;0;10;1
2020-04-08;SR;Suriname;0;0;10;1
2020-04-09;SR;Suriname;0;0;10;1
2020-04-10;SR;Suriname;0;0;10;1
2020-04-11;SR;Suriname;0;0;10;1
2020-04-12;SR;Suriname;0;0;10;1
2020-04-13;SR;Suriname;0;0;10;1
2020-04-14;SR;Suriname;0;0;10;1
2020-04-15;SR;Suriname;0;0;10;1
2020-04-16;SR;Suriname;0;0;10;1
2020-04-17;SR;Suriname;0;0;10;1
2020-04-18;SR;Suriname;0;0;10;1
2020-04-19;SR;Suriname;0;0;10;1
2020-04-20;SR;Suriname;0;0;10;1
2020-04-21;SR;Suriname;0;0;10;1
2020-04-22;SR;Suriname;0;0;10;1
2020-04-23;SR;Suriname;0;0;10;1
2020-04-24;SR;Suriname;0;0;10;1
2020-04-25;SR;Suriname;0;0;10;1
2020-04-26;SR;Suriname;0;0;10;1
2020-04-27;SR;Suriname;0;0;10;1
2020-04-28;SR;Suriname;0;0;10;1
2020-04-29;SR;Suriname;0;0;10;1
2020-04-30;SR;Suriname;0;0;10;1
2020-05-01;SR;Suriname;0;0;10;1
2020-05-02;SR;Suriname;0;0;10;1
2020-05-03;SR;Suriname;0;0;10;1
2020-05-04;SR;Suriname;0;0;10;1
2020-05-05;SR;Suriname;0;0;10;1
2020-05-06;SR;Suriname;0;0;10;1
2020-05-07;SR;Suriname;0;0;10;1
2020-05-08;SR;Suriname;0;0;10;1
2020-05-09;SR;Suriname;0;0;10;1
2020-05-10;SR;Suriname;0;0;10;1
2020-05-11;SR;Suriname;0;0;10;1
2020-05-12;SR;Suriname;0;0;10;1
2020-05-13;SR;Suriname;0;0;10;1
2020-05-14;SR;Suriname;0;0;10;1
2020-05-15;SR;Suriname;0;0;10;1
2020-05-16;SR;Suriname;0;0;10;1
2020-05-17;SR;Suriname;0;0;10;1
2020-05-18;SR;Suriname;1;0;11;1
2020-05-19;SR;Suriname;0;0;11;1
2020-05-20;SR;Suriname;0;0;11;1
2020-05-21;SR;Suriname;0;0;11;1
2020-05-22;SR;Suriname;0;0;11;1
2020-05-23;SR;Suriname;0;0;11;1
2020-05-24;SR;Suriname;0;0;11;1
2020-05-25;SR;Suriname;0;0;11;1
2020-05-26;SR;Suriname;0;0;11;1
2020-05-27;SR;Suriname;1;0;12;1
2020-05-28;SR;Suriname;0;0;12;1
2020-05-29;SR;Suriname;0;0;12;1
2020-05-30;SR;Suriname;2;0;14;1
2020-05-31;SR;Suriname;9;0;23;1
2020-06-01;SR;Suriname;21;0;44;1
2020-06-02;SR;Suriname;10;0;54;1
2020-06-03;SR;Suriname;20;0;74;1
2020-06-04;SR;Suriname;8;0;82;1
2020-06-05;SR;Suriname;8;0;90;1
2020-06-06;SR;Suriname;10;0;100;1
2020-06-07;SR;Suriname;22;0;122;1
2020-06-08;SR;Suriname;6;1;128;2
2020-06-09;SR;Suriname;9;0;137;2
2020-06-10;SR;Suriname;7;0;144;2
2020-06-11;SR;Suriname;24;0;168;2
2020-06-12;SR;Suriname;19;1;187;3
2020-06-13;SR;Suriname;9;0;196;3
2020-06-14;SR;Suriname;12;0;208;3
2020-06-15;SR;Suriname;21;2;229;5
2020-06-16;SR;Suriname;7;1;236;6
2020-06-17;SR;Suriname;25;0;261;6
2020-06-18;SR;Suriname;16;1;277;7
2020-06-19;SR;Suriname;16;1;293;8
2020-06-20;SR;Suriname;10;0;303;8
2020-06-21;SR;Suriname;11;0;314;8
2020-06-22;SR;Suriname;5;0;319;8
2020-06-23;SR;Suriname;0;1;319;9
2020-06-24;SR;Suriname;38;1;357;10
2020-06-25;SR;Suriname;16;0;373;10
2020-06-26;SR;Suriname;16;0;389;10
2020-06-27;SR;Suriname;78;1;467;11
2020-06-28;SR;Suriname;23;0;490;11
2020-06-29;SR;Suriname;11;2;501;13
2020-06-30;SR;Suriname;14;0;515;13
2020-07-01;SR;Suriname;20;0;535;13
2020-07-02;SR;Suriname;12;0;547;13
2020-07-03;SR;Suriname;14;0;561;13
2020-07-04;SR;Suriname;4;1;565;14
2020-07-05;SR;Suriname;29;0;594;14
2020-07-06;SR;Suriname;20;0;614;14
2020-07-07;SR;Suriname;20;1;634;15
2020-07-08;SR;Suriname;31;2;665;17
2020-07-09;SR;Suriname;29;0;694;17
2020-07-10;SR;Suriname;32;1;726;18
2020-07-11;SR;Suriname;15;0;741;18
2020-07-12;SR;Suriname;0;0;741;18
2020-07-13;SR;Suriname;39;0;780;18
2020-07-14;SR;Suriname;21;0;801;18
2020-07-15;SR;Suriname;36;0;837;18
2020-07-16;SR;Suriname;67;0;904;18
2020-07-17;SR;Suriname;39;1;943;19
2020-07-18;SR;Suriname;58;1;1001;20
2020-07-19;SR;Suriname;28;1;1029;21
2020-07-20;SR;Suriname;50;0;1079;21
2020-07-21;SR;Suriname;52;0;1131;21
2020-07-22;SR;Suriname;45;0;1176;21
2020-07-23;SR;Suriname;58;2;1234;23
2020-07-24;SR;Suriname;71;0;1305;23
2020-07-25;SR;Suriname;76;0;1381;23
2020-07-26;SR;Suriname;58;0;1439;23
2020-07-27;SR;Suriname;44;1;1483;24
2020-07-28;SR;Suriname;27;0;1510;24
2020-07-29;SR;Suriname;97;2;1607;26
2020-07-30;SR;Suriname;0;0;1607;26
2020-07-31;SR;Suriname;43;0;1650;26
2020-08-01;SR;Suriname;110;0;1760;26
2020-08-02;SR;Suriname;89;1;1849;27
2020-08-03;SR;Suriname;44;0;1893;27
2020-08-04;SR;Suriname;88;0;1981;27
2020-08-05;SR;Suriname;69;0;2050;27
2020-08-06;SR;Suriname;46;2;2096;29
2020-08-07;SR;Suriname;107;0;2203;29
2020-08-08;SR;Suriname;103;0;2306;29
2020-08-09;SR;Suriname;85;0;2391;29
2020-08-10;SR;Suriname;98;1;2489;30
2020-08-11;SR;Suriname;70;9;2559;39
2020-08-12;SR;Suriname;94;0;2653;39
2020-08-13;SR;Suriname;108;1;2761;40
2020-08-14;SR;Suriname;77;1;2838;41
2020-08-15;SR;Suriname;123;1;2961;42
2020-08-16;SR;Suriname;55;5;3016;47
2020-08-17;SR;Suriname;61;1;3077;48
2020-08-18;SR;Suriname;139;6;3216;54
2020-08-19;SR;Suriname;79;0;3295;54
2020-08-20;SR;Suriname;71;1;3366;55
2020-08-21;SR;Suriname;94;1;3460;56
2020-08-22;SR;Suriname;109;1;3569;57
2020-08-23;SR;Suriname;38;1;3607;58
2020-08-24;SR;Suriname;25;2;3632;60
2020-08-25;SR;Suriname;66;1;3698;61
2020-08-26;SR;Suriname;26;1;3724;62
2020-08-27;SR;Suriname;69;4;3793;66
2020-08-28;SR;Suriname;55;0;3848;66
2020-08-29;SR;Suriname;106;1;3954;67
2020-08-30;SR;Suriname;55;0;4009;67
2020-08-31;SR;Suriname;25;4;4034;71
2020-09-01;SR;Suriname;55;1;4089;72
2020-09-02;SR;Suriname;60;0;4149;72
2020-09-03;SR;Suriname;66;1;4215;73
2020-09-04;SR;Suriname;37;2;4252;75
2020-09-05;SR;Suriname;68;1;4320;76
2020-09-06;SR;Suriname;26;9;4346;85
2020-09-07;SR;Suriname;14;6;4360;91
2020-09-08;SR;Suriname;59;0;4419;91
2020-09-09;SR;Suriname;28;1;4447;92
2020-09-10;SR;Suriname;30;1;4477;93
2020-09-11;SR;Suriname;52;0;4529;93
2020-09-12;SR;Suriname;50;0;4579;93
2020-09-13;SR;Suriname;3;0;4582;93
2020-09-14;SR;Suriname;29;2;4611;95
2020-09-15;SR;Suriname;14;0;4625;95
2020-09-16;SR;Suriname;20;0;4645;95
2020-09-17;SR;Suriname;26;0;4671;95
2020-09-18;SR;Suriname;20;1;4691;96
2020-09-19;SR;Suriname;18;1;4709;97
2020-09-20;SR;Suriname;14;0;4723;97
2020-09-21;SR;Suriname;17;0;4740;97
2020-09-22;SR;Suriname;19;3;4759;100
2020-09-23;SR;Suriname;20;1;4779;101
2020-09-24;SR;Suriname;10;1;4789;102
2020-09-25;SR;Suriname;28;0;4817;102
2020-09-26;SR;Suriname;14;0;4831;102
2020-09-27;SR;Suriname;4;0;4835;102
2020-09-28;SR;Suriname;1;0;4836;102
2020-09-29;SR;Suriname;27;2;4863;104
2020-09-30;SR;Suriname;14;0;4877;104
2020-10-01;SR;Suriname;14;1;4891;105
2020-10-02;SR;Suriname;8;0;4899;105
2020-10-03;SR;Suriname;25;1;4924;106
2020-10-04;SR;Suriname;17;0;4941;106
2020-10-05;SR;Suriname;13;0;4954;106
2020-10-06;SR;Suriname;11;0;4965;106
2020-10-07;SR;Suriname;14;0;4979;106
2020-10-08;SR;Suriname;25;0;5004;106
2020-10-09;SR;Suriname;14;0;5018;106
2020-10-10;SR;Suriname;17;1;5035;107
2020-10-11;SR;Suriname;16;0;5051;107
2020-10-12;SR;Suriname;7;0;5058;107
2020-10-13;SR;Suriname;14;0;5072;107
2020-10-14;SR;Suriname;11;1;5083;108
2020-10-15;SR;Suriname;11;1;5094;109
2020-10-16;SR;Suriname;19;0;5113;109
2020-10-17;SR;Suriname;10;0;5123;109
2020-10-18;SR;Suriname;7;0;5130;109
2020-10-19;SR;Suriname;3;0;5133;109
2020-10-20;SR;Suriname;11;0;5144;109
2020-10-21;SR;Suriname;6;0;5150;109
2020-10-22;SR;Suriname;4;0;5154;109
2020-10-23;SR;Suriname;1;0;5155;109
2020-10-24;SR;Suriname;11;0;5166;109
2020-10-25;SR;Suriname;4;0;5170;109
2020-10-26;SR;Suriname;10;1;5180;110
2020-10-27;SR;Suriname;7;1;5187;111
2020-10-28;SR;Suriname;5;0;5192;111
2020-10-29;SR;Suriname;5;0;5197;111
2020-10-30;SR;Suriname;4;0;5201;111
2020-10-31;SR;Suriname;2;0;5203;111
2020-11-01;SR;Suriname;7;0;5210;111
2020-11-02;SR;Suriname;2;0;5212;111
2020-11-03;SR;Suriname;6;0;5218;111
2020-11-04;SR;Suriname;2;1;5220;112
2020-11-05;SR;Suriname;5;0;5225;112
2020-11-06;SR;Suriname;2;0;5227;112
2020-11-07;SR;Suriname;7;1;5234;113
2020-11-08;SR;Suriname;5;0;5239;113
2020-11-09;SR;Suriname;2;0;5241;113
2020-11-10;SR;Suriname;4;0;5245;113
2020-11-11;SR;Suriname;9;0;5254;113
2020-11-12;SR;Suriname;7;1;5261;114
2020-11-13;SR;Suriname;7;0;5268;114
2020-11-14;SR;Suriname;6;0;5274;114
2020-11-15;SR;Suriname;0;0;5274;114
2020-11-16;SR;Suriname;1;1;5275;115
2020-11-17;SR;Suriname;3;1;5278;116
2020-11-18;SR;Suriname;4;0;5282;116
2020-11-19;SR;Suriname;2;0;5284;116
2020-11-20;SR;Suriname;5;0;5289;116
2020-11-21;SR;Suriname;6;0;5295;116
2020-11-22;SR;Suriname;1;0;5296;116
2020-11-23;SR;Suriname;1;0;5297;116
2020-11-24;SR;Suriname;3;1;5300;117
2020-11-25;SR;Suriname;5;0;5305;117
2020-11-26;SR;Suriname;2;0;5307;117
2020-11-27;SR;Suriname;4;0;5311;117
2020-11-28;SR;Suriname;1;0;5312;117
2020-11-29;SR;Suriname;0;0;5312;117
2020-11-30;SR;Suriname;0;0;5312;117
2020-12-01;SR;Suriname;7;0;5319;117
2020-12-02;SR;Suriname;1;0;5320;117
2020-12-03;SR;Suriname;2;0;5322;117
2020-12-04;SR;Suriname;0;0;5322;117
2020-12-05;SR;Suriname;2;0;5324;117
2020-12-06;SR;Suriname;0;0;5324;117
2020-12-07;SR;Suriname;1;0;5325;117
2020-12-08;SR;Suriname;1;0;5326;117
2020-12-09;SR;Suriname;7;0;5333;117
2020-12-10;SR;Suriname;4;0;5337;117
2020-12-11;SR;Suriname;2;0;5339;117
2020-12-12;SR;Suriname;1;0;5340;117
2020-12-13;SR;Suriname;13;0;5353;117
2020-12-14;SR;Suriname;6;0;5359;117
2020-12-15;SR;Suriname;22;0;5381;117
2020-12-16;SR;Suriname;20;0;5401;117
2020-12-17;SR;Suriname;27;0;5428;117
2020-12-18;SR;Suriname;31;0;5459;117
2020-12-19;SR;Suriname;52;1;5511;118
2020-12-20;SR;Suriname;41;0;5552;118
2020-12-21;SR;Suriname;31;0;5583;118
2020-12-22;SR;Suriname;86;0;5669;118
2020-12-23;SR;Suriname;65;0;5734;118
2020-12-24;SR;Suriname;76;0;5810;118
2020-12-25;SR;Suriname;70;1;5880;119
2020-12-26;SR;Suriname;58;0;5938;119
2020-12-27;SR;Suriname;40;0;5978;119
2020-12-28;SR;Suriname;35;1;6013;120
2020-12-29;SR;Suriname;85;0;6098;120
2020-12-30;SR;Suriname;83;1;6181;121
2020-12-31;SR;Suriname;29;1;6210;122
2021-01-01;SR;Suriname;67;1;6277;123
2021-01-02;SR;Suriname;66;0;6343;123
2021-01-03;SR;Suriname;50;0;6393;123
2021-01-04;SR;Suriname;100;1;6493;124
2021-01-05;SR;Suriname;93;1;6586;125
2021-01-06;SR;Suriname;80;1;6666;126
2021-01-07;SR;Suriname;84;4;6750;130
2021-01-08;SR;Suriname;104;1;6854;131
2021-01-09;SR;Suriname;94;1;6948;132
2021-01-10;SR;Suriname;60;1;7008;133
2021-01-11;SR;Suriname;56;5;7064;138
2021-01-12;SR;Suriname;114;0;7178;138
2021-01-13;SR;Suriname;69;1;7247;139
2021-01-14;SR;Suriname;53;0;7300;139
2021-01-15;SR;Suriname;109;0;7409;139
2021-01-16;SR;Suriname;60;2;7469;141
2021-01-17;SR;Suriname;58;0;7527;141
2021-01-18;SR;Suriname;97;4;7624;145
2021-01-19;SR;Suriname;85;1;7709;146
2021-01-20;SR;Suriname;74;0;7783;146
2021-01-21;SR;Suriname;97;0;7880;146
2021-01-22;SR;Suriname;65;2;7945;148
2021-01-23;SR;Suriname;55;0;8000;148
2021-01-24;SR;Suriname;57;1;8057;149
2021-01-25;SR;Suriname;55;0;8112;149
2021-01-26;SR;Suriname;62;1;8174;150
2021-01-27;SR;Suriname;69;2;8243;152
2021-01-28;SR;Suriname;50;2;8293;154
2021-01-29;SR;Suriname;71;0;8364;154
2021-01-30;SR;Suriname;39;0;8403;154
2021-01-31;SR;Suriname;35;0;8438;154
2021-02-01;SR;Suriname;11;2;8449;156
2021-02-02;SR;Suriname;48;0;8497;156
2021-02-03;SR;Suriname;59;0;8556;156
2021-02-04;SR;Suriname;39;2;8595;158
2021-02-05;SR;Suriname;24;0;8619;158
2021-02-06;SR;Suriname;31;2;8650;160
2021-02-07;SR;Suriname;21;1;8671;161
2021-02-08;SR;Suriname;19;1;8690;162
2021-02-09;SR;Suriname;20;1;8710;163
2021-02-10;SR;Suriname;29;1;8739;164
2021-02-11;SR;Suriname;26;2;8765;166
2021-02-12;SR;Suriname;13;0;8778;166
2021-02-13;SR;Suriname;16;0;8794;166
2021-02-14;SR;Suriname;9;0;8803;166
2021-02-15;SR;Suriname;8;1;8811;167
2021-02-16;SR;Suriname;9;0;8820;167
2021-02-17;SR;Suriname;12;1;8832;168
2021-02-18;SR;Suriname;6;0;8838;168
2021-02-19;SR;Suriname;16;0;8854;168
2021-02-20;SR;Suriname;2;0;8856;168
2021-02-21;SR;Suriname;12;0;8868;168
2021-02-22;SR;Suriname;1;1;8869;169
2021-02-23;SR;Suriname;11;1;8880;170
2021-02-24;SR;Suriname;12;0;8892;170
2021-02-25;SR;Suriname;9;0;8901;170
2021-02-26;SR;Suriname;12;0;8913;170
2021-02-27;SR;Suriname;6;0;8919;170
2021-02-28;SR;Suriname;10;2;8929;172
2021-03-01;SR;Suriname;4;1;8933;173
2021-03-02;SR;Suriname;6;0;8939;173
2021-03-03;SR;Suriname;14;0;8953;173
2021-03-04;SR;Suriname;6;2;8959;175
2021-03-05;SR;Suriname;7;0;8966;175
2021-03-06;SR;Suriname;5;0;8971;175
2021-03-07;SR;Suriname;6;0;8977;175
2021-03-08;SR;Suriname;3;0;8980;175
2021-03-09;SR;Suriname;5;0;8985;175
2021-03-10;SR;Suriname;5;0;8990;175
2021-03-11;SR;Suriname;7;1;8997;176
2021-03-12;SR;Suriname;15;0;9012;176
2021-03-13;SR;Suriname;10;0;9022;176
2021-03-14;SR;Suriname;2;0;9024;176
2021-03-15;SR;Suriname;4;0;9028;176
2021-03-16;SR;Suriname;6;0;9034;176
2021-03-17;SR;Suriname;8;0;9042;176
2021-03-18;SR;Suriname;7;0;9049;176
2021-03-19;SR;Suriname;6;0;9055;176
2021-03-20;SR;Suriname;6;0;9061;176
2021-03-21;SR;Suriname;5;0;9066;176
2021-03-22;SR;Suriname;1;1;9067;177
2021-03-23;SR;Suriname;7;0;9074;177
2021-03-24;SR;Suriname;3;0;9077;177
2021-03-25;SR;Suriname;8;0;9085;177
2021-03-26;SR;Suriname;3;0;9088;177
2021-03-27;SR;Suriname;7;0;9095;177
2021-03-28;SR;Suriname;2;0;9097;177
2021-03-29;SR;Suriname;7;0;9104;177
2021-03-30;SR;Suriname;5;0;9109;177
2021-03-31;SR;Suriname;13;0;9122;177
2021-04-01;SR;Suriname;0;0;9122;177
2021-04-02;SR;Suriname;8;0;9130;177
2021-04-03;SR;Suriname;23;0;9153;177
2021-04-04;SR;Suriname;10;0;9163;177
2021-04-05;SR;Suriname;11;0;9174;177
2021-04-06;SR;Suriname;10;1;9184;178
2021-04-07;SR;Suriname;16;0;9200;178
2021-04-08;SR;Suriname;54;0;9254;178
2021-04-09;SR;Suriname;11;0;9265;178
2021-04-10;SR;Suriname;13;1;9278;179
2021-04-11;SR;Suriname;24;3;9302;182
2021-04-12;SR;Suriname;14;0;9316;182
2021-04-13;SR;Suriname;47;2;9363;184
2021-04-14;SR;Suriname;54;0;9417;184
2021-04-15;SR;Suriname;41;1;9458;185
2021-04-16;SR;Suriname;38;2;9496;187
2021-04-17;SR;Suriname;49;0;9545;187
2021-04-18;SR;Suriname;36;0;9581;187
2021-04-19;SR;Suriname;0;0;9581;187
2021-04-20;SR;Suriname;106;1;9687;188
2021-04-21;SR;Suriname;104;1;9791;189
2021-04-22;SR;Suriname;74;2;9865;191
2021-04-23;SR;Suriname;67;2;9932;193
2021-04-24;SR;Suriname;64;2;9996;195
2021-04-25;SR;Suriname;49;3;10045;198
2021-04-26;SR;Suriname;36;3;10081;201
2021-04-27;SR;Suriname;76;0;10157;201
2021-04-28;SR;Suriname;61;0;10218;201
2021-04-29;SR;Suriname;68;0;10286;201
2021-04-30;SR;Suriname;77;3;10363;204
2021-05-01;SR;Suriname;65;0;10428;204
2021-05-02;SR;Suriname;61;3;10489;207
2021-05-03;SR;Suriname;54;0;10543;207
2021-05-04;SR;Suriname;80;5;10623;212
2021-05-05;SR;Suriname;73;0;10696;212
2021-05-06;SR;Suriname;120;1;10816;213
2021-05-07;SR;Suriname;117;1;10933;214
2021-05-08;SR;Suriname;87;0;11020;214
2021-05-09;SR;Suriname;92;1;11112;215
2021-05-10;SR;Suriname;101;3;11213;218
2021-05-11;SR;Suriname;93;2;11306;220
2021-05-12;SR;Suriname;121;0;11427;220
2021-05-13;SR;Suriname;145;1;11572;221
2021-05-14;SR;Suriname;135;2;11707;223
2021-05-15;SR;Suriname;121;1;11828;224
2021-05-16;SR;Suriname;122;4;11950;228
2021-05-17;SR;Suriname;157;2;12107;230
2021-05-18;SR;Suriname;144;8;12251;238
2021-05-19;SR;Suriname;158;1;12409;239
2021-05-20;SR;Suriname;162;1;12571;240
2021-05-21;SR;Suriname;171;3;12742;243
2021-05-22;SR;Suriname;186;2;12928;245
2021-05-23;SR;Suriname;183;4;13111;249
2021-05-24;SR;Suriname;191;7;13302;256
2021-05-25;SR;Suriname;193;5;13495;261
2021-05-26;SR;Suriname;225;7;13720;268
2021-05-27;SR;Suriname;292;7;14012;275
2021-05-28;SR;Suriname;293;7;14305;282
2021-05-29;SR;Suriname;210;6;14515;288
2021-05-30;SR;Suriname;249;4;14764;292
2021-05-31;SR;Suriname;190;10;14954;302
2021-06-01;SR;Suriname;174;11;15128;313
2021-06-02;SR;Suriname;300;3;15428;316
2021-06-03;SR;Suriname;248;9;15676;325
2021-06-04;SR;Suriname;333;7;16009;332
2021-06-05;SR;Suriname;283;7;16292;339
2021-06-06;SR;Suriname;249;11;16541;350
2021-06-07;SR;Suriname;245;5;16786;355
2021-06-08;SR;Suriname;255;8;17041;363
2021-06-09;SR;Suriname;272;10;17313;373
2021-06-10;SR;Suriname;233;11;17546;384
2021-06-11;SR;Suriname;253;6;17799;390
2021-06-12;SR;Suriname;311;3;18110;393
2021-06-13;SR;Suriname;262;11;18372;404
2021-06-14;SR;Suriname;227;8;18599;412
2021-06-15;SR;Suriname;226;6;18825;418
2021-06-16;SR;Suriname;283;9;19108;427
2021-06-17;SR;Suriname;253;9;19361;436
2021-06-18;SR;Suriname;215;7;19576;443
2021-06-19;SR;Suriname;172;11;19748;454
2021-06-20;SR;Suriname;277;6;20025;460
2021-06-21;SR;Suriname;116;7;20141;467
2021-06-22;SR;Suriname;157;10;20298;477
2021-06-23;SR;Suriname;251;5;20549;482
2021-06-24;SR;Suriname;174;8;20723;490
2021-06-25;SR;Suriname;188;4;20911;494
2021-06-26;SR;Suriname;149;5;21060;499
2021-06-27;SR;Suriname;189;8;21249;507
2021-06-28;SR;Suriname;111;5;21360;512
2021-06-29;SR;Suriname;159;4;21519;516
2021-06-30;SR;Suriname;213;6;21732;522
2021-07-01;SR;Suriname;204;9;21936;531
2020-02-01;SE;Sweden;1;0;1;0
2020-02-02;SE;Sweden;0;0;1;0
2020-02-03;SE;Sweden;0;0;1;0
2020-02-04;SE;Sweden;0;0;1;0
2020-02-05;SE;Sweden;0;0;1;0
2020-02-06;SE;Sweden;0;0;1;0
2020-02-07;SE;Sweden;0;0;1;0
2020-02-08;SE;Sweden;0;0;1;0
2020-02-09;SE;Sweden;0;0;1;0
2020-02-10;SE;Sweden;0;0;1;0
2020-02-11;SE;Sweden;0;0;1;0
2020-02-12;SE;Sweden;0;0;1;0
2020-02-13;SE;Sweden;0;0;1;0
2020-02-14;SE;Sweden;0;0;1;0
2020-02-15;SE;Sweden;0;0;1;0
2020-02-16;SE;Sweden;0;0;1;0
2020-02-17;SE;Sweden;0;0;1;0
2020-02-18;SE;Sweden;0;0;1;0
2020-02-19;SE;Sweden;0;0;1;0
2020-02-20;SE;Sweden;0;0;1;0
2020-02-21;SE;Sweden;0;0;1;0
2020-02-22;SE;Sweden;0;0;1;0
2020-02-23;SE;Sweden;0;0;1;0
2020-02-24;SE;Sweden;0;0;1;0
2020-02-25;SE;Sweden;0;0;1;0
2020-02-26;SE;Sweden;1;0;2;0
2020-02-27;SE;Sweden;1;0;3;0
2020-02-28;SE;Sweden;8;0;11;0
2020-02-29;SE;Sweden;3;0;14;0
2020-03-01;SE;Sweden;0;0;14;0
2020-03-02;SE;Sweden;5;0;19;0
2020-03-03;SE;Sweden;13;0;32;0
2020-03-04;SE;Sweden;30;0;62;0
2020-03-05;SE;Sweden;25;0;87;0
2020-03-06;SE;Sweden;59;0;146;0
2020-03-07;SE;Sweden;33;0;179;0
2020-03-08;SE;Sweden;46;0;225;0
2020-03-09;SE;Sweden;101;0;326;0
2020-03-10;SE;Sweden;98;1;424;1
2020-03-11;SE;Sweden;196;0;620;1
2020-03-12;SE;Sweden;151;1;771;2
2020-03-13;SE;Sweden;152;1;923;3
2020-03-14;SE;Sweden;71;2;994;5
2020-03-15;SE;Sweden;69;2;1063;7
2020-03-16;SE;Sweden;83;1;1146;8
2020-03-17;SE;Sweden;119;6;1265;14
2020-03-18;SE;Sweden;145;7;1410;21
2020-03-19;SE;Sweden;143;9;1553;30
2020-03-20;SE;Sweden;180;8;1733;38
2020-03-21;SE;Sweden;135;11;1868;49
2020-03-22;SE;Sweden;118;11;1986;60
2020-03-23;SE;Sweden;182;21;2168;81
2020-03-24;SE;Sweden;230;22;2398;103
2020-03-25;SE;Sweden;314;31;2712;134
2020-03-26;SE;Sweden;286;32;2998;166
2020-03-27;SE;Sweden;365;35;3363;201
2020-03-28;SE;Sweden;300;38;3663;239
2020-03-29;SE;Sweden;280;45;3943;284
2020-03-30;SE;Sweden;416;48;4359;332
2020-03-31;SE;Sweden;475;53;4834;385
2020-04-01;SE;Sweden;486;70;5320;455
2020-04-02;SE;Sweden;554;80;5874;535
2020-04-03;SE;Sweden;601;70;6475;605
2020-04-04;SE;Sweden;357;-232;6832;373
2020-04-05;SE;Sweden;340;28;7172;401
2020-04-06;SE;Sweden;389;76;7561;477
2020-04-07;SE;Sweden;738;114;8299;591
2020-04-08;SE;Sweden;655;96;8954;687
2020-04-09;SE;Sweden;645;106;9599;793
2020-04-10;SE;Sweden;454;77;10053;870
2020-04-11;SE;Sweden;395;17;10448;887
2020-04-12;SE;Sweden;464;12;10912;899
2020-04-13;SE;Sweden;437;20;11349;919
2020-04-14;SE;Sweden;479;114;11828;1033
2020-04-15;SE;Sweden;604;170;12432;1203
2020-04-16;SE;Sweden;623;130;13055;1333
2020-04-17;SE;Sweden;688;67;13743;1400
2020-04-18;SE;Sweden;532;111;14275;1511
2020-04-19;SE;Sweden;388;29;14663;1540
2020-04-20;SE;Sweden;461;40;15124;1580
2020-04-21;SE;Sweden;707;185;15831;1765
2020-04-22;SE;Sweden;722;172;16553;1937
2020-04-23;SE;Sweden;758;84;17311;2021
2020-04-24;SE;Sweden;779;131;18090;2152
2020-04-25;SE;Sweden;473;40;18563;2192
2020-04-26;SE;Sweden;300;2;18863;2194
2020-04-27;SE;Sweden;563;80;19426;2274
2020-04-28;SE;Sweden;742;81;20168;2355
2020-04-29;SE;Sweden;798;107;20966;2462
2020-04-30;SE;Sweden;635;124;21601;2586
2020-05-01;SE;Sweden;532;67;22133;2653
2020-05-02;SE;Sweden;299;16;22432;2669
2020-05-03;SE;Sweden;261;10;22693;2679
2020-05-04;SE;Sweden;476;90;23169;2769
2020-05-05;SE;Sweden;657;85;23826;2854
2020-05-06;SE;Sweden;746;87;24572;2941
2020-05-07;SE;Sweden;787;99;25359;3040
2020-05-08;SE;Sweden;700;135;26059;3175
2020-05-09;SE;Sweden;509;45;26568;3220
2020-05-10;SE;Sweden;278;5;26846;3225
2020-05-11;SE;Sweden;455;31;27301;3256
2020-05-12;SE;Sweden;754;57;28055;3313
2020-05-13;SE;Sweden;700;147;28755;3460
2020-05-14;SE;Sweden;660;69;29415;3529
2020-05-15;SE;Sweden;688;117;30103;3646
2020-05-16;SE;Sweden;358;28;30461;3674
2020-05-17;SE;Sweden;259;5;30720;3679
2020-05-18;SE;Sweden;431;19;31151;3698
2020-05-19;SE;Sweden;667;45;31818;3743
2020-05-20;SE;Sweden;808;88;32626;3831
2020-05-21;SE;Sweden;610;40;33236;3871
2020-05-22;SE;Sweden;532;54;33768;3925
2020-05-23;SE;Sweden;403;67;34171;3992
2020-05-24;SE;Sweden;210;6;34381;3998
2020-05-25;SE;Sweden;490;31;34871;4029
2020-05-26;SE;Sweden;746;96;35617;4125
2020-05-27;SE;Sweden;800;95;36417;4220
2020-05-28;SE;Sweden;774;46;37191;4266
2020-05-29;SE;Sweden;773;84;37964;4350
2020-05-30;SE;Sweden;432;45;38396;4395
2020-05-31;SE;Sweden;265;0;38661;4395
2020-06-01;SE;Sweden;648;8;39309;4403
2020-06-02;SE;Sweden;901;65;40210;4468
2020-06-03;SE;Sweden;1046;74;41256;4542
2020-06-04;SE;Sweden;1039;20;42295;4562
2020-06-05;SE;Sweden;1146;77;43441;4639
2020-06-06;SE;Sweden;783;17;44224;4656
2020-06-07;SE;Sweden;462;3;44686;4659
2020-06-08;SE;Sweden;677;35;45363;4694
2020-06-09;SE;Sweden;936;23;46299;4717
2020-06-10;SE;Sweden;1437;78;47736;4795
2020-06-11;SE;Sweden;1294;19;49030;4814
2020-06-12;SE;Sweden;1337;40;50367;4854
2020-06-13;SE;Sweden;1042;20;51409;4874
2020-06-14;SE;Sweden;418;0;51827;4874
2020-06-15;SE;Sweden;684;17;52511;4891
2020-06-16;SE;Sweden;1218;48;53729;4939
2020-06-17;SE;Sweden;1457;102;55186;5041
2020-06-18;SE;Sweden;1496;12;56682;5053
2020-06-19;SE;Sweden;1213;0;57895;5053
2020-06-20;SE;Sweden;702;0;58597;5053
2020-06-21;SE;Sweden;321;0;58918;5053
2020-06-22;SE;Sweden;800;0;59718;5053
2020-06-23;SE;Sweden;1312;108;61030;5161
2020-06-24;SE;Sweden;1698;48;62728;5209
2020-06-25;SE;Sweden;1281;21;64009;5230
2020-06-26;SE;Sweden;1203;50;65212;5280
2020-06-27;SE;Sweden;760;0;65972;5280
2020-06-28;SE;Sweden;420;0;66392;5280
2020-06-29;SE;Sweden;727;0;67119;5280
2020-06-30;SE;Sweden;805;53;67924;5333
2020-07-01;SE;Sweden;684;37;68608;5370
2020-07-02;SE;Sweden;689;41;69297;5411
2020-07-03;SE;Sweden;699;9;69996;5420
2020-07-04;SE;Sweden;370;0;70366;5420
2020-07-05;SE;Sweden;315;0;70681;5420
2020-07-06;SE;Sweden;251;0;70932;5420
2020-07-07;SE;Sweden;278;27;71210;5447
2020-07-08;SE;Sweden;537;35;71747;5482
2020-07-09;SE;Sweden;335;18;72082;5500
2020-07-10;SE;Sweden;377;26;72459;5526
2020-07-11;SE;Sweden;314;0;72773;5526
2020-07-12;SE;Sweden;106;0;72879;5526
2020-07-13;SE;Sweden;170;0;73049;5526
2020-07-14;SE;Sweden;315;19;73364;5545
2020-07-15;SE;Sweden;299;27;73663;5572
2020-07-16;SE;Sweden;273;21;73936;5593
2020-07-17;SE;Sweden;299;26;74235;5619
2020-07-18;SE;Sweden;200;0;74435;5619
2020-07-19;SE;Sweden;110;0;74545;5619
2020-07-20;SE;Sweden;131;0;74676;5619
2020-07-21;SE;Sweden;226;27;74902;5646
2020-07-22;SE;Sweden;297;21;75199;5667
2020-07-23;SE;Sweden;220;9;75419;5676
2020-07-24;SE;Sweden;262;21;75681;5697
2020-07-25;SE;Sweden;138;0;75819;5697
2020-07-26;SE;Sweden;42;0;75861;5697
2020-07-27;SE;Sweden;71;0;75932;5697
2020-07-28;SE;Sweden;283;5;76215;5702
2020-07-29;SE;Sweden;301;28;76516;5730
2020-07-30;SE;Sweden;302;9;76818;5739
2020-07-31;SE;Sweden;258;4;77076;5743
2020-08-01;SE;Sweden;303;0;77379;5743
2020-08-02;SE;Sweden;38;0;77417;5743
2020-08-03;SE;Sweden;165;0;77582;5743
2020-08-04;SE;Sweden;334;4;77916;5747
2020-08-05;SE;Sweden;425;13;78341;5760
2020-08-06;SE;Sweden;378;6;78719;5766
2020-08-07;SE;Sweden;380;-3;79099;5763
2020-08-08;SE;Sweden;260;0;79359;5763
2020-08-09;SE;Sweden;73;0;79432;5763
2020-08-10;SE;Sweden;196;0;79628;5763
2020-08-11;SE;Sweden;417;7;80045;5770
2020-08-12;SE;Sweden;444;4;80489;5774
2020-08-13;SE;Sweden;362;2;80851;5776
2020-08-14;SE;Sweden;344;7;81195;5783
2020-08-15;SE;Sweden;226;0;81421;5783
2020-08-16;SE;Sweden;63;0;81484;5783
2020-08-17;SE;Sweden;174;0;81658;5783
2020-08-18;SE;Sweden;314;7;81972;5790
2020-08-19;SE;Sweden;351;12;82323;5802
2020-08-20;SE;Sweden;333;3;82656;5805
2020-08-21;SE;Sweden;298;5;82954;5810
2020-08-22;SE;Sweden;160;0;83114;5810
2020-08-23;SE;Sweden;57;0;83171;5810
2020-08-24;SE;Sweden;182;0;83353;5810
2020-08-25;SE;Sweden;225;4;83578;5814
2020-08-26;SE;Sweden;246;3;83824;5817
2020-08-27;SE;Sweden;134;3;83958;5820
2020-08-28;SE;Sweden;0;1;83958;5821
2020-08-29;SE;Sweden;0;0;83958;5821
2020-08-30;SE;Sweden;0;0;83958;5821
2020-08-31;SE;Sweden;421;0;84379;5821
2020-09-01;SE;Sweden;142;-8;84521;5813
2020-09-02;SE;Sweden;11;7;84532;5820
2020-09-03;SE;Sweden;197;12;84729;5832
2020-09-04;SE;Sweden;256;3;84985;5835
2020-09-05;SE;Sweden;0;0;84985;5835
2020-09-06;SE;Sweden;0;0;84985;5835
2020-09-07;SE;Sweden;573;0;85558;5835
2020-09-08;SE;Sweden;149;3;85707;5838
2020-09-09;SE;Sweden;173;4;85880;5842
2020-09-10;SE;Sweden;314;1;86194;5843
2020-09-11;SE;Sweden;311;3;86505;5846
2020-09-12;SE;Sweden;0;0;86505;5846
2020-09-13;SE;Sweden;0;0;86505;5846
2020-09-14;SE;Sweden;0;0;86505;5846
2020-09-15;SE;Sweden;840;0;87345;5846
2020-09-16;SE;Sweden;230;14;87575;5860
2020-09-17;SE;Sweden;310;4;87885;5864
2020-09-18;SE;Sweden;352;1;88237;5865
2020-09-19;SE;Sweden;0;0;88237;5865
2020-09-20;SE;Sweden;0;0;88237;5865
2020-09-21;SE;Sweden;0;0;88237;5865
2020-09-22;SE;Sweden;1199;0;89436;5865
2020-09-23;SE;Sweden;320;11;89756;5876
2020-09-24;SE;Sweden;533;2;90289;5878
2020-09-25;SE;Sweden;634;2;90923;5880
2020-09-26;SE;Sweden;0;0;90923;5880
2020-09-27;SE;Sweden;0;0;90923;5880
2020-09-28;SE;Sweden;0;0;90923;5880
2020-09-29;SE;Sweden;1543;0;92466;5880
2020-09-30;SE;Sweden;397;13;92863;5893
2020-10-01;SE;Sweden;752;0;93615;5893
2020-10-02;SE;Sweden;668;2;94283;5895
2020-10-03;SE;Sweden;0;0;94283;5895
2020-10-04;SE;Sweden;0;0;94283;5895
2020-10-05;SE;Sweden;0;0;94283;5895
2020-10-06;SE;Sweden;1862;0;96145;5895
2020-10-07;SE;Sweden;532;-3;96677;5892
2020-10-08;SE;Sweden;855;0;97532;5892
2020-10-09;SE;Sweden;919;2;98451;5894
2020-10-10;SE;Sweden;0;0;98451;5894
2020-10-11;SE;Sweden;0;0;98451;5894
2020-10-12;SE;Sweden;0;0;98451;5894
2020-10-13;SE;Sweden;2203;0;100654;5894
2020-10-14;SE;Sweden;678;13;101332;5907
2020-10-15;SE;Sweden;1075;3;102407;5910
2020-10-16;SE;Sweden;793;8;103200;5918
2020-10-17;SE;Sweden;0;0;103200;5918
2020-10-18;SE;Sweden;0;0;103200;5918
2020-10-19;SE;Sweden;0;0;103200;5918
2020-10-20;SE;Sweden;3180;0;106380;5918
2020-10-21;SE;Sweden;975;11;107355;5929
2020-10-22;SE;Sweden;1614;1;108969;5930
2020-10-23;SE;Sweden;1625;3;110594;5933
2020-10-24;SE;Sweden;0;0;110594;5933
2020-10-25;SE;Sweden;0;0;110594;5933
2020-10-26;SE;Sweden;0;0;110594;5933
2020-10-27;SE;Sweden;5191;0;115785;5933
2020-10-28;SE;Sweden;2128;-6;117913;5927
2020-10-29;SE;Sweden;3254;7;121167;5934
2020-10-30;SE;Sweden;3188;4;124355;5938
2020-10-31;SE;Sweden;0;0;124355;5938
2020-11-01;SE;Sweden;0;0;124355;5938
2020-11-02;SE;Sweden;0;0;124355;5938
2020-11-03;SE;Sweden;10177;0;134532;5938
2020-11-04;SE;Sweden;3198;59;137730;5997
2020-11-05;SE;Sweden;4034;5;141764;6002
2020-11-06;SE;Sweden;4697;20;146461;6022
2020-11-07;SE;Sweden;0;0;146461;6022
2020-11-08;SE;Sweden;0;0;146461;6022
2020-11-09;SE;Sweden;0;0;146461;6022
2020-11-10;SE;Sweden;15779;0;162240;6022
2020-11-11;SE;Sweden;4467;60;166707;6082
2020-11-12;SE;Sweden;4658;40;171365;6122
2020-11-13;SE;Sweden;5990;42;177355;6164
2020-11-14;SE;Sweden;0;0;177355;6164
2020-11-15;SE;Sweden;0;0;177355;6164
2020-11-16;SE;Sweden;0;0;177355;6164
2020-11-17;SE;Sweden;15084;0;192439;6164
2020-11-18;SE;Sweden;4007;157;196446;6321
2020-11-19;SE;Sweden;4609;19;201055;6340
2020-11-20;SE;Sweden;7240;66;208295;6406
2020-11-21;SE;Sweden;0;0;208295;6406
2020-11-22;SE;Sweden;0;0;208295;6406
2020-11-23;SE;Sweden;0;0;208295;6406
2020-11-24;SE;Sweden;17265;0;225560;6406
2020-11-25;SE;Sweden;4954;149;230514;6555
2020-11-26;SE;Sweden;5841;67;236355;6622
2020-11-27;SE;Sweden;6774;59;243129;6681
2020-11-28;SE;Sweden;0;0;243129;6681
2020-11-29;SE;Sweden;0;0;243129;6681
2020-11-30;SE;Sweden;0;0;243129;6681
2020-12-01;SE;Sweden;17629;0;260758;6681
2020-12-02;SE;Sweden;5400;291;266158;6972
2020-12-03;SE;Sweden;6485;35;272643;7007
2020-12-04;SE;Sweden;6269;60;278912;7067
2020-12-05;SE;Sweden;0;0;278912;7067
2020-12-06;SE;Sweden;0;0;278912;7067
2020-12-07;SE;Sweden;0;0;278912;7067
2020-12-08;SE;Sweden;18820;0;297732;7067
2020-12-09;SE;Sweden;7061;229;304793;7296
2020-12-10;SE;Sweden;7935;58;312728;7354
2020-12-11;SE;Sweden;7370;160;320098;7514
2020-12-12;SE;Sweden;0;0;320098;7514
2020-12-13;SE;Sweden;0;0;320098;7514
2020-12-14;SE;Sweden;0;0;320098;7514
2020-12-15;SE;Sweden;20931;0;341029;7514
2020-12-16;SE;Sweden;7556;288;348585;7802
2020-12-17;SE;Sweden;8881;91;357466;7893
2020-12-18;SE;Sweden;9654;100;367120;7993
2020-12-19;SE;Sweden;0;0;367120;7993
2020-12-20;SE;Sweden;0;0;367120;7993
2020-12-21;SE;Sweden;0;0;367120;7993
2020-12-22;SE;Sweden;22319;0;389439;7993
2020-12-23;SE;Sweden;6609;286;396048;8279
2020-12-24;SE;Sweden;0;0;396048;8279
2020-12-25;SE;Sweden;0;0;396048;8279
2020-12-26;SE;Sweden;0;0;396048;8279
2020-12-27;SE;Sweden;0;0;396048;8279
2020-12-28;SE;Sweden;0;0;396048;8279
2020-12-29;SE;Sweden;32485;0;428533;8279
2020-12-30;SE;Sweden;8846;448;437379;8727
2020-12-31;SE;Sweden;0;0;437379;8727
2021-01-01;SE;Sweden;0;0;437379;8727
2021-01-02;SE;Sweden;0;0;437379;8727
2021-01-03;SE;Sweden;0;0;437379;8727
2021-01-04;SE;Sweden;0;0;437379;8727
2021-01-05;SE;Sweden;32369;238;469748;8965
2021-01-06;SE;Sweden;0;0;469748;8965
2021-01-07;SE;Sweden;12536;297;482284;9262
2021-01-08;SE;Sweden;7187;171;489471;9433
2021-01-09;SE;Sweden;0;0;489471;9433
2021-01-10;SE;Sweden;0;0;489471;9433
2021-01-11;SE;Sweden;0;0;489471;9433
2021-01-12;SE;Sweden;17395;0;506866;9433
2021-01-13;SE;Sweden;5337;401;512203;9834
2021-01-14;SE;Sweden;6580;351;518783;10185
2021-01-15;SE;Sweden;4703;138;523486;10323
2021-01-16;SE;Sweden;0;0;523486;10323
2021-01-17;SE;Sweden;0;0;523486;10323
2021-01-18;SE;Sweden;0;0;523486;10323
2021-01-19;SE;Sweden;9779;0;533265;10323
2021-01-20;SE;Sweden;4702;474;537967;10797
2021-01-21;SE;Sweden;4985;124;542952;10921
2021-01-22;SE;Sweden;4214;84;547166;11005
2021-01-23;SE;Sweden;0;0;547166;11005
2021-01-24;SE;Sweden;0;0;547166;11005
2021-01-25;SE;Sweden;0;0;547166;11005
2021-01-26;SE;Sweden;9123;242;556289;11247
2021-01-27;SE;Sweden;4183;178;560472;11425
2021-01-28;SE;Sweden;4085;95;564557;11520
2021-01-29;SE;Sweden;2400;71;566957;11591
2021-01-30;SE;Sweden;0;0;566957;11591
2021-01-31;SE;Sweden;0;0;566957;11591
2021-02-01;SE;Sweden;0;0;566957;11591
2021-02-02;SE;Sweden;9649;224;576606;11815
2021-02-03;SE;Sweden;4310;124;580916;11939
2021-02-04;SE;Sweden;3758;89;584674;12028
2021-02-05;SE;Sweden;3388;87;588062;12115
2021-02-06;SE;Sweden;0;0;588062;12115
2021-02-07;SE;Sweden;0;0;588062;12115
2021-02-08;SE;Sweden;0;0;588062;12115
2021-02-09;SE;Sweden;8112;73;596174;12188
2021-02-10;SE;Sweden;4070;138;600244;12326
2021-02-11;SE;Sweden;4333;44;604577;12370
2021-02-12;SE;Sweden;3834;58;608411;12428
2021-02-13;SE;Sweden;0;0;608411;12428
2021-02-14;SE;Sweden;0;0;608411;12428
2021-02-15;SE;Sweden;0;0;608411;12428
2021-02-16;SE;Sweden;9458;59;617869;12487
2021-02-17;SE;Sweden;4233;82;622102;12569
2021-02-18;SE;Sweden;4920;29;627022;12598
2021-02-19;SE;Sweden;4144;51;631166;12649
2021-02-20;SE;Sweden;0;0;631166;12649
2021-02-21;SE;Sweden;0;0;631166;12649
2021-02-22;SE;Sweden;0;0;631166;12649
2021-02-23;SE;Sweden;10933;64;642099;12713
2021-02-24;SE;Sweden;5371;80;647470;12793
2021-02-25;SE;Sweden;4995;5;652465;12798
2021-02-26;SE;Sweden;4844;28;657309;12826
2021-02-27;SE;Sweden;0;0;657309;12826
2021-02-28;SE;Sweden;0;0;657309;12826
2021-03-01;SE;Sweden;0;0;657309;12826
2021-03-02;SE;Sweden;11804;56;669113;12882
2021-03-03;SE;Sweden;6179;82;675292;12964
2021-03-04;SE;Sweden;4838;13;680130;12977
2021-03-05;SE;Sweden;4831;26;684961;13003
2021-03-06;SE;Sweden;0;0;684961;13003
2021-03-07;SE;Sweden;0;0;684961;13003
2021-03-08;SE;Sweden;0;0;684961;13003
2021-03-09;SE;Sweden;11014;39;695975;13042
2021-03-10;SE;Sweden;5917;46;701892;13088
2021-03-11;SE;Sweden;5300;23;707192;13111
2021-03-12;SE;Sweden;5335;35;712527;13146
2021-03-13;SE;Sweden;0;0;712527;13146
2021-03-14;SE;Sweden;0;0;712527;13146
2021-03-15;SE;Sweden;0;0;712527;13146
2021-03-16;SE;Sweden;12762;26;725289;13172
2021-03-17;SE;Sweden;6781;56;732070;13228
2021-03-18;SE;Sweden;6467;8;738537;13236
2021-03-19;SE;Sweden;5735;26;744272;13262
2021-03-20;SE;Sweden;0;0;744272;13262
2021-03-21;SE;Sweden;0;0;744272;13262
2021-03-22;SE;Sweden;0;0;744272;13262
2021-03-23;SE;Sweden;14063;53;758335;13315
2021-03-24;SE;Sweden;7649;42;765984;13357
2021-03-25;SE;Sweden;7706;16;773690;13373
2021-03-26;SE;Sweden;6328;29;780018;13402
2021-03-27;SE;Sweden;0;0;780018;13402
2021-03-28;SE;Sweden;0;0;780018;13402
2021-03-29;SE;Sweden;0;0;780018;13402
2021-03-30;SE;Sweden;16427;28;796445;13430
2021-03-31;SE;Sweden;8441;35;804886;13465
2021-04-01;SE;Sweden;8305;33;813191;13498
2021-04-02;SE;Sweden;0;0;813191;13498
2021-04-03;SE;Sweden;0;0;813191;13498
2021-04-04;SE;Sweden;0;0;813191;13498
2021-04-05;SE;Sweden;0;0;813191;13498
2021-04-06;SE;Sweden;21802;35;834993;13533
2021-04-07;SE;Sweden;6814;45;841807;13578
2021-04-08;SE;Sweden;7822;17;849629;13595
2021-04-09;SE;Sweden;7772;26;857401;13621
2021-04-10;SE;Sweden;0;0;857401;13621
2021-04-11;SE;Sweden;0;0;857401;13621
2021-04-12;SE;Sweden;0;0;857401;13621
2021-04-13;SE;Sweden;19105;39;876506;13660
2021-04-14;SE;Sweden;8879;60;885385;13720
2021-04-15;SE;Sweden;7095;41;892480;13761
2021-04-16;SE;Sweden;7658;27;900138;13788
2021-04-17;SE;Sweden;0;0;900138;13788
2021-04-18;SE;Sweden;0;0;900138;13788
2021-04-19;SE;Sweden;0;0;900138;13788
2021-04-20;SE;Sweden;16692;37;916830;13825
2021-04-21;SE;Sweden;7510;38;924340;13863
2021-04-22;SE;Sweden;7736;19;932076;13882
2021-04-23;SE;Sweden;6267;41;938343;13923
2021-04-24;SE;Sweden;0;0;938343;13923
2021-04-25;SE;Sweden;0;0;938343;13923
2021-04-26;SE;Sweden;0;0;938343;13923
2021-04-27;SE;Sweden;14911;45;953254;13968
2021-04-28;SE;Sweden;7266;32;960520;14000
2021-04-29;SE;Sweden;7158;2;967678;14002
2021-04-30;SE;Sweden;5926;46;973604;14048
2021-05-01;SE;Sweden;0;0;973604;14048
2021-05-02;SE;Sweden;0;0;973604;14048
2021-05-03;SE;Sweden;0;0;973604;14048
2021-05-04;SE;Sweden;14950;43;988554;14091
2021-05-05;SE;Sweden;7041;60;995595;14151
2021-05-06;SE;Sweden;6526;7;1002121;14158
2021-05-07;SE;Sweden;5671;15;1007792;14173
2021-05-08;SE;Sweden;0;0;1007792;14173
2021-05-09;SE;Sweden;0;0;1007792;14173
2021-05-10;SE;Sweden;0;0;1007792;14173
2021-05-11;SE;Sweden;13812;44;1021604;14217
2021-05-12;SE;Sweden;6330;50;1027934;14267
2021-05-13;SE;Sweden;0;0;1027934;14267
2021-05-14;SE;Sweden;9192;8;1037126;14275
2021-05-15;SE;Sweden;0;0;1037126;14275
2021-05-16;SE;Sweden;0;0;1037126;14275
2021-05-17;SE;Sweden;0;0;1037126;14275
2021-05-18;SE;Sweden;10017;26;1047143;14301
2021-05-19;SE;Sweden;4619;48;1051762;14349
2021-05-20;SE;Sweden;3411;2;1055173;14351
2021-05-21;SE;Sweden;3168;15;1058341;14366
2021-05-22;SE;Sweden;0;0;1058341;14366
2021-05-23;SE;Sweden;0;0;1058341;14366
2021-05-24;SE;Sweden;0;0;1058341;14366
2021-05-25;SE;Sweden;6034;30;1064375;14396
2021-05-26;SE;Sweden;2732;40;1067107;14436
2021-05-27;SE;Sweden;1366;15;1068473;14451
2021-05-28;SE;Sweden;0;0;1068473;14451
2021-05-29;SE;Sweden;0;0;1068473;14451
2021-05-30;SE;Sweden;0;0;1068473;14451
2021-05-31;SE;Sweden;0;0;1068473;14451
2021-06-01;SE;Sweden;0;0;1068473;14451
2021-06-02;SE;Sweden;0;0;1068473;14451
2021-06-03;SE;Sweden;8520;61;1076993;14512
2021-06-04;SE;Sweden;1069;11;1078062;14523
2021-06-05;SE;Sweden;0;0;1078062;14523
2021-06-06;SE;Sweden;0;0;1078062;14523
2021-06-07;SE;Sweden;0;0;1078062;14523
2021-06-08;SE;Sweden;2671;23;1080733;14546
2021-06-09;SE;Sweden;1165;16;1081898;14562
2021-06-10;SE;Sweden;831;3;1082729;14565
2021-06-11;SE;Sweden;727;9;1083456;14574
2021-06-12;SE;Sweden;0;0;1083456;14574
2021-06-13;SE;Sweden;0;0;1083456;14574
2021-06-14;SE;Sweden;0;0;1083456;14574
2021-06-15;SE;Sweden;1180;0;1084636;14574
2021-06-16;SE;Sweden;0;0;1084636;14574
2021-06-17;SE;Sweden;0;0;1084636;14574
2021-06-18;SE;Sweden;0;0;1084636;14574
2021-06-19;SE;Sweden;0;0;1084636;14574
2021-06-20;SE;Sweden;0;0;1084636;14574
2021-06-21;SE;Sweden;0;0;1084636;14574
2021-06-22;SE;Sweden;3378;34;1088014;14608
2021-06-23;SE;Sweden;504;8;1088518;14616
2021-06-24;SE;Sweden;378;3;1088896;14619
2021-06-25;SE;Sweden;0;0;1088896;14619
2021-06-26;SE;Sweden;0;0;1088896;14619
2021-06-27;SE;Sweden;0;0;1088896;14619
2021-06-28;SE;Sweden;0;0;1088896;14619
2021-06-29;SE;Sweden;847;7;1089743;14626
2021-06-30;SE;Sweden;247;3;1089990;14629
2021-07-01;SE;Sweden;563;1;1090553;14630
2020-02-25;CH;Switzerland;1;0;1;0
2020-02-26;CH;Switzerland;0;0;1;0
2020-02-27;CH;Switzerland;7;0;8;0
2020-02-28;CH;Switzerland;0;0;8;0
2020-02-29;CH;Switzerland;10;0;18;0
2020-03-01;CH;Switzerland;9;0;27;0
2020-03-02;CH;Switzerland;15;0;42;0
2020-03-03;CH;Switzerland;14;0;56;0
2020-03-04;CH;Switzerland;34;0;90;0
2020-03-05;CH;Switzerland;24;1;114;1
2020-03-06;CH;Switzerland;100;0;214;1
2020-03-07;CH;Switzerland;54;0;268;1
2020-03-08;CH;Switzerland;69;1;337;2
2020-03-09;CH;Switzerland;37;0;374;2
2020-03-10;CH;Switzerland;117;1;491;3
2020-03-11;CH;Switzerland;161;1;652;4
2020-03-12;CH;Switzerland;0;0;652;4
2020-03-13;CH;Switzerland;487;7;1139;11
2020-03-14;CH;Switzerland;220;2;1359;13
2020-03-15;CH;Switzerland;841;1;2200;14
2020-03-16;CH;Switzerland;0;0;2200;14
2020-03-17;CH;Switzerland;500;13;2700;27
2020-03-18;CH;Switzerland;328;1;3028;28
2020-03-19;CH;Switzerland;1047;13;4075;41
2020-03-20;CH;Switzerland;1219;13;5294;54
2020-03-21;CH;Switzerland;1281;21;6575;75
2020-03-22;CH;Switzerland;899;23;7474;98
2020-03-23;CH;Switzerland;1321;22;8795;120
2020-03-24;CH;Switzerland;1082;2;9877;122
2020-03-25;CH;Switzerland;1020;31;10897;153
2020-03-26;CH;Switzerland;914;38;11811;191
2020-03-27;CH;Switzerland;1117;40;12928;231
2020-03-28;CH;Switzerland;1148;33;14076;264
2020-03-29;CH;Switzerland;753;36;14829;300
2020-03-30;CH;Switzerland;1093;59;15922;359
2020-03-31;CH;Switzerland;683;74;16605;433
2020-04-01;CH;Switzerland;1163;55;17768;488
2020-04-02;CH;Switzerland;1059;48;18827;536
2020-04-03;CH;Switzerland;779;55;19606;591
2020-04-04;CH;Switzerland;899;75;20505;666
2020-04-05;CH;Switzerland;595;49;21100;715
2020-04-06;CH;Switzerland;557;50;21657;765
2020-04-07;CH;Switzerland;596;56;22253;821
2020-04-08;CH;Switzerland;1027;74;23280;895
2020-04-09;CH;Switzerland;771;53;24051;948
2020-04-10;CH;Switzerland;500;54;24551;1002
2020-04-11;CH;Switzerland;556;34;25107;1036
2020-04-12;CH;Switzerland;308;70;25415;1106
2020-04-13;CH;Switzerland;273;32;25688;1138
2020-04-14;CH;Switzerland;248;36;25936;1174
2020-04-15;CH;Switzerland;400;65;26336;1239
2020-04-16;CH;Switzerland;396;42;26732;1281
2020-04-17;CH;Switzerland;346;46;27078;1327
2020-04-18;CH;Switzerland;326;41;27404;1368
2020-04-19;CH;Switzerland;336;25;27740;1393
2020-04-20;CH;Switzerland;204;36;27944;1429
2020-04-21;CH;Switzerland;119;49;28063;1478
2020-04-22;CH;Switzerland;205;31;28268;1509
2020-04-23;CH;Switzerland;228;40;28496;1549
2020-04-24;CH;Switzerland;181;40;28677;1589
2020-04-25;CH;Switzerland;217;10;28894;1599
2020-04-26;CH;Switzerland;167;11;29061;1610
2020-04-27;CH;Switzerland;103;55;29164;1665
2020-04-28;CH;Switzerland;100;34;29264;1699
2020-04-29;CH;Switzerland;143;17;29407;1716
2020-04-30;CH;Switzerland;179;21;29586;1737
2020-05-01;CH;Switzerland;119;17;29705;1754
2020-05-02;CH;Switzerland;112;8;29817;1762
2020-05-03;CH;Switzerland;88;0;29905;1762
2020-05-04;CH;Switzerland;76;22;29981;1784
2020-05-05;CH;Switzerland;28;11;30009;1795
2020-05-06;CH;Switzerland;51;10;30060;1805
2020-05-07;CH;Switzerland;66;5;30126;1810
2020-05-08;CH;Switzerland;81;13;30207;1823
2020-05-09;CH;Switzerland;44;7;30251;1830
2020-05-10;CH;Switzerland;54;3;30305;1833
2020-05-11;CH;Switzerland;39;12;30344;1845
2020-05-12;CH;Switzerland;36;22;30380;1867
2020-05-13;CH;Switzerland;33;3;30413;1870
2020-05-14;CH;Switzerland;50;2;30463;1872
2020-05-15;CH;Switzerland;51;6;30514;1878
2020-05-16;CH;Switzerland;58;1;30572;1879
2020-05-17;CH;Switzerland;15;2;30587;1881
2020-05-18;CH;Switzerland;10;5;30597;1886
2020-05-19;CH;Switzerland;21;5;30618;1891
2020-05-20;CH;Switzerland;40;1;30658;1892
2020-05-21;CH;Switzerland;36;6;30694;1898
2020-05-22;CH;Switzerland;13;5;30707;1903
2020-05-23;CH;Switzerland;18;2;30725;1905
2020-05-24;CH;Switzerland;11;1;30736;1906
2020-05-25;CH;Switzerland;10;7;30746;1913
2020-05-26;CH;Switzerland;15;2;30761;1915
2020-05-27;CH;Switzerland;15;2;30776;1917
2020-05-28;CH;Switzerland;20;2;30796;1919
2020-05-29;CH;Switzerland;32;0;30828;1919
2020-05-30;CH;Switzerland;17;0;30845;1919
2020-05-31;CH;Switzerland;17;1;30862;1920
2020-06-01;CH;Switzerland;9;0;30871;1920
2020-06-02;CH;Switzerland;3;0;30874;1920
2020-06-03;CH;Switzerland;19;1;30893;1921
2020-06-04;CH;Switzerland;20;0;30913;1921
2020-06-05;CH;Switzerland;23;0;30936;1921
2020-06-06;CH;Switzerland;20;0;30956;1921
2020-06-07;CH;Switzerland;9;0;30965;1921
2020-06-08;CH;Switzerland;7;2;30972;1923
2020-06-09;CH;Switzerland;16;11;30988;1934
2020-06-10;CH;Switzerland;23;2;31011;1936
2020-06-11;CH;Switzerland;33;1;31044;1937
2020-06-12;CH;Switzerland;19;1;31063;1938
2020-06-13;CH;Switzerland;31;0;31094;1938
2020-06-14;CH;Switzerland;23;0;31117;1938
2020-06-15;CH;Switzerland;14;1;31131;1939
2020-06-16;CH;Switzerland;23;15;31154;1954
2020-06-17;CH;Switzerland;33;2;31187;1956
2020-06-18;CH;Switzerland;13;0;31200;1956
2020-06-19;CH;Switzerland;35;0;31235;1956
2020-06-20;CH;Switzerland;8;0;31243;1956
2020-06-21;CH;Switzerland;49;0;31292;1956
2020-06-22;CH;Switzerland;18;0;31310;1956
2020-06-23;CH;Switzerland;22;0;31332;1956
2020-06-24;CH;Switzerland;44;2;31376;1958
2020-06-25;CH;Switzerland;52;0;31428;1958
2020-06-26;CH;Switzerland;58;4;31486;1962
2020-06-27;CH;Switzerland;69;0;31555;1962
2020-06-28;CH;Switzerland;62;0;31617;1962
2020-06-29;CH;Switzerland;35;0;31652;1962
2020-06-30;CH;Switzerland;62;1;31714;1963
2020-07-01;CH;Switzerland;137;2;31851;1965
2020-07-02;CH;Switzerland;116;0;31967;1965
2020-07-03;CH;Switzerland;134;0;32101;1965
2020-07-04;CH;Switzerland;97;0;32198;1965
2020-07-05;CH;Switzerland;70;0;32268;1965
2020-07-06;CH;Switzerland;47;0;32315;1965
2020-07-07;CH;Switzerland;54;1;32369;1966
2020-07-08;CH;Switzerland;129;0;32498;1966
2020-07-09;CH;Switzerland;88;0;32586;1966
2020-07-10;CH;Switzerland;104;0;32690;1966
2020-07-11;CH;Switzerland;127;2;32817;1968
2020-07-12;CH;Switzerland;66;0;32883;1968
2020-07-13;CH;Switzerland;63;0;32946;1968
2020-07-14;CH;Switzerland;70;0;33016;1968
2020-07-15;CH;Switzerland;132;0;33148;1968
2020-07-16;CH;Switzerland;142;1;33290;1969
2020-07-17;CH;Switzerland;92;0;33382;1969
2020-07-18;CH;Switzerland;110;0;33492;1969
2020-07-19;CH;Switzerland;99;0;33591;1969
2020-07-20;CH;Switzerland;43;2;33634;1971
2020-07-21;CH;Switzerland;108;1;33742;1972
2020-07-22;CH;Switzerland;141;0;33883;1972
2020-07-23;CH;Switzerland;117;3;34000;1975
2020-07-24;CH;Switzerland;154;2;34154;1977
2020-07-25;CH;Switzerland;148;0;34302;1977
2020-07-26;CH;Switzerland;110;0;34412;1977
2020-07-27;CH;Switzerland;65;1;34477;1978
2020-07-28;CH;Switzerland;132;0;34609;1978
2020-07-29;CH;Switzerland;193;1;34802;1979
2020-07-30;CH;Switzerland;220;1;35022;1980
2020-07-31;CH;Switzerland;210;1;35232;1981
2020-08-01;CH;Switzerland;180;0;35412;1981
2020-08-02;CH;Switzerland;138;0;35550;1981
2020-08-03;CH;Switzerland;66;0;35616;1981
2020-08-04;CH;Switzerland;130;0;35746;1981
2020-08-05;CH;Switzerland;181;3;35927;1984
2020-08-06;CH;Switzerland;181;1;36108;1985
2020-08-07;CH;Switzerland;161;1;36269;1986
2020-08-08;CH;Switzerland;182;0;36451;1986
2020-08-09;CH;Switzerland;152;0;36603;1986
2020-08-10;CH;Switzerland;105;1;36708;1987
2020-08-11;CH;Switzerland;187;3;36895;1990
2020-08-12;CH;Switzerland;274;1;37169;1991
2020-08-13;CH;Switzerland;234;0;37403;1991
2020-08-14;CH;Switzerland;268;0;37671;1991
2020-08-15;CH;Switzerland;253;0;37924;1991
2020-08-16;CH;Switzerland;200;0;38124;1991
2020-08-17;CH;Switzerland;128;0;38252;1991
2020-08-18;CH;Switzerland;197;1;38449;1992
2020-08-19;CH;Switzerland;311;4;38760;1996
2020-08-20;CH;Switzerland;266;2;39026;1998
2020-08-21;CH;Switzerland;306;2;39332;2000
2020-08-22;CH;Switzerland;295;0;39627;2000
2020-08-23;CH;Switzerland;276;1;39903;2001
2020-08-24;CH;Switzerland;157;0;40060;2001
2020-08-25;CH;Switzerland;202;1;40262;2002
2020-08-26;CH;Switzerland;383;1;40645;2003
2020-08-27;CH;Switzerland;361;0;41006;2003
2020-08-28;CH;Switzerland;340;1;41346;2004
2020-08-29;CH;Switzerland;376;1;41722;2005
2020-08-30;CH;Switzerland;292;0;42014;2005
2020-08-31;CH;Switzerland;163;1;42177;2006
2020-09-01;CH;Switzerland;216;5;42393;2011
2020-09-02;CH;Switzerland;370;0;42763;2011
2020-09-03;CH;Switzerland;364;2;43127;2013
2020-09-04;CH;Switzerland;405;0;43532;2013
2020-09-05;CH;Switzerland;425;0;43957;2013
2020-09-06;CH;Switzerland;444;0;44401;2013
2020-09-07;CH;Switzerland;191;1;44592;2014
2020-09-08;CH;Switzerland;245;4;44837;2018
2020-09-09;CH;Switzerland;469;1;45306;2019
2020-09-10;CH;Switzerland;405;1;45711;2020
2020-09-11;CH;Switzerland;528;0;46239;2020
2020-09-12;CH;Switzerland;465;0;46704;2020
2020-09-13;CH;Switzerland;475;1;47179;2021
2020-09-14;CH;Switzerland;257;4;47436;2025
2020-09-15;CH;Switzerland;315;3;47751;2028
2020-09-16;CH;Switzerland;514;11;48265;2039
2020-09-17;CH;Switzerland;530;3;48795;2042
2020-09-18;CH;Switzerland;488;3;49283;2045
2020-09-19;CH;Switzerland;0;0;49283;2045
2020-09-20;CH;Switzerland;0;0;49283;2045
2020-09-21;CH;Switzerland;1095;5;50378;2050
2020-09-22;CH;Switzerland;286;4;50664;2054
2020-09-23;CH;Switzerland;437;6;51101;2060
2020-09-24;CH;Switzerland;391;1;51492;2061
2020-09-25;CH;Switzerland;372;3;51864;2064
2020-09-26;CH;Switzerland;0;0;51864;2064
2020-09-27;CH;Switzerland;0;0;51864;2064
2020-09-28;CH;Switzerland;782;1;52646;2065
2020-09-29;CH;Switzerland;225;4;52871;2069
2020-09-30;CH;Switzerland;411;5;53282;2074
2020-10-01;CH;Switzerland;550;0;53832;2074
2020-10-02;CH;Switzerland;552;1;54384;2075
2020-10-03;CH;Switzerland;0;1;54384;2076
2020-10-04;CH;Switzerland;0;1;54384;2077
2020-10-05;CH;Switzerland;1548;1;55932;2078
2020-10-06;CH;Switzerland;700;3;56632;2081
2020-10-07;CH;Switzerland;1077;1;57709;2082
2020-10-08;CH;Switzerland;1172;5;58881;2087
2020-10-09;CH;Switzerland;1487;1;60368;2088
2020-10-10;CH;Switzerland;0;0;60368;2088
2020-10-11;CH;Switzerland;0;0;60368;2088
2020-10-12;CH;Switzerland;4068;8;64436;2096
2020-10-13;CH;Switzerland;1445;7;65881;2103
2020-10-14;CH;Switzerland;2823;6;68704;2109
2020-10-15;CH;Switzerland;2613;6;71317;2115
2020-10-16;CH;Switzerland;3105;7;74422;2122
2020-10-17;CH;Switzerland;0;0;74422;2122
2020-10-18;CH;Switzerland;0;1;74422;2123
2020-10-19;CH;Switzerland;8737;15;83159;2138
2020-10-20;CH;Switzerland;3008;7;86167;2145
2020-10-21;CH;Switzerland;5596;-106;91763;2039
2020-10-22;CH;Switzerland;5256;7;97019;2046
2020-10-23;CH;Switzerland;6634;21;103653;2067
2020-10-24;CH;Switzerland;0;14;103653;2081
2020-10-25;CH;Switzerland;0;2;103653;2083
2020-10-26;CH;Switzerland;17440;28;121093;2111
2020-10-27;CH;Switzerland;5949;36;127042;2147
2020-10-28;CH;Switzerland;8616;11;135658;2158
2020-10-29;CH;Switzerland;9386;42;145044;2200
2020-10-30;CH;Switzerland;9207;77;154251;2277
2020-10-31;CH;Switzerland;0;20;154251;2297
2020-11-01;CH;Switzerland;0;29;154251;2326
2020-11-02;CH;Switzerland;21926;78;176177;2404
2020-11-03;CH;Switzerland;6126;67;182303;2471
2020-11-04;CH;Switzerland;10073;84;192376;2555
2020-11-05;CH;Switzerland;10128;73;202504;2628
2020-11-06;CH;Switzerland;9409;82;211913;2710
2020-11-07;CH;Switzerland;0;39;211913;2749
2020-11-08;CH;Switzerland;0;23;211913;2772
2020-11-09;CH;Switzerland;17309;130;229222;2902
2020-11-10;CH;Switzerland;5980;111;235202;3013
2020-11-11;CH;Switzerland;8270;100;243472;3113
2020-11-12;CH;Switzerland;6924;103;250396;3216
2020-11-13;CH;Switzerland;6739;99;257135;3315
2020-11-14;CH;Switzerland;0;36;257135;3351
2020-11-15;CH;Switzerland;0;18;257135;3369
2020-11-16;CH;Switzerland;12839;167;269974;3536
2020-11-17;CH;Switzerland;4560;128;274534;3664
2020-11-18;CH;Switzerland;6114;101;280648;3765
2020-11-19;CH;Switzerland;5007;114;285655;3879
2020-11-20;CH;Switzerland;4946;113;290601;3992
2020-11-21;CH;Switzerland;0;39;290601;4031
2020-11-22;CH;Switzerland;0;25;290601;4056
2020-11-23;CH;Switzerland;9751;166;300352;4222
2020-11-24;CH;Switzerland;4241;86;304593;4308
2020-11-25;CH;Switzerland;4876;85;309469;4393
2020-11-26;CH;Switzerland;4509;116;313978;4509
2020-11-27;CH;Switzerland;4312;62;318290;4571
2020-11-28;CH;Switzerland;0;50;318290;4621
2020-11-29;CH;Switzerland;0;29;318290;4650
2020-11-30;CH;Switzerland;8782;165;327072;4815
2020-12-01;CH;Switzerland;3802;125;330874;4940
2020-12-02;CH;Switzerland;4786;105;335660;5045
2020-12-03;CH;Switzerland;4455;136;340115;5181
2020-12-04;CH;Switzerland;4382;112;344497;5293
2020-12-05;CH;Switzerland;0;31;344497;5324
2020-12-06;CH;Switzerland;0;25;344497;5349
2020-12-07;CH;Switzerland;9809;146;354306;5495
2020-12-08;CH;Switzerland;4262;98;358568;5593
2020-12-09;CH;Switzerland;5086;117;363654;5710
2020-12-10;CH;Switzerland;5041;114;368695;5824
2020-12-11;CH;Switzerland;5136;104;373831;5928
2020-12-12;CH;Switzerland;0;48;373831;5976
2020-12-13;CH;Switzerland;0;9;373831;5985
2020-12-14;CH;Switzerland;10726;169;384557;6154
2020-12-15;CH;Switzerland;4271;112;388828;6266
2020-12-16;CH;Switzerland;5625;113;394453;6379
2020-12-17;CH;Switzerland;5058;108;399511;6487
2020-12-18;CH;Switzerland;4478;74;403989;6561
2020-12-19;CH;Switzerland;0;41;403989;6602
2020-12-20;CH;Switzerland;0;20;403989;6622
2020-12-21;CH;Switzerland;10002;159;413991;6781
2020-12-22;CH;Switzerland;4275;143;418266;6924
2020-12-23;CH;Switzerland;5033;105;423299;7029
2020-12-24;CH;Switzerland;4898;69;428197;7098
2020-12-25;CH;Switzerland;0;61;428197;7159
2020-12-26;CH;Switzerland;0;34;428197;7193
2020-12-27;CH;Switzerland;0;17;428197;7210
2020-12-28;CH;Switzerland;10087;152;438284;7362
2020-12-29;CH;Switzerland;4197;131;442481;7493
2020-12-30;CH;Switzerland;5424;101;447905;7594
2020-12-31;CH;Switzerland;4391;51;452296;7645
2021-01-01;CH;Switzerland;0;59;452296;7704
2021-01-02;CH;Switzerland;0;25;452296;7729
2021-01-03;CH;Switzerland;0;18;452296;7747
2021-01-04;CH;Switzerland;9665;171;461961;7918
2021-01-05;CH;Switzerland;4020;100;465981;8018
2021-01-06;CH;Switzerland;4808;91;470789;8109
2021-01-07;CH;Switzerland;3975;69;474764;8178
2021-01-08;CH;Switzerland;3219;52;477983;8230
2021-01-09;CH;Switzerland;0;23;477983;8253
2021-01-10;CH;Switzerland;0;14;477983;8267
2021-01-11;CH;Switzerland;6523;97;484506;8364
2021-01-12;CH;Switzerland;2851;106;487357;8470
2021-01-13;CH;Switzerland;3001;51;490358;8521
2021-01-14;CH;Switzerland;2474;65;492832;8586
2021-01-15;CH;Switzerland;2396;60;495228;8646
2021-01-16;CH;Switzerland;0;29;495228;8675
2021-01-17;CH;Switzerland;0;7;495228;8682
2021-01-18;CH;Switzerland;4703;110;499931;8792
2021-01-19;CH;Switzerland;2260;67;502191;8859
2021-01-20;CH;Switzerland;2727;65;504918;8924
2021-01-21;CH;Switzerland;2205;47;507123;8971
2021-01-22;CH;Switzerland;2156;63;509279;9034
2021-01-23;CH;Switzerland;0;16;509279;9050
2021-01-24;CH;Switzerland;0;15;509279;9065
2021-01-25;CH;Switzerland;4320;81;513599;9146
2021-01-26;CH;Switzerland;1884;58;515483;9204
2021-01-27;CH;Switzerland;2222;56;517705;9260
2021-01-28;CH;Switzerland;1699;48;519404;9308
2021-01-29;CH;Switzerland;1916;46;521320;9354
2021-01-30;CH;Switzerland;0;16;521320;9370
2021-01-31;CH;Switzerland;0;11;521320;9381
2021-02-01;CH;Switzerland;3775;71;525095;9452
2021-02-02;CH;Switzerland;1633;37;526728;9489
2021-02-03;CH;Switzerland;1796;41;528524;9530
2021-02-04;CH;Switzerland;1765;26;530289;9556
2021-02-05;CH;Switzerland;1584;28;531873;9584
2021-02-06;CH;Switzerland;0;22;531873;9606
2021-02-07;CH;Switzerland;0;7;531873;9613
2021-02-08;CH;Switzerland;3280;38;535153;9651
2021-02-09;CH;Switzerland;1363;36;536516;9687
2021-02-10;CH;Switzerland;1602;24;538118;9711
2021-02-11;CH;Switzerland;1356;18;539474;9729
2021-02-12;CH;Switzerland;1253;18;540727;9747
2021-02-13;CH;Switzerland;0;8;540727;9755
2021-02-14;CH;Switzerland;0;10;540727;9765
2021-02-15;CH;Switzerland;2480;11;543207;9776
2021-02-16;CH;Switzerland;1075;41;544282;9817
2021-02-17;CH;Switzerland;1253;32;545535;9849
2021-02-18;CH;Switzerland;1219;27;546754;9876
2021-02-19;CH;Switzerland;1021;7;547775;9883
2021-02-20;CH;Switzerland;0;3;547775;9886
2021-02-21;CH;Switzerland;0;1;547775;9887
2021-02-22;CH;Switzerland;2449;20;550224;9907
2021-02-23;CH;Switzerland;1131;23;551355;9930
2021-02-24;CH;Switzerland;1343;12;552698;9942
2021-02-25;CH;Switzerland;1169;12;553867;9954
2021-02-26;CH;Switzerland;1065;7;554932;9961
2021-02-27;CH;Switzerland;0;5;554932;9966
2021-02-28;CH;Switzerland;0;0;554932;9966
2021-03-01;CH;Switzerland;2560;22;557492;9988
2021-03-02;CH;Switzerland;1130;17;558622;10005
2021-03-03;CH;Switzerland;1223;9;559845;10014
2021-03-04;CH;Switzerland;1223;8;561068;10022
2021-03-05;CH;Switzerland;1222;19;562290;10041
2021-03-06;CH;Switzerland;0;5;562290;10046
2021-03-07;CH;Switzerland;0;2;562290;10048
2021-03-08;CH;Switzerland;2744;8;565034;10056
2021-03-09;CH;Switzerland;1378;9;566412;10065
2021-03-10;CH;Switzerland;1491;17;567903;10082
2021-03-11;CH;Switzerland;1409;8;569312;10090
2021-03-12;CH;Switzerland;1333;14;570645;10104
2021-03-13;CH;Switzerland;0;4;570645;10108
2021-03-14;CH;Switzerland;0;4;570645;10112
2021-03-15;CH;Switzerland;3170;6;573815;10118
2021-03-16;CH;Switzerland;1438;29;575253;10147
2021-03-17;CH;Switzerland;1858;16;577111;10163
2021-03-18;CH;Switzerland;1750;20;578861;10183
2021-03-19;CH;Switzerland;1748;20;580609;10203
2021-03-20;CH;Switzerland;0;0;580609;10203
2021-03-21;CH;Switzerland;0;10;580609;10213
2021-03-22;CH;Switzerland;3643;26;584252;10239
2021-03-23;CH;Switzerland;1844;8;586096;10247
2021-03-24;CH;Switzerland;2022;29;588118;10276
2021-03-25;CH;Switzerland;2046;8;590164;10284
2021-03-26;CH;Switzerland;2053;14;592217;10298
2021-03-27;CH;Switzerland;0;1;592217;10299
2021-03-28;CH;Switzerland;0;1;592217;10300
2021-03-29;CH;Switzerland;4573;5;596790;10305
2021-03-30;CH;Switzerland;1923;17;598713;10322
2021-03-31;CH;Switzerland;2411;15;601124;10337
2021-04-01;CH;Switzerland;1968;13;603092;10350
2021-04-02;CH;Switzerland;2250;1;605342;10351
2021-04-03;CH;Switzerland;0;0;605342;10351
2021-04-04;CH;Switzerland;0;2;605342;10353
2021-04-05;CH;Switzerland;0;24;605342;10377
2021-04-06;CH;Switzerland;4932;26;610274;10403
2021-04-07;CH;Switzerland;2301;29;612575;10432
2021-04-08;CH;Switzerland;2449;13;615024;10445
2021-04-09;CH;Switzerland;2519;5;617543;10450
2021-04-10;CH;Switzerland;0;2;617543;10452
2021-04-11;CH;Switzerland;0;1;617543;10453
2021-04-12;CH;Switzerland;5583;13;623126;10466
2021-04-13;CH;Switzerland;2241;6;625367;10472
2021-04-14;CH;Switzerland;2601;16;627968;10488
2021-04-15;CH;Switzerland;2226;10;630194;10498
2021-04-16;CH;Switzerland;2205;7;632399;10505
2021-04-17;CH;Switzerland;0;0;632399;10505
2021-04-18;CH;Switzerland;0;3;632399;10508
2021-04-19;CH;Switzerland;4905;13;637304;10521
2021-04-20;CH;Switzerland;2141;11;639445;10532
2021-04-21;CH;Switzerland;2686;14;642131;10546
2021-04-22;CH;Switzerland;2265;9;644396;10555
2021-04-23;CH;Switzerland;2113;11;646509;10566
2021-04-24;CH;Switzerland;0;28;646509;10594
2021-04-25;CH;Switzerland;0;-24;646509;10570
2021-04-26;CH;Switzerland;5313;13;651822;10583
2021-04-27;CH;Switzerland;2135;8;653957;10591
2021-04-28;CH;Switzerland;2120;26;656077;10617
2021-04-29;CH;Switzerland;2066;8;658143;10625
2021-04-30;CH;Switzerland;1831;7;659974;10632
2021-05-01;CH;Switzerland;0;1;659974;10633
2021-05-02;CH;Switzerland;0;1;659974;10634
2021-05-03;CH;Switzerland;3978;21;663952;10655
2021-05-04;CH;Switzerland;1633;12;665585;10667
2021-05-05;CH;Switzerland;1795;18;667380;10685
2021-05-06;CH;Switzerland;1687;10;669067;10695
2021-05-07;CH;Switzerland;1546;7;670613;10702
2021-05-08;CH;Switzerland;0;2;670613;10704
2021-05-09;CH;Switzerland;0;2;670613;10706
2021-05-10;CH;Switzerland;3683;9;674296;10715
2021-05-11;CH;Switzerland;1375;6;675671;10721
2021-05-12;CH;Switzerland;1539;4;677210;10725
2021-05-13;CH;Switzerland;0;3;677210;10728
2021-05-14;CH;Switzerland;2300;2;679510;10730
2021-05-15;CH;Switzerland;0;0;679510;10730
2021-05-16;CH;Switzerland;0;1;679510;10731
2021-05-17;CH;Switzerland;2650;13;682160;10744
2021-05-18;CH;Switzerland;1240;8;683400;10752
2021-05-19;CH;Switzerland;1554;4;684954;10756
2021-05-20;CH;Switzerland;1198;4;686152;10760
2021-05-21;CH;Switzerland;0;8;686152;10768
2021-05-22;CH;Switzerland;1201;7;687353;10775
2021-05-23;CH;Switzerland;0;1;687353;10776
2021-05-24;CH;Switzerland;0;3;687353;10779
2021-05-25;CH;Switzerland;2770;7;690123;10786
2021-05-26;CH;Switzerland;996;3;691119;10789
2021-05-27;CH;Switzerland;992;9;692111;10798
2021-05-28;CH;Switzerland;912;3;693023;10801
2021-05-29;CH;Switzerland;0;4;693023;10805
2021-05-30;CH;Switzerland;0;1;693023;10806
2021-05-31;CH;Switzerland;1717;4;694740;10810
2021-06-01;CH;Switzerland;756;16;695496;10826
2021-06-02;CH;Switzerland;717;0;696213;10826
2021-06-03;CH;Switzerland;588;2;696801;10828
2021-06-04;CH;Switzerland;491;3;697292;10831
2021-06-05;CH;Switzerland;0;1;697292;10832
2021-06-06;CH;Switzerland;0;0;697292;10832
2021-06-07;CH;Switzerland;1077;9;698369;10841
2021-06-08;CH;Switzerland;429;3;698798;10844
2021-06-09;CH;Switzerland;0;7;698798;10851
2021-06-10;CH;Switzerland;899;2;699697;10853
2021-06-11;CH;Switzerland;354;6;700051;10859
2021-06-12;CH;Switzerland;0;0;700051;10859
2021-06-13;CH;Switzerland;0;0;700051;10859
2021-06-14;CH;Switzerland;684;2;700735;10861
2021-06-15;CH;Switzerland;243;5;700978;10866
2021-06-16;CH;Switzerland;282;2;701260;10868
2021-06-17;CH;Switzerland;194;-1;701454;10867
2021-06-18;CH;Switzerland;173;1;701627;10868
2021-06-19;CH;Switzerland;0;0;701627;10868
2021-06-20;CH;Switzerland;0;0;701627;10868
2021-06-21;CH;Switzerland;367;7;701994;10875
2021-06-22;CH;Switzerland;130;0;702124;10875
2021-06-23;CH;Switzerland;154;1;702278;10876
2021-06-24;CH;Switzerland;120;4;702398;10880
2021-06-25;CH;Switzerland;109;2;702507;10882
2021-06-26;CH;Switzerland;0;0;702507;10882
2021-06-27;CH;Switzerland;0;0;702507;10882
2021-06-28;CH;Switzerland;239;3;702746;10885
2021-06-29;CH;Switzerland;129;2;702875;10887
2021-06-30;CH;Switzerland;129;4;703004;10891
2021-07-01;CH;Switzerland;172;3;703176;10894
2020-03-22;SY;Syria;1;0;1;0
2020-03-23;SY;Syria;0;0;1;0
2020-03-24;SY;Syria;0;0;1;0
2020-03-25;SY;Syria;4;0;5;0
2020-03-26;SY;Syria;0;0;5;0
2020-03-27;SY;Syria;0;0;5;0
2020-03-28;SY;Syria;0;0;5;0
2020-03-29;SY;Syria;4;1;9;1
2020-03-30;SY;Syria;1;1;10;2
2020-03-31;SY;Syria;0;0;10;2
2020-04-01;SY;Syria;0;0;10;2
2020-04-02;SY;Syria;6;0;16;2
2020-04-03;SY;Syria;0;0;16;2
2020-04-04;SY;Syria;0;0;16;2
2020-04-05;SY;Syria;3;0;19;2
2020-04-06;SY;Syria;0;0;19;2
2020-04-07;SY;Syria;0;0;19;2
2020-04-08;SY;Syria;0;0;19;2
2020-04-09;SY;Syria;0;0;19;2
2020-04-10;SY;Syria;0;0;19;2
2020-04-11;SY;Syria;6;0;25;2
2020-04-12;SY;Syria;0;0;25;2
2020-04-13;SY;Syria;0;0;25;2
2020-04-14;SY;Syria;4;0;29;2
2020-04-15;SY;Syria;4;0;33;2
2020-04-16;SY;Syria;0;0;33;2
2020-04-17;SY;Syria;5;0;38;2
2020-04-18;SY;Syria;0;0;38;2
2020-04-19;SY;Syria;1;1;39;3
2020-04-20;SY;Syria;0;0;39;3
2020-04-21;SY;Syria;3;0;42;3
2020-04-22;SY;Syria;0;0;42;3
2020-04-23;SY;Syria;0;0;42;3
2020-04-24;SY;Syria;0;0;42;3
2020-04-25;SY;Syria;0;0;42;3
2020-04-26;SY;Syria;1;0;43;3
2020-04-27;SY;Syria;0;0;43;3
2020-04-28;SY;Syria;0;0;43;3
2020-04-29;SY;Syria;0;0;43;3
2020-04-30;SY;Syria;0;0;43;3
2020-05-01;SY;Syria;1;0;44;3
2020-05-02;SY;Syria;0;0;44;3
2020-05-03;SY;Syria;0;0;44;3
2020-05-04;SY;Syria;0;0;44;3
2020-05-05;SY;Syria;0;0;44;3
2020-05-06;SY;Syria;1;0;45;3
2020-05-07;SY;Syria;0;0;45;3
2020-05-08;SY;Syria;2;0;47;3
2020-05-09;SY;Syria;0;0;47;3
2020-05-10;SY;Syria;0;0;47;3
2020-05-11;SY;Syria;0;0;47;3
2020-05-12;SY;Syria;0;0;47;3
2020-05-13;SY;Syria;1;0;48;3
2020-05-14;SY;Syria;0;0;48;3
2020-05-15;SY;Syria;2;0;50;3
2020-05-16;SY;Syria;1;0;51;3
2020-05-17;SY;Syria;7;0;58;3
2020-05-18;SY;Syria;0;0;58;3
2020-05-19;SY;Syria;0;0;58;3
2020-05-20;SY;Syria;0;0;58;3
2020-05-21;SY;Syria;0;0;58;3
2020-05-22;SY;Syria;1;1;59;4
2020-05-23;SY;Syria;11;0;70;4
2020-05-24;SY;Syria;16;0;86;4
2020-05-25;SY;Syria;20;0;106;4
2020-05-26;SY;Syria;15;0;121;4
2020-05-27;SY;Syria;0;0;121;4
2020-05-28;SY;Syria;1;0;122;4
2020-05-29;SY;Syria;0;0;122;4
2020-05-30;SY;Syria;0;0;122;4
2020-05-31;SY;Syria;0;1;122;5
2020-06-01;SY;Syria;1;0;123;5
2020-06-02;SY;Syria;0;1;123;6
2020-06-03;SY;Syria;0;0;123;6
2020-06-04;SY;Syria;1;0;124;6
2020-06-05;SY;Syria;0;0;124;6
2020-06-06;SY;Syria;1;0;125;6
2020-06-07;SY;Syria;16;0;141;6
2020-06-08;SY;Syria;3;0;144;6
2020-06-09;SY;Syria;2;0;146;6
2020-06-10;SY;Syria;6;0;152;6
2020-06-11;SY;Syria;12;0;164;6
2020-06-12;SY;Syria;0;0;164;6
2020-06-13;SY;Syria;6;0;170;6
2020-06-14;SY;Syria;7;0;177;6
2020-06-15;SY;Syria;0;0;177;6
2020-06-16;SY;Syria;0;0;177;6
2020-06-17;SY;Syria;1;1;178;7
2020-06-18;SY;Syria;9;0;187;7
2020-06-19;SY;Syria;0;0;187;7
2020-06-20;SY;Syria;11;0;198;7
2020-06-21;SY;Syria;6;0;204;7
2020-06-22;SY;Syria;15;0;219;7
2020-06-23;SY;Syria;12;0;231;7
2020-06-24;SY;Syria;0;0;231;7
2020-06-25;SY;Syria;11;0;242;7
2020-06-26;SY;Syria;13;1;255;8
2020-06-27;SY;Syria;1;1;256;9
2020-06-28;SY;Syria;0;0;256;9
2020-06-29;SY;Syria;13;0;269;9
2020-06-30;SY;Syria;10;0;279;9
2020-07-01;SY;Syria;14;0;293;9
2020-07-02;SY;Syria;19;0;312;9
2020-07-03;SY;Syria;16;1;328;10
2020-07-04;SY;Syria;10;0;338;10
2020-07-05;SY;Syria;20;3;358;13
2020-07-06;SY;Syria;14;1;372;14
2020-07-07;SY;Syria;0;0;372;14
2020-07-08;SY;Syria;0;0;372;14
2020-07-09;SY;Syria;0;0;372;14
2020-07-10;SY;Syria;22;2;394;16
2020-07-11;SY;Syria;0;0;394;16
2020-07-12;SY;Syria;0;0;394;16
2020-07-13;SY;Syria;23;3;417;19
2020-07-14;SY;Syria;22;2;439;21
2020-07-15;SY;Syria;19;1;458;22
2020-07-16;SY;Syria;19;0;477;22
2020-07-17;SY;Syria;19;3;496;25
2020-07-18;SY;Syria;0;0;496;25
2020-07-19;SY;Syria;0;0;496;25
2020-07-20;SY;Syria;26;4;522;29
2020-07-21;SY;Syria;18;2;540;31
2020-07-22;SY;Syria;21;1;561;32
2020-07-23;SY;Syria;23;3;584;35
2020-07-24;SY;Syria;24;0;608;35
2020-07-25;SY;Syria;19;1;627;36
2020-07-26;SY;Syria;23;2;650;38
2020-07-27;SY;Syria;24;2;674;40
2020-07-28;SY;Syria;20;0;694;40
2020-07-29;SY;Syria;23;0;717;40
2020-07-30;SY;Syria;21;1;738;41
2020-07-31;SY;Syria;19;2;757;43
2020-08-01;SY;Syria;23;0;780;43
2020-08-02;SY;Syria;29;1;809;44
2020-08-03;SY;Syria;38;2;847;46
2020-08-04;SY;Syria;45;0;892;46
2020-08-05;SY;Syria;52;2;944;48
2020-08-06;SY;Syria;55;0;999;48
2020-08-07;SY;Syria;61;0;1060;48
2020-08-08;SY;Syria;65;2;1125;50
2020-08-09;SY;Syria;63;2;1188;52
2020-08-10;SY;Syria;67;0;1255;52
2020-08-11;SY;Syria;72;1;1327;53
2020-08-12;SY;Syria;0;0;1327;53
2020-08-13;SY;Syria;105;2;1432;55
2020-08-14;SY;Syria;83;3;1515;58
2020-08-15;SY;Syria;78;2;1593;60
2020-08-16;SY;Syria;84;4;1677;64
2020-08-17;SY;Syria;87;4;1764;68
2020-08-18;SY;Syria;80;5;1844;73
2020-08-19;SY;Syria;83;5;1927;78
2020-08-20;SY;Syria;81;4;2008;82
2020-08-21;SY;Syria;65;1;2073;83
2020-08-22;SY;Syria;70;2;2143;85
2020-08-23;SY;Syria;74;4;2217;89
2020-08-24;SY;Syria;76;3;2293;92
2020-08-25;SY;Syria;72;3;2365;95
2020-08-26;SY;Syria;75;3;2440;98
2020-08-27;SY;Syria;64;2;2504;100
2020-08-28;SY;Syria;59;3;2563;103
2020-08-29;SY;Syria;65;3;2628;106
2020-08-30;SY;Syria;75;3;2703;109
2020-08-31;SY;Syria;62;3;2765;112
2020-09-01;SY;Syria;65;4;2830;116
2020-09-02;SY;Syria;68;4;2898;120
2020-09-03;SY;Syria;75;4;2973;124
2020-09-04;SY;Syria;68;3;3041;127
2020-09-05;SY;Syria;63;3;3104;130
2020-09-06;SY;Syria;67;4;3171;134
2020-09-07;SY;Syria;58;3;3229;137
2020-09-08;SY;Syria;60;3;3289;140
2020-09-09;SY;Syria;62;3;3351;143
2020-09-10;SY;Syria;65;4;3416;147
2020-09-11;SY;Syria;60;3;3476;150
2020-09-12;SY;Syria;30;2;3506;152
2020-09-13;SY;Syria;34;3;3540;155
2020-09-14;SY;Syria;36;2;3576;157
2020-09-15;SY;Syria;38;3;3614;160
2020-09-16;SY;Syria;40;3;3654;163
2020-09-17;SY;Syria;37;2;3691;165
2020-09-18;SY;Syria;40;3;3731;168
2020-09-19;SY;Syria;34;2;3765;170
2020-09-20;SY;Syria;35;2;3800;172
2020-09-21;SY;Syria;33;3;3833;175
2020-09-22;SY;Syria;44;3;3877;178
2020-09-23;SY;Syria;47;3;3924;181
2020-09-24;SY;Syria;42;2;3966;183
2020-09-25;SY;Syria;35;2;4001;185
2020-09-26;SY;Syria;37;3;4038;188
2020-09-27;SY;Syria;34;4;4072;192
2020-09-28;SY;Syria;30;2;4102;194
2020-09-29;SY;Syria;46;3;4148;197
2020-09-30;SY;Syria;52;3;4200;200
2020-10-01;SY;Syria;47;2;4247;202
2020-10-02;SY;Syria;42;1;4289;203
2020-10-03;SY;Syria;40;1;4329;204
2020-10-04;SY;Syria;37;1;4366;205
2020-10-05;SY;Syria;45;2;4411;207
2020-10-06;SY;Syria;46;2;4457;209
2020-10-07;SY;Syria;47;3;4504;212
2020-10-08;SY;Syria;62;3;4566;215
2020-10-09;SY;Syria;50;3;4616;218
2020-10-10;SY;Syria;57;3;4673;221
2020-10-11;SY;Syria;45;3;4718;224
2020-10-12;SY;Syria;56;4;4774;228
2020-10-13;SY;Syria;52;3;4826;231
2020-10-14;SY;Syria;57;3;4883;234
2020-10-15;SY;Syria;48;4;4931;238
2020-10-16;SY;Syria;56;3;4987;241
2020-10-17;SY;Syria;46;4;5033;245
2020-10-18;SY;Syria;44;3;5077;248
2020-10-19;SY;Syria;57;3;5134;251
2020-10-20;SY;Syria;46;3;5180;254
2020-10-21;SY;Syria;44;3;5224;257
2020-10-22;SY;Syria;43;3;5267;260
2020-10-23;SY;Syria;52;4;5319;264
2020-10-24;SY;Syria;40;3;5359;267
2020-10-25;SY;Syria;49;2;5408;269
2020-10-26;SY;Syria;53;3;5461;272
2020-10-27;SY;Syria;67;3;5528;275
2020-10-28;SY;Syria;52;3;5580;278
2020-10-29;SY;Syria;53;3;5633;281
2020-10-30;SY;Syria;50;4;5683;285
2020-10-31;SY;Syria;45;3;5728;288
2020-11-01;SY;Syria;61;4;5789;292
2020-11-02;SY;Syria;54;3;5843;295
2020-11-03;SY;Syria;45;3;5888;298
2020-11-04;SY;Syria;76;3;5964;301
2020-11-05;SY;Syria;76;4;6040;305
2020-11-06;SY;Syria;62;4;6102;309
2020-11-07;SY;Syria;45;4;6147;313
2020-11-08;SY;Syria;68;4;6215;317
2020-11-09;SY;Syria;69;4;6284;321
2020-11-10;SY;Syria;68;4;6352;325
2020-11-11;SY;Syria;69;4;6421;329
2020-11-12;SY;Syria;65;4;6486;333
2020-11-13;SY;Syria;66;4;6552;337
2020-11-14;SY;Syria;61;4;6613;341
2020-11-15;SY;Syria;71;4;6684;345
2020-11-16;SY;Syria;75;5;6759;350
2020-11-17;SY;Syria;77;4;6836;354
2020-11-18;SY;Syria;83;4;6919;358
2020-11-19;SY;Syria;72;5;6991;363
2020-11-20;SY;Syria;88;5;7079;368
2020-11-21;SY;Syria;75;4;7154;372
2020-11-22;SY;Syria;71;4;7225;376
2020-11-23;SY;Syria;70;4;7295;380
2020-11-24;SY;Syria;74;5;7369;385
2020-11-25;SY;Syria;90;6;7459;391
2020-11-26;SY;Syria;83;8;7542;399
2020-11-27;SY;Syria;93;5;7635;404
2020-11-28;SY;Syria;80;5;7715;409
2020-11-29;SY;Syria;82;4;7797;413
2020-11-30;SY;Syria;90;4;7887;417
2020-12-01;SY;Syria;86;5;7973;422
2020-12-02;SY;Syria;86;4;8059;426
2020-12-03;SY;Syria;88;6;8147;432
2020-12-04;SY;Syria;86;5;8233;437
2020-12-05;SY;Syria;87;5;8320;442
2020-12-06;SY;Syria;83;5;8403;447
2020-12-07;SY;Syria;87;5;8490;452
2020-12-08;SY;Syria;90;6;8580;458
2020-12-09;SY;Syria;95;7;8675;465
2020-12-10;SY;Syria;112;11;8787;476
2020-12-11;SY;Syria;124;15;8911;491
2020-12-12;SY;Syria;130;15;9041;506
2020-12-13;SY;Syria;125;12;9166;518
2020-12-14;SY;Syria;136;12;9302;530
2020-12-15;SY;Syria;150;13;9452;543
2020-12-16;SY;Syria;151;11;9603;554
2020-12-17;SY;Syria;156;17;9759;571
2020-12-18;SY;Syria;169;20;9928;591
2020-12-19;SY;Syria;122;10;10050;601
2020-12-20;SY;Syria;145;9;10195;610
2020-12-21;SY;Syria;123;11;10318;621
2020-12-22;SY;Syria;124;9;10442;630
2020-12-23;SY;Syria;129;11;10571;641
2020-12-24;SY;Syria;130;11;10701;652
2020-12-25;SY;Syria;120;8;10821;660
2020-12-26;SY;Syria;111;9;10932;669
2020-12-27;SY;Syria;101;9;11033;678
2020-12-28;SY;Syria;105;8;11138;686
2020-12-29;SY;Syria;105;10;11243;696
2020-12-30;SY;Syria;101;8;11344;704
2020-12-31;SY;Syria;90;7;11434;711
2021-01-01;SY;Syria;92;6;11526;717
2021-01-02;SY;Syria;90;6;11616;723
2021-01-03;SY;Syria;94;6;11710;729
2021-01-04;SY;Syria;89;5;11799;734
2021-01-05;SY;Syria;91;7;11890;741
2021-01-06;SY;Syria;98;6;11988;747
2021-01-07;SY;Syria;96;8;12084;755
2021-01-08;SY;Syria;95;8;12179;763
2021-01-09;SY;Syria;95;5;12274;768
2021-01-10;SY;Syria;90;6;12364;774
2021-01-11;SY;Syria;98;7;12462;781
2021-01-12;SY;Syria;96;9;12558;790
2021-01-13;SY;Syria;102;9;12660;799
2021-01-14;SY;Syria;100;10;12760;809
2021-01-15;SY;Syria;90;8;12850;817
2021-01-16;SY;Syria;92;7;12942;824
2021-01-17;SY;Syria;94;8;13036;832
2021-01-18;SY;Syria;96;9;13132;841
2021-01-19;SY;Syria;92;9;13224;850
2021-01-20;SY;Syria;89;8;13313;858
2021-01-21;SY;Syria;85;8;13398;866
2021-01-22;SY;Syria;81;7;13479;873
2021-01-23;SY;Syria;78;6;13557;879
2021-01-24;SY;Syria;71;6;13628;885
2021-01-25;SY;Syria;69;5;13697;890
2021-01-26;SY;Syria;65;5;13762;895
2021-01-27;SY;Syria;61;5;13823;900
2021-01-28;SY;Syria;62;6;13885;906
2021-01-29;SY;Syria;59;5;13944;911
2021-01-30;SY;Syria;54;5;13998;916
2021-01-31;SY;Syria;50;5;14048;921
2021-02-01;SY;Syria;48;5;14096;926
2021-02-02;SY;Syria;46;3;14142;929
2021-02-03;SY;Syria;60;4;14202;933
2021-02-04;SY;Syria;65;5;14267;938
2021-02-05;SY;Syria;71;5;14338;943
2021-02-06;SY;Syria;70;4;14408;947
2021-02-07;SY;Syria;69;5;14477;952
2021-02-08;SY;Syria;74;6;14551;958
2021-02-09;SY;Syria;60;3;14611;961
2021-02-10;SY;Syria;57;4;14668;965
2021-02-11;SY;Syria;56;3;14724;968
2021-02-12;SY;Syria;41;3;14765;971
2021-02-13;SY;Syria;55;4;14820;975
2021-02-14;SY;Syria;43;3;14863;978
2021-02-15;SY;Syria;43;3;14906;981
2021-02-16;SY;Syria;45;3;14951;984
2021-02-17;SY;Syria;50;3;15001;987
2021-02-18;SY;Syria;44;3;15045;990
2021-02-19;SY;Syria;49;4;15094;994
2021-02-20;SY;Syria;49;2;15143;996
2021-02-21;SY;Syria;36;2;15179;998
2021-02-22;SY;Syria;51;3;15230;1001
2021-02-23;SY;Syria;52;3;15282;1004
2021-02-24;SY;Syria;61;4;15343;1008
2021-02-25;SY;Syria;62;6;15405;1014
2021-02-26;SY;Syria;62;4;15467;1018
2021-02-27;SY;Syria;66;5;15533;1023
2021-02-28;SY;Syria;55;4;15588;1027
2021-03-01;SY;Syria;54;5;15642;1032
2021-03-02;SY;Syria;54;7;15696;1039
2021-03-03;SY;Syria;57;6;15753;1045
2021-03-04;SY;Syria;62;5;15815;1050
2021-03-05;SY;Syria;55;4;15870;1054
2021-03-06;SY;Syria;55;4;15925;1058
2021-03-07;SY;Syria;56;5;15981;1063
2021-03-08;SY;Syria;61;5;16042;1068
2021-03-09;SY;Syria;75;6;16117;1074
2021-03-10;SY;Syria;70;5;16187;1079
2021-03-11;SY;Syria;70;6;16257;1085
2021-03-12;SY;Syria;71;5;16328;1090
2021-03-13;SY;Syria;73;4;16401;1094
2021-03-14;SY;Syria;77;5;16478;1099
2021-03-15;SY;Syria;78;5;16556;1104
2021-03-16;SY;Syria;100;6;16656;1110
2021-03-17;SY;Syria;120;10;16776;1120
2021-03-18;SY;Syria;149;10;16925;1130
2021-03-19;SY;Syria;152;11;17077;1141
2021-03-20;SY;Syria;163;12;17240;1153
2021-03-21;SY;Syria;171;10;17411;1163
2021-03-22;SY;Syria;172;12;17583;1175
2021-03-23;SY;Syria;160;8;17743;1183
2021-03-24;SY;Syria;153;12;17896;1195
2021-03-25;SY;Syria;150;11;18046;1206
2021-03-26;SY;Syria;155;10;18201;1216
2021-03-27;SY;Syria;155;11;18356;1227
2021-03-28;SY;Syria;142;12;18498;1239
2021-03-29;SY;Syria;140;8;18638;1247
2021-03-30;SY;Syria;137;7;18775;1254
2021-03-31;SY;Syria;134;11;18909;1265
2021-04-01;SY;Syria;130;9;19039;1274
2021-04-02;SY;Syria;125;14;19164;1288
2021-04-03;SY;Syria;120;11;19284;1299
2021-04-04;SY;Syria;120;14;19404;1313
2021-04-05;SY;Syria;122;10;19526;1323
2021-04-06;SY;Syria;115;9;19641;1332
2021-04-07;SY;Syria;120;10;19761;1342
2021-04-08;SY;Syria;122;10;19883;1352
2021-04-09;SY;Syria;125;8;20008;1360
2021-04-10;SY;Syria;110;8;20118;1368
2021-04-11;SY;Syria;108;10;20226;1378
2021-04-12;SY;Syria;105;7;20331;1385
2021-04-13;SY;Syria;104;7;20435;1392
2021-04-14;SY;Syria;120;10;20555;1402
2021-04-15;SY;Syria;158;12;20713;1414
2021-04-16;SY;Syria;143;9;20856;1423
2021-04-17;SY;Syria;148;14;21004;1437
2021-04-18;SY;Syria;138;9;21142;1446
2021-04-19;SY;Syria;137;10;21279;1456
2021-04-20;SY;Syria;154;12;21433;1468
2021-04-21;SY;Syria;151;15;21584;1483
2021-04-22;SY;Syria;141;13;21725;1496
2021-04-23;SY;Syria;139;14;21864;1510
2021-04-24;SY;Syria;135;16;21999;1526
2021-04-25;SY;Syria;136;11;22135;1537
2021-04-26;SY;Syria;130;11;22265;1548
2021-04-27;SY;Syria;124;11;22389;1559
2021-04-28;SY;Syria;124;13;22513;1572
2021-04-29;SY;Syria;118;11;22631;1583
2021-04-30;SY;Syria;102;9;22733;1592
2021-05-01;SY;Syria;85;6;22818;1598
2021-05-02;SY;Syria;80;5;22898;1603
2021-05-03;SY;Syria;79;7;22977;1610
2021-05-04;SY;Syria;74;7;23051;1617
2021-05-05;SY;Syria;70;8;23121;1625
2021-05-06;SY;Syria;70;6;23191;1631
2021-05-07;SY;Syria;65;8;23256;1639
2021-05-08;SY;Syria;63;9;23319;1648
2021-05-09;SY;Syria;60;9;23379;1657
2021-05-10;SY;Syria;60;7;23439;1664
2021-05-11;SY;Syria;51;6;23490;1670
2021-05-12;SY;Syria;53;6;23543;1676
2021-05-13;SY;Syria;52;6;23595;1682
2021-05-14;SY;Syria;50;6;23645;1688
2021-05-15;SY;Syria;48;5;23693;1693
2021-05-16;SY;Syria;45;5;23738;1698
2021-05-17;SY;Syria;50;7;23788;1705
2021-05-18;SY;Syria;42;5;23830;1710
2021-05-19;SY;Syria;54;4;23884;1714
2021-05-20;SY;Syria;55;6;23939;1720
2021-05-21;SY;Syria;57;4;23996;1724
2021-05-22;SY;Syria;56;5;24052;1729
2021-05-23;SY;Syria;65;5;24117;1734
2021-05-24;SY;Syria;70;6;24187;1740
2021-05-25;SY;Syria;65;5;24252;1745
2021-05-26;SY;Syria;63;5;24315;1750
2021-05-27;SY;Syria;50;4;24365;1754
2021-05-28;SY;Syria;45;4;24410;1758
2021-05-29;SY;Syria;30;5;24440;1763
2021-05-30;SY;Syria;27;3;24467;1766
2021-05-31;SY;Syria;28;4;24495;1770
2021-06-01;SY;Syria;34;4;24529;1774
2021-06-02;SY;Syria;30;4;24559;1778
2021-06-03;SY;Syria;32;4;24591;1782
2021-06-04;SY;Syria;28;5;24619;1787
2021-06-05;SY;Syria;20;3;24639;1790
2021-06-06;SY;Syria;20;3;24659;1793
2021-06-07;SY;Syria;21;3;24680;1796
2021-06-08;SY;Syria;20;3;24700;1799
2021-06-09;SY;Syria;23;2;24723;1801
2021-06-10;SY;Syria;20;3;24743;1804
2021-06-11;SY;Syria;24;2;24767;1806
2021-06-12;SY;Syria;22;2;24789;1808
2021-06-13;SY;Syria;25;2;24814;1810
2021-06-14;SY;Syria;46;5;24860;1815
2021-06-15;SY;Syria;44;6;24904;1821
2021-06-16;SY;Syria;42;5;24946;1826
2021-06-17;SY;Syria;45;6;24991;1832
2021-06-18;SY;Syria;44;5;25035;1837
2021-06-19;SY;Syria;41;4;25076;1841
2021-06-20;SY;Syria;42;4;25118;1845
2021-06-21;SY;Syria;40;3;25158;1848
2021-06-22;SY;Syria;47;3;25205;1851
2021-06-23;SY;Syria;43;4;25248;1855
2021-06-24;SY;Syria;39;4;25287;1859
2021-06-25;SY;Syria;41;3;25328;1862
2021-06-26;SY;Syria;37;2;25365;1864
2021-06-27;SY;Syria;39;3;25404;1867
2021-06-28;SY;Syria;38;3;25442;1870
2021-06-29;SY;Syria;37;3;25479;1873
2021-06-30;SY;Syria;36;3;25515;1876
2021-07-01;SY;Syria;36;3;25551;1879
2020-01-16;TW;Taiwan;0;0;0;0
2020-01-17;TW;Taiwan;0;0;0;0
2020-01-18;TW;Taiwan;0;0;0;0
2020-01-19;TW;Taiwan;0;0;0;0
2020-01-20;TW;Taiwan;0;0;0;0
2020-01-21;TW;Taiwan;0;0;0;0
2020-01-22;TW;Taiwan;0;0;1;0
2020-01-23;TW;Taiwan;0;0;1;0
2020-01-24;TW;Taiwan;2;0;3;0
2020-01-25;TW;Taiwan;0;0;3;0
2020-01-26;TW;Taiwan;1;0;4;0
2020-01-27;TW;Taiwan;1;0;5;0
2020-01-28;TW;Taiwan;3;0;8;0
2020-01-29;TW;Taiwan;0;0;8;0
2020-01-30;TW;Taiwan;1;0;9;0
2020-01-31;TW;Taiwan;1;0;10;0
2020-02-01;TW;Taiwan;0;0;10;0
2020-02-02;TW;Taiwan;0;0;10;0
2020-02-03;TW;Taiwan;0;0;10;0
2020-02-04;TW;Taiwan;1;0;11;0
2020-02-05;TW;Taiwan;0;0;11;0
2020-02-06;TW;Taiwan;5;0;16;0
2020-02-07;TW;Taiwan;0;0;16;0
2020-02-08;TW;Taiwan;1;0;17;0
2020-02-09;TW;Taiwan;1;0;18;0
2020-02-10;TW;Taiwan;0;0;18;0
2020-02-11;TW;Taiwan;0;0;18;0
2020-02-12;TW;Taiwan;0;0;18;0
2020-02-13;TW;Taiwan;0;0;18;0
2020-02-14;TW;Taiwan;0;0;18;0
2020-02-15;TW;Taiwan;0;0;18;0
2020-02-16;TW;Taiwan;2;1;20;1
2020-02-17;TW;Taiwan;2;0;22;1
2020-02-18;TW;Taiwan;0;0;22;1
2020-02-19;TW;Taiwan;1;0;23;1
2020-02-20;TW;Taiwan;1;0;24;1
2020-02-21;TW;Taiwan;2;0;26;1
2020-02-22;TW;Taiwan;0;0;26;1
2020-02-23;TW;Taiwan;2;0;28;1
2020-02-24;TW;Taiwan;2;0;30;1
2020-02-25;TW;Taiwan;1;0;31;1
2020-02-26;TW;Taiwan;1;0;32;1
2020-02-27;TW;Taiwan;0;0;32;1
2020-02-28;TW;Taiwan;2;0;34;1
2020-02-29;TW;Taiwan;5;0;39;1
2020-03-01;TW;Taiwan;1;0;40;1
2020-03-02;TW;Taiwan;1;0;41;1
2020-03-03;TW;Taiwan;1;0;42;1
2020-03-04;TW;Taiwan;0;0;42;1
2020-03-05;TW;Taiwan;2;0;44;1
2020-03-06;TW;Taiwan;1;0;45;1
2020-03-07;TW;Taiwan;0;0;45;1
2020-03-08;TW;Taiwan;0;0;45;1
2020-03-09;TW;Taiwan;0;0;45;1
2020-03-10;TW;Taiwan;2;0;47;1
2020-03-11;TW;Taiwan;1;0;48;1
2020-03-12;TW;Taiwan;1;0;49;1
2020-03-13;TW;Taiwan;1;0;50;1
2020-03-14;TW;Taiwan;3;0;53;1
2020-03-15;TW;Taiwan;6;0;59;1
2020-03-16;TW;Taiwan;8;0;67;1
2020-03-17;TW;Taiwan;10;0;77;1
2020-03-18;TW;Taiwan;23;0;100;1
2020-03-19;TW;Taiwan;8;0;108;1
2020-03-20;TW;Taiwan;27;1;135;2
2020-03-21;TW;Taiwan;18;0;153;2
2020-03-22;TW;Taiwan;16;0;169;2
2020-03-23;TW;Taiwan;26;0;195;2
2020-03-24;TW;Taiwan;20;0;215;2
2020-03-25;TW;Taiwan;20;0;235;2
2020-03-26;TW;Taiwan;17;0;252;2
2020-03-27;TW;Taiwan;15;0;267;2
2020-03-28;TW;Taiwan;16;0;283;2
2020-03-29;TW;Taiwan;15;0;298;2
2020-03-30;TW;Taiwan;8;3;306;5
2020-03-31;TW;Taiwan;16;0;322;5
2020-04-01;TW;Taiwan;7;0;329;5
2020-04-02;TW;Taiwan;10;0;339;5
2020-04-03;TW;Taiwan;9;0;348;5
2020-04-04;TW;Taiwan;7;0;355;5
2020-04-05;TW;Taiwan;8;0;363;5
2020-04-06;TW;Taiwan;10;0;373;5
2020-04-07;TW;Taiwan;3;0;376;5
2020-04-08;TW;Taiwan;3;0;379;5
2020-04-09;TW;Taiwan;1;0;380;5
2020-04-10;TW;Taiwan;2;1;382;6
2020-04-11;TW;Taiwan;3;0;385;6
2020-04-12;TW;Taiwan;3;0;388;6
2020-04-13;TW;Taiwan;5;0;393;6
2020-04-14;TW;Taiwan;0;0;393;6
2020-04-15;TW;Taiwan;2;0;395;6
2020-04-16;TW;Taiwan;0;0;395;6
2020-04-17;TW;Taiwan;0;0;395;6
2020-04-18;TW;Taiwan;3;0;398;6
2020-04-19;TW;Taiwan;22;0;420;6
2020-04-20;TW;Taiwan;2;0;422;6
2020-04-21;TW;Taiwan;3;0;425;6
2020-04-22;TW;Taiwan;1;0;426;6
2020-04-23;TW;Taiwan;1;0;427;6
2020-04-24;TW;Taiwan;1;0;428;6
2020-04-25;TW;Taiwan;1;0;429;6
2020-04-26;TW;Taiwan;0;0;429;6
2020-04-27;TW;Taiwan;0;0;429;6
2020-04-28;TW;Taiwan;0;0;429;6
2020-04-29;TW;Taiwan;0;0;429;6
2020-04-30;TW;Taiwan;0;0;429;6
2020-05-01;TW;Taiwan;0;0;429;6
2020-05-02;TW;Taiwan;3;0;432;6
2020-05-03;TW;Taiwan;4;0;436;6
2020-05-04;TW;Taiwan;2;0;438;6
2020-05-05;TW;Taiwan;0;0;438;6
2020-05-06;TW;Taiwan;1;0;439;6
2020-05-07;TW;Taiwan;1;0;440;6
2020-05-08;TW;Taiwan;0;0;440;6
2020-05-09;TW;Taiwan;0;0;440;6
2020-05-10;TW;Taiwan;0;0;440;6
2020-05-11;TW;Taiwan;0;1;440;7
2020-05-12;TW;Taiwan;0;0;440;7
2020-05-13;TW;Taiwan;0;0;440;7
2020-05-14;TW;Taiwan;0;0;440;7
2020-05-15;TW;Taiwan;0;0;440;7
2020-05-16;TW;Taiwan;0;0;440;7
2020-05-17;TW;Taiwan;0;0;440;7
2020-05-18;TW;Taiwan;0;0;440;7
2020-05-19;TW;Taiwan;0;0;440;7
2020-05-20;TW;Taiwan;0;0;440;7
2020-05-21;TW;Taiwan;0;0;440;7
2020-05-22;TW;Taiwan;1;0;441;7
2020-05-23;TW;Taiwan;0;0;441;7
2020-05-24;TW;Taiwan;0;0;441;7
2020-05-25;TW;Taiwan;0;0;441;7
2020-05-26;TW;Taiwan;0;0;441;7
2020-05-27;TW;Taiwan;0;0;441;7
2020-05-28;TW;Taiwan;0;0;441;7
2020-05-29;TW;Taiwan;1;0;442;7
2020-05-30;TW;Taiwan;0;0;442;7
2020-05-31;TW;Taiwan;0;0;442;7
2020-06-01;TW;Taiwan;1;0;443;7
2020-06-02;TW;Taiwan;0;0;443;7
2020-06-03;TW;Taiwan;0;0;443;7
2020-06-04;TW;Taiwan;0;0;443;7
2020-06-05;TW;Taiwan;0;0;443;7
2020-06-06;TW;Taiwan;0;0;443;7
2020-06-07;TW;Taiwan;0;0;443;7
2020-06-08;TW;Taiwan;0;0;443;7
2020-06-09;TW;Taiwan;0;0;443;7
2020-06-10;TW;Taiwan;0;0;443;7
2020-06-11;TW;Taiwan;0;0;443;7
2020-06-12;TW;Taiwan;0;0;443;7
2020-06-13;TW;Taiwan;0;0;443;7
2020-06-14;TW;Taiwan;0;0;443;7
2020-06-15;TW;Taiwan;2;0;445;7
2020-06-16;TW;Taiwan;0;0;445;7
2020-06-17;TW;Taiwan;0;0;445;7
2020-06-18;TW;Taiwan;1;0;446;7
2020-06-19;TW;Taiwan;0;0;446;7
2020-06-20;TW;Taiwan;0;0;446;7
2020-06-21;TW;Taiwan;0;0;446;7
2020-06-22;TW;Taiwan;0;0;446;7
2020-06-23;TW;Taiwan;0;0;446;7
2020-06-24;TW;Taiwan;0;0;446;7
2020-06-25;TW;Taiwan;1;0;447;7
2020-06-26;TW;Taiwan;0;0;447;7
2020-06-27;TW;Taiwan;0;0;447;7
2020-06-28;TW;Taiwan;0;0;447;7
2020-06-29;TW;Taiwan;0;0;447;7
2020-06-30;TW;Taiwan;0;0;447;7
2020-07-01;TW;Taiwan;0;0;447;7
2020-07-02;TW;Taiwan;1;0;448;7
2020-07-03;TW;Taiwan;1;0;449;7
2020-07-04;TW;Taiwan;0;0;449;7
2020-07-05;TW;Taiwan;0;0;449;7
2020-07-06;TW;Taiwan;0;0;449;7
2020-07-07;TW;Taiwan;0;0;449;7
2020-07-08;TW;Taiwan;0;0;449;7
2020-07-09;TW;Taiwan;0;0;449;7
2020-07-10;TW;Taiwan;0;0;449;7
2020-07-11;TW;Taiwan;2;0;451;7
2020-07-12;TW;Taiwan;0;0;451;7
2020-07-13;TW;Taiwan;0;0;451;7
2020-07-14;TW;Taiwan;0;0;451;7
2020-07-15;TW;Taiwan;0;0;451;7
2020-07-16;TW;Taiwan;0;0;451;7
2020-07-17;TW;Taiwan;0;0;451;7
2020-07-18;TW;Taiwan;0;0;451;7
2020-07-19;TW;Taiwan;0;0;451;7
2020-07-20;TW;Taiwan;0;0;451;7
2020-07-21;TW;Taiwan;0;0;451;7
2020-07-22;TW;Taiwan;4;0;455;7
2020-07-23;TW;Taiwan;0;0;455;7
2020-07-24;TW;Taiwan;3;0;458;7
2020-07-25;TW;Taiwan;0;0;458;7
2020-07-26;TW;Taiwan;0;0;458;7
2020-07-27;TW;Taiwan;4;0;462;7
2020-07-28;TW;Taiwan;5;0;467;7
2020-07-29;TW;Taiwan;0;0;467;7
2020-07-30;TW;Taiwan;0;0;467;7
2020-07-31;TW;Taiwan;0;0;467;7
2020-08-01;TW;Taiwan;7;0;474;7
2020-08-02;TW;Taiwan;1;0;475;7
2020-08-03;TW;Taiwan;-1;0;474;7
2020-08-04;TW;Taiwan;2;0;476;7
2020-08-05;TW;Taiwan;0;0;476;7
2020-08-06;TW;Taiwan;1;0;477;7
2020-08-07;TW;Taiwan;0;0;477;7
2020-08-08;TW;Taiwan;2;0;479;7
2020-08-09;TW;Taiwan;-2;0;477;7
2020-08-10;TW;Taiwan;0;0;477;7
2020-08-11;TW;Taiwan;3;0;480;7
2020-08-12;TW;Taiwan;1;0;481;7
2020-08-13;TW;Taiwan;0;0;481;7
2020-08-14;TW;Taiwan;0;0;481;7
2020-08-15;TW;Taiwan;1;0;482;7
2020-08-16;TW;Taiwan;2;0;484;7
2020-08-17;TW;Taiwan;1;0;485;7
2020-08-18;TW;Taiwan;1;0;486;7
2020-08-19;TW;Taiwan;0;0;486;7
2020-08-20;TW;Taiwan;0;0;486;7
2020-08-21;TW;Taiwan;1;0;487;7
2020-08-22;TW;Taiwan;0;0;487;7
2020-08-23;TW;Taiwan;0;0;487;7
2020-08-24;TW;Taiwan;0;0;487;7
2020-08-25;TW;Taiwan;0;0;487;7
2020-08-26;TW;Taiwan;0;0;487;7
2020-08-27;TW;Taiwan;0;0;487;7
2020-08-28;TW;Taiwan;0;0;487;7
2020-08-29;TW;Taiwan;1;0;488;7
2020-08-30;TW;Taiwan;0;0;488;7
2020-08-31;TW;Taiwan;0;0;488;7
2020-09-01;TW;Taiwan;0;0;488;7
2020-09-02;TW;Taiwan;1;0;489;7
2020-09-03;TW;Taiwan;0;0;489;7
2020-09-04;TW;Taiwan;1;0;490;7
2020-09-05;TW;Taiwan;2;0;492;7
2020-09-06;TW;Taiwan;1;0;493;7
2020-09-07;TW;Taiwan;1;0;494;7
2020-09-08;TW;Taiwan;1;0;495;7
2020-09-09;TW;Taiwan;0;0;495;7
2020-09-10;TW;Taiwan;1;0;496;7
2020-09-11;TW;Taiwan;2;0;498;7
2020-09-12;TW;Taiwan;0;0;498;7
2020-09-13;TW;Taiwan;0;0;498;7
2020-09-14;TW;Taiwan;1;0;499;7
2020-09-15;TW;Taiwan;0;0;499;7
2020-09-16;TW;Taiwan;1;0;500;7
2020-09-17;TW;Taiwan;3;0;503;7
2020-09-18;TW;Taiwan;0;0;503;7
2020-09-19;TW;Taiwan;3;0;506;7
2020-09-20;TW;Taiwan;1;0;507;7
2020-09-21;TW;Taiwan;2;0;509;7
2020-09-22;TW;Taiwan;0;0;509;7
2020-09-23;TW;Taiwan;0;0;509;7
2020-09-24;TW;Taiwan;0;0;509;7
2020-09-25;TW;Taiwan;1;0;510;7
2020-09-26;TW;Taiwan;0;0;510;7
2020-09-27;TW;Taiwan;0;0;510;7
2020-09-28;TW;Taiwan;3;0;513;7
2020-09-29;TW;Taiwan;0;0;513;7
2020-09-30;TW;Taiwan;1;0;514;7
2020-10-01;TW;Taiwan;1;0;515;7
2020-10-02;TW;Taiwan;2;0;517;7
2020-10-03;TW;Taiwan;0;0;517;7
2020-10-04;TW;Taiwan;0;0;517;7
2020-10-05;TW;Taiwan;1;0;518;7
2020-10-06;TW;Taiwan;3;0;521;7
2020-10-07;TW;Taiwan;2;0;523;7
2020-10-08;TW;Taiwan;1;0;524;7
2020-10-09;TW;Taiwan;3;0;527;7
2020-10-10;TW;Taiwan;0;0;527;7
2020-10-11;TW;Taiwan;0;0;527;7
2020-10-12;TW;Taiwan;2;0;529;7
2020-10-13;TW;Taiwan;1;0;530;7
2020-10-14;TW;Taiwan;0;0;530;7
2020-10-15;TW;Taiwan;1;0;531;7
2020-10-16;TW;Taiwan;4;0;535;7
2020-10-17;TW;Taiwan;0;0;535;7
2020-10-18;TW;Taiwan;0;0;535;7
2020-10-19;TW;Taiwan;5;0;540;7
2020-10-20;TW;Taiwan;3;0;543;7
2020-10-21;TW;Taiwan;1;0;544;7
2020-10-22;TW;Taiwan;4;0;548;7
2020-10-23;TW;Taiwan;0;0;548;7
2020-10-24;TW;Taiwan;2;0;550;7
2020-10-25;TW;Taiwan;0;0;550;7
2020-10-26;TW;Taiwan;0;0;550;7
2020-10-27;TW;Taiwan;0;0;550;7
2020-10-28;TW;Taiwan;0;0;550;7
2020-10-29;TW;Taiwan;3;0;553;7
2020-10-30;TW;Taiwan;1;0;554;7
2020-10-31;TW;Taiwan;1;0;555;7
2020-11-01;TW;Taiwan;3;0;558;7
2020-11-02;TW;Taiwan;5;0;563;7
2020-11-03;TW;Taiwan;4;0;567;7
2020-11-04;TW;Taiwan;1;0;568;7
2020-11-05;TW;Taiwan;1;0;569;7
2020-11-06;TW;Taiwan;4;0;573;7
2020-11-07;TW;Taiwan;0;0;573;7
2020-11-08;TW;Taiwan;4;0;577;7
2020-11-09;TW;Taiwan;1;0;578;7
2020-11-10;TW;Taiwan;2;0;580;7
2020-11-11;TW;Taiwan;4;0;584;7
2020-11-12;TW;Taiwan;5;0;589;7
2020-11-13;TW;Taiwan;8;0;597;7
2020-11-14;TW;Taiwan;3;0;600;7
2020-11-15;TW;Taiwan;2;0;602;7
2020-11-16;TW;Taiwan;1;0;603;7
2020-11-17;TW;Taiwan;2;0;605;7
2020-11-18;TW;Taiwan;2;0;607;7
2020-11-19;TW;Taiwan;2;0;609;7
2020-11-20;TW;Taiwan;2;0;611;7
2020-11-21;TW;Taiwan;0;0;611;7
2020-11-22;TW;Taiwan;6;0;617;7
2020-11-23;TW;Taiwan;1;0;618;7
2020-11-24;TW;Taiwan;0;0;618;7
2020-11-25;TW;Taiwan;5;0;623;7
2020-11-26;TW;Taiwan;2;0;625;7
2020-11-27;TW;Taiwan;14;0;639;7
2020-11-28;TW;Taiwan;9;0;648;7
2020-11-29;TW;Taiwan;3;0;651;7
2020-11-30;TW;Taiwan;24;0;675;7
2020-12-01;TW;Taiwan;4;0;679;7
2020-12-02;TW;Taiwan;6;0;685;7
2020-12-03;TW;Taiwan;1;0;686;7
2020-12-04;TW;Taiwan;4;0;690;7
2020-12-05;TW;Taiwan;4;0;694;7
2020-12-06;TW;Taiwan;22;0;716;7
2020-12-07;TW;Taiwan;0;0;716;7
2020-12-08;TW;Taiwan;2;0;718;7
2020-12-09;TW;Taiwan;2;0;720;7
2020-12-10;TW;Taiwan;4;0;724;7
2020-12-11;TW;Taiwan;1;0;725;7
2020-12-12;TW;Taiwan;8;0;733;7
2020-12-13;TW;Taiwan;3;0;736;7
2020-12-14;TW;Taiwan;4;0;740;7
2020-12-15;TW;Taiwan;2;0;742;7
2020-12-16;TW;Taiwan;7;0;749;7
2020-12-17;TW;Taiwan;8;0;757;7
2020-12-18;TW;Taiwan;2;0;759;7
2020-12-19;TW;Taiwan;4;0;763;7
2020-12-20;TW;Taiwan;3;0;766;7
2020-12-21;TW;Taiwan;0;0;766;7
2020-12-22;TW;Taiwan;4;0;770;7
2020-12-23;TW;Taiwan;6;0;776;7
2020-12-24;TW;Taiwan;0;0;776;7
2020-12-25;TW;Taiwan;4;0;780;7
2020-12-26;TW;Taiwan;3;0;783;7
2020-12-27;TW;Taiwan;2;0;785;7
2020-12-28;TW;Taiwan;8;0;793;7
2020-12-29;TW;Taiwan;2;0;795;7
2020-12-30;TW;Taiwan;2;0;797;7
2020-12-31;TW;Taiwan;2;0;799;7
2021-01-01;TW;Taiwan;3;0;802;7
2021-01-02;TW;Taiwan;6;0;808;7
2021-01-03;TW;Taiwan;4;0;812;7
2021-01-04;TW;Taiwan;3;0;815;7
2021-01-05;TW;Taiwan;2;0;817;7
2021-01-06;TW;Taiwan;2;0;819;7
2021-01-07;TW;Taiwan;3;0;822;7
2021-01-08;TW;Taiwan;3;0;825;7
2021-01-09;TW;Taiwan;3;0;828;7
2021-01-10;TW;Taiwan;0;0;828;7
2021-01-11;TW;Taiwan;6;0;834;7
2021-01-12;TW;Taiwan;4;0;838;7
2021-01-13;TW;Taiwan;4;0;842;7
2021-01-14;TW;Taiwan;0;0;842;7
2021-01-15;TW;Taiwan;1;0;843;7
2021-01-16;TW;Taiwan;8;0;851;7
2021-01-17;TW;Taiwan;4;0;855;7
2021-01-18;TW;Taiwan;7;0;862;7
2021-01-19;TW;Taiwan;6;0;868;7
2021-01-20;TW;Taiwan;2;0;870;7
2021-01-21;TW;Taiwan;11;0;881;7
2021-01-22;TW;Taiwan;0;0;881;7
2021-01-23;TW;Taiwan;3;0;884;7
2021-01-24;TW;Taiwan;5;0;889;7
2021-01-25;TW;Taiwan;0;0;889;7
2021-01-26;TW;Taiwan;1;0;890;7
2021-01-27;TW;Taiwan;3;0;893;7
2021-01-28;TW;Taiwan;2;0;895;7
2021-01-29;TW;Taiwan;4;0;899;7
2021-01-30;TW;Taiwan;10;1;909;8
2021-01-31;TW;Taiwan;2;0;911;8
2021-02-01;TW;Taiwan;1;0;912;8
2021-02-02;TW;Taiwan;3;0;915;8
2021-02-03;TW;Taiwan;2;0;917;8
2021-02-04;TW;Taiwan;2;1;919;9
2021-02-05;TW;Taiwan;4;0;923;9
2021-02-06;TW;Taiwan;1;0;924;9
2021-02-07;TW;Taiwan;3;0;927;9
2021-02-08;TW;Taiwan;1;0;928;9
2021-02-09;TW;Taiwan;5;0;933;9
2021-02-10;TW;Taiwan;2;0;935;9
2021-02-11;TW;Taiwan;1;0;936;9
2021-02-12;TW;Taiwan;1;0;937;9
2021-02-13;TW;Taiwan;0;0;937;9
2021-02-14;TW;Taiwan;0;0;937;9
2021-02-15;TW;Taiwan;0;0;937;9
2021-02-16;TW;Taiwan;0;0;937;9
2021-02-17;TW;Taiwan;1;0;938;9
2021-02-18;TW;Taiwan;2;0;940;9
2021-02-19;TW;Taiwan;1;0;941;9
2021-02-20;TW;Taiwan;1;0;942;9
2021-02-21;TW;Taiwan;0;0;942;9
2021-02-22;TW;Taiwan;0;0;942;9
2021-02-23;TW;Taiwan;0;0;942;9
2021-02-24;TW;Taiwan;4;0;946;9
2021-02-25;TW;Taiwan;5;0;951;9
2021-02-26;TW;Taiwan;0;0;951;9
2021-02-27;TW;Taiwan;3;0;954;9
2021-02-28;TW;Taiwan;1;0;955;9
2021-03-01;TW;Taiwan;0;0;955;9
2021-03-02;TW;Taiwan;0;0;955;9
2021-03-03;TW;Taiwan;3;0;958;9
2021-03-04;TW;Taiwan;2;0;960;9
2021-03-05;TW;Taiwan;0;0;960;9
2021-03-06;TW;Taiwan;7;1;967;10
2021-03-07;TW;Taiwan;2;0;969;10
2021-03-08;TW;Taiwan;7;0;976;10
2021-03-09;TW;Taiwan;1;0;977;10
2021-03-10;TW;Taiwan;1;0;978;10
2021-03-11;TW;Taiwan;0;0;978;10
2021-03-12;TW;Taiwan;6;0;984;10
2021-03-13;TW;Taiwan;0;0;984;10
2021-03-14;TW;Taiwan;1;0;985;10
2021-03-15;TW;Taiwan;5;0;990;10
2021-03-16;TW;Taiwan;0;0;990;10
2021-03-17;TW;Taiwan;0;0;990;10
2021-03-18;TW;Taiwan;8;0;998;10
2021-03-19;TW;Taiwan;6;0;1004;10
2021-03-20;TW;Taiwan;1;0;1005;10
2021-03-21;TW;Taiwan;1;0;1006;10
2021-03-22;TW;Taiwan;0;0;1006;10
2021-03-23;TW;Taiwan;1;0;1007;10
2021-03-24;TW;Taiwan;2;0;1009;10
2021-03-25;TW;Taiwan;3;0;1012;10
2021-03-26;TW;Taiwan;1;0;1013;10
2021-03-27;TW;Taiwan;7;0;1020;10
2021-03-28;TW;Taiwan;2;0;1022;10
2021-03-29;TW;Taiwan;1;0;1023;10
2021-03-30;TW;Taiwan;1;0;1024;10
2021-03-31;TW;Taiwan;6;0;1030;10
2021-04-01;TW;Taiwan;6;0;1036;10
2021-04-02;TW;Taiwan;3;0;1039;10
2021-04-03;TW;Taiwan;6;0;1045;10
2021-04-04;TW;Taiwan;2;0;1047;10
2021-04-05;TW;Taiwan;1;0;1048;10
2021-04-06;TW;Taiwan;2;0;1050;10
2021-04-07;TW;Taiwan;0;0;1050;10
2021-04-08;TW;Taiwan;0;0;1050;10
2021-04-09;TW;Taiwan;4;0;1054;10
2021-04-10;TW;Taiwan;2;0;1056;10
2021-04-11;TW;Taiwan;1;1;1057;11
2021-04-12;TW;Taiwan;1;0;1058;11
2021-04-13;TW;Taiwan;4;0;1062;11
2021-04-14;TW;Taiwan;5;0;1067;11
2021-04-15;TW;Taiwan;1;0;1068;11
2021-04-16;TW;Taiwan;2;0;1070;11
2021-04-17;TW;Taiwan;2;0;1072;11
2021-04-18;TW;Taiwan;1;0;1073;11
2021-04-19;TW;Taiwan;3;0;1076;11
2021-04-20;TW;Taiwan;2;0;1078;11
2021-04-21;TW;Taiwan;4;0;1082;11
2021-04-22;TW;Taiwan;4;0;1086;11
2021-04-23;TW;Taiwan;4;0;1090;11
2021-04-24;TW;Taiwan;7;1;1097;12
2021-04-25;TW;Taiwan;3;0;1100;12
2021-04-26;TW;Taiwan;4;0;1104;12
2021-04-27;TW;Taiwan;6;0;1110;12
2021-04-28;TW;Taiwan;6;0;1116;12
2021-04-29;TW;Taiwan;5;0;1121;12
2021-04-30;TW;Taiwan;7;0;1128;12
2021-05-01;TW;Taiwan;4;0;1132;12
2021-05-02;TW;Taiwan;5;0;1137;12
2021-05-03;TW;Taiwan;8;0;1145;12
2021-05-04;TW;Taiwan;8;0;1153;12
2021-05-05;TW;Taiwan;7;0;1160;12
2021-05-06;TW;Taiwan;13;0;1173;12
2021-05-07;TW;Taiwan;5;0;1178;12
2021-05-08;TW;Taiwan;5;0;1183;12
2021-05-09;TW;Taiwan;1;0;1184;12
2021-05-10;TW;Taiwan;15;0;1199;12
2021-05-11;TW;Taiwan;11;0;1210;12
2021-05-12;TW;Taiwan;21;0;1231;12
2021-05-13;TW;Taiwan;25;0;1256;12
2021-05-14;TW;Taiwan;34;0;1290;12
2021-05-15;TW;Taiwan;185;0;1475;12
2021-05-16;TW;Taiwan;207;0;1682;12
2021-05-17;TW;Taiwan;335;0;2017;12
2021-05-18;TW;Taiwan;243;2;2260;14
2021-05-19;TW;Taiwan;273;0;2533;14
2021-05-20;TW;Taiwan;292;1;2825;15
2021-05-21;TW;Taiwan;314;0;3139;15
2021-05-22;TW;Taiwan;723;2;3862;17
2021-05-23;TW;Taiwan;460;6;4322;23
2021-05-24;TW;Taiwan;595;6;4917;29
2021-05-25;TW;Taiwan;539;6;5456;35
2021-05-26;TW;Taiwan;635;11;6091;46
2021-05-27;TW;Taiwan;670;13;6761;59
2021-05-28;TW;Taiwan;554;19;7315;78
2021-05-29;TW;Taiwan;491;21;7806;99
2021-05-30;TW;Taiwan;354;10;8160;109
2021-05-31;TW;Taiwan;351;15;8511;124
2021-06-01;TW;Taiwan;331;13;8842;137
2021-06-02;TW;Taiwan;547;12;9389;149
2021-06-03;TW;Taiwan;585;17;9974;166
2021-06-04;TW;Taiwan;472;21;10446;187
2021-06-05;TW;Taiwan;510;37;10956;224
2021-06-06;TW;Taiwan;342;36;11298;260
2021-06-07;TW;Taiwan;193;26;11491;286
2021-06-08;TW;Taiwan;203;22;11694;308
2021-06-09;TW;Taiwan;274;25;11968;333
2021-06-10;TW;Taiwan;254;28;12222;361
2021-06-11;TW;Taiwan;278;24;12500;385
2021-06-12;TW;Taiwan;246;26;12746;411
2021-06-13;TW;Taiwan;175;26;12921;437
2021-06-14;TW;Taiwan;185;15;13106;452
2021-06-15;TW;Taiwan;135;8;13241;460
2021-06-16;TW;Taiwan;168;18;13409;478
2021-06-17;TW;Taiwan;175;19;13584;497
2021-06-18;TW;Taiwan;187;21;13771;518
2021-06-19;TW;Taiwan;125;20;13896;538
2021-06-20;TW;Taiwan;109;11;14005;549
2021-06-21;TW;Taiwan;75;20;14080;569
2021-06-22;TW;Taiwan;77;6;14157;575
2021-06-23;TW;Taiwan;103;24;14260;599
2021-06-24;TW;Taiwan;129;6;14389;605
2021-06-25;TW;Taiwan;76;5;14465;610
2021-06-26;TW;Taiwan;80;13;14545;623
2021-06-27;TW;Taiwan;89;9;14634;632
2021-06-28;TW;Taiwan;60;3;14694;635
2021-06-29;TW;Taiwan;54;8;14748;643
2021-06-30;TW;Taiwan;56;5;14804;648
2021-07-01;TW;Taiwan;49;13;14853;661
2020-04-30;TJ;Tajikistan;15;0;15;0
2020-05-01;TJ;Tajikistan;0;0;15;0
2020-05-02;TJ;Tajikistan;61;2;76;2
2020-05-03;TJ;Tajikistan;52;0;128;2
2020-05-04;TJ;Tajikistan;102;1;230;3
2020-05-05;TJ;Tajikistan;63;2;293;5
2020-05-06;TJ;Tajikistan;86;3;379;8
2020-05-07;TJ;Tajikistan;82;4;461;12
2020-05-08;TJ;Tajikistan;61;0;522;12
2020-05-09;TJ;Tajikistan;90;8;612;20
2020-05-10;TJ;Tajikistan;0;0;612;20
2020-05-11;TJ;Tajikistan;49;1;661;21
2020-05-12;TJ;Tajikistan;68;0;729;21
2020-05-13;TJ;Tajikistan;72;2;801;23
2020-05-14;TJ;Tajikistan;106;6;907;29
2020-05-15;TJ;Tajikistan;211;4;1118;33
2020-05-16;TJ;Tajikistan;204;3;1322;36
2020-05-17;TJ;Tajikistan;202;3;1524;39
2020-05-18;TJ;Tajikistan;205;2;1729;41
2020-05-19;TJ;Tajikistan;207;0;1936;41
2020-05-20;TJ;Tajikistan;204;0;2140;41
2020-05-21;TJ;Tajikistan;210;3;2350;44
2020-05-22;TJ;Tajikistan;201;0;2551;44
2020-05-23;TJ;Tajikistan;187;0;2738;44
2020-05-24;TJ;Tajikistan;191;2;2929;46
2020-05-25;TJ;Tajikistan;171;0;3100;46
2020-05-26;TJ;Tajikistan;166;1;3266;47
2020-05-27;TJ;Tajikistan;158;0;3424;47
2020-05-28;TJ;Tajikistan;139;0;3563;47
2020-05-29;TJ;Tajikistan;123;0;3686;47
2020-05-30;TJ;Tajikistan;121;0;3807;47
2020-05-31;TJ;Tajikistan;123;0;3930;47
2020-06-01;TJ;Tajikistan;83;0;4013;47
2020-06-02;TJ;Tajikistan;87;0;4100;47
2020-06-03;TJ;Tajikistan;91;1;4191;48
2020-06-04;TJ;Tajikistan;98;0;4289;48
2020-06-05;TJ;Tajikistan;81;0;4370;48
2020-06-06;TJ;Tajikistan;83;0;4453;48
2020-06-07;TJ;Tajikistan;76;0;4529;48
2020-06-08;TJ;Tajikistan;80;0;4609;48
2020-06-09;TJ;Tajikistan;81;0;4690;48
2020-06-10;TJ;Tajikistan;73;0;4763;48
2020-06-11;TJ;Tajikistan;71;1;4834;49
2020-06-12;TJ;Tajikistan;68;0;4902;49
2020-06-13;TJ;Tajikistan;69;1;4971;50
2020-06-14;TJ;Tajikistan;64;0;5035;50
2020-06-15;TJ;Tajikistan;62;0;5097;50
2020-06-16;TJ;Tajikistan;63;0;5160;50
2020-06-17;TJ;Tajikistan;61;1;5221;51
2020-06-18;TJ;Tajikistan;58;0;5279;51
2020-06-19;TJ;Tajikistan;59;0;5338;51
2020-06-20;TJ;Tajikistan;61;1;5399;52
2020-06-21;TJ;Tajikistan;58;0;5457;52
2020-06-22;TJ;Tajikistan;56;0;5513;52
2020-06-23;TJ;Tajikistan;54;0;5567;52
2020-06-24;TJ;Tajikistan;63;0;5630;52
2020-06-25;TJ;Tajikistan;61;0;5691;52
2020-06-26;TJ;Tajikistan;56;0;5747;52
2020-06-27;TJ;Tajikistan;52;0;5799;52
2020-06-28;TJ;Tajikistan;50;0;5849;52
2020-06-29;TJ;Tajikistan;51;0;5900;52
2020-06-30;TJ;Tajikistan;0;0;5900;52
2020-07-01;TJ;Tajikistan;105;0;6005;52
2020-07-02;TJ;Tajikistan;53;0;6058;52
2020-07-03;TJ;Tajikistan;0;0;6058;52
2020-07-04;TJ;Tajikistan;101;0;6159;52
2020-07-05;TJ;Tajikistan;54;1;6213;53
2020-07-06;TJ;Tajikistan;49;0;6262;53
2020-07-07;TJ;Tajikistan;53;0;6315;53
2020-07-08;TJ;Tajikistan;49;1;6364;54
2020-07-09;TJ;Tajikistan;46;0;6410;54
2020-07-10;TJ;Tajikistan;47;1;6457;55
2020-07-11;TJ;Tajikistan;49;0;6506;55
2020-07-12;TJ;Tajikistan;46;0;6552;55
2020-07-13;TJ;Tajikistan;44;0;6596;55
2020-07-14;TJ;Tajikistan;47;1;6643;56
2020-07-15;TJ;Tajikistan;52;0;6695;56
2020-07-16;TJ;Tajikistan;46;0;6741;56
2020-07-17;TJ;Tajikistan;45;0;6786;56
2020-07-18;TJ;Tajikistan;48;1;6834;57
2020-07-19;TJ;Tajikistan;44;0;6878;57
2020-07-20;TJ;Tajikistan;43;0;6921;57
2020-07-21;TJ;Tajikistan;46;0;6967;57
2020-07-22;TJ;Tajikistan;48;1;7015;58
2020-07-23;TJ;Tajikistan;45;0;7060;58
2020-07-24;TJ;Tajikistan;44;0;7104;58
2020-07-25;TJ;Tajikistan;46;1;7150;59
2020-07-26;TJ;Tajikistan;42;0;7192;59
2020-07-27;TJ;Tajikistan;43;1;7235;60
2020-07-28;TJ;Tajikistan;41;0;7276;60
2020-07-29;TJ;Tajikistan;44;0;7320;60
2020-07-30;TJ;Tajikistan;46;0;7366;60
2020-07-31;TJ;Tajikistan;43;0;7409;60
2020-08-01;TJ;Tajikistan;42;0;7451;60
2020-08-02;TJ;Tajikistan;44;1;7495;61
2020-08-03;TJ;Tajikistan;43;0;7538;61
2020-08-04;TJ;Tajikistan;45;0;7583;61
2020-08-05;TJ;Tajikistan;42;0;7625;61
2020-08-06;TJ;Tajikistan;40;1;7665;62
2020-08-07;TJ;Tajikistan;41;0;7706;62
2020-08-08;TJ;Tajikistan;0;0;7706;62
2020-08-09;TJ;Tajikistan;39;0;7745;62
2020-08-10;TJ;Tajikistan;82;0;7827;62
2020-08-11;TJ;Tajikistan;44;1;7871;63
2020-08-12;TJ;Tajikistan;41;0;7912;63
2020-08-13;TJ;Tajikistan;38;0;7950;63
2020-08-14;TJ;Tajikistan;39;0;7989;63
2020-08-15;TJ;Tajikistan;40;1;8029;64
2020-08-16;TJ;Tajikistan;36;0;8065;64
2020-08-17;TJ;Tajikistan;34;0;8099;64
2020-08-18;TJ;Tajikistan;32;1;8131;65
2020-08-19;TJ;Tajikistan;35;0;8166;65
2020-08-20;TJ;Tajikistan;37;1;8203;66
2020-08-21;TJ;Tajikistan;38;0;8241;66
2020-08-22;TJ;Tajikistan;36;0;8277;66
2020-08-23;TJ;Tajikistan;34;0;8311;66
2020-08-24;TJ;Tajikistan;35;1;8346;67
2020-08-25;TJ;Tajikistan;33;0;8379;67
2020-08-26;TJ;Tajikistan;34;0;8413;67
2020-08-27;TJ;Tajikistan;36;1;8449;68
2020-08-28;TJ;Tajikistan;32;0;8481;68
2020-08-29;TJ;Tajikistan;35;0;8516;68
2020-08-30;TJ;Tajikistan;0;0;8516;68
2020-08-31;TJ;Tajikistan;67;0;8583;68
2020-09-01;TJ;Tajikistan;36;0;8619;68
2020-09-02;TJ;Tajikistan;35;1;8654;69
2020-09-03;TJ;Tajikistan;36;0;8690;69
2020-09-04;TJ;Tajikistan;34;0;8724;69
2020-09-05;TJ;Tajikistan;33;1;8757;70
2020-09-06;TJ;Tajikistan;35;0;8792;70
2020-09-07;TJ;Tajikistan;32;0;8824;70
2020-09-08;TJ;Tajikistan;36;0;8860;70
2020-09-09;TJ;Tajikistan;39;1;8899;71
2020-09-10;TJ;Tajikistan;40;1;8939;72
2020-09-11;TJ;Tajikistan;38;0;8977;72
2020-09-12;TJ;Tajikistan;37;0;9014;72
2020-09-13;TJ;Tajikistan;35;0;9049;72
2020-09-14;TJ;Tajikistan;39;0;9088;72
2020-09-15;TJ;Tajikistan;41;1;9129;73
2020-09-16;TJ;Tajikistan;42;0;9171;73
2020-09-17;TJ;Tajikistan;43;0;9214;73
2020-09-18;TJ;Tajikistan;45;0;9259;73
2020-09-19;TJ;Tajikistan;44;0;9303;73
2020-09-20;TJ;Tajikistan;43;0;9346;73
2020-09-21;TJ;Tajikistan;42;0;9388;73
2020-09-22;TJ;Tajikistan;44;0;9432;73
2020-09-23;TJ;Tajikistan;43;1;9475;74
2020-09-24;TJ;Tajikistan;45;0;9520;74
2020-09-25;TJ;Tajikistan;42;0;9562;74
2020-09-26;TJ;Tajikistan;43;1;9605;75
2020-09-27;TJ;Tajikistan;41;0;9646;75
2020-09-28;TJ;Tajikistan;39;0;9685;75
2020-09-29;TJ;Tajikistan;41;0;9726;75
2020-09-30;TJ;Tajikistan;43;1;9769;76
2020-10-01;TJ;Tajikistan;42;1;9811;77
2020-10-02;TJ;Tajikistan;41;0;9852;77
2020-10-03;TJ;Tajikistan;43;0;9895;77
2020-10-04;TJ;Tajikistan;40;1;9935;78
2020-10-05;TJ;Tajikistan;39;0;9974;78
2020-10-06;TJ;Tajikistan;40;0;10014;78
2020-10-07;TJ;Tajikistan;41;0;10055;78
2020-10-08;TJ;Tajikistan;42;0;10097;78
2020-10-09;TJ;Tajikistan;40;1;10137;79
2020-10-10;TJ;Tajikistan;43;0;10180;79
2020-10-11;TJ;Tajikistan;42;0;10222;79
2020-10-12;TJ;Tajikistan;38;0;10260;79
2020-10-13;TJ;Tajikistan;37;0;10297;79
2020-10-14;TJ;Tajikistan;39;0;10336;79
2020-10-15;TJ;Tajikistan;38;1;10374;80
2020-10-16;TJ;Tajikistan;40;0;10414;80
2020-10-17;TJ;Tajikistan;41;0;10455;80
2020-10-18;TJ;Tajikistan;38;0;10493;80
2020-10-19;TJ;Tajikistan;40;0;10533;80
2020-10-20;TJ;Tajikistan;41;0;10574;80
2020-10-21;TJ;Tajikistan;39;0;10613;80
2020-10-22;TJ;Tajikistan;40;1;10653;81
2020-10-23;TJ;Tajikistan;42;0;10695;81
2020-10-24;TJ;Tajikistan;41;0;10736;81
2020-10-25;TJ;Tajikistan;40;0;10776;81
2020-10-26;TJ;Tajikistan;43;0;10819;81
2020-10-27;TJ;Tajikistan;41;0;10860;81
2020-10-28;TJ;Tajikistan;40;1;10900;82
2020-10-29;TJ;Tajikistan;39;0;10939;82
2020-10-30;TJ;Tajikistan;38;0;10977;82
2020-10-31;TJ;Tajikistan;40;0;11017;82
2020-11-01;TJ;Tajikistan;37;0;11054;82
2020-11-02;TJ;Tajikistan;42;0;11096;82
2020-11-03;TJ;Tajikistan;43;1;11139;83
2020-11-04;TJ;Tajikistan;41;0;11180;83
2020-11-05;TJ;Tajikistan;39;0;11219;83
2020-11-06;TJ;Tajikistan;37;0;11256;83
2020-11-07;TJ;Tajikistan;38;0;11294;83
2020-11-08;TJ;Tajikistan;42;0;11336;83
2020-11-09;TJ;Tajikistan;40;0;11376;83
2020-11-10;TJ;Tajikistan;41;1;11417;84
2020-11-11;TJ;Tajikistan;39;0;11456;84
2020-11-12;TJ;Tajikistan;40;0;11496;84
2020-11-13;TJ;Tajikistan;38;1;11534;85
2020-11-14;TJ;Tajikistan;39;0;11573;85
2020-11-15;TJ;Tajikistan;37;0;11610;85
2020-11-16;TJ;Tajikistan;39;0;11649;85
2020-11-17;TJ;Tajikistan;40;0;11689;85
2020-11-18;TJ;Tajikistan;42;1;11731;86
2020-11-19;TJ;Tajikistan;41;0;11772;86
2020-11-20;TJ;Tajikistan;43;0;11815;86
2020-11-21;TJ;Tajikistan;39;0;11854;86
2020-11-22;TJ;Tajikistan;40;0;11894;86
2020-11-23;TJ;Tajikistan;38;0;11932;86
2020-11-24;TJ;Tajikistan;39;0;11971;86
2020-11-25;TJ;Tajikistan;37;0;12008;86
2020-11-26;TJ;Tajikistan;36;0;12044;86
2020-11-27;TJ;Tajikistan;38;0;12082;86
2020-11-28;TJ;Tajikistan;36;0;12118;86
2020-11-29;TJ;Tajikistan;37;0;12155;86
2020-11-30;TJ;Tajikistan;39;0;12194;86
2020-12-01;TJ;Tajikistan;37;0;12231;86
2020-12-02;TJ;Tajikistan;38;1;12269;87
2020-12-03;TJ;Tajikistan;39;0;12308;87
2020-12-04;TJ;Tajikistan;41;0;12349;87
2020-12-05;TJ;Tajikistan;40;0;12389;87
2020-12-06;TJ;Tajikistan;39;0;12428;87
2020-12-07;TJ;Tajikistan;41;0;12469;87
2020-12-08;TJ;Tajikistan;42;1;12511;88
2020-12-09;TJ;Tajikistan;40;0;12551;88
2020-12-10;TJ;Tajikistan;37;0;12588;88
2020-12-11;TJ;Tajikistan;0;0;12588;88
2020-12-12;TJ;Tajikistan;36;1;12624;89
2020-12-13;TJ;Tajikistan;80;-1;12704;88
2020-12-14;TJ;Tajikistan;37;0;12741;88
2020-12-15;TJ;Tajikistan;36;0;12777;88
2020-12-16;TJ;Tajikistan;38;1;12815;89
2020-12-17;TJ;Tajikistan;37;0;12852;89
2020-12-18;TJ;Tajikistan;36;0;12888;89
2020-12-19;TJ;Tajikistan;35;0;12923;89
2020-12-20;TJ;Tajikistan;37;0;12960;89
2020-12-21;TJ;Tajikistan;38;0;12998;89
2020-12-22;TJ;Tajikistan;36;0;13034;89
2020-12-23;TJ;Tajikistan;37;0;13071;89
2020-12-24;TJ;Tajikistan;35;0;13106;89
2020-12-25;TJ;Tajikistan;32;0;13138;89
2020-12-26;TJ;Tajikistan;34;1;13172;90
2020-12-27;TJ;Tajikistan;33;0;13205;90
2020-12-28;TJ;Tajikistan;32;0;13237;90
2020-12-29;TJ;Tajikistan;28;0;13265;90
2020-12-30;TJ;Tajikistan;31;0;13296;90
2020-12-31;TJ;Tajikistan;0;0;13296;90
2021-01-01;TJ;Tajikistan;0;0;13296;90
2021-01-02;TJ;Tajikistan;4;0;13300;90
2021-01-03;TJ;Tajikistan;0;0;13300;90
2021-01-04;TJ;Tajikistan;0;0;13300;90
2021-01-05;TJ;Tajikistan;5;0;13305;90
2021-01-06;TJ;Tajikistan;0;0;13305;90
2021-01-07;TJ;Tajikistan;0;0;13305;90
2021-01-08;TJ;Tajikistan;0;0;13305;90
2021-01-09;TJ;Tajikistan;0;0;13305;90
2021-01-10;TJ;Tajikistan;3;0;13308;90
2021-01-11;TJ;Tajikistan;0;0;13308;90
2021-01-12;TJ;Tajikistan;0;0;13308;90
2021-01-13;TJ;Tajikistan;0;0;13308;90
2021-01-14;TJ;Tajikistan;0;0;13308;90
2021-01-15;TJ;Tajikistan;0;0;13308;90
2021-01-16;TJ;Tajikistan;0;0;13308;90
2021-01-17;TJ;Tajikistan;0;0;13308;90
2021-01-18;TJ;Tajikistan;0;0;13308;90
2021-01-19;TJ;Tajikistan;0;0;13308;90
2021-01-20;TJ;Tajikistan;0;0;13308;90
2021-01-21;TJ;Tajikistan;0;0;13308;90
2021-01-22;TJ;Tajikistan;0;0;13308;90
2021-01-23;TJ;Tajikistan;0;0;13308;90
2021-01-24;TJ;Tajikistan;0;0;13308;90
2021-01-25;TJ;Tajikistan;0;0;13308;90
2021-01-26;TJ;Tajikistan;0;0;13308;90
2021-01-27;TJ;Tajikistan;0;0;13308;90
2021-01-28;TJ;Tajikistan;0;0;13308;90
2021-01-29;TJ;Tajikistan;0;0;13308;90
2021-01-30;TJ;Tajikistan;0;0;13308;90
2021-01-31;TJ;Tajikistan;0;0;13308;90
2021-02-01;TJ;Tajikistan;0;0;13308;90
2021-02-02;TJ;Tajikistan;0;0;13308;90
2021-02-03;TJ;Tajikistan;0;0;13308;90
2021-02-04;TJ;Tajikistan;0;0;13308;90
2021-02-05;TJ;Tajikistan;0;0;13308;90
2021-02-06;TJ;Tajikistan;0;0;13308;90
2021-02-07;TJ;Tajikistan;0;0;13308;90
2021-02-08;TJ;Tajikistan;0;0;13308;90
2021-02-09;TJ;Tajikistan;0;0;13308;90
2021-02-10;TJ;Tajikistan;0;0;13308;90
2021-02-11;TJ;Tajikistan;0;0;13308;90
2021-02-12;TJ;Tajikistan;0;0;13308;90
2021-02-13;TJ;Tajikistan;0;0;13308;90
2021-02-14;TJ;Tajikistan;0;0;13308;90
2021-02-15;TJ;Tajikistan;0;0;13308;90
2021-02-16;TJ;Tajikistan;0;0;13308;90
2021-02-17;TJ;Tajikistan;0;0;13308;90
2021-02-18;TJ;Tajikistan;0;0;13308;90
2021-02-19;TJ;Tajikistan;0;0;13308;90
2021-02-20;TJ;Tajikistan;0;0;13308;90
2021-02-21;TJ;Tajikistan;0;0;13308;90
2021-02-22;TJ;Tajikistan;0;0;13308;90
2021-02-23;TJ;Tajikistan;0;0;13308;90
2021-02-24;TJ;Tajikistan;0;0;13308;90
2021-02-25;TJ;Tajikistan;0;0;13308;90
2021-02-26;TJ;Tajikistan;0;0;13308;90
2021-02-27;TJ;Tajikistan;0;0;13308;90
2021-02-28;TJ;Tajikistan;0;0;13308;90
2021-03-01;TJ;Tajikistan;0;0;13308;90
2021-03-02;TJ;Tajikistan;0;0;13308;90
2021-03-03;TJ;Tajikistan;0;0;13308;90
2021-03-04;TJ;Tajikistan;0;0;13308;90
2021-03-05;TJ;Tajikistan;0;0;13308;90
2021-03-06;TJ;Tajikistan;0;0;13308;90
2021-03-07;TJ;Tajikistan;0;0;13308;90
2021-03-08;TJ;Tajikistan;0;0;13308;90
2021-03-09;TJ;Tajikistan;0;0;13308;90
2021-03-10;TJ;Tajikistan;0;0;13308;90
2021-03-11;TJ;Tajikistan;0;0;13308;90
2021-03-12;TJ;Tajikistan;0;0;13308;90
2021-03-13;TJ;Tajikistan;0;0;13308;90
2021-03-14;TJ;Tajikistan;0;0;13308;90
2021-03-15;TJ;Tajikistan;0;0;13308;90
2021-03-16;TJ;Tajikistan;0;0;13308;90
2021-03-17;TJ;Tajikistan;0;0;13308;90
2021-03-18;TJ;Tajikistan;0;0;13308;90
2021-03-19;TJ;Tajikistan;0;0;13308;90
2021-03-20;TJ;Tajikistan;0;0;13308;90
2021-03-21;TJ;Tajikistan;0;0;13308;90
2021-03-22;TJ;Tajikistan;0;0;13308;90
2021-03-23;TJ;Tajikistan;0;0;13308;90
2021-03-24;TJ;Tajikistan;0;0;13308;90
2021-03-25;TJ;Tajikistan;0;0;13308;90
2021-03-26;TJ;Tajikistan;0;0;13308;90
2021-03-27;TJ;Tajikistan;0;0;13308;90
2021-03-28;TJ;Tajikistan;0;0;13308;90
2021-03-29;TJ;Tajikistan;0;0;13308;90
2021-03-30;TJ;Tajikistan;0;0;13308;90
2021-03-31;TJ;Tajikistan;0;0;13308;90
2021-04-01;TJ;Tajikistan;0;0;13308;90
2021-04-02;TJ;Tajikistan;0;0;13308;90
2021-04-03;TJ;Tajikistan;0;0;13308;90
2021-04-04;TJ;Tajikistan;0;0;13308;90
2021-04-05;TJ;Tajikistan;0;0;13308;90
2021-04-06;TJ;Tajikistan;0;0;13308;90
2021-04-07;TJ;Tajikistan;0;0;13308;90
2021-04-08;TJ;Tajikistan;0;0;13308;90
2021-04-09;TJ;Tajikistan;0;0;13308;90
2021-04-10;TJ;Tajikistan;0;0;13308;90
2021-04-11;TJ;Tajikistan;0;0;13308;90
2021-04-12;TJ;Tajikistan;0;0;13308;90
2021-04-13;TJ;Tajikistan;0;0;13308;90
2021-04-14;TJ;Tajikistan;0;0;13308;90
2021-04-15;TJ;Tajikistan;0;0;13308;90
2021-04-16;TJ;Tajikistan;0;0;13308;90
2021-04-17;TJ;Tajikistan;0;0;13308;90
2021-04-18;TJ;Tajikistan;0;0;13308;90
2021-04-19;TJ;Tajikistan;0;0;13308;90
2021-04-20;TJ;Tajikistan;0;0;13308;90
2021-04-21;TJ;Tajikistan;0;0;13308;90
2021-04-22;TJ;Tajikistan;0;0;13308;90
2021-04-23;TJ;Tajikistan;0;0;13308;90
2021-04-24;TJ;Tajikistan;0;0;13308;90
2021-04-25;TJ;Tajikistan;0;0;13308;90
2021-04-26;TJ;Tajikistan;0;0;13308;90
2021-04-27;TJ;Tajikistan;0;0;13308;90
2021-04-28;TJ;Tajikistan;0;0;13308;90
2021-04-29;TJ;Tajikistan;0;0;13308;90
2021-04-30;TJ;Tajikistan;0;0;13308;90
2021-05-01;TJ;Tajikistan;0;0;13308;90
2021-05-02;TJ;Tajikistan;0;0;13308;90
2021-05-03;TJ;Tajikistan;0;0;13308;90
2021-05-04;TJ;Tajikistan;0;0;13308;90
2021-05-05;TJ;Tajikistan;0;0;13308;90
2021-05-06;TJ;Tajikistan;0;0;13308;90
2021-05-07;TJ;Tajikistan;0;0;13308;90
2021-05-08;TJ;Tajikistan;0;0;13308;90
2021-05-09;TJ;Tajikistan;0;0;13308;90
2021-05-10;TJ;Tajikistan;0;0;13308;90
2021-05-11;TJ;Tajikistan;0;0;13308;90
2021-05-12;TJ;Tajikistan;0;0;13308;90
2021-05-13;TJ;Tajikistan;0;0;13308;90
2021-05-14;TJ;Tajikistan;0;0;13308;90
2021-05-15;TJ;Tajikistan;0;0;13308;90
2021-05-16;TJ;Tajikistan;0;0;13308;90
2021-05-17;TJ;Tajikistan;0;0;13308;90
2021-05-18;TJ;Tajikistan;0;0;13308;90
2021-05-19;TJ;Tajikistan;0;0;13308;90
2021-05-20;TJ;Tajikistan;0;0;13308;90
2021-05-21;TJ;Tajikistan;0;0;13308;90
2021-05-22;TJ;Tajikistan;0;0;13308;90
2021-05-23;TJ;Tajikistan;0;0;13308;90
2021-05-24;TJ;Tajikistan;0;0;13308;90
2021-05-25;TJ;Tajikistan;0;0;13308;90
2021-05-26;TJ;Tajikistan;0;0;13308;90
2021-05-27;TJ;Tajikistan;0;0;13308;90
2021-05-28;TJ;Tajikistan;0;0;13308;90
2021-05-29;TJ;Tajikistan;0;0;13308;90
2021-05-30;TJ;Tajikistan;0;0;13308;90
2021-05-31;TJ;Tajikistan;0;0;13308;90
2021-06-01;TJ;Tajikistan;0;0;13308;90
2021-06-02;TJ;Tajikistan;0;0;13308;90
2021-06-03;TJ;Tajikistan;0;0;13308;90
2021-06-04;TJ;Tajikistan;0;0;13308;90
2021-06-05;TJ;Tajikistan;0;0;13308;90
2021-06-06;TJ;Tajikistan;0;0;13308;90
2021-06-07;TJ;Tajikistan;0;0;13308;90
2021-06-08;TJ;Tajikistan;0;0;13308;90
2021-06-09;TJ;Tajikistan;0;0;13308;90
2021-06-10;TJ;Tajikistan;0;0;13308;90
2021-06-11;TJ;Tajikistan;0;0;13308;90
2021-06-12;TJ;Tajikistan;0;0;13308;90
2021-06-13;TJ;Tajikistan;0;0;13308;90
2021-06-14;TJ;Tajikistan;0;0;13308;90
2021-06-15;TJ;Tajikistan;0;0;13308;90
2021-06-16;TJ;Tajikistan;0;0;13308;90
2021-06-17;TJ;Tajikistan;0;0;13308;90
2021-06-18;TJ;Tajikistan;0;0;13308;90
2021-06-19;TJ;Tajikistan;0;0;13308;90
2021-06-20;TJ;Tajikistan;0;0;13308;90
2021-06-21;TJ;Tajikistan;0;0;13308;90
2021-06-22;TJ;Tajikistan;0;0;13308;90
2021-06-23;TJ;Tajikistan;50;0;13358;90
2021-06-24;TJ;Tajikistan;0;0;13358;90
2021-06-25;TJ;Tajikistan;34;0;13392;90
2021-06-26;TJ;Tajikistan;23;0;13415;90
2021-06-27;TJ;Tajikistan;24;0;13439;90
2021-06-28;TJ;Tajikistan;21;0;13460;90
2021-06-29;TJ;Tajikistan;18;0;13478;90
2021-06-30;TJ;Tajikistan;21;0;13499;90
2021-07-01;TJ;Tajikistan;24;0;13523;90
2020-03-16;TZ;Tanzania;1;0;1;0
2020-03-17;TZ;Tanzania;0;0;1;0
2020-03-18;TZ;Tanzania;2;0;3;0
2020-03-19;TZ;Tanzania;3;0;6;0
2020-03-20;TZ;Tanzania;0;0;6;0
2020-03-21;TZ;Tanzania;0;0;6;0
2020-03-22;TZ;Tanzania;6;0;12;0
2020-03-23;TZ;Tanzania;0;0;12;0
2020-03-24;TZ;Tanzania;0;0;12;0
2020-03-25;TZ;Tanzania;0;0;12;0
2020-03-26;TZ;Tanzania;1;0;13;0
2020-03-27;TZ;Tanzania;0;0;13;0
2020-03-28;TZ;Tanzania;1;0;14;0
2020-03-29;TZ;Tanzania;0;0;14;0
2020-03-30;TZ;Tanzania;5;0;19;0
2020-03-31;TZ;Tanzania;0;1;19;1
2020-04-01;TZ;Tanzania;1;0;20;1
2020-04-02;TZ;Tanzania;0;0;20;1
2020-04-03;TZ;Tanzania;0;0;20;1
2020-04-04;TZ;Tanzania;0;0;20;1
2020-04-05;TZ;Tanzania;2;0;22;1
2020-04-06;TZ;Tanzania;2;0;24;1
2020-04-07;TZ;Tanzania;0;0;24;1
2020-04-08;TZ;Tanzania;1;0;25;1
2020-04-09;TZ;Tanzania;0;0;25;1
2020-04-10;TZ;Tanzania;7;2;32;3
2020-04-11;TZ;Tanzania;0;0;32;3
2020-04-12;TZ;Tanzania;0;0;32;3
2020-04-13;TZ;Tanzania;17;0;49;3
2020-04-14;TZ;Tanzania;4;0;53;3
2020-04-15;TZ;Tanzania;35;1;88;4
2020-04-16;TZ;Tanzania;6;0;94;4
2020-04-17;TZ;Tanzania;53;1;147;5
2020-04-18;TZ;Tanzania;0;0;147;5
2020-04-19;TZ;Tanzania;23;2;170;7
2020-04-20;TZ;Tanzania;84;3;254;10
2020-04-21;TZ;Tanzania;0;0;254;10
2020-04-22;TZ;Tanzania;30;0;284;10
2020-04-23;TZ;Tanzania;0;0;284;10
2020-04-24;TZ;Tanzania;15;0;299;10
2020-04-25;TZ;Tanzania;0;0;299;10
2020-04-26;TZ;Tanzania;0;0;299;10
2020-04-27;TZ;Tanzania;0;0;299;10
2020-04-28;TZ;Tanzania;0;0;299;10
2020-04-29;TZ;Tanzania;181;6;480;16
2020-04-30;TZ;Tanzania;0;0;480;16
2020-05-01;TZ;Tanzania;0;0;480;16
2020-05-02;TZ;Tanzania;0;0;480;16
2020-05-03;TZ;Tanzania;0;0;480;16
2020-05-04;TZ;Tanzania;0;0;480;16
2020-05-05;TZ;Tanzania;0;0;480;16
2020-05-06;TZ;Tanzania;0;0;480;16
2020-05-07;TZ;Tanzania;0;0;480;16
2020-05-08;TZ;Tanzania;29;5;509;21
2020-05-09;TZ;Tanzania;0;0;509;21
2020-05-10;TZ;Tanzania;0;0;509;21
2020-05-11;TZ;Tanzania;0;0;509;21
2020-05-12;TZ;Tanzania;0;0;509;21
2020-05-13;TZ;Tanzania;0;0;509;21
2020-05-14;TZ;Tanzania;0;0;509;21
2020-05-15;TZ;Tanzania;0;0;509;21
2020-05-16;TZ;Tanzania;0;0;509;21
2020-05-17;TZ;Tanzania;0;0;509;21
2020-05-18;TZ;Tanzania;0;0;509;21
2020-05-19;TZ;Tanzania;0;0;509;21
2020-05-20;TZ;Tanzania;0;0;509;21
2020-05-21;TZ;Tanzania;0;0;509;21
2020-05-22;TZ;Tanzania;0;0;509;21
2020-05-23;TZ;Tanzania;0;0;509;21
2020-05-24;TZ;Tanzania;0;0;509;21
2020-05-25;TZ;Tanzania;0;0;509;21
2020-05-26;TZ;Tanzania;0;0;509;21
2020-05-27;TZ;Tanzania;0;0;509;21
2020-05-28;TZ;Tanzania;0;0;509;21
2020-05-29;TZ;Tanzania;0;0;509;21
2020-05-30;TZ;Tanzania;0;0;509;21
2020-05-31;TZ;Tanzania;0;0;509;21
2020-06-01;TZ;Tanzania;0;0;509;21
2020-06-02;TZ;Tanzania;0;0;509;21
2020-06-03;TZ;Tanzania;0;0;509;21
2020-06-04;TZ;Tanzania;0;0;509;21
2020-06-05;TZ;Tanzania;0;0;509;21
2020-06-06;TZ;Tanzania;0;0;509;21
2020-06-07;TZ;Tanzania;0;0;509;21
2020-06-08;TZ;Tanzania;0;0;509;21
2020-06-09;TZ;Tanzania;0;0;509;21
2020-06-10;TZ;Tanzania;0;0;509;21
2020-06-11;TZ;Tanzania;0;0;509;21
2020-06-12;TZ;Tanzania;0;0;509;21
2020-06-13;TZ;Tanzania;0;0;509;21
2020-06-14;TZ;Tanzania;0;0;509;21
2020-06-15;TZ;Tanzania;0;0;509;21
2020-06-16;TZ;Tanzania;0;0;509;21
2020-06-17;TZ;Tanzania;0;0;509;21
2020-06-18;TZ;Tanzania;0;0;509;21
2020-06-19;TZ;Tanzania;0;0;509;21
2020-06-20;TZ;Tanzania;0;0;509;21
2020-06-21;TZ;Tanzania;0;0;509;21
2020-06-22;TZ;Tanzania;0;0;509;21
2020-06-23;TZ;Tanzania;0;0;509;21
2020-06-24;TZ;Tanzania;0;0;509;21
2020-06-25;TZ;Tanzania;0;0;509;21
2020-06-26;TZ;Tanzania;0;0;509;21
2020-06-27;TZ;Tanzania;0;0;509;21
2020-06-28;TZ;Tanzania;0;0;509;21
2020-06-29;TZ;Tanzania;0;0;509;21
2020-06-30;TZ;Tanzania;0;0;509;21
2020-07-01;TZ;Tanzania;0;0;509;21
2020-07-02;TZ;Tanzania;0;0;509;21
2020-07-03;TZ;Tanzania;0;0;509;21
2020-07-04;TZ;Tanzania;0;0;509;21
2020-07-05;TZ;Tanzania;0;0;509;21
2020-07-06;TZ;Tanzania;0;0;509;21
2020-07-07;TZ;Tanzania;0;0;509;21
2020-07-08;TZ;Tanzania;0;0;509;21
2020-07-09;TZ;Tanzania;0;0;509;21
2020-07-10;TZ;Tanzania;0;0;509;21
2020-07-11;TZ;Tanzania;0;0;509;21
2020-07-12;TZ;Tanzania;0;0;509;21
2020-07-13;TZ;Tanzania;0;0;509;21
2020-07-14;TZ;Tanzania;0;0;509;21
2020-07-15;TZ;Tanzania;0;0;509;21
2020-07-16;TZ;Tanzania;0;0;509;21
2020-07-17;TZ;Tanzania;0;0;509;21
2020-07-18;TZ;Tanzania;0;0;509;21
2020-07-19;TZ;Tanzania;0;0;509;21
2020-07-20;TZ;Tanzania;0;0;509;21
2020-07-21;TZ;Tanzania;0;0;509;21
2020-07-22;TZ;Tanzania;0;0;509;21
2020-07-23;TZ;Tanzania;0;0;509;21
2020-07-24;TZ;Tanzania;0;0;509;21
2020-07-25;TZ;Tanzania;0;0;509;21
2020-07-26;TZ;Tanzania;0;0;509;21
2020-07-27;TZ;Tanzania;0;0;509;21
2020-07-28;TZ;Tanzania;0;0;509;21
2020-07-29;TZ;Tanzania;0;0;509;21
2020-07-30;TZ;Tanzania;0;0;509;21
2020-07-31;TZ;Tanzania;0;0;509;21
2020-08-01;TZ;Tanzania;0;0;509;21
2020-08-02;TZ;Tanzania;0;0;509;21
2020-08-03;TZ;Tanzania;0;0;509;21
2020-08-04;TZ;Tanzania;0;0;509;21
2020-08-05;TZ;Tanzania;0;0;509;21
2020-08-06;TZ;Tanzania;0;0;509;21
2020-08-07;TZ;Tanzania;0;0;509;21
2020-08-08;TZ;Tanzania;0;0;509;21
2020-08-09;TZ;Tanzania;0;0;509;21
2020-08-10;TZ;Tanzania;0;0;509;21
2020-08-11;TZ;Tanzania;0;0;509;21
2020-08-12;TZ;Tanzania;0;0;509;21
2020-08-13;TZ;Tanzania;0;0;509;21
2020-08-14;TZ;Tanzania;0;0;509;21
2020-08-15;TZ;Tanzania;0;0;509;21
2020-08-16;TZ;Tanzania;0;0;509;21
2020-08-17;TZ;Tanzania;0;0;509;21
2020-08-18;TZ;Tanzania;0;0;509;21
2020-08-19;TZ;Tanzania;0;0;509;21
2020-08-20;TZ;Tanzania;0;0;509;21
2020-08-21;TZ;Tanzania;0;0;509;21
2020-08-22;TZ;Tanzania;0;0;509;21
2020-08-23;TZ;Tanzania;0;0;509;21
2020-08-24;TZ;Tanzania;0;0;509;21
2020-08-25;TZ;Tanzania;0;0;509;21
2020-08-26;TZ;Tanzania;0;0;509;21
2020-08-27;TZ;Tanzania;0;0;509;21
2020-08-28;TZ;Tanzania;0;0;509;21
2020-08-29;TZ;Tanzania;0;0;509;21
2020-08-30;TZ;Tanzania;0;0;509;21
2020-08-31;TZ;Tanzania;0;0;509;21
2020-09-01;TZ;Tanzania;0;0;509;21
2020-09-02;TZ;Tanzania;0;0;509;21
2020-09-03;TZ;Tanzania;0;0;509;21
2020-09-04;TZ;Tanzania;0;0;509;21
2020-09-05;TZ;Tanzania;0;0;509;21
2020-09-06;TZ;Tanzania;0;0;509;21
2020-09-07;TZ;Tanzania;0;0;509;21
2020-09-08;TZ;Tanzania;0;0;509;21
2020-09-09;TZ;Tanzania;0;0;509;21
2020-09-10;TZ;Tanzania;0;0;509;21
2020-09-11;TZ;Tanzania;0;0;509;21
2020-09-12;TZ;Tanzania;0;0;509;21
2020-09-13;TZ;Tanzania;0;0;509;21
2020-09-14;TZ;Tanzania;0;0;509;21
2020-09-15;TZ;Tanzania;0;0;509;21
2020-09-16;TZ;Tanzania;0;0;509;21
2020-09-17;TZ;Tanzania;0;0;509;21
2020-09-18;TZ;Tanzania;0;0;509;21
2020-09-19;TZ;Tanzania;0;0;509;21
2020-09-20;TZ;Tanzania;0;0;509;21
2020-09-21;TZ;Tanzania;0;0;509;21
2020-09-22;TZ;Tanzania;0;0;509;21
2020-09-23;TZ;Tanzania;0;0;509;21
2020-09-24;TZ;Tanzania;0;0;509;21
2020-09-25;TZ;Tanzania;0;0;509;21
2020-09-26;TZ;Tanzania;0;0;509;21
2020-09-27;TZ;Tanzania;0;0;509;21
2020-09-28;TZ;Tanzania;0;0;509;21
2020-09-29;TZ;Tanzania;0;0;509;21
2020-09-30;TZ;Tanzania;0;0;509;21
2020-10-01;TZ;Tanzania;0;0;509;21
2020-10-02;TZ;Tanzania;0;0;509;21
2020-10-03;TZ;Tanzania;0;0;509;21
2020-10-04;TZ;Tanzania;0;0;509;21
2020-10-05;TZ;Tanzania;0;0;509;21
2020-10-06;TZ;Tanzania;0;0;509;21
2020-10-07;TZ;Tanzania;0;0;509;21
2020-10-08;TZ;Tanzania;0;0;509;21
2020-10-09;TZ;Tanzania;0;0;509;21
2020-10-10;TZ;Tanzania;0;0;509;21
2020-10-11;TZ;Tanzania;0;0;509;21
2020-10-12;TZ;Tanzania;0;0;509;21
2020-10-13;TZ;Tanzania;0;0;509;21
2020-10-14;TZ;Tanzania;0;0;509;21
2020-10-15;TZ;Tanzania;0;0;509;21
2020-10-16;TZ;Tanzania;0;0;509;21
2020-10-17;TZ;Tanzania;0;0;509;21
2020-10-18;TZ;Tanzania;0;0;509;21
2020-10-19;TZ;Tanzania;0;0;509;21
2020-10-20;TZ;Tanzania;0;0;509;21
2020-10-21;TZ;Tanzania;0;0;509;21
2020-10-22;TZ;Tanzania;0;0;509;21
2020-10-23;TZ;Tanzania;0;0;509;21
2020-10-24;TZ;Tanzania;0;0;509;21
2020-10-25;TZ;Tanzania;0;0;509;21
2020-10-26;TZ;Tanzania;0;0;509;21
2020-10-27;TZ;Tanzania;0;0;509;21
2020-10-28;TZ;Tanzania;0;0;509;21
2020-10-29;TZ;Tanzania;0;0;509;21
2020-10-30;TZ;Tanzania;0;0;509;21
2020-10-31;TZ;Tanzania;0;0;509;21
2020-11-01;TZ;Tanzania;0;0;509;21
2020-11-02;TZ;Tanzania;0;0;509;21
2020-11-03;TZ;Tanzania;0;0;509;21
2020-11-04;TZ;Tanzania;0;0;509;21
2020-11-05;TZ;Tanzania;0;0;509;21
2020-11-06;TZ;Tanzania;0;0;509;21
2020-11-07;TZ;Tanzania;0;0;509;21
2020-11-08;TZ;Tanzania;0;0;509;21
2020-11-09;TZ;Tanzania;0;0;509;21
2020-11-10;TZ;Tanzania;0;0;509;21
2020-11-11;TZ;Tanzania;0;0;509;21
2020-11-12;TZ;Tanzania;0;0;509;21
2020-11-13;TZ;Tanzania;0;0;509;21
2020-11-14;TZ;Tanzania;0;0;509;21
2020-11-15;TZ;Tanzania;0;0;509;21
2020-11-16;TZ;Tanzania;0;0;509;21
2020-11-17;TZ;Tanzania;0;0;509;21
2020-11-18;TZ;Tanzania;0;0;509;21
2020-11-19;TZ;Tanzania;0;0;509;21
2020-11-20;TZ;Tanzania;0;0;509;21
2020-11-21;TZ;Tanzania;0;0;509;21
2020-11-22;TZ;Tanzania;0;0;509;21
2020-11-23;TZ;Tanzania;0;0;509;21
2020-11-24;TZ;Tanzania;0;0;509;21
2020-11-25;TZ;Tanzania;0;0;509;21
2020-11-26;TZ;Tanzania;0;0;509;21
2020-11-27;TZ;Tanzania;0;0;509;21
2020-11-28;TZ;Tanzania;0;0;509;21
2020-11-29;TZ;Tanzania;0;0;509;21
2020-11-30;TZ;Tanzania;0;0;509;21
2020-12-01;TZ;Tanzania;0;0;509;21
2020-12-02;TZ;Tanzania;0;0;509;21
2020-12-03;TZ;Tanzania;0;0;509;21
2020-12-04;TZ;Tanzania;0;0;509;21
2020-12-05;TZ;Tanzania;0;0;509;21
2020-12-06;TZ;Tanzania;0;0;509;21
2020-12-07;TZ;Tanzania;0;0;509;21
2020-12-08;TZ;Tanzania;0;0;509;21
2020-12-09;TZ;Tanzania;0;0;509;21
2020-12-10;TZ;Tanzania;0;0;509;21
2020-12-11;TZ;Tanzania;0;0;509;21
2020-12-12;TZ;Tanzania;0;0;509;21
2020-12-13;TZ;Tanzania;0;0;509;21
2020-12-14;TZ;Tanzania;0;0;509;21
2020-12-15;TZ;Tanzania;0;0;509;21
2020-12-16;TZ;Tanzania;0;0;509;21
2020-12-17;TZ;Tanzania;0;0;509;21
2020-12-18;TZ;Tanzania;0;0;509;21
2020-12-19;TZ;Tanzania;0;0;509;21
2020-12-20;TZ;Tanzania;0;0;509;21
2020-12-21;TZ;Tanzania;0;0;509;21
2020-12-22;TZ;Tanzania;0;0;509;21
2020-12-23;TZ;Tanzania;0;0;509;21
2020-12-24;TZ;Tanzania;0;0;509;21
2020-12-25;TZ;Tanzania;0;0;509;21
2020-12-26;TZ;Tanzania;0;0;509;21
2020-12-27;TZ;Tanzania;0;0;509;21
2020-12-28;TZ;Tanzania;0;0;509;21
2020-12-29;TZ;Tanzania;0;0;509;21
2020-12-30;TZ;Tanzania;0;0;509;21
2020-12-31;TZ;Tanzania;0;0;509;21
2021-01-01;TZ;Tanzania;0;0;509;21
2021-01-02;TZ;Tanzania;0;0;509;21
2021-01-03;TZ;Tanzania;0;0;509;21
2021-01-04;TZ;Tanzania;0;0;509;21
2021-01-05;TZ;Tanzania;0;0;509;21
2021-01-06;TZ;Tanzania;0;0;509;21
2021-01-07;TZ;Tanzania;0;0;509;21
2021-01-08;TZ;Tanzania;0;0;509;21
2021-01-09;TZ;Tanzania;0;0;509;21
2021-01-10;TZ;Tanzania;0;0;509;21
2021-01-11;TZ;Tanzania;0;0;509;21
2021-01-12;TZ;Tanzania;0;0;509;21
2021-01-13;TZ;Tanzania;0;0;509;21
2021-01-14;TZ;Tanzania;0;0;509;21
2021-01-15;TZ;Tanzania;0;0;509;21
2021-01-16;TZ;Tanzania;0;0;509;21
2021-01-17;TZ;Tanzania;0;0;509;21
2021-01-18;TZ;Tanzania;0;0;509;21
2021-01-19;TZ;Tanzania;0;0;509;21
2021-01-20;TZ;Tanzania;0;0;509;21
2021-01-21;TZ;Tanzania;0;0;509;21
2021-01-22;TZ;Tanzania;0;0;509;21
2021-01-23;TZ;Tanzania;0;0;509;21
2021-01-24;TZ;Tanzania;0;0;509;21
2021-01-25;TZ;Tanzania;0;0;509;21
2021-01-26;TZ;Tanzania;0;0;509;21
2021-01-27;TZ;Tanzania;0;0;509;21
2021-01-28;TZ;Tanzania;0;0;509;21
2021-01-29;TZ;Tanzania;0;0;509;21
2021-01-30;TZ;Tanzania;0;0;509;21
2021-01-31;TZ;Tanzania;0;0;509;21
2021-02-01;TZ;Tanzania;0;0;509;21
2021-02-02;TZ;Tanzania;0;0;509;21
2021-02-03;TZ;Tanzania;0;0;509;21
2021-02-04;TZ;Tanzania;0;0;509;21
2021-02-05;TZ;Tanzania;0;0;509;21
2021-02-06;TZ;Tanzania;0;0;509;21
2021-02-07;TZ;Tanzania;0;0;509;21
2021-02-08;TZ;Tanzania;0;0;509;21
2021-02-09;TZ;Tanzania;0;0;509;21
2021-02-10;TZ;Tanzania;0;0;509;21
2021-02-11;TZ;Tanzania;0;0;509;21
2021-02-12;TZ;Tanzania;0;0;509;21
2021-02-13;TZ;Tanzania;0;0;509;21
2021-02-14;TZ;Tanzania;0;0;509;21
2021-02-15;TZ;Tanzania;0;0;509;21
2021-02-16;TZ;Tanzania;0;0;509;21
2021-02-17;TZ;Tanzania;0;0;509;21
2021-02-18;TZ;Tanzania;0;0;509;21
2021-02-19;TZ;Tanzania;0;0;509;21
2021-02-20;TZ;Tanzania;0;0;509;21
2021-02-21;TZ;Tanzania;0;0;509;21
2021-02-22;TZ;Tanzania;0;0;509;21
2021-02-23;TZ;Tanzania;0;0;509;21
2021-02-24;TZ;Tanzania;0;0;509;21
2021-02-25;TZ;Tanzania;0;0;509;21
2021-02-26;TZ;Tanzania;0;0;509;21
2021-02-27;TZ;Tanzania;0;0;509;21
2021-02-28;TZ;Tanzania;0;0;509;21
2021-03-01;TZ;Tanzania;0;0;509;21
2021-03-02;TZ;Tanzania;0;0;509;21
2021-03-03;TZ;Tanzania;0;0;509;21
2021-03-04;TZ;Tanzania;0;0;509;21
2021-03-05;TZ;Tanzania;0;0;509;21
2021-03-06;TZ;Tanzania;0;0;509;21
2021-03-07;TZ;Tanzania;0;0;509;21
2021-03-08;TZ;Tanzania;0;0;509;21
2021-03-09;TZ;Tanzania;0;0;509;21
2021-03-10;TZ;Tanzania;0;0;509;21
2021-03-11;TZ;Tanzania;0;0;509;21
2021-03-12;TZ;Tanzania;0;0;509;21
2021-03-13;TZ;Tanzania;0;0;509;21
2021-03-14;TZ;Tanzania;0;0;509;21
2021-03-15;TZ;Tanzania;0;0;509;21
2021-03-16;TZ;Tanzania;0;0;509;21
2021-03-17;TZ;Tanzania;0;0;509;21
2021-03-18;TZ;Tanzania;0;0;509;21
2021-03-19;TZ;Tanzania;0;0;509;21
2021-03-20;TZ;Tanzania;0;0;509;21
2021-03-21;TZ;Tanzania;0;0;509;21
2021-03-22;TZ;Tanzania;0;0;509;21
2021-03-23;TZ;Tanzania;0;0;509;21
2021-03-24;TZ;Tanzania;0;0;509;21
2021-03-25;TZ;Tanzania;0;0;509;21
2021-03-26;TZ;Tanzania;0;0;509;21
2021-03-27;TZ;Tanzania;0;0;509;21
2021-03-28;TZ;Tanzania;0;0;509;21
2021-03-29;TZ;Tanzania;0;0;509;21
2021-03-30;TZ;Tanzania;0;0;509;21
2021-03-31;TZ;Tanzania;0;0;509;21
2021-04-01;TZ;Tanzania;0;0;509;21
2021-04-02;TZ;Tanzania;0;0;509;21
2021-04-03;TZ;Tanzania;0;0;509;21
2021-04-04;TZ;Tanzania;0;0;509;21
2021-04-05;TZ;Tanzania;0;0;509;21
2021-04-06;TZ;Tanzania;0;0;509;21
2021-04-07;TZ;Tanzania;0;0;509;21
2021-04-08;TZ;Tanzania;0;0;509;21
2021-04-09;TZ;Tanzania;0;0;509;21
2021-04-10;TZ;Tanzania;0;0;509;21
2021-04-11;TZ;Tanzania;0;0;509;21
2021-04-12;TZ;Tanzania;0;0;509;21
2021-04-13;TZ;Tanzania;0;0;509;21
2021-04-14;TZ;Tanzania;0;0;509;21
2021-04-15;TZ;Tanzania;0;0;509;21
2021-04-16;TZ;Tanzania;0;0;509;21
2021-04-17;TZ;Tanzania;0;0;509;21
2021-04-18;TZ;Tanzania;0;0;509;21
2021-04-19;TZ;Tanzania;0;0;509;21
2021-04-20;TZ;Tanzania;0;0;509;21
2021-04-21;TZ;Tanzania;0;0;509;21
2021-04-22;TZ;Tanzania;0;0;509;21
2021-04-23;TZ;Tanzania;0;0;509;21
2021-04-24;TZ;Tanzania;0;0;509;21
2021-04-25;TZ;Tanzania;0;0;509;21
2021-04-26;TZ;Tanzania;0;0;509;21
2021-04-27;TZ;Tanzania;0;0;509;21
2021-04-28;TZ;Tanzania;0;0;509;21
2021-04-29;TZ;Tanzania;0;0;509;21
2021-04-30;TZ;Tanzania;0;0;509;21
2021-05-01;TZ;Tanzania;0;0;509;21
2021-05-02;TZ;Tanzania;0;0;509;21
2021-05-03;TZ;Tanzania;0;0;509;21
2021-05-04;TZ;Tanzania;0;0;509;21
2021-05-05;TZ;Tanzania;0;0;509;21
2021-05-06;TZ;Tanzania;0;0;509;21
2021-05-07;TZ;Tanzania;0;0;509;21
2021-05-08;TZ;Tanzania;0;0;509;21
2021-05-09;TZ;Tanzania;0;0;509;21
2021-05-10;TZ;Tanzania;0;0;509;21
2021-05-11;TZ;Tanzania;0;0;509;21
2021-05-12;TZ;Tanzania;0;0;509;21
2021-05-13;TZ;Tanzania;0;0;509;21
2021-05-14;TZ;Tanzania;0;0;509;21
2021-05-15;TZ;Tanzania;0;0;509;21
2021-05-16;TZ;Tanzania;0;0;509;21
2021-05-17;TZ;Tanzania;0;0;509;21
2021-05-18;TZ;Tanzania;0;0;509;21
2021-05-19;TZ;Tanzania;0;0;509;21
2021-05-20;TZ;Tanzania;0;0;509;21
2021-05-21;TZ;Tanzania;0;0;509;21
2021-05-22;TZ;Tanzania;0;0;509;21
2021-05-23;TZ;Tanzania;0;0;509;21
2021-05-24;TZ;Tanzania;0;0;509;21
2021-05-25;TZ;Tanzania;0;0;509;21
2021-05-26;TZ;Tanzania;0;0;509;21
2021-05-27;TZ;Tanzania;0;0;509;21
2021-05-28;TZ;Tanzania;0;0;509;21
2021-05-29;TZ;Tanzania;0;0;509;21
2021-05-30;TZ;Tanzania;0;0;509;21
2021-05-31;TZ;Tanzania;0;0;509;21
2021-06-01;TZ;Tanzania;0;0;509;21
2021-06-02;TZ;Tanzania;0;0;509;21
2021-06-03;TZ;Tanzania;0;0;509;21
2021-06-04;TZ;Tanzania;0;0;509;21
2021-06-05;TZ;Tanzania;0;0;509;21
2021-06-06;TZ;Tanzania;0;0;509;21
2021-06-07;TZ;Tanzania;0;0;509;21
2021-06-08;TZ;Tanzania;0;0;509;21
2021-06-09;TZ;Tanzania;0;0;509;21
2021-06-10;TZ;Tanzania;0;0;509;21
2021-06-11;TZ;Tanzania;0;0;509;21
2021-06-12;TZ;Tanzania;0;0;509;21
2021-06-13;TZ;Tanzania;0;0;509;21
2021-06-14;TZ;Tanzania;0;0;509;21
2021-06-15;TZ;Tanzania;0;0;509;21
2021-06-16;TZ;Tanzania;0;0;509;21
2021-06-17;TZ;Tanzania;0;0;509;21
2021-06-18;TZ;Tanzania;0;0;509;21
2021-06-19;TZ;Tanzania;0;0;509;21
2021-06-20;TZ;Tanzania;0;0;509;21
2021-06-21;TZ;Tanzania;0;0;509;21
2021-06-22;TZ;Tanzania;0;0;509;21
2021-06-23;TZ;Tanzania;0;0;509;21
2021-06-24;TZ;Tanzania;0;0;509;21
2021-06-25;TZ;Tanzania;0;0;509;21
2021-06-26;TZ;Tanzania;0;0;509;21
2021-06-27;TZ;Tanzania;0;0;509;21
2021-06-28;TZ;Tanzania;0;0;509;21
2021-06-29;TZ;Tanzania;0;0;509;21
2021-06-30;TZ;Tanzania;0;0;509;21
2021-07-01;TZ;Tanzania;0;0;509;21
2020-01-04;TH;Thailand;0;0;0;0
2020-01-05;TH;Thailand;0;0;0;0
2020-01-06;TH;Thailand;0;0;0;0
2020-01-07;TH;Thailand;0;0;0;0
2020-01-08;TH;Thailand;0;0;0;0
2020-01-09;TH;Thailand;0;0;0;0
2020-01-10;TH;Thailand;0;0;0;0
2020-01-11;TH;Thailand;0;0;0;0
2020-01-12;TH;Thailand;0;0;0;0
2020-01-13;TH;Thailand;0;0;0;0
2020-01-14;TH;Thailand;0;0;0;0
2020-01-15;TH;Thailand;0;0;0;0
2020-01-16;TH;Thailand;0;0;0;0
2020-01-17;TH;Thailand;0;0;0;0
2020-01-18;TH;Thailand;0;0;0;0
2020-01-19;TH;Thailand;0;0;0;0
2020-01-20;TH;Thailand;0;0;0;0
2020-01-21;TH;Thailand;0;0;0;0
2020-01-22;TH;Thailand;0;0;4;0
2020-01-23;TH;Thailand;0;0;4;0
2020-01-24;TH;Thailand;1;0;5;0
2020-01-25;TH;Thailand;1;0;6;0
2020-01-26;TH;Thailand;2;0;8;0
2020-01-27;TH;Thailand;0;0;8;0
2020-01-28;TH;Thailand;6;0;14;0
2020-01-29;TH;Thailand;0;0;14;0
2020-01-30;TH;Thailand;0;0;14;0
2020-01-31;TH;Thailand;5;0;19;0
2020-02-01;TH;Thailand;0;0;19;0
2020-02-02;TH;Thailand;0;0;19;0
2020-02-03;TH;Thailand;0;0;19;0
2020-02-04;TH;Thailand;6;0;25;0
2020-02-05;TH;Thailand;0;0;25;0
2020-02-06;TH;Thailand;0;0;25;0
2020-02-07;TH;Thailand;0;0;25;0
2020-02-08;TH;Thailand;7;0;32;0
2020-02-09;TH;Thailand;0;0;32;0
2020-02-10;TH;Thailand;0;0;32;0
2020-02-11;TH;Thailand;1;0;33;0
2020-02-12;TH;Thailand;0;0;33;0
2020-02-13;TH;Thailand;0;0;33;0
2020-02-14;TH;Thailand;0;0;33;0
2020-02-15;TH;Thailand;1;0;34;0
2020-02-16;TH;Thailand;0;0;34;0
2020-02-17;TH;Thailand;1;0;35;0
2020-02-18;TH;Thailand;0;0;35;0
2020-02-19;TH;Thailand;0;0;35;0
2020-02-20;TH;Thailand;0;0;35;0
2020-02-21;TH;Thailand;0;0;35;0
2020-02-22;TH;Thailand;0;0;35;0
2020-02-23;TH;Thailand;0;0;35;0
2020-02-24;TH;Thailand;0;0;35;0
2020-02-25;TH;Thailand;2;0;37;0
2020-02-26;TH;Thailand;3;0;40;0
2020-02-27;TH;Thailand;0;0;40;0
2020-02-28;TH;Thailand;1;0;41;0
2020-02-29;TH;Thailand;1;0;42;0
2020-03-01;TH;Thailand;0;1;42;1
2020-03-02;TH;Thailand;1;0;43;1
2020-03-03;TH;Thailand;0;0;43;1
2020-03-04;TH;Thailand;0;0;43;1
2020-03-05;TH;Thailand;4;0;47;1
2020-03-06;TH;Thailand;1;0;48;1
2020-03-07;TH;Thailand;2;0;50;1
2020-03-08;TH;Thailand;0;0;50;1
2020-03-09;TH;Thailand;0;0;50;1
2020-03-10;TH;Thailand;3;0;53;1
2020-03-11;TH;Thailand;6;0;59;1
2020-03-12;TH;Thailand;11;0;70;1
2020-03-13;TH;Thailand;5;0;75;1
2020-03-14;TH;Thailand;7;0;82;1
2020-03-15;TH;Thailand;32;0;114;1
2020-03-16;TH;Thailand;33;0;147;1
2020-03-17;TH;Thailand;30;0;177;1
2020-03-18;TH;Thailand;35;0;212;1
2020-03-19;TH;Thailand;60;0;272;1
2020-03-20;TH;Thailand;50;0;322;1
2020-03-21;TH;Thailand;89;0;411;1
2020-03-22;TH;Thailand;188;0;599;1
2020-03-23;TH;Thailand;122;0;721;1
2020-03-24;TH;Thailand;106;3;827;4
2020-03-25;TH;Thailand;107;0;934;4
2020-03-26;TH;Thailand;111;0;1045;4
2020-03-27;TH;Thailand;91;1;1136;5
2020-03-28;TH;Thailand;109;1;1245;6
2020-03-29;TH;Thailand;143;1;1388;7
2020-03-30;TH;Thailand;136;2;1524;9
2020-03-31;TH;Thailand;127;1;1651;10
2020-04-01;TH;Thailand;120;2;1771;12
2020-04-02;TH;Thailand;104;3;1875;15
2020-04-03;TH;Thailand;103;4;1978;19
2020-04-04;TH;Thailand;89;1;2067;20
2020-04-05;TH;Thailand;102;3;2169;23
2020-04-06;TH;Thailand;51;3;2220;26
2020-04-07;TH;Thailand;38;1;2258;27
2020-04-08;TH;Thailand;111;3;2369;30
2020-04-09;TH;Thailand;54;2;2423;32
2020-04-10;TH;Thailand;50;1;2473;33
2020-04-11;TH;Thailand;45;2;2518;35
2020-04-12;TH;Thailand;33;3;2551;38
2020-04-13;TH;Thailand;28;2;2579;40
2020-04-14;TH;Thailand;34;1;2613;41
2020-04-15;TH;Thailand;30;2;2643;43
2020-04-16;TH;Thailand;29;3;2672;46
2020-04-17;TH;Thailand;28;1;2700;47
2020-04-18;TH;Thailand;33;0;2733;47
2020-04-19;TH;Thailand;32;0;2765;47
2020-04-20;TH;Thailand;27;0;2792;47
2020-04-21;TH;Thailand;19;1;2811;48
2020-04-22;TH;Thailand;15;1;2826;49
2020-04-23;TH;Thailand;13;1;2839;50
2020-04-24;TH;Thailand;15;0;2854;50
2020-04-25;TH;Thailand;53;1;2907;51
2020-04-26;TH;Thailand;15;0;2922;51
2020-04-27;TH;Thailand;9;1;2931;52
2020-04-28;TH;Thailand;7;2;2938;54
2020-04-29;TH;Thailand;9;0;2947;54
2020-04-30;TH;Thailand;7;0;2954;54
2020-05-01;TH;Thailand;6;0;2960;54
2020-05-02;TH;Thailand;6;0;2966;54
2020-05-03;TH;Thailand;3;0;2969;54
2020-05-04;TH;Thailand;18;0;2987;54
2020-05-05;TH;Thailand;1;0;2988;54
2020-05-06;TH;Thailand;1;1;2989;55
2020-05-07;TH;Thailand;3;0;2992;55
2020-05-08;TH;Thailand;8;0;3000;55
2020-05-09;TH;Thailand;4;1;3004;56
2020-05-10;TH;Thailand;5;0;3009;56
2020-05-11;TH;Thailand;6;0;3015;56
2020-05-12;TH;Thailand;2;0;3017;56
2020-05-13;TH;Thailand;0;0;3017;56
2020-05-14;TH;Thailand;1;0;3018;56
2020-05-15;TH;Thailand;7;0;3025;56
2020-05-16;TH;Thailand;0;0;3025;56
2020-05-17;TH;Thailand;3;0;3028;56
2020-05-18;TH;Thailand;3;0;3031;56
2020-05-19;TH;Thailand;2;0;3033;56
2020-05-20;TH;Thailand;1;0;3034;56
2020-05-21;TH;Thailand;3;0;3037;56
2020-05-22;TH;Thailand;0;0;3037;56
2020-05-23;TH;Thailand;3;0;3040;56
2020-05-24;TH;Thailand;0;0;3040;56
2020-05-25;TH;Thailand;2;1;3042;57
2020-05-26;TH;Thailand;3;0;3045;57
2020-05-27;TH;Thailand;9;0;3054;57
2020-05-28;TH;Thailand;11;0;3065;57
2020-05-29;TH;Thailand;11;0;3076;57
2020-05-30;TH;Thailand;1;0;3077;57
2020-05-31;TH;Thailand;4;0;3081;57
2020-06-01;TH;Thailand;1;0;3082;57
2020-06-02;TH;Thailand;1;1;3083;58
2020-06-03;TH;Thailand;1;0;3084;58
2020-06-04;TH;Thailand;17;0;3101;58
2020-06-05;TH;Thailand;1;0;3102;58
2020-06-06;TH;Thailand;2;0;3104;58
2020-06-07;TH;Thailand;8;0;3112;58
2020-06-08;TH;Thailand;7;0;3119;58
2020-06-09;TH;Thailand;2;0;3121;58
2020-06-10;TH;Thailand;4;0;3125;58
2020-06-11;TH;Thailand;0;0;3125;58
2020-06-12;TH;Thailand;4;0;3129;58
2020-06-13;TH;Thailand;5;0;3134;58
2020-06-14;TH;Thailand;1;0;3135;58
2020-06-15;TH;Thailand;0;0;3135;58
2020-06-16;TH;Thailand;0;0;3135;58
2020-06-17;TH;Thailand;0;0;3135;58
2020-06-18;TH;Thailand;6;0;3141;58
2020-06-19;TH;Thailand;5;0;3146;58
2020-06-20;TH;Thailand;1;0;3147;58
2020-06-21;TH;Thailand;1;0;3148;58
2020-06-22;TH;Thailand;3;0;3151;58
2020-06-23;TH;Thailand;5;0;3156;58
2020-06-24;TH;Thailand;1;0;3157;58
2020-06-25;TH;Thailand;1;0;3158;58
2020-06-26;TH;Thailand;4;0;3162;58
2020-06-27;TH;Thailand;0;0;3162;58
2020-06-28;TH;Thailand;0;0;3162;58
2020-06-29;TH;Thailand;7;0;3169;58
2020-06-30;TH;Thailand;2;0;3171;58
2020-07-01;TH;Thailand;2;0;3173;58
2020-07-02;TH;Thailand;6;0;3179;58
2020-07-03;TH;Thailand;1;0;3180;58
2020-07-04;TH;Thailand;5;0;3185;58
2020-07-05;TH;Thailand;5;0;3190;58
2020-07-06;TH;Thailand;5;0;3195;58
2020-07-07;TH;Thailand;0;0;3195;58
2020-07-08;TH;Thailand;2;0;3197;58
2020-07-09;TH;Thailand;5;0;3202;58
2020-07-10;TH;Thailand;0;0;3202;58
2020-07-11;TH;Thailand;14;0;3216;58
2020-07-12;TH;Thailand;1;0;3217;58
2020-07-13;TH;Thailand;3;0;3220;58
2020-07-14;TH;Thailand;7;0;3227;58
2020-07-15;TH;Thailand;5;0;3232;58
2020-07-16;TH;Thailand;4;0;3236;58
2020-07-17;TH;Thailand;3;0;3239;58
2020-07-18;TH;Thailand;7;0;3246;58
2020-07-19;TH;Thailand;3;0;3249;58
2020-07-20;TH;Thailand;1;0;3250;58
2020-07-21;TH;Thailand;5;0;3255;58
2020-07-22;TH;Thailand;-2;0;3253;58
2020-07-23;TH;Thailand;16;0;3269;58
2020-07-24;TH;Thailand;10;0;3279;58
2020-07-25;TH;Thailand;3;0;3282;58
2020-07-26;TH;Thailand;9;0;3291;58
2020-07-27;TH;Thailand;4;0;3295;58
2020-07-28;TH;Thailand;2;0;3297;58
2020-07-29;TH;Thailand;1;0;3298;58
2020-07-30;TH;Thailand;6;0;3304;58
2020-07-31;TH;Thailand;6;0;3310;58
2020-08-01;TH;Thailand;2;0;3312;58
2020-08-02;TH;Thailand;5;0;3317;58
2020-08-03;TH;Thailand;3;0;3320;58
2020-08-04;TH;Thailand;1;0;3321;58
2020-08-05;TH;Thailand;7;0;3328;58
2020-08-06;TH;Thailand;2;0;3330;58
2020-08-07;TH;Thailand;15;0;3345;58
2020-08-08;TH;Thailand;3;0;3348;58
2020-08-09;TH;Thailand;3;0;3351;58
2020-08-10;TH;Thailand;0;0;3351;58
2020-08-11;TH;Thailand;0;0;3351;58
2020-08-12;TH;Thailand;5;0;3356;58
2020-08-13;TH;Thailand;3;0;3359;58
2020-08-14;TH;Thailand;17;0;3376;58
2020-08-15;TH;Thailand;0;0;3376;58
2020-08-16;TH;Thailand;1;0;3377;58
2020-08-17;TH;Thailand;1;0;3378;58
2020-08-18;TH;Thailand;3;0;3381;58
2020-08-19;TH;Thailand;1;0;3382;58
2020-08-20;TH;Thailand;7;0;3389;58
2020-08-21;TH;Thailand;1;0;3390;58
2020-08-22;TH;Thailand;0;0;3390;58
2020-08-23;TH;Thailand;5;0;3395;58
2020-08-24;TH;Thailand;2;0;3397;58
2020-08-25;TH;Thailand;5;0;3402;58
2020-08-26;TH;Thailand;1;0;3403;58
2020-08-27;TH;Thailand;1;0;3404;58
2020-08-28;TH;Thailand;6;0;3410;58
2020-08-29;TH;Thailand;1;0;3411;58
2020-08-30;TH;Thailand;0;0;3411;58
2020-08-31;TH;Thailand;1;0;3412;58
2020-09-01;TH;Thailand;5;0;3417;58
2020-09-02;TH;Thailand;8;0;3425;58
2020-09-03;TH;Thailand;2;0;3427;58
2020-09-04;TH;Thailand;4;0;3431;58
2020-09-05;TH;Thailand;7;0;3438;58
2020-09-06;TH;Thailand;6;0;3444;58
2020-09-07;TH;Thailand;1;0;3445;58
2020-09-08;TH;Thailand;1;0;3446;58
2020-09-09;TH;Thailand;1;0;3447;58
2020-09-10;TH;Thailand;7;0;3454;58
2020-09-11;TH;Thailand;7;0;3461;58
2020-09-12;TH;Thailand;5;0;3466;58
2020-09-13;TH;Thailand;7;0;3473;58
2020-09-14;TH;Thailand;2;0;3475;58
2020-09-15;TH;Thailand;5;0;3480;58
2020-09-16;TH;Thailand;10;0;3490;58
2020-09-17;TH;Thailand;0;0;3490;58
2020-09-18;TH;Thailand;7;0;3497;58
2020-09-19;TH;Thailand;3;1;3500;59
2020-09-20;TH;Thailand;6;0;3506;59
2020-09-21;TH;Thailand;5;0;3511;59
2020-09-22;TH;Thailand;3;0;3514;59
2020-09-23;TH;Thailand;2;0;3516;59
2020-09-24;TH;Thailand;3;0;3519;59
2020-09-25;TH;Thailand;3;0;3522;59
2020-09-26;TH;Thailand;1;0;3523;59
2020-09-27;TH;Thailand;22;0;3545;59
2020-09-28;TH;Thailand;14;0;3559;59
2020-09-29;TH;Thailand;5;0;3564;59
2020-09-30;TH;Thailand;5;0;3569;59
2020-10-01;TH;Thailand;6;0;3575;59
2020-10-02;TH;Thailand;8;0;3583;59
2020-10-03;TH;Thailand;2;0;3585;59
2020-10-04;TH;Thailand;5;0;3590;59
2020-10-05;TH;Thailand;10;0;3600;59
2020-10-06;TH;Thailand;15;0;3615;59
2020-10-07;TH;Thailand;7;0;3622;59
2020-10-08;TH;Thailand;6;0;3628;59
2020-10-09;TH;Thailand;6;0;3634;59
2020-10-10;TH;Thailand;2;0;3636;59
2020-10-11;TH;Thailand;5;0;3641;59
2020-10-12;TH;Thailand;2;0;3643;59
2020-10-13;TH;Thailand;9;0;3652;59
2020-10-14;TH;Thailand;13;0;3665;59
2020-10-15;TH;Thailand;10;0;3675;59
2020-10-16;TH;Thailand;11;0;3686;59
2020-10-17;TH;Thailand;-7;0;3679;59
2020-10-18;TH;Thailand;12;0;3691;59
2020-10-19;TH;Thailand;9;0;3700;59
2020-10-20;TH;Thailand;9;0;3709;59
2020-10-21;TH;Thailand;10;0;3719;59
2020-10-22;TH;Thailand;8;0;3727;59
2020-10-23;TH;Thailand;4;0;3731;59
2020-10-24;TH;Thailand;5;0;3736;59
2020-10-25;TH;Thailand;7;0;3743;59
2020-10-26;TH;Thailand;3;0;3746;59
2020-10-27;TH;Thailand;13;0;3759;59
2020-10-28;TH;Thailand;4;0;3763;59
2020-10-29;TH;Thailand;12;0;3775;59
2020-10-30;TH;Thailand;5;0;3780;59
2020-10-31;TH;Thailand;4;0;3784;59
2020-11-01;TH;Thailand;3;0;3787;59
2020-11-02;TH;Thailand;10;0;3797;59
2020-11-03;TH;Thailand;7;0;3804;59
2020-11-04;TH;Thailand;6;0;3810;59
2020-11-05;TH;Thailand;8;1;3818;60
2020-11-06;TH;Thailand;12;0;3830;60
2020-11-07;TH;Thailand;7;0;3837;60
2020-11-08;TH;Thailand;3;0;3840;60
2020-11-09;TH;Thailand;4;0;3844;60
2020-11-10;TH;Thailand;3;0;3847;60
2020-11-11;TH;Thailand;5;0;3852;60
2020-11-12;TH;Thailand;9;0;3861;60
2020-11-13;TH;Thailand;5;0;3866;60
2020-11-14;TH;Thailand;8;0;3874;60
2020-11-15;TH;Thailand;1;0;3875;60
2020-11-16;TH;Thailand;3;0;3878;60
2020-11-17;TH;Thailand;2;0;3880;60
2020-11-18;TH;Thailand;8;0;3888;60
2020-11-19;TH;Thailand;4;0;3892;60
2020-11-20;TH;Thailand;7;0;3899;60
2020-11-21;TH;Thailand;23;0;3922;60
2020-11-22;TH;Thailand;-2;0;3920;60
2020-11-23;TH;Thailand;-10;0;3910;60
2020-11-24;TH;Thailand;16;0;3926;60
2020-11-25;TH;Thailand;16;0;3942;60
2020-11-26;TH;Thailand;19;0;3961;60
2020-11-27;TH;Thailand;5;0;3966;60
2020-11-28;TH;Thailand;11;0;3977;60
2020-11-29;TH;Thailand;21;0;3998;60
2020-11-30;TH;Thailand;10;0;4008;60
2020-12-01;TH;Thailand;18;0;4026;60
2020-12-02;TH;Thailand;13;0;4039;60
2020-12-03;TH;Thailand;14;0;4053;60
2020-12-04;TH;Thailand;19;0;4072;60
2020-12-05;TH;Thailand;14;0;4086;60
2020-12-06;TH;Thailand;21;0;4107;60
2020-12-07;TH;Thailand;19;0;4126;60
2020-12-08;TH;Thailand;25;0;4151;60
2020-12-09;TH;Thailand;18;0;4169;60
2020-12-10;TH;Thailand;11;0;4180;60
2020-12-11;TH;Thailand;12;0;4192;60
2020-12-12;TH;Thailand;17;0;4209;60
2020-12-13;TH;Thailand;28;0;4237;60
2020-12-14;TH;Thailand;9;0;4246;60
2020-12-15;TH;Thailand;15;0;4261;60
2020-12-16;TH;Thailand;20;0;4281;60
2020-12-17;TH;Thailand;16;0;4297;60
2020-12-18;TH;Thailand;34;0;4331;60
2020-12-19;TH;Thailand;576;0;4907;60
2020-12-20;TH;Thailand;382;0;5289;60
2020-12-21;TH;Thailand;427;0;5716;60
2020-12-22;TH;Thailand;46;0;5762;60
2020-12-23;TH;Thailand;67;0;5829;60
2020-12-24;TH;Thailand;81;0;5910;60
2020-12-25;TH;Thailand;110;0;6020;60
2020-12-26;TH;Thailand;121;0;6141;60
2020-12-27;TH;Thailand;144;0;6285;60
2020-12-28;TH;Thailand;155;1;6440;61
2020-12-29;TH;Thailand;250;0;6690;61
2020-12-30;TH;Thailand;194;0;6884;61
2020-12-31;TH;Thailand;279;2;7163;63
2021-01-01;TH;Thailand;216;1;7379;64
2021-01-02;TH;Thailand;315;0;7694;64
2021-01-03;TH;Thailand;745;1;8439;65
2021-01-04;TH;Thailand;527;0;8966;65
2021-01-05;TH;Thailand;365;1;9331;66
2021-01-06;TH;Thailand;305;1;9636;67
2021-01-07;TH;Thailand;205;0;9841;67
2021-01-08;TH;Thailand;212;0;10053;67
2021-01-09;TH;Thailand;245;0;10298;67
2021-01-10;TH;Thailand;249;0;10547;67
2021-01-11;TH;Thailand;287;0;10834;67
2021-01-12;TH;Thailand;157;0;10991;67
2021-01-13;TH;Thailand;0;0;10991;67
2021-01-14;TH;Thailand;459;2;11450;69
2021-01-15;TH;Thailand;230;1;11680;70
2021-01-16;TH;Thailand;374;0;12054;70
2021-01-17;TH;Thailand;369;0;12423;70
2021-01-18;TH;Thailand;171;0;12594;70
2021-01-19;TH;Thailand;59;1;12653;71
2021-01-20;TH;Thailand;142;0;12795;71
2021-01-21;TH;Thailand;0;0;12795;71
2021-01-22;TH;Thailand;309;0;13104;71
2021-01-23;TH;Thailand;198;1;13302;72
2021-01-24;TH;Thailand;198;1;13500;73
2021-01-25;TH;Thailand;1146;2;14646;75
2021-01-26;TH;Thailand;0;0;14646;75
2021-01-27;TH;Thailand;819;1;15465;76
2021-01-28;TH;Thailand;756;0;16221;76
2021-01-29;TH;Thailand;1732;1;17953;77
2021-01-30;TH;Thailand;829;0;18782;77
2021-01-31;TH;Thailand;836;0;19618;77
2021-02-01;TH;Thailand;836;2;20454;79
2021-02-02;TH;Thailand;795;0;21249;79
2021-02-03;TH;Thailand;0;0;21249;79
2021-02-04;TH;Thailand;809;0;22058;79
2021-02-05;TH;Thailand;1076;0;23134;79
2021-02-06;TH;Thailand;237;0;23371;79
2021-02-07;TH;Thailand;186;0;23557;79
2021-02-08;TH;Thailand;0;0;23557;79
2021-02-09;TH;Thailand;189;0;23746;79
2021-02-10;TH;Thailand;358;1;24104;80
2021-02-11;TH;Thailand;175;0;24279;80
2021-02-12;TH;Thailand;0;0;24279;80
2021-02-13;TH;Thailand;126;0;24405;80
2021-02-14;TH;Thailand;166;0;24571;80
2021-02-15;TH;Thailand;143;2;24714;82
2021-02-16;TH;Thailand;72;0;24786;82
2021-02-17;TH;Thailand;175;0;24961;82
2021-02-18;TH;Thailand;150;1;25111;83
2021-02-19;TH;Thailand;130;0;25241;83
2021-02-20;TH;Thailand;82;0;25323;83
2021-02-21;TH;Thailand;181;0;25504;83
2021-02-22;TH;Thailand;0;0;25504;83
2021-02-23;TH;Thailand;188;0;25692;83
2021-02-24;TH;Thailand;0;0;25692;83
2021-02-25;TH;Thailand;72;0;25764;83
2021-02-26;TH;Thailand;45;0;25809;83
2021-02-27;TH;Thailand;142;0;25951;83
2021-02-28;TH;Thailand;80;0;26031;83
2021-03-01;TH;Thailand;0;0;26031;83
2021-03-02;TH;Thailand;42;1;26073;84
2021-03-03;TH;Thailand;35;1;26108;85
2021-03-04;TH;Thailand;54;0;26162;85
2021-03-05;TH;Thailand;79;0;26241;85
2021-03-06;TH;Thailand;64;0;26305;85
2021-03-07;TH;Thailand;136;0;26441;85
2021-03-08;TH;Thailand;0;0;26441;85
2021-03-09;TH;Thailand;60;0;26501;85
2021-03-10;TH;Thailand;39;0;26540;85
2021-03-11;TH;Thailand;58;0;26598;85
2021-03-12;TH;Thailand;81;0;26679;85
2021-03-13;TH;Thailand;78;1;26757;86
2021-03-14;TH;Thailand;170;1;26927;87
2021-03-15;TH;Thailand;78;0;27005;87
2021-03-16;TH;Thailand;149;1;27154;88
2021-03-17;TH;Thailand;248;1;27402;89
2021-03-18;TH;Thailand;92;0;27494;89
2021-03-19;TH;Thailand;100;1;27594;90
2021-03-20;TH;Thailand;119;0;27713;90
2021-03-21;TH;Thailand;90;0;27803;90
2021-03-22;TH;Thailand;73;1;27876;91
2021-03-23;TH;Thailand;470;1;28346;92
2021-03-24;TH;Thailand;97;0;28443;92
2021-03-25;TH;Thailand;0;0;28443;92
2021-03-26;TH;Thailand;134;0;28577;92
2021-03-27;TH;Thailand;80;1;28657;93
2021-03-28;TH;Thailand;77;1;28734;94
2021-03-29;TH;Thailand;39;0;28773;94
2021-03-30;TH;Thailand;48;0;28821;94
2021-03-31;TH;Thailand;42;0;28863;94
2021-04-01;TH;Thailand;26;0;28889;94
2021-04-02;TH;Thailand;58;0;28947;94
2021-04-03;TH;Thailand;84;1;29031;95
2021-04-04;TH;Thailand;96;0;29127;95
2021-04-05;TH;Thailand;194;0;29321;95
2021-04-06;TH;Thailand;250;0;29571;95
2021-04-07;TH;Thailand;334;0;29905;95
2021-04-08;TH;Thailand;405;0;30310;95
2021-04-09;TH;Thailand;559;1;30869;96
2021-04-10;TH;Thailand;789;1;31658;97
2021-04-11;TH;Thailand;967;0;32625;97
2021-04-12;TH;Thailand;985;0;33610;97
2021-04-13;TH;Thailand;965;0;34575;97
2021-04-14;TH;Thailand;1335;0;35910;97
2021-04-15;TH;Thailand;1543;0;37453;97
2021-04-16;TH;Thailand;1585;0;39038;97
2021-04-17;TH;Thailand;1547;2;40585;99
2021-04-18;TH;Thailand;1767;2;42352;101
2021-04-19;TH;Thailand;1390;3;43742;104
2021-04-20;TH;Thailand;1443;4;45185;108
2021-04-21;TH;Thailand;1458;2;46643;110
2021-04-22;TH;Thailand;1470;7;48113;117
2021-04-23;TH;Thailand;2070;4;50183;121
2021-04-24;TH;Thailand;2839;8;53022;129
2021-04-25;TH;Thailand;2438;11;55460;140
2021-04-26;TH;Thailand;2048;8;57508;148
2021-04-27;TH;Thailand;2180;15;59688;163
2021-04-28;TH;Thailand;2011;15;61699;178
2021-04-29;TH;Thailand;1871;10;63570;188
2021-04-30;TH;Thailand;1583;15;65153;203
2021-05-01;TH;Thailand;1891;21;67044;224
2021-05-02;TH;Thailand;1940;21;68984;245
2021-05-03;TH;Thailand;2041;31;71025;276
2021-05-04;TH;Thailand;1763;27;72788;303
2021-05-05;TH;Thailand;2112;15;74900;318
2021-05-06;TH;Thailand;1911;18;76811;336
2021-05-07;TH;Thailand;2044;27;78855;363
2021-05-08;TH;Thailand;2419;19;81274;382
2021-05-09;TH;Thailand;2101;17;83375;399
2021-05-10;TH;Thailand;1630;22;85005;421
2021-05-11;TH;Thailand;1919;31;86924;452
2021-05-12;TH;Thailand;1983;34;88907;486
2021-05-13;TH;Thailand;4887;32;93794;518
2021-05-14;TH;Thailand;2256;30;96050;548
2021-05-15;TH;Thailand;3095;17;99145;565
2021-05-16;TH;Thailand;2302;24;101447;589
2021-05-17;TH;Thailand;9635;25;111082;614
2021-05-18;TH;Thailand;2473;35;113555;649
2021-05-19;TH;Thailand;3394;29;116949;678
2021-05-20;TH;Thailand;2636;25;119585;703
2021-05-21;TH;Thailand;3481;32;123066;735
2021-05-22;TH;Thailand;3052;24;126118;759
2021-05-23;TH;Thailand;3382;17;129500;776
2021-05-24;TH;Thailand;2713;30;132213;806
2021-05-25;TH;Thailand;3226;26;135439;832
2021-05-26;TH;Thailand;2455;41;137894;873
2021-05-27;TH;Thailand;5386;47;143280;920
2021-05-28;TH;Thailand;3759;34;147039;954
2021-05-29;TH;Thailand;4803;34;151842;988
2021-05-30;TH;Thailand;4528;24;156370;1012
2021-05-31;TH;Thailand;3422;19;159792;1031
2021-06-01;TH;Thailand;2230;38;162022;1069
2021-06-02;TH;Thailand;3440;38;165462;1107
2021-06-03;TH;Thailand;3886;39;169348;1146
2021-06-04;TH;Thailand;2630;31;171978;1177
2021-06-05;TH;Thailand;2818;36;174796;1213
2021-06-06;TH;Thailand;2671;23;177467;1236
2021-06-07;TH;Thailand;2419;33;179886;1269
2021-06-08;TH;Thailand;2662;28;182548;1297
2021-06-09;TH;Thailand;2680;35;185228;1332
2021-06-10;TH;Thailand;2310;43;187538;1375
2021-06-11;TH;Thailand;2290;27;189828;1402
2021-06-12;TH;Thailand;3277;29;193105;1431
2021-06-13;TH;Thailand;2804;18;195909;1449
2021-06-14;TH;Thailand;3355;17;199264;1466
2021-06-15;TH;Thailand;3000;19;202264;1485
2021-06-16;TH;Thailand;2331;40;204595;1525
2021-06-17;TH;Thailand;3129;30;207724;1555
2021-06-18;TH;Thailand;3058;22;210782;1577
2021-06-19;TH;Thailand;3667;32;214449;1609
2021-06-20;TH;Thailand;3682;20;218131;1629
2021-06-21;TH;Thailand;3175;29;221306;1658
2021-06-22;TH;Thailand;4059;35;225365;1693
2021-06-23;TH;Thailand;3174;51;228539;1744
2021-06-24;TH;Thailand;4108;31;232647;1775
2021-06-25;TH;Thailand;3644;44;236291;1819
2021-06-26;TH;Thailand;4161;51;240452;1870
2021-06-27;TH;Thailand;3995;42;244447;1912
2021-06-28;TH;Thailand;5406;22;249853;1934
2021-06-29;TH;Thailand;4662;36;254515;1970
2021-06-30;TH;Thailand;4786;53;259301;2023
2021-07-01;TH;Thailand;5533;57;264834;2080
2020-03-22;TL;Timor;1;0;1;0
2020-03-23;TL;Timor;0;0;1;0
2020-03-24;TL;Timor;0;0;1;0
2020-03-25;TL;Timor;0;0;1;0
2020-03-26;TL;Timor;0;0;1;0
2020-03-27;TL;Timor;0;0;1;0
2020-03-28;TL;Timor;0;0;1;0
2020-03-29;TL;Timor;0;0;1;0
2020-03-30;TL;Timor;0;0;1;0
2020-03-31;TL;Timor;0;0;1;0
2020-04-01;TL;Timor;0;0;1;0
2020-04-02;TL;Timor;0;0;1;0
2020-04-03;TL;Timor;0;0;1;0
2020-04-04;TL;Timor;0;0;1;0
2020-04-05;TL;Timor;0;0;1;0
2020-04-06;TL;Timor;0;0;1;0
2020-04-07;TL;Timor;0;0;1;0
2020-04-08;TL;Timor;0;0;1;0
2020-04-09;TL;Timor;0;0;1;0
2020-04-10;TL;Timor;1;0;2;0
2020-04-11;TL;Timor;0;0;2;0
2020-04-12;TL;Timor;0;0;2;0
2020-04-13;TL;Timor;2;0;4;0
2020-04-14;TL;Timor;2;0;6;0
2020-04-15;TL;Timor;2;0;8;0
2020-04-16;TL;Timor;10;0;18;0
2020-04-17;TL;Timor;0;0;18;0
2020-04-18;TL;Timor;0;0;18;0
2020-04-19;TL;Timor;1;0;19;0
2020-04-20;TL;Timor;3;0;22;0
2020-04-21;TL;Timor;1;0;23;0
2020-04-22;TL;Timor;0;0;23;0
2020-04-23;TL;Timor;0;0;23;0
2020-04-24;TL;Timor;1;0;24;0
2020-04-25;TL;Timor;0;0;24;0
2020-04-26;TL;Timor;0;0;24;0
2020-04-27;TL;Timor;0;0;24;0
2020-04-28;TL;Timor;0;0;24;0
2020-04-29;TL;Timor;0;0;24;0
2020-04-30;TL;Timor;0;0;24;0
2020-05-01;TL;Timor;0;0;24;0
2020-05-02;TL;Timor;0;0;24;0
2020-05-03;TL;Timor;0;0;24;0
2020-05-04;TL;Timor;0;0;24;0
2020-05-05;TL;Timor;0;0;24;0
2020-05-06;TL;Timor;0;0;24;0
2020-05-07;TL;Timor;0;0;24;0
2020-05-08;TL;Timor;0;0;24;0
2020-05-09;TL;Timor;0;0;24;0
2020-05-10;TL;Timor;0;0;24;0
2020-05-11;TL;Timor;0;0;24;0
2020-05-12;TL;Timor;0;0;24;0
2020-05-13;TL;Timor;0;0;24;0
2020-05-14;TL;Timor;0;0;24;0
2020-05-15;TL;Timor;0;0;24;0
2020-05-16;TL;Timor;0;0;24;0
2020-05-17;TL;Timor;0;0;24;0
2020-05-18;TL;Timor;0;0;24;0
2020-05-19;TL;Timor;0;0;24;0
2020-05-20;TL;Timor;0;0;24;0
2020-05-21;TL;Timor;0;0;24;0
2020-05-22;TL;Timor;0;0;24;0
2020-05-23;TL;Timor;0;0;24;0
2020-05-24;TL;Timor;0;0;24;0
2020-05-25;TL;Timor;0;0;24;0
2020-05-26;TL;Timor;0;0;24;0
2020-05-27;TL;Timor;0;0;24;0
2020-05-28;TL;Timor;0;0;24;0
2020-05-29;TL;Timor;0;0;24;0
2020-05-30;TL;Timor;0;0;24;0
2020-05-31;TL;Timor;0;0;24;0
2020-06-01;TL;Timor;0;0;24;0
2020-06-02;TL;Timor;0;0;24;0
2020-06-03;TL;Timor;0;0;24;0
2020-06-04;TL;Timor;0;0;24;0
2020-06-05;TL;Timor;0;0;24;0
2020-06-06;TL;Timor;0;0;24;0
2020-06-07;TL;Timor;0;0;24;0
2020-06-08;TL;Timor;0;0;24;0
2020-06-09;TL;Timor;0;0;24;0
2020-06-10;TL;Timor;0;0;24;0
2020-06-11;TL;Timor;0;0;24;0
2020-06-12;TL;Timor;0;0;24;0
2020-06-13;TL;Timor;0;0;24;0
2020-06-14;TL;Timor;0;0;24;0
2020-06-15;TL;Timor;0;0;24;0
2020-06-16;TL;Timor;0;0;24;0
2020-06-17;TL;Timor;0;0;24;0
2020-06-18;TL;Timor;0;0;24;0
2020-06-19;TL;Timor;0;0;24;0
2020-06-20;TL;Timor;0;0;24;0
2020-06-21;TL;Timor;0;0;24;0
2020-06-22;TL;Timor;0;0;24;0
2020-06-23;TL;Timor;0;0;24;0
2020-06-24;TL;Timor;0;0;24;0
2020-06-25;TL;Timor;0;0;24;0
2020-06-26;TL;Timor;0;0;24;0
2020-06-27;TL;Timor;0;0;24;0
2020-06-28;TL;Timor;0;0;24;0
2020-06-29;TL;Timor;0;0;24;0
2020-06-30;TL;Timor;0;0;24;0
2020-07-01;TL;Timor;0;0;24;0
2020-07-02;TL;Timor;0;0;24;0
2020-07-03;TL;Timor;0;0;24;0
2020-07-04;TL;Timor;0;0;24;0
2020-07-05;TL;Timor;0;0;24;0
2020-07-06;TL;Timor;0;0;24;0
2020-07-07;TL;Timor;0;0;24;0
2020-07-08;TL;Timor;0;0;24;0
2020-07-09;TL;Timor;0;0;24;0
2020-07-10;TL;Timor;0;0;24;0
2020-07-11;TL;Timor;0;0;24;0
2020-07-12;TL;Timor;0;0;24;0
2020-07-13;TL;Timor;0;0;24;0
2020-07-14;TL;Timor;0;0;24;0
2020-07-15;TL;Timor;0;0;24;0
2020-07-16;TL;Timor;0;0;24;0
2020-07-17;TL;Timor;0;0;24;0
2020-07-18;TL;Timor;0;0;24;0
2020-07-19;TL;Timor;0;0;24;0
2020-07-20;TL;Timor;0;0;24;0
2020-07-21;TL;Timor;0;0;24;0
2020-07-22;TL;Timor;0;0;24;0
2020-07-23;TL;Timor;0;0;24;0
2020-07-24;TL;Timor;0;0;24;0
2020-07-25;TL;Timor;0;0;24;0
2020-07-26;TL;Timor;0;0;24;0
2020-07-27;TL;Timor;0;0;24;0
2020-07-28;TL;Timor;0;0;24;0
2020-07-29;TL;Timor;0;0;24;0
2020-07-30;TL;Timor;0;0;24;0
2020-07-31;TL;Timor;0;0;24;0
2020-08-01;TL;Timor;0;0;24;0
2020-08-02;TL;Timor;0;0;24;0
2020-08-03;TL;Timor;0;0;24;0
2020-08-04;TL;Timor;1;0;25;0
2020-08-05;TL;Timor;0;0;25;0
2020-08-06;TL;Timor;0;0;25;0
2020-08-07;TL;Timor;0;0;25;0
2020-08-08;TL;Timor;0;0;25;0
2020-08-09;TL;Timor;0;0;25;0
2020-08-10;TL;Timor;0;0;25;0
2020-08-11;TL;Timor;0;0;25;0
2020-08-12;TL;Timor;0;0;25;0
2020-08-13;TL;Timor;0;0;25;0
2020-08-14;TL;Timor;0;0;25;0
2020-08-15;TL;Timor;0;0;25;0
2020-08-16;TL;Timor;0;0;25;0
2020-08-17;TL;Timor;0;0;25;0
2020-08-18;TL;Timor;0;0;25;0
2020-08-19;TL;Timor;0;0;25;0
2020-08-20;TL;Timor;0;0;25;0
2020-08-21;TL;Timor;0;0;25;0
2020-08-22;TL;Timor;1;0;26;0
2020-08-23;TL;Timor;0;0;26;0
2020-08-24;TL;Timor;0;0;26;0
2020-08-25;TL;Timor;0;0;26;0
2020-08-26;TL;Timor;0;0;26;0
2020-08-27;TL;Timor;1;0;27;0
2020-08-28;TL;Timor;0;0;27;0
2020-08-29;TL;Timor;0;0;27;0
2020-08-30;TL;Timor;0;0;27;0
2020-08-31;TL;Timor;0;0;27;0
2020-09-01;TL;Timor;0;0;27;0
2020-09-02;TL;Timor;0;0;27;0
2020-09-03;TL;Timor;0;0;27;0
2020-09-04;TL;Timor;0;0;27;0
2020-09-05;TL;Timor;0;0;27;0
2020-09-06;TL;Timor;0;0;27;0
2020-09-07;TL;Timor;0;0;27;0
2020-09-08;TL;Timor;0;0;27;0
2020-09-09;TL;Timor;0;0;27;0
2020-09-10;TL;Timor;0;0;27;0
2020-09-11;TL;Timor;0;0;27;0
2020-09-12;TL;Timor;0;0;27;0
2020-09-13;TL;Timor;0;0;27;0
2020-09-14;TL;Timor;0;0;27;0
2020-09-15;TL;Timor;0;0;27;0
2020-09-16;TL;Timor;0;0;27;0
2020-09-17;TL;Timor;0;0;27;0
2020-09-18;TL;Timor;0;0;27;0
2020-09-19;TL;Timor;0;0;27;0
2020-09-20;TL;Timor;0;0;27;0
2020-09-21;TL;Timor;0;0;27;0
2020-09-22;TL;Timor;0;0;27;0
2020-09-23;TL;Timor;0;0;27;0
2020-09-24;TL;Timor;0;0;27;0
2020-09-25;TL;Timor;0;0;27;0
2020-09-26;TL;Timor;0;0;27;0
2020-09-27;TL;Timor;0;0;27;0
2020-09-28;TL;Timor;0;0;27;0
2020-09-29;TL;Timor;1;0;28;0
2020-09-30;TL;Timor;0;0;28;0
2020-10-01;TL;Timor;0;0;28;0
2020-10-02;TL;Timor;0;0;28;0
2020-10-03;TL;Timor;0;0;28;0
2020-10-04;TL;Timor;0;0;28;0
2020-10-05;TL;Timor;0;0;28;0
2020-10-06;TL;Timor;0;0;28;0
2020-10-07;TL;Timor;0;0;28;0
2020-10-08;TL;Timor;0;0;28;0
2020-10-09;TL;Timor;0;0;28;0
2020-10-10;TL;Timor;0;0;28;0
2020-10-11;TL;Timor;0;0;28;0
2020-10-12;TL;Timor;1;0;29;0
2020-10-13;TL;Timor;0;0;29;0
2020-10-14;TL;Timor;0;0;29;0
2020-10-15;TL;Timor;0;0;29;0
2020-10-16;TL;Timor;0;0;29;0
2020-10-17;TL;Timor;0;0;29;0
2020-10-18;TL;Timor;0;0;29;0
2020-10-19;TL;Timor;0;0;29;0
2020-10-20;TL;Timor;0;0;29;0
2020-10-21;TL;Timor;0;0;29;0
2020-10-22;TL;Timor;0;0;29;0
2020-10-23;TL;Timor;0;0;29;0
2020-10-24;TL;Timor;0;0;29;0
2020-10-25;TL;Timor;0;0;29;0
2020-10-26;TL;Timor;1;0;30;0
2020-10-27;TL;Timor;0;0;30;0
2020-10-28;TL;Timor;0;0;30;0
2020-10-29;TL;Timor;0;0;30;0
2020-10-30;TL;Timor;0;0;30;0
2020-10-31;TL;Timor;0;0;30;0
2020-11-01;TL;Timor;0;0;30;0
2020-11-02;TL;Timor;0;0;30;0
2020-11-03;TL;Timor;0;0;30;0
2020-11-04;TL;Timor;0;0;30;0
2020-11-05;TL;Timor;0;0;30;0
2020-11-06;TL;Timor;0;0;30;0
2020-11-07;TL;Timor;0;0;30;0
2020-11-08;TL;Timor;0;0;30;0
2020-11-09;TL;Timor;0;0;30;0
2020-11-10;TL;Timor;0;0;30;0
2020-11-11;TL;Timor;0;0;30;0
2020-11-12;TL;Timor;0;0;30;0
2020-11-13;TL;Timor;0;0;30;0
2020-11-14;TL;Timor;0;0;30;0
2020-11-15;TL;Timor;0;0;30;0
2020-11-16;TL;Timor;0;0;30;0
2020-11-17;TL;Timor;0;0;30;0
2020-11-18;TL;Timor;0;0;30;0
2020-11-19;TL;Timor;0;0;30;0
2020-11-20;TL;Timor;0;0;30;0
2020-11-21;TL;Timor;0;0;30;0
2020-11-22;TL;Timor;0;0;30;0
2020-11-23;TL;Timor;0;0;30;0
2020-11-24;TL;Timor;0;0;30;0
2020-11-25;TL;Timor;0;0;30;0
2020-11-26;TL;Timor;0;0;30;0
2020-11-27;TL;Timor;0;0;30;0
2020-11-28;TL;Timor;0;0;30;0
2020-11-29;TL;Timor;0;0;30;0
2020-11-30;TL;Timor;0;0;30;0
2020-12-01;TL;Timor;0;0;30;0
2020-12-02;TL;Timor;1;0;31;0
2020-12-03;TL;Timor;0;0;31;0
2020-12-04;TL;Timor;0;0;31;0
2020-12-05;TL;Timor;0;0;31;0
2020-12-06;TL;Timor;0;0;31;0
2020-12-07;TL;Timor;0;0;31;0
2020-12-08;TL;Timor;0;0;31;0
2020-12-09;TL;Timor;0;0;31;0
2020-12-10;TL;Timor;0;0;31;0
2020-12-11;TL;Timor;0;0;31;0
2020-12-12;TL;Timor;0;0;31;0
2020-12-13;TL;Timor;0;0;31;0
2020-12-14;TL;Timor;0;0;31;0
2020-12-15;TL;Timor;0;0;31;0
2020-12-16;TL;Timor;0;0;31;0
2020-12-17;TL;Timor;0;0;31;0
2020-12-18;TL;Timor;0;0;31;0
2020-12-19;TL;Timor;0;0;31;0
2020-12-20;TL;Timor;0;0;31;0
2020-12-21;TL;Timor;0;0;31;0
2020-12-22;TL;Timor;0;0;31;0
2020-12-23;TL;Timor;2;0;33;0
2020-12-24;TL;Timor;8;0;41;0
2020-12-25;TL;Timor;0;0;41;0
2020-12-26;TL;Timor;0;0;41;0
2020-12-27;TL;Timor;0;0;41;0
2020-12-28;TL;Timor;3;0;44;0
2020-12-29;TL;Timor;0;0;44;0
2020-12-30;TL;Timor;0;0;44;0
2020-12-31;TL;Timor;0;0;44;0
2021-01-01;TL;Timor;0;0;44;0
2021-01-02;TL;Timor;0;0;44;0
2021-01-03;TL;Timor;2;0;46;0
2021-01-04;TL;Timor;3;0;49;0
2021-01-05;TL;Timor;0;0;49;0
2021-01-06;TL;Timor;0;0;49;0
2021-01-07;TL;Timor;0;0;49;0
2021-01-08;TL;Timor;0;0;49;0
2021-01-09;TL;Timor;0;0;49;0
2021-01-10;TL;Timor;0;0;49;0
2021-01-11;TL;Timor;0;0;49;0
2021-01-12;TL;Timor;0;0;49;0
2021-01-13;TL;Timor;2;0;51;0
2021-01-14;TL;Timor;0;0;51;0
2021-01-15;TL;Timor;0;0;51;0
2021-01-16;TL;Timor;1;0;52;0
2021-01-17;TL;Timor;0;0;52;0
2021-01-18;TL;Timor;0;0;52;0
2021-01-19;TL;Timor;0;0;52;0
2021-01-20;TL;Timor;1;0;53;0
2021-01-21;TL;Timor;0;0;53;0
2021-01-22;TL;Timor;0;0;53;0
2021-01-23;TL;Timor;11;0;64;0
2021-01-24;TL;Timor;3;0;67;0
2021-01-25;TL;Timor;0;0;67;0
2021-01-26;TL;Timor;0;0;67;0
2021-01-27;TL;Timor;1;0;68;0
2021-01-28;TL;Timor;0;0;68;0
2021-01-29;TL;Timor;1;0;69;0
2021-01-30;TL;Timor;1;0;70;0
2021-01-31;TL;Timor;0;0;70;0
2021-02-01;TL;Timor;0;0;70;0
2021-02-02;TL;Timor;5;0;75;0
2021-02-03;TL;Timor;2;0;77;0
2021-02-04;TL;Timor;3;0;80;0
2021-02-05;TL;Timor;0;0;80;0
2021-02-06;TL;Timor;0;0;80;0
2021-02-07;TL;Timor;0;0;80;0
2021-02-08;TL;Timor;0;0;80;0
2021-02-09;TL;Timor;6;0;86;0
2021-02-10;TL;Timor;0;0;86;0
2021-02-11;TL;Timor;14;0;100;0
2021-02-12;TL;Timor;0;0;100;0
2021-02-13;TL;Timor;1;0;101;0
2021-02-14;TL;Timor;1;0;102;0
2021-02-15;TL;Timor;0;0;102;0
2021-02-16;TL;Timor;0;0;102;0
2021-02-17;TL;Timor;0;0;102;0
2021-02-18;TL;Timor;1;0;103;0
2021-02-19;TL;Timor;0;0;103;0
2021-02-20;TL;Timor;0;0;103;0
2021-02-21;TL;Timor;0;0;103;0
2021-02-22;TL;Timor;0;0;103;0
2021-02-23;TL;Timor;4;0;107;0
2021-02-24;TL;Timor;2;0;109;0
2021-02-25;TL;Timor;1;0;110;0
2021-02-26;TL;Timor;0;0;110;0
2021-02-27;TL;Timor;1;0;111;0
2021-02-28;TL;Timor;2;0;113;0
2021-03-01;TL;Timor;0;0;113;0
2021-03-02;TL;Timor;0;0;113;0
2021-03-03;TL;Timor;0;0;113;0
2021-03-04;TL;Timor;0;0;113;0
2021-03-05;TL;Timor;6;0;119;0
2021-03-06;TL;Timor;0;0;119;0
2021-03-07;TL;Timor;3;0;122;0
2021-03-08;TL;Timor;7;0;129;0
2021-03-09;TL;Timor;13;0;142;0
2021-03-10;TL;Timor;3;0;145;0
2021-03-11;TL;Timor;14;0;159;0
2021-03-12;TL;Timor;11;0;170;0
2021-03-13;TL;Timor;8;0;178;0
2021-03-14;TL;Timor;18;0;196;0
2021-03-15;TL;Timor;7;0;203;0
2021-03-16;TL;Timor;5;0;208;0
2021-03-17;TL;Timor;8;0;216;0
2021-03-18;TL;Timor;13;0;229;0
2021-03-19;TL;Timor;23;0;252;0
2021-03-20;TL;Timor;19;0;271;0
2021-03-21;TL;Timor;55;0;326;0
2021-03-22;TL;Timor;9;0;335;0
2021-03-23;TL;Timor;16;0;351;0
2021-03-24;TL;Timor;21;0;372;0
2021-03-25;TL;Timor;22;0;394;0
2021-03-26;TL;Timor;58;0;452;0
2021-03-27;TL;Timor;28;0;480;0
2021-03-28;TL;Timor;11;0;491;0
2021-03-29;TL;Timor;21;0;512;0
2021-03-30;TL;Timor;51;0;563;0
2021-03-31;TL;Timor;41;0;604;0
2021-04-01;TL;Timor;39;0;643;0
2021-04-02;TL;Timor;34;0;677;0
2021-04-03;TL;Timor;37;0;714;0
2021-04-04;TL;Timor;0;0;714;0
2021-04-05;TL;Timor;52;0;766;0
2021-04-06;TL;Timor;13;1;779;1
2021-04-07;TL;Timor;0;0;779;1
2021-04-08;TL;Timor;8;0;787;1
2021-04-09;TL;Timor;90;0;877;1
2021-04-10;TL;Timor;70;0;947;1
2021-04-11;TL;Timor;0;0;947;1
2021-04-12;TL;Timor;99;0;1046;1
2021-04-13;TL;Timor;28;1;1074;2
2021-04-14;TL;Timor;29;0;1103;2
2021-04-15;TL;Timor;35;0;1138;2
2021-04-16;TL;Timor;55;0;1193;2
2021-04-17;TL;Timor;43;0;1236;2
2021-04-18;TL;Timor;70;0;1306;2
2021-04-19;TL;Timor;62;0;1368;2
2021-04-20;TL;Timor;84;0;1452;2
2021-04-21;TL;Timor;57;0;1509;2
2021-04-22;TL;Timor;148;1;1657;3
2021-04-23;TL;Timor;0;0;1657;3
2021-04-24;TL;Timor;82;0;1739;3
2021-04-25;TL;Timor;158;0;1897;3
2021-04-26;TL;Timor;52;0;1949;3
2021-04-27;TL;Timor;99;0;2048;3
2021-04-28;TL;Timor;76;0;2124;3
2021-04-29;TL;Timor;66;0;2190;3
2021-04-30;TL;Timor;86;0;2276;3
2021-05-01;TL;Timor;0;0;2276;3
2021-05-02;TL;Timor;168;1;2444;4
2021-05-03;TL;Timor;80;0;2524;4
2021-05-04;TL;Timor;129;0;2653;4
2021-05-05;TL;Timor;133;0;2786;4
2021-05-06;TL;Timor;84;0;2870;4
2021-05-07;TL;Timor;95;0;2965;4
2021-05-08;TL;Timor;146;0;3111;4
2021-05-09;TL;Timor;116;0;3227;4
2021-05-10;TL;Timor;126;1;3353;5
2021-05-11;TL;Timor;140;0;3493;5
2021-05-12;TL;Timor;133;0;3626;5
2021-05-13;TL;Timor;253;3;3879;8
2021-05-14;TL;Timor;239;0;4118;8
2021-05-15;TL;Timor;161;0;4279;8
2021-05-16;TL;Timor;179;2;4458;10
2021-05-17;TL;Timor;131;0;4589;10
2021-05-18;TL;Timor;176;0;4765;10
2021-05-19;TL;Timor;184;1;4949;11
2021-05-20;TL;Timor;172;0;5121;11
2021-05-21;TL;Timor;166;0;5287;11
2021-05-22;TL;Timor;194;0;5481;11
2021-05-23;TL;Timor;156;2;5637;13
2021-05-24;TL;Timor;179;0;5816;13
2021-05-25;TL;Timor;0;0;5816;13
2021-05-26;TL;Timor;429;1;6245;14
2021-05-27;TL;Timor;214;1;6459;15
2021-05-28;TL;Timor;163;0;6622;15
2021-05-29;TL;Timor;130;1;6752;16
2021-05-30;TL;Timor;145;0;6897;16
2021-05-31;TL;Timor;97;0;6994;16
2021-06-01;TL;Timor;167;0;7161;16
2021-06-02;TL;Timor;149;0;7310;16
2021-06-03;TL;Timor;112;0;7422;16
2021-06-04;TL;Timor;89;1;7511;17
2021-06-05;TL;Timor;148;0;7659;17
2021-06-06;TL;Timor;81;0;7740;17
2021-06-07;TL;Timor;24;0;7764;17
2021-06-08;TL;Timor;0;0;7764;17
2021-06-09;TL;Timor;177;1;7941;18
2021-06-10;TL;Timor;172;0;8113;18
2021-06-11;TL;Timor;32;0;8145;18
2021-06-12;TL;Timor;83;0;8228;18
2021-06-13;TL;Timor;57;0;8285;18
2021-06-14;TL;Timor;56;1;8341;19
2021-06-15;TL;Timor;71;0;8412;19
2021-06-16;TL;Timor;66;0;8478;19
2021-06-17;TL;Timor;26;0;8504;19
2021-06-18;TL;Timor;98;0;8602;19
2021-06-19;TL;Timor;76;0;8678;19
2021-06-20;TL;Timor;29;0;8707;19
2021-06-21;TL;Timor;21;0;8728;19
2021-06-22;TL;Timor;53;0;8781;19
2021-06-23;TL;Timor;62;0;8843;19
2021-06-24;TL;Timor;46;1;8889;20
2021-06-25;TL;Timor;23;0;8912;20
2021-06-26;TL;Timor;67;1;8979;21
2021-06-27;TL;Timor;56;0;9035;21
2021-06-28;TL;Timor;20;0;9055;21
2021-06-29;TL;Timor;63;1;9118;22
2021-06-30;TL;Timor;104;1;9222;23
2021-07-01;TL;Timor;56;1;9278;24
2020-03-04;TG;Togo;0;0;0;0
2020-03-05;TG;Togo;0;0;0;0
2020-03-06;TG;Togo;1;0;1;0
2020-03-07;TG;Togo;0;0;1;0
2020-03-08;TG;Togo;0;0;1;0
2020-03-09;TG;Togo;0;0;1;0
2020-03-10;TG;Togo;0;0;1;0
2020-03-11;TG;Togo;0;0;1;0
2020-03-12;TG;Togo;0;0;1;0
2020-03-13;TG;Togo;0;0;1;0
2020-03-14;TG;Togo;0;0;1;0
2020-03-15;TG;Togo;0;0;1;0
2020-03-16;TG;Togo;0;0;1;0
2020-03-17;TG;Togo;0;0;1;0
2020-03-18;TG;Togo;0;0;1;0
2020-03-19;TG;Togo;0;0;1;0
2020-03-20;TG;Togo;8;0;9;0
2020-03-21;TG;Togo;7;0;16;0
2020-03-22;TG;Togo;0;0;16;0
2020-03-23;TG;Togo;2;0;18;0
2020-03-24;TG;Togo;2;0;20;0
2020-03-25;TG;Togo;3;0;23;0
2020-03-26;TG;Togo;0;0;23;0
2020-03-27;TG;Togo;2;1;25;1
2020-03-28;TG;Togo;0;0;25;1
2020-03-29;TG;Togo;0;0;25;1
2020-03-30;TG;Togo;5;0;30;1
2020-03-31;TG;Togo;4;0;34;1
2020-04-01;TG;Togo;2;1;36;2
2020-04-02;TG;Togo;3;0;39;2
2020-04-03;TG;Togo;1;1;40;3
2020-04-04;TG;Togo;1;0;41;3
2020-04-05;TG;Togo;3;0;44;3
2020-04-06;TG;Togo;14;0;58;3
2020-04-07;TG;Togo;7;0;65;3
2020-04-08;TG;Togo;5;0;70;3
2020-04-09;TG;Togo;3;0;73;3
2020-04-10;TG;Togo;3;0;76;3
2020-04-11;TG;Togo;0;0;76;3
2020-04-12;TG;Togo;0;0;76;3
2020-04-13;TG;Togo;1;0;77;3
2020-04-14;TG;Togo;0;0;77;3
2020-04-15;TG;Togo;4;0;81;3
2020-04-16;TG;Togo;0;2;81;5
2020-04-17;TG;Togo;2;0;83;5
2020-04-18;TG;Togo;1;0;84;5
2020-04-19;TG;Togo;0;0;84;5
2020-04-20;TG;Togo;0;1;84;6
2020-04-21;TG;Togo;2;0;86;6
2020-04-22;TG;Togo;2;0;88;6
2020-04-23;TG;Togo;0;0;88;6
2020-04-24;TG;Togo;2;0;90;6
2020-04-25;TG;Togo;6;0;96;6
2020-04-26;TG;Togo;2;0;98;6
2020-04-27;TG;Togo;0;0;98;6
2020-04-28;TG;Togo;1;0;99;6
2020-04-29;TG;Togo;10;1;109;7
2020-04-30;TG;Togo;7;2;116;9
2020-05-01;TG;Togo;7;0;123;9
2020-05-02;TG;Togo;0;0;123;9
2020-05-03;TG;Togo;1;0;124;9
2020-05-04;TG;Togo;2;0;126;9
2020-05-05;TG;Togo;2;0;128;9
2020-05-06;TG;Togo;0;0;128;9
2020-05-07;TG;Togo;7;0;135;9
2020-05-08;TG;Togo;10;1;145;10
2020-05-09;TG;Togo;8;0;153;10
2020-05-10;TG;Togo;21;1;174;11
2020-05-11;TG;Togo;7;0;181;11
2020-05-12;TG;Togo;18;0;199;11
2020-05-13;TG;Togo;20;0;219;11
2020-05-14;TG;Togo;19;0;238;11
2020-05-15;TG;Togo;25;0;263;11
2020-05-16;TG;Togo;35;0;298;11
2020-05-17;TG;Togo;3;0;301;11
2020-05-18;TG;Togo;29;1;330;12
2020-05-19;TG;Togo;8;0;338;12
2020-05-20;TG;Togo;2;0;340;12
2020-05-21;TG;Togo;14;0;354;12
2020-05-22;TG;Togo;9;0;363;12
2020-05-23;TG;Togo;10;0;373;12
2020-05-24;TG;Togo;8;0;381;12
2020-05-25;TG;Togo;5;1;386;13
2020-05-26;TG;Togo;5;0;391;13
2020-05-27;TG;Togo;4;0;395;13
2020-05-28;TG;Togo;27;0;422;13
2020-05-29;TG;Togo;6;0;428;13
2020-05-30;TG;Togo;5;0;433;13
2020-05-31;TG;Togo;9;0;442;13
2020-06-01;TG;Togo;1;0;443;13
2020-06-02;TG;Togo;2;0;445;13
2020-06-03;TG;Togo;7;0;452;13
2020-06-04;TG;Togo;13;0;465;13
2020-06-05;TG;Togo;20;0;485;13
2020-06-06;TG;Togo;2;0;487;13
2020-06-07;TG;Togo;8;0;495;13
2020-06-08;TG;Togo;2;0;497;13
2020-06-09;TG;Togo;4;0;501;13
2020-06-10;TG;Togo;21;0;522;13
2020-06-11;TG;Togo;2;0;524;13
2020-06-12;TG;Togo;1;0;525;13
2020-06-13;TG;Togo;5;0;530;13
2020-06-14;TG;Togo;0;0;530;13
2020-06-15;TG;Togo;1;0;531;13
2020-06-16;TG;Togo;6;0;537;13
2020-06-17;TG;Togo;7;0;544;13
2020-06-18;TG;Togo;3;0;547;13
2020-06-19;TG;Togo;8;0;555;13
2020-06-20;TG;Togo;6;0;561;13
2020-06-21;TG;Togo;8;0;569;13
2020-06-22;TG;Togo;0;0;569;13
2020-06-23;TG;Togo;7;0;576;13
2020-06-24;TG;Togo;7;1;583;14
2020-06-25;TG;Togo;5;0;588;14
2020-06-26;TG;Togo;3;0;591;14
2020-06-27;TG;Togo;24;0;615;14
2020-06-28;TG;Togo;27;0;642;14
2020-06-29;TG;Togo;1;0;643;14
2020-06-30;TG;Togo;7;0;650;14
2020-07-01;TG;Togo;11;0;661;14
2020-07-02;TG;Togo;6;0;667;14
2020-07-03;TG;Togo;4;0;671;14
2020-07-04;TG;Togo;5;1;676;15
2020-07-05;TG;Togo;4;0;680;15
2020-07-06;TG;Togo;0;0;680;15
2020-07-07;TG;Togo;9;0;689;15
2020-07-08;TG;Togo;6;0;695;15
2020-07-09;TG;Togo;9;0;704;15
2020-07-10;TG;Togo;6;0;710;15
2020-07-11;TG;Togo;0;0;710;15
2020-07-12;TG;Togo;10;0;720;15
2020-07-13;TG;Togo;1;0;721;15
2020-07-14;TG;Togo;10;0;731;15
2020-07-15;TG;Togo;9;0;740;15
2020-07-16;TG;Togo;9;0;749;15
2020-07-17;TG;Togo;17;0;766;15
2020-07-18;TG;Togo;8;0;774;15
2020-07-19;TG;Togo;4;0;778;15
2020-07-20;TG;Togo;5;0;783;15
2020-07-21;TG;Togo;7;0;790;15
2020-07-22;TG;Togo;16;1;806;16
2020-07-23;TG;Togo;22;0;828;16
2020-07-24;TG;Togo;11;1;839;17
2020-07-25;TG;Togo;14;0;853;17
2020-07-26;TG;Togo;15;1;868;18
2020-07-27;TG;Togo;6;0;874;18
2020-07-28;TG;Togo;22;0;896;18
2020-07-29;TG;Togo;0;0;896;18
2020-07-30;TG;Togo;12;0;908;18
2020-07-31;TG;Togo;33;1;941;19
2020-08-01;TG;Togo;17;0;958;19
2020-08-02;TG;Togo;3;0;961;19
2020-08-03;TG;Togo;15;0;976;19
2020-08-04;TG;Togo;12;0;988;19
2020-08-05;TG;Togo;13;2;1001;21
2020-08-06;TG;Togo;11;1;1012;22
2020-08-07;TG;Togo;16;0;1028;22
2020-08-08;TG;Togo;18;1;1046;23
2020-08-09;TG;Togo;14;0;1060;23
2020-08-10;TG;Togo;7;2;1067;25
2020-08-11;TG;Togo;3;1;1070;26
2020-08-12;TG;Togo;22;0;1092;26
2020-08-13;TG;Togo;12;0;1104;26
2020-08-14;TG;Togo;20;0;1124;26
2020-08-15;TG;Togo;6;1;1130;27
2020-08-16;TG;Togo;17;0;1147;27
2020-08-17;TG;Togo;7;0;1154;27
2020-08-18;TG;Togo;19;0;1173;27
2020-08-19;TG;Togo;17;0;1190;27
2020-08-20;TG;Togo;22;0;1212;27
2020-08-21;TG;Togo;27;0;1239;27
2020-08-22;TG;Togo;36;0;1275;27
2020-08-23;TG;Togo;2;0;1277;27
2020-08-24;TG;Togo;18;0;1295;27
2020-08-25;TG;Togo;14;0;1309;27
2020-08-26;TG;Togo;17;0;1326;27
2020-08-27;TG;Togo;0;0;1326;27
2020-08-28;TG;Togo;39;0;1365;27
2020-08-29;TG;Togo;25;0;1390;27
2020-08-30;TG;Togo;6;0;1396;27
2020-08-31;TG;Togo;4;1;1400;28
2020-09-01;TG;Togo;16;0;1416;28
2020-09-02;TG;Togo;18;2;1434;30
2020-09-03;TG;Togo;9;1;1443;31
2020-09-04;TG;Togo;14;0;1457;31
2020-09-05;TG;Togo;20;1;1477;32
2020-09-06;TG;Togo;11;0;1488;32
2020-09-07;TG;Togo;5;1;1493;33
2020-09-08;TG;Togo;20;1;1513;34
2020-09-09;TG;Togo;15;2;1528;36
2020-09-10;TG;Togo;9;1;1537;37
2020-09-11;TG;Togo;11;0;1548;37
2020-09-12;TG;Togo;7;0;1555;37
2020-09-13;TG;Togo;17;0;1572;37
2020-09-14;TG;Togo;6;3;1578;40
2020-09-15;TG;Togo;17;0;1595;40
2020-09-16;TG;Togo;13;0;1608;40
2020-09-17;TG;Togo;10;1;1618;41
2020-09-18;TG;Togo;22;0;1640;41
2020-09-19;TG;Togo;19;0;1659;41
2020-09-20;TG;Togo;7;0;1666;41
2020-09-21;TG;Togo;3;0;1669;41
2020-09-22;TG;Togo;14;0;1683;41
2020-09-23;TG;Togo;18;0;1701;41
2020-09-24;TG;Togo;6;3;1707;44
2020-09-25;TG;Togo;15;0;1722;44
2020-09-26;TG;Togo;14;2;1736;46
2020-09-27;TG;Togo;7;0;1743;46
2020-09-28;TG;Togo;6;1;1749;47
2020-09-29;TG;Togo;10;1;1759;48
2020-09-30;TG;Togo;25;0;1784;48
2020-10-01;TG;Togo;25;0;1809;48
2020-10-02;TG;Togo;9;0;1818;48
2020-10-03;TG;Togo;22;0;1840;48
2020-10-04;TG;Togo;14;0;1854;48
2020-10-05;TG;Togo;10;0;1864;48
2020-10-06;TG;Togo;17;1;1881;49
2020-10-07;TG;Togo;17;0;1898;49
2020-10-08;TG;Togo;9;0;1907;49
2020-10-09;TG;Togo;14;0;1921;49
2020-10-10;TG;Togo;14;0;1935;49
2020-10-11;TG;Togo;5;0;1940;49
2020-10-12;TG;Togo;9;0;1949;49
2020-10-13;TG;Togo;23;1;1972;50
2020-10-14;TG;Togo;11;1;1983;51
2020-10-15;TG;Togo;13;0;1996;51
2020-10-16;TG;Togo;31;0;2027;51
2020-10-17;TG;Togo;22;0;2049;51
2020-10-18;TG;Togo;8;0;2057;51
2020-10-19;TG;Togo;14;0;2071;51
2020-10-20;TG;Togo;33;0;2104;51
2020-10-21;TG;Togo;16;0;2120;51
2020-10-22;TG;Togo;19;1;2139;52
2020-10-23;TG;Togo;23;0;2162;52
2020-10-24;TG;Togo;25;0;2187;52
2020-10-25;TG;Togo;13;0;2200;52
2020-10-26;TG;Togo;4;1;2204;53
2020-10-27;TG;Togo;25;1;2229;54
2020-10-28;TG;Togo;9;0;2238;54
2020-10-29;TG;Togo;58;1;2296;55
2020-10-30;TG;Togo;16;0;2312;55
2020-10-31;TG;Togo;19;2;2331;57
2020-11-01;TG;Togo;26;0;2357;57
2020-11-02;TG;Togo;7;0;2364;57
2020-11-03;TG;Togo;17;0;2381;57
2020-11-04;TG;Togo;25;0;2406;57
2020-11-05;TG;Togo;36;0;2442;57
2020-11-06;TG;Togo;18;0;2460;57
2020-11-07;TG;Togo;23;0;2483;57
2020-11-08;TG;Togo;33;0;2516;57
2020-11-09;TG;Togo;7;0;2523;57
2020-11-10;TG;Togo;35;0;2558;57
2020-11-11;TG;Togo;35;2;2593;59
2020-11-12;TG;Togo;12;1;2605;60
2020-11-13;TG;Togo;22;0;2627;60
2020-11-14;TG;Togo;24;1;2651;61
2020-11-15;TG;Togo;24;0;2675;61
2020-11-16;TG;Togo;18;0;2693;61
2020-11-17;TG;Togo;29;1;2722;62
2020-11-18;TG;Togo;30;1;2752;63
2020-11-19;TG;Togo;19;0;2771;63
2020-11-20;TG;Togo;25;1;2796;64
2020-11-21;TG;Togo;33;0;2829;64
2020-11-22;TG;Togo;14;0;2843;64
2020-11-23;TG;Togo;11;0;2854;64
2020-11-24;TG;Togo;18;0;2872;64
2020-11-25;TG;Togo;17;0;2889;64
2020-11-26;TG;Togo;15;0;2904;64
2020-11-27;TG;Togo;22;0;2926;64
2020-11-28;TG;Togo;20;0;2946;64
2020-11-29;TG;Togo;16;0;2962;64
2020-11-30;TG;Togo;12;0;2974;64
2020-12-01;TG;Togo;23;0;2997;64
2020-12-02;TG;Togo;17;1;3014;65
2020-12-03;TG;Togo;25;0;3039;65
2020-12-04;TG;Togo;12;0;3051;65
2020-12-05;TG;Togo;0;0;3051;65
2020-12-06;TG;Togo;44;0;3095;65
2020-12-07;TG;Togo;16;0;3111;65
2020-12-08;TG;Togo;21;0;3132;65
2020-12-09;TG;Togo;19;0;3151;65
2020-12-10;TG;Togo;31;1;3182;66
2020-12-11;TG;Togo;20;0;3202;66
2020-12-12;TG;Togo;19;0;3221;66
2020-12-13;TG;Togo;30;0;3251;66
2020-12-14;TG;Togo;15;0;3266;66
2020-12-15;TG;Togo;29;0;3295;66
2020-12-16;TG;Togo;20;0;3315;66
2020-12-17;TG;Togo;15;0;3330;66
2020-12-18;TG;Togo;20;0;3350;66
2020-12-19;TG;Togo;46;0;3396;66
2020-12-20;TG;Togo;20;0;3416;66
2020-12-21;TG;Togo;20;0;3436;66
2020-12-22;TG;Togo;31;0;3467;66
2020-12-23;TG;Togo;27;2;3494;68
2020-12-24;TG;Togo;26;0;3520;68
2020-12-25;TG;Togo;26;0;3546;68
2020-12-26;TG;Togo;9;0;3555;68
2020-12-27;TG;Togo;0;0;3555;68
2020-12-28;TG;Togo;21;0;3576;68
2020-12-29;TG;Togo;28;0;3604;68
2020-12-30;TG;Togo;7;0;3611;68
2020-12-31;TG;Togo;22;0;3633;68
2021-01-01;TG;Togo;29;0;3662;68
2021-01-02;TG;Togo;21;0;3683;68
2021-01-03;TG;Togo;19;0;3702;68
2021-01-04;TG;Togo;20;1;3722;69
2021-01-05;TG;Togo;48;0;3770;69
2021-01-06;TG;Togo;37;1;3807;70
2021-01-07;TG;Togo;38;2;3845;72
2021-01-08;TG;Togo;49;0;3894;72
2021-01-09;TG;Togo;38;0;3932;72
2021-01-10;TG;Togo;25;0;3957;72
2021-01-11;TG;Togo;21;1;3978;73
2021-01-12;TG;Togo;67;0;4045;73
2021-01-13;TG;Togo;64;0;4109;73
2021-01-14;TG;Togo;56;0;4165;73
2021-01-15;TG;Togo;55;0;4220;73
2021-01-16;TG;Togo;52;0;4272;73
2021-01-17;TG;Togo;30;0;4302;73
2021-01-18;TG;Togo;22;1;4324;74
2021-01-19;TG;Togo;59;0;4383;74
2021-01-20;TG;Togo;76;0;4459;74
2021-01-21;TG;Togo;46;0;4505;74
2021-01-22;TG;Togo;40;0;4545;74
2021-01-23;TG;Togo;91;0;4636;74
2021-01-24;TG;Togo;26;1;4662;75
2021-01-25;TG;Togo;20;1;4682;76
2021-01-26;TG;Togo;0;0;4682;76
2021-01-27;TG;Togo;188;0;4870;76
2021-01-28;TG;Togo;52;0;4922;76
2021-01-29;TG;Togo;0;0;4922;76
2021-01-30;TG;Togo;119;1;5041;77
2021-01-31;TG;Togo;33;0;5074;77
2021-02-01;TG;Togo;18;2;5092;79
2021-02-02;TG;Togo;74;0;5166;79
2021-02-03;TG;Togo;58;0;5224;79
2021-02-04;TG;Togo;66;0;5290;79
2021-02-05;TG;Togo;66;0;5356;79
2021-02-06;TG;Togo;80;0;5436;79
2021-02-07;TG;Togo;47;1;5483;80
2021-02-08;TG;Togo;13;0;5496;80
2021-02-09;TG;Togo;80;0;5576;80
2021-02-10;TG;Togo;30;0;5606;80
2021-02-11;TG;Togo;81;0;5687;80
2021-02-12;TG;Togo;70;0;5757;80
2021-02-13;TG;Togo;66;0;5823;80
2021-02-14;TG;Togo;51;1;5874;81
2021-02-15;TG;Togo;8;0;5882;81
2021-02-16;TG;Togo;71;0;5953;81
2021-02-17;TG;Togo;54;0;6007;81
2021-02-18;TG;Togo;78;0;6085;81
2021-02-19;TG;Togo;97;0;6182;81
2021-02-20;TG;Togo;86;0;6268;81
2021-02-21;TG;Togo;51;0;6319;81
2021-02-22;TG;Togo;29;0;6348;81
2021-02-23;TG;Togo;118;0;6466;81
2021-02-24;TG;Togo;82;1;6548;82
2021-02-25;TG;Togo;89;0;6637;82
2021-02-26;TG;Togo;93;0;6730;82
2021-02-27;TG;Togo;121;1;6851;83
2021-02-28;TG;Togo;50;1;6901;84
2021-03-01;TG;Togo;32;1;6933;85
2021-03-02;TG;Togo;153;0;7086;85
2021-03-03;TG;Togo;102;0;7188;85
2021-03-04;TG;Togo;135;3;7323;88
2021-03-05;TG;Togo;105;0;7428;88
2021-03-06;TG;Togo;93;2;7521;90
2021-03-07;TG;Togo;49;2;7570;92
2021-03-08;TG;Togo;28;0;7598;92
2021-03-09;TG;Togo;82;0;7680;92
2021-03-10;TG;Togo;57;0;7737;92
2021-03-11;TG;Togo;120;1;7857;93
2021-03-12;TG;Togo;96;0;7953;93
2021-03-13;TG;Togo;0;0;7953;93
2021-03-14;TG;Togo;117;2;8070;95
2021-03-15;TG;Togo;152;1;8222;96
2021-03-16;TG;Togo;100;1;8322;97
2021-03-17;TG;Togo;150;1;8472;98
2021-03-18;TG;Togo;110;4;8582;102
2021-03-19;TG;Togo;113;0;8695;102
2021-03-20;TG;Togo;144;0;8839;102
2021-03-21;TG;Togo;79;2;8918;104
2021-03-22;TG;Togo;42;0;8960;104
2021-03-23;TG;Togo;187;1;9147;105
2021-03-24;TG;Togo;0;0;9147;105
2021-03-25;TG;Togo;359;2;9506;107
2021-03-26;TG;Togo;170;0;9676;107
2021-03-27;TG;Togo;0;0;9676;107
2021-03-28;TG;Togo;279;0;9955;107
2021-03-29;TG;Togo;37;0;9992;107
2021-03-30;TG;Togo;257;2;10249;109
2021-03-31;TG;Togo;0;0;10249;109
2021-04-01;TG;Togo;405;1;10654;110
2021-04-02;TG;Togo;194;0;10848;110
2021-04-03;TG;Togo;216;0;11064;110
2021-04-04;TG;Togo;123;2;11187;112
2021-04-05;TG;Togo;62;0;11249;112
2021-04-06;TG;Togo;61;1;11310;113
2021-04-07;TG;Togo;191;0;11501;113
2021-04-08;TG;Togo;148;2;11649;115
2021-04-09;TG;Togo;165;1;11814;116
2021-04-10;TG;Togo;133;0;11947;116
2021-04-11;TG;Togo;59;0;12006;116
2021-04-12;TG;Togo;28;0;12034;116
2021-04-13;TG;Togo;0;0;12034;116
2021-04-14;TG;Togo;180;1;12214;117
2021-04-15;TG;Togo;0;0;12214;117
2021-04-16;TG;Togo;177;2;12391;119
2021-04-17;TG;Togo;105;0;12496;119
2021-04-18;TG;Togo;37;0;12533;119
2021-04-19;TG;Togo;20;1;12553;120
2021-04-20;TG;Togo;57;1;12610;121
2021-04-21;TG;Togo;47;0;12657;121
2021-04-22;TG;Togo;41;0;12698;121
2021-04-23;TG;Togo;44;0;12742;121
2021-04-24;TG;Togo;45;0;12787;121
2021-04-25;TG;Togo;0;0;12787;121
2021-04-26;TG;Togo;40;1;12827;122
2021-04-27;TG;Togo;57;0;12884;122
2021-04-28;TG;Togo;14;0;12898;122
2021-04-29;TG;Togo;33;1;12931;123
2021-04-30;TG;Togo;36;0;12967;123
2021-05-01;TG;Togo;25;0;12992;123
2021-05-02;TG;Togo;18;0;13010;123
2021-05-03;TG;Togo;0;0;13010;123
2021-05-04;TG;Togo;27;0;13037;123
2021-05-05;TG;Togo;31;0;13068;123
2021-05-06;TG;Togo;0;0;13068;123
2021-05-07;TG;Togo;38;1;13106;124
2021-05-08;TG;Togo;0;0;13106;124
2021-05-09;TG;Togo;48;0;13154;124
2021-05-10;TG;Togo;13;1;13167;125
2021-05-11;TG;Togo;0;0;13167;125
2021-05-12;TG;Togo;43;0;13210;125
2021-05-13;TG;Togo;28;0;13238;125
2021-05-14;TG;Togo;6;0;13244;125
2021-05-15;TG;Togo;21;0;13265;125
2021-05-16;TG;Togo;10;0;13275;125
2021-05-17;TG;Togo;4;0;13279;125
2021-05-18;TG;Togo;7;0;13286;125
2021-05-19;TG;Togo;13;0;13299;125
2021-05-20;TG;Togo;41;0;13340;125
2021-05-21;TG;Togo;12;0;13352;125
2021-05-22;TG;Togo;11;0;13363;125
2021-05-23;TG;Togo;11;0;13374;125
2021-05-24;TG;Togo;0;0;13374;125
2021-05-25;TG;Togo;10;0;13384;125
2021-05-26;TG;Togo;12;0;13396;125
2021-05-27;TG;Togo;24;0;13420;125
2021-05-28;TG;Togo;12;0;13432;125
2021-05-29;TG;Togo;0;0;13432;125
2021-05-30;TG;Togo;25;0;13457;125
2021-05-31;TG;Togo;9;0;13466;125
2021-06-01;TG;Togo;15;0;13481;125
2021-06-02;TG;Togo;15;0;13496;125
2021-06-03;TG;Togo;17;0;13513;125
2021-06-04;TG;Togo;9;0;13522;125
2021-06-05;TG;Togo;11;0;13533;125
2021-06-06;TG;Togo;6;0;13539;125
2021-06-07;TG;Togo;3;0;13542;125
2021-06-08;TG;Togo;9;0;13551;125
2021-06-09;TG;Togo;12;1;13563;126
2021-06-10;TG;Togo;13;0;13576;126
2021-06-11;TG;Togo;21;0;13597;126
2021-06-12;TG;Togo;0;0;13597;126
2021-06-13;TG;Togo;30;0;13627;126
2021-06-14;TG;Togo;4;0;13631;126
2021-06-15;TG;Togo;20;0;13651;126
2021-06-16;TG;Togo;18;1;13669;127
2021-06-17;TG;Togo;13;0;13682;127
2021-06-18;TG;Togo;19;0;13701;127
2021-06-19;TG;Togo;14;0;13715;127
2021-06-20;TG;Togo;6;1;13721;128
2021-06-21;TG;Togo;10;0;13731;128
2021-06-22;TG;Togo;4;0;13735;128
2021-06-23;TG;Togo;14;0;13749;128
2021-06-24;TG;Togo;0;0;13749;128
2021-06-25;TG;Togo;39;0;13788;128
2021-06-26;TG;Togo;0;0;13788;128
2021-06-27;TG;Togo;28;0;13816;128
2021-06-28;TG;Togo;30;0;13846;128
2021-06-29;TG;Togo;35;1;13881;129
2021-06-30;TG;Togo;36;0;13917;129
2021-07-01;TG;Togo;45;1;13962;130
2021-04-20;TO;Tonga;0;0;0;0
2021-04-21;TO;Tonga;0;0;0;0
2021-04-22;TO;Tonga;0;0;0;0
2021-04-23;TO;Tonga;0;0;0;0
2021-04-24;TO;Tonga;0;0;0;0
2021-04-25;TO;Tonga;0;0;0;0
2021-04-26;TO;Tonga;0;0;0;0
2021-04-27;TO;Tonga;0;0;0;0
2021-04-28;TO;Tonga;0;0;0;0
2021-04-29;TO;Tonga;0;0;0;0
2021-04-30;TO;Tonga;0;0;0;0
2021-05-01;TO;Tonga;0;0;0;0
2021-05-02;TO;Tonga;0;0;0;0
2021-05-03;TO;Tonga;0;0;0;0
2021-05-04;TO;Tonga;0;0;0;0
2021-05-05;TO;Tonga;0;0;0;0
2021-05-06;TO;Tonga;0;0;0;0
2021-05-07;TO;Tonga;0;0;0;0
2021-05-08;TO;Tonga;0;0;0;0
2021-05-09;TO;Tonga;0;0;0;0
2021-05-10;TO;Tonga;0;0;0;0
2021-05-11;TO;Tonga;0;0;0;0
2021-05-12;TO;Tonga;0;0;0;0
2021-05-13;TO;Tonga;0;0;0;0
2021-05-14;TO;Tonga;0;0;0;0
2021-05-15;TO;Tonga;0;0;0;0
2021-05-16;TO;Tonga;0;0;0;0
2021-05-17;TO;Tonga;0;0;0;0
2021-05-18;TO;Tonga;0;0;0;0
2021-05-19;TO;Tonga;0;0;0;0
2021-05-20;TO;Tonga;0;0;0;0
2021-05-21;TO;Tonga;0;0;0;0
2021-05-22;TO;Tonga;0;0;0;0
2021-05-23;TO;Tonga;0;0;0;0
2021-05-24;TO;Tonga;0;0;0;0
2021-05-25;TO;Tonga;0;0;0;0
2021-05-26;TO;Tonga;0;0;0;0
2021-05-27;TO;Tonga;0;0;0;0
2021-05-28;TO;Tonga;0;0;0;0
2021-05-29;TO;Tonga;0;0;0;0
2021-05-30;TO;Tonga;0;0;0;0
2021-05-31;TO;Tonga;0;0;0;0
2021-06-01;TO;Tonga;0;0;0;0
2021-06-21;TO;Tonga;0;0;0;0
2020-03-14;TT;Trinidad and Tobago;2;0;2;0
2020-03-15;TT;Trinidad and Tobago;0;0;2;0
2020-03-16;TT;Trinidad and Tobago;2;0;4;0
2020-03-17;TT;Trinidad and Tobago;1;0;5;0
2020-03-18;TT;Trinidad and Tobago;2;0;7;0
2020-03-19;TT;Trinidad and Tobago;2;0;9;0
2020-03-20;TT;Trinidad and Tobago;0;0;9;0
2020-03-21;TT;Trinidad and Tobago;40;0;49;0
2020-03-22;TT;Trinidad and Tobago;1;0;50;0
2020-03-23;TT;Trinidad and Tobago;1;0;51;0
2020-03-24;TT;Trinidad and Tobago;6;0;57;0
2020-03-25;TT;Trinidad and Tobago;3;1;60;1
2020-03-26;TT;Trinidad and Tobago;5;0;65;1
2020-03-27;TT;Trinidad and Tobago;1;1;66;2
2020-03-28;TT;Trinidad and Tobago;8;1;74;3
2020-03-29;TT;Trinidad and Tobago;4;0;78;3
2020-03-30;TT;Trinidad and Tobago;4;0;82;3
2020-03-31;TT;Trinidad and Tobago;5;0;87;3
2020-04-01;TT;Trinidad and Tobago;3;2;90;5
2020-04-02;TT;Trinidad and Tobago;4;0;94;5
2020-04-03;TT;Trinidad and Tobago;4;1;98;6
2020-04-04;TT;Trinidad and Tobago;5;0;103;6
2020-04-05;TT;Trinidad and Tobago;1;1;104;7
2020-04-06;TT;Trinidad and Tobago;1;1;105;8
2020-04-07;TT;Trinidad and Tobago;2;0;107;8
2020-04-08;TT;Trinidad and Tobago;0;0;107;8
2020-04-09;TT;Trinidad and Tobago;2;0;109;8
2020-04-10;TT;Trinidad and Tobago;0;0;109;8
2020-04-11;TT;Trinidad and Tobago;3;0;112;8
2020-04-12;TT;Trinidad and Tobago;1;0;113;8
2020-04-13;TT;Trinidad and Tobago;0;0;113;8
2020-04-14;TT;Trinidad and Tobago;0;0;113;8
2020-04-15;TT;Trinidad and Tobago;1;0;114;8
2020-04-16;TT;Trinidad and Tobago;0;0;114;8
2020-04-17;TT;Trinidad and Tobago;0;0;114;8
2020-04-18;TT;Trinidad and Tobago;0;0;114;8
2020-04-19;TT;Trinidad and Tobago;0;0;114;8
2020-04-20;TT;Trinidad and Tobago;0;0;114;8
2020-04-21;TT;Trinidad and Tobago;1;0;115;8
2020-04-22;TT;Trinidad and Tobago;0;0;115;8
2020-04-23;TT;Trinidad and Tobago;0;0;115;8
2020-04-24;TT;Trinidad and Tobago;0;0;115;8
2020-04-25;TT;Trinidad and Tobago;0;0;115;8
2020-04-26;TT;Trinidad and Tobago;0;0;115;8
2020-04-27;TT;Trinidad and Tobago;1;0;116;8
2020-04-28;TT;Trinidad and Tobago;0;0;116;8
2020-04-29;TT;Trinidad and Tobago;0;0;116;8
2020-04-30;TT;Trinidad and Tobago;0;0;116;8
2020-05-01;TT;Trinidad and Tobago;0;0;116;8
2020-05-02;TT;Trinidad and Tobago;0;0;116;8
2020-05-03;TT;Trinidad and Tobago;0;0;116;8
2020-05-04;TT;Trinidad and Tobago;0;0;116;8
2020-05-05;TT;Trinidad and Tobago;0;0;116;8
2020-05-06;TT;Trinidad and Tobago;0;0;116;8
2020-05-07;TT;Trinidad and Tobago;0;0;116;8
2020-05-08;TT;Trinidad and Tobago;0;0;116;8
2020-05-09;TT;Trinidad and Tobago;0;0;116;8
2020-05-10;TT;Trinidad and Tobago;0;0;116;8
2020-05-11;TT;Trinidad and Tobago;0;0;116;8
2020-05-12;TT;Trinidad and Tobago;0;0;116;8
2020-05-13;TT;Trinidad and Tobago;0;0;116;8
2020-05-14;TT;Trinidad and Tobago;0;0;116;8
2020-05-15;TT;Trinidad and Tobago;0;0;116;8
2020-05-16;TT;Trinidad and Tobago;0;0;116;8
2020-05-17;TT;Trinidad and Tobago;0;0;116;8
2020-05-18;TT;Trinidad and Tobago;0;0;116;8
2020-05-19;TT;Trinidad and Tobago;0;0;116;8
2020-05-20;TT;Trinidad and Tobago;0;0;116;8
2020-05-21;TT;Trinidad and Tobago;0;0;116;8
2020-05-22;TT;Trinidad and Tobago;0;0;116;8
2020-05-23;TT;Trinidad and Tobago;0;0;116;8
2020-05-24;TT;Trinidad and Tobago;0;0;116;8
2020-05-25;TT;Trinidad and Tobago;0;0;116;8
2020-05-26;TT;Trinidad and Tobago;0;0;116;8
2020-05-27;TT;Trinidad and Tobago;0;0;116;8
2020-05-28;TT;Trinidad and Tobago;0;0;116;8
2020-05-29;TT;Trinidad and Tobago;0;0;116;8
2020-05-30;TT;Trinidad and Tobago;1;0;117;8
2020-05-31;TT;Trinidad and Tobago;0;0;117;8
2020-06-01;TT;Trinidad and Tobago;0;0;117;8
2020-06-02;TT;Trinidad and Tobago;0;0;117;8
2020-06-03;TT;Trinidad and Tobago;0;0;117;8
2020-06-04;TT;Trinidad and Tobago;0;0;117;8
2020-06-05;TT;Trinidad and Tobago;0;0;117;8
2020-06-06;TT;Trinidad and Tobago;0;0;117;8
2020-06-07;TT;Trinidad and Tobago;0;0;117;8
2020-06-08;TT;Trinidad and Tobago;0;0;117;8
2020-06-09;TT;Trinidad and Tobago;0;0;117;8
2020-06-10;TT;Trinidad and Tobago;0;0;117;8
2020-06-11;TT;Trinidad and Tobago;0;0;117;8
2020-06-12;TT;Trinidad and Tobago;0;0;117;8
2020-06-13;TT;Trinidad and Tobago;0;0;117;8
2020-06-14;TT;Trinidad and Tobago;6;0;123;8
2020-06-15;TT;Trinidad and Tobago;0;0;123;8
2020-06-16;TT;Trinidad and Tobago;0;0;123;8
2020-06-17;TT;Trinidad and Tobago;0;0;123;8
2020-06-18;TT;Trinidad and Tobago;0;0;123;8
2020-06-19;TT;Trinidad and Tobago;0;0;123;8
2020-06-20;TT;Trinidad and Tobago;0;0;123;8
2020-06-21;TT;Trinidad and Tobago;0;0;123;8
2020-06-22;TT;Trinidad and Tobago;0;0;123;8
2020-06-23;TT;Trinidad and Tobago;0;0;123;8
2020-06-24;TT;Trinidad and Tobago;0;0;123;8
2020-06-25;TT;Trinidad and Tobago;0;0;123;8
2020-06-26;TT;Trinidad and Tobago;1;0;124;8
2020-06-27;TT;Trinidad and Tobago;2;0;126;8
2020-06-28;TT;Trinidad and Tobago;0;0;126;8
2020-06-29;TT;Trinidad and Tobago;0;0;126;8
2020-06-30;TT;Trinidad and Tobago;4;0;130;8
2020-07-01;TT;Trinidad and Tobago;0;0;130;8
2020-07-02;TT;Trinidad and Tobago;0;0;130;8
2020-07-03;TT;Trinidad and Tobago;0;0;130;8
2020-07-04;TT;Trinidad and Tobago;0;0;130;8
2020-07-05;TT;Trinidad and Tobago;3;0;133;8
2020-07-06;TT;Trinidad and Tobago;0;0;133;8
2020-07-07;TT;Trinidad and Tobago;0;0;133;8
2020-07-08;TT;Trinidad and Tobago;0;0;133;8
2020-07-09;TT;Trinidad and Tobago;0;0;133;8
2020-07-10;TT;Trinidad and Tobago;0;0;133;8
2020-07-11;TT;Trinidad and Tobago;0;0;133;8
2020-07-12;TT;Trinidad and Tobago;0;0;133;8
2020-07-13;TT;Trinidad and Tobago;0;0;133;8
2020-07-14;TT;Trinidad and Tobago;0;0;133;8
2020-07-15;TT;Trinidad and Tobago;0;0;133;8
2020-07-16;TT;Trinidad and Tobago;0;0;133;8
2020-07-17;TT;Trinidad and Tobago;3;0;136;8
2020-07-18;TT;Trinidad and Tobago;1;0;137;8
2020-07-19;TT;Trinidad and Tobago;0;0;137;8
2020-07-20;TT;Trinidad and Tobago;0;0;137;8
2020-07-21;TT;Trinidad and Tobago;2;0;139;8
2020-07-22;TT;Trinidad and Tobago;2;0;141;8
2020-07-23;TT;Trinidad and Tobago;0;0;141;8
2020-07-24;TT;Trinidad and Tobago;1;0;142;8
2020-07-25;TT;Trinidad and Tobago;5;0;147;8
2020-07-26;TT;Trinidad and Tobago;0;0;147;8
2020-07-27;TT;Trinidad and Tobago;1;0;148;8
2020-07-28;TT;Trinidad and Tobago;5;0;153;8
2020-07-29;TT;Trinidad and Tobago;3;0;156;8
2020-07-30;TT;Trinidad and Tobago;8;0;164;8
2020-07-31;TT;Trinidad and Tobago;5;0;169;8
2020-08-01;TT;Trinidad and Tobago;4;0;173;8
2020-08-02;TT;Trinidad and Tobago;9;0;182;8
2020-08-03;TT;Trinidad and Tobago;0;0;182;8
2020-08-04;TT;Trinidad and Tobago;12;0;194;8
2020-08-05;TT;Trinidad and Tobago;5;0;199;8
2020-08-06;TT;Trinidad and Tobago;11;0;210;8
2020-08-07;TT;Trinidad and Tobago;15;0;225;8
2020-08-08;TT;Trinidad and Tobago;50;0;275;8
2020-08-09;TT;Trinidad and Tobago;4;0;279;8
2020-08-10;TT;Trinidad and Tobago;2;0;281;8
2020-08-11;TT;Trinidad and Tobago;19;0;300;8
2020-08-12;TT;Trinidad and Tobago;26;0;326;8
2020-08-13;TT;Trinidad and Tobago;78;0;404;8
2020-08-14;TT;Trinidad and Tobago;22;2;426;10
2020-08-15;TT;Trinidad and Tobago;71;0;497;10
2020-08-16;TT;Trinidad and Tobago;55;1;552;11
2020-08-17;TT;Trinidad and Tobago;36;1;588;12
2020-08-18;TT;Trinidad and Tobago;41;0;629;12
2020-08-19;TT;Trinidad and Tobago;57;0;686;12
2020-08-20;TT;Trinidad and Tobago;81;0;767;12
2020-08-21;TT;Trinidad and Tobago;97;0;864;12
2020-08-22;TT;Trinidad and Tobago;66;1;930;13
2020-08-23;TT;Trinidad and Tobago;77;1;1007;14
2020-08-24;TT;Trinidad and Tobago;92;1;1099;15
2020-08-25;TT;Trinidad and Tobago;153;0;1252;15
2020-08-26;TT;Trinidad and Tobago;159;0;1411;15
2020-08-27;TT;Trinidad and Tobago;18;0;1429;15
2020-08-28;TT;Trinidad and Tobago;125;4;1554;19
2020-08-29;TT;Trinidad and Tobago;91;0;1645;19
2020-08-30;TT;Trinidad and Tobago;38;2;1683;21
2020-08-31;TT;Trinidad and Tobago;76;1;1759;22
2020-09-01;TT;Trinidad and Tobago;38;5;1797;27
2020-09-02;TT;Trinidad and Tobago;123;1;1920;28
2020-09-03;TT;Trinidad and Tobago;64;1;1984;29
2020-09-04;TT;Trinidad and Tobago;56;2;2040;31
2020-09-05;TT;Trinidad and Tobago;190;2;2230;33
2020-09-06;TT;Trinidad and Tobago;20;1;2250;34
2020-09-07;TT;Trinidad and Tobago;27;3;2277;37
2020-09-08;TT;Trinidad and Tobago;114;2;2391;39
2020-09-09;TT;Trinidad and Tobago;197;0;2588;39
2020-09-10;TT;Trinidad and Tobago;110;4;2698;43
2020-09-11;TT;Trinidad and Tobago;127;7;2825;50
2020-09-12;TT;Trinidad and Tobago;168;1;2993;51
2020-09-13;TT;Trinidad and Tobago;49;2;3042;53
2020-09-14;TT;Trinidad and Tobago;99;2;3141;55
2020-09-15;TT;Trinidad and Tobago;82;1;3223;56
2020-09-16;TT;Trinidad and Tobago;104;2;3327;58
2020-09-17;TT;Trinidad and Tobago;107;2;3434;60
2020-09-18;TT;Trinidad and Tobago;217;0;3651;60
2020-09-19;TT;Trinidad and Tobago;202;1;3853;61
2020-09-20;TT;Trinidad and Tobago;48;4;3901;65
2020-09-21;TT;Trinidad and Tobago;44;0;3945;65
2020-09-22;TT;Trinidad and Tobago;81;0;4026;65
2020-09-23;TT;Trinidad and Tobago;110;2;4136;67
2020-09-24;TT;Trinidad and Tobago;99;0;4235;67
2020-09-25;TT;Trinidad and Tobago;42;3;4277;70
2020-09-26;TT;Trinidad and Tobago;35;0;4312;70
2020-09-27;TT;Trinidad and Tobago;50;1;4362;71
2020-09-28;TT;Trinidad and Tobago;24;1;4386;72
2020-09-29;TT;Trinidad and Tobago;77;2;4463;74
2020-09-30;TT;Trinidad and Tobago;68;2;4531;76
2020-10-01;TT;Trinidad and Tobago;39;0;4570;76
2020-10-02;TT;Trinidad and Tobago;59;0;4629;76
2020-10-03;TT;Trinidad and Tobago;86;3;4715;79
2020-10-04;TT;Trinidad and Tobago;48;2;4763;81
2020-10-05;TT;Trinidad and Tobago;4;1;4767;82
2020-10-06;TT;Trinidad and Tobago;79;1;4846;83
2020-10-07;TT;Trinidad and Tobago;41;1;4887;84
2020-10-08;TT;Trinidad and Tobago;76;2;4963;86
2020-10-09;TT;Trinidad and Tobago;58;3;5021;89
2020-10-10;TT;Trinidad and Tobago;22;1;5043;90
2020-10-11;TT;Trinidad and Tobago;0;0;5043;90
2020-10-12;TT;Trinidad and Tobago;73;2;5116;92
2020-10-13;TT;Trinidad and Tobago;11;1;5127;93
2020-10-14;TT;Trinidad and Tobago;27;0;5154;93
2020-10-15;TT;Trinidad and Tobago;40;0;5194;93
2020-10-16;TT;Trinidad and Tobago;47;2;5241;95
2020-10-17;TT;Trinidad and Tobago;40;0;5281;95
2020-10-18;TT;Trinidad and Tobago;16;1;5297;96
2020-10-19;TT;Trinidad and Tobago;1;1;5298;97
2020-10-20;TT;Trinidad and Tobago;35;1;5333;98
2020-10-21;TT;Trinidad and Tobago;59;3;5392;101
2020-10-22;TT;Trinidad and Tobago;54;2;5446;103
2020-10-23;TT;Trinidad and Tobago;41;1;5487;104
2020-10-24;TT;Trinidad and Tobago;16;1;5503;105
2020-10-25;TT;Trinidad and Tobago;8;0;5511;105
2020-10-26;TT;Trinidad and Tobago;24;1;5535;106
2020-10-27;TT;Trinidad and Tobago;33;0;5568;106
2020-10-28;TT;Trinidad and Tobago;26;1;5594;107
2020-10-29;TT;Trinidad and Tobago;42;0;5636;107
2020-10-30;TT;Trinidad and Tobago;32;0;5668;107
2020-10-31;TT;Trinidad and Tobago;24;1;5692;108
2020-11-01;TT;Trinidad and Tobago;12;1;5704;109
2020-11-02;TT;Trinidad and Tobago;0;0;5704;109
2020-11-03;TT;Trinidad and Tobago;50;1;5754;110
2020-11-04;TT;Trinidad and Tobago;10;0;5764;110
2020-11-05;TT;Trinidad and Tobago;10;1;5774;111
2020-11-06;TT;Trinidad and Tobago;24;0;5798;111
2020-11-07;TT;Trinidad and Tobago;40;0;5838;111
2020-11-08;TT;Trinidad and Tobago;11;0;5849;111
2020-11-09;TT;Trinidad and Tobago;0;0;5849;111
2020-11-10;TT;Trinidad and Tobago;31;0;5880;111
2020-11-11;TT;Trinidad and Tobago;24;0;5904;111
2020-11-12;TT;Trinidad and Tobago;26;0;5930;111
2020-11-13;TT;Trinidad and Tobago;50;0;5980;111
2020-11-14;TT;Trinidad and Tobago;97;1;6077;112
2020-11-15;TT;Trinidad and Tobago;3;0;6080;112
2020-11-16;TT;Trinidad and Tobago;16;0;6096;112
2020-11-17;TT;Trinidad and Tobago;39;1;6135;113
2020-11-18;TT;Trinidad and Tobago;45;0;6180;113
2020-11-19;TT;Trinidad and Tobago;53;0;6233;113
2020-11-20;TT;Trinidad and Tobago;28;0;6261;113
2020-11-21;TT;Trinidad and Tobago;63;2;6324;115
2020-11-22;TT;Trinidad and Tobago;126;0;6450;115
2020-11-23;TT;Trinidad and Tobago;25;0;6475;115
2020-11-24;TT;Trinidad and Tobago;13;0;6488;115
2020-11-25;TT;Trinidad and Tobago;15;1;6503;116
2020-11-26;TT;Trinidad and Tobago;67;0;6570;116
2020-11-27;TT;Trinidad and Tobago;16;2;6586;118
2020-11-28;TT;Trinidad and Tobago;44;0;6630;118
2020-11-29;TT;Trinidad and Tobago;30;2;6660;120
2020-11-30;TT;Trinidad and Tobago;9;0;6669;120
2020-12-01;TT;Trinidad and Tobago;16;0;6685;120
2020-12-02;TT;Trinidad and Tobago;19;1;6704;121
2020-12-03;TT;Trinidad and Tobago;21;0;6725;121
2020-12-04;TT;Trinidad and Tobago;10;0;6735;121
2020-12-05;TT;Trinidad and Tobago;16;1;6751;122
2020-12-06;TT;Trinidad and Tobago;16;0;6767;122
2020-12-07;TT;Trinidad and Tobago;8;0;6775;122
2020-12-08;TT;Trinidad and Tobago;7;0;6782;122
2020-12-09;TT;Trinidad and Tobago;26;0;6808;122
2020-12-10;TT;Trinidad and Tobago;25;0;6833;122
2020-12-11;TT;Trinidad and Tobago;19;0;6852;122
2020-12-12;TT;Trinidad and Tobago;12;0;6864;122
2020-12-13;TT;Trinidad and Tobago;15;0;6879;122
2020-12-14;TT;Trinidad and Tobago;6;1;6885;123
2020-12-15;TT;Trinidad and Tobago;15;0;6900;123
2020-12-16;TT;Trinidad and Tobago;17;0;6917;123
2020-12-17;TT;Trinidad and Tobago;23;0;6940;123
2020-12-18;TT;Trinidad and Tobago;15;0;6955;123
2020-12-19;TT;Trinidad and Tobago;19;0;6974;123
2020-12-20;TT;Trinidad and Tobago;26;0;7000;123
2020-12-21;TT;Trinidad and Tobago;12;2;7012;125
2020-12-22;TT;Trinidad and Tobago;12;0;7024;125
2020-12-23;TT;Trinidad and Tobago;47;0;7071;125
2020-12-24;TT;Trinidad and Tobago;18;0;7089;125
2020-12-25;TT;Trinidad and Tobago;8;0;7097;125
2020-12-26;TT;Trinidad and Tobago;7;0;7104;125
2020-12-27;TT;Trinidad and Tobago;8;0;7112;125
2020-12-28;TT;Trinidad and Tobago;3;0;7115;125
2020-12-29;TT;Trinidad and Tobago;12;0;7127;125
2020-12-30;TT;Trinidad and Tobago;5;1;7132;126
2020-12-31;TT;Trinidad and Tobago;18;1;7150;127
2021-01-01;TT;Trinidad and Tobago;8;0;7158;127
2021-01-02;TT;Trinidad and Tobago;4;0;7162;127
2021-01-03;TT;Trinidad and Tobago;6;0;7168;127
2021-01-04;TT;Trinidad and Tobago;10;0;7178;127
2021-01-05;TT;Trinidad and Tobago;8;0;7186;127
2021-01-06;TT;Trinidad and Tobago;10;0;7196;127
2021-01-07;TT;Trinidad and Tobago;14;0;7210;127
2021-01-08;TT;Trinidad and Tobago;9;0;7219;127
2021-01-09;TT;Trinidad and Tobago;25;1;7244;128
2021-01-10;TT;Trinidad and Tobago;21;0;7265;128
2021-01-11;TT;Trinidad and Tobago;8;0;7273;128
2021-01-12;TT;Trinidad and Tobago;13;0;7286;128
2021-01-13;TT;Trinidad and Tobago;19;1;7305;129
2021-01-14;TT;Trinidad and Tobago;15;1;7320;130
2021-01-15;TT;Trinidad and Tobago;23;0;7343;130
2021-01-16;TT;Trinidad and Tobago;27;1;7370;131
2021-01-17;TT;Trinidad and Tobago;23;1;7393;132
2021-01-18;TT;Trinidad and Tobago;6;0;7399;132
2021-01-19;TT;Trinidad and Tobago;16;0;7415;132
2021-01-20;TT;Trinidad and Tobago;15;1;7430;133
2021-01-21;TT;Trinidad and Tobago;20;0;7450;133
2021-01-22;TT;Trinidad and Tobago;6;0;7456;133
2021-01-23;TT;Trinidad and Tobago;6;1;7462;134
2021-01-24;TT;Trinidad and Tobago;11;0;7473;134
2021-01-25;TT;Trinidad and Tobago;17;0;7490;134
2021-01-26;TT;Trinidad and Tobago;6;0;7496;134
2021-01-27;TT;Trinidad and Tobago;13;0;7509;134
2021-01-28;TT;Trinidad and Tobago;11;0;7520;134
2021-01-29;TT;Trinidad and Tobago;13;0;7533;134
2021-01-30;TT;Trinidad and Tobago;9;0;7542;134
2021-01-31;TT;Trinidad and Tobago;22;0;7564;134
2021-02-01;TT;Trinidad and Tobago;2;0;7566;134
2021-02-02;TT;Trinidad and Tobago;12;0;7578;134
2021-02-03;TT;Trinidad and Tobago;8;1;7586;135
2021-02-04;TT;Trinidad and Tobago;21;0;7607;135
2021-02-05;TT;Trinidad and Tobago;0;0;7607;135
2021-02-06;TT;Trinidad and Tobago;5;0;7612;135
2021-02-07;TT;Trinidad and Tobago;4;0;7616;135
2021-02-08;TT;Trinidad and Tobago;0;0;7616;135
2021-02-09;TT;Trinidad and Tobago;1;1;7617;136
2021-02-10;TT;Trinidad and Tobago;14;0;7631;136
2021-02-11;TT;Trinidad and Tobago;1;0;7632;136
2021-02-12;TT;Trinidad and Tobago;5;1;7637;137
2021-02-13;TT;Trinidad and Tobago;5;1;7642;138
2021-02-14;TT;Trinidad and Tobago;0;0;7642;138
2021-02-15;TT;Trinidad and Tobago;4;0;7646;138
2021-02-16;TT;Trinidad and Tobago;10;0;7656;138
2021-02-17;TT;Trinidad and Tobago;7;0;7663;138
2021-02-18;TT;Trinidad and Tobago;3;0;7666;138
2021-02-19;TT;Trinidad and Tobago;0;0;7666;138
2021-02-20;TT;Trinidad and Tobago;10;1;7676;139
2021-02-21;TT;Trinidad and Tobago;4;0;7680;139
2021-02-22;TT;Trinidad and Tobago;2;0;7682;139
2021-02-23;TT;Trinidad and Tobago;4;0;7686;139
2021-02-24;TT;Trinidad and Tobago;4;0;7690;139
2021-02-25;TT;Trinidad and Tobago;7;0;7697;139
2021-02-26;TT;Trinidad and Tobago;7;0;7704;139
2021-02-27;TT;Trinidad and Tobago;1;0;7705;139
2021-02-28;TT;Trinidad and Tobago;8;0;7713;139
2021-03-01;TT;Trinidad and Tobago;3;0;7716;139
2021-03-02;TT;Trinidad and Tobago;1;0;7717;139
2021-03-03;TT;Trinidad and Tobago;6;0;7723;139
2021-03-04;TT;Trinidad and Tobago;4;0;7727;139
2021-03-05;TT;Trinidad and Tobago;2;0;7729;139
2021-03-06;TT;Trinidad and Tobago;3;0;7732;139
2021-03-07;TT;Trinidad and Tobago;4;0;7736;139
2021-03-08;TT;Trinidad and Tobago;0;1;7736;140
2021-03-09;TT;Trinidad and Tobago;0;0;7736;140
2021-03-10;TT;Trinidad and Tobago;7;0;7743;140
2021-03-11;TT;Trinidad and Tobago;10;0;7753;140
2021-03-12;TT;Trinidad and Tobago;6;0;7759;140
2021-03-13;TT;Trinidad and Tobago;10;0;7769;140
2021-03-14;TT;Trinidad and Tobago;14;0;7783;140
2021-03-15;TT;Trinidad and Tobago;5;0;7788;140
2021-03-16;TT;Trinidad and Tobago;2;0;7790;140
2021-03-17;TT;Trinidad and Tobago;17;0;7807;140
2021-03-18;TT;Trinidad and Tobago;5;0;7812;140
2021-03-19;TT;Trinidad and Tobago;9;0;7821;140
2021-03-20;TT;Trinidad and Tobago;18;0;7839;140
2021-03-21;TT;Trinidad and Tobago;16;0;7855;140
2021-03-22;TT;Trinidad and Tobago;6;0;7861;140
2021-03-23;TT;Trinidad and Tobago;4;1;7865;141
2021-03-24;TT;Trinidad and Tobago;38;0;7903;141
2021-03-25;TT;Trinidad and Tobago;21;0;7924;141
2021-03-26;TT;Trinidad and Tobago;15;0;7939;141
2021-03-27;TT;Trinidad and Tobago;15;1;7954;142
2021-03-28;TT;Trinidad and Tobago;23;0;7977;142
2021-03-29;TT;Trinidad and Tobago;9;0;7986;142
2021-03-30;TT;Trinidad and Tobago;18;0;8004;142
2021-03-31;TT;Trinidad and Tobago;22;0;8026;142
2021-04-01;TT;Trinidad and Tobago;46;3;8072;145
2021-04-02;TT;Trinidad and Tobago;44;0;8116;145
2021-04-03;TT;Trinidad and Tobago;20;0;8136;145
2021-04-04;TT;Trinidad and Tobago;42;0;8178;145
2021-04-05;TT;Trinidad and Tobago;14;0;8192;145
2021-04-06;TT;Trinidad and Tobago;22;0;8214;145
2021-04-07;TT;Trinidad and Tobago;21;0;8235;145
2021-04-08;TT;Trinidad and Tobago;41;0;8276;145
2021-04-09;TT;Trinidad and Tobago;47;0;8323;145
2021-04-10;TT;Trinidad and Tobago;59;0;8382;145
2021-04-11;TT;Trinidad and Tobago;22;1;8404;146
2021-04-12;TT;Trinidad and Tobago;37;0;8441;146
2021-04-13;TT;Trinidad and Tobago;70;0;8511;146
2021-04-14;TT;Trinidad and Tobago;85;2;8596;148
2021-04-15;TT;Trinidad and Tobago;82;2;8678;150
2021-04-16;TT;Trinidad and Tobago;0;0;8678;150
2021-04-17;TT;Trinidad and Tobago;128;0;8806;150
2021-04-18;TT;Trinidad and Tobago;134;3;8940;153
2021-04-19;TT;Trinidad and Tobago;24;1;8964;154
2021-04-20;TT;Trinidad and Tobago;171;3;9135;157
2021-04-21;TT;Trinidad and Tobago;81;0;9216;157
2021-04-22;TT;Trinidad and Tobago;167;0;9383;157
2021-04-23;TT;Trinidad and Tobago;0;0;9383;157
2021-04-24;TT;Trinidad and Tobago;104;0;9487;157
2021-04-25;TT;Trinidad and Tobago;189;2;9676;159
2021-04-26;TT;Trinidad and Tobago;120;0;9796;159
2021-04-27;TT;Trinidad and Tobago;151;2;9947;161
2021-04-28;TT;Trinidad and Tobago;223;2;10170;163
2021-04-29;TT;Trinidad and Tobago;328;2;10498;165
2021-04-30;TT;Trinidad and Tobago;326;4;10824;169
2021-05-01;TT;Trinidad and Tobago;248;2;11072;171
2021-05-02;TT;Trinidad and Tobago;241;3;11313;174
2021-05-03;TT;Trinidad and Tobago;158;5;11471;179
2021-05-04;TT;Trinidad and Tobago;235;6;11706;185
2021-05-05;TT;Trinidad and Tobago;399;4;12105;189
2021-05-06;TT;Trinidad and Tobago;291;2;12396;191
2021-05-07;TT;Trinidad and Tobago;324;5;12720;196
2021-05-08;TT;Trinidad and Tobago;402;7;13122;203
2021-05-09;TT;Trinidad and Tobago;233;8;13355;211
2021-05-10;TT;Trinidad and Tobago;99;4;13454;215
2021-05-11;TT;Trinidad and Tobago;348;9;13802;224
2021-05-12;TT;Trinidad and Tobago;615;11;14417;235
2021-05-13;TT;Trinidad and Tobago;397;21;14814;256
2021-05-14;TT;Trinidad and Tobago;565;9;15379;265
2021-05-15;TT;Trinidad and Tobago;520;11;15899;276
2021-05-16;TT;Trinidad and Tobago;356;9;16255;285
2021-05-17;TT;Trinidad and Tobago;294;9;16549;294
2021-05-18;TT;Trinidad and Tobago;601;23;17150;317
2021-05-19;TT;Trinidad and Tobago;519;14;17669;331
2021-05-20;TT;Trinidad and Tobago;558;10;18227;341
2021-05-21;TT;Trinidad and Tobago;708;7;18935;348
2021-05-22;TT;Trinidad and Tobago;509;17;19444;365
2021-05-23;TT;Trinidad and Tobago;573;10;20017;375
2021-05-24;TT;Trinidad and Tobago;250;15;20267;390
2021-05-25;TT;Trinidad and Tobago;612;18;20879;408
2021-05-26;TT;Trinidad and Tobago;582;17;21461;425
2021-05-27;TT;Trinidad and Tobago;526;15;21987;440
2021-05-28;TT;Trinidad and Tobago;633;18;22620;458
2021-05-29;TT;Trinidad and Tobago;381;12;23001;470
2021-05-30;TT;Trinidad and Tobago;637;9;23638;479
2021-05-31;TT;Trinidad and Tobago;271;16;23909;495
2021-06-01;TT;Trinidad and Tobago;405;12;24314;507
2021-06-02;TT;Trinidad and Tobago;412;16;24726;523
2021-06-03;TT;Trinidad and Tobago;546;14;25272;537
2021-06-04;TT;Trinidad and Tobago;529;19;25801;556
2021-06-05;TT;Trinidad and Tobago;391;8;26192;564
2021-06-06;TT;Trinidad and Tobago;218;13;26410;577
2021-06-07;TT;Trinidad and Tobago;389;12;26799;589
2021-06-08;TT;Trinidad and Tobago;280;10;27079;599
2021-06-09;TT;Trinidad and Tobago;454;17;27533;616
2021-06-10;TT;Trinidad and Tobago;273;14;27806;630
2021-06-11;TT;Trinidad and Tobago;300;14;28106;644
2021-06-12;TT;Trinidad and Tobago;316;12;28422;656
2021-06-13;TT;Trinidad and Tobago;301;14;28723;670
2021-06-14;TT;Trinidad and Tobago;259;7;28982;677
2021-06-15;TT;Trinidad and Tobago;327;9;29309;686
2021-06-16;TT;Trinidad and Tobago;297;9;29606;695
2021-06-17;TT;Trinidad and Tobago;350;4;29956;699
2021-06-18;TT;Trinidad and Tobago;227;14;30183;713
2021-06-19;TT;Trinidad and Tobago;330;19;30513;732
2021-06-20;TT;Trinidad and Tobago;106;5;30619;737
2021-06-21;TT;Trinidad and Tobago;148;10;30767;747
2021-06-22;TT;Trinidad and Tobago;215;14;30982;761
2021-06-23;TT;Trinidad and Tobago;225;7;31207;768
2021-06-24;TT;Trinidad and Tobago;222;7;31429;775
2021-06-25;TT;Trinidad and Tobago;346;16;31775;791
2021-06-26;TT;Trinidad and Tobago;294;9;32069;800
2021-06-27;TT;Trinidad and Tobago;129;17;32198;817
2021-06-28;TT;Trinidad and Tobago;145;5;32343;822
2021-06-29;TT;Trinidad and Tobago;185;11;32528;833
2021-06-30;TT;Trinidad and Tobago;265;14;32793;847
2021-07-01;TT;Trinidad and Tobago;236;10;33029;857
2020-03-04;TN;Tunisia;1;0;1;0
2020-03-05;TN;Tunisia;0;0;1;0
2020-03-06;TN;Tunisia;0;0;1;0
2020-03-07;TN;Tunisia;0;0;1;0
2020-03-08;TN;Tunisia;1;0;2;0
2020-03-09;TN;Tunisia;0;0;2;0
2020-03-10;TN;Tunisia;3;0;5;0
2020-03-11;TN;Tunisia;2;0;7;0
2020-03-12;TN;Tunisia;0;0;7;0
2020-03-13;TN;Tunisia;9;0;16;0
2020-03-14;TN;Tunisia;2;0;18;0
2020-03-15;TN;Tunisia;0;0;18;0
2020-03-16;TN;Tunisia;2;0;20;0
2020-03-17;TN;Tunisia;4;0;24;0
2020-03-18;TN;Tunisia;5;0;29;0
2020-03-19;TN;Tunisia;10;1;39;1
2020-03-20;TN;Tunisia;15;0;54;1
2020-03-21;TN;Tunisia;6;0;60;1
2020-03-22;TN;Tunisia;15;2;75;3
2020-03-23;TN;Tunisia;14;0;89;3
2020-03-24;TN;Tunisia;25;1;114;4
2020-03-25;TN;Tunisia;59;1;173;5
2020-03-26;TN;Tunisia;24;1;197;6
2020-03-27;TN;Tunisia;30;0;227;6
2020-03-28;TN;Tunisia;51;2;278;8
2020-03-29;TN;Tunisia;34;0;312;8
2020-03-30;TN;Tunisia;0;0;312;8
2020-03-31;TN;Tunisia;82;2;394;10
2020-04-01;TN;Tunisia;29;2;423;12
2020-04-02;TN;Tunisia;32;2;455;14
2020-04-03;TN;Tunisia;40;4;495;18
2020-04-04;TN;Tunisia;58;0;553;18
2020-04-05;TN;Tunisia;21;4;574;22
2020-04-06;TN;Tunisia;22;0;596;22
2020-04-07;TN;Tunisia;27;1;623;23
2020-04-08;TN;Tunisia;5;1;628;24
2020-04-09;TN;Tunisia;15;1;643;25
2020-04-10;TN;Tunisia;28;0;671;25
2020-04-11;TN;Tunisia;14;3;685;28
2020-04-12;TN;Tunisia;22;3;707;31
2020-04-13;TN;Tunisia;19;3;726;34
2020-04-14;TN;Tunisia;21;0;747;34
2020-04-15;TN;Tunisia;33;1;780;35
2020-04-16;TN;Tunisia;42;2;822;37
2020-04-17;TN;Tunisia;42;0;864;37
2020-04-18;TN;Tunisia;0;0;864;37
2020-04-19;TN;Tunisia;15;1;879;38
2020-04-20;TN;Tunisia;5;0;884;38
2020-04-21;TN;Tunisia;0;0;884;38
2020-04-22;TN;Tunisia;25;0;909;38
2020-04-23;TN;Tunisia;9;0;918;38
2020-04-24;TN;Tunisia;4;0;922;38
2020-04-25;TN;Tunisia;17;0;939;38
2020-04-26;TN;Tunisia;10;0;949;38
2020-04-27;TN;Tunisia;18;1;967;39
2020-04-28;TN;Tunisia;8;1;975;40
2020-04-29;TN;Tunisia;5;0;980;40
2020-04-30;TN;Tunisia;14;1;994;41
2020-05-01;TN;Tunisia;4;0;998;41
2020-05-02;TN;Tunisia;11;1;1009;42
2020-05-03;TN;Tunisia;4;0;1013;42
2020-05-04;TN;Tunisia;5;1;1018;43
2020-05-05;TN;Tunisia;4;0;1022;43
2020-05-06;TN;Tunisia;3;0;1025;43
2020-05-07;TN;Tunisia;1;1;1026;44
2020-05-08;TN;Tunisia;4;1;1030;45
2020-05-09;TN;Tunisia;2;0;1032;45
2020-05-10;TN;Tunisia;0;0;1032;45
2020-05-11;TN;Tunisia;0;0;1032;45
2020-05-12;TN;Tunisia;0;0;1032;45
2020-05-13;TN;Tunisia;0;0;1032;45
2020-05-14;TN;Tunisia;0;0;1032;45
2020-05-15;TN;Tunisia;3;0;1035;45
2020-05-16;TN;Tunisia;2;0;1037;45
2020-05-17;TN;Tunisia;0;0;1037;45
2020-05-18;TN;Tunisia;6;1;1043;46
2020-05-19;TN;Tunisia;1;1;1044;47
2020-05-20;TN;Tunisia;1;0;1045;47
2020-05-21;TN;Tunisia;1;0;1046;47
2020-05-22;TN;Tunisia;2;0;1048;47
2020-05-23;TN;Tunisia;0;1;1048;48
2020-05-24;TN;Tunisia;3;0;1051;48
2020-05-25;TN;Tunisia;0;0;1051;48
2020-05-26;TN;Tunisia;0;0;1051;48
2020-05-27;TN;Tunisia;0;0;1051;48
2020-05-28;TN;Tunisia;17;0;1068;48
2020-05-29;TN;Tunisia;3;0;1071;48
2020-05-30;TN;Tunisia;5;0;1076;48
2020-05-31;TN;Tunisia;1;0;1077;48
2020-06-01;TN;Tunisia;7;0;1084;48
2020-06-02;TN;Tunisia;2;0;1086;48
2020-06-03;TN;Tunisia;1;1;1087;49
2020-06-04;TN;Tunisia;0;0;1087;49
2020-06-05;TN;Tunisia;0;0;1087;49
2020-06-06;TN;Tunisia;0;0;1087;49
2020-06-07;TN;Tunisia;0;0;1087;49
2020-06-08;TN;Tunisia;0;0;1087;49
2020-06-09;TN;Tunisia;0;0;1087;49
2020-06-10;TN;Tunisia;0;0;1087;49
2020-06-11;TN;Tunisia;0;0;1087;49
2020-06-12;TN;Tunisia;6;0;1093;49
2020-06-13;TN;Tunisia;1;0;1094;49
2020-06-14;TN;Tunisia;2;0;1096;49
2020-06-15;TN;Tunisia;14;0;1110;49
2020-06-16;TN;Tunisia;15;0;1125;49
2020-06-17;TN;Tunisia;3;1;1128;50
2020-06-18;TN;Tunisia;4;0;1132;50
2020-06-19;TN;Tunisia;14;0;1146;50
2020-06-20;TN;Tunisia;10;0;1156;50
2020-06-21;TN;Tunisia;1;0;1157;50
2020-06-22;TN;Tunisia;2;0;1159;50
2020-06-23;TN;Tunisia;0;0;1159;50
2020-06-24;TN;Tunisia;1;0;1160;50
2020-06-25;TN;Tunisia;2;0;1162;50
2020-06-26;TN;Tunisia;2;0;1164;50
2020-06-27;TN;Tunisia;4;0;1168;50
2020-06-28;TN;Tunisia;1;0;1169;50
2020-06-29;TN;Tunisia;3;0;1172;50
2020-06-30;TN;Tunisia;2;0;1174;50
2020-07-01;TN;Tunisia;1;0;1175;50
2020-07-02;TN;Tunisia;3;0;1178;50
2020-07-03;TN;Tunisia;3;0;1181;50
2020-07-04;TN;Tunisia;5;0;1186;50
2020-07-05;TN;Tunisia;2;0;1188;50
2020-07-06;TN;Tunisia;11;0;1199;50
2020-07-07;TN;Tunisia;6;0;1205;50
2020-07-08;TN;Tunisia;16;0;1221;50
2020-07-09;TN;Tunisia;10;0;1231;50
2020-07-10;TN;Tunisia;9;0;1240;50
2020-07-11;TN;Tunisia;5;0;1245;50
2020-07-12;TN;Tunisia;18;0;1263;50
2020-07-13;TN;Tunisia;39;0;1302;50
2020-07-14;TN;Tunisia;4;0;1306;50
2020-07-15;TN;Tunisia;13;0;1319;50
2020-07-16;TN;Tunisia;8;0;1327;50
2020-07-17;TN;Tunisia;9;0;1336;50
2020-07-18;TN;Tunisia;12;0;1348;50
2020-07-19;TN;Tunisia;26;0;1374;50
2020-07-20;TN;Tunisia;7;0;1381;50
2020-07-21;TN;Tunisia;8;0;1389;50
2020-07-22;TN;Tunisia;5;0;1394;50
2020-07-23;TN;Tunisia;12;0;1406;50
2020-07-24;TN;Tunisia;19;0;1425;50
2020-07-25;TN;Tunisia;18;0;1443;50
2020-07-26;TN;Tunisia;9;0;1452;50
2020-07-27;TN;Tunisia;3;0;1455;50
2020-07-28;TN;Tunisia;13;0;1468;50
2020-07-29;TN;Tunisia;20;0;1488;50
2020-07-30;TN;Tunisia;26;0;1514;50
2020-07-31;TN;Tunisia;21;0;1535;50
2020-08-01;TN;Tunisia;17;1;1552;51
2020-08-02;TN;Tunisia;9;0;1561;51
2020-08-03;TN;Tunisia;4;0;1565;51
2020-08-04;TN;Tunisia;19;0;1584;51
2020-08-05;TN;Tunisia;17;0;1601;51
2020-08-06;TN;Tunisia;41;0;1642;51
2020-08-07;TN;Tunisia;14;0;1656;51
2020-08-08;TN;Tunisia;22;0;1678;51
2020-08-09;TN;Tunisia;19;0;1697;51
2020-08-10;TN;Tunisia;20;0;1717;51
2020-08-11;TN;Tunisia;21;1;1738;52
2020-08-12;TN;Tunisia;42;0;1780;52
2020-08-13;TN;Tunisia;67;1;1847;53
2020-08-14;TN;Tunisia;56;0;1903;53
2020-08-15;TN;Tunisia;120;1;2023;54
2020-08-16;TN;Tunisia;84;0;2107;54
2020-08-17;TN;Tunisia;78;2;2185;56
2020-08-18;TN;Tunisia;129;1;2314;57
2020-08-19;TN;Tunisia;113;3;2427;60
2020-08-20;TN;Tunisia;116;3;2543;63
2020-08-21;TN;Tunisia;64;1;2607;64
2020-08-22;TN;Tunisia;131;4;2738;68
2020-08-23;TN;Tunisia;80;3;2818;71
2020-08-24;TN;Tunisia;75;0;2893;71
2020-08-25;TN;Tunisia;176;0;3069;71
2020-08-26;TN;Tunisia;137;0;3206;71
2020-08-27;TN;Tunisia;117;2;3323;73
2020-08-28;TN;Tunisia;138;1;3461;74
2020-08-29;TN;Tunisia;111;2;3572;76
2020-08-30;TN;Tunisia;113;0;3685;76
2020-08-31;TN;Tunisia;118;1;3803;77
2020-09-01;TN;Tunisia;160;3;3963;80
2020-09-02;TN;Tunisia;233;1;4196;81
2020-09-03;TN;Tunisia;198;3;4394;84
2020-09-04;TN;Tunisia;148;3;4542;87
2020-09-05;TN;Tunisia;234;6;4776;93
2020-09-06;TN;Tunisia;265;0;5041;93
2020-09-07;TN;Tunisia;83;1;5124;94
2020-09-08;TN;Tunisia;293;2;5417;96
2020-09-09;TN;Tunisia;0;0;5417;96
2020-09-10;TN;Tunisia;465;3;5882;99
2020-09-11;TN;Tunisia;377;4;6259;103
2020-09-12;TN;Tunisia;376;4;6635;107
2020-09-13;TN;Tunisia;0;0;6635;107
2020-09-14;TN;Tunisia;747;10;7382;117
2020-09-15;TN;Tunisia;241;6;7623;123
2020-09-16;TN;Tunisia;477;6;8100;129
2020-09-17;TN;Tunisia;470;4;8570;133
2020-09-18;TN;Tunisia;0;0;8570;133
2020-09-19;TN;Tunisia;540;5;9110;138
2020-09-20;TN;Tunisia;1622;21;10732;159
2020-09-21;TN;Tunisia;528;5;11260;164
2020-09-22;TN;Tunisia;0;0;11260;164
2020-09-23;TN;Tunisia;1219;10;12479;174
2020-09-24;TN;Tunisia;826;6;13305;180
2020-09-25;TN;Tunisia;1087;11;14392;191
2020-09-26;TN;Tunisia;0;0;14392;191
2020-09-27;TN;Tunisia;1722;23;16114;214
2020-09-28;TN;Tunisia;0;0;16114;214
2020-09-29;TN;Tunisia;1291;32;17405;246
2020-09-30;TN;Tunisia;1008;19;18413;265
2020-10-01;TN;Tunisia;0;0;18413;265
2020-10-02;TN;Tunisia;1308;6;19721;271
2020-10-03;TN;Tunisia;1223;5;20944;276
2020-10-04;TN;Tunisia;1286;45;22230;321
2020-10-05;TN;Tunisia;0;0;22230;321
2020-10-06;TN;Tunisia;0;0;22230;321
2020-10-07;TN;Tunisia;2312;43;24542;364
2020-10-08;TN;Tunisia;2357;45;26899;409
2020-10-09;TN;Tunisia;0;0;26899;409
2020-10-10;TN;Tunisia;4360;47;31259;456
2020-10-11;TN;Tunisia;1297;22;32556;478
2020-10-12;TN;Tunisia;0;0;32556;478
2020-10-13;TN;Tunisia;0;0;32556;478
2020-10-14;TN;Tunisia;2234;34;34790;512
2020-10-15;TN;Tunisia;0;0;34790;512
2020-10-16;TN;Tunisia;0;0;34790;512
2020-10-17;TN;Tunisia;5752;114;40542;626
2020-10-18;TN;Tunisia;0;0;40542;626
2020-10-19;TN;Tunisia;2185;61;42727;687
2020-10-20;TN;Tunisia;1723;24;44450;711
2020-10-21;TN;Tunisia;1442;29;45892;740
2020-10-22;TN;Tunisia;0;0;45892;740
2020-10-23;TN;Tunisia;1322;44;47214;784
2020-10-24;TN;Tunisia;1585;35;48799;819
2020-10-25;TN;Tunisia;0;0;48799;819
2020-10-26;TN;Tunisia;3600;164;52399;983
2020-10-27;TN;Tunisia;0;0;52399;983
2020-10-28;TN;Tunisia;1879;170;54278;1153
2020-10-29;TN;Tunisia;0;0;54278;1153
2020-10-30;TN;Tunisia;3751;100;58029;1253
2020-10-31;TN;Tunisia;1784;64;59813;1317
2020-11-01;TN;Tunisia;1302;31;61115;1348
2020-11-02;TN;Tunisia;791;33;61906;1381
2020-11-03;TN;Tunisia;1220;102;63126;1483
2020-11-04;TN;Tunisia;1237;29;64363;1512
2020-11-05;TN;Tunisia;1971;65;66334;1577
2020-11-06;TN;Tunisia;0;0;66334;1577
2020-11-07;TN;Tunisia;3209;217;69543;1794
2020-11-08;TN;Tunisia;1576;79;71119;1873
2020-11-09;TN;Tunisia;450;47;71569;1920
2020-11-10;TN;Tunisia;1424;86;72993;2006
2020-11-11;TN;Tunisia;1529;94;74522;2100
2020-11-12;TN;Tunisia;1584;51;76106;2151
2020-11-13;TN;Tunisia;1562;58;77668;2209
2020-11-14;TN;Tunisia;1671;70;79339;2279
2020-11-15;TN;Tunisia;1065;66;80404;2345
2020-11-16;TN;Tunisia;599;51;81003;2396
2020-11-17;TN;Tunisia;720;49;81723;2445
2020-11-18;TN;Tunisia;2049;96;83772;2541
2020-11-19;TN;Tunisia;0;0;83772;2541
2020-11-20;TN;Tunisia;2493;143;86265;2684
2020-11-21;TN;Tunisia;1206;68;87471;2752
2020-11-22;TN;Tunisia;1240;69;88711;2821
2020-11-23;TN;Tunisia;485;41;89196;2862
2020-11-24;TN;Tunisia;1017;73;90213;2935
2020-11-25;TN;Tunisia;1094;48;91307;2983
2020-11-26;TN;Tunisia;1168;51;92475;3034
2020-11-27;TN;Tunisia;1295;72;93770;3106
2020-11-28;TN;Tunisia;1210;47;94980;3153
2020-11-29;TN;Tunisia;1271;66;96251;3219
2020-11-30;TN;Tunisia;518;41;96769;3260
2020-12-01;TN;Tunisia;0;0;96769;3260
2020-12-02;TN;Tunisia;2511;99;99280;3359
2020-12-03;TN;Tunisia;0;0;99280;3359
2020-12-04;TN;Tunisia;2620;122;101900;3481
2020-12-05;TN;Tunisia;1091;45;102991;3526
2020-12-06;TN;Tunisia;1011;35;104002;3561
2020-12-07;TN;Tunisia;327;35;104329;3596
2020-12-08;TN;Tunisia;1116;72;105445;3668
2020-12-09;TN;Tunisia;1411;49;106856;3717
2020-12-10;TN;Tunisia;958;41;107814;3758
2020-12-11;TN;Tunisia;1290;43;109104;3801
2020-12-12;TN;Tunisia;1289;35;110393;3836
2020-12-13;TN;Tunisia;968;58;111361;3894
2020-12-14;TN;Tunisia;0;0;111361;3894
2020-12-15;TN;Tunisia;1880;62;113241;3956
2020-12-16;TN;Tunisia;1306;41;114547;3997
2020-12-17;TN;Tunisia;1419;35;115966;4032
2020-12-18;TN;Tunisia;1616;58;117582;4090
2020-12-19;TN;Tunisia;1569;36;119151;4126
2020-12-20;TN;Tunisia;1536;32;120687;4158
2020-12-21;TN;Tunisia;1031;41;121718;4199
2020-12-22;TN;Tunisia;1605;38;123323;4237
2020-12-23;TN;Tunisia;1677;38;125000;4275
2020-12-24;TN;Tunisia;1752;49;126752;4324
2020-12-25;TN;Tunisia;1826;61;128578;4385
2020-12-26;TN;Tunisia;1652;41;130230;4426
2020-12-27;TN;Tunisia;1362;40;131592;4466
2020-12-28;TN;Tunisia;1612;52;133204;4518
2020-12-29;TN;Tunisia;1598;52;134802;4570
2020-12-30;TN;Tunisia;2414;50;137216;4620
2020-12-31;TN;Tunisia;1924;56;139140;4676
2021-01-01;TN;Tunisia;1417;54;140557;4730
2021-01-02;TN;Tunisia;1422;35;141979;4765
2021-01-03;TN;Tunisia;1565;35;143544;4800
2021-01-04;TN;Tunisia;1252;62;144796;4862
2021-01-05;TN;Tunisia;2265;72;147061;4934
2021-01-06;TN;Tunisia;2820;70;149881;5004
2021-01-07;TN;Tunisia;2373;48;152254;5052
2021-01-08;TN;Tunisia;2649;56;154903;5108
2021-01-09;TN;Tunisia;2611;45;157514;5153
2021-01-10;TN;Tunisia;1762;62;159276;5215
2021-01-11;TN;Tunisia;3074;69;162350;5284
2021-01-12;TN;Tunisia;2586;59;164936;5343
2021-01-13;TN;Tunisia;3632;72;168568;5415
2021-01-14;TN;Tunisia;2327;63;170895;5478
2021-01-15;TN;Tunisia;4170;50;175065;5528
2021-01-16;TN;Tunisia;2166;88;177231;5616
2021-01-17;TN;Tunisia;2859;76;180090;5692
2021-01-18;TN;Tunisia;1795;58;181885;5750
2021-01-19;TN;Tunisia;2598;94;184483;5844
2021-01-20;TN;Tunisia;3890;77;188373;5921
2021-01-21;TN;Tunisia;2511;68;190884;5989
2021-01-22;TN;Tunisia;2389;103;193273;6092
2021-01-23;TN;Tunisia;2041;62;195314;6154
2021-01-24;TN;Tunisia;2059;80;197373;6234
2021-01-25;TN;Tunisia;1263;53;198636;6287
2021-01-26;TN;Tunisia;2026;83;200662;6370
2021-01-27;TN;Tunisia;1661;76;202323;6446
2021-01-28;TN;Tunisia;2028;62;204351;6508
2021-01-29;TN;Tunisia;1679;91;206030;6599
2021-01-30;TN;Tunisia;1438;81;207468;6680
2021-01-31;TN;Tunisia;1417;74;208885;6754
2021-02-01;TN;Tunisia;1160;48;210045;6802
2021-02-02;TN;Tunisia;1367;91;211412;6893
2021-02-03;TN;Tunisia;1267;87;212679;6980
2021-02-04;TN;Tunisia;1270;68;213949;7048
2021-02-05;TN;Tunisia;1163;51;215112;7099
2021-02-06;TN;Tunisia;1064;63;216176;7162
2021-02-07;TN;Tunisia;910;52;217086;7214
2021-02-08;TN;Tunisia;667;43;217753;7257
2021-02-09;TN;Tunisia;811;75;218564;7332
2021-02-10;TN;Tunisia;1086;46;219650;7378
2021-02-11;TN;Tunisia;828;51;220478;7429
2021-02-12;TN;Tunisia;977;32;221455;7461
2021-02-13;TN;Tunisia;1049;47;222504;7508
2021-02-14;TN;Tunisia;740;36;223244;7544
2021-02-15;TN;Tunisia;305;31;223549;7575
2021-02-16;TN;Tunisia;780;42;224329;7617
2021-02-17;TN;Tunisia;787;34;225116;7651
2021-02-18;TN;Tunisia;899;33;226015;7684
2021-02-19;TN;Tunisia;725;35;226740;7719
2021-02-20;TN;Tunisia;903;36;227643;7755
2021-02-21;TN;Tunisia;719;38;228362;7793
2021-02-22;TN;Tunisia;575;18;228937;7811
2021-02-23;TN;Tunisia;844;32;229781;7843
2021-02-24;TN;Tunisia;662;26;230443;7869
2021-02-25;TN;Tunisia;855;42;231298;7911
2021-02-26;TN;Tunisia;666;31;231964;7942
2021-02-27;TN;Tunisia;651;32;232615;7974
2021-02-28;TN;Tunisia;662;27;233277;8001
2021-03-01;TN;Tunisia;392;21;233669;8022
2021-03-02;TN;Tunisia;562;25;234231;8047
2021-03-03;TN;Tunisia;777;27;235008;8074
2021-03-04;TN;Tunisia;635;32;235643;8106
2021-03-05;TN;Tunisia;713;24;236356;8130
2021-03-06;TN;Tunisia;672;37;237028;8167
2021-03-07;TN;Tunisia;676;34;237704;8201
2021-03-08;TN;Tunisia;313;24;238017;8225
2021-03-09;TN;Tunisia;596;43;238613;8268
2021-03-10;TN;Tunisia;755;24;239368;8292
2021-03-11;TN;Tunisia;609;21;239977;8313
2021-03-12;TN;Tunisia;640;16;240617;8329
2021-03-13;TN;Tunisia;640;30;241257;8359
2021-03-14;TN;Tunisia;577;30;241834;8389
2021-03-15;TN;Tunisia;290;15;242124;8404
2021-03-16;TN;Tunisia;549;25;242673;8429
2021-03-17;TN;Tunisia;766;34;243439;8463
2021-03-18;TN;Tunisia;496;27;243935;8490
2021-03-19;TN;Tunisia;841;16;244776;8506
2021-03-20;TN;Tunisia;629;20;245405;8526
2021-03-21;TN;Tunisia;301;20;245706;8546
2021-03-22;TN;Tunisia;217;23;245923;8569
2021-03-23;TN;Tunisia;584;41;246507;8610
2021-03-24;TN;Tunisia;747;27;247254;8637
2021-03-25;TN;Tunisia;783;26;248037;8663
2021-03-26;TN;Tunisia;745;21;248782;8684
2021-03-27;TN;Tunisia;921;21;249703;8705
2021-03-28;TN;Tunisia;862;30;250565;8735
2021-03-29;TN;Tunisia;604;25;251169;8760
2021-03-30;TN;Tunisia;1002;28;252171;8788
2021-03-31;TN;Tunisia;1847;24;254018;8812
2021-04-01;TN;Tunisia;1290;31;255308;8843
2021-04-02;TN;Tunisia;1623;47;256931;8890
2021-04-03;TN;Tunisia;1404;41;258335;8931
2021-04-04;TN;Tunisia;1709;34;260044;8965
2021-04-05;TN;Tunisia;1133;28;261177;8993
2021-04-06;TN;Tunisia;1866;46;263043;9039
2021-04-07;TN;Tunisia;1951;48;264994;9087
2021-04-08;TN;Tunisia;1833;49;266827;9136
2021-04-09;TN;Tunisia;2010;43;268837;9179
2021-04-10;TN;Tunisia;1460;56;270297;9235
2021-04-11;TN;Tunisia;1564;58;271861;9293
2021-04-12;TN;Tunisia;1079;39;272940;9332
2021-04-13;TN;Tunisia;1664;64;274604;9396
2021-04-14;TN;Tunisia;2123;84;276727;9480
2021-04-15;TN;Tunisia;2649;73;279376;9553
2021-04-16;TN;Tunisia;2401;86;281777;9639
2021-04-17;TN;Tunisia;2199;78;283976;9717
2021-04-18;TN;Tunisia;1514;66;285490;9783
2021-04-19;TN;Tunisia;1571;42;287061;9825
2021-04-20;TN;Tunisia;2169;93;289230;9918
2021-04-21;TN;Tunisia;2603;75;291833;9993
2021-04-22;TN;Tunisia;2305;70;294138;10063
2021-04-23;TN;Tunisia;2205;107;296343;10170
2021-04-24;TN;Tunisia;2229;61;298572;10231
2021-04-25;TN;Tunisia;1770;73;300342;10304
2021-04-26;TN;Tunisia;1285;48;301627;10352
2021-04-27;TN;Tunisia;1957;92;303584;10444
2021-04-28;TN;Tunisia;1729;119;305313;10563
2021-04-29;TN;Tunisia;1902;78;307215;10641
2021-04-30;TN;Tunisia;1904;81;309119;10722
2021-05-01;TN;Tunisia;1615;86;310734;10808
2021-05-02;TN;Tunisia;1009;60;311743;10868
2021-05-03;TN;Tunisia;1004;47;312747;10915
2021-05-04;TN;Tunisia;1405;101;314152;11016
2021-05-05;TN;Tunisia;1448;106;315600;11122
2021-05-06;TN;Tunisia;1410;86;317010;11208
2021-05-07;TN;Tunisia;1226;69;318236;11277
2021-05-08;TN;Tunisia;1276;73;319512;11350
2021-05-09;TN;Tunisia;1301;79;320813;11429
2021-05-10;TN;Tunisia;1024;39;321837;11468
2021-05-11;TN;Tunisia;1161;88;322998;11556
2021-05-12;TN;Tunisia;1105;81;324103;11637
2021-05-13;TN;Tunisia;720;56;324823;11693
2021-05-14;TN;Tunisia;457;34;325280;11727
2021-05-15;TN;Tunisia;552;52;325832;11779
2021-05-16;TN;Tunisia;740;70;326572;11849
2021-05-17;TN;Tunisia;901;50;327473;11899
2021-05-18;TN;Tunisia;1055;72;328528;11971
2021-05-19;TN;Tunisia;1397;61;329925;12032
2021-05-20;TN;Tunisia;1749;57;331674;12089
2021-05-21;TN;Tunisia;1159;52;332833;12141
2021-05-22;TN;Tunisia;1266;41;334099;12182
2021-05-23;TN;Tunisia;1246;54;335345;12236
2021-05-24;TN;Tunisia;1069;37;336414;12273
2021-05-25;TN;Tunisia;1115;69;337529;12342
2021-05-26;TN;Tunisia;1324;56;338853;12398
2021-05-27;TN;Tunisia;1397;53;340250;12451
2021-05-28;TN;Tunisia;1702;62;341952;12513
2021-05-29;TN;Tunisia;1422;61;343374;12574
2021-05-30;TN;Tunisia;1314;49;344688;12623
2021-05-31;TN;Tunisia;786;31;345474;12654
2021-06-01;TN;Tunisia;1512;66;346986;12720
2021-06-02;TN;Tunisia;1925;73;348911;12793
2021-06-03;TN;Tunisia;1576;46;350487;12839
2021-06-04;TN;Tunisia;1816;63;352303;12902
2021-06-05;TN;Tunisia;1479;46;353782;12948
2021-06-06;TN;Tunisia;1950;32;355732;12980
2021-06-07;TN;Tunisia;1018;47;356750;13027
2021-06-08;TN;Tunisia;1433;99;358183;13126
2021-06-09;TN;Tunisia;2102;103;360285;13229
2021-06-10;TN;Tunisia;2373;76;362658;13305
2021-06-11;TN;Tunisia;2161;60;364819;13365
2021-06-12;TN;Tunisia;2228;71;367047;13436
2021-06-13;TN;Tunisia;1861;79;368908;13515
2021-06-14;TN;Tunisia;1316;52;370224;13567
2021-06-15;TN;Tunisia;1997;89;372221;13656
2021-06-16;TN;Tunisia;2091;65;374312;13721
2021-06-17;TN;Tunisia;2379;71;376691;13792
2021-06-18;TN;Tunisia;2291;82;378982;13874
2021-06-19;TN;Tunisia;2193;86;381175;13960
2021-06-20;TN;Tunisia;1775;78;382950;14038
2021-06-21;TN;Tunisia;2478;80;385428;14118
2021-06-22;TN;Tunisia;2345;105;387773;14223
2021-06-23;TN;Tunisia;3638;95;391411;14318
2021-06-24;TN;Tunisia;3951;88;395362;14406
2021-06-25;TN;Tunisia;3467;83;398829;14489
2021-06-26;TN;Tunisia;4664;90;403493;14579
2021-06-27;TN;Tunisia;3524;75;407017;14654
2021-06-28;TN;Tunisia;1914;83;408931;14737
2021-06-29;TN;Tunisia;5251;106;414182;14843
2021-06-30;TN;Tunisia;5921;116;420103;14959
2021-07-01;TN;Tunisia;6776;106;426879;15065
2020-03-11;TR;Turkey;1;0;1;0
2020-03-12;TR;Turkey;0;0;1;0
2020-03-13;TR;Turkey;4;0;5;0
2020-03-14;TR;Turkey;0;0;5;0
2020-03-15;TR;Turkey;1;0;6;0
2020-03-16;TR;Turkey;12;0;18;0
2020-03-17;TR;Turkey;29;1;47;1
2020-03-18;TR;Turkey;51;0;98;1
2020-03-19;TR;Turkey;94;2;192;3
2020-03-20;TR;Turkey;167;1;359;4
2020-03-21;TR;Turkey;311;5;670;9
2020-03-22;TR;Turkey;566;21;1236;30
2020-03-23;TR;Turkey;293;7;1529;37
2020-03-24;TR;Turkey;343;7;1872;44
2020-03-25;TR;Turkey;561;15;2433;59
2020-03-26;TR;Turkey;1196;16;3629;75
2020-03-27;TR;Turkey;2069;17;5698;92
2020-03-28;TR;Turkey;1704;16;7402;108
2020-03-29;TR;Turkey;1815;23;9217;131
2020-03-30;TR;Turkey;1610;37;10827;168
2020-03-31;TR;Turkey;2704;46;13531;214
2020-04-01;TR;Turkey;2148;63;15679;277
2020-04-02;TR;Turkey;2456;79;18135;356
2020-04-03;TR;Turkey;2786;69;20921;425
2020-04-04;TR;Turkey;3013;76;23934;501
2020-04-05;TR;Turkey;3135;73;27069;574
2020-04-06;TR;Turkey;3148;75;30217;649
2020-04-07;TR;Turkey;3892;76;34109;725
2020-04-08;TR;Turkey;4117;87;38226;812
2020-04-09;TR;Turkey;4056;96;42282;908
2020-04-10;TR;Turkey;4747;98;47029;1006
2020-04-11;TR;Turkey;5138;95;52167;1101
2020-04-12;TR;Turkey;4789;97;56956;1198
2020-04-13;TR;Turkey;4093;98;61049;1296
2020-04-14;TR;Turkey;4062;107;65111;1403
2020-04-15;TR;Turkey;4281;115;69392;1518
2020-04-16;TR;Turkey;4801;125;74193;1643
2020-04-17;TR;Turkey;4353;126;78546;1769
2020-04-18;TR;Turkey;3783;121;82329;1890
2020-04-19;TR;Turkey;3977;127;86306;2017
2020-04-20;TR;Turkey;4674;123;90980;2140
2020-04-21;TR;Turkey;4611;119;95591;2259
2020-04-22;TR;Turkey;3083;117;98674;2376
2020-04-23;TR;Turkey;3116;115;101790;2491
2020-04-24;TR;Turkey;3122;109;104912;2600
2020-04-25;TR;Turkey;2861;106;107773;2706
2020-04-26;TR;Turkey;2357;99;110130;2805
2020-04-27;TR;Turkey;2131;95;112261;2900
2020-04-28;TR;Turkey;2392;92;114653;2992
2020-04-29;TR;Turkey;2936;89;117589;3081
2020-04-30;TR;Turkey;2615;93;120204;3174
2020-05-01;TR;Turkey;2188;84;122392;3258
2020-05-02;TR;Turkey;1983;78;124375;3336
2020-05-03;TR;Turkey;1670;61;126045;3397
2020-05-04;TR;Turkey;1614;64;127659;3461
2020-05-05;TR;Turkey;1832;59;129491;3520
2020-05-06;TR;Turkey;2253;64;131744;3584
2020-05-07;TR;Turkey;1977;57;133721;3641
2020-05-08;TR;Turkey;1848;48;135569;3689
2020-05-09;TR;Turkey;1546;50;137115;3739
2020-05-10;TR;Turkey;1542;47;138657;3786
2020-05-11;TR;Turkey;1114;55;139771;3841
2020-05-12;TR;Turkey;1704;53;141475;3894
2020-05-13;TR;Turkey;1639;58;143114;3952
2020-05-14;TR;Turkey;1635;55;144749;4007
2020-05-15;TR;Turkey;1708;48;146457;4055
2020-05-16;TR;Turkey;1610;41;148067;4096
2020-05-17;TR;Turkey;1368;44;149435;4140
2020-05-18;TR;Turkey;1158;31;150593;4171
2020-05-19;TR;Turkey;1022;28;151615;4199
2020-05-20;TR;Turkey;972;23;152587;4222
2020-05-21;TR;Turkey;961;27;153548;4249
2020-05-22;TR;Turkey;952;27;154500;4276
2020-05-23;TR;Turkey;1186;32;155686;4308
2020-05-24;TR;Turkey;1141;32;156827;4340
2020-05-25;TR;Turkey;987;29;157814;4369
2020-05-26;TR;Turkey;948;28;158762;4397
2020-05-27;TR;Turkey;1035;34;159797;4431
2020-05-28;TR;Turkey;1182;30;160979;4461
2020-05-29;TR;Turkey;1141;28;162120;4489
2020-05-30;TR;Turkey;983;26;163103;4515
2020-05-31;TR;Turkey;839;25;163942;4540
2020-06-01;TR;Turkey;827;23;164769;4563
2020-06-02;TR;Turkey;786;22;165555;4585
2020-06-03;TR;Turkey;867;24;166422;4609
2020-06-04;TR;Turkey;988;21;167410;4630
2020-06-05;TR;Turkey;930;18;168340;4648
2020-06-06;TR;Turkey;878;21;169218;4669
2020-06-07;TR;Turkey;914;23;170132;4692
2020-06-08;TR;Turkey;989;19;171121;4711
2020-06-09;TR;Turkey;993;18;172114;4729
2020-06-10;TR;Turkey;922;17;173036;4746
2020-06-11;TR;Turkey;987;17;174023;4763
2020-06-12;TR;Turkey;1195;15;175218;4778
2020-06-13;TR;Turkey;1459;14;176677;4792
2020-06-14;TR;Turkey;1562;15;178239;4807
2020-06-15;TR;Turkey;1592;18;179831;4825
2020-06-16;TR;Turkey;1467;17;181298;4842
2020-06-17;TR;Turkey;1429;19;182727;4861
2020-06-18;TR;Turkey;1304;21;184031;4882
2020-06-19;TR;Turkey;1214;23;185245;4905
2020-06-20;TR;Turkey;1248;22;186493;4927
2020-06-21;TR;Turkey;1192;23;187685;4950
2020-06-22;TR;Turkey;1212;24;188897;4974
2020-06-23;TR;Turkey;1268;27;190165;5001
2020-06-24;TR;Turkey;1492;24;191657;5025
2020-06-25;TR;Turkey;1458;21;193115;5046
2020-06-26;TR;Turkey;1396;19;194511;5065
2020-06-27;TR;Turkey;1372;17;195883;5082
2020-06-28;TR;Turkey;1356;15;197239;5097
2020-06-29;TR;Turkey;1374;18;198613;5115
2020-06-30;TR;Turkey;1293;16;199906;5131
2020-07-01;TR;Turkey;1192;19;201098;5150
2020-07-02;TR;Turkey;1186;17;202284;5167
2020-07-03;TR;Turkey;1172;19;203456;5186
2020-07-04;TR;Turkey;1154;20;204610;5206
2020-07-05;TR;Turkey;1148;19;205758;5225
2020-07-06;TR;Turkey;1086;16;206844;5241
2020-07-07;TR;Turkey;1053;19;207897;5260
2020-07-08;TR;Turkey;1041;22;208938;5282
2020-07-09;TR;Turkey;1024;18;209962;5300
2020-07-10;TR;Turkey;1003;23;210965;5323
2020-07-11;TR;Turkey;1016;21;211981;5344
2020-07-12;TR;Turkey;1012;19;212993;5363
2020-07-13;TR;Turkey;1008;19;214001;5382
2020-07-14;TR;Turkey;992;20;214993;5402
2020-07-15;TR;Turkey;947;17;215940;5419
2020-07-16;TR;Turkey;933;21;216873;5440
2020-07-17;TR;Turkey;926;18;217799;5458
2020-07-18;TR;Turkey;918;17;218717;5475
2020-07-19;TR;Turkey;924;16;219641;5491
2020-07-20;TR;Turkey;931;17;220572;5508
2020-07-21;TR;Turkey;928;18;221500;5526
2020-07-22;TR;Turkey;902;19;222402;5545
2020-07-23;TR;Turkey;913;18;223315;5563
2020-07-24;TR;Turkey;937;17;224252;5580
2020-07-25;TR;Turkey;921;16;225173;5596
2020-07-26;TR;Turkey;927;17;226100;5613
2020-07-27;TR;Turkey;919;17;227019;5630
2020-07-28;TR;Turkey;963;15;227982;5645
2020-07-29;TR;Turkey;942;14;228924;5659
2020-07-30;TR;Turkey;967;15;229891;5674
2020-07-31;TR;Turkey;982;17;230873;5691
2020-08-01;TR;Turkey;996;19;231869;5710
2020-08-02;TR;Turkey;987;18;232856;5728
2020-08-03;TR;Turkey;995;19;233851;5747
2020-08-04;TR;Turkey;1083;18;234934;5765
2020-08-05;TR;Turkey;1178;19;236112;5784
2020-08-06;TR;Turkey;1153;14;237265;5798
2020-08-07;TR;Turkey;1185;15;238450;5813
2020-08-08;TR;Turkey;1172;16;239622;5829
2020-08-09;TR;Turkey;1182;15;240804;5844
2020-08-10;TR;Turkey;1193;14;241997;5858
2020-08-11;TR;Turkey;1183;15;243180;5873
2020-08-12;TR;Turkey;1212;18;244392;5891
2020-08-13;TR;Turkey;1243;21;245635;5912
2020-08-14;TR;Turkey;1226;22;246861;5934
2020-08-15;TR;Turkey;1256;21;248117;5955
2020-08-16;TR;Turkey;1192;19;249309;5974
2020-08-17;TR;Turkey;1233;22;250542;5996
2020-08-18;TR;Turkey;1263;20;251805;6016
2020-08-19;TR;Turkey;1303;23;253108;6039
2020-08-20;TR;Turkey;1412;19;254520;6058
2020-08-21;TR;Turkey;1203;22;255723;6080
2020-08-22;TR;Turkey;1309;22;257032;6102
2020-08-23;TR;Turkey;1217;19;258249;6121
2020-08-24;TR;Turkey;1443;18;259692;6139
2020-08-25;TR;Turkey;1502;24;261194;6163
2020-08-26;TR;Turkey;1313;20;262507;6183
2020-08-27;TR;Turkey;1491;26;263998;6209
2020-08-28;TR;Turkey;1517;36;265515;6245
2020-08-29;TR;Turkey;1549;39;267064;6284
2020-08-30;TR;Turkey;1482;42;268546;6326
2020-08-31;TR;Turkey;1587;44;270133;6370
2020-09-01;TR;Turkey;1572;47;271705;6417
2020-09-02;TR;Turkey;1596;45;273301;6462
2020-09-03;TR;Turkey;1642;49;274943;6511
2020-09-04;TR;Turkey;1612;53;276555;6564
2020-09-05;TR;Turkey;1673;56;278228;6620
2020-09-06;TR;Turkey;1578;53;279806;6673
2020-09-07;TR;Turkey;1703;57;281509;6730
2020-09-08;TR;Turkey;1761;52;283270;6782
2020-09-09;TR;Turkey;1673;55;284943;6837
2020-09-10;TR;Turkey;1512;58;286455;6895
2020-09-11;TR;Turkey;1671;56;288126;6951
2020-09-12;TR;Turkey;1509;48;289635;6999
2020-09-13;TR;Turkey;1527;57;291162;7056
2020-09-14;TR;Turkey;1716;63;292878;7119
2020-09-15;TR;Turkey;1742;67;294620;7186
2020-09-16;TR;Turkey;1771;63;296391;7249
2020-09-17;TR;Turkey;1648;66;298039;7315
2020-09-18;TR;Turkey;1771;62;299810;7377
2020-09-19;TR;Turkey;1538;68;301348;7445
2020-09-20;TR;Turkey;1519;61;302867;7506
2020-09-21;TR;Turkey;1743;68;304610;7574
2020-09-22;TR;Turkey;1692;65;306302;7639
2020-09-23;TR;Turkey;1767;72;308069;7711
2020-09-24;TR;Turkey;1721;74;309790;7785
2020-09-25;TR;Turkey;1665;73;311455;7858
2020-09-26;TR;Turkey;1511;71;312966;7929
2020-09-27;TR;Turkey;1467;68;314433;7997
2020-09-28;TR;Turkey;1412;65;315845;8062
2020-09-29;TR;Turkey;1427;68;317272;8130
2020-09-30;TR;Turkey;1391;65;318663;8195
2020-10-01;TR;Turkey;1407;67;320070;8262
2020-10-02;TR;Turkey;1442;63;321512;8325
2020-10-03;TR;Turkey;1502;59;323014;8384
2020-10-04;TR;Turkey;1429;57;324443;8441
2020-10-05;TR;Turkey;1603;57;326046;8498
2020-10-06;TR;Turkey;1511;55;327557;8553
2020-10-07;TR;Turkey;1581;56;329138;8609
2020-10-08;TR;Turkey;1615;58;330753;8667
2020-10-09;TR;Turkey;1629;55;332382;8722
2020-10-10;TR;Turkey;1649;56;334031;8778
2020-10-11;TR;Turkey;1502;59;335533;8837
2020-10-12;TR;Turkey;1614;58;337147;8895
2020-10-13;TR;Turkey;1632;62;338779;8957
2020-10-14;TR;Turkey;1671;57;340450;9014
2020-10-15;TR;Turkey;1693;66;342143;9080
2020-10-16;TR;Turkey;1812;73;343955;9153
2020-10-17;TR;Turkey;1723;71;345678;9224
2020-10-18;TR;Turkey;1815;72;347493;9296
2020-10-19;TR;Turkey;2026;75;349519;9371
2020-10-20;TR;Turkey;1894;74;351413;9445
2020-10-21;TR;Turkey;2013;68;353426;9513
2020-10-22;TR;Turkey;2102;71;355528;9584
2020-10-23;TR;Turkey;2165;74;357693;9658
2020-10-24;TR;Turkey;2091;69;359784;9727
2020-10-25;TR;Turkey;2017;72;361801;9799
2020-10-26;TR;Turkey;2198;75;363999;9874
2020-10-27;TR;Turkey;2209;76;366208;9950
2020-10-28;TR;Turkey;2305;77;368513;10027
2020-10-29;TR;Turkey;2319;72;370832;10099
2020-10-30;TR;Turkey;2322;78;373154;10177
2020-10-31;TR;Turkey;2213;75;375367;10252
2020-11-01;TR;Turkey;2106;74;377473;10326
2020-11-02;TR;Turkey;2302;76;379775;10402
2020-11-03;TR;Turkey;2343;79;382118;10481
2020-11-04;TR;Turkey;2391;77;384509;10558
2020-11-05;TR;Turkey;2311;81;386820;10639
2020-11-06;TR;Turkey;2436;83;389256;10722
2020-11-07;TR;Turkey;2483;81;391739;10803
2020-11-08;TR;Turkey;2516;84;394255;10887
2020-11-09;TR;Turkey;2576;85;396831;10972
2020-11-10;TR;Turkey;2529;87;399360;11059
2020-11-11;TR;Turkey;2693;86;402053;11145
2020-11-12;TR;Turkey;2841;88;404894;11233
2020-11-13;TR;Turkey;3045;93;407939;11326
2020-11-14;TR;Turkey;3116;92;411055;11418
2020-11-15;TR;Turkey;3223;89;414278;11507
2020-11-16;TR;Turkey;3316;94;417594;11601
2020-11-17;TR;Turkey;3819;103;421413;11704
2020-11-18;TR;Turkey;4215;116;425628;11820
2020-11-19;TR;Turkey;4542;123;430170;11943
2020-11-20;TR;Turkey;5103;141;435273;12084
2020-11-21;TR;Turkey;5532;135;440805;12219
2020-11-22;TR;Turkey;6017;139;446822;12358
2020-11-23;TR;Turkey;6713;153;453535;12511
2020-11-24;TR;Turkey;7381;161;460916;12672
2020-11-25;TR;Turkey;6814;168;467730;12840
2020-11-26;TR;Turkey;36008;174;503738;13014
2020-11-27;TR;Turkey;44506;177;548244;13191
2020-11-28;TR;Turkey;30103;182;578347;13373
2020-11-29;TR;Turkey;29281;185;607628;13558
2020-11-30;TR;Turkey;31219;188;638847;13746
2020-12-01;TR;Turkey;30110;190;668957;13936
2020-12-02;TR;Turkey;31923;193;700880;14129
2020-12-03;TR;Turkey;32381;187;733261;14316
2020-12-04;TR;Turkey;32736;193;765997;14509
2020-12-05;TR;Turkey;31896;196;797893;14705
2020-12-06;TR;Turkey;30402;195;828295;14900
2020-12-07;TR;Turkey;32137;203;860432;15103
2020-12-08;TR;Turkey;33198;211;893630;15314
2020-12-09;TR;Turkey;31712;217;925342;15531
2020-12-10;TR;Turkey;0;220;1748567;15751
2020-12-11;TR;Turkey;32106;226;1780673;15977
2020-12-12;TR;Turkey;29136;222;1809809;16199
2020-12-13;TR;Turkey;26919;218;1836728;16417
2020-12-14;TR;Turkey;29617;229;1866345;16646
2020-12-15;TR;Turkey;32102;235;1898447;16881
2020-12-16;TR;Turkey;29718;240;1928165;17121
2020-12-17;TR;Turkey;27515;243;1955680;17364
2020-12-18;TR;Turkey;26410;246;1982090;17610
2020-12-19;TR;Turkey;22195;241;2004285;17851
2020-12-20;TR;Turkey;20316;246;2024601;18097
2020-12-21;TR;Turkey;19103;254;2043704;18351
2020-12-22;TR;Turkey;19256;251;2062960;18602
2020-12-23;TR;Turkey;19650;259;2082610;18861
2020-12-24;TR;Turkey;18102;254;2100712;19115
2020-12-25;TR;Turkey;17543;256;2118255;19371
2020-12-26;TR;Turkey;15118;253;2133373;19624
2020-12-27;TR;Turkey;14205;254;2147578;19878
2020-12-28;TR;Turkey;15197;257;2162775;20135
2020-12-29;TR;Turkey;15805;253;2178580;20388
2020-12-30;TR;Turkey;15692;254;2194272;20642
2020-12-31;TR;Turkey;14380;239;2208652;20881
2021-01-01;TR;Turkey;12203;212;2220855;21093
2021-01-02;TR;Turkey;11180;202;2232035;21295
2021-01-03;TR;Turkey;9877;193;2241912;21488
2021-01-04;TR;Turkey;13695;197;2255607;21685
2021-01-05;TR;Turkey;14494;194;2270101;21879
2021-01-06;TR;Turkey;13830;191;2283931;22070
2021-01-07;TR;Turkey;12171;194;2296102;22264
2021-01-08;TR;Turkey;11479;186;2307581;22450
2021-01-09;TR;Turkey;9537;181;2317118;22631
2021-01-10;TR;Turkey;9138;176;2326256;22807
2021-01-11;TR;Turkey;10220;174;2336476;22981
2021-01-12;TR;Turkey;9809;171;2346285;23152
2021-01-13;TR;Turkey;9554;173;2355839;23325
2021-01-14;TR;Turkey;8962;170;2364801;23495
2021-01-15;TR;Turkey;8314;169;2373115;23664
2021-01-16;TR;Turkey;7550;168;2380665;23832
2021-01-17;TR;Turkey;6436;165;2387101;23997
2021-01-18;TR;Turkey;5862;164;2392963;24161
2021-01-19;TR;Turkey;6818;167;2399781;24328
2021-01-20;TR;Turkey;6435;159;2406216;24487
2021-01-21;TR;Turkey;6289;153;2412505;24640
2021-01-22;TR;Turkey;5967;149;2418472;24789
2021-01-23;TR;Turkey;5856;144;2424328;24933
2021-01-24;TR;Turkey;5277;140;2429605;25073
2021-01-25;TR;Turkey;5642;137;2435247;25210
2021-01-26;TR;Turkey;7103;134;2442350;25344
2021-01-27;TR;Turkey;7489;132;2449839;25476
2021-01-28;TR;Turkey;7279;129;2457118;25605
2021-01-29;TR;Turkey;6912;131;2464030;25736
2021-01-30;TR;Turkey;6871;129;2470901;25865
2021-01-31;TR;Turkey;6562;128;2477463;25993
2021-02-01;TR;Turkey;7719;124;2485182;26117
2021-02-02;TR;Turkey;7795;120;2492977;26237
2021-02-03;TR;Turkey;8102;117;2501079;26354
2021-02-04;TR;Turkey;7909;113;2508988;26467
2021-02-05;TR;Turkey;7901;110;2516889;26577
2021-02-06;TR;Turkey;7897;108;2524786;26685
2021-02-07;TR;Turkey;6670;112;2531456;26797
2021-02-08;TR;Turkey;8103;103;2539559;26900
2021-02-09;TR;Turkey;8636;98;2548195;26998
2021-02-10;TR;Turkey;8642;95;2556837;27093
2021-02-11;TR;Turkey;7590;94;2564427;27187
2021-02-12;TR;Turkey;7763;97;2572190;27284
2021-02-13;TR;Turkey;7706;93;2579896;27377
2021-02-14;TR;Turkey;6287;94;2586183;27471
2021-02-15;TR;Turkey;7945;91;2594128;27562
2021-02-16;TR;Turkey;7906;90;2602034;27652
2021-02-17;TR;Turkey;7325;86;2609359;27738
2021-02-18;TR;Turkey;7241;83;2616600;27821
2021-02-19;TR;Turkey;7419;82;2624019;27903
2021-02-20;TR;Turkey;7857;80;2631876;27983
2021-02-21;TR;Turkey;6546;77;2638422;28060
2021-02-22;TR;Turkey;8104;78;2646526;28138
2021-02-23;TR;Turkey;9107;75;2655633;28213
2021-02-24;TR;Turkey;9561;72;2665194;28285
2021-02-25;TR;Turkey;9572;73;2674766;28358
2021-02-26;TR;Turkey;9205;74;2683971;28432
2021-02-27;TR;Turkey;9193;71;2693164;28503
2021-02-28;TR;Turkey;8424;66;2701588;28569
2021-03-01;TR;Turkey;9891;69;2711479;28638
2021-03-02;TR;Turkey;11837;68;2723316;28706
2021-03-03;TR;Turkey;11520;65;2734836;28771
2021-03-04;TR;Turkey;11322;68;2746158;28839
2021-03-05;TR;Turkey;11302;62;2757460;28901
2021-03-06;TR;Turkey;11770;64;2769230;28965
2021-03-07;TR;Turkey;11187;65;2780417;29030
2021-03-08;TR;Turkey;13215;64;2793632;29094
2021-03-09;TR;Turkey;13755;66;2807387;29160
2021-03-10;TR;Turkey;14556;67;2821943;29227
2021-03-11;TR;Turkey;14046;63;2835989;29290
2021-03-12;TR;Turkey;14941;66;2850930;29356
2021-03-13;TR;Turkey;15082;65;2866012;29421
2021-03-14;TR;Turkey;13378;68;2879390;29489
2021-03-15;TR;Turkey;15503;63;2894893;29552
2021-03-16;TR;Turkey;16749;71;2911642;29623
2021-03-17;TR;Turkey;18912;73;2930554;29696
2021-03-18;TR;Turkey;20049;81;2950603;29777
2021-03-19;TR;Turkey;21030;87;2971633;29864
2021-03-20;TR;Turkey;21061;95;2992694;29959
2021-03-21;TR;Turkey;20428;102;3013122;30061
2021-03-22;TR;Turkey;22216;117;3035338;30178
2021-03-23;TR;Turkey;26182;138;3061520;30316
2021-03-24;TR;Turkey;29762;146;3091282;30462
2021-03-25;TR;Turkey;28731;157;3120013;30619
2021-03-26;TR;Turkey;29081;153;3149094;30772
2021-03-27;TR;Turkey;30021;151;3179115;30923
2021-03-28;TR;Turkey;29058;153;3208173;31076
2021-03-29;TR;Turkey;32404;154;3240577;31230
2021-03-30;TR;Turkey;37303;155;3277880;31385
2021-03-31;TR;Turkey;39302;152;3317182;31537
2021-04-01;TR;Turkey;40806;176;3357988;31713
2021-04-02;TR;Turkey;42308;179;3400296;31892
2021-04-03;TR;Turkey;44756;186;3445052;32078
2021-04-04;TR;Turkey;41998;185;3487050;32263
2021-04-05;TR;Turkey;42551;193;3529601;32456
2021-04-06;TR;Turkey;49584;211;3579185;32667
2021-04-07;TR;Turkey;54740;276;3633925;32943
2021-04-08;TR;Turkey;55941;258;3689866;33201
2021-04-09;TR;Turkey;55791;253;3745657;33454
2021-04-10;TR;Turkey;52676;248;3798333;33702
2021-04-11;TR;Turkey;50678;237;3849011;33939
2021-04-12;TR;Turkey;54562;243;3903573;34182
2021-04-13;TR;Turkey;59187;273;3962760;34455
2021-04-14;TR;Turkey;62797;279;4025557;34734
2021-04-15;TR;Turkey;61400;297;4086957;35031
2021-04-16;TR;Turkey;63082;289;4150039;35320
2021-04-17;TR;Turkey;62606;288;4212645;35608
2021-04-18;TR;Turkey;55802;318;4268447;35926
2021-04-19;TR;Turkey;55149;341;4323596;36267
2021-04-20;TR;Turkey;61028;346;4384624;36613
2021-04-21;TR;Turkey;61967;362;4446591;36975
2021-04-22;TR;Turkey;54791;354;4501382;37329
2021-04-23;TR;Turkey;49438;343;4550820;37672
2021-04-24;TR;Turkey;40596;339;4591416;38011
2021-04-25;TR;Turkey;38553;347;4629969;38358
2021-04-26;TR;Turkey;37312;353;4667281;38711
2021-04-27;TR;Turkey;43301;346;4710582;39057
2021-04-28;TR;Turkey;40444;341;4751026;39398
2021-04-29;TR;Turkey;37674;339;4788700;39737
2021-04-30;TR;Turkey;31891;394;4820591;40131
2021-05-01;TR;Turkey;28817;373;4849408;40504
2021-05-02;TR;Turkey;25980;340;4875388;40844
2021-05-03;TR;Turkey;24733;347;4900121;41191
2021-05-04;TR;Turkey;28997;336;4929118;41527
2021-05-05;TR;Turkey;26476;356;4955594;41883
2021-05-06;TR;Turkey;22388;304;4977982;42187
2021-05-07;TR;Turkey;20107;278;4998089;42465
2021-05-08;TR;Turkey;18052;281;5016141;42746
2021-05-09;TR;Turkey;15191;283;5031332;43029
2021-05-10;TR;Turkey;13604;282;5044936;43311
2021-05-11;TR;Turkey;14497;278;5059433;43589
2021-05-12;TR;Turkey;13029;232;5072462;43821
2021-05-13;TR;Turkey;11534;238;5083996;44059
2021-05-14;TR;Turkey;11394;242;5095390;44301
2021-05-15;TR;Turkey;11472;236;5106862;44537
2021-05-16;TR;Turkey;10512;223;5117374;44760
2021-05-17;TR;Turkey;10174;223;5127548;44983
2021-05-18;TR;Turkey;11937;203;5139485;45186
2021-05-19;TR;Turkey;11553;233;5151038;45419
2021-05-20;TR;Turkey;9385;207;5160423;45626
2021-05-21;TR;Turkey;9528;214;5169951;45840
2021-05-22;TR;Turkey;8697;231;5178648;46071
2021-05-23;TR;Turkey;7839;197;5186487;46268
2021-05-24;TR;Turkey;7523;178;5194010;46446
2021-05-25;TR;Turkey;9375;175;5203385;46621
2021-05-26;TR;Turkey;8738;166;5212123;46787
2021-05-27;TR;Turkey;8426;183;5220549;46970
2021-05-28;TR;Turkey;7773;164;5228322;47134
2021-05-29;TR;Turkey;7656;137;5235978;47271
2021-05-30;TR;Turkey;6933;134;5242911;47405
2021-05-31;TR;Turkey;6493;122;5249404;47527
2021-06-01;TR;Turkey;7112;129;5256516;47656
2021-06-02;TR;Turkey;7181;112;5263697;47768
2021-06-03;TR;Turkey;6602;114;5270299;47882
2021-06-04;TR;Turkey;6169;94;5276468;47976
2021-06-05;TR;Turkey;6126;92;5282594;48068
2021-06-06;TR;Turkey;5386;96;5287980;48164
2021-06-07;TR;Turkey;5647;91;5293627;48255
2021-06-08;TR;Turkey;6609;86;5300236;48341
2021-06-09;TR;Turkey;6454;87;5306690;48428
2021-06-10;TR;Turkey;6408;96;5313098;48524
2021-06-11;TR;Turkey;6261;69;5319359;48593
2021-06-12;TR;Turkey;6076;75;5325435;48668
2021-06-13;TR;Turkey;5012;53;5330447;48721
2021-06-14;TR;Turkey;5626;74;5336073;48795
2021-06-15;TR;Turkey;5955;84;5342028;48879
2021-06-16;TR;Turkey;6221;71;5348249;48950
2021-06-17;TR;Turkey;5904;62;5354153;49012
2021-06-18;TR;Turkey;5575;59;5359728;49071
2021-06-19;TR;Turkey;5480;51;5365208;49122
2021-06-20;TR;Turkey;5091;63;5370299;49185
2021-06-21;TR;Turkey;5294;51;5375593;49236
2021-06-22;TR;Turkey;6143;57;5381736;49293
2021-06-23;TR;Turkey;5809;65;5387545;49358
2021-06-24;TR;Turkey;5703;59;5393248;49417
2021-06-25;TR;Turkey;5630;56;5398878;49473
2021-06-26;TR;Turkey;5266;51;5404144;49524
2021-06-27;TR;Turkey;4883;52;5409027;49576
2021-06-28;TR;Turkey;5283;58;5414310;49634
2021-06-29;TR;Turkey;5846;53;5420156;49687
2021-06-30;TR;Turkey;5496;45;5425652;49732
2021-07-01;TR;Turkey;5288;42;5430940;49774
2021-04-04;TM;Turkmenistan;0;0;0;0
2021-01-10;TC;Turks and Caicos Islands;0;0;0;0
2021-01-11;TC;Turks and Caicos Islands;0;0;0;0
2021-01-12;TC;Turks and Caicos Islands;0;0;0;0
2021-01-13;TC;Turks and Caicos Islands;0;0;0;0
2021-01-14;TC;Turks and Caicos Islands;0;0;0;0
2021-01-15;TC;Turks and Caicos Islands;0;0;0;0
2021-01-16;TC;Turks and Caicos Islands;0;0;0;0
2021-01-17;TC;Turks and Caicos Islands;0;0;0;0
2021-01-18;TC;Turks and Caicos Islands;0;0;0;0
2021-01-19;TC;Turks and Caicos Islands;0;0;0;0
2021-01-20;TC;Turks and Caicos Islands;0;0;0;0
2021-01-21;TC;Turks and Caicos Islands;0;0;0;0
2021-01-22;TC;Turks and Caicos Islands;0;0;0;0
2021-01-23;TC;Turks and Caicos Islands;0;0;0;0
2021-01-24;TC;Turks and Caicos Islands;0;0;0;0
2021-01-25;TC;Turks and Caicos Islands;0;0;0;0
2021-01-26;TC;Turks and Caicos Islands;0;0;0;0
2021-01-27;TC;Turks and Caicos Islands;0;0;0;0
2021-01-28;TC;Turks and Caicos Islands;0;0;0;0
2021-01-29;TC;Turks and Caicos Islands;0;0;0;0
2021-01-30;TC;Turks and Caicos Islands;0;0;0;0
2021-01-31;TC;Turks and Caicos Islands;0;0;0;0
2021-02-01;TC;Turks and Caicos Islands;0;0;0;0
2021-02-02;TC;Turks and Caicos Islands;0;0;0;0
2021-02-03;TC;Turks and Caicos Islands;0;0;0;0
2021-02-04;TC;Turks and Caicos Islands;0;0;0;0
2021-02-05;TC;Turks and Caicos Islands;0;0;0;0
2021-02-06;TC;Turks and Caicos Islands;0;0;0;0
2021-02-07;TC;Turks and Caicos Islands;0;0;0;0
2021-02-08;TC;Turks and Caicos Islands;0;0;0;0
2021-02-09;TC;Turks and Caicos Islands;0;0;0;0
2021-02-10;TC;Turks and Caicos Islands;0;0;0;0
2021-02-11;TC;Turks and Caicos Islands;0;0;0;0
2021-02-12;TC;Turks and Caicos Islands;0;0;0;0
2021-02-13;TC;Turks and Caicos Islands;0;0;0;0
2021-02-14;TC;Turks and Caicos Islands;0;0;0;0
2021-02-15;TC;Turks and Caicos Islands;0;0;0;0
2021-02-16;TC;Turks and Caicos Islands;0;0;0;0
2021-02-17;TC;Turks and Caicos Islands;0;0;0;0
2021-02-18;TC;Turks and Caicos Islands;0;0;0;0
2021-02-19;TC;Turks and Caicos Islands;0;0;0;0
2021-02-20;TC;Turks and Caicos Islands;0;0;0;0
2021-02-21;TC;Turks and Caicos Islands;0;0;0;0
2021-02-22;TC;Turks and Caicos Islands;0;0;0;0
2021-02-23;TC;Turks and Caicos Islands;0;0;0;0
2021-02-24;TC;Turks and Caicos Islands;0;0;0;0
2021-02-25;TC;Turks and Caicos Islands;0;0;0;0
2021-02-26;TC;Turks and Caicos Islands;0;0;0;0
2021-02-27;TC;Turks and Caicos Islands;0;0;0;0
2021-02-28;TC;Turks and Caicos Islands;0;0;0;0
2021-03-01;TC;Turks and Caicos Islands;0;0;0;0
2021-03-02;TC;Turks and Caicos Islands;0;0;0;0
2021-03-03;TC;Turks and Caicos Islands;0;0;0;0
2021-03-04;TC;Turks and Caicos Islands;0;0;0;0
2021-03-05;TC;Turks and Caicos Islands;0;0;0;0
2021-03-06;TC;Turks and Caicos Islands;0;0;0;0
2021-03-07;TC;Turks and Caicos Islands;0;0;0;0
2021-03-08;TC;Turks and Caicos Islands;0;0;0;0
2021-03-09;TC;Turks and Caicos Islands;0;0;0;0
2021-03-10;TC;Turks and Caicos Islands;0;0;0;0
2021-03-11;TC;Turks and Caicos Islands;0;0;0;0
2021-03-12;TC;Turks and Caicos Islands;0;0;0;0
2021-03-13;TC;Turks and Caicos Islands;0;0;0;0
2021-03-14;TC;Turks and Caicos Islands;0;0;0;0
2021-03-15;TC;Turks and Caicos Islands;0;0;0;0
2021-03-16;TC;Turks and Caicos Islands;0;0;0;0
2021-03-17;TC;Turks and Caicos Islands;0;0;0;0
2021-03-18;TC;Turks and Caicos Islands;0;0;0;0
2021-03-19;TC;Turks and Caicos Islands;0;0;0;0
2021-03-20;TC;Turks and Caicos Islands;0;0;0;0
2021-03-21;TC;Turks and Caicos Islands;0;0;0;0
2021-03-22;TC;Turks and Caicos Islands;0;0;0;0
2021-03-23;TC;Turks and Caicos Islands;0;0;0;0
2021-03-24;TC;Turks and Caicos Islands;0;0;0;0
2021-03-25;TC;Turks and Caicos Islands;0;0;0;0
2021-03-26;TC;Turks and Caicos Islands;0;0;0;0
2021-03-27;TC;Turks and Caicos Islands;0;0;0;0
2021-03-28;TC;Turks and Caicos Islands;0;0;0;0
2021-03-29;TC;Turks and Caicos Islands;0;0;0;0
2021-03-30;TC;Turks and Caicos Islands;0;0;0;0
2021-03-31;TC;Turks and Caicos Islands;0;0;0;0
2021-04-01;TC;Turks and Caicos Islands;0;0;0;0
2021-04-02;TC;Turks and Caicos Islands;0;0;0;0
2021-04-03;TC;Turks and Caicos Islands;0;0;0;0
2021-04-04;TC;Turks and Caicos Islands;0;0;0;0
2021-04-05;TC;Turks and Caicos Islands;0;0;0;0
2021-04-06;TC;Turks and Caicos Islands;0;0;0;0
2021-04-07;TC;Turks and Caicos Islands;0;0;0;0
2021-04-08;TC;Turks and Caicos Islands;0;0;0;0
2021-04-09;TC;Turks and Caicos Islands;0;0;0;0
2021-04-10;TC;Turks and Caicos Islands;0;0;0;0
2021-04-11;TC;Turks and Caicos Islands;0;0;0;0
2021-04-12;TC;Turks and Caicos Islands;0;0;0;0
2021-04-13;TC;Turks and Caicos Islands;0;0;0;0
2021-04-14;TC;Turks and Caicos Islands;0;0;0;0
2021-04-15;TC;Turks and Caicos Islands;0;0;0;0
2021-04-16;TC;Turks and Caicos Islands;0;0;0;0
2021-04-17;TC;Turks and Caicos Islands;0;0;0;0
2021-04-18;TC;Turks and Caicos Islands;0;0;0;0
2021-04-19;TC;Turks and Caicos Islands;0;0;0;0
2021-04-20;TC;Turks and Caicos Islands;0;0;0;0
2021-04-21;TC;Turks and Caicos Islands;0;0;0;0
2021-04-22;TC;Turks and Caicos Islands;0;0;0;0
2021-04-23;TC;Turks and Caicos Islands;0;0;0;0
2021-04-24;TC;Turks and Caicos Islands;0;0;0;0
2021-04-25;TC;Turks and Caicos Islands;0;0;0;0
2021-04-26;TC;Turks and Caicos Islands;0;0;0;0
2021-04-27;TC;Turks and Caicos Islands;0;0;0;0
2021-04-28;TC;Turks and Caicos Islands;0;0;0;0
2021-04-29;TC;Turks and Caicos Islands;0;0;0;0
2021-04-30;TC;Turks and Caicos Islands;0;0;0;0
2021-05-01;TC;Turks and Caicos Islands;0;0;0;0
2021-05-02;TC;Turks and Caicos Islands;0;0;0;0
2021-05-03;TC;Turks and Caicos Islands;0;0;0;0
2021-05-04;TC;Turks and Caicos Islands;0;0;0;0
2021-05-05;TC;Turks and Caicos Islands;0;0;0;0
2021-05-06;TC;Turks and Caicos Islands;0;0;0;0
2021-05-07;TC;Turks and Caicos Islands;0;0;0;0
2021-05-08;TC;Turks and Caicos Islands;0;0;0;0
2021-05-09;TC;Turks and Caicos Islands;0;0;0;0
2021-05-10;TC;Turks and Caicos Islands;0;0;0;0
2021-05-11;TC;Turks and Caicos Islands;0;0;0;0
2021-05-12;TC;Turks and Caicos Islands;0;0;0;0
2021-05-13;TC;Turks and Caicos Islands;0;0;0;0
2021-05-14;TC;Turks and Caicos Islands;0;0;0;0
2021-05-15;TC;Turks and Caicos Islands;0;0;0;0
2021-05-16;TC;Turks and Caicos Islands;0;0;0;0
2021-05-17;TC;Turks and Caicos Islands;0;0;0;0
2021-05-18;TC;Turks and Caicos Islands;0;0;0;0
2021-05-19;TC;Turks and Caicos Islands;0;0;0;0
2021-05-20;TC;Turks and Caicos Islands;0;0;0;0
2021-05-21;TC;Turks and Caicos Islands;0;0;0;0
2021-05-22;TC;Turks and Caicos Islands;0;0;0;0
2021-05-23;TC;Turks and Caicos Islands;0;0;0;0
2021-05-24;TC;Turks and Caicos Islands;0;0;0;0
2021-05-25;TC;Turks and Caicos Islands;0;0;0;0
2021-05-26;TC;Turks and Caicos Islands;0;0;0;0
2021-05-27;TC;Turks and Caicos Islands;0;0;0;0
2021-05-28;TC;Turks and Caicos Islands;0;0;0;0
2021-05-29;TC;Turks and Caicos Islands;0;0;0;0
2021-05-30;TC;Turks and Caicos Islands;0;0;0;0
2021-05-31;TC;Turks and Caicos Islands;0;0;0;0
2021-06-01;TC;Turks and Caicos Islands;0;0;0;0
2021-06-02;TC;Turks and Caicos Islands;0;0;0;0
2021-06-03;TC;Turks and Caicos Islands;0;0;0;0
2021-06-04;TC;Turks and Caicos Islands;0;0;0;0
2021-06-05;TC;Turks and Caicos Islands;0;0;0;0
2021-06-06;TC;Turks and Caicos Islands;0;0;0;0
2021-06-07;TC;Turks and Caicos Islands;0;0;0;0
2021-06-08;TC;Turks and Caicos Islands;0;0;0;0
2021-06-09;TC;Turks and Caicos Islands;0;0;0;0
2021-06-10;TC;Turks and Caicos Islands;0;0;0;0
2021-06-11;TC;Turks and Caicos Islands;0;0;0;0
2021-06-12;TC;Turks and Caicos Islands;0;0;0;0
2021-06-13;TC;Turks and Caicos Islands;0;0;0;0
2021-06-14;TC;Turks and Caicos Islands;0;0;0;0
2021-06-15;TC;Turks and Caicos Islands;0;0;0;0
2021-06-16;TC;Turks and Caicos Islands;0;0;0;0
2021-06-17;TC;Turks and Caicos Islands;0;0;0;0
2021-06-18;TC;Turks and Caicos Islands;0;0;0;0
2021-04-27;TV;Tuvalu;0;0;0;0
2021-04-28;TV;Tuvalu;0;0;0;0
2021-04-29;TV;Tuvalu;0;0;0;0
2021-04-30;TV;Tuvalu;0;0;0;0
2021-05-01;TV;Tuvalu;0;0;0;0
2021-05-02;TV;Tuvalu;0;0;0;0
2021-05-03;TV;Tuvalu;0;0;0;0
2021-05-04;TV;Tuvalu;0;0;0;0
2021-05-05;TV;Tuvalu;0;0;0;0
2021-05-06;TV;Tuvalu;0;0;0;0
2021-05-07;TV;Tuvalu;0;0;0;0
2021-05-08;TV;Tuvalu;0;0;0;0
2021-05-09;TV;Tuvalu;0;0;0;0
2021-05-10;TV;Tuvalu;0;0;0;0
2021-05-11;TV;Tuvalu;0;0;0;0
2021-05-12;TV;Tuvalu;0;0;0;0
2021-05-13;TV;Tuvalu;0;0;0;0
2021-05-14;TV;Tuvalu;0;0;0;0
2021-05-15;TV;Tuvalu;0;0;0;0
2021-05-16;TV;Tuvalu;0;0;0;0
2021-05-17;TV;Tuvalu;0;0;0;0
2021-05-18;TV;Tuvalu;0;0;0;0
2021-05-19;TV;Tuvalu;0;0;0;0
2021-05-20;TV;Tuvalu;0;0;0;0
2021-05-21;TV;Tuvalu;0;0;0;0
2021-05-22;TV;Tuvalu;0;0;0;0
2021-05-23;TV;Tuvalu;0;0;0;0
2021-05-24;TV;Tuvalu;0;0;0;0
2021-05-25;TV;Tuvalu;0;0;0;0
2021-05-26;TV;Tuvalu;0;0;0;0
2021-05-27;TV;Tuvalu;0;0;0;0
2021-05-28;TV;Tuvalu;0;0;0;0
2021-05-29;TV;Tuvalu;0;0;0;0
2021-05-30;TV;Tuvalu;0;0;0;0
2021-05-31;TV;Tuvalu;0;0;0;0
2021-06-01;TV;Tuvalu;0;0;0;0
2021-06-02;TV;Tuvalu;0;0;0;0
2021-06-03;TV;Tuvalu;0;0;0;0
2021-06-04;TV;Tuvalu;0;0;0;0
2021-06-05;TV;Tuvalu;0;0;0;0
2021-06-06;TV;Tuvalu;0;0;0;0
2021-06-07;TV;Tuvalu;0;0;0;0
2021-06-08;TV;Tuvalu;0;0;0;0
2021-06-09;TV;Tuvalu;0;0;0;0
2021-06-10;TV;Tuvalu;0;0;0;0
2021-06-11;TV;Tuvalu;0;0;0;0
2021-06-12;TV;Tuvalu;0;0;0;0
2021-06-13;TV;Tuvalu;0;0;0;0
2021-06-14;TV;Tuvalu;0;0;0;0
2021-06-15;TV;Tuvalu;0;0;0;0
2020-03-21;UG;Uganda;1;0;1;0
2020-03-22;UG;Uganda;0;0;1;0
2020-03-23;UG;Uganda;8;0;9;0
2020-03-24;UG;Uganda;0;0;9;0
2020-03-25;UG;Uganda;5;0;14;0
2020-03-26;UG;Uganda;0;0;14;0
2020-03-27;UG;Uganda;9;0;23;0
2020-03-28;UG;Uganda;7;0;30;0
2020-03-29;UG;Uganda;3;0;33;0
2020-03-30;UG;Uganda;0;0;33;0
2020-03-31;UG;Uganda;11;0;44;0
2020-04-01;UG;Uganda;0;0;44;0
2020-04-02;UG;Uganda;1;0;45;0
2020-04-03;UG;Uganda;3;0;48;0
2020-04-04;UG;Uganda;0;0;48;0
2020-04-05;UG;Uganda;4;0;52;0
2020-04-06;UG;Uganda;0;0;52;0
2020-04-07;UG;Uganda;0;0;52;0
2020-04-08;UG;Uganda;1;0;53;0
2020-04-09;UG;Uganda;0;0;53;0
2020-04-10;UG;Uganda;0;0;53;0
2020-04-11;UG;Uganda;0;0;53;0
2020-04-12;UG;Uganda;1;0;54;0
2020-04-13;UG;Uganda;0;0;54;0
2020-04-14;UG;Uganda;1;0;55;0
2020-04-15;UG;Uganda;0;0;55;0
2020-04-16;UG;Uganda;0;0;55;0
2020-04-17;UG;Uganda;1;0;56;0
2020-04-18;UG;Uganda;-1;0;55;0
2020-04-19;UG;Uganda;0;0;55;0
2020-04-20;UG;Uganda;1;0;56;0
2020-04-21;UG;Uganda;5;0;61;0
2020-04-22;UG;Uganda;2;0;63;0
2020-04-23;UG;Uganda;11;0;74;0
2020-04-24;UG;Uganda;1;0;75;0
2020-04-25;UG;Uganda;0;0;75;0
2020-04-26;UG;Uganda;4;0;79;0
2020-04-27;UG;Uganda;0;0;79;0
2020-04-28;UG;Uganda;0;0;79;0
2020-04-29;UG;Uganda;2;0;81;0
2020-04-30;UG;Uganda;2;0;83;0
2020-05-01;UG;Uganda;2;0;85;0
2020-05-02;UG;Uganda;3;0;88;0
2020-05-03;UG;Uganda;1;0;89;0
2020-05-04;UG;Uganda;8;0;97;0
2020-05-05;UG;Uganda;1;0;98;0
2020-05-06;UG;Uganda;2;0;100;0
2020-05-07;UG;Uganda;1;0;101;0
2020-05-08;UG;Uganda;0;0;101;0
2020-05-09;UG;Uganda;15;0;116;0
2020-05-10;UG;Uganda;5;0;121;0
2020-05-11;UG;Uganda;0;0;121;0
2020-05-12;UG;Uganda;8;0;129;0
2020-05-13;UG;Uganda;10;0;139;0
2020-05-14;UG;Uganda;21;0;160;0
2020-05-15;UG;Uganda;43;0;203;0
2020-05-16;UG;Uganda;24;0;227;0
2020-05-17;UG;Uganda;0;0;227;0
2020-05-18;UG;Uganda;21;0;248;0
2020-05-19;UG;Uganda;12;0;260;0
2020-05-20;UG;Uganda;4;0;264;0
2020-05-21;UG;Uganda;-104;0;160;0
2020-05-22;UG;Uganda;15;0;175;0
2020-05-23;UG;Uganda;23;0;198;0
2020-05-24;UG;Uganda;0;0;198;0
2020-05-25;UG;Uganda;24;0;222;0
2020-05-26;UG;Uganda;31;0;253;0
2020-05-27;UG;Uganda;28;0;281;0
2020-05-28;UG;Uganda;36;0;317;0
2020-05-29;UG;Uganda;12;0;329;0
2020-05-30;UG;Uganda;84;0;413;0
2020-05-31;UG;Uganda;4;0;417;0
2020-06-01;UG;Uganda;40;0;457;0
2020-06-02;UG;Uganda;32;0;489;0
2020-06-03;UG;Uganda;18;0;507;0
2020-06-04;UG;Uganda;15;0;522;0
2020-06-05;UG;Uganda;35;0;557;0
2020-06-06;UG;Uganda;36;0;593;0
2020-06-07;UG;Uganda;23;0;616;0
2020-06-08;UG;Uganda;30;0;646;0
2020-06-09;UG;Uganda;11;0;657;0
2020-06-10;UG;Uganda;8;0;665;0
2020-06-11;UG;Uganda;14;0;679;0
2020-06-12;UG;Uganda;7;0;686;0
2020-06-13;UG;Uganda;8;0;694;0
2020-06-14;UG;Uganda;2;0;696;0
2020-06-15;UG;Uganda;9;0;705;0
2020-06-16;UG;Uganda;19;0;724;0
2020-06-17;UG;Uganda;8;0;732;0
2020-06-18;UG;Uganda;9;0;741;0
2020-06-19;UG;Uganda;14;0;755;0
2020-06-20;UG;Uganda;8;0;763;0
2020-06-21;UG;Uganda;7;0;770;0
2020-06-22;UG;Uganda;4;0;774;0
2020-06-23;UG;Uganda;23;0;797;0
2020-06-24;UG;Uganda;8;0;805;0
2020-06-25;UG;Uganda;16;0;821;0
2020-06-26;UG;Uganda;12;0;833;0
2020-06-27;UG;Uganda;15;0;848;0
2020-06-28;UG;Uganda;11;0;859;0
2020-06-29;UG;Uganda;11;0;870;0
2020-06-30;UG;Uganda;19;0;889;0
2020-07-01;UG;Uganda;4;0;893;0
2020-07-02;UG;Uganda;9;0;902;0
2020-07-03;UG;Uganda;9;0;911;0
2020-07-04;UG;Uganda;16;0;927;0
2020-07-05;UG;Uganda;12;0;939;0
2020-07-06;UG;Uganda;14;0;953;0
2020-07-07;UG;Uganda;18;0;971;0
2020-07-08;UG;Uganda;6;0;977;0
2020-07-09;UG;Uganda;23;0;1000;0
2020-07-10;UG;Uganda;6;0;1006;0
2020-07-11;UG;Uganda;7;0;1013;0
2020-07-12;UG;Uganda;12;0;1025;0
2020-07-13;UG;Uganda;4;0;1029;0
2020-07-14;UG;Uganda;11;0;1040;0
2020-07-15;UG;Uganda;3;0;1043;0
2020-07-16;UG;Uganda;8;0;1051;0
2020-07-17;UG;Uganda;5;0;1056;0
2020-07-18;UG;Uganda;6;0;1062;0
2020-07-19;UG;Uganda;3;0;1065;0
2020-07-20;UG;Uganda;4;0;1069;0
2020-07-21;UG;Uganda;3;0;1072;0
2020-07-22;UG;Uganda;3;0;1075;0
2020-07-23;UG;Uganda;4;0;1079;0
2020-07-24;UG;Uganda;10;1;1089;1
2020-07-25;UG;Uganda;14;0;1103;1
2020-07-26;UG;Uganda;12;1;1115;2
2020-07-27;UG;Uganda;13;0;1128;2
2020-07-28;UG;Uganda;7;0;1135;2
2020-07-29;UG;Uganda;5;0;1140;2
2020-07-30;UG;Uganda;7;0;1147;2
2020-07-31;UG;Uganda;7;1;1154;3
2020-08-01;UG;Uganda;22;1;1176;4
2020-08-02;UG;Uganda;6;0;1182;4
2020-08-03;UG;Uganda;13;1;1195;5
2020-08-04;UG;Uganda;8;0;1203;5
2020-08-05;UG;Uganda;10;0;1213;5
2020-08-06;UG;Uganda;10;0;1223;5
2020-08-07;UG;Uganda;31;1;1254;6
2020-08-08;UG;Uganda;13;0;1267;6
2020-08-09;UG;Uganda;16;1;1283;7
2020-08-10;UG;Uganda;14;2;1297;9
2020-08-11;UG;Uganda;16;0;1313;9
2020-08-12;UG;Uganda;19;0;1332;9
2020-08-13;UG;Uganda;21;2;1353;11
2020-08-14;UG;Uganda;32;1;1385;12
2020-08-15;UG;Uganda;49;1;1434;13
2020-08-16;UG;Uganda;66;0;1500;13
2020-08-17;UG;Uganda;60;2;1560;15
2020-08-18;UG;Uganda;43;0;1603;15
2020-08-19;UG;Uganda;53;1;1656;16
2020-08-20;UG;Uganda;94;3;1750;19
2020-08-21;UG;Uganda;98;0;1848;19
2020-08-22;UG;Uganda;318;1;2166;20
2020-08-23;UG;Uganda;97;0;2263;20
2020-08-24;UG;Uganda;99;2;2362;22
2020-08-25;UG;Uganda;64;3;2426;25
2020-08-26;UG;Uganda;98;1;2524;26
2020-08-27;UG;Uganda;155;2;2679;28
2020-08-28;UG;Uganda;77;0;2756;28
2020-08-29;UG;Uganda;91;1;2847;29
2020-08-30;UG;Uganda;81;1;2928;30
2020-08-31;UG;Uganda;44;2;2972;32
2020-09-01;UG;Uganda;65;0;3037;32
2020-09-02;UG;Uganda;75;0;3112;32
2020-09-03;UG;Uganda;176;1;3288;33
2020-09-04;UG;Uganda;65;2;3353;35
2020-09-05;UG;Uganda;186;4;3539;39
2020-09-06;UG;Uganda;128;2;3667;41
2020-09-07;UG;Uganda;109;3;3776;44
2020-09-08;UG;Uganda;124;2;3900;46
2020-09-09;UG;Uganda;201;0;4101;46
2020-09-10;UG;Uganda;190;2;4291;48
2020-09-11;UG;Uganda;86;1;4377;49
2020-09-12;UG;Uganda;326;3;4703;52
2020-09-13;UG;Uganda;96;3;4799;55
2020-09-14;UG;Uganda;179;1;4978;56
2020-09-15;UG;Uganda;145;2;5123;58
2020-09-16;UG;Uganda;143;2;5266;60
2020-09-17;UG;Uganda;114;0;5380;60
2020-09-18;UG;Uganda;214;1;5594;61
2020-09-19;UG;Uganda;423;2;6017;63
2020-09-20;UG;Uganda;270;0;6287;63
2020-09-21;UG;Uganda;181;0;6468;63
2020-09-22;UG;Uganda;244;1;6712;64
2020-09-23;UG;Uganda;167;5;6879;69
2020-09-24;UG;Uganda;185;1;7064;70
2020-09-25;UG;Uganda;154;1;7218;71
2020-09-26;UG;Uganda;146;0;7364;71
2020-09-27;UG;Uganda;166;2;7530;73
2020-09-28;UG;Uganda;247;2;7777;75
2020-09-29;UG;Uganda;240;0;8017;75
2020-09-30;UG;Uganda;112;0;8129;75
2020-10-01;UG;Uganda;158;0;8287;75
2020-10-02;UG;Uganda;204;4;8491;79
2020-10-03;UG;Uganda;171;0;8662;79
2020-10-04;UG;Uganda;146;2;8808;81
2020-10-05;UG;Uganda;157;1;8965;82
2020-10-06;UG;Uganda;117;2;9082;84
2020-10-07;UG;Uganda;178;1;9260;85
2020-10-08;UG;Uganda;182;0;9442;85
2020-10-09;UG;Uganda;96;1;9538;86
2020-10-10;UG;Uganda;163;7;9701;93
2020-10-11;UG;Uganda;100;0;9801;93
2020-10-12;UG;Uganda;63;1;9864;94
2020-10-13;UG;Uganda;81;1;9945;95
2020-10-14;UG;Uganda;124;0;10069;95
2020-10-15;UG;Uganda;48;1;10117;96
2020-10-16;UG;Uganda;217;0;10334;96
2020-10-17;UG;Uganda;121;0;10455;96
2020-10-18;UG;Uganda;135;1;10590;97
2020-10-19;UG;Uganda;101;0;10691;97
2020-10-20;UG;Uganda;97;0;10788;97
2020-10-21;UG;Uganda;145;1;10933;98
2020-10-22;UG;Uganda;108;0;11041;98
2020-10-23;UG;Uganda;122;1;11163;99
2020-10-24;UG;Uganda;134;0;11297;99
2020-10-25;UG;Uganda;146;2;11443;101
2020-10-26;UG;Uganda;114;0;11557;101
2020-10-27;UG;Uganda;64;2;11621;103
2020-10-28;UG;Uganda;146;3;11767;106
2020-10-29;UG;Uganda;434;2;12201;108
2020-10-30;UG;Uganda;209;2;12410;110
2020-10-31;UG;Uganda;85;1;12495;111
2020-11-01;UG;Uganda;248;1;12743;112
2020-11-02;UG;Uganda;228;2;12971;114
2020-11-03;UG;Uganda;128;1;13099;115
2020-11-04;UG;Uganda;252;2;13351;117
2020-11-05;UG;Uganda;217;0;13568;117
2020-11-06;UG;Uganda;284;14;13852;131
2020-11-07;UG;Uganda;214;0;14066;131
2020-11-08;UG;Uganda;337;1;14403;132
2020-11-09;UG;Uganda;171;1;14574;133
2020-11-10;UG;Uganda;130;0;14704;133
2020-11-11;UG;Uganda;289;6;14993;139
2020-11-12;UG;Uganda;224;4;15217;143
2020-11-13;UG;Uganda;185;1;15402;144
2020-11-14;UG;Uganda;387;0;15789;144
2020-11-15;UG;Uganda;231;1;16020;145
2020-11-16;UG;Uganda;237;5;16257;150
2020-11-17;UG;Uganda;306;0;16563;150
2020-11-18;UG;Uganda;342;7;16905;157
2020-11-19;UG;Uganda;243;1;17148;158
2020-11-20;UG;Uganda;283;10;17431;168
2020-11-21;UG;Uganda;236;0;17667;168
2020-11-22;UG;Uganda;301;4;17968;172
2020-11-23;UG;Uganda;197;9;18165;181
2020-11-24;UG;Uganda;241;5;18406;186
2020-11-25;UG;Uganda;484;5;18890;191
2020-11-26;UG;Uganda;225;0;19115;191
2020-11-27;UG;Uganda;473;6;19588;197
2020-11-28;UG;Uganda;356;4;19944;201
2020-11-29;UG;Uganda;201;0;20145;201
2020-11-30;UG;Uganda;314;4;20459;205
2020-12-01;UG;Uganda;576;0;21035;205
2020-12-02;UG;Uganda;374;1;21409;206
2020-12-03;UG;Uganda;203;0;21612;206
2020-12-04;UG;Uganda;286;0;21898;206
2020-12-05;UG;Uganda;290;0;22188;206
2020-12-06;UG;Uganda;311;0;22499;206
2020-12-07;UG;Uganda;701;1;23200;207
2020-12-08;UG;Uganda;0;0;23200;207
2020-12-09;UG;Uganda;1859;12;25059;219
2020-12-10;UG;Uganda;671;1;25730;220
2020-12-11;UG;Uganda;639;0;26369;220
2020-12-12;UG;Uganda;702;0;27071;220
2020-12-13;UG;Uganda;461;1;27532;221
2020-12-14;UG;Uganda;234;3;27766;224
2020-12-15;UG;Uganda;402;1;28168;225
2020-12-16;UG;Uganda;565;0;28733;225
2020-12-17;UG;Uganda;628;3;29361;228
2020-12-18;UG;Uganda;710;2;30071;230
2020-12-19;UG;Uganda;631;0;30702;230
2020-12-20;UG;Uganda;485;1;31187;231
2020-12-21;UG;Uganda;197;7;31384;238
2020-12-22;UG;Uganda;526;0;31910;238
2020-12-23;UG;Uganda;489;7;32399;245
2020-12-24;UG;Uganda;515;0;32914;245
2020-12-25;UG;Uganda;446;0;33360;245
2020-12-26;UG;Uganda;203;0;33563;245
2020-12-27;UG;Uganda;248;3;33811;248
2020-12-28;UG;Uganda;162;0;33973;248
2020-12-29;UG;Uganda;308;2;34281;250
2020-12-30;UG;Uganda;396;1;34677;251
2020-12-31;UG;Uganda;539;0;35216;251
2021-01-01;UG;Uganda;295;14;35511;265
2021-01-02;UG;Uganda;201;9;35712;274
2021-01-03;UG;Uganda;210;0;35922;274
2021-01-04;UG;Uganda;128;0;36050;274
2021-01-05;UG;Uganda;357;16;36407;290
2021-01-06;UG;Uganda;295;4;36702;294
2021-01-07;UG;Uganda;372;3;37074;297
2021-01-08;UG;Uganda;222;3;37296;300
2021-01-09;UG;Uganda;258;1;37554;301
2021-01-10;UG;Uganda;188;0;37742;301
2021-01-11;UG;Uganda;66;1;37808;302
2021-01-12;UG;Uganda;140;1;37948;303
2021-01-13;UG;Uganda;137;1;38085;304
2021-01-14;UG;Uganda;0;0;38085;304
2021-01-15;UG;Uganda;0;0;38085;304
2021-01-16;UG;Uganda;0;0;38085;304
2021-01-17;UG;Uganda;0;0;38085;304
2021-01-18;UG;Uganda;0;0;38085;304
2021-01-19;UG;Uganda;449;1;38534;305
2021-01-20;UG;Uganda;94;0;38628;305
2021-01-21;UG;Uganda;178;11;38806;316
2021-01-22;UG;Uganda;129;1;38935;317
2021-01-23;UG;Uganda;109;0;39044;317
2021-01-24;UG;Uganda;105;0;39149;317
2021-01-25;UG;Uganda;39;1;39188;318
2021-01-26;UG;Uganda;73;0;39261;318
2021-01-27;UG;Uganda;53;0;39314;318
2021-01-28;UG;Uganda;110;0;39424;318
2021-01-29;UG;Uganda;66;6;39490;324
2021-01-30;UG;Uganda;43;0;39533;324
2021-01-31;UG;Uganda;46;0;39579;324
2021-02-01;UG;Uganda;27;1;39606;325
2021-02-02;UG;Uganda;45;0;39651;325
2021-02-03;UG;Uganda;34;2;39685;327
2021-02-04;UG;Uganda;50;0;39735;327
2021-02-05;UG;Uganda;54;0;39789;327
2021-02-06;UG;Uganda;32;0;39821;327
2021-02-07;UG;Uganda;27;0;39848;327
2021-02-08;UG;Uganda;12;0;39860;327
2021-02-09;UG;Uganda;23;0;39883;327
2021-02-10;UG;Uganda;28;1;39911;328
2021-02-11;UG;Uganda;31;0;39942;328
2021-02-12;UG;Uganda;37;0;39979;328
2021-02-13;UG;Uganda;40;0;40019;328
2021-02-14;UG;Uganda;0;0;40019;328
2021-02-15;UG;Uganda;36;0;40055;328
2021-02-16;UG;Uganda;8;3;40063;331
2021-02-17;UG;Uganda;39;0;40102;331
2021-02-18;UG;Uganda;52;0;40154;331
2021-02-19;UG;Uganda;14;0;40168;331
2021-02-20;UG;Uganda;31;2;40199;333
2021-02-21;UG;Uganda;14;0;40213;333
2021-02-22;UG;Uganda;8;0;40221;333
2021-02-23;UG;Uganda;22;0;40243;333
2021-02-24;UG;Uganda;18;1;40261;334
2021-02-25;UG;Uganda;39;0;40300;334
2021-02-26;UG;Uganda;22;0;40322;334
2021-02-27;UG;Uganda;13;0;40335;334
2021-02-28;UG;Uganda;22;0;40357;334
2021-03-01;UG;Uganda;10;0;40367;334
2021-03-02;UG;Uganda;28;0;40395;334
2021-03-03;UG;Uganda;13;0;40408;334
2021-03-04;UG;Uganda;18;0;40426;334
2021-03-05;UG;Uganda;26;0;40452;334
2021-03-06;UG;Uganda;0;0;40452;334
2021-03-07;UG;Uganda;12;0;40464;334
2021-03-08;UG;Uganda;15;0;40479;334
2021-03-09;UG;Uganda;11;0;40490;334
2021-03-10;UG;Uganda;30;0;40520;334
2021-03-11;UG;Uganda;15;0;40535;334
2021-03-12;UG;Uganda;9;0;40544;334
2021-03-13;UG;Uganda;0;0;40544;334
2021-03-14;UG;Uganda;37;0;40581;334
2021-03-15;UG;Uganda;10;0;40591;334
2021-03-16;UG;Uganda;2;0;40593;334
2021-03-17;UG;Uganda;14;0;40607;334
2021-03-18;UG;Uganda;18;0;40625;334
2021-03-19;UG;Uganda;26;0;40651;334
2021-03-20;UG;Uganda;0;0;40651;334
2021-03-21;UG;Uganda;20;0;40671;334
2021-03-22;UG;Uganda;16;0;40687;334
2021-03-23;UG;Uganda;32;0;40719;334
2021-03-24;UG;Uganda;0;0;40719;334
2021-03-25;UG;Uganda;15;0;40734;334
2021-03-26;UG;Uganda;17;1;40751;335
2021-03-27;UG;Uganda;16;0;40767;335
2021-03-28;UG;Uganda;27;0;40794;335
2021-03-29;UG;Uganda;26;0;40820;335
2021-03-30;UG;Uganda;19;0;40839;335
2021-03-31;UG;Uganda;28;0;40867;335
2021-04-01;UG;Uganda;22;0;40889;335
2021-04-02;UG;Uganda;35;0;40924;335
2021-04-03;UG;Uganda;38;0;40962;335
2021-04-04;UG;Uganda;0;0;40962;335
2021-04-05;UG;Uganda;54;0;41016;335
2021-04-06;UG;Uganda;7;0;41023;335
2021-04-07;UG;Uganda;23;2;41046;337
2021-04-08;UG;Uganda;16;0;41062;337
2021-04-09;UG;Uganda;24;0;41086;337
2021-04-10;UG;Uganda;27;0;41113;337
2021-04-11;UG;Uganda;27;0;41140;337
2021-04-12;UG;Uganda;34;0;41174;337
2021-04-13;UG;Uganda;30;0;41204;337
2021-04-14;UG;Uganda;33;1;41237;338
2021-04-15;UG;Uganda;26;0;41263;338
2021-04-16;UG;Uganda;47;0;41310;338
2021-04-17;UG;Uganda;30;0;41340;338
2021-04-18;UG;Uganda;38;0;41378;338
2021-04-19;UG;Uganda;18;1;41396;339
2021-04-20;UG;Uganda;26;2;41422;341
2021-04-21;UG;Uganda;53;0;41475;341
2021-04-22;UG;Uganda;54;0;41529;341
2021-04-23;UG;Uganda;46;0;41575;341
2021-04-24;UG;Uganda;0;0;41575;341
2021-04-25;UG;Uganda;80;0;41655;341
2021-04-26;UG;Uganda;60;0;41715;341
2021-04-27;UG;Uganda;22;0;41737;341
2021-04-28;UG;Uganda;29;0;41766;341
2021-04-29;UG;Uganda;31;1;41797;342
2021-04-30;UG;Uganda;69;0;41866;342
2021-05-01;UG;Uganda;39;0;41905;342
2021-05-02;UG;Uganda;0;0;41905;342
2021-05-03;UG;Uganda;68;0;41973;342
2021-05-04;UG;Uganda;59;0;42032;342
2021-05-05;UG;Uganda;70;1;42102;343
2021-05-06;UG;Uganda;50;2;42152;345
2021-05-07;UG;Uganda;72;1;42224;346
2021-05-08;UG;Uganda;84;0;42308;346
2021-05-09;UG;Uganda;47;0;42355;346
2021-05-10;UG;Uganda;29;0;42384;346
2021-05-11;UG;Uganda;43;0;42427;346
2021-05-12;UG;Uganda;60;0;42487;346
2021-05-13;UG;Uganda;91;0;42578;346
2021-05-14;UG;Uganda;96;1;42674;347
2021-05-15;UG;Uganda;0;0;42674;347
2021-05-16;UG;Uganda;105;0;42779;347
2021-05-17;UG;Uganda;80;0;42859;347
2021-05-18;UG;Uganda;71;2;42930;349
2021-05-19;UG;Uganda;164;1;43094;350
2021-05-20;UG;Uganda;129;0;43223;350
2021-05-21;UG;Uganda;147;0;43370;350
2021-05-22;UG;Uganda;137;0;43507;350
2021-05-23;UG;Uganda;227;6;43734;356
2021-05-24;UG;Uganda;185;1;43919;357
2021-05-25;UG;Uganda;155;1;44074;358
2021-05-26;UG;Uganda;207;1;44281;359
2021-05-27;UG;Uganda;313;2;44594;361
2021-05-28;UG;Uganda;637;0;45231;361
2021-05-29;UG;Uganda;700;1;45931;362
2021-05-30;UG;Uganda;692;0;46623;362
2021-05-31;UG;Uganda;524;0;47147;362
2021-06-01;UG;Uganda;614;0;47761;362
2021-06-02;UG;Uganda;915;2;48676;364
2021-06-03;UG;Uganda;1083;1;49759;365
2021-06-04;UG;Uganda;1247;9;51006;374
2021-06-05;UG;Uganda;670;0;51676;374
2021-06-06;UG;Uganda;1259;9;52935;383
2021-06-07;UG;Uganda;1026;0;53961;383
2021-06-08;UG;Uganda;708;5;54669;388
2021-06-09;UG;Uganda;842;4;55511;392
2021-06-10;UG;Uganda;1438;10;56949;402
2021-06-11;UG;Uganda;1566;6;58515;408
2021-06-12;UG;Uganda;1735;15;60250;423
2021-06-13;UG;Uganda;1727;5;61977;428
2021-06-14;UG;Uganda;1122;6;63099;434
2021-06-15;UG;Uganda;1422;25;64521;459
2021-06-16;UG;Uganda;1110;49;65631;508
2021-06-17;UG;Uganda;1584;34;67215;542
2021-06-18;UG;Uganda;1564;42;68779;584
2021-06-19;UG;Uganda;1397;42;70176;626
2021-06-20;UG;Uganda;1367;34;71543;660
2021-06-21;UG;Uganda;1136;20;72679;680
2021-06-22;UG;Uganda;722;34;73401;714
2021-06-23;UG;Uganda;859;38;74260;752
2021-06-24;UG;Uganda;1277;29;75537;781
2021-06-25;UG;Uganda;1025;49;76562;830
2021-06-26;UG;Uganda;943;38;77505;868
2021-06-27;UG;Uganda;889;35;78394;903
2021-06-28;UG;Uganda;695;53;79089;956
2021-06-29;UG;Uganda;345;33;79434;989
2021-06-30;UG;Uganda;543;34;79977;1023
2021-07-01;UG;Uganda;1057;38;81034;1061
2020-03-03;UA;Ukraine;1;0;1;0
2020-03-04;UA;Ukraine;0;0;1;0
2020-03-05;UA;Ukraine;0;0;1;0
2020-03-06;UA;Ukraine;0;0;1;0
2020-03-07;UA;Ukraine;0;0;1;0
2020-03-08;UA;Ukraine;0;0;1;0
2020-03-09;UA;Ukraine;0;0;1;0
2020-03-10;UA;Ukraine;0;0;1;0
2020-03-11;UA;Ukraine;0;0;1;0
2020-03-12;UA;Ukraine;0;0;1;0
2020-03-13;UA;Ukraine;2;1;3;1
2020-03-14;UA;Ukraine;0;0;3;1
2020-03-15;UA;Ukraine;0;0;3;1
2020-03-16;UA;Ukraine;4;0;7;1
2020-03-17;UA;Ukraine;7;1;14;2
2020-03-18;UA;Ukraine;0;0;14;2
2020-03-19;UA;Ukraine;2;0;16;2
2020-03-20;UA;Ukraine;13;1;29;3
2020-03-21;UA;Ukraine;18;0;47;3
2020-03-22;UA;Ukraine;26;0;73;3
2020-03-23;UA;Ukraine;0;0;73;3
2020-03-24;UA;Ukraine;24;0;97;3
2020-03-25;UA;Ukraine;48;2;145;5
2020-03-26;UA;Ukraine;51;0;196;5
2020-03-27;UA;Ukraine;114;0;310;5
2020-03-28;UA;Ukraine;46;4;356;9
2020-03-29;UA;Ukraine;119;1;475;10
2020-03-30;UA;Ukraine;73;3;548;13
2020-03-31;UA;Ukraine;97;4;645;17
2020-04-01;UA;Ukraine;149;3;794;20
2020-04-02;UA;Ukraine;103;2;897;22
2020-04-03;UA;Ukraine;175;5;1072;27
2020-04-04;UA;Ukraine;153;5;1225;32
2020-04-05;UA;Ukraine;83;5;1308;37
2020-04-06;UA;Ukraine;11;1;1319;38
2020-04-07;UA;Ukraine;143;7;1462;45
2020-04-08;UA;Ukraine;206;7;1668;52
2020-04-09;UA;Ukraine;224;5;1892;57
2020-04-10;UA;Ukraine;311;12;2203;69
2020-04-11;UA;Ukraine;308;4;2511;73
2020-04-12;UA;Ukraine;266;10;2777;83
2020-04-13;UA;Ukraine;325;10;3102;93
2020-04-14;UA;Ukraine;270;5;3372;98
2020-04-15;UA;Ukraine;392;10;3764;108
2020-04-16;UA;Ukraine;397;8;4161;116
2020-04-17;UA;Ukraine;501;9;4662;125
2020-04-18;UA;Ukraine;444;8;5106;133
2020-04-19;UA;Ukraine;343;8;5449;141
2020-04-20;UA;Ukraine;261;10;5710;151
2020-04-21;UA;Ukraine;415;10;6125;161
2020-04-22;UA;Ukraine;467;13;6592;174
2020-04-23;UA;Ukraine;578;13;7170;187
2020-04-24;UA;Ukraine;477;14;7647;201
2020-04-25;UA;Ukraine;478;0;8125;201
2020-04-26;UA;Ukraine;492;8;8617;209
2020-04-27;UA;Ukraine;392;11;9009;220
2020-04-28;UA;Ukraine;401;19;9410;239
2020-04-29;UA;Ukraine;456;11;9866;250
2020-04-30;UA;Ukraine;540;11;10406;261
2020-05-01;UA;Ukraine;455;11;10861;272
2020-05-02;UA;Ukraine;550;7;11411;279
2020-05-03;UA;Ukraine;502;9;11913;288
2020-05-04;UA;Ukraine;418;15;12331;303
2020-05-05;UA;Ukraine;366;13;12697;316
2020-05-06;UA;Ukraine;487;11;13184;327
2020-05-07;UA;Ukraine;507;13;13691;340
2020-05-08;UA;Ukraine;504;21;14195;361
2020-05-09;UA;Ukraine;515;15;14710;376
2020-05-10;UA;Ukraine;522;15;15232;391
2020-05-11;UA;Ukraine;416;17;15648;408
2020-05-12;UA;Ukraine;375;17;16023;425
2020-05-13;UA;Ukraine;402;14;16425;439
2020-05-14;UA;Ukraine;422;17;16847;456
2020-05-15;UA;Ukraine;483;20;17330;476
2020-05-16;UA;Ukraine;528;21;17858;497
2020-05-17;UA;Ukraine;433;17;18291;514
2020-05-18;UA;Ukraine;325;21;18616;535
2020-05-19;UA;Ukraine;260;13;18876;548
2020-05-20;UA;Ukraine;354;16;19230;564
2020-05-21;UA;Ukraine;476;15;19706;579
2020-05-22;UA;Ukraine;442;9;20148;588
2020-05-23;UA;Ukraine;432;17;20580;605
2020-05-24;UA;Ukraine;406;12;20986;617
2020-05-25;UA;Ukraine;259;6;21245;623
2020-05-26;UA;Ukraine;339;21;21584;644
2020-05-27;UA;Ukraine;321;14;21905;658
2020-05-28;UA;Ukraine;477;11;22382;669
2020-05-29;UA;Ukraine;429;10;22811;679
2020-05-30;UA;Ukraine;393;17;23204;696
2020-05-31;UA;Ukraine;468;12;23672;708
2020-06-01;UA;Ukraine;890;16;24562;724
2020-06-02;UA;Ukraine;333;9;24895;733
2020-06-03;UA;Ukraine;490;9;25385;742
2020-06-04;UA;Ukraine;596;13;25981;755
2020-06-05;UA;Ukraine;561;15;26542;770
2020-06-06;UA;Ukraine;559;15;27101;785
2020-06-07;UA;Ukraine;498;11;27599;796
2020-06-08;UA;Ukraine;478;9;28077;805
2020-06-09;UA;Ukraine;402;13;28479;818
2020-06-10;UA;Ukraine;536;23;29015;841
2020-06-11;UA;Ukraine;691;23;29706;864
2020-06-12;UA;Ukraine;709;16;30415;880
2020-06-13;UA;Ukraine;762;10;31177;890
2020-06-14;UA;Ukraine;674;9;31851;899
2020-06-15;UA;Ukraine;685;12;32536;911
2020-06-16;UA;Ukraine;673;11;33209;922
2020-06-17;UA;Ukraine;777;31;33986;953
2020-06-18;UA;Ukraine;847;23;34833;976
2020-06-19;UA;Ukraine;922;19;35755;995
2020-06-20;UA;Ukraine;860;9;36615;1004
2020-06-21;UA;Ukraine;746;8;37361;1012
2020-06-22;UA;Ukraine;695;10;38056;1022
2020-06-23;UA;Ukraine;845;23;38901;1045
2020-06-24;UA;Ukraine;951;16;39852;1061
2020-06-25;UA;Ukraine;1002;17;40854;1078
2020-06-26;UA;Ukraine;1121;19;41975;1097
2020-06-27;UA;Ukraine;957;24;42932;1121
2020-06-28;UA;Ukraine;924;21;43856;1142
2020-06-29;UA;Ukraine;682;19;44538;1161
2020-06-30;UA;Ukraine;716;12;45254;1173
2020-07-01;UA;Ukraine;670;15;45924;1188
2020-07-02;UA;Ukraine;897;12;46821;1200
2020-07-03;UA;Ukraine;884;27;47705;1227
2020-07-04;UA;Ukraine;923;16;48628;1243
2020-07-05;UA;Ukraine;840;22;49468;1265
2020-07-06;UA;Ukraine;585;13;50053;1278
2020-07-07;UA;Ukraine;569;21;50622;1299
2020-07-08;UA;Ukraine;835;24;51457;1323
2020-07-09;UA;Ukraine;828;21;52285;1344
2020-07-10;UA;Ukraine;831;18;53116;1362
2020-07-11;UA;Ukraine;825;27;53941;1389
2020-07-12;UA;Ukraine;706;11;54647;1400
2020-07-13;UA;Ukraine;638;15;55285;1415
2020-07-14;UA;Ukraine;646;14;55931;1429
2020-07-15;UA;Ukraine;848;15;56779;1444
2020-07-16;UA;Ukraine;861;18;57640;1462
2020-07-17;UA;Ukraine;826;11;58466;1473
2020-07-18;UA;Ukraine;867;23;59333;1496
2020-07-19;UA;Ukraine;744;8;60077;1504
2020-07-20;UA;Ukraine;690;13;60767;1517
2020-07-21;UA;Ukraine;687;20;61454;1537
2020-07-22;UA;Ukraine;841;16;62295;1553
2020-07-23;UA;Ukraine;874;17;63169;1570
2020-07-24;UA;Ukraine;1004;21;64173;1591
2020-07-25;UA;Ukraine;1144;19;65317;1610
2020-07-26;UA;Ukraine;944;15;66261;1625
2020-07-27;UA;Ukraine;835;11;67096;1636
2020-07-28;UA;Ukraine;934;14;68030;1650
2020-07-29;UA;Ukraine;1048;23;69078;1673
2020-07-30;UA;Ukraine;1222;24;70300;1697
2020-07-31;UA;Ukraine;1104;20;71404;1717
2020-08-01;UA;Ukraine;1205;16;72609;1733
2020-08-02;UA;Ukraine;1152;16;73761;1749
2020-08-03;UA;Ukraine;1020;13;74781;1762
2020-08-04;UA;Ukraine;1099;26;75880;1788
2020-08-05;UA;Ukraine;1289;25;77169;1813
2020-08-06;UA;Ukraine;1346;33;78515;1846
2020-08-07;UA;Ukraine;1503;33;80018;1879
2020-08-08;UA;Ukraine;1516;27;81534;1906
2020-08-09;UA;Ukraine;1233;19;82767;1925
2020-08-10;UA;Ukraine;1045;25;83812;1950
2020-08-11;UA;Ukraine;1211;29;85023;1979
2020-08-12;UA;Ukraine;1481;20;86504;1999
2020-08-13;UA;Ukraine;1632;24;88136;2023
2020-08-14;UA;Ukraine;1781;19;89917;2042
2020-08-15;UA;Ukraine;1878;34;91795;2076
2020-08-16;UA;Ukraine;1695;24;93490;2100
2020-08-17;UA;Ukraine;1517;22;95007;2122
2020-08-18;UA;Ukraine;1646;30;96653;2152
2020-08-19;UA;Ukraine;2005;30;98658;2182
2020-08-20;UA;Ukraine;2152;43;100810;2225
2020-08-21;UA;Ukraine;2138;23;102948;2248
2020-08-22;UA;Ukraine;2389;38;105337;2286
2020-08-23;UA;Ukraine;2042;27;107379;2313
2020-08-24;UA;Ukraine;1855;22;109234;2335
2020-08-25;UA;Ukraine;1715;27;110949;2362
2020-08-26;UA;Ukraine;1704;37;112653;2399
2020-08-27;UA;Ukraine;2010;50;114663;2449
2020-08-28;UA;Ukraine;2509;50;117172;2499
2020-08-29;UA;Ukraine;2579;41;119751;2540
2020-08-30;UA;Ukraine;2179;35;121930;2575
2020-08-31;UA;Ukraine;2202;30;124132;2605
2020-09-01;UA;Ukraine;2147;49;126279;2654
2020-09-02;UA;Ukraine;2554;51;128833;2705
2020-09-03;UA;Ukraine;2467;54;131300;2759
2020-09-04;UA;Ukraine;2769;53;134069;2812
2020-09-05;UA;Ukraine;2897;51;136966;2863
2020-09-06;UA;Ukraine;2205;35;139171;2898
2020-09-07;UA;Ukraine;2253;32;141424;2930
2020-09-08;UA;Ukraine;2490;58;143914;2988
2020-09-09;UA;Ukraine;2597;46;146511;3034
2020-09-10;UA;Ukraine;2635;45;149146;3079
2020-09-11;UA;Ukraine;3227;53;152373;3132
2020-09-12;UA;Ukraine;3185;74;155558;3206
2020-09-13;UA;Ukraine;2564;33;158122;3239
2020-09-14;UA;Ukraine;2557;34;160679;3273
2020-09-15;UA;Ukraine;2999;53;163678;3326
2020-09-16;UA;Ukraine;3016;78;166694;3404
2020-09-17;UA;Ukraine;3679;61;170373;3465
2020-09-18;UA;Ukraine;3330;70;173703;3535
2020-09-19;UA;Ukraine;3345;50;177048;3585
2020-09-20;UA;Ukraine;3071;41;180119;3626
2020-09-21;UA;Ukraine;2781;26;182900;3652
2020-09-22;UA;Ukraine;2990;64;185890;3716
2020-09-23;UA;Ukraine;3598;68;189488;3784
2020-09-24;UA;Ukraine;3478;54;192966;3838
2020-09-25;UA;Ukraine;3665;72;196631;3910
2020-09-26;UA;Ukraine;3935;78;200566;3988
2020-09-27;UA;Ukraine;3233;56;203799;4044
2020-09-28;UA;Ukraine;2780;38;206579;4082
2020-09-29;UA;Ukraine;3730;72;210309;4154
2020-09-30;UA;Ukraine;4137;67;214446;4221
2020-10-01;UA;Ukraine;4179;67;218625;4288
2020-10-02;UA;Ukraine;4751;69;223376;4357
2020-10-03;UA;Ukraine;4785;94;228161;4451
2020-10-04;UA;Ukraine;4263;44;232424;4495
2020-10-05;UA;Ukraine;3905;35;236329;4530
2020-10-06;UA;Ukraine;4482;94;240811;4624
2020-10-07;UA;Ukraine;4887;83;245698;4707
2020-10-08;UA;Ukraine;5545;100;251243;4807
2020-10-09;UA;Ukraine;5961;92;257204;4899
2020-10-10;UA;Ukraine;5901;111;263105;5010
2020-10-11;UA;Ukraine;4960;88;268065;5098
2020-10-12;UA;Ukraine;4606;45;272671;5143
2020-10-13;UA;Ukraine;5311;111;277982;5254
2020-10-14;UA;Ukraine;5780;111;283762;5365
2020-10-15;UA;Ukraine;5260;78;289022;5443
2020-10-16;UA;Ukraine;6205;108;295227;5551
2020-10-17;UA;Ukraine;6629;118;301856;5669
2020-10-18;UA;Ukraine;5445;93;307301;5762
2020-10-19;UA;Ukraine;4986;72;312287;5834
2020-10-20;UA;Ukraine;5680;114;317967;5948
2020-10-21;UA;Ukraine;6975;145;324942;6093
2020-10-22;UA;Ukraine;7320;120;332262;6213
2020-10-23;UA;Ukraine;7780;123;340042;6336
2020-10-24;UA;Ukraine;7275;127;347317;6463
2020-10-25;UA;Ukraine;6406;103;353723;6566
2020-10-26;UA;Ukraine;5625;75;359348;6641
2020-10-27;UA;Ukraine;6885;129;366233;6770
2020-10-28;UA;Ukraine;7790;168;374023;6938
2020-10-29;UA;Ukraine;7641;120;381664;7058
2020-10-30;UA;Ukraine;8608;177;390272;7235
2020-10-31;UA;Ukraine;9058;164;399330;7399
2020-11-01;UA;Ukraine;8243;116;407573;7515
2020-11-02;UA;Ukraine;6994;69;414567;7584
2020-11-03;UA;Ukraine;9116;165;423683;7749
2020-11-04;UA;Ukraine;9809;203;433492;7952
2020-11-05;UA;Ukraine;10138;196;443630;8148
2020-11-06;UA;Ukraine;9935;210;453565;8358
2020-11-07;UA;Ukraine;11033;195;464598;8553
2020-11-08;UA;Ukraine;9647;142;474245;8695
2020-11-09;UA;Ukraine;8908;117;483153;8812
2020-11-10;UA;Ukraine;10391;206;493544;9018
2020-11-11;UA;Ukraine;10879;196;504423;9214
2020-11-12;UA;Ukraine;11332;208;515755;9422
2020-11-13;UA;Ukraine;12053;182;527808;9604
2020-11-14;UA;Ukraine;12785;202;540593;9806
2020-11-15;UA;Ukraine;10940;98;551533;9904
2020-11-16;UA;Ukraine;10048;98;561581;10002
2020-11-17;UA;Ukraine;12177;166;573758;10168
2020-11-18;UA;Ukraine;12764;263;586522;10431
2020-11-19;UA;Ukraine;13630;263;600152;10694
2020-11-20;UA;Ukraine;14834;235;614986;10929
2020-11-21;UA;Ukraine;14864;220;629850;11149
2020-11-22;UA;Ukraine;12365;143;642215;11292
2020-11-23;UA;Ukraine;11227;131;653442;11423
2020-11-24;UA;Ukraine;12526;196;665968;11619
2020-11-25;UA;Ukraine;14164;238;680132;11857
2020-11-26;UA;Ukraine;15623;234;695755;12091
2020-11-27;UA;Ukraine;16494;201;712249;12292
2020-11-28;UA;Ukraine;16585;193;728834;12485
2020-11-29;UA;Ukraine;13271;128;742105;12613
2020-11-30;UA;Ukraine;10238;118;752343;12731
2020-12-01;UA;Ukraine;12774;231;765117;12962
2020-12-02;UA;Ukraine;13443;178;778560;13140
2020-12-03;UA;Ukraine;14812;254;793372;13394
2020-12-04;UA;Ukraine;15456;247;808828;13641
2020-12-05;UA;Ukraine;14157;236;822985;13877
2020-12-06;UA;Ukraine;11928;177;834913;14054
2020-12-07;UA;Ukraine;8985;154;843898;14208
2020-12-08;UA;Ukraine;11156;205;855054;14413
2020-12-09;UA;Ukraine;12937;289;867991;14702
2020-12-10;UA;Ukraine;13736;279;881727;14981
2020-12-11;UA;Ukraine;13893;297;895620;15278
2020-12-12;UA;Ukraine;13219;250;908839;15528
2020-12-13;UA;Ukraine;9605;163;918444;15691
2020-12-14;UA;Ukraine;6877;101;925321;15792
2020-12-15;UA;Ukraine;8840;246;934161;16038
2020-12-16;UA;Ukraine;11057;276;945218;16314
2020-12-17;UA;Ukraine;12474;265;957692;16579
2020-12-18;UA;Ukraine;13066;269;970758;16848
2020-12-19;UA;Ukraine;12179;224;982937;17072
2020-12-20;UA;Ukraine;8763;129;991700;17201
2020-12-21;UA;Ukraine;6978;92;998678;17293
2020-12-22;UA;Ukraine;8949;242;1007627;17535
2020-12-23;UA;Ukraine;10572;288;1018199;17823
2020-12-24;UA;Ukraine;11926;234;1030125;18057
2020-12-25;UA;Ukraine;11458;198;1041583;18255
2020-12-26;UA;Ukraine;8134;134;1049717;18389
2020-12-27;UA;Ukraine;6548;83;1056265;18472
2020-12-28;UA;Ukraine;4809;83;1061074;18555
2020-12-29;UA;Ukraine;7402;246;1068476;18801
2020-12-30;UA;Ukraine;8404;257;1076880;19058
2020-12-31;UA;Ukraine;10117;223;1086997;19281
2021-01-01;UA;Ukraine;9858;156;1096855;19437
2021-01-02;UA;Ukraine;5401;61;1102256;19498
2021-01-03;UA;Ukraine;4881;132;1107137;19630
2021-01-04;UA;Ukraine;4494;82;1111631;19712
2021-01-05;UA;Ukraine;5625;217;1117256;19929
2021-01-06;UA;Ukraine;7226;242;1124482;20171
2021-01-07;UA;Ukraine;9320;163;1133802;20334
2021-01-08;UA;Ukraine;5998;98;1139800;20432
2021-01-09;UA;Ukraine;5143;94;1144943;20526
2021-01-10;UA;Ukraine;5322;115;1150265;20641
2021-01-11;UA;Ukraine;4585;78;1154850;20719
2021-01-12;UA;Ukraine;5393;196;1160243;20915
2021-01-13;UA;Ukraine;6715;206;1166958;21121
2021-01-14;UA;Ukraine;8385;179;1175343;21300
2021-01-15;UA;Ukraine;8620;179;1183963;21479
2021-01-16;UA;Ukraine;8151;158;1192114;21637
2021-01-17;UA;Ukraine;6398;130;1198512;21767
2021-01-18;UA;Ukraine;3382;80;1201894;21847
2021-01-19;UA;Ukraine;4231;190;1206125;22037
2021-01-20;UA;Ukraine;4729;227;1210854;22264
2021-01-21;UA;Ukraine;5926;257;1216780;22521
2021-01-22;UA;Ukraine;5679;177;1222459;22698
2021-01-23;UA;Ukraine;5264;132;1227723;22830
2021-01-24;UA;Ukraine;4242;96;1231965;22926
2021-01-25;UA;Ukraine;2807;75;1234772;23001
2021-01-26;UA;Ukraine;3038;147;1237810;23148
2021-01-27;UA;Ukraine;4053;159;1241863;23307
2021-01-28;UA;Ukraine;5811;162;1247674;23469
2021-01-29;UA;Ukraine;5453;141;1253127;23610
2021-01-30;UA;Ukraine;4966;159;1258093;23769
2021-01-31;UA;Ukraine;3453;91;1261546;23860
2021-02-01;UA;Ukraine;2287;71;1263833;23931
2021-02-02;UA;Ukraine;2631;169;1266464;24100
2021-02-03;UA;Ukraine;3537;176;1270001;24276
2021-02-04;UA;Ukraine;5333;153;1275334;24429
2021-02-05;UA;Ukraine;5167;170;1280501;24599
2021-02-06;UA;Ukraine;4558;136;1285059;24735
2021-02-07;UA;Ukraine;3610;93;1288669;24828
2021-02-08;UA;Ukraine;2356;56;1291025;24884
2021-02-09;UA;Ukraine;2867;138;1293892;25022
2021-02-10;UA;Ukraine;3645;173;1297537;25195
2021-02-11;UA;Ukraine;5274;135;1302811;25330
2021-02-12;UA;Ukraine;4995;127;1307806;25457
2021-02-13;UA;Ukraine;5403;121;1313209;25578
2021-02-14;UA;Ukraine;3311;53;1316520;25631
2021-02-15;UA;Ukraine;2540;71;1319060;25702
2021-02-16;UA;Ukraine;3346;160;1322406;25862
2021-02-17;UA;Ukraine;4485;155;1326891;26017
2021-02-18;UA;Ukraine;6441;174;1333332;26191
2021-02-19;UA;Ukraine;6722;129;1340054;26320
2021-02-20;UA;Ukraine;6473;84;1346527;26404
2021-02-21;UA;Ukraine;4663;66;1351190;26470
2021-02-22;UA;Ukraine;3355;61;1354545;26531
2021-02-23;UA;Ukraine;4326;159;1358871;26690
2021-02-24;UA;Ukraine;5990;157;1364861;26847
2021-02-25;UA;Ukraine;8278;144;1373139;26991
2021-02-26;UA;Ukraine;8134;155;1381273;27146
2021-02-27;UA;Ukraine;8297;160;1389570;27306
2021-02-28;UA;Ukraine;5958;98;1395528;27404
2021-03-01;UA;Ukraine;4406;76;1399934;27480
2021-03-02;UA;Ukraine;5460;170;1405394;27650
2021-03-03;UA;Ukraine;7354;194;1412748;27844
2021-03-04;UA;Ukraine;10179;202;1422927;28046
2021-03-05;UA;Ukraine;10273;181;1433200;28227
2021-03-06;UA;Ukraine;9257;165;1442457;28392
2021-03-07;UA;Ukraine;7284;110;1449741;28502
2021-03-08;UA;Ukraine;5680;114;1455421;28616
2021-03-09;UA;Ukraine;3364;82;1458785;28698
2021-03-10;UA;Ukraine;6480;227;1465265;28925
2021-03-11;UA;Ukraine;9187;270;1474452;29195
2021-03-12;UA;Ukraine;13045;239;1487497;29434
2021-03-13;UA;Ukraine;13376;250;1500873;29684
2021-03-14;UA;Ukraine;9110;151;1509983;29835
2021-03-15;UA;Ukraine;6882;134;1516865;29969
2021-03-16;UA;Ukraine;9730;270;1526595;30239
2021-03-17;UA;Ukraine;11921;296;1538516;30535
2021-03-18;UA;Ukraine;15143;276;1553659;30811
2021-03-19;UA;Ukraine;15937;267;1569596;31078
2021-03-20;UA;Ukraine;15376;266;1584972;31344
2021-03-21;UA;Ukraine;11229;170;1596201;31514
2021-03-22;UA;Ukraine;7982;163;1604183;31677
2021-03-23;UA;Ukraine;11564;341;1615747;32018
2021-03-24;UA;Ukraine;14266;350;1630013;32368
2021-03-25;UA;Ukraine;16762;369;1646775;32737
2021-03-26;UA;Ukraine;18226;331;1665001;33068
2021-03-27;UA;Ukraine;17526;295;1682527;33363
2021-03-28;UA;Ukraine;12041;208;1694568;33571
2021-03-29;UA;Ukraine;8468;181;1703036;33752
2021-03-30;UA;Ukraine;10648;291;1713684;34043
2021-03-31;UA;Ukraine;11345;413;1725029;34456
2021-04-01;UA;Ukraine;17681;429;1742710;34885
2021-04-02;UA;Ukraine;20003;441;1762713;35326
2021-04-03;UA;Ukraine;20456;403;1783169;35729
2021-04-04;UA;Ukraine;13858;265;1797027;35994
2021-04-05;UA;Ukraine;10300;261;1807327;36255
2021-04-06;UA;Ukraine;13398;437;1820725;36692
2021-04-07;UA;Ukraine;15535;486;1836260;37178
2021-04-08;UA;Ukraine;19546;471;1855806;37649
2021-04-09;UA;Ukraine;19799;425;1875605;38074
2021-04-10;UA;Ukraine;17587;405;1893192;38479
2021-04-11;UA;Ukraine;12238;239;1905430;38718
2021-04-12;UA;Ukraine;7985;294;1913415;39012
2021-04-13;UA;Ukraine;11809;465;1925224;39477
2021-04-14;UA;Ukraine;14677;473;1939901;39950
2021-04-15;UA;Ukraine;16553;439;1956454;40389
2021-04-16;UA;Ukraine;17602;443;1974056;40832
2021-04-17;UA;Ukraine;15104;446;1989160;41278
2021-04-18;UA;Ukraine;10407;256;1999567;41534
2021-04-19;UA;Ukraine;6630;221;2006197;41755
2021-04-20;UA;Ukraine;9060;374;2015257;42129
2021-04-21;UA;Ukraine;12287;436;2027544;42565
2021-04-22;UA;Ukraine;16357;476;2043901;43041
2021-04-23;UA;Ukraine;14400;442;2058301;43483
2021-04-24;UA;Ukraine;12841;401;2071142;43884
2021-04-25;UA;Ukraine;8058;237;2079200;44121
2021-04-26;UA;Ukraine;5184;202;2084384;44323
2021-04-27;UA;Ukraine;8037;440;2092421;44763
2021-04-28;UA;Ukraine;9709;448;2102130;45211
2021-04-29;UA;Ukraine;11750;396;2113880;45607
2021-04-30;UA;Ukraine;10190;316;2124070;45923
2021-05-01;UA;Ukraine;8672;358;2132742;46281
2021-05-02;UA;Ukraine;5217;166;2137959;46447
2021-05-03;UA;Ukraine;2879;160;2140838;46607
2021-05-04;UA;Ukraine;2589;174;2143427;46781
2021-05-05;UA;Ukraine;2694;169;2146121;46950
2021-05-06;UA;Ukraine;6159;381;2152280;47331
2021-05-07;UA;Ukraine;8529;386;2160809;47717
2021-05-08;UA;Ukraine;8841;378;2169650;48095
2021-05-09;UA;Ukraine;5501;199;2175151;48294
2021-05-10;UA;Ukraine;2944;125;2178095;48419
2021-05-11;UA;Ukraine;2334;125;2180429;48544
2021-05-12;UA;Ukraine;4659;364;2185088;48908
2021-05-13;UA;Ukraine;6934;353;2192022;49261
2021-05-14;UA;Ukraine;7686;293;2199708;49554
2021-05-15;UA;Ukraine;6919;327;2206627;49881
2021-05-16;UA;Ukraine;3748;138;2210375;50019
2021-05-17;UA;Ukraine;2260;113;2212635;50132
2021-05-18;UA;Ukraine;4221;293;2216856;50425
2021-05-19;UA;Ukraine;5259;233;2222115;50658
2021-05-20;UA;Ukraine;5285;209;2227400;50867
2021-05-21;UA;Ukraine;5110;209;2232510;51076
2021-05-22;UA;Ukraine;4730;184;2237240;51260
2021-05-23;UA;Ukraine;2657;93;2239897;51353
2021-05-24;UA;Ukraine;1457;72;2241354;51425
2021-05-25;UA;Ukraine;2730;257;2244084;51682
2021-05-26;UA;Ukraine;3521;216;2247605;51898
2021-05-27;UA;Ukraine;3637;190;2251242;52088
2021-05-28;UA;Ukraine;3432;164;2254674;52252
2021-05-29;UA;Ukraine;3230;162;2257904;52414
2021-05-30;UA;Ukraine;1839;90;2259743;52504
2021-05-31;UA;Ukraine;1156;69;2260899;52573
2021-06-01;UA;Ukraine;2268;169;2263167;52742
2021-06-02;UA;Ukraine;2335;165;2265502;52907
2021-06-03;UA;Ukraine;2707;108;2268209;53015
2021-06-04;UA;Ukraine;2393;102;2270602;53117
2021-06-05;UA;Ukraine;2031;94;2272633;53211
2021-06-06;UA;Ukraine;1075;47;2273708;53258
2021-06-07;UA;Ukraine;667;37;2274375;53295
2021-06-08;UA;Ukraine;1736;125;2276111;53420
2021-06-09;UA;Ukraine;1521;83;2277632;53503
2021-06-10;UA;Ukraine;1924;104;2279556;53607
2021-06-11;UA;Ukraine;1747;76;2281303;53683
2021-06-12;UA;Ukraine;1424;75;2282727;53758
2021-06-13;UA;Ukraine;1019;37;2283746;53795
2021-06-14;UA;Ukraine;591;17;2284337;53812
2021-06-15;UA;Ukraine;1197;82;2285534;53894
2021-06-16;UA;Ukraine;1233;86;2286767;53980
2021-06-17;UA;Ukraine;1388;61;2288155;54041
2021-06-18;UA;Ukraine;1178;56;2289333;54097
2021-06-19;UA;Ukraine;1079;45;2290412;54142
2021-06-20;UA;Ukraine;723;29;2291135;54171
2021-06-21;UA;Ukraine;587;21;2291722;54192
2021-06-22;UA;Ukraine;573;28;2292295;54220
2021-06-23;UA;Ukraine;1126;79;2293421;54299
2021-06-24;UA;Ukraine;1248;67;2294669;54366
2021-06-25;UA;Ukraine;1204;63;2295873;54429
2021-06-26;UA;Ukraine;1109;44;2296982;54473
2021-06-27;UA;Ukraine;819;25;2297801;54498
2021-06-28;UA;Ukraine;677;19;2298478;54517
2021-06-29;UA;Ukraine;581;14;2299059;54531
2021-06-30;UA;Ukraine;1042;50;2300101;54581
2021-07-01;UA;Ukraine;1120;63;2301221;54644
2020-01-29;AE;United Arab Emirates;4;0;4;0
2020-01-30;AE;United Arab Emirates;0;0;4;0
2020-01-31;AE;United Arab Emirates;0;0;4;0
2020-02-01;AE;United Arab Emirates;0;0;4;0
2020-02-02;AE;United Arab Emirates;1;0;5;0
2020-02-03;AE;United Arab Emirates;0;0;5;0
2020-02-04;AE;United Arab Emirates;0;0;5;0
2020-02-05;AE;United Arab Emirates;0;0;5;0
2020-02-06;AE;United Arab Emirates;0;0;5;0
2020-02-07;AE;United Arab Emirates;0;0;5;0
2020-02-08;AE;United Arab Emirates;2;0;7;0
2020-02-09;AE;United Arab Emirates;0;0;7;0
2020-02-10;AE;United Arab Emirates;1;0;8;0
2020-02-11;AE;United Arab Emirates;0;0;8;0
2020-02-12;AE;United Arab Emirates;0;0;8;0
2020-02-13;AE;United Arab Emirates;0;0;8;0
2020-02-14;AE;United Arab Emirates;0;0;8;0
2020-02-15;AE;United Arab Emirates;0;0;8;0
2020-02-16;AE;United Arab Emirates;1;0;9;0
2020-02-17;AE;United Arab Emirates;0;0;9;0
2020-02-18;AE;United Arab Emirates;0;0;9;0
2020-02-19;AE;United Arab Emirates;0;0;9;0
2020-02-20;AE;United Arab Emirates;0;0;9;0
2020-02-21;AE;United Arab Emirates;0;0;9;0
2020-02-22;AE;United Arab Emirates;4;0;13;0
2020-02-23;AE;United Arab Emirates;0;0;13;0
2020-02-24;AE;United Arab Emirates;0;0;13;0
2020-02-25;AE;United Arab Emirates;0;0;13;0
2020-02-26;AE;United Arab Emirates;0;0;13;0
2020-02-27;AE;United Arab Emirates;0;0;13;0
2020-02-28;AE;United Arab Emirates;6;0;19;0
2020-02-29;AE;United Arab Emirates;2;0;21;0
2020-03-01;AE;United Arab Emirates;0;0;21;0
2020-03-02;AE;United Arab Emirates;0;0;21;0
2020-03-03;AE;United Arab Emirates;6;0;27;0
2020-03-04;AE;United Arab Emirates;0;0;27;0
2020-03-05;AE;United Arab Emirates;2;0;29;0
2020-03-06;AE;United Arab Emirates;0;0;29;0
2020-03-07;AE;United Arab Emirates;16;0;45;0
2020-03-08;AE;United Arab Emirates;0;0;45;0
2020-03-09;AE;United Arab Emirates;0;0;45;0
2020-03-10;AE;United Arab Emirates;29;0;74;0
2020-03-11;AE;United Arab Emirates;0;0;74;0
2020-03-12;AE;United Arab Emirates;11;0;85;0
2020-03-13;AE;United Arab Emirates;0;0;85;0
2020-03-14;AE;United Arab Emirates;0;0;85;0
2020-03-15;AE;United Arab Emirates;13;0;98;0
2020-03-16;AE;United Arab Emirates;0;0;98;0
2020-03-17;AE;United Arab Emirates;0;0;98;0
2020-03-18;AE;United Arab Emirates;15;0;113;0
2020-03-19;AE;United Arab Emirates;27;0;140;0
2020-03-20;AE;United Arab Emirates;0;2;140;2
2020-03-21;AE;United Arab Emirates;13;0;153;2
2020-03-22;AE;United Arab Emirates;0;0;153;2
2020-03-23;AE;United Arab Emirates;45;0;198;2
2020-03-24;AE;United Arab Emirates;50;0;248;2
2020-03-25;AE;United Arab Emirates;85;0;333;2
2020-03-26;AE;United Arab Emirates;0;0;333;2
2020-03-27;AE;United Arab Emirates;72;0;405;2
2020-03-28;AE;United Arab Emirates;63;0;468;2
2020-03-29;AE;United Arab Emirates;102;1;570;3
2020-03-30;AE;United Arab Emirates;41;2;611;5
2020-03-31;AE;United Arab Emirates;53;1;664;6
2020-04-01;AE;United Arab Emirates;150;2;814;8
2020-04-02;AE;United Arab Emirates;210;0;1024;8
2020-04-03;AE;United Arab Emirates;240;1;1264;9
2020-04-04;AE;United Arab Emirates;241;1;1505;10
2020-04-05;AE;United Arab Emirates;294;0;1799;10
2020-04-06;AE;United Arab Emirates;277;1;2076;11
2020-04-07;AE;United Arab Emirates;283;1;2359;12
2020-04-08;AE;United Arab Emirates;300;0;2659;12
2020-04-09;AE;United Arab Emirates;331;2;2990;14
2020-04-10;AE;United Arab Emirates;370;2;3360;16
2020-04-11;AE;United Arab Emirates;376;4;3736;20
2020-04-12;AE;United Arab Emirates;387;2;4123;22
2020-04-13;AE;United Arab Emirates;398;3;4521;25
2020-04-14;AE;United Arab Emirates;412;3;4933;28
2020-04-15;AE;United Arab Emirates;432;5;5365;33
2020-04-16;AE;United Arab Emirates;460;2;5825;35
2020-04-17;AE;United Arab Emirates;477;2;6302;37
2020-04-18;AE;United Arab Emirates;0;0;6302;37
2020-04-19;AE;United Arab Emirates;479;4;6781;41
2020-04-20;AE;United Arab Emirates;484;2;7265;43
2020-04-21;AE;United Arab Emirates;490;3;7755;46
2020-04-22;AE;United Arab Emirates;483;6;8238;52
2020-04-23;AE;United Arab Emirates;518;4;8756;56
2020-04-24;AE;United Arab Emirates;525;8;9281;64
2020-04-25;AE;United Arab Emirates;532;7;9813;71
2020-04-26;AE;United Arab Emirates;536;5;10349;76
2020-04-27;AE;United Arab Emirates;490;6;10839;82
2020-04-28;AE;United Arab Emirates;541;7;11380;89
2020-04-29;AE;United Arab Emirates;549;9;11929;98
2020-04-30;AE;United Arab Emirates;552;7;12481;105
2020-05-01;AE;United Arab Emirates;557;6;13038;111
2020-05-02;AE;United Arab Emirates;561;8;13599;119
2020-05-03;AE;United Arab Emirates;564;7;14163;126
2020-05-04;AE;United Arab Emirates;567;11;14730;137
2020-05-05;AE;United Arab Emirates;462;9;15192;146
2020-05-06;AE;United Arab Emirates;546;11;15738;157
2020-05-07;AE;United Arab Emirates;502;8;16240;165
2020-05-08;AE;United Arab Emirates;553;9;16793;174
2020-05-09;AE;United Arab Emirates;624;11;17417;185
2020-05-10;AE;United Arab Emirates;781;13;18198;198
2020-05-11;AE;United Arab Emirates;680;3;18878;201
2020-05-12;AE;United Arab Emirates;783;2;19661;203
2020-05-13;AE;United Arab Emirates;725;3;20386;206
2020-05-14;AE;United Arab Emirates;698;2;21084;208
2020-05-15;AE;United Arab Emirates;747;2;21831;210
2020-05-16;AE;United Arab Emirates;796;4;22627;214
2020-05-17;AE;United Arab Emirates;731;6;23358;220
2020-05-18;AE;United Arab Emirates;832;4;24190;224
2020-05-19;AE;United Arab Emirates;873;3;25063;227
2020-05-20;AE;United Arab Emirates;941;6;26004;233
2020-05-21;AE;United Arab Emirates;894;4;26898;237
2020-05-22;AE;United Arab Emirates;994;4;27892;241
2020-05-23;AE;United Arab Emirates;812;3;28704;244
2020-05-24;AE;United Arab Emirates;781;1;29485;245
2020-05-25;AE;United Arab Emirates;822;3;30307;248
2020-05-26;AE;United Arab Emirates;779;5;31086;253
2020-05-27;AE;United Arab Emirates;883;2;31969;255
2020-05-28;AE;United Arab Emirates;563;3;32532;258
2020-05-29;AE;United Arab Emirates;638;2;33170;260
2020-05-30;AE;United Arab Emirates;726;2;33896;262
2020-05-31;AE;United Arab Emirates;661;2;34557;264
2020-06-01;AE;United Arab Emirates;635;2;35192;266
2020-06-02;AE;United Arab Emirates;596;3;35788;269
2020-06-03;AE;United Arab Emirates;571;1;36359;270
2020-06-04;AE;United Arab Emirates;659;3;37018;273
2020-06-05;AE;United Arab Emirates;624;1;37642;274
2020-06-06;AE;United Arab Emirates;626;1;38268;275
2020-06-07;AE;United Arab Emirates;540;1;38808;276
2020-06-08;AE;United Arab Emirates;568;5;39376;281
2020-06-09;AE;United Arab Emirates;528;2;39904;283
2020-06-10;AE;United Arab Emirates;603;1;40507;284
2020-06-11;AE;United Arab Emirates;479;2;40986;286
2020-06-12;AE;United Arab Emirates;513;1;41499;287
2020-06-13;AE;United Arab Emirates;491;1;41990;288
2020-06-14;AE;United Arab Emirates;304;1;42294;289
2020-06-15;AE;United Arab Emirates;342;2;42636;291
2020-06-16;AE;United Arab Emirates;346;2;42982;293
2020-06-17;AE;United Arab Emirates;382;2;43364;295
2020-06-18;AE;United Arab Emirates;388;3;43752;298
2020-06-19;AE;United Arab Emirates;393;2;44145;300
2020-06-20;AE;United Arab Emirates;388;1;44533;301
2020-06-21;AE;United Arab Emirates;392;1;44925;302
2020-06-22;AE;United Arab Emirates;378;1;45303;303
2020-06-23;AE;United Arab Emirates;380;2;45683;305
2020-06-24;AE;United Arab Emirates;450;2;46133;307
2020-06-25;AE;United Arab Emirates;430;1;46563;308
2020-06-26;AE;United Arab Emirates;410;2;46973;310
2020-06-27;AE;United Arab Emirates;387;1;47360;311
2020-06-28;AE;United Arab Emirates;437;2;47797;313
2020-06-29;AE;United Arab Emirates;449;1;48246;314
2020-06-30;AE;United Arab Emirates;421;1;48667;315
2020-07-01;AE;United Arab Emirates;402;1;49069;316
2020-07-02;AE;United Arab Emirates;400;1;49469;317
2020-07-03;AE;United Arab Emirates;672;1;50141;318
2020-07-04;AE;United Arab Emirates;716;3;50857;321
2020-07-05;AE;United Arab Emirates;683;2;51540;323
2020-07-06;AE;United Arab Emirates;528;1;52068;324
2020-07-07;AE;United Arab Emirates;532;2;52600;326
2020-07-08;AE;United Arab Emirates;445;1;53045;327
2020-07-09;AE;United Arab Emirates;532;1;53577;328
2020-07-10;AE;United Arab Emirates;473;2;54050;330
2020-07-11;AE;United Arab Emirates;403;1;54453;331
2020-07-12;AE;United Arab Emirates;401;2;54854;333
2020-07-13;AE;United Arab Emirates;344;1;55198;334
2020-07-14;AE;United Arab Emirates;375;1;55573;335
2020-07-15;AE;United Arab Emirates;275;0;55848;335
2020-07-16;AE;United Arab Emirates;281;0;56129;335
2020-07-17;AE;United Arab Emirates;293;2;56422;337
2020-07-18;AE;United Arab Emirates;289;1;56711;338
2020-07-19;AE;United Arab Emirates;211;1;56922;339
2020-07-20;AE;United Arab Emirates;271;1;57193;340
2020-07-21;AE;United Arab Emirates;305;1;57498;341
2020-07-22;AE;United Arab Emirates;236;1;57734;342
2020-07-23;AE;United Arab Emirates;254;0;57988;342
2020-07-24;AE;United Arab Emirates;261;1;58249;343
2020-07-25;AE;United Arab Emirates;313;0;58562;343
2020-07-26;AE;United Arab Emirates;351;1;58913;344
2020-07-27;AE;United Arab Emirates;264;1;59177;345
2020-07-28;AE;United Arab Emirates;369;2;59546;347
2020-07-29;AE;United Arab Emirates;375;0;59921;347
2020-07-30;AE;United Arab Emirates;302;2;60223;349
2020-07-31;AE;United Arab Emirates;283;2;60506;351
2020-08-01;AE;United Arab Emirates;254;0;60760;351
2020-08-02;AE;United Arab Emirates;239;0;60999;351
2020-08-03;AE;United Arab Emirates;164;0;61163;351
2020-08-04;AE;United Arab Emirates;189;0;61352;351
2020-08-05;AE;United Arab Emirates;254;2;61606;353
2020-08-06;AE;United Arab Emirates;239;1;61845;354
2020-08-07;AE;United Arab Emirates;216;2;62061;356
2020-08-08;AE;United Arab Emirates;239;0;62300;356
2020-08-09;AE;United Arab Emirates;225;1;62525;357
2020-08-10;AE;United Arab Emirates;179;0;62704;357
2020-08-11;AE;United Arab Emirates;262;1;62966;358
2020-08-12;AE;United Arab Emirates;246;0;63212;358
2020-08-13;AE;United Arab Emirates;277;0;63489;358
2020-08-14;AE;United Arab Emirates;330;1;63819;359
2020-08-15;AE;United Arab Emirates;283;2;64102;361
2020-08-16;AE;United Arab Emirates;210;3;64312;364
2020-08-17;AE;United Arab Emirates;229;0;64541;364
2020-08-18;AE;United Arab Emirates;365;2;64906;366
2020-08-19;AE;United Arab Emirates;435;1;65341;367
2020-08-20;AE;United Arab Emirates;461;2;65802;369
2020-08-21;AE;United Arab Emirates;391;1;66193;370
2020-08-22;AE;United Arab Emirates;424;2;66617;372
2020-08-23;AE;United Arab Emirates;390;3;67007;375
2020-08-24;AE;United Arab Emirates;275;1;67282;376
2020-08-25;AE;United Arab Emirates;339;1;67621;377
2020-08-26;AE;United Arab Emirates;399;1;68020;378
2020-08-27;AE;United Arab Emirates;491;0;68511;378
2020-08-28;AE;United Arab Emirates;390;1;68901;379
2020-08-29;AE;United Arab Emirates;427;0;69328;379
2020-08-30;AE;United Arab Emirates;362;3;69690;382
2020-08-31;AE;United Arab Emirates;541;2;70231;384
2020-09-01;AE;United Arab Emirates;574;0;70805;384
2020-09-02;AE;United Arab Emirates;735;3;71540;387
2020-09-03;AE;United Arab Emirates;614;0;72154;387
2020-09-04;AE;United Arab Emirates;612;0;72766;387
2020-09-05;AE;United Arab Emirates;705;1;73471;388
2020-09-06;AE;United Arab Emirates;513;0;73984;388
2020-09-07;AE;United Arab Emirates;470;2;74454;390
2020-09-08;AE;United Arab Emirates;644;1;75098;391
2020-09-09;AE;United Arab Emirates;883;2;75981;393
2020-09-10;AE;United Arab Emirates;930;5;76911;398
2020-09-11;AE;United Arab Emirates;931;0;77842;398
2020-09-12;AE;United Arab Emirates;1007;1;78849;399
2020-09-13;AE;United Arab Emirates;640;0;79489;399
2020-09-14;AE;United Arab Emirates;777;0;80266;399
2020-09-15;AE;United Arab Emirates;674;2;80940;401
2020-09-16;AE;United Arab Emirates;842;1;81782;402
2020-09-17;AE;United Arab Emirates;786;0;82568;402
2020-09-18;AE;United Arab Emirates;865;1;83433;403
2020-09-19;AE;United Arab Emirates;809;1;84242;404
2020-09-20;AE;United Arab Emirates;674;0;84916;404
2020-09-21;AE;United Arab Emirates;679;1;85595;405
2020-09-22;AE;United Arab Emirates;852;0;86447;405
2020-09-23;AE;United Arab Emirates;1083;1;87530;406
2020-09-24;AE;United Arab Emirates;1002;1;88532;407
2020-09-25;AE;United Arab Emirates;1008;2;89540;409
2020-09-26;AE;United Arab Emirates;1078;2;90618;411
2020-09-27;AE;United Arab Emirates;851;1;91469;412
2020-09-28;AE;United Arab Emirates;626;1;92095;413
2020-09-29;AE;United Arab Emirates;995;3;93090;416
2020-09-30;AE;United Arab Emirates;1100;3;94190;419
2020-10-01;AE;United Arab Emirates;1158;2;95348;421
2020-10-02;AE;United Arab Emirates;1181;3;96529;424
2020-10-03;AE;United Arab Emirates;1231;2;97760;426
2020-10-04;AE;United Arab Emirates;1041;0;98801;426
2020-10-05;AE;United Arab Emirates;932;3;99733;429
2020-10-06;AE;United Arab Emirates;1061;6;100794;435
2020-10-07;AE;United Arab Emirates;1046;1;101840;436
2020-10-08;AE;United Arab Emirates;1089;2;102929;438
2020-10-09;AE;United Arab Emirates;1075;4;104004;442
2020-10-10;AE;United Arab Emirates;1129;1;105133;443
2020-10-11;AE;United Arab Emirates;1096;2;106229;445
2020-10-12;AE;United Arab Emirates;1064;1;107293;446
2020-10-13;AE;United Arab Emirates;1315;2;108608;448
2020-10-14;AE;United Arab Emirates;1431;2;110039;450
2020-10-15;AE;United Arab Emirates;1398;2;111437;452
2020-10-16;AE;United Arab Emirates;1412;3;112849;455
2020-10-17;AE;United Arab Emirates;1538;4;114387;459
2020-10-18;AE;United Arab Emirates;1215;4;115602;463
2020-10-19;AE;United Arab Emirates;915;3;116517;466
2020-10-20;AE;United Arab Emirates;1077;4;117594;470
2020-10-21;AE;United Arab Emirates;1538;2;119132;472
2020-10-22;AE;United Arab Emirates;1578;2;120710;474
2020-10-23;AE;United Arab Emirates;1563;1;122273;475
2020-10-24;AE;United Arab Emirates;1491;0;123764;475
2020-10-25;AE;United Arab Emirates;1359;2;125123;477
2020-10-26;AE;United Arab Emirates;1111;3;126234;480
2020-10-27;AE;United Arab Emirates;1390;2;127624;482
2020-10-28;AE;United Arab Emirates;1400;3;129024;485
2020-10-29;AE;United Arab Emirates;1312;3;130336;488
2020-10-30;AE;United Arab Emirates;1172;2;131508;490
2020-10-31;AE;United Arab Emirates;1121;5;132629;495
2020-11-01;AE;United Arab Emirates;1278;1;133907;496
2020-11-02;AE;United Arab Emirates;1234;1;135141;497
2020-11-03;AE;United Arab Emirates;1008;6;136149;503
2020-11-04;AE;United Arab Emirates;1161;2;137310;505
2020-11-05;AE;United Arab Emirates;1289;3;138599;508
2020-11-06;AE;United Arab Emirates;1292;2;139891;510
2020-11-07;AE;United Arab Emirates;1141;4;141032;514
2020-11-08;AE;United Arab Emirates;1111;0;142143;514
2020-11-09;AE;United Arab Emirates;1146;1;143289;515
2020-11-10;AE;United Arab Emirates;1096;3;144385;518
2020-11-11;AE;United Arab Emirates;1214;2;145599;520
2020-11-12;AE;United Arab Emirates;1136;3;146735;523
2020-11-13;AE;United Arab Emirates;1226;5;147961;528
2020-11-14;AE;United Arab Emirates;1174;0;149135;528
2020-11-15;AE;United Arab Emirates;1210;2;150345;530
2020-11-16;AE;United Arab Emirates;1209;4;151554;534
2020-11-17;AE;United Arab Emirates;1255;4;152809;538
2020-11-18;AE;United Arab Emirates;1292;4;154101;542
2020-11-19;AE;United Arab Emirates;1153;2;155254;544
2020-11-20;AE;United Arab Emirates;1269;3;156523;547
2020-11-21;AE;United Arab Emirates;1262;1;157785;548
2020-11-22;AE;United Arab Emirates;1205;4;158990;552
2020-11-23;AE;United Arab Emirates;1065;2;160055;554
2020-11-24;AE;United Arab Emirates;1310;5;161365;559
2020-11-25;AE;United Arab Emirates;1297;4;162662;563
2020-11-26;AE;United Arab Emirates;1305;1;163967;564
2020-11-27;AE;United Arab Emirates;1283;3;165250;567
2020-11-28;AE;United Arab Emirates;1252;2;166502;569
2020-11-29;AE;United Arab Emirates;1251;1;167753;570
2020-11-30;AE;United Arab Emirates;1107;2;168860;572
2020-12-01;AE;United Arab Emirates;1289;4;170149;576
2020-12-02;AE;United Arab Emirates;1285;4;171434;580
2020-12-03;AE;United Arab Emirates;1317;5;172751;585
2020-12-04;AE;United Arab Emirates;1311;1;174062;586
2020-12-05;AE;United Arab Emirates;1214;3;175276;589
2020-12-06;AE;United Arab Emirates;1153;3;176429;592
2020-12-07;AE;United Arab Emirates;1148;2;177577;594
2020-12-08;AE;United Arab Emirates;1260;2;178837;596
2020-12-09;AE;United Arab Emirates;1313;2;180150;598
2020-12-10;AE;United Arab Emirates;1255;4;181405;602
2020-12-11;AE;United Arab Emirates;1196;5;182601;607
2020-12-12;AE;United Arab Emirates;1154;2;183755;609
2020-12-13;AE;United Arab Emirates;1194;8;184949;617
2020-12-14;AE;United Arab Emirates;1092;1;186041;618
2020-12-15;AE;United Arab Emirates;1226;4;187267;622
2020-12-16;AE;United Arab Emirates;1278;4;188545;626
2020-12-17;AE;United Arab Emirates;1321;3;189866;629
2020-12-18;AE;United Arab Emirates;1284;1;191150;630
2020-12-19;AE;United Arab Emirates;1254;4;192404;634
2020-12-20;AE;United Arab Emirates;1171;3;193575;637
2020-12-21;AE;United Arab Emirates;1077;2;194652;639
2020-12-22;AE;United Arab Emirates;1226;3;195878;642
2020-12-23;AE;United Arab Emirates;1246;3;197124;645
2020-12-24;AE;United Arab Emirates;1311;2;198435;647
2020-12-25;AE;United Arab Emirates;1230;6;199665;653
2020-12-26;AE;United Arab Emirates;1227;2;200892;655
2020-12-27;AE;United Arab Emirates;944;2;201836;657
2020-12-28;AE;United Arab Emirates;1027;3;202863;660
2020-12-29;AE;United Arab Emirates;1506;2;204369;662
2020-12-30;AE;United Arab Emirates;1723;3;206092;665
2020-12-31;AE;United Arab Emirates;1730;4;207822;669
2021-01-01;AE;United Arab Emirates;1856;2;209678;671
2021-01-02;AE;United Arab Emirates;1963;3;211641;674
2021-01-03;AE;United Arab Emirates;1590;5;213231;679
2021-01-04;AE;United Arab Emirates;1501;3;214732;682
2021-01-05;AE;United Arab Emirates;1967;3;216699;685
2021-01-06;AE;United Arab Emirates;2067;4;218766;689
2021-01-07;AE;United Arab Emirates;2988;5;221754;694
2021-01-08;AE;United Arab Emirates;2950;3;224704;697
2021-01-09;AE;United Arab Emirates;2998;5;227702;702
2021-01-10;AE;United Arab Emirates;2876;6;230578;708
2021-01-11;AE;United Arab Emirates;2404;3;232982;711
2021-01-12;AE;United Arab Emirates;3243;6;236225;717
2021-01-13;AE;United Arab Emirates;3362;6;239587;723
2021-01-14;AE;United Arab Emirates;3382;3;242969;726
2021-01-15;AE;United Arab Emirates;3407;7;246376;733
2021-01-16;AE;United Arab Emirates;3432;7;249808;740
2021-01-17;AE;United Arab Emirates;3453;5;253261;745
2021-01-18;AE;United Arab Emirates;3471;6;256732;751
2021-01-19;AE;United Arab Emirates;3491;5;260223;756
2021-01-20;AE;United Arab Emirates;3506;6;263729;762
2021-01-21;AE;United Arab Emirates;3529;4;267258;766
2021-01-22;AE;United Arab Emirates;3552;10;270810;776
2021-01-23;AE;United Arab Emirates;3566;7;274376;783
2021-01-24;AE;United Arab Emirates;3579;9;277955;792
2021-01-25;AE;United Arab Emirates;3591;6;281546;798
2021-01-26;AE;United Arab Emirates;3601;7;285147;805
2021-01-27;AE;United Arab Emirates;3939;6;289086;811
2021-01-28;AE;United Arab Emirates;3966;8;293052;819
2021-01-29;AE;United Arab Emirates;3962;7;297014;826
2021-01-30;AE;United Arab Emirates;3647;12;300661;838
2021-01-31;AE;United Arab Emirates;2948;12;303609;850
2021-02-01;AE;United Arab Emirates;2730;9;306339;859
2021-02-02;AE;United Arab Emirates;3310;7;309649;866
2021-02-03;AE;United Arab Emirates;3977;12;313626;878
2021-02-04;AE;United Arab Emirates;3249;10;316875;888
2021-02-05;AE;United Arab Emirates;3251;14;320126;902
2021-02-06;AE;United Arab Emirates;3276;12;323402;914
2021-02-07;AE;United Arab Emirates;3093;7;326495;921
2021-02-08;AE;United Arab Emirates;2798;9;329293;930
2021-02-09;AE;United Arab Emirates;3310;17;332603;947
2021-02-10;AE;United Arab Emirates;3539;9;336142;956
2021-02-11;AE;United Arab Emirates;3525;18;339667;974
2021-02-12;AE;United Arab Emirates;3307;12;342974;986
2021-02-13;AE;United Arab Emirates;2631;15;345605;1001
2021-02-14;AE;United Arab Emirates;3167;13;348772;1014
2021-02-15;AE;United Arab Emirates;3123;13;351895;1027
2021-02-16;AE;United Arab Emirates;3236;14;355131;1041
2021-02-17;AE;United Arab Emirates;3452;14;358583;1055
2021-02-18;AE;United Arab Emirates;3294;18;361877;1073
2021-02-19;AE;United Arab Emirates;3140;20;365017;1093
2021-02-20;AE;United Arab Emirates;3158;15;368175;1108
2021-02-21;AE;United Arab Emirates;2250;17;370425;1125
2021-02-22;AE;United Arab Emirates;2105;15;372530;1140
2021-02-23;AE;United Arab Emirates;3005;5;375535;1145
2021-02-24;AE;United Arab Emirates;3102;19;378637;1164
2021-02-25;AE;United Arab Emirates;3025;18;381662;1182
2021-02-26;AE;United Arab Emirates;3498;16;385160;1198
2021-02-27;AE;United Arab Emirates;3434;15;388594;1213
2021-02-28;AE;United Arab Emirates;2930;8;391524;1221
2021-03-01;AE;United Arab Emirates;2526;17;394050;1238
2021-03-02;AE;United Arab Emirates;2721;15;396771;1253
2021-03-03;AE;United Arab Emirates;2692;16;399463;1269
2021-03-04;AE;United Arab Emirates;2742;17;402205;1286
2021-03-05;AE;United Arab Emirates;3072;10;405277;1296
2021-03-06;AE;United Arab Emirates;2959;14;408236;1310
2021-03-07;AE;United Arab Emirates;2613;12;410849;1322
2021-03-08;AE;United Arab Emirates;2483;13;413332;1335
2021-03-09;AE;United Arab Emirates;2373;10;415705;1345
2021-03-10;AE;United Arab Emirates;2204;8;417909;1353
2021-03-11;AE;United Arab Emirates;2087;16;419996;1369
2021-03-12;AE;United Arab Emirates;2250;9;422246;1378
2021-03-13;AE;United Arab Emirates;2159;10;424405;1388
2021-03-14;AE;United Arab Emirates;1992;7;426397;1395
2021-03-15;AE;United Arab Emirates;1898;7;428295;1402
2021-03-16;AE;United Arab Emirates;2018;4;430313;1406
2021-03-17;AE;United Arab Emirates;2051;8;432364;1414
2021-03-18;AE;United Arab Emirates;2101;10;434465;1424
2021-03-19;AE;United Arab Emirates;2160;4;436625;1428
2021-03-20;AE;United Arab Emirates;2013;5;438638;1433
2021-03-21;AE;United Arab Emirates;1717;5;440355;1438
2021-03-22;AE;United Arab Emirates;1871;7;442226;1445
2021-03-23;AE;United Arab Emirates;2172;6;444398;1451
2021-03-24;AE;United Arab Emirates;2196;5;446594;1456
2021-03-25;AE;United Arab Emirates;2043;10;448637;1466
2021-03-26;AE;United Arab Emirates;2128;6;450765;1472
2021-03-27;AE;United Arab Emirates;2304;5;453069;1477
2021-03-28;AE;United Arab Emirates;2128;4;455197;1481
2021-03-29;AE;United Arab Emirates;1874;5;457071;1486
2021-03-30;AE;United Arab Emirates;2289;6;459360;1492
2021-03-31;AE;United Arab Emirates;2084;5;461444;1497
2021-04-01;AE;United Arab Emirates;2315;2;463759;1499
2021-04-02;AE;United Arab Emirates;2180;3;465939;1502
2021-04-03;AE;United Arab Emirates;2084;2;468023;1504
2021-04-04;AE;United Arab Emirates;2113;6;470136;1510
2021-04-05;AE;United Arab Emirates;2012;2;472148;1512
2021-04-06;AE;United Arab Emirates;1988;4;474136;1516
2021-04-07;AE;United Arab Emirates;1883;4;476019;1520
2021-04-08;AE;United Arab Emirates;2112;3;478131;1523
2021-04-09;AE;United Arab Emirates;1875;3;480006;1526
2021-04-10;AE;United Arab Emirates;1931;3;481937;1529
2021-04-11;AE;United Arab Emirates;1810;2;483747;1531
2021-04-12;AE;United Arab Emirates;1928;2;485675;1533
2021-04-13;AE;United Arab Emirates;2022;4;487697;1537
2021-04-14;AE;United Arab Emirates;1798;4;489495;1541
2021-04-15;AE;United Arab Emirates;1928;4;491423;1545
2021-04-16;AE;United Arab Emirates;1843;2;493266;1547
2021-04-17;AE;United Arab Emirates;1958;3;495224;1550
2021-04-18;AE;United Arab Emirates;1930;4;497154;1554
2021-04-19;AE;United Arab Emirates;1803;2;498957;1556
2021-04-20;AE;United Arab Emirates;1903;3;500860;1559
2021-04-21;AE;United Arab Emirates;1931;2;502791;1561
2021-04-22;AE;United Arab Emirates;2081;4;504872;1565
2021-04-23;AE;United Arab Emirates;1973;2;506845;1567
2021-04-24;AE;United Arab Emirates;2080;2;508925;1569
2021-04-25;AE;United Arab Emirates;1813;2;510738;1571
2021-04-26;AE;United Arab Emirates;1759;2;512497;1573
2021-04-27;AE;United Arab Emirates;2094;5;514591;1578
2021-04-28;AE;United Arab Emirates;1710;2;516301;1580
2021-04-29;AE;United Arab Emirates;1961;4;518262;1584
2021-04-30;AE;United Arab Emirates;1974;3;520236;1587
2021-05-01;AE;United Arab Emirates;1712;4;521948;1591
2021-05-02;AE;United Arab Emirates;1847;2;523795;1593
2021-05-03;AE;United Arab Emirates;1772;3;525567;1596
2021-05-04;AE;United Arab Emirates;1699;2;527266;1598
2021-05-05;AE;United Arab Emirates;1954;3;529220;1601
2021-05-06;AE;United Arab Emirates;1724;3;530944;1604
2021-05-07;AE;United Arab Emirates;1766;3;532710;1607
2021-05-08;AE;United Arab Emirates;1735;3;534445;1610
2021-05-09;AE;United Arab Emirates;1572;3;536017;1613
2021-05-10;AE;United Arab Emirates;1507;2;537524;1615
2021-05-11;AE;United Arab Emirates;1614;2;539138;1617
2021-05-12;AE;United Arab Emirates;1508;2;540646;1619
2021-05-13;AE;United Arab Emirates;1512;4;542158;1623
2021-05-14;AE;United Arab Emirates;1452;3;543610;1626
2021-05-15;AE;United Arab Emirates;1321;3;544931;1629
2021-05-16;AE;United Arab Emirates;1251;2;546182;1631
2021-05-17;AE;United Arab Emirates;1229;2;547411;1633
2021-05-18;AE;United Arab Emirates;1270;4;548681;1637
2021-05-19;AE;United Arab Emirates;1348;2;550029;1639
2021-05-20;AE;United Arab Emirates;1401;3;551430;1642
2021-05-21;AE;United Arab Emirates;1490;2;552920;1644
2021-05-22;AE;United Arab Emirates;1596;4;554516;1648
2021-05-23;AE;United Arab Emirates;1591;3;556107;1651
2021-05-24;AE;United Arab Emirates;1512;3;557619;1654
2021-05-25;AE;United Arab Emirates;1672;4;559291;1658
2021-05-26;AE;United Arab Emirates;1757;3;561048;1661
2021-05-27;AE;United Arab Emirates;2167;3;563215;1664
2021-05-28;AE;United Arab Emirates;2236;4;565451;1668
2021-05-29;AE;United Arab Emirates;1812;5;567263;1673
2021-05-30;AE;United Arab Emirates;1810;4;569073;1677
2021-05-31;AE;United Arab Emirates;1763;3;570836;1680
2021-06-01;AE;United Arab Emirates;1968;4;572804;1684
2021-06-02;AE;United Arab Emirates;2154;2;574958;1686
2021-06-03;AE;United Arab Emirates;1989;3;576947;1689
2021-06-04;AE;United Arab Emirates;2062;2;579009;1691
2021-06-05;AE;United Arab Emirates;2188;5;581197;1696
2021-06-06;AE;United Arab Emirates;1874;3;583071;1699
2021-06-07;AE;United Arab Emirates;1968;3;585039;1702
2021-06-08;AE;United Arab Emirates;2205;2;587244;1704
2021-06-09;AE;United Arab Emirates;2179;6;589423;1710
2021-06-10;AE;United Arab Emirates;0;0;589423;1710
2021-06-11;AE;United Arab Emirates;4471;10;593894;1720
2021-06-12;AE;United Arab Emirates;2123;4;596017;1724
2021-06-13;AE;United Arab Emirates;1969;2;597986;1726
2021-06-14;AE;United Arab Emirates;1837;4;599823;1730
2021-06-15;AE;United Arab Emirates;2127;4;601950;1734
2021-06-16;AE;United Arab Emirates;2011;4;603961;1738
2021-06-17;AE;United Arab Emirates;2167;3;606128;1741
2021-06-18;AE;United Arab Emirates;1942;6;608070;1747
2021-06-19;AE;United Arab Emirates;2109;5;610179;1752
2021-06-20;AE;United Arab Emirates;1850;5;612029;1757
2021-06-21;AE;United Arab Emirates;1964;6;613993;1763
2021-06-22;AE;United Arab Emirates;2167;4;616160;1767
2021-06-23;AE;United Arab Emirates;1988;6;618148;1773
2021-06-24;AE;United Arab Emirates;2161;2;620309;1775
2021-06-25;AE;United Arab Emirates;2223;7;622532;1782
2021-06-26;AE;United Arab Emirates;2282;10;624814;1792
2021-06-27;AE;United Arab Emirates;2122;4;626936;1796
2021-06-28;AE;United Arab Emirates;2040;6;628976;1802
2021-06-29;AE;United Arab Emirates;2184;5;631160;1807
2021-06-30;AE;United Arab Emirates;1747;4;632907;1811
2021-07-01;AE;United Arab Emirates;1675;8;634582;1819
2020-01-31;GB;United Kingdom;2;0;2;0
2020-02-01;GB;United Kingdom;0;0;2;0
2020-02-02;GB;United Kingdom;0;0;2;0
2020-02-03;GB;United Kingdom;6;0;8;0
2020-02-04;GB;United Kingdom;0;0;8;0
2020-02-05;GB;United Kingdom;1;0;9;0
2020-02-06;GB;United Kingdom;0;0;9;0
2020-02-07;GB;United Kingdom;0;0;9;0
2020-02-08;GB;United Kingdom;4;0;13;0
2020-02-09;GB;United Kingdom;1;0;14;0
2020-02-10;GB;United Kingdom;0;0;14;0
2020-02-11;GB;United Kingdom;1;0;15;0
2020-02-12;GB;United Kingdom;1;0;16;0
2020-02-13;GB;United Kingdom;1;0;17;0
2020-02-14;GB;United Kingdom;1;0;18;0
2020-02-15;GB;United Kingdom;0;0;18;0
2020-02-16;GB;United Kingdom;0;0;18;0
2020-02-17;GB;United Kingdom;1;0;19;0
2020-02-18;GB;United Kingdom;0;0;19;0
2020-02-19;GB;United Kingdom;1;0;20;0
2020-02-20;GB;United Kingdom;2;0;22;0
2020-02-21;GB;United Kingdom;1;0;23;0
2020-02-22;GB;United Kingdom;0;0;23;0
2020-02-23;GB;United Kingdom;5;0;28;0
2020-02-24;GB;United Kingdom;2;0;30;0
2020-02-25;GB;United Kingdom;4;0;34;0
2020-02-26;GB;United Kingdom;3;0;37;0
2020-02-27;GB;United Kingdom;7;0;44;0
2020-02-28;GB;United Kingdom;12;0;56;0
2020-02-29;GB;United Kingdom;5;0;61;0
2020-03-01;GB;United Kingdom;33;0;94;0
2020-03-02;GB;United Kingdom;40;0;134;0
2020-03-03;GB;United Kingdom;55;0;189;0
2020-03-04;GB;United Kingdom;57;0;246;0
2020-03-05;GB;United Kingdom;49;0;295;0
2020-03-06;GB;United Kingdom;79;1;374;1
2020-03-07;GB;United Kingdom;55;1;429;2
2020-03-08;GB;United Kingdom;54;0;483;2
2020-03-09;GB;United Kingdom;147;1;630;3
2020-03-10;GB;United Kingdom;259;4;889;7
2020-03-11;GB;United Kingdom;412;0;1301;7
2020-03-12;GB;United Kingdom;489;2;1790;9
2020-03-13;GB;United Kingdom;480;1;2270;10
2020-03-14;GB;United Kingdom;364;19;2634;29
2020-03-15;GB;United Kingdom;443;14;3077;43
2020-03-16;GB;United Kingdom;615;23;3692;66
2020-03-17;GB;United Kingdom;770;17;4462;83
2020-03-18;GB;United Kingdom;1006;35;5468;118
2020-03-19;GB;United Kingdom;1066;46;6534;164
2020-03-20;GB;United Kingdom;1258;32;7792;196
2020-03-21;GB;United Kingdom;1215;58;9007;254
2020-03-22;GB;United Kingdom;1388;35;10395;289
2020-03-23;GB;United Kingdom;2349;76;12744;365
2020-03-24;GB;United Kingdom;2382;148;15126;513
2020-03-25;GB;United Kingdom;2717;191;17843;704
2020-03-26;GB;United Kingdom;3127;182;20970;886
2020-03-27;GB;United Kingdom;3249;288;24219;1174
2020-03-28;GB;United Kingdom;2843;292;27062;1466
2020-03-29;GB;United Kingdom;2892;213;29954;1679
2020-03-30;GB;United Kingdom;4327;374;34281;2053
2020-03-31;GB;United Kingdom;4534;404;38815;2457
2020-04-01;GB;United Kingdom;4974;673;43789;3130
2020-04-02;GB;United Kingdom;4929;657;48718;3787
2020-04-03;GB;United Kingdom;4981;737;53699;4524
2020-04-04;GB;United Kingdom;4073;757;57772;5281
2020-04-05;GB;United Kingdom;3650;601;61422;5882
2020-04-06;GB;United Kingdom;5316;570;66738;6452
2020-04-07;GB;United Kingdom;5486;1105;72224;7557
2020-04-08;GB;United Kingdom;5163;1032;77387;8589
2020-04-09;GB;United Kingdom;4906;1117;82293;9706
2020-04-10;GB;United Kingdom;4367;1123;86660;10829
2020-04-11;GB;United Kingdom;3613;844;90273;11673
2020-04-12;GB;United Kingdom;3539;657;93812;12330
2020-04-13;GB;United Kingdom;4205;725;98017;13055
2020-04-14;GB;United Kingdom;4348;1080;102365;14135
2020-04-15;GB;United Kingdom;5100;884;107465;15019
2020-04-16;GB;United Kingdom;5343;1040;112808;16059
2020-04-17;GB;United Kingdom;4990;914;117798;16973
2020-04-18;GB;United Kingdom;4736;1108;122534;18081
2020-04-19;GB;United Kingdom;3860;433;126394;18514
2020-04-20;GB;United Kingdom;4866;576;131260;19090
2020-04-21;GB;United Kingdom;4775;1224;136035;20314
2020-04-22;GB;United Kingdom;5505;857;141540;21171
2020-04-23;GB;United Kingdom;5168;684;146708;21855
2020-04-24;GB;United Kingdom;4981;1018;151689;22873
2020-04-25;GB;United Kingdom;3764;816;155453;23689
2020-04-26;GB;United Kingdom;3473;364;158926;24053
2020-04-27;GB;United Kingdom;4704;323;163630;24376
2020-04-28;GB;United Kingdom;4727;971;168357;25347
2020-04-29;GB;United Kingdom;5450;771;173807;26118
2020-04-30;GB;United Kingdom;4964;636;178771;26754
2020-05-01;GB;United Kingdom;4730;700;183501;27454
2020-05-02;GB;United Kingdom;3230;585;186731;28039
2020-05-03;GB;United Kingdom;2977;253;189708;28292
2020-05-04;GB;United Kingdom;3383;273;193091;28565
2020-05-05;GB;United Kingdom;3689;725;196780;29290
2020-05-06;GB;United Kingdom;3836;647;200616;29937
2020-05-07;GB;United Kingdom;3771;458;204387;30395
2020-05-08;GB;United Kingdom;3052;580;207439;30975
2020-05-09;GB;United Kingdom;2150;275;209589;31250
2020-05-10;GB;United Kingdom;2322;217;211911;31467
2020-05-11;GB;United Kingdom;3589;188;215500;31655
2020-05-12;GB;United Kingdom;3395;615;218895;32270
2020-05-13;GB;United Kingdom;3300;448;222195;32718
2020-05-14;GB;United Kingdom;2618;353;224813;33071
2020-05-15;GB;United Kingdom;2521;351;227334;33422
2020-05-16;GB;United Kingdom;2072;411;229406;33833
2020-05-17;GB;United Kingdom;1826;67;231232;33900
2020-05-18;GB;United Kingdom;2577;146;233809;34046
2020-05-19;GB;United Kingdom;3058;501;236867;34547
2020-05-20;GB;United Kingdom;2712;329;239579;34876
2020-05-21;GB;United Kingdom;2554;273;242133;35149
2020-05-22;GB;United Kingdom;2041;291;244174;35440
2020-05-23;GB;United Kingdom;1508;220;245682;35660
2020-05-24;GB;United Kingdom;1355;379;247037;36039
2020-05-25;GB;United Kingdom;1613;104;248650;36143
2020-05-26;GB;United Kingdom;1659;131;250309;36274
2020-05-27;GB;United Kingdom;1809;422;252118;36696
2020-05-28;GB;United Kingdom;1736;343;253854;37039
2020-05-29;GB;United Kingdom;1508;274;255362;37313
2020-05-30;GB;United Kingdom;1107;154;256469;37467
2020-05-31;GB;United Kingdom;1070;60;257539;37527
2020-06-01;GB;United Kingdom;1444;86;258983;37613
2020-06-02;GB;United Kingdom;1470;250;260453;37863
2020-06-03;GB;United Kingdom;1349;254;261802;38117
2020-06-04;GB;United Kingdom;1238;130;263040;38247
2020-06-05;GB;United Kingdom;1110;258;264150;38505
2020-06-06;GB;United Kingdom;794;143;264944;38648
2020-06-07;GB;United Kingdom;718;54;265662;38702
2020-06-08;GB;United Kingdom;1094;47;266756;38749
2020-06-09;GB;United Kingdom;1159;197;267915;38946
2020-06-10;GB;United Kingdom;1186;164;269101;39110
2020-06-11;GB;United Kingdom;1007;76;270108;39186
2020-06-12;GB;United Kingdom;1054;131;271162;39317
2020-06-13;GB;United Kingdom;888;107;272050;39424
2020-06-14;GB;United Kingdom;807;27;272857;39451
2020-06-15;GB;United Kingdom;1031;29;273888;39480
2020-06-16;GB;United Kingdom;1083;120;274971;39600
2020-06-17;GB;United Kingdom;999;110;275970;39710
2020-06-18;GB;United Kingdom;1020;67;276990;39777
2020-06-19;GB;United Kingdom;984;84;277974;39861
2020-06-20;GB;United Kingdom;666;71;278640;39932
2020-06-21;GB;United Kingdom;624;31;279264;39963
2020-06-22;GB;United Kingdom;892;13;280156;39976
2020-06-23;GB;United Kingdom;882;94;281038;40070
2020-06-24;GB;United Kingdom;777;87;281815;40157
2020-06-25;GB;United Kingdom;697;99;282512;40256
2020-06-26;GB;United Kingdom;639;77;283151;40333
2020-06-27;GB;United Kingdom;634;40;283785;40373
2020-06-28;GB;United Kingdom;407;31;284192;40404
2020-06-29;GB;United Kingdom;620;21;284812;40425
2020-06-30;GB;United Kingdom;404;54;285216;40479
2020-07-01;GB;United Kingdom;63;97;285279;40576
2020-07-02;GB;United Kingdom;6;41;285285;40617
2020-07-03;GB;United Kingdom;502;49;285787;40666
2020-07-04;GB;United Kingdom;625;32;286412;40698
2020-07-05;GB;United Kingdom;519;19;286931;40717
2020-07-06;GB;United Kingdom;359;11;287290;40728
2020-07-07;GB;United Kingdom;584;54;287874;40782
2020-07-08;GB;United Kingdom;637;57;288511;40839
2020-07-09;GB;United Kingdom;643;31;289154;40870
2020-07-10;GB;United Kingdom;524;34;289678;40904
2020-07-11;GB;United Kingdom;826;17;290504;40921
2020-07-12;GB;United Kingdom;650;9;291154;40930
2020-07-13;GB;United Kingdom;537;10;291691;40940
2020-07-14;GB;United Kingdom;1240;44;292931;40984
2020-07-15;GB;United Kingdom;538;26;293469;41010
2020-07-16;GB;United Kingdom;647;24;294116;41034
2020-07-17;GB;United Kingdom;687;26;294803;41060
2020-07-18;GB;United Kingdom;829;9;295632;41069
2020-07-19;GB;United Kingdom;726;11;296358;41080
2020-07-20;GB;United Kingdom;586;10;296944;41090
2020-07-21;GB;United Kingdom;445;25;297389;41115
2020-07-22;GB;United Kingdom;563;17;297952;41132
2020-07-23;GB;United Kingdom;779;9;298731;41141
2020-07-24;GB;United Kingdom;769;32;299500;41173
2020-07-25;GB;United Kingdom;770;15;300270;41188
2020-07-26;GB;United Kingdom;750;8;301020;41196
2020-07-27;GB;United Kingdom;688;3;301708;41199
2020-07-28;GB;United Kingdom;553;21;302261;41220
2020-07-29;GB;United Kingdom;802;34;303063;41254
2020-07-30;GB;United Kingdom;847;0;303910;41254
2020-07-31;GB;United Kingdom;883;20;304793;41274
2020-08-01;GB;United Kingdom;769;13;305562;41287
2020-08-02;GB;United Kingdom;747;5;306309;41292
2020-08-03;GB;United Kingdom;942;1;307251;41293
2020-08-04;GB;United Kingdom;675;18;307926;41311
2020-08-05;GB;United Kingdom;906;14;308832;41325
2020-08-06;GB;United Kingdom;964;18;309796;41343
2020-08-07;GB;United Kingdom;900;12;310696;41355
2020-08-08;GB;United Kingdom;765;3;311461;41358
2020-08-09;GB;United Kingdom;1113;5;312574;41363
2020-08-10;GB;United Kingdom;818;18;313392;41381
2020-08-11;GB;United Kingdom;1150;13;314542;41394
2020-08-12;GB;United Kingdom;1039;20;315581;41414
2020-08-13;GB;United Kingdom;1148;18;316729;41432
2020-08-14;GB;United Kingdom;1461;11;318190;41443
2020-08-15;GB;United Kingdom;1042;3;319232;41446
2020-08-16;GB;United Kingdom;1111;5;320343;41451
2020-08-17;GB;United Kingdom;721;3;321064;41454
2020-08-18;GB;United Kingdom;1113;12;322177;41466
2020-08-19;GB;United Kingdom;831;17;323008;41483
2020-08-20;GB;United Kingdom;1195;6;324203;41489
2020-08-21;GB;United Kingdom;1060;2;325263;41491
2020-08-22;GB;United Kingdom;1332;18;326595;41509
2020-08-23;GB;United Kingdom;1048;6;327643;41515
2020-08-24;GB;United Kingdom;977;4;328620;41519
2020-08-25;GB;United Kingdom;1201;16;329821;41535
2020-08-26;GB;United Kingdom;1146;17;330967;41552
2020-08-27;GB;United Kingdom;1542;12;332509;41564
2020-08-28;GB;United Kingdom;1297;9;333806;41573
2020-08-29;GB;United Kingdom;1110;12;334916;41585
2020-08-30;GB;United Kingdom;1752;1;336668;41586
2020-08-31;GB;United Kingdom;1415;3;338083;41589
2020-09-01;GB;United Kingdom;1332;3;339415;41592
2020-09-02;GB;United Kingdom;1514;10;340929;41602
2020-09-03;GB;United Kingdom;1779;14;342708;41616
2020-09-04;GB;United Kingdom;1978;10;344686;41626
2020-09-05;GB;United Kingdom;1827;12;346513;41638
2020-09-06;GB;United Kingdom;2987;2;349500;41640
2020-09-07;GB;United Kingdom;2953;3;352453;41643
2020-09-08;GB;United Kingdom;2481;32;354934;41675
2020-09-09;GB;United Kingdom;2681;8;357615;41683
2020-09-10;GB;United Kingdom;2931;14;360546;41697
2020-09-11;GB;United Kingdom;3544;6;364090;41703
2020-09-12;GB;United Kingdom;3504;9;367594;41712
2020-09-13;GB;United Kingdom;3338;5;370932;41717
2020-09-14;GB;United Kingdom;2625;9;373557;41726
2020-09-15;GB;United Kingdom;3115;27;376672;41753
2020-09-16;GB;United Kingdom;4007;20;380679;41773
2020-09-17;GB;United Kingdom;3410;21;384089;41794
2020-09-18;GB;United Kingdom;4329;27;388418;41821
2020-09-19;GB;United Kingdom;4429;27;392847;41848
2020-09-20;GB;United Kingdom;3899;18;396746;41866
2020-09-21;GB;United Kingdom;4378;11;401124;41877
2020-09-22;GB;United Kingdom;4936;37;406060;41914
2020-09-23;GB;United Kingdom;6187;37;412247;41951
2020-09-24;GB;United Kingdom;6644;40;418891;41991
2020-09-25;GB;United Kingdom;6878;34;425769;42025
2020-09-26;GB;United Kingdom;6050;35;431819;42060
2020-09-27;GB;United Kingdom;5700;17;437519;42077
2020-09-28;GB;United Kingdom;4056;13;441575;42090
2020-09-29;GB;United Kingdom;7156;72;448731;42162
2020-09-30;GB;United Kingdom;7117;71;455848;42233
2020-10-01;GB;United Kingdom;6929;59;462777;42292
2020-10-02;GB;United Kingdom;6994;66;469771;42358
2020-10-03;GB;United Kingdom;12885;49;482656;42407
2020-10-04;GB;United Kingdom;22965;33;505621;42440
2020-10-05;GB;United Kingdom;12603;19;518224;42459
2020-10-06;GB;United Kingdom;14557;76;532781;42535
2020-10-07;GB;United Kingdom;14173;70;546954;42605
2020-10-08;GB;United Kingdom;17550;77;564504;42682
2020-10-09;GB;United Kingdom;13888;87;578392;42769
2020-10-10;GB;United Kingdom;15175;81;593567;42850
2020-10-11;GB;United Kingdom;12882;65;606449;42915
2020-10-12;GB;United Kingdom;14011;50;620460;42965
2020-10-13;GB;United Kingdom;17250;143;637710;43108
2020-10-14;GB;United Kingdom;19751;137;657461;43245
2020-10-15;GB;United Kingdom;18996;138;676457;43383
2020-10-16;GB;United Kingdom;15657;136;692114;43519
2020-10-17;GB;United Kingdom;16186;150;708300;43669
2020-10-18;GB;United Kingdom;16994;67;725294;43736
2020-10-19;GB;United Kingdom;18830;80;744124;43816
2020-10-20;GB;United Kingdom;21365;241;765489;44057
2020-10-21;GB;United Kingdom;26707;191;792196;44248
2020-10-22;GB;United Kingdom;21257;189;813453;44437
2020-10-23;GB;United Kingdom;20559;224;834012;44661
2020-10-24;GB;United Kingdom;23033;174;857045;44835
2020-10-25;GB;United Kingdom;19797;151;876842;44986
2020-10-26;GB;United Kingdom;20900;102;897742;45088
2020-10-27;GB;United Kingdom;22924;367;920666;45455
2020-10-28;GB;United Kingdom;24714;310;945380;45765
2020-10-29;GB;United Kingdom;23078;280;968458;46045
2020-10-30;GB;United Kingdom;24418;274;992876;46319
2020-10-31;GB;United Kingdom;21919;326;1014795;46645
2020-11-01;GB;United Kingdom;23261;162;1038056;46807
2020-11-02;GB;United Kingdom;18967;136;1057023;46943
2020-11-03;GB;United Kingdom;20078;397;1077101;47340
2020-11-04;GB;United Kingdom;25206;492;1102307;47832
2020-11-05;GB;United Kingdom;24164;378;1126471;48210
2020-11-06;GB;United Kingdom;23322;355;1149793;48565
2020-11-07;GB;United Kingdom;24979;413;1174772;48978
2020-11-08;GB;United Kingdom;20580;156;1195352;49134
2020-11-09;GB;United Kingdom;21397;195;1216749;49329
2020-11-10;GB;United Kingdom;20451;532;1237200;49861
2020-11-11;GB;United Kingdom;23000;596;1260200;50457
2020-11-12;GB;United Kingdom;33517;563;1293717;51020
2020-11-13;GB;United Kingdom;27316;376;1321033;51396
2020-11-14;GB;United Kingdom;26876;462;1347909;51858
2020-11-15;GB;United Kingdom;24977;168;1372886;52026
2020-11-16;GB;United Kingdom;21416;214;1394302;52240
2020-11-17;GB;United Kingdom;20060;599;1414362;52839
2020-11-18;GB;United Kingdom;19645;529;1434007;53368
2020-11-19;GB;United Kingdom;22936;502;1456943;53870
2020-11-20;GB;United Kingdom;20274;511;1477217;54381
2020-11-21;GB;United Kingdom;19921;340;1497138;54721
2020-11-22;GB;United Kingdom;18667;399;1515805;55120
2020-11-23;GB;United Kingdom;15465;207;1531270;55327
2020-11-24;GB;United Kingdom;11344;608;1542614;55935
2020-11-25;GB;United Kingdom;18261;695;1560875;56630
2020-11-26;GB;United Kingdom;17557;498;1578432;57128
2020-11-27;GB;United Kingdom;14821;520;1593253;57648
2020-11-28;GB;United Kingdom;15891;479;1609144;58127
2020-11-29;GB;United Kingdom;12164;215;1621308;58342
2020-11-30;GB;United Kingdom;12428;203;1633736;58545
2020-12-01;GB;United Kingdom;13497;603;1647233;59148
2020-12-02;GB;United Kingdom;16237;648;1663470;59796
2020-12-03;GB;United Kingdom;14951;414;1678421;60210
2020-12-04;GB;United Kingdom;16382;504;1694803;60714
2020-12-05;GB;United Kingdom;15579;397;1710382;61111
2020-12-06;GB;United Kingdom;17372;231;1727754;61342
2020-12-07;GB;United Kingdom;14774;189;1742528;61531
2020-12-08;GB;United Kingdom;12386;599;1754914;62130
2020-12-09;GB;United Kingdom;16634;533;1771548;62663
2020-12-10;GB;United Kingdom;21066;516;1792614;63179
2020-12-11;GB;United Kingdom;21784;424;1814398;63603
2020-12-12;GB;United Kingdom;21554;520;1835952;64123
2020-12-13;GB;United Kingdom;18541;144;1854493;64267
2020-12-14;GB;United Kingdom;20377;233;1874870;64500
2020-12-15;GB;United Kingdom;18569;506;1893439;65006
2020-12-16;GB;United Kingdom;25300;612;1918739;65618
2020-12-17;GB;United Kingdom;35532;532;1954271;66150
2020-12-18;GB;United Kingdom;28560;490;1982831;66640
2020-12-19;GB;United Kingdom;27249;537;2010080;67177
2020-12-20;GB;United Kingdom;36084;326;2046164;67503
2020-12-21;GB;United Kingdom;33517;215;2079681;67718
2020-12-22;GB;United Kingdom;36931;691;2116612;68409
2020-12-23;GB;United Kingdom;39387;748;2155999;69157
2020-12-24;GB;United Kingdom;39149;575;2195148;69732
2020-12-25;GB;United Kingdom;32803;570;2227951;70302
2020-12-26;GB;United Kingdom;34788;211;2262739;70513
2020-12-27;GB;United Kingdom;32493;347;2295232;70860
2020-12-28;GB;United Kingdom;41460;357;2336692;71217
2020-12-29;GB;United Kingdom;53275;458;2389967;71675
2020-12-30;GB;United Kingdom;50239;982;2440206;72657
2020-12-31;GB;United Kingdom;56029;965;2496235;73622
2021-01-01;GB;United Kingdom;53458;615;2549693;74237
2021-01-02;GB;United Kingdom;57853;445;2607546;74682
2021-01-03;GB;United Kingdom;55157;455;2662703;75137
2021-01-04;GB;United Kingdom;58923;410;2721626;75547
2021-01-05;GB;United Kingdom;61087;881;2782713;76428
2021-01-06;GB;United Kingdom;62556;1042;2845269;77470
2021-01-07;GB;United Kingdom;52787;1162;2898056;78632
2021-01-08;GB;United Kingdom;68192;1333;2966248;79965
2021-01-09;GB;United Kingdom;60098;1035;3026346;81000
2021-01-10;GB;United Kingdom;55026;567;3081372;81567
2021-01-11;GB;United Kingdom;46275;529;3127647;82096
2021-01-12;GB;United Kingdom;45648;1246;3173295;83342
2021-01-13;GB;United Kingdom;47662;1568;3220957;84910
2021-01-14;GB;United Kingdom;48804;1253;3269761;86163
2021-01-15;GB;United Kingdom;55885;1285;3325646;87448
2021-01-16;GB;United Kingdom;41428;1299;3367074;88747
2021-01-17;GB;United Kingdom;38670;682;3405744;89429
2021-01-18;GB;United Kingdom;37610;602;3443354;90031
2021-01-19;GB;United Kingdom;33454;1612;3476808;91643
2021-01-20;GB;United Kingdom;38992;1826;3515800;93469
2021-01-21;GB;United Kingdom;37977;1296;3553777;94765
2021-01-22;GB;United Kingdom;40321;1401;3594098;96166
2021-01-23;GB;United Kingdom;33652;1352;3627750;97518
2021-01-24;GB;United Kingdom;30111;611;3657861;98129
2021-01-25;GB;United Kingdom;22244;594;3680105;98723
2021-01-26;GB;United Kingdom;20167;1636;3700272;100359
2021-01-27;GB;United Kingdom;25369;1726;3725641;102085
2021-01-28;GB;United Kingdom;28811;1239;3754452;103324
2021-01-29;GB;United Kingdom;29145;1248;3783597;104572
2021-01-30;GB;United Kingdom;23400;1205;3806997;105777
2021-01-31;GB;United Kingdom;21190;590;3828187;106367
2021-02-01;GB;United Kingdom;18668;407;3846855;106774
2021-02-02;GB;United Kingdom;16906;1451;3863761;108225
2021-02-03;GB;United Kingdom;19215;1322;3882976;109547
2021-02-04;GB;United Kingdom;20734;915;3903710;110462
2021-02-05;GB;United Kingdom;19204;1015;3922914;111477
2021-02-06;GB;United Kingdom;18363;828;3941277;112305
2021-02-07;GB;United Kingdom;15904;376;3957181;112681
2021-02-08;GB;United Kingdom;14138;333;3971319;113014
2021-02-09;GB;United Kingdom;12441;1052;3983760;114066
2021-02-10;GB;United Kingdom;13077;1002;3996837;115068
2021-02-11;GB;United Kingdom;13543;680;4010380;115748
2021-02-12;GB;United Kingdom;15198;759;4025578;116507
2021-02-13;GB;United Kingdom;13355;621;4038933;117128
2021-02-14;GB;United Kingdom;10991;259;4049924;117387
2021-02-15;GB;United Kingdom;9776;235;4059700;117622
2021-02-16;GB;United Kingdom;10636;799;4070336;118421
2021-02-17;GB;United Kingdom;12760;738;4083096;119159
2021-02-18;GB;United Kingdom;12095;455;4095191;119614
2021-02-19;GB;United Kingdom;12099;533;4107290;120147
2021-02-20;GB;United Kingdom;10453;446;4117743;120593
2021-02-21;GB;United Kingdom;9835;217;4127578;120810
2021-02-22;GB;United Kingdom;10659;178;4138237;120988
2021-02-23;GB;United Kingdom;8523;548;4146760;121536
2021-02-24;GB;United Kingdom;9947;443;4156707;121979
2021-02-25;GB;United Kingdom;10020;324;4166727;122303
2021-02-26;GB;United Kingdom;8588;345;4175315;122648
2021-02-27;GB;United Kingdom;7457;291;4182772;122939
2021-02-28;GB;United Kingdom;6055;144;4188827;123083
2021-03-01;GB;United Kingdom;5462;104;4194289;123187
2021-03-02;GB;United Kingdom;6411;343;4200700;123530
2021-03-03;GB;United Kingdom;6420;487;4207120;124017
2021-03-04;GB;United Kingdom;6644;242;4213764;124259
2021-03-05;GB;United Kingdom;6024;236;4219788;124495
2021-03-06;GB;United Kingdom;6118;159;4225906;124654
2021-03-07;GB;United Kingdom;5260;82;4231166;124736
2021-03-08;GB;United Kingdom;4823;65;4235989;124801
2021-03-09;GB;United Kingdom;5869;231;4241858;125032
2021-03-10;GB;United Kingdom;6021;190;4247879;125222
2021-03-11;GB;United Kingdom;6835;181;4254714;125403
2021-03-12;GB;United Kingdom;6684;176;4261398;125579
2021-03-13;GB;United Kingdom;5617;122;4267015;125701
2021-03-14;GB;United Kingdom;4695;52;4271710;125753
2021-03-15;GB;United Kingdom;5130;64;4276840;125817
2021-03-16;GB;United Kingdom;5363;110;4282203;125927
2021-03-17;GB;United Kingdom;5793;141;4287996;126068
2021-03-18;GB;United Kingdom;6332;95;4294328;126163
2021-03-19;GB;United Kingdom;4872;100;4299200;126263
2021-03-20;GB;United Kingdom;5639;96;4304839;126359
2021-03-21;GB;United Kingdom;5356;34;4310195;126393
2021-03-22;GB;United Kingdom;5407;18;4315602;126411
2021-03-23;GB;United Kingdom;5417;112;4321019;126523
2021-03-24;GB;United Kingdom;5626;98;4326645;126621
2021-03-25;GB;United Kingdom;6277;63;4332922;126684
2021-03-26;GB;United Kingdom;6235;71;4339157;126755
2021-03-27;GB;United Kingdom;3909;58;4343066;126813
2021-03-28;GB;United Kingdom;3947;21;4347013;126834
2021-03-29;GB;United Kingdom;4783;23;4351796;126857
2021-03-30;GB;United Kingdom;4071;55;4355867;126912
2021-03-31;GB;United Kingdom;4115;43;4359982;126955
2021-04-01;GB;United Kingdom;4565;51;4364547;127006
2021-04-02;GB;United Kingdom;3422;52;4367969;127058
2021-04-03;GB;United Kingdom;3424;10;4371393;127068
2021-04-04;GB;United Kingdom;2405;10;4373798;127078
2021-04-05;GB;United Kingdom;2831;28;4376629;127106
2021-04-06;GB;United Kingdom;2404;20;4379033;127126
2021-04-07;GB;United Kingdom;2797;45;4381830;127171
2021-04-08;GB;United Kingdom;3124;53;4384954;127224
2021-04-09;GB;United Kingdom;-4787;60;4380167;127284
2021-04-10;GB;United Kingdom;2713;40;4382880;127324
2021-04-11;GB;United Kingdom;1730;7;4384610;127331
2021-04-12;GB;United Kingdom;3686;15;4388296;127346
2021-04-13;GB;United Kingdom;2505;23;4390801;127369
2021-04-14;GB;United Kingdom;2529;38;4393330;127407
2021-04-15;GB;United Kingdom;2766;31;4396096;127438
2021-04-16;GB;United Kingdom;2807;34;4398903;127472
2021-04-17;GB;United Kingdom;2273;36;4401176;127508
2021-04-18;GB;United Kingdom;1884;10;4403060;127518
2021-04-19;GB;United Kingdom;3054;6;4406114;127524
2021-04-20;GB;United Kingdom;2530;33;4408644;127557
2021-04-21;GB;United Kingdom;2424;20;4411068;127577
2021-04-22;GB;United Kingdom;2766;20;4413834;127597
2021-04-23;GB;United Kingdom;2754;41;4416588;127638
2021-04-24;GB;United Kingdom;2122;32;4418710;127670
2021-04-25;GB;United Kingdom;1733;11;4420443;127681
2021-04-26;GB;United Kingdom;2119;7;4422562;127688
2021-04-27;GB;United Kingdom;2697;17;4425259;127705
2021-04-28;GB;United Kingdom;2131;29;4427390;127734
2021-04-29;GB;United Kingdom;2459;25;4429849;127759
2021-04-30;GB;United Kingdom;2397;16;4432246;127775
2021-05-01;GB;United Kingdom;1911;7;4434157;127782
2021-05-02;GB;United Kingdom;1674;14;4435831;127796
2021-05-03;GB;United Kingdom;1674;1;4437505;127797
2021-05-04;GB;United Kingdom;1984;6;4439489;127803
2021-05-05;GB;United Kingdom;2155;27;4441644;127830
2021-05-06;GB;United Kingdom;2618;13;4444262;127843
2021-05-07;GB;United Kingdom;2490;15;4446752;127858
2021-05-08;GB;United Kingdom;2056;5;4448808;127863
2021-05-09;GB;United Kingdom;1770;2;4450578;127865
2021-05-10;GB;United Kingdom;2378;5;4452956;127870
2021-05-11;GB;United Kingdom;2490;20;4455446;127890
2021-05-12;GB;United Kingdom;2296;11;4457742;127901
2021-05-13;GB;United Kingdom;2663;11;4460405;127912
2021-05-14;GB;United Kingdom;2198;18;4462603;127930
2021-05-15;GB;United Kingdom;2060;7;4464663;127937
2021-05-16;GB;United Kingdom;1926;4;4466589;127941
2021-05-17;GB;United Kingdom;1993;5;4468582;127946
2021-05-18;GB;United Kingdom;-2362;7;4466220;127953
2021-05-19;GB;United Kingdom;2146;3;4468366;127956
2021-05-20;GB;United Kingdom;2699;7;4471065;127963
2021-05-21;GB;United Kingdom;2708;9;4473773;127972
2021-05-22;GB;United Kingdom;2524;6;4476297;127978
2021-05-23;GB;United Kingdom;2093;5;4478390;127983
2021-05-24;GB;United Kingdom;2370;3;4480760;127986
2021-05-25;GB;United Kingdom;2417;15;4483177;128001
2021-05-26;GB;United Kingdom;2991;9;4486168;128010
2021-05-27;GB;United Kingdom;3384;10;4489552;128020
2021-05-28;GB;United Kingdom;4030;10;4493582;128030
2021-05-29;GB;United Kingdom;3241;7;4496823;128037
2021-05-30;GB;United Kingdom;3114;6;4499937;128043
2021-05-31;GB;United Kingdom;3294;2;4503231;128045
2021-06-01;GB;United Kingdom;3102;0;4506333;128045
2021-06-02;GB;United Kingdom;4264;12;4510597;128057
2021-06-03;GB;United Kingdom;5181;18;4515778;128075
2021-06-04;GB;United Kingdom;6144;11;4521922;128086
2021-06-05;GB;United Kingdom;5655;13;4527577;128099
2021-06-06;GB;United Kingdom;5225;4;4532802;128103
2021-06-07;GB;United Kingdom;5597;1;4538399;128104
2021-06-08;GB;United Kingdom;5973;14;4544372;128118
2021-06-09;GB;United Kingdom;7322;6;4551694;128124
2021-06-10;GB;United Kingdom;7239;7;4558933;128131
2021-06-11;GB;United Kingdom;7960;17;4566893;128148
2021-06-12;GB;United Kingdom;7552;12;4574445;128160
2021-06-13;GB;United Kingdom;7334;8;4581779;128168
2021-06-14;GB;United Kingdom;7621;3;4589400;128171
2021-06-15;GB;United Kingdom;7594;10;4596994;128181
2021-06-16;GB;United Kingdom;8811;9;4605805;128190
2021-06-17;GB;United Kingdom;10823;19;4616628;128209
2021-06-18;GB;United Kingdom;10287;11;4626915;128220
2021-06-19;GB;United Kingdom;10076;14;4636991;128234
2021-06-20;GB;United Kingdom;9077;6;4646068;128240
2021-06-21;GB;United Kingdom;10468;5;4656536;128245
2021-06-22;GB;United Kingdom;11507;27;4668043;128272
2021-06-23;GB;United Kingdom;15943;19;4683986;128291
2021-06-24;GB;United Kingdom;16705;21;4700691;128312
2021-06-25;GB;United Kingdom;15374;18;4716065;128330
2021-06-26;GB;United Kingdom;17946;23;4734011;128353
2021-06-27;GB;United Kingdom;14633;11;4748644;128364
2021-06-28;GB;United Kingdom;22723;3;4771367;128367
2021-06-29;GB;United Kingdom;20261;23;4791628;128390
2021-06-30;GB;United Kingdom;25670;14;4817298;128404
2021-07-01;GB;United Kingdom;27646;22;4844944;128426
2020-01-22;US;United States;0;0;1;0
2020-01-23;US;United States;0;0;1;0
2020-01-24;US;United States;1;0;2;0
2020-01-25;US;United States;0;0;2;0
2020-01-26;US;United States;3;0;5;0
2020-01-27;US;United States;0;0;5;0
2020-01-28;US;United States;0;0;5;0
2020-01-29;US;United States;1;0;6;0
2020-01-30;US;United States;0;0;6;0
2020-01-31;US;United States;2;0;8;0
2020-02-01;US;United States;0;0;8;0
2020-02-02;US;United States;0;0;8;0
2020-02-03;US;United States;3;0;11;0
2020-02-04;US;United States;0;0;11;0
2020-02-05;US;United States;0;0;11;0
2020-02-06;US;United States;1;0;12;0
2020-02-07;US;United States;0;0;12;0
2020-02-08;US;United States;0;0;12;0
2020-02-09;US;United States;0;0;12;0
2020-02-10;US;United States;0;0;12;0
2020-02-11;US;United States;1;0;13;0
2020-02-12;US;United States;0;0;13;0
2020-02-13;US;United States;1;0;14;0
2020-02-14;US;United States;0;0;14;0
2020-02-15;US;United States;0;0;14;0
2020-02-16;US;United States;0;0;14;0
2020-02-17;US;United States;0;0;14;0
2020-02-18;US;United States;0;0;14;0
2020-02-19;US;United States;0;0;14;0
2020-02-20;US;United States;0;0;14;0
2020-02-21;US;United States;2;0;16;0
2020-02-22;US;United States;0;0;16;0
2020-02-23;US;United States;0;0;16;0
2020-02-24;US;United States;0;0;16;0
2020-02-25;US;United States;0;0;16;0
2020-02-26;US;United States;0;0;16;0
2020-02-27;US;United States;1;0;17;0
2020-02-28;US;United States;0;0;17;0
2020-02-29;US;United States;8;1;25;1
2020-03-01;US;United States;7;0;32;1
2020-03-02;US;United States;23;5;55;6
2020-03-03;US;United States;19;1;74;7
2020-03-04;US;United States;33;4;107;11
2020-03-05;US;United States;77;1;184;12
2020-03-06;US;United States;53;2;237;14
2020-03-07;US;United States;166;3;403;17
2020-03-08;US;United States;116;4;519;21
2020-03-09;US;United States;75;1;594;22
2020-03-10;US;United States;188;6;782;28
2020-03-11;US;United States;365;5;1147;33
2020-03-12;US;United States;439;10;1586;43
2020-03-13;US;United States;633;8;2219;51
2020-03-14;US;United States;759;7;2978;58
2020-03-15;US;United States;234;12;3212;70
2020-03-16;US;United States;1467;27;4679;97
2020-03-17;US;United States;1833;37;6512;134
2020-03-18;US;United States;2657;60;9169;194
2020-03-19;US;United States;4494;72;13663;266
2020-03-20;US;United States;6367;106;20030;372
2020-03-21;US;United States;5995;103;26025;475
2020-03-22;US;United States;8873;124;34898;599
2020-03-23;US;United States;11238;191;46136;790
2020-03-24;US;United States;10619;243;56755;1033
2020-03-25;US;United States;12082;334;68837;1367
2020-03-26;US;United States;17856;418;86693;1785
2020-03-27;US;United States;18690;522;105383;2307
2020-03-28;US;United States;19630;650;125013;2957
2020-03-29;US;United States;18899;616;143912;3573
2020-03-30;US;United States;22075;713;165987;4286
2020-03-31;US;United States;26314;1085;192301;5371
2020-04-01;US;United States;32286;1284;224587;6655
2020-04-02;US;United States;32222;1514;256809;8169
2020-04-03;US;United States;32307;1429;289116;9598
2020-04-04;US;United States;32386;1568;321502;11166
2020-04-05;US;United States;29895;1615;351397;12781
2020-04-06;US;United States;31390;1772;382787;14553
2020-04-07;US;United States;30779;2573;413566;17126
2020-04-08;US;United States;31235;2161;444801;19287
2020-04-09;US;United States;35942;2211;480743;21498
2020-04-10;US;United States;34403;2197;515146;23695
2020-04-11;US;United States;29083;2126;544229;25821
2020-04-12;US;United States;27256;1873;571485;27694
2020-04-13;US;United States;26939;2015;598424;29709
2020-04-14;US;United States;28818;2447;627242;32156
2020-04-15;US;United States;25408;2607;652650;34763
2020-04-16;US;United States;30002;2153;682652;36916
2020-04-17;US;United States;33066;2113;715718;39029
2020-04-18;US;United States;27907;1972;743625;41001
2020-04-19;US;United States;26062;1977;769687;42978
2020-04-20;US;United States;29820;2236;799507;45214
2020-04-21;US;United States;25926;2505;825433;47719
2020-04-22;US;United States;28911;2465;854344;50184
2020-04-23;US;United States;33612;2458;887956;52642
2020-04-24;US;United States;32327;2188;920283;54830
2020-04-25;US;United States;30380;1716;950663;56546
2020-04-26;US;United States;26488;1404;977151;57950
2020-04-27;US;United States;23715;1520;1000866;59470
2020-04-28;US;United States;24575;2225;1025441;61695
2020-04-29;US;United States;26459;2410;1051900;64105
2020-04-30;US;United States;29205;2188;1081105;66293
2020-05-01;US;United States;34907;1915;1116012;68208
2020-05-02;US;United States;27348;1730;1143360;69938
2020-05-03;US;United States;24321;1197;1167681;71135
2020-05-04;US;United States;24068;1390;1191749;72525
2020-05-05;US;United States;24528;2215;1216277;74740
2020-05-06;US;United States;24569;2309;1240846;77049
2020-05-07;US;United States;27429;1925;1268275;78974
2020-05-08;US;United States;26830;1758;1295105;80732
2020-05-09;US;United States;25176;1463;1320281;82195
2020-05-10;US;United States;18805;987;1339086;83182
2020-05-11;US;United States;19298;1044;1358384;84226
2020-05-12;US;United States;22927;1598;1381311;85824
2020-05-13;US;United States;20433;1725;1401744;87549
2020-05-14;US;United States;26817;1782;1428561;89331
2020-05-15;US;United States;24733;1666;1453294;90997
2020-05-16;US;United States;24135;1201;1477429;92198
2020-05-17;US;United States;18388;825;1495817;93023
2020-05-18;US;United States;22389;1223;1518206;94246
2020-05-19;US;United States;20979;1460;1539185;95706
2020-05-20;US;United States;22725;1499;1561910;97205
2020-05-21;US;United States;25769;1185;1587679;98390
2020-05-22;US;United States;23649;1222;1611328;99612
2020-05-23;US;United States;21099;1086;1632427;100698
2020-05-24;US;United States;20077;640;1652504;101338
2020-05-25;US;United States;18662;597;1671166;101935
2020-05-26;US;United States;19663;678;1690829;102613
2020-05-27;US;United States;18551;1459;1709380;104072
2020-05-28;US;United States;22320;1092;1731700;105164
2020-05-29;US;United States;24478;1130;1756178;106294
2020-05-30;US;United States;23632;954;1779810;107248
2020-05-31;US;United States;18983;617;1798793;107865
2020-06-01;US;United States;17414;778;1816207;108643
2020-06-02;US;United States;21502;980;1837709;109623
2020-06-03;US;United States;19857;1008;1857566;110631
2020-06-04;US;United States;21658;1006;1879224;111637
2020-06-05;US;United States;25403;889;1904627;112526
2020-06-06;US;United States;21142;642;1925769;113168
2020-06-07;US;United States;17928;460;1943697;113628
2020-06-08;US;United States;17616;509;1961313;114137
2020-06-09;US;United States;18383;907;1979696;115044
2020-06-10;US;United States;21111;879;2000807;115923
2020-06-11;US;United States;23166;828;2023973;116751
2020-06-12;US;United States;24828;829;2048801;117580
2020-06-13;US;United States;25212;740;2074013;118320
2020-06-14;US;United States;18941;345;2092954;118665
2020-06-15;US;United States;19827;396;2112781;119061
2020-06-16;US;United States;23667;813;2136448;119874
2020-06-17;US;United States;27072;739;2163520;120613
2020-06-18;US;United States;28537;688;2192057;121301
2020-06-19;US;United States;31544;627;2223601;121928
2020-06-20;US;United States;32280;558;2255881;122486
2020-06-21;US;United States;25150;320;2281031;122806
2020-06-22;US;United States;32144;407;2313175;123213
2020-06-23;US;United States;37072;748;2350247;123961
2020-06-24;US;United States;35878;737;2386125;124698
2020-06-25;US;United States;40326;538;2426451;125236
2020-06-26;US;United States;45999;628;2472450;125864
2020-06-27;US;United States;41330;506;2513780;126370
2020-06-28;US;United States;40734;316;2554514;126686
2020-06-29;US;United States;41299;386;2595813;127072
2020-06-30;US;United States;46420;555;2642233;127627
2020-07-01;US;United States;51820;701;2694053;128328
2020-07-02;US;United States;56636;710;2750689;129038
2020-07-03;US;United States;51351;670;2802040;129708
2020-07-04;US;United States;45693;315;2847733;130023
2020-07-05;US;United States;50747;326;2898480;130349
2020-07-06;US;United States;43106;377;2941586;130726
2020-07-07;US;United States;60661;1161;3002247;131887
2020-07-08;US;United States;60119;822;3062366;132709
2020-07-09;US;United States;62509;1020;3124875;133729
2020-07-10;US;United States;68057;816;3192932;134545
2020-07-11;US;United States;60017;729;3252949;135274
2020-07-12;US;United States;58424;472;3311373;135746
2020-07-13;US;United States;58930;448;3370303;136194
2020-07-14;US;United States;68051;928;3438354;137122
2020-07-15;US;United States;68090;974;3506444;138096
2020-07-16;US;United States;75866;955;3582310;139051
2020-07-17;US;United States;72236;925;3654546;139976
2020-07-18;US;United States;62536;859;3717082;140835
2020-07-19;US;United States;60456;485;3777538;141320
2020-07-20;US;United States;62107;563;3839645;141883
2020-07-21;US;United States;64461;1085;3904106;142968
2020-07-22;US;United States;70579;1223;3974685;144191
2020-07-23;US;United States;68445;1070;4043130;145261
2020-07-24;US;United States;73319;1106;4116449;146367
2020-07-25;US;United States;64953;932;4181402;147299
2020-07-26;US;United States;54816;531;4236218;147830
2020-07-27;US;United States;56783;1127;4293001;148957
2020-07-28;US;United States;66412;1332;4359413;150289
2020-07-29;US;United States;71873;1411;4431286;151700
2020-07-30;US;United States;67466;1235;4498752;152935
2020-07-31;US;United States;68712;1237;4567464;154172
2020-08-01;US;United States;56201;1087;4623665;155259
2020-08-02;US;United States;45568;437;4669233;155696
2020-08-03;US;United States;45501;583;4714734;156279
2020-08-04;US;United States;58774;1282;4773508;157561
2020-08-05;US;United States;54466;1439;4827974;159000
2020-08-06;US;United States;59349;1239;4887323;160239
2020-08-07;US;United States;59303;1241;4946626;161480
2020-08-08;US;United States;54134;1076;5000760;162556
2020-08-09;US;United States;45769;523;5046529;163079
2020-08-10;US;United States;47606;634;5094135;163713
2020-08-11;US;United States;48003;1025;5142138;164738
2020-08-12;US;United States;56040;1505;5198178;166243
2020-08-13;US;United States;51316;1064;5249494;167307
2020-08-14;US;United States;65336;1337;5314830;168644
2020-08-15;US;United States;46951;1000;5361781;169644
2020-08-16;US;United States;39212;616;5400993;170260
2020-08-17;US;United States;36652;493;5437645;170753
2020-08-18;US;United States;45033;1226;5482678;171979
2020-08-19;US;United States;47320;1337;5529998;173316
2020-08-20;US;United States;44041;1104;5574039;174420
2020-08-21;US;United States;48843;1088;5622882;175508
2020-08-22;US;United States;43064;911;5665946;176419
2020-08-23;US;United States;34247;545;5700193;176964
2020-08-24;US;United States;36482;475;5736675;177439
2020-08-25;US;United States;40354;1230;5777029;178669
2020-08-26;US;United States;45172;1162;5822201;179831
2020-08-27;US;United States;45393;1115;5867594;180946
2020-08-28;US;United States;46832;978;5914426;181924
2020-08-29;US;United States;42754;915;5957180;182839
2020-08-30;US;United States;34404;441;5991584;183280
2020-08-31;US;United States;35362;541;6026946;183821
2020-09-01;US;United States;41846;1029;6068792;184850
2020-09-02;US;United States;41018;1073;6109810;185923
2020-09-03;US;United States;44251;1031;6154061;186954
2020-09-04;US;United States;50382;957;6204443;187911
2020-09-05;US;United States;43158;762;6247601;188673
2020-09-06;US;United States;31218;472;6278819;189145
2020-09-07;US;United States;23613;295;6302432;189440
2020-09-08;US;United States;27226;455;6329658;189895
2020-09-09;US;United States;34049;1161;6363707;191056
2020-09-10;US;United States;36056;919;6399763;191975
2020-09-11;US;United States;47769;1164;6447532;193139
2020-09-12;US;United States;41101;711;6488633;193850
2020-09-13;US;United States;34372;423;6523005;194273
2020-09-14;US;United States;34423;432;6557428;194705
2020-09-15;US;United States;39492;1198;6596920;195903
2020-09-16;US;United States;39030;962;6635950;196865
2020-09-17;US;United States;45130;858;6681080;197723
2020-09-18;US;United States;49282;891;6730362;198614
2020-09-19;US;United States;42202;732;6772564;199346
2020-09-20;US;United States;38447;266;6811011;199612
2020-09-21;US;United States;51878;425;6862889;200037
2020-09-22;US;United States;39866;1029;6902755;201066
2020-09-23;US;United States;39069;1056;6941824;202122
2020-09-24;US;United States;47103;900;6988927;203022
2020-09-25;US;United States;48295;940;7037222;203962
2020-09-26;US;United States;44673;769;7081895;204731
2020-09-27;US;United States;37528;315;7119423;205046
2020-09-28;US;United States;33294;358;7152717;205404
2020-09-29;US;United States;43338;836;7196055;206240
2020-09-30;US;United States;39443;958;7235498;207198
2020-10-01;US;United States;45650;869;7281148;208067
2020-10-02;US;United States;54950;860;7336098;208927
2020-10-03;US;United States;48577;682;7384675;209609
2020-10-04;US;United States;35738;378;7420413;209987
2020-10-05;US;United States;39376;481;7459789;210468
2020-10-06;US;United States;45289;686;7505078;211154
2020-10-07;US;United States;51056;923;7556134;212077
2020-10-08;US;United States;58599;989;7614733;213066
2020-10-09;US;United States;56384;969;7671117;214035
2020-10-10;US;United States;54953;657;7726070;214692
2020-10-11;US;United States;45981;465;7772051;215157
2020-10-12;US;United States;41774;397;7813825;215554
2020-10-13;US;United States;52231;801;7866056;216355
2020-10-14;US;United States;59778;987;7925834;217342
2020-10-15;US;United States;64880;842;7990714;218184
2020-10-16;US;United States;69147;948;8059861;219132
2020-10-17;US;United States;56759;761;8116620;219893
2020-10-18;US;United States;49367;487;8165987;220380
2020-10-19;US;United States;67717;488;8233704;220868
2020-10-20;US;United States;61956;923;8295660;221791
2020-10-21;US;United States;63301;1119;8358961;222910
2020-10-22;US;United States;76310;894;8435271;223804
2020-10-23;US;United States;81933;965;8517204;224769
2020-10-24;US;United States;82767;952;8599971;225721
2020-10-25;US;United States;62204;461;8662175;226182
2020-10-26;US;United States;67310;533;8729485;226715
2020-10-27;US;United States;76838;974;8806323;227689
2020-10-28;US;United States;79426;1034;8885749;228723
2020-10-29;US;United States;91019;1004;8976768;229727
2020-10-30;US;United States;99264;1059;9076032;230786
2020-10-31;US;United States;89754;924;9165786;231710
2020-11-01;US;United States;104900;499;9270686;232209
2020-11-02;US;United States;85211;574;9355897;232783
2020-11-03;US;United States;127198;1575;9483095;234358
2020-11-04;US;United States;104541;1116;9587636;235474
2020-11-05;US;United States;129367;1159;9717003;236633
2020-11-06;US;United States;128033;1231;9845036;237864
2020-11-07;US;United States;127510;1081;9972546;238945
2020-11-08;US;United States;115170;573;10087716;239518
2020-11-09;US;United States;120434;779;10208150;240297
2020-11-10;US;United States;140504;1419;10348654;241716
2020-11-11;US;United States;146750;1434;10495404;243150
2020-11-12;US;United States;164750;1208;10660154;244358
2020-11-13;US;United States;180398;1202;10840552;245560
2020-11-14;US;United States;167926;1346;11008478;246906
2020-11-15;US;United States;136356;778;11144834;247684
2020-11-16;US;United States;162624;834;11307458;248518
2020-11-17;US;United States;163958;1719;11471416;250237
2020-11-18;US;United States;173251;1919;11644667;252156
2020-11-19;US;United States;191510;2057;11836177;254213
2020-11-20;US;United States;198333;1956;12034510;256169
2020-11-21;US;United States;179436;1621;12213946;257790
2020-11-22;US;United States;146947;1036;12360893;258826
2020-11-23;US;United States;174089;1099;12534982;259925
2020-11-24;US;United States;175544;2131;12710526;262056
2020-11-25;US;United States;183403;2259;12893929;264315
2020-11-26;US;United States;112526;1388;13006455;265703
2020-11-27;US;United States;207933;1551;13214388;267254
2020-11-28;US;United States;155661;1365;13370049;268619
2020-11-29;US;United States;140328;1039;13510377;269658
2020-11-30;US;United States;160321;1348;13670698;271006
2020-12-01;US;United States;188339;2551;13859037;273557
2020-12-02;US;United States;202894;2815;14061931;276372
2020-12-03;US;United States;223421;2944;14285352;279316
2020-12-04;US;United States;232644;2701;14517996;282017
2020-12-05;US;United States;215811;2358;14733807;284375
2020-12-06;US;United States;181253;1352;14915060;285727
2020-12-07;US;United States;194409;1609;15109469;287336
2020-12-08;US;United States;224452;2623;15333921;289959
2020-12-09;US;United States;222648;3177;15556569;293136
2020-12-10;US;United States;231428;2996;15787997;296132
2020-12-11;US;United States;240089;3410;16028086;299542
2020-12-12;US;United States;217797;2470;16245883;302012
2020-12-13;US;United States;187971;1634;16433854;303646
2020-12-14;US;United States;194314;1653;16628168;305299
2020-12-15;US;United States;208992;3115;16837160;308414
2020-12-16;US;United States;246644;3670;17083804;312084
2020-12-17;US;United States;239900;3500;17323704;315584
2020-12-18;US;United States;251832;2974;17575536;318558
2020-12-19;US;United States;192102;2654;17767638;321212
2020-12-20;US;United States;188015;1722;17955653;322934
2020-12-21;US;United States;198703;1924;18154356;324858
2020-12-22;US;United States;198107;3405;18352463;328263
2020-12-23;US;United States;229624;3432;18582087;331695
2020-12-24;US;United States;194155;2898;18776242;334593
2020-12-25;US;United States;97880;1434;18874122;336027
2020-12-26;US;United States;226416;1892;19100538;337919
2020-12-27;US;United States;155845;1436;19256383;339355
2020-12-28;US;United States;174152;2008;19430535;341363
2020-12-29;US;United States;200408;3634;19630943;344997
2020-12-30;US;United States;233701;3752;19864644;348749
2020-12-31;US;United States;235600;3462;20100244;352211
2021-01-01;US;United States;153916;2155;20254160;354366
2021-01-02;US;United States;300462;2515;20554622;356881
2021-01-03;US;United States;208853;1453;20763475;358334
2021-01-04;US;United States;184005;2093;20947480;360427
2021-01-05;US;United States;235042;3710;21182522;364137
2021-01-06;US;United States;255637;3904;21438159;368041
2021-01-07;US;United States;278337;3993;21716496;372034
2021-01-08;US;United States;295257;4110;22011753;376144
2021-01-09;US;United States;260967;3325;22272720;379469
2021-01-10;US;United States;213415;2003;22486135;381472
2021-01-11;US;United States;214664;2107;22700799;383579
2021-01-12;US;United States;226967;4476;22927766;388055
2021-01-13;US;United States;230301;4013;23158067;392068
2021-01-14;US;United States;235766;3988;23393833;396056
2021-01-15;US;United States;242780;3888;23636613;399944
2021-01-16;US;United States;201858;3423;23838471;403367
2021-01-17;US;United States;177931;1883;24016402;405250
2021-01-18;US;United States;143598;1553;24160000;406803
2021-01-19;US;United States;176216;2723;24336216;409526
2021-01-20;US;United States;183261;4406;24519477;413932
2021-01-21;US;United States;193856;4192;24713333;418124
2021-01-22;US;United States;190760;3846;24904093;421970
2021-01-23;US;United States;170759;3346;25074852;425316
2021-01-24;US;United States;131198;1892;25206050;427208
2021-01-25;US;United States;151677;1976;25357727;429184
2021-01-26;US;United States;147626;4009;25505353;433193
2021-01-27;US;United States;153961;3967;25659314;437160
2021-01-28;US;United States;168804;4007;25828118;441167
2021-01-29;US;United States;166613;3617;25994731;444784
2021-01-30;US;United States;142459;2783;26137190;447567
2021-01-31;US;United States;112152;1858;26249342;449425
2021-02-01;US;United States;134975;2071;26384317;451496
2021-02-02;US;United States;115303;3435;26499620;454931
2021-02-03;US;United States;121691;3907;26621311;458838
2021-02-04;US;United States;124006;3737;26745317;462575
2021-02-05;US;United States;134422;3666;26879739;466241
2021-02-06;US;United States;104176;2670;26983915;468911
2021-02-07;US;United States;89746;1437;27073661;470348
2021-02-08;US;United States;90438;1620;27164099;471968
2021-02-09;US;United States;95265;3073;27259364;475041
2021-02-10;US;United States;95250;3296;27354614;478337
2021-02-11;US;United States;105764;3228;27460378;481565
2021-02-12;US;United States;99670;2910;27560048;484475
2021-02-13;US;United States;87219;2187;27647267;486662
2021-02-14;US;United States;65135;1164;27712402;487826
2021-02-15;US;United States;54279;959;27766681;488785
2021-02-16;US;United States;62498;1751;27829179;490536
2021-02-17;US;United States;70139;2409;27899318;492945
2021-02-18;US;United States;69911;2529;27969229;495474
2021-02-19;US;United States;79282;2612;28048511;498086
2021-02-20;US;United States;71696;1823;28120207;499909
2021-02-21;US;United States;57152;1232;28177359;501141
2021-02-22;US;United States;56159;1325;28233518;502466
2021-02-23;US;United States;72270;2282;28305788;504748
2021-02-24;US;United States;74749;3169;28380537;507917
2021-02-25;US;United States;77504;2451;28458041;510368
2021-02-26;US;United States;77349;2067;28535390;512435
2021-02-27;US;United States;64626;1518;28600016;513953
2021-02-28;US;United States;51422;1091;28651438;515044
2021-03-01;US;United States;58098;1521;28709536;516565
2021-03-02;US;United States;57098;1957;28766634;518522
2021-03-03;US;United States;67191;2468;28833825;520990
2021-03-04;US;United States;68060;1941;28901885;522931
2021-03-05;US;United States;66419;1783;28968304;524714
2021-03-06;US;United States;58254;1506;29026558;526220
2021-03-07;US;United States;41073;699;29067631;526919
2021-03-08;US;United States;44917;738;29112548;527657
2021-03-09;US;United States;57667;1809;29170215;529466
2021-03-10;US;United States;57895;1572;29228110;531038
2021-03-11;US;United States;62471;1553;29290581;532591
2021-03-12;US;United States;61513;1565;29352094;534156
2021-03-13;US;United States;53031;1006;29405125;535162
2021-03-14;US;United States;38278;578;29443403;535740
2021-03-15;US;United States;56541;757;29499944;536497
2021-03-16;US;United States;54008;1188;29553952;537685
2021-03-17;US;United States;59280;1216;29613232;538901
2021-03-18;US;United States;60375;1660;29673607;540561
2021-03-19;US;United States;61651;1147;29735258;541708
2021-03-20;US;United States;55519;737;29790777;542445
2021-03-21;US;United States;33822;447;29824599;542892
2021-03-22;US;United States;51436;722;29876035;543614
2021-03-23;US;United States;53688;877;29929723;544491
2021-03-24;US;United States;86938;1511;30016661;546002
2021-03-25;US;United States;67546;1402;30084207;547404
2021-03-26;US;United States;77377;1151;30161584;548555
2021-03-27;US;United States;62842;791;30224426;549346
2021-03-28;US;United States;43223;525;30267649;549871
2021-03-29;US;United States;69273;710;30336922;550581
2021-03-30;US;United States;61429;885;30398351;551466
2021-03-31;US;United States;66765;1077;30465116;552543
2021-04-01;US;United States;79119;1077;30544235;553620
2021-04-02;US;United States;69887;952;30614122;554572
2021-04-03;US;United States;63261;739;30677383;555311
2021-04-04;US;United States;35133;297;30712516;555608
2021-04-05;US;United States;77404;518;30789920;556126
2021-04-06;US;United States;60674;861;30850594;556987
2021-04-07;US;United States;75021;2593;30925615;559580
2021-04-08;US;United States;79894;1025;31005509;560605
2021-04-09;US;United States;82710;896;31088219;561501
2021-04-10;US;United States;66687;712;31154906;562213
2021-04-11;US;United States;46509;305;31201415;562518
2021-04-12;US;United States;70075;479;31271490;562997
2021-04-13;US;United States;77966;835;31349456;563832
2021-04-14;US;United States;75403;955;31424859;564787
2021-04-15;US;United States;74308;905;31499167;565692
2021-04-16;US;United States;80071;869;31579238;566561
2021-04-17;US;United States;52532;697;31631770;567258
2021-04-18;US;United States;42121;337;31673891;567595
2021-04-19;US;United States;68105;504;31741996;568099
2021-04-20;US;United States;60949;842;31802945;568941
2021-04-21;US;United States;62855;860;31865800;569801
2021-04-22;US;United States;67278;966;31933078;570767
2021-04-23;US;United States;62411;784;31995489;571551
2021-04-24;US;United States;53495;748;32048984;572299
2021-04-25;US;United States;32153;293;32081137;572592
2021-04-26;US;United States;47568;494;32128705;573086
2021-04-27;US;United States;50836;654;32179541;573740
2021-04-28;US;United States;55150;968;32234691;574708
2021-04-29;US;United States;58251;873;32292942;575581
2021-04-30;US;United States;57919;753;32350861;576334
2021-05-01;US;United States;45391;715;32396252;577049
2021-05-02;US;United States;29403;337;32425655;577386
2021-05-03;US;United States;50491;504;32476146;577890
2021-05-04;US;United States;40723;875;32516869;578765
2021-05-05;US;United States;44704;794;32561573;579559
2021-05-06;US;United States;47557;799;32609130;580358
2021-05-07;US;United States;48130;759;32657260;581117
2021-05-08;US;United States;33675;629;32690935;581746
2021-05-09;US;United States;21427;249;32712362;581995
2021-05-10;US;United States;36798;414;32749160;582409
2021-05-11;US;United States;33662;686;32782822;583095
2021-05-12;US;United States;35826;768;32818648;583863
2021-05-13;US;United States;38076;766;32856724;584629
2021-05-14;US;United States;42260;655;32898984;585284
2021-05-15;US;United States;28857;496;32927841;585780
2021-05-16;US;United States;16875;278;32944716;586058
2021-05-17;US;United States;28621;400;32973337;586458
2021-05-18;US;United States;27789;770;33001126;587228
2021-05-19;US;United States;29301;675;33030427;587903
2021-05-20;US;United States;30206;682;33060633;588585
2021-05-21;US;United States;27946;615;33088579;589200
2021-05-22;US;United States;19798;495;33108377;589695
2021-05-23;US;United States;12868;197;33121245;589892
2021-05-24;US;United States;25815;446;33147060;590338
2021-05-25;US;United States;22739;632;33169799;590970
2021-05-26;US;United States;23976;981;33193775;591951
2021-05-27;US;United States;27448;1356;33221223;593307
2021-05-28;US;United States;21859;565;33243082;593872
2021-05-29;US;United States;12001;331;33255083;594203
2021-05-30;US;United States;6734;134;33261817;594337
2021-05-31;US;United States;5775;152;33267592;594489
2021-06-01;US;United States;22940;648;33290532;595137
2021-06-02;US;United States;16917;556;33307449;595693
2021-06-03;US;United States;19080;618;33326529;596311
2021-06-04;US;United States;16850;534;33343379;596845
2021-06-05;US;United States;13906;378;33357285;597223
2021-06-06;US;United States;5395;169;33362680;597392
2021-06-07;US;United States;15496;317;33378176;597709
2021-06-08;US;United States;13013;339;33391189;598048
2021-06-09;US;United States;18647;447;33409836;598495
2021-06-10;US;United States;14545;428;33424381;598923
2021-06-11;US;United States;24699;651;33449080;599574
2021-06-12;US;United States;8228;286;33457308;599860
2021-06-13;US;United States;4777;111;33462085;599971
2021-06-14;US;United States;12730;174;33474815;600145
2021-06-15;US;United States;11305;312;33486120;600457
2021-06-16;US;United States;12425;371;33498545;600828
2021-06-17;US;United States;10393;284;33508938;601112
2021-06-18;US;United States;20591;594;33529529;601706
2021-06-19;US;United States;8520;173;33538049;601879
2021-06-20;US;United States;3892;88;33541941;601967
2021-06-21;US;United States;12334;268;33554275;602235
2021-06-22;US;United States;10940;323;33565215;602558
2021-06-23;US;United States;12436;375;33577651;602933
2021-06-24;US;United States;12830;341;33590481;603274
2021-06-25;US;United States;23715;498;33614196;603772
2021-06-26;US;United States;7303;147;33621499;603919
2021-06-27;US;United States;3920;74;33625419;603993
2021-06-28;US;United States;15083;150;33640502;604143
2021-06-29;US;United States;11596;331;33652098;604474
2021-06-30;US;United States;12872;240;33664970;604714
2021-07-01;US;United States;14463;305;33679433;605019
2020-03-13;UY;Uruguay;4;0;4;0
2020-03-14;UY;Uruguay;2;0;6;0
2020-03-15;UY;Uruguay;2;0;8;0
2020-03-16;UY;Uruguay;21;0;29;0
2020-03-17;UY;Uruguay;21;0;50;0
2020-03-18;UY;Uruguay;29;0;79;0
2020-03-19;UY;Uruguay;15;0;94;0
2020-03-20;UY;Uruguay;16;0;110;0
2020-03-21;UY;Uruguay;25;0;135;0
2020-03-22;UY;Uruguay;23;0;158;0
2020-03-23;UY;Uruguay;4;0;162;0
2020-03-24;UY;Uruguay;27;0;189;0
2020-03-25;UY;Uruguay;28;0;217;0
2020-03-26;UY;Uruguay;21;0;238;0
2020-03-27;UY;Uruguay;36;0;274;0
2020-03-28;UY;Uruguay;29;1;303;1
2020-03-29;UY;Uruguay;6;0;309;1
2020-03-30;UY;Uruguay;11;0;320;1
2020-03-31;UY;Uruguay;18;0;338;1
2020-04-01;UY;Uruguay;12;1;350;2
2020-04-02;UY;Uruguay;19;2;369;4
2020-04-03;UY;Uruguay;17;0;386;4
2020-04-04;UY;Uruguay;14;1;400;5
2020-04-05;UY;Uruguay;6;1;406;6
2020-04-06;UY;Uruguay;9;0;415;6
2020-04-07;UY;Uruguay;9;1;424;7
2020-04-08;UY;Uruguay;32;0;456;7
2020-04-09;UY;Uruguay;17;0;473;7
2020-04-10;UY;Uruguay;21;0;494;7
2020-04-11;UY;Uruguay;7;0;501;7
2020-04-12;UY;Uruguay;-21;0;480;7
2020-04-13;UY;Uruguay;3;1;483;8
2020-04-14;UY;Uruguay;9;0;492;8
2020-04-15;UY;Uruguay;1;1;493;9
2020-04-16;UY;Uruguay;9;0;502;9
2020-04-17;UY;Uruguay;6;0;508;9
2020-04-18;UY;Uruguay;9;0;517;9
2020-04-19;UY;Uruguay;11;1;528;10
2020-04-20;UY;Uruguay;7;0;535;10
2020-04-21;UY;Uruguay;8;2;543;12
2020-04-22;UY;Uruguay;6;0;549;12
2020-04-23;UY;Uruguay;8;0;557;12
2020-04-24;UY;Uruguay;6;0;563;12
2020-04-25;UY;Uruguay;33;2;596;14
2020-04-26;UY;Uruguay;10;1;606;15
2020-04-27;UY;Uruguay;14;0;620;15
2020-04-28;UY;Uruguay;5;0;625;15
2020-04-29;UY;Uruguay;5;0;630;15
2020-04-30;UY;Uruguay;13;2;643;17
2020-05-01;UY;Uruguay;5;0;648;17
2020-05-02;UY;Uruguay;4;0;652;17
2020-05-03;UY;Uruguay;3;0;655;17
2020-05-04;UY;Uruguay;2;0;657;17
2020-05-05;UY;Uruguay;13;0;670;17
2020-05-06;UY;Uruguay;3;0;673;17
2020-05-07;UY;Uruguay;11;0;684;17
2020-05-08;UY;Uruguay;10;1;694;18
2020-05-09;UY;Uruguay;8;0;702;18
2020-05-10;UY;Uruguay;5;1;707;19
2020-05-11;UY;Uruguay;4;0;711;19
2020-05-12;UY;Uruguay;6;0;717;19
2020-05-13;UY;Uruguay;2;0;719;19
2020-05-14;UY;Uruguay;5;0;724;19
2020-05-15;UY;Uruguay;8;0;732;19
2020-05-16;UY;Uruguay;1;0;733;19
2020-05-17;UY;Uruguay;1;1;734;20
2020-05-18;UY;Uruguay;3;0;737;20
2020-05-19;UY;Uruguay;1;0;738;20
2020-05-20;UY;Uruguay;8;0;746;20
2020-05-21;UY;Uruguay;3;0;749;20
2020-05-22;UY;Uruguay;4;0;753;20
2020-05-23;UY;Uruguay;11;2;764;22
2020-05-24;UY;Uruguay;5;0;769;22
2020-05-25;UY;Uruguay;18;0;787;22
2020-05-26;UY;Uruguay;2;0;789;22
2020-05-27;UY;Uruguay;14;0;803;22
2020-05-28;UY;Uruguay;8;0;811;22
2020-05-29;UY;Uruguay;5;0;816;22
2020-05-30;UY;Uruguay;5;0;821;22
2020-05-31;UY;Uruguay;2;0;823;22
2020-06-01;UY;Uruguay;2;1;825;23
2020-06-02;UY;Uruguay;1;0;826;23
2020-06-03;UY;Uruguay;2;0;828;23
2020-06-04;UY;Uruguay;4;0;832;23
2020-06-05;UY;Uruguay;2;0;834;23
2020-06-06;UY;Uruguay;11;0;845;23
2020-06-07;UY;Uruguay;0;0;845;23
2020-06-08;UY;Uruguay;0;0;845;23
2020-06-09;UY;Uruguay;1;0;846;23
2020-06-10;UY;Uruguay;1;0;847;23
2020-06-11;UY;Uruguay;0;0;847;23
2020-06-12;UY;Uruguay;0;0;847;23
2020-06-13;UY;Uruguay;0;0;847;23
2020-06-14;UY;Uruguay;1;0;848;23
2020-06-15;UY;Uruguay;0;0;848;23
2020-06-16;UY;Uruguay;1;1;849;24
2020-06-17;UY;Uruguay;0;0;849;24
2020-06-18;UY;Uruguay;1;0;850;24
2020-06-19;UY;Uruguay;3;0;853;24
2020-06-20;UY;Uruguay;6;1;859;25
2020-06-21;UY;Uruguay;17;0;876;25
2020-06-22;UY;Uruguay;6;0;882;25
2020-06-23;UY;Uruguay;3;0;885;25
2020-06-24;UY;Uruguay;17;1;902;26
2020-06-25;UY;Uruguay;5;0;907;26
2020-06-26;UY;Uruguay;12;0;919;26
2020-06-27;UY;Uruguay;5;0;924;26
2020-06-28;UY;Uruguay;5;1;929;27
2020-06-29;UY;Uruguay;3;0;932;27
2020-06-30;UY;Uruguay;4;0;936;27
2020-07-01;UY;Uruguay;7;1;943;28
2020-07-02;UY;Uruguay;4;0;947;28
2020-07-03;UY;Uruguay;5;0;952;28
2020-07-04;UY;Uruguay;3;0;955;28
2020-07-05;UY;Uruguay;1;0;956;28
2020-07-06;UY;Uruguay;4;1;960;29
2020-07-07;UY;Uruguay;5;0;965;29
2020-07-08;UY;Uruguay;9;0;974;29
2020-07-09;UY;Uruguay;3;0;977;29
2020-07-10;UY;Uruguay;8;0;985;29
2020-07-11;UY;Uruguay;1;1;986;30
2020-07-12;UY;Uruguay;1;1;987;31
2020-07-13;UY;Uruguay;2;0;989;31
2020-07-14;UY;Uruguay;8;0;997;31
2020-07-15;UY;Uruguay;12;0;1009;31
2020-07-16;UY;Uruguay;17;1;1026;32
2020-07-17;UY;Uruguay;11;0;1037;32
2020-07-18;UY;Uruguay;7;1;1044;33
2020-07-19;UY;Uruguay;10;0;1054;33
2020-07-20;UY;Uruguay;10;0;1064;33
2020-07-21;UY;Uruguay;32;0;1096;33
2020-07-22;UY;Uruguay;21;1;1117;34
2020-07-23;UY;Uruguay;24;0;1141;34
2020-07-24;UY;Uruguay;25;0;1166;34
2020-07-25;UY;Uruguay;8;0;1174;34
2020-07-26;UY;Uruguay;18;0;1192;34
2020-07-27;UY;Uruguay;10;1;1202;35
2020-07-28;UY;Uruguay;16;0;1218;35
2020-07-29;UY;Uruguay;19;0;1237;35
2020-07-30;UY;Uruguay;6;0;1243;35
2020-07-31;UY;Uruguay;21;0;1264;35
2020-08-01;UY;Uruguay;14;0;1278;35
2020-08-02;UY;Uruguay;8;1;1286;36
2020-08-03;UY;Uruguay;5;0;1291;36
2020-08-04;UY;Uruguay;9;1;1300;37
2020-08-05;UY;Uruguay;9;0;1309;37
2020-08-06;UY;Uruguay;9;0;1318;37
2020-08-07;UY;Uruguay;7;0;1325;37
2020-08-08;UY;Uruguay;10;0;1335;37
2020-08-09;UY;Uruguay;18;0;1353;37
2020-08-10;UY;Uruguay;11;0;1364;37
2020-08-11;UY;Uruguay;21;0;1385;37
2020-08-12;UY;Uruguay;8;0;1393;37
2020-08-13;UY;Uruguay;16;0;1409;37
2020-08-14;UY;Uruguay;12;1;1421;38
2020-08-15;UY;Uruguay;13;0;1434;38
2020-08-16;UY;Uruguay;6;0;1440;38
2020-08-17;UY;Uruguay;17;2;1457;40
2020-08-18;UY;Uruguay;28;0;1485;40
2020-08-19;UY;Uruguay;8;0;1493;40
2020-08-20;UY;Uruguay;13;1;1506;41
2020-08-21;UY;Uruguay;10;1;1516;42
2020-08-22;UY;Uruguay;5;0;1521;42
2020-08-23;UY;Uruguay;6;0;1527;42
2020-08-24;UY;Uruguay;6;0;1533;42
2020-08-25;UY;Uruguay;3;1;1536;43
2020-08-26;UY;Uruguay;7;0;1543;43
2020-08-27;UY;Uruguay;8;0;1551;43
2020-08-28;UY;Uruguay;5;0;1556;43
2020-08-29;UY;Uruguay;14;1;1570;44
2020-08-30;UY;Uruguay;15;0;1585;44
2020-08-31;UY;Uruguay;10;0;1595;44
2020-09-01;UY;Uruguay;16;0;1611;44
2020-09-02;UY;Uruguay;15;0;1626;44
2020-09-03;UY;Uruguay;10;0;1636;44
2020-09-04;UY;Uruguay;17;1;1653;45
2020-09-05;UY;Uruguay;16;0;1669;45
2020-09-06;UY;Uruguay;10;0;1679;45
2020-09-07;UY;Uruguay;14;0;1693;45
2020-09-08;UY;Uruguay;19;0;1712;45
2020-09-09;UY;Uruguay;29;0;1741;45
2020-09-10;UY;Uruguay;18;0;1759;45
2020-09-11;UY;Uruguay;14;0;1773;45
2020-09-12;UY;Uruguay;7;0;1780;45
2020-09-13;UY;Uruguay;28;0;1808;45
2020-09-14;UY;Uruguay;4;0;1812;45
2020-09-15;UY;Uruguay;15;0;1827;45
2020-09-16;UY;Uruguay;29;0;1856;45
2020-09-17;UY;Uruguay;20;1;1876;46
2020-09-18;UY;Uruguay;14;0;1890;46
2020-09-19;UY;Uruguay;14;0;1904;46
2020-09-20;UY;Uruguay;13;0;1917;46
2020-09-21;UY;Uruguay;10;0;1927;46
2020-09-22;UY;Uruguay;7;0;1934;46
2020-09-23;UY;Uruguay;12;1;1946;47
2020-09-24;UY;Uruguay;13;0;1959;47
2020-09-25;UY;Uruguay;8;0;1967;47
2020-09-26;UY;Uruguay;31;0;1998;47
2020-09-27;UY;Uruguay;10;0;2008;47
2020-09-28;UY;Uruguay;2;0;2010;47
2020-09-29;UY;Uruguay;23;1;2033;48
2020-09-30;UY;Uruguay;13;0;2046;48
2020-10-01;UY;Uruguay;15;0;2061;48
2020-10-02;UY;Uruguay;36;0;2097;48
2020-10-03;UY;Uruguay;25;0;2122;48
2020-10-04;UY;Uruguay;23;0;2145;48
2020-10-05;UY;Uruguay;10;0;2155;48
2020-10-06;UY;Uruguay;22;1;2177;49
2020-10-07;UY;Uruguay;29;0;2206;49
2020-10-08;UY;Uruguay;20;0;2226;49
2020-10-09;UY;Uruguay;25;0;2251;49
2020-10-10;UY;Uruguay;17;1;2268;50
2020-10-11;UY;Uruguay;26;0;2294;50
2020-10-12;UY;Uruguay;19;1;2313;51
2020-10-13;UY;Uruguay;24;0;2337;51
2020-10-14;UY;Uruguay;51;0;2388;51
2020-10-15;UY;Uruguay;29;0;2417;51
2020-10-16;UY;Uruguay;33;0;2450;51
2020-10-17;UY;Uruguay;51;0;2501;51
2020-10-18;UY;Uruguay;30;0;2531;51
2020-10-19;UY;Uruguay;29;0;2560;51
2020-10-20;UY;Uruguay;63;1;2623;52
2020-10-21;UY;Uruguay;40;1;2663;53
2020-10-22;UY;Uruguay;38;0;2701;53
2020-10-23;UY;Uruguay;58;0;2759;53
2020-10-24;UY;Uruguay;48;0;2807;53
2020-10-25;UY;Uruguay;44;0;2851;53
2020-10-26;UY;Uruguay;21;1;2872;54
2020-10-27;UY;Uruguay;44;0;2916;54
2020-10-28;UY;Uruguay;65;1;2981;55
2020-10-29;UY;Uruguay;63;2;3044;57
2020-10-30;UY;Uruguay;38;1;3082;58
2020-10-31;UY;Uruguay;42;0;3124;58
2020-11-01;UY;Uruguay;25;1;3149;59
2020-11-02;UY;Uruguay;16;1;3165;60
2020-11-03;UY;Uruguay;31;1;3196;61
2020-11-04;UY;Uruguay;49;0;3245;61
2020-11-05;UY;Uruguay;64;0;3309;61
2020-11-06;UY;Uruguay;61;0;3370;61
2020-11-07;UY;Uruguay;71;0;3441;61
2020-11-08;UY;Uruguay;73;1;3514;62
2020-11-09;UY;Uruguay;46;0;3560;62
2020-11-10;UY;Uruguay;60;0;3620;62
2020-11-11;UY;Uruguay;80;1;3700;63
2020-11-12;UY;Uruguay;95;0;3795;63
2020-11-13;UY;Uruguay;88;1;3883;64
2020-11-14;UY;Uruguay;74;0;3957;64
2020-11-15;UY;Uruguay;73;1;4030;65
2020-11-16;UY;Uruguay;74;2;4104;67
2020-11-17;UY;Uruguay;104;1;4208;68
2020-11-18;UY;Uruguay;88;0;4296;68
2020-11-19;UY;Uruguay;81;1;4377;69
2020-11-20;UY;Uruguay;100;0;4477;69
2020-11-21;UY;Uruguay;87;0;4564;69
2020-11-22;UY;Uruguay;135;2;4699;71
2020-11-23;UY;Uruguay;64;0;4763;71
2020-11-24;UY;Uruguay;107;1;4870;72
2020-11-25;UY;Uruguay;118;1;4988;73
2020-11-26;UY;Uruguay;129;1;5117;74
2020-11-27;UY;Uruguay;186;0;5303;74
2020-11-28;UY;Uruguay;208;1;5511;75
2020-11-29;UY;Uruguay;205;1;5716;76
2020-11-30;UY;Uruguay;141;1;5857;77
2020-12-01;UY;Uruguay;167;1;6024;78
2020-12-02;UY;Uruguay;201;2;6225;80
2020-12-03;UY;Uruguay;230;0;6455;80
2020-12-04;UY;Uruguay;276;0;6731;80
2020-12-05;UY;Uruguay;234;1;6965;81
2020-12-06;UY;Uruguay;338;1;7303;82
2020-12-07;UY;Uruguay;202;1;7505;83
2020-12-08;UY;Uruguay;301;3;7806;86
2020-12-09;UY;Uruguay;298;1;8104;87
2020-12-10;UY;Uruguay;383;3;8487;90
2020-12-11;UY;Uruguay;362;0;8849;90
2020-12-12;UY;Uruguay;331;1;9180;91
2020-12-13;UY;Uruguay;528;1;9708;92
2020-12-14;UY;Uruguay;321;3;10029;95
2020-12-15;UY;Uruguay;389;3;10418;98
2020-12-16;UY;Uruguay;475;4;10893;102
2020-12-17;UY;Uruguay;543;3;11436;105
2020-12-18;UY;Uruguay;514;4;11950;109
2020-12-19;UY;Uruguay;607;5;12557;114
2020-12-20;UY;Uruguay;491;5;13048;119
2020-12-21;UY;Uruguay;429;0;13477;119
2020-12-22;UY;Uruguay;524;1;14001;120
2020-12-23;UY;Uruguay;709;8;14710;128
2020-12-24;UY;Uruguay;747;7;15457;135
2020-12-25;UY;Uruguay;391;8;15848;143
2020-12-26;UY;Uruguay;370;4;16218;147
2020-12-27;UY;Uruguay;510;11;16728;158
2020-12-28;UY;Uruguay;578;2;17306;160
2020-12-29;UY;Uruguay;656;8;17962;168
2020-12-30;UY;Uruguay;518;6;18480;174
2020-12-31;UY;Uruguay;639;7;19119;181
2021-01-01;UY;Uruguay;634;12;19753;193
2021-01-02;UY;Uruguay;522;8;20275;201
2021-01-03;UY;Uruguay;548;3;20823;204
2021-01-04;UY;Uruguay;603;7;21426;211
2021-01-05;UY;Uruguay;678;6;22104;217
2021-01-06;UY;Uruguay;944;4;23048;221
2021-01-07;UY;Uruguay;759;10;23807;231
2021-01-08;UY;Uruguay;532;9;24339;240
2021-01-09;UY;Uruguay;635;8;24974;248
2021-01-10;UY;Uruguay;1212;8;26186;256
2021-01-11;UY;Uruguay;715;6;26901;262
2021-01-12;UY;Uruguay;945;7;27846;269
2021-01-13;UY;Uruguay;629;6;28475;275
2021-01-14;UY;Uruguay;1514;5;29989;280
2021-01-15;UY;Uruguay;957;11;30946;291
2021-01-16;UY;Uruguay;723;7;31669;298
2021-01-17;UY;Uruguay;709;13;32378;311
2021-01-18;UY;Uruguay;485;8;32863;319
2021-01-19;UY;Uruguay;583;11;33446;330
2021-01-20;UY;Uruguay;848;6;34294;336
2021-01-21;UY;Uruguay;698;11;34992;347
2021-01-22;UY;Uruguay;1178;17;36170;364
2021-01-23;UY;Uruguay;797;3;36967;367
2021-01-24;UY;Uruguay;666;9;37633;376
2021-01-25;UY;Uruguay;408;14;38041;390
2021-01-26;UY;Uruguay;639;11;38680;401
2021-01-27;UY;Uruguay;648;6;39328;407
2021-01-28;UY;Uruguay;559;8;39887;415
2021-01-29;UY;Uruguay;642;10;40529;425
2021-01-30;UY;Uruguay;652;6;41181;431
2021-01-31;UY;Uruguay;557;5;41738;436
2021-02-01;UY;Uruguay;390;8;42128;444
2021-02-02;UY;Uruguay;539;9;42667;453
2021-02-03;UY;Uruguay;548;11;43215;464
2021-02-04;UY;Uruguay;589;12;43804;476
2021-02-05;UY;Uruguay;499;2;44303;478
2021-02-06;UY;Uruguay;509;3;44812;481
2021-02-07;UY;Uruguay;499;9;45311;490
2021-02-08;UY;Uruguay;339;7;45650;497
2021-02-09;UY;Uruguay;503;9;46153;506
2021-02-10;UY;Uruguay;625;10;46778;516
2021-02-11;UY;Uruguay;476;8;47254;524
2021-02-12;UY;Uruguay;574;3;47828;527
2021-02-13;UY;Uruguay;631;6;48459;533
2021-02-14;UY;Uruguay;450;2;48909;535
2021-02-15;UY;Uruguay;451;6;49360;541
2021-02-16;UY;Uruguay;365;5;49725;546
2021-02-17;UY;Uruguay;483;7;50208;553
2021-02-18;UY;Uruguay;544;5;50752;558
2021-02-19;UY;Uruguay;625;5;51377;563
2021-02-20;UY;Uruguay;786;6;52163;569
2021-02-21;UY;Uruguay;652;5;52815;574
2021-02-22;UY;Uruguay;495;9;53310;583
2021-02-23;UY;Uruguay;663;5;53973;588
2021-02-24;UY;Uruguay;901;3;54874;591
2021-02-25;UY;Uruguay;821;4;55695;595
2021-02-26;UY;Uruguay;847;6;56542;601
2021-02-27;UY;Uruguay;820;2;57362;603
2021-02-28;UY;Uruguay;632;5;57994;608
2021-03-01;UY;Uruguay;595;3;58589;611
2021-03-02;UY;Uruguay;582;6;59171;617
2021-03-03;UY;Uruguay;903;7;60074;624
2021-03-04;UY;Uruguay;871;7;60945;631
2021-03-05;UY;Uruguay;984;6;61929;637
2021-03-06;UY;Uruguay;1081;8;63010;645
2021-03-07;UY;Uruguay;827;6;63837;651
2021-03-08;UY;Uruguay;863;7;64700;658
2021-03-09;UY;Uruguay;827;8;65527;666
2021-03-10;UY;Uruguay;957;12;66484;678
2021-03-11;UY;Uruguay;1233;5;67717;683
2021-03-12;UY;Uruguay;1357;6;69074;689
2021-03-13;UY;Uruguay;1059;9;70133;698
2021-03-14;UY;Uruguay;1558;14;71691;712
2021-03-15;UY;Uruguay;1171;5;72862;717
2021-03-16;UY;Uruguay;908;8;73770;725
2021-03-17;UY;Uruguay;1368;15;75138;740
2021-03-18;UY;Uruguay;1678;9;76816;749
2021-03-19;UY;Uruguay;1585;11;78401;760
2021-03-20;UY;Uruguay;1522;16;79923;776
2021-03-21;UY;Uruguay;1614;16;81537;792
2021-03-22;UY;Uruguay;2693;19;84230;811
2021-03-23;UY;Uruguay;1777;16;86007;827
2021-03-24;UY;Uruguay;1805;16;87812;843
2021-03-25;UY;Uruguay;1646;13;89458;856
2021-03-26;UY;Uruguay;2885;19;92343;875
2021-03-27;UY;Uruguay;2935;26;95278;901
2021-03-28;UY;Uruguay;2128;14;97406;915
2021-03-29;UY;Uruguay;2178;13;99584;928
2021-03-30;UY;Uruguay;2877;25;102461;953
2021-03-31;UY;Uruguay;3088;21;105549;974
2021-04-01;UY;Uruguay;2639;35;108188;1009
2021-04-02;UY;Uruguay;3380;32;111568;1041
2021-04-03;UY;Uruguay;2336;30;113904;1071
2021-04-04;UY;Uruguay;3853;30;117757;1101
2021-04-05;UY;Uruguay;2201;45;119958;1146
2021-04-06;UY;Uruguay;3105;45;123063;1191
2021-04-07;UY;Uruguay;3924;40;126987;1231
2021-04-08;UY;Uruguay;3670;44;130657;1275
2021-04-09;UY;Uruguay;7289;88;137946;1363
2021-04-10;UY;Uruguay;3434;51;141380;1414
2021-04-11;UY;Uruguay;3262;48;144642;1462
2021-04-12;UY;Uruguay;2531;71;147173;1533
2021-04-13;UY;Uruguay;2257;62;149430;1595
2021-04-14;UY;Uruguay;2659;52;152089;1647
2021-04-15;UY;Uruguay;4410;79;156499;1726
2021-04-16;UY;Uruguay;3070;62;159569;1788
2021-04-17;UY;Uruguay;2831;60;162400;1848
2021-04-18;UY;Uruguay;2344;60;164744;1908
2021-04-19;UY;Uruguay;2289;63;167033;1971
2021-04-20;UY;Uruguay;2294;51;169327;2022
2021-04-21;UY;Uruguay;3274;61;172601;2083
2021-04-22;UY;Uruguay;3290;77;175891;2160
2021-04-23;UY;Uruguay;3646;67;179537;2227
2021-04-24;UY;Uruguay;2789;56;182326;2283
2021-04-25;UY;Uruguay;2539;43;184865;2326
2021-04-26;UY;Uruguay;2484;65;187349;2391
2021-04-27;UY;Uruguay;2747;61;190096;2452
2021-04-28;UY;Uruguay;2931;45;193027;2497
2021-04-29;UY;Uruguay;2707;66;195734;2563
2021-04-30;UY;Uruguay;2694;53;198428;2616
2021-05-01;UY;Uruguay;2480;53;200908;2669
2021-05-02;UY;Uruguay;1584;55;202492;2724
2021-05-03;UY;Uruguay;1628;72;204120;2796
2021-05-04;UY;Uruguay;2826;65;206946;2861
2021-05-05;UY;Uruguay;2921;57;209867;2918
2021-05-06;UY;Uruguay;3582;54;213449;2972
2021-05-07;UY;Uruguay;2697;60;216146;3032
2021-05-08;UY;Uruguay;2654;50;218800;3082
2021-05-09;UY;Uruguay;1883;40;220683;3122
2021-05-10;UY;Uruguay;2187;49;222870;3171
2021-05-11;UY;Uruguay;2977;37;225847;3208
2021-05-12;UY;Uruguay;2255;44;228102;3252
2021-05-13;UY;Uruguay;3799;66;231901;3318
2021-05-14;UY;Uruguay;3305;51;235206;3369
2021-05-15;UY;Uruguay;2873;50;238079;3419
2021-05-16;UY;Uruguay;2433;40;240512;3459
2021-05-17;UY;Uruguay;2394;62;242906;3521
2021-05-18;UY;Uruguay;3120;57;246026;3578
2021-05-19;UY;Uruguay;3339;60;249365;3638
2021-05-20;UY;Uruguay;4576;53;253941;3691
2021-05-21;UY;Uruguay;4599;69;258540;3760
2021-05-22;UY;Uruguay;3469;51;262009;3811
2021-05-23;UY;Uruguay;3089;60;265098;3871
2021-05-24;UY;Uruguay;2790;51;267888;3922
2021-05-25;UY;Uruguay;3971;51;271859;3973
2021-05-26;UY;Uruguay;4576;49;276435;4022
2021-05-27;UY;Uruguay;3937;44;280372;4066
2021-05-28;UY;Uruguay;1826;52;282198;4118
2021-05-29;UY;Uruguay;5974;58;288172;4176
2021-05-30;UY;Uruguay;3316;37;291488;4213
2021-05-31;UY;Uruguay;3015;63;294503;4276
2021-06-01;UY;Uruguay;3503;66;298006;4342
2021-06-02;UY;Uruguay;3518;52;301524;4394
2021-06-03;UY;Uruguay;2887;66;304411;4460
2021-06-04;UY;Uruguay;4079;56;308490;4516
2021-06-05;UY;Uruguay;4213;67;312703;4583
2021-06-06;UY;Uruguay;3832;57;316535;4640
2021-06-07;UY;Uruguay;2248;52;318783;4692
2021-06-08;UY;Uruguay;4195;57;322978;4749
2021-06-09;UY;Uruguay;3427;67;326405;4816
2021-06-10;UY;Uruguay;3622;46;330027;4862
2021-06-11;UY;Uruguay;3457;44;333484;4906
2021-06-12;UY;Uruguay;2986;50;336470;4956
2021-06-13;UY;Uruguay;2043;39;338513;4995
2021-06-14;UY;Uruguay;2305;41;340818;5036
2021-06-15;UY;Uruguay;2797;53;343615;5089
2021-06-16;UY;Uruguay;2900;31;346515;5120
2021-06-17;UY;Uruguay;2147;32;348662;5152
2021-06-18;UY;Uruguay;2716;55;351378;5207
2021-06-19;UY;Uruguay;1999;34;353377;5241
2021-06-20;UY;Uruguay;1488;30;354865;5271
2021-06-21;UY;Uruguay;1517;45;356382;5316
2021-06-22;UY;Uruguay;2079;34;358461;5350
2021-06-23;UY;Uruguay;1786;24;360247;5374
2021-06-24;UY;Uruguay;1747;39;361994;5413
2021-06-25;UY;Uruguay;1586;34;363580;5447
2021-06-26;UY;Uruguay;1279;27;364859;5474
2021-06-27;UY;Uruguay;1007;20;365866;5494
2021-06-28;UY;Uruguay;1049;30;366915;5524
2021-06-29;UY;Uruguay;1263;34;368178;5558
2021-06-30;UY;Uruguay;1172;35;369350;5593
2021-07-01;UY;Uruguay;1250;26;370600;5619
2020-03-15;UZ;Uzbekistan;1;0;1;0
2020-03-16;UZ;Uzbekistan;5;0;6;0
2020-03-17;UZ;Uzbekistan;4;0;10;0
2020-03-18;UZ;Uzbekistan;5;0;15;0
2020-03-19;UZ;Uzbekistan;8;0;23;0
2020-03-20;UZ;Uzbekistan;10;0;33;0
2020-03-21;UZ;Uzbekistan;10;0;43;0
2020-03-22;UZ;Uzbekistan;0;0;43;0
2020-03-23;UZ;Uzbekistan;3;0;46;0
2020-03-24;UZ;Uzbekistan;4;0;50;0
2020-03-25;UZ;Uzbekistan;10;0;60;0
2020-03-26;UZ;Uzbekistan;15;0;75;0
2020-03-27;UZ;Uzbekistan;13;1;88;1
2020-03-28;UZ;Uzbekistan;16;1;104;2
2020-03-29;UZ;Uzbekistan;40;0;144;2
2020-03-30;UZ;Uzbekistan;5;0;149;2
2020-03-31;UZ;Uzbekistan;23;0;172;2
2020-04-01;UZ;Uzbekistan;9;0;181;2
2020-04-02;UZ;Uzbekistan;24;0;205;2
2020-04-03;UZ;Uzbekistan;22;0;227;2
2020-04-04;UZ;Uzbekistan;39;0;266;2
2020-04-05;UZ;Uzbekistan;76;0;342;2
2020-04-06;UZ;Uzbekistan;115;0;457;2
2020-04-07;UZ;Uzbekistan;63;0;520;2
2020-04-08;UZ;Uzbekistan;25;1;545;3
2020-04-09;UZ;Uzbekistan;37;0;582;3
2020-04-10;UZ;Uzbekistan;42;0;624;3
2020-04-11;UZ;Uzbekistan;143;1;767;4
2020-04-12;UZ;Uzbekistan;98;0;865;4
2020-04-13;UZ;Uzbekistan;133;0;998;4
2020-04-14;UZ;Uzbekistan;167;0;1165;4
2020-04-15;UZ;Uzbekistan;137;0;1302;4
2020-04-16;UZ;Uzbekistan;47;0;1349;4
2020-04-17;UZ;Uzbekistan;56;0;1405;4
2020-04-18;UZ;Uzbekistan;85;1;1490;5
2020-04-19;UZ;Uzbekistan;75;0;1565;5
2020-04-20;UZ;Uzbekistan;62;0;1627;5
2020-04-21;UZ;Uzbekistan;51;1;1678;6
2020-04-22;UZ;Uzbekistan;38;1;1716;7
2020-04-23;UZ;Uzbekistan;42;0;1758;7
2020-04-24;UZ;Uzbekistan;46;1;1804;8
2020-04-25;UZ;Uzbekistan;58;0;1862;8
2020-04-26;UZ;Uzbekistan;7;0;1869;8
2020-04-27;UZ;Uzbekistan;35;0;1904;8
2020-04-28;UZ;Uzbekistan;35;0;1939;8
2020-04-29;UZ;Uzbekistan;63;1;2002;9
2020-04-30;UZ;Uzbekistan;37;0;2039;9
2020-05-01;UZ;Uzbekistan;47;0;2086;9
2020-05-02;UZ;Uzbekistan;32;0;2118;9
2020-05-03;UZ;Uzbekistan;31;1;2149;10
2020-05-04;UZ;Uzbekistan;40;0;2189;10
2020-05-05;UZ;Uzbekistan;18;0;2207;10
2020-05-06;UZ;Uzbekistan;26;0;2233;10
2020-05-07;UZ;Uzbekistan;65;0;2298;10
2020-05-08;UZ;Uzbekistan;27;0;2325;10
2020-05-09;UZ;Uzbekistan;24;0;2349;10
2020-05-10;UZ;Uzbekistan;69;0;2418;10
2020-05-11;UZ;Uzbekistan;68;0;2486;10
2020-05-12;UZ;Uzbekistan;33;0;2519;10
2020-05-13;UZ;Uzbekistan;93;1;2612;11
2020-05-14;UZ;Uzbekistan;33;0;2645;11
2020-05-15;UZ;Uzbekistan;41;0;2686;11
2020-05-16;UZ;Uzbekistan;52;0;2738;11
2020-05-17;UZ;Uzbekistan;15;1;2753;12
2020-05-18;UZ;Uzbekistan;38;1;2791;13
2020-05-19;UZ;Uzbekistan;64;0;2855;13
2020-05-20;UZ;Uzbekistan;84;0;2939;13
2020-05-21;UZ;Uzbekistan;25;0;2964;13
2020-05-22;UZ;Uzbekistan;64;0;3028;13
2020-05-23;UZ;Uzbekistan;87;0;3115;13
2020-05-24;UZ;Uzbekistan;49;0;3164;13
2020-05-25;UZ;Uzbekistan;25;0;3189;13
2020-05-26;UZ;Uzbekistan;101;1;3290;14
2020-05-27;UZ;Uzbekistan;79;0;3369;14
2020-05-28;UZ;Uzbekistan;75;0;3444;14
2020-05-29;UZ;Uzbekistan;24;0;3468;14
2020-05-30;UZ;Uzbekistan;78;0;3546;14
2020-05-31;UZ;Uzbekistan;77;1;3623;15
2020-06-01;UZ;Uzbekistan;79;0;3702;15
2020-06-02;UZ;Uzbekistan;58;0;3760;15
2020-06-03;UZ;Uzbekistan;83;1;3843;16
2020-06-04;UZ;Uzbekistan;96;0;3939;16
2020-06-05;UZ;Uzbekistan;68;0;4007;16
2020-06-06;UZ;Uzbekistan;87;1;4094;17
2020-06-07;UZ;Uzbekistan;237;0;4331;17
2020-06-08;UZ;Uzbekistan;109;1;4440;18
2020-06-09;UZ;Uzbekistan;80;0;4520;18
2020-06-10;UZ;Uzbekistan;103;1;4623;19
2020-06-11;UZ;Uzbekistan;118;0;4741;19
2020-06-12;UZ;Uzbekistan;128;0;4869;19
2020-06-13;UZ;Uzbekistan;97;0;4966;19
2020-06-14;UZ;Uzbekistan;114;0;5080;19
2020-06-15;UZ;Uzbekistan;183;0;5263;19
2020-06-16;UZ;Uzbekistan;230;0;5493;19
2020-06-17;UZ;Uzbekistan;189;0;5682;19
2020-06-18;UZ;Uzbekistan;85;0;5767;19
2020-06-19;UZ;Uzbekistan;179;0;5946;19
2020-06-20;UZ;Uzbekistan;207;0;6153;19
2020-06-21;UZ;Uzbekistan;162;0;6315;19
2020-06-22;UZ;Uzbekistan;146;0;6461;19
2020-06-23;UZ;Uzbekistan;201;0;6662;19
2020-06-24;UZ;Uzbekistan;328;0;6990;19
2020-06-25;UZ;Uzbekistan;187;1;7177;20
2020-06-26;UZ;Uzbekistan;250;0;7427;20
2020-06-27;UZ;Uzbekistan;255;0;7682;20
2020-06-28;UZ;Uzbekistan;266;2;7948;22
2020-06-29;UZ;Uzbekistan;274;1;8222;23
2020-06-30;UZ;Uzbekistan;281;3;8503;26
2020-07-01;UZ;Uzbekistan;278;0;8781;26
2020-07-02;UZ;Uzbekistan;297;1;9078;27
2020-07-03;UZ;Uzbekistan;318;2;9396;29
2020-07-04;UZ;Uzbekistan;312;2;9708;31
2020-07-05;UZ;Uzbekistan;312;3;10020;34
2020-07-06;UZ;Uzbekistan;342;3;10362;37
2020-07-07;UZ;Uzbekistan;476;4;10838;41
2020-07-08;UZ;Uzbekistan;254;4;11092;45
2020-07-09;UZ;Uzbekistan;472;6;11564;51
2020-07-10;UZ;Uzbekistan;463;3;12027;54
2020-07-11;UZ;Uzbekistan;486;3;12513;57
2020-07-12;UZ;Uzbekistan;484;3;12997;60
2020-07-13;UZ;Uzbekistan;594;4;13591;64
2020-07-14;UZ;Uzbekistan;494;3;14085;67
2020-07-15;UZ;Uzbekistan;496;4;14581;71
2020-07-16;UZ;Uzbekistan;485;4;15066;75
2020-07-17;UZ;Uzbekistan;541;4;15607;79
2020-07-18;UZ;Uzbekistan;579;4;16186;83
2020-07-19;UZ;Uzbekistan;566;4;16752;87
2020-07-20;UZ;Uzbekistan;397;3;17149;90
2020-07-21;UZ;Uzbekistan;732;5;17881;95
2020-07-22;UZ;Uzbekistan;498;3;18379;98
2020-07-23;UZ;Uzbekistan;607;5;18986;103
2020-07-24;UZ;Uzbekistan;374;3;19360;106
2020-07-25;UZ;Uzbekistan;592;5;19952;111
2020-07-26;UZ;Uzbekistan;579;5;20531;116
2020-07-27;UZ;Uzbekistan;678;5;21209;121
2020-07-28;UZ;Uzbekistan;490;3;21699;124
2020-07-29;UZ;Uzbekistan;886;7;22585;131
2020-07-30;UZ;Uzbekistan;686;5;23271;136
2020-07-31;UZ;Uzbekistan;738;5;24009;141
2020-08-01;UZ;Uzbekistan;774;6;24783;147
2020-08-02;UZ;Uzbekistan;553;4;25336;151
2020-08-03;UZ;Uzbekistan;730;6;26066;157
2020-08-04;UZ;Uzbekistan;981;8;27047;165
2020-08-05;UZ;Uzbekistan;746;6;27793;171
2020-08-06;UZ;Uzbekistan;522;4;28315;175
2020-08-07;UZ;Uzbekistan;742;6;29057;181
2020-08-08;UZ;Uzbekistan;595;6;29652;187
2020-08-09;UZ;Uzbekistan;957;7;30609;194
2020-08-10;UZ;Uzbekistan;695;6;31304;200
2020-08-11;UZ;Uzbekistan;443;4;31747;204
2020-08-12;UZ;Uzbekistan;907;7;32654;211
2020-08-13;UZ;Uzbekistan;669;5;33323;216
2020-08-14;UZ;Uzbekistan;498;4;33821;220
2020-08-15;UZ;Uzbekistan;707;5;34528;225
2020-08-16;UZ;Uzbekistan;801;7;35329;232
2020-08-17;UZ;Uzbekistan;373;4;35702;236
2020-08-18;UZ;Uzbekistan;650;6;36352;242
2020-08-19;UZ;Uzbekistan;760;6;37112;248
2020-08-20;UZ;Uzbekistan;435;4;37547;252
2020-08-21;UZ;Uzbekistan;527;8;38074;260
2020-08-22;UZ;Uzbekistan;458;7;38532;267
2020-08-23;UZ;Uzbekistan;414;6;38946;273
2020-08-24;UZ;Uzbekistan;402;7;39348;280
2020-08-25;UZ;Uzbekistan;293;4;39641;284
2020-08-26;UZ;Uzbekistan;323;7;39964;291
2020-08-27;UZ;Uzbekistan;483;7;40447;298
2020-08-28;UZ;Uzbekistan;273;4;40720;302
2020-08-29;UZ;Uzbekistan;347;5;41067;307
2020-08-30;UZ;Uzbekistan;357;6;41424;313
2020-08-31;UZ;Uzbekistan;469;7;41893;320
2020-09-01;UZ;Uzbekistan;234;3;42127;323
2020-09-02;UZ;Uzbekistan;310;4;42437;327
2020-09-03;UZ;Uzbekistan;251;4;42688;331
2020-09-04;UZ;Uzbekistan;310;7;42998;338
2020-09-05;UZ;Uzbekistan;295;5;43293;343
2020-09-06;UZ;Uzbekistan;294;4;43587;347
2020-09-07;UZ;Uzbekistan;306;5;43893;352
2020-09-08;UZ;Uzbekistan;388;6;44281;358
2020-09-09;UZ;Uzbekistan;649;8;44930;366
2020-09-10;UZ;Uzbekistan;543;4;45473;370
2020-09-11;UZ;Uzbekistan;687;7;46160;377
2020-09-12;UZ;Uzbekistan;561;7;46721;384
2020-09-13;UZ;Uzbekistan;566;6;47287;390
2020-09-14;UZ;Uzbekistan;549;6;47836;396
2020-09-15;UZ;Uzbekistan;593;6;48429;402
2020-09-16;UZ;Uzbekistan;586;5;49015;407
2020-09-17;UZ;Uzbekistan;612;6;49627;413
2020-09-18;UZ;Uzbekistan;626;6;50253;419
2020-09-19;UZ;Uzbekistan;739;8;50992;427
2020-09-20;UZ;Uzbekistan;648;6;51640;433
2020-09-21;UZ;Uzbekistan;430;4;52070;437
2020-09-22;UZ;Uzbekistan;615;5;52685;442
2020-09-23;UZ;Uzbekistan;590;2;53275;444
2020-09-24;UZ;Uzbekistan;559;2;53834;446
2020-09-25;UZ;Uzbekistan;558;3;54392;449
2020-09-26;UZ;Uzbekistan;427;3;54819;452
2020-09-27;UZ;Uzbekistan;501;6;55320;458
2020-09-28;UZ;Uzbekistan;456;2;55776;460
2020-09-29;UZ;Uzbekistan;578;6;56354;466
2020-09-30;UZ;Uzbekistan;363;4;56717;470
2020-10-01;UZ;Uzbekistan;473;1;57190;471
2020-10-02;UZ;Uzbekistan;264;1;57454;472
2020-10-03;UZ;Uzbekistan;784;5;58238;477
2020-10-04;UZ;Uzbekistan;374;3;58612;480
2020-10-05;UZ;Uzbekistan;334;5;58946;485
2020-10-06;UZ;Uzbekistan;397;4;59343;489
2020-10-07;UZ;Uzbekistan;236;2;59579;491
2020-10-08;UZ;Uzbekistan;447;5;60026;496
2020-10-09;UZ;Uzbekistan;316;2;60342;498
2020-10-10;UZ;Uzbekistan;434;4;60776;502
2020-10-11;UZ;Uzbekistan;322;3;61098;505
2020-10-12;UZ;Uzbekistan;221;4;61319;509
2020-10-13;UZ;Uzbekistan;323;2;61642;511
2020-10-14;UZ;Uzbekistan;308;3;61950;514
2020-10-15;UZ;Uzbekistan;328;4;62278;518
2020-10-16;UZ;Uzbekistan;310;2;62588;520
2020-10-17;UZ;Uzbekistan;221;2;62809;522
2020-10-18;UZ;Uzbekistan;315;3;63124;525
2020-10-19;UZ;Uzbekistan;399;6;63523;531
2020-10-20;UZ;Uzbekistan;308;3;63831;534
2020-10-21;UZ;Uzbekistan;179;0;64010;534
2020-10-22;UZ;Uzbekistan;429;6;64439;540
2020-10-23;UZ;Uzbekistan;285;2;64724;542
2020-10-24;UZ;Uzbekistan;199;2;64923;544
2020-10-25;UZ;Uzbekistan;384;5;65307;549
2020-10-26;UZ;Uzbekistan;360;3;65667;552
2020-10-27;UZ;Uzbekistan;214;4;65881;556
2020-10-28;UZ;Uzbekistan;260;2;66141;558
2020-10-29;UZ;Uzbekistan;251;3;66392;561
2020-10-30;UZ;Uzbekistan;236;2;66628;563
2020-10-31;UZ;Uzbekistan;304;3;66932;566
2020-11-01;UZ;Uzbekistan;224;4;67156;570
2020-11-02;UZ;Uzbekistan;98;1;67254;571
2020-11-03;UZ;Uzbekistan;299;3;67553;574
2020-11-04;UZ;Uzbekistan;226;3;67779;577
2020-11-05;UZ;Uzbekistan;230;2;68009;579
2020-11-06;UZ;Uzbekistan;130;0;68139;579
2020-11-07;UZ;Uzbekistan;228;2;68367;581
2020-11-08;UZ;Uzbekistan;363;4;68730;585
2020-11-09;UZ;Uzbekistan;297;3;69027;588
2020-11-10;UZ;Uzbekistan;0;0;69027;588
2020-11-11;UZ;Uzbekistan;370;3;69397;591
2020-11-12;UZ;Uzbekistan;163;2;69560;593
2020-11-13;UZ;Uzbekistan;194;1;69754;594
2020-11-14;UZ;Uzbekistan;233;0;69987;594
2020-11-15;UZ;Uzbekistan;256;4;70243;598
2020-11-16;UZ;Uzbekistan;138;0;70381;598
2020-11-17;UZ;Uzbekistan;267;1;70648;599
2020-11-18;UZ;Uzbekistan;210;2;70858;601
2020-11-19;UZ;Uzbekistan;63;0;70921;601
2020-11-20;UZ;Uzbekistan;287;2;71208;603
2020-11-21;UZ;Uzbekistan;223;0;71431;603
2020-11-22;UZ;Uzbekistan;186;0;71617;603
2020-11-23;UZ;Uzbekistan;157;1;71774;604
2020-11-24;UZ;Uzbekistan;211;0;71985;604
2020-11-25;UZ;Uzbekistan;242;2;72227;606
2020-11-26;UZ;Uzbekistan;182;1;72409;607
2020-11-27;UZ;Uzbekistan;104;0;72513;607
2020-11-28;UZ;Uzbekistan;205;1;72718;608
2020-11-29;UZ;Uzbekistan;152;0;72870;608
2020-11-30;UZ;Uzbekistan;224;2;73094;610
2020-12-01;UZ;Uzbekistan;182;1;73276;611
2020-12-02;UZ;Uzbekistan;59;0;73335;611
2020-12-03;UZ;Uzbekistan;96;0;73431;611
2020-12-04;UZ;Uzbekistan;320;0;73751;611
2020-12-05;UZ;Uzbekistan;0;0;73751;611
2020-12-06;UZ;Uzbekistan;302;0;74053;611
2020-12-07;UZ;Uzbekistan;0;0;74053;611
2020-12-08;UZ;Uzbekistan;153;0;74206;611
2020-12-09;UZ;Uzbekistan;146;0;74352;611
2020-12-10;UZ;Uzbekistan;146;0;74498;611
2020-12-11;UZ;Uzbekistan;313;1;74811;612
2020-12-12;UZ;Uzbekistan;0;0;74811;612
2020-12-13;UZ;Uzbekistan;145;0;74956;612
2020-12-14;UZ;Uzbekistan;138;0;75094;612
2020-12-15;UZ;Uzbekistan;147;0;75241;612
2020-12-16;UZ;Uzbekistan;297;0;75538;612
2020-12-17;UZ;Uzbekistan;0;0;75538;612
2020-12-18;UZ;Uzbekistan;137;0;75675;612
2020-12-19;UZ;Uzbekistan;131;0;75806;612
2020-12-20;UZ;Uzbekistan;127;0;75933;612
2020-12-21;UZ;Uzbekistan;115;0;76048;612
2020-12-22;UZ;Uzbekistan;132;0;76180;612
2020-12-23;UZ;Uzbekistan;135;0;76315;612
2020-12-24;UZ;Uzbekistan;141;0;76456;612
2020-12-25;UZ;Uzbekistan;112;0;76568;612
2020-12-26;UZ;Uzbekistan;98;0;76666;612
2020-12-27;UZ;Uzbekistan;85;1;76751;613
2020-12-28;UZ;Uzbekistan;81;0;76832;613
2020-12-29;UZ;Uzbekistan;75;0;76907;613
2020-12-30;UZ;Uzbekistan;78;1;76985;614
2020-12-31;UZ;Uzbekistan;75;0;77060;614
2021-01-01;UZ;Uzbekistan;122;0;77182;614
2021-01-02;UZ;Uzbekistan;0;0;77182;614
2021-01-03;UZ;Uzbekistan;76;0;77258;614
2021-01-04;UZ;Uzbekistan;0;0;77258;614
2021-01-05;UZ;Uzbekistan;37;0;77295;614
2021-01-06;UZ;Uzbekistan;55;1;77350;615
2021-01-07;UZ;Uzbekistan;62;0;77412;615
2021-01-08;UZ;Uzbekistan;73;1;77485;616
2021-01-09;UZ;Uzbekistan;45;0;77530;616
2021-01-10;UZ;Uzbekistan;42;1;77572;617
2021-01-11;UZ;Uzbekistan;39;0;77611;617
2021-01-12;UZ;Uzbekistan;52;0;77663;617
2021-01-13;UZ;Uzbekistan;53;1;77716;618
2021-01-14;UZ;Uzbekistan;61;0;77777;618
2021-01-15;UZ;Uzbekistan;127;1;77904;619
2021-01-16;UZ;Uzbekistan;64;0;77968;619
2021-01-17;UZ;Uzbekistan;0;0;77968;619
2021-01-18;UZ;Uzbekistan;68;0;78036;619
2021-01-19;UZ;Uzbekistan;55;1;78091;620
2021-01-20;UZ;Uzbekistan;72;0;78163;620
2021-01-21;UZ;Uzbekistan;56;0;78219;620
2021-01-22;UZ;Uzbekistan;53;0;78272;620
2021-01-23;UZ;Uzbekistan;45;1;78317;621
2021-01-24;UZ;Uzbekistan;58;0;78375;621
2021-01-25;UZ;Uzbekistan;54;0;78429;621
2021-01-26;UZ;Uzbekistan;42;0;78471;621
2021-01-27;UZ;Uzbekistan;39;0;78510;621
2021-01-28;UZ;Uzbekistan;46;0;78556;621
2021-01-29;UZ;Uzbekistan;46;0;78602;621
2021-01-30;UZ;Uzbekistan;109;0;78711;621
2021-01-31;UZ;Uzbekistan;0;0;78711;621
2021-02-01;UZ;Uzbekistan;44;0;78755;621
2021-02-02;UZ;Uzbekistan;46;0;78801;621
2021-02-03;UZ;Uzbekistan;58;0;78859;621
2021-02-04;UZ;Uzbekistan;57;0;78916;621
2021-02-05;UZ;Uzbekistan;73;0;78989;621
2021-02-06;UZ;Uzbekistan;56;0;79045;621
2021-02-07;UZ;Uzbekistan;53;0;79098;621
2021-02-08;UZ;Uzbekistan;64;0;79162;621
2021-02-09;UZ;Uzbekistan;42;0;79204;621
2021-02-10;UZ;Uzbekistan;33;0;79237;621
2021-02-11;UZ;Uzbekistan;66;1;79303;622
2021-02-12;UZ;Uzbekistan;37;0;79340;622
2021-02-13;UZ;Uzbekistan;41;0;79381;622
2021-02-14;UZ;Uzbekistan;35;0;79416;622
2021-02-15;UZ;Uzbekistan;26;0;79442;622
2021-02-16;UZ;Uzbekistan;19;0;79461;622
2021-02-17;UZ;Uzbekistan;36;0;79497;622
2021-02-18;UZ;Uzbekistan;51;0;79548;622
2021-02-19;UZ;Uzbekistan;50;0;79598;622
2021-02-20;UZ;Uzbekistan;34;0;79632;622
2021-02-21;UZ;Uzbekistan;22;0;79654;622
2021-02-22;UZ;Uzbekistan;27;0;79681;622
2021-02-23;UZ;Uzbekistan;36;0;79717;622
2021-02-24;UZ;Uzbekistan;32;0;79749;622
2021-02-25;UZ;Uzbekistan;24;0;79773;622
2021-02-26;UZ;Uzbekistan;31;0;79804;622
2021-02-27;UZ;Uzbekistan;32;0;79836;622
2021-02-28;UZ;Uzbekistan;90;0;79926;622
2021-03-01;UZ;Uzbekistan;0;0;79926;622
2021-03-02;UZ;Uzbekistan;35;0;79961;622
2021-03-03;UZ;Uzbekistan;74;0;80035;622
2021-03-04;UZ;Uzbekistan;0;0;80035;622
2021-03-05;UZ;Uzbekistan;46;0;80081;622
2021-03-06;UZ;Uzbekistan;44;0;80125;622
2021-03-07;UZ;Uzbekistan;51;0;80176;622
2021-03-08;UZ;Uzbekistan;43;0;80219;622
2021-03-09;UZ;Uzbekistan;28;0;80247;622
2021-03-10;UZ;Uzbekistan;21;0;80268;622
2021-03-11;UZ;Uzbekistan;124;0;80392;622
2021-03-12;UZ;Uzbekistan;0;0;80392;622
2021-03-13;UZ;Uzbekistan;89;0;80481;622
2021-03-14;UZ;Uzbekistan;86;0;80567;622
2021-03-15;UZ;Uzbekistan;111;0;80678;622
2021-03-16;UZ;Uzbekistan;65;0;80743;622
2021-03-17;UZ;Uzbekistan;115;0;80858;622
2021-03-18;UZ;Uzbekistan;113;0;80971;622
2021-03-19;UZ;Uzbekistan;124;0;81095;622
2021-03-20;UZ;Uzbekistan;244;0;81339;622
2021-03-21;UZ;Uzbekistan;0;0;81339;622
2021-03-22;UZ;Uzbekistan;107;0;81446;622
2021-03-23;UZ;Uzbekistan;232;1;81678;623
2021-03-24;UZ;Uzbekistan;0;0;81678;623
2021-03-25;UZ;Uzbekistan;138;1;81816;624
2021-03-26;UZ;Uzbekistan;144;0;81960;624
2021-03-27;UZ;Uzbekistan;186;1;82146;625
2021-03-28;UZ;Uzbekistan;194;1;82340;626
2021-03-29;UZ;Uzbekistan;196;0;82536;626
2021-03-30;UZ;Uzbekistan;146;2;82682;628
2021-03-31;UZ;Uzbekistan;187;1;82869;629
2021-04-01;UZ;Uzbekistan;181;1;83050;630
2021-04-02;UZ;Uzbekistan;189;0;83239;630
2021-04-03;UZ;Uzbekistan;196;0;83435;630
2021-04-04;UZ;Uzbekistan;188;1;83623;631
2021-04-05;UZ;Uzbekistan;179;0;83802;631
2021-04-06;UZ;Uzbekistan;133;1;83935;632
2021-04-07;UZ;Uzbekistan;192;1;84127;633
2021-04-08;UZ;Uzbekistan;195;1;84322;634
2021-04-09;UZ;Uzbekistan;207;0;84529;634
2021-04-10;UZ;Uzbekistan;195;0;84724;634
2021-04-11;UZ;Uzbekistan;198;0;84922;634
2021-04-12;UZ;Uzbekistan;192;0;85114;634
2021-04-13;UZ;Uzbekistan;177;0;85291;634
2021-04-14;UZ;Uzbekistan;212;0;85503;634
2021-04-15;UZ;Uzbekistan;227;0;85730;634
2021-04-16;UZ;Uzbekistan;292;1;86022;635
2021-04-17;UZ;Uzbekistan;316;1;86338;636
2021-04-18;UZ;Uzbekistan;342;2;86680;638
2021-04-19;UZ;Uzbekistan;302;0;86982;638
2021-04-20;UZ;Uzbekistan;243;1;87225;639
2021-04-21;UZ;Uzbekistan;326;1;87551;640
2021-04-22;UZ;Uzbekistan;384;0;87935;640
2021-04-23;UZ;Uzbekistan;345;1;88280;641
2021-04-24;UZ;Uzbekistan;399;1;88679;642
2021-04-25;UZ;Uzbekistan;348;1;89027;643
2021-04-26;UZ;Uzbekistan;328;2;89355;645
2021-04-27;UZ;Uzbekistan;275;1;89630;646
2021-04-28;UZ;Uzbekistan;378;0;90008;646
2021-04-29;UZ;Uzbekistan;398;1;90406;647
2021-04-30;UZ;Uzbekistan;402;2;90808;649
2021-05-01;UZ;Uzbekistan;442;1;91250;650
2021-05-02;UZ;Uzbekistan;393;2;91643;652
2021-05-03;UZ;Uzbekistan;363;1;92006;653
2021-05-04;UZ;Uzbekistan;314;2;92320;655
2021-05-05;UZ;Uzbekistan;404;0;92724;655
2021-05-06;UZ;Uzbekistan;452;2;93176;657
2021-05-07;UZ;Uzbekistan;421;3;93597;660
2021-05-08;UZ;Uzbekistan;381;2;93978;662
2021-05-09;UZ;Uzbekistan;419;0;94397;662
2021-05-10;UZ;Uzbekistan;362;0;94759;662
2021-05-11;UZ;Uzbekistan;313;2;95072;664
2021-05-12;UZ;Uzbekistan;395;2;95467;666
2021-05-13;UZ;Uzbekistan;359;1;95826;667
2021-05-14;UZ;Uzbekistan;291;0;96117;667
2021-05-15;UZ;Uzbekistan;251;0;96368;667
2021-05-16;UZ;Uzbekistan;302;1;96670;668
2021-05-17;UZ;Uzbekistan;223;2;96893;670
2021-05-18;UZ;Uzbekistan;175;2;97068;672
2021-05-19;UZ;Uzbekistan;212;2;97280;674
2021-05-20;UZ;Uzbekistan;263;2;97543;676
2021-05-21;UZ;Uzbekistan;313;2;97856;678
2021-05-22;UZ;Uzbekistan;308;2;98164;680
2021-05-23;UZ;Uzbekistan;287;0;98451;680
2021-05-24;UZ;Uzbekistan;206;0;98657;680
2021-05-25;UZ;Uzbekistan;192;2;98849;682
2021-05-26;UZ;Uzbekistan;215;2;99064;684
2021-05-27;UZ;Uzbekistan;280;1;99344;685
2021-05-28;UZ;Uzbekistan;236;2;99580;687
2021-05-29;UZ;Uzbekistan;264;1;99844;688
2021-05-30;UZ;Uzbekistan;280;2;100124;690
2021-05-31;UZ;Uzbekistan;211;0;100335;690
2021-06-01;UZ;Uzbekistan;160;0;100495;690
2021-06-02;UZ;Uzbekistan;231;1;100726;691
2021-06-03;UZ;Uzbekistan;271;2;100997;693
2021-06-04;UZ;Uzbekistan;201;2;101198;695
2021-06-05;UZ;Uzbekistan;238;1;101436;696
2021-06-06;UZ;Uzbekistan;286;0;101722;696
2021-06-07;UZ;Uzbekistan;242;0;101964;696
2021-06-08;UZ;Uzbekistan;199;3;102163;699
2021-06-09;UZ;Uzbekistan;199;2;102362;701
2021-06-10;UZ;Uzbekistan;243;1;102605;702
2021-06-11;UZ;Uzbekistan;287;2;102892;704
2021-06-12;UZ;Uzbekistan;314;1;103206;705
2021-06-13;UZ;Uzbekistan;304;3;103510;708
2021-06-14;UZ;Uzbekistan;303;0;103813;708
2021-06-15;UZ;Uzbekistan;300;1;104113;709
2021-06-16;UZ;Uzbekistan;350;2;104463;711
2021-06-17;UZ;Uzbekistan;371;2;104834;713
2021-06-18;UZ;Uzbekistan;385;4;105219;717
2021-06-19;UZ;Uzbekistan;391;1;105610;718
2021-06-20;UZ;Uzbekistan;415;0;106025;718
2021-06-21;UZ;Uzbekistan;427;0;106452;718
2021-06-22;UZ;Uzbekistan;395;2;106847;720
2021-06-23;UZ;Uzbekistan;419;2;107266;722
2021-06-24;UZ;Uzbekistan;442;1;107708;723
2021-06-25;UZ;Uzbekistan;476;2;108184;725
2021-06-26;UZ;Uzbekistan;546;2;108730;727
2021-06-27;UZ;Uzbekistan;493;2;109223;729
2021-06-28;UZ;Uzbekistan;469;2;109692;731
2021-06-29;UZ;Uzbekistan;498;2;110190;733
2021-06-30;UZ;Uzbekistan;487;3;110677;736
2021-07-01;UZ;Uzbekistan;476;4;111153;740
2020-11-10;VU;Vanuatu;1;0;1;0
2020-11-11;VU;Vanuatu;0;0;1;0
2020-11-12;VU;Vanuatu;0;0;1;0
2020-11-13;VU;Vanuatu;0;0;1;0
2020-11-14;VU;Vanuatu;0;0;1;0
2020-11-15;VU;Vanuatu;0;0;1;0
2020-11-16;VU;Vanuatu;0;0;1;0
2020-11-17;VU;Vanuatu;0;0;1;0
2020-11-18;VU;Vanuatu;0;0;1;0
2020-11-19;VU;Vanuatu;0;0;1;0
2020-11-20;VU;Vanuatu;0;0;1;0
2020-11-21;VU;Vanuatu;0;0;1;0
2020-11-22;VU;Vanuatu;0;0;1;0
2020-11-23;VU;Vanuatu;0;0;1;0
2020-11-24;VU;Vanuatu;0;0;1;0
2020-11-25;VU;Vanuatu;0;0;1;0
2020-11-26;VU;Vanuatu;0;0;1;0
2020-11-27;VU;Vanuatu;0;0;1;0
2020-11-28;VU;Vanuatu;0;0;1;0
2020-11-29;VU;Vanuatu;0;0;1;0
2020-11-30;VU;Vanuatu;0;0;1;0
2020-12-01;VU;Vanuatu;0;0;1;0
2020-12-02;VU;Vanuatu;0;0;1;0
2020-12-03;VU;Vanuatu;0;0;1;0
2020-12-04;VU;Vanuatu;0;0;1;0
2020-12-05;VU;Vanuatu;0;0;1;0
2020-12-06;VU;Vanuatu;0;0;1;0
2020-12-07;VU;Vanuatu;0;0;1;0
2020-12-08;VU;Vanuatu;0;0;1;0
2020-12-09;VU;Vanuatu;0;0;1;0
2020-12-10;VU;Vanuatu;0;0;1;0
2020-12-11;VU;Vanuatu;0;0;1;0
2020-12-12;VU;Vanuatu;0;0;1;0
2020-12-13;VU;Vanuatu;0;0;1;0
2020-12-14;VU;Vanuatu;0;0;1;0
2020-12-15;VU;Vanuatu;0;0;1;0
2020-12-16;VU;Vanuatu;0;0;1;0
2020-12-17;VU;Vanuatu;0;0;1;0
2020-12-18;VU;Vanuatu;0;0;1;0
2020-12-19;VU;Vanuatu;0;0;1;0
2020-12-20;VU;Vanuatu;0;0;1;0
2020-12-21;VU;Vanuatu;0;0;1;0
2020-12-22;VU;Vanuatu;0;0;1;0
2020-12-23;VU;Vanuatu;0;0;1;0
2020-12-24;VU;Vanuatu;0;0;1;0
2020-12-25;VU;Vanuatu;0;0;1;0
2020-12-26;VU;Vanuatu;0;0;1;0
2020-12-27;VU;Vanuatu;0;0;1;0
2020-12-28;VU;Vanuatu;0;0;1;0
2020-12-29;VU;Vanuatu;0;0;1;0
2020-12-30;VU;Vanuatu;0;0;1;0
2020-12-31;VU;Vanuatu;0;0;1;0
2021-01-01;VU;Vanuatu;0;0;1;0
2021-01-02;VU;Vanuatu;0;0;1;0
2021-01-03;VU;Vanuatu;0;0;1;0
2021-01-04;VU;Vanuatu;0;0;1;0
2021-01-05;VU;Vanuatu;0;0;1;0
2021-01-06;VU;Vanuatu;0;0;1;0
2021-01-07;VU;Vanuatu;0;0;1;0
2021-01-08;VU;Vanuatu;0;0;1;0
2021-01-09;VU;Vanuatu;0;0;1;0
2021-01-10;VU;Vanuatu;0;0;1;0
2021-01-11;VU;Vanuatu;0;0;1;0
2021-01-12;VU;Vanuatu;0;0;1;0
2021-01-13;VU;Vanuatu;0;0;1;0
2021-01-14;VU;Vanuatu;0;0;1;0
2021-01-15;VU;Vanuatu;0;0;1;0
2021-01-16;VU;Vanuatu;0;0;1;0
2021-01-17;VU;Vanuatu;0;0;1;0
2021-01-18;VU;Vanuatu;0;0;1;0
2021-01-19;VU;Vanuatu;0;0;1;0
2021-01-20;VU;Vanuatu;0;0;1;0
2021-01-21;VU;Vanuatu;0;0;1;0
2021-01-22;VU;Vanuatu;0;0;1;0
2021-01-23;VU;Vanuatu;0;0;1;0
2021-01-24;VU;Vanuatu;0;0;1;0
2021-01-25;VU;Vanuatu;0;0;1;0
2021-01-26;VU;Vanuatu;0;0;1;0
2021-01-27;VU;Vanuatu;0;0;1;0
2021-01-28;VU;Vanuatu;0;0;1;0
2021-01-29;VU;Vanuatu;0;0;1;0
2021-01-30;VU;Vanuatu;0;0;1;0
2021-01-31;VU;Vanuatu;0;0;1;0
2021-02-01;VU;Vanuatu;0;0;1;0
2021-02-02;VU;Vanuatu;0;0;1;0
2021-02-03;VU;Vanuatu;0;0;1;0
2021-02-04;VU;Vanuatu;0;0;1;0
2021-02-05;VU;Vanuatu;0;0;1;0
2021-02-06;VU;Vanuatu;0;0;1;0
2021-02-07;VU;Vanuatu;0;0;1;0
2021-02-08;VU;Vanuatu;0;0;1;0
2021-02-09;VU;Vanuatu;0;0;1;0
2021-02-10;VU;Vanuatu;0;0;1;0
2021-02-11;VU;Vanuatu;0;0;1;0
2021-02-12;VU;Vanuatu;0;0;1;0
2021-02-13;VU;Vanuatu;0;0;1;0
2021-02-14;VU;Vanuatu;0;0;1;0
2021-02-15;VU;Vanuatu;0;0;1;0
2021-02-16;VU;Vanuatu;0;0;1;0
2021-02-17;VU;Vanuatu;0;0;1;0
2021-02-18;VU;Vanuatu;0;0;1;0
2021-02-19;VU;Vanuatu;0;0;1;0
2021-02-20;VU;Vanuatu;0;0;1;0
2021-02-21;VU;Vanuatu;0;0;1;0
2021-02-22;VU;Vanuatu;0;0;1;0
2021-02-23;VU;Vanuatu;0;0;1;0
2021-02-24;VU;Vanuatu;0;0;1;0
2021-02-25;VU;Vanuatu;0;0;1;0
2021-02-26;VU;Vanuatu;0;0;1;0
2021-02-27;VU;Vanuatu;0;0;1;0
2021-02-28;VU;Vanuatu;0;0;1;0
2021-03-01;VU;Vanuatu;0;0;1;0
2021-03-02;VU;Vanuatu;0;0;1;0
2021-03-03;VU;Vanuatu;0;0;1;0
2021-03-04;VU;Vanuatu;0;0;1;0
2021-03-05;VU;Vanuatu;0;0;1;0
2021-03-06;VU;Vanuatu;0;0;1;0
2021-03-07;VU;Vanuatu;0;0;1;0
2021-03-08;VU;Vanuatu;2;0;3;0
2021-03-09;VU;Vanuatu;0;0;3;0
2021-03-10;VU;Vanuatu;0;0;3;0
2021-03-11;VU;Vanuatu;0;0;3;0
2021-03-12;VU;Vanuatu;0;0;3;0
2021-03-13;VU;Vanuatu;0;0;3;0
2021-03-14;VU;Vanuatu;0;0;3;0
2021-03-15;VU;Vanuatu;0;0;3;0
2021-03-16;VU;Vanuatu;0;0;3;0
2021-03-17;VU;Vanuatu;0;0;3;0
2021-03-18;VU;Vanuatu;0;0;3;0
2021-03-19;VU;Vanuatu;0;0;3;0
2021-03-20;VU;Vanuatu;0;0;3;0
2021-03-21;VU;Vanuatu;0;0;3;0
2021-03-22;VU;Vanuatu;0;0;3;0
2021-03-23;VU;Vanuatu;0;0;3;0
2021-03-24;VU;Vanuatu;0;0;3;0
2021-03-25;VU;Vanuatu;0;0;3;0
2021-03-26;VU;Vanuatu;0;0;3;0
2021-03-27;VU;Vanuatu;0;0;3;0
2021-03-28;VU;Vanuatu;0;0;3;0
2021-03-29;VU;Vanuatu;0;0;3;0
2021-03-30;VU;Vanuatu;0;0;3;0
2021-03-31;VU;Vanuatu;0;0;3;0
2021-04-01;VU;Vanuatu;0;0;3;0
2021-04-02;VU;Vanuatu;0;0;3;0
2021-04-03;VU;Vanuatu;0;0;3;0
2021-04-04;VU;Vanuatu;0;0;3;0
2021-04-05;VU;Vanuatu;0;0;3;0
2021-04-06;VU;Vanuatu;0;0;3;0
2021-04-07;VU;Vanuatu;0;0;3;0
2021-04-08;VU;Vanuatu;0;0;3;0
2021-04-09;VU;Vanuatu;0;0;3;0
2021-04-10;VU;Vanuatu;0;0;3;0
2021-04-11;VU;Vanuatu;0;0;3;0
2021-04-12;VU;Vanuatu;0;0;3;0
2021-04-13;VU;Vanuatu;0;0;3;0
2021-04-14;VU;Vanuatu;0;0;3;0
2021-04-15;VU;Vanuatu;0;0;3;0
2021-04-16;VU;Vanuatu;0;0;3;0
2021-04-17;VU;Vanuatu;0;0;3;0
2021-04-18;VU;Vanuatu;0;0;3;0
2021-04-19;VU;Vanuatu;0;0;3;0
2021-04-20;VU;Vanuatu;0;0;3;0
2021-04-21;VU;Vanuatu;1;1;4;1
2021-04-22;VU;Vanuatu;0;0;4;1
2021-04-23;VU;Vanuatu;0;0;4;1
2021-04-24;VU;Vanuatu;0;0;4;1
2021-04-25;VU;Vanuatu;0;0;4;1
2021-04-26;VU;Vanuatu;0;0;4;1
2021-04-27;VU;Vanuatu;0;0;4;1
2021-04-28;VU;Vanuatu;0;0;4;1
2021-04-29;VU;Vanuatu;0;0;4;1
2021-04-30;VU;Vanuatu;0;0;4;1
2021-05-01;VU;Vanuatu;0;0;4;1
2021-05-02;VU;Vanuatu;0;0;4;1
2021-05-03;VU;Vanuatu;0;0;4;1
2021-05-04;VU;Vanuatu;0;0;4;1
2021-05-05;VU;Vanuatu;0;0;4;1
2021-05-06;VU;Vanuatu;0;0;4;1
2021-05-07;VU;Vanuatu;0;0;4;1
2021-05-08;VU;Vanuatu;0;0;4;1
2021-05-09;VU;Vanuatu;0;0;4;1
2021-05-10;VU;Vanuatu;0;0;4;1
2021-05-11;VU;Vanuatu;0;0;4;1
2021-05-12;VU;Vanuatu;0;0;4;1
2021-05-13;VU;Vanuatu;0;0;4;1
2021-05-14;VU;Vanuatu;0;0;4;1
2021-05-15;VU;Vanuatu;0;0;4;1
2021-05-16;VU;Vanuatu;0;0;4;1
2021-05-17;VU;Vanuatu;0;0;4;1
2021-05-18;VU;Vanuatu;0;0;4;1
2021-05-19;VU;Vanuatu;0;0;4;1
2021-05-20;VU;Vanuatu;0;0;4;1
2021-05-21;VU;Vanuatu;0;0;4;1
2021-05-22;VU;Vanuatu;0;0;4;1
2021-05-23;VU;Vanuatu;0;0;4;1
2021-05-24;VU;Vanuatu;0;0;4;1
2021-05-25;VU;Vanuatu;0;0;4;1
2021-05-26;VU;Vanuatu;0;0;4;1
2021-05-27;VU;Vanuatu;0;0;4;1
2021-05-28;VU;Vanuatu;0;0;4;1
2021-05-29;VU;Vanuatu;0;0;4;1
2021-05-30;VU;Vanuatu;0;0;4;1
2021-05-31;VU;Vanuatu;0;0;4;1
2021-06-01;VU;Vanuatu;0;0;4;1
2021-06-02;VU;Vanuatu;0;0;4;1
2021-06-03;VU;Vanuatu;0;0;4;1
2021-06-04;VU;Vanuatu;0;0;4;1
2021-06-05;VU;Vanuatu;0;0;4;1
2021-06-06;VU;Vanuatu;0;0;4;1
2021-06-07;VU;Vanuatu;0;0;4;1
2021-06-08;VU;Vanuatu;0;0;4;1
2021-06-09;VU;Vanuatu;0;0;4;1
2021-06-10;VU;Vanuatu;0;0;4;1
2021-06-11;VU;Vanuatu;0;0;4;1
2021-06-12;VU;Vanuatu;0;0;4;1
2021-06-13;VU;Vanuatu;0;0;4;1
2021-06-14;VU;Vanuatu;0;0;4;1
2021-06-15;VU;Vanuatu;0;0;4;1
2021-06-16;VU;Vanuatu;0;0;4;1
2021-06-17;VU;Vanuatu;0;0;4;1
2021-06-18;VU;Vanuatu;0;0;4;1
2021-06-19;VU;Vanuatu;0;0;4;1
2021-06-20;VU;Vanuatu;0;0;4;1
2021-06-21;VU;Vanuatu;0;0;4;1
2021-06-22;VU;Vanuatu;0;0;4;1
2021-06-23;VU;Vanuatu;0;0;4;1
2021-06-24;VU;Vanuatu;0;0;4;1
2021-06-25;VU;Vanuatu;0;0;4;1
2021-06-26;VU;Vanuatu;0;0;4;1
2021-06-27;VU;Vanuatu;0;0;4;1
2021-06-28;VU;Vanuatu;0;0;4;1
2021-06-29;VU;Vanuatu;0;0;4;1
2021-06-30;VU;Vanuatu;0;0;4;1
2021-07-01;VU;Vanuatu;0;0;4;1
2020-03-06;VA;Vatican;1;0;1;0
2020-03-07;VA;Vatican;0;0;1;0
2020-03-08;VA;Vatican;0;0;1;0
2020-03-09;VA;Vatican;0;0;1;0
2020-03-10;VA;Vatican;0;0;1;0
2020-03-11;VA;Vatican;0;0;1;0
2020-03-12;VA;Vatican;0;0;1;0
2020-03-13;VA;Vatican;0;0;1;0
2020-03-14;VA;Vatican;0;0;1;0
2020-03-15;VA;Vatican;0;0;1;0
2020-03-16;VA;Vatican;0;0;1;0
2020-03-17;VA;Vatican;0;0;1;0
2020-03-18;VA;Vatican;0;0;1;0
2020-03-19;VA;Vatican;0;0;1;0
2020-03-20;VA;Vatican;0;0;1;0
2020-03-21;VA;Vatican;0;0;1;0
2020-03-22;VA;Vatican;0;0;1;0
2020-03-23;VA;Vatican;0;0;1;0
2020-03-24;VA;Vatican;3;0;4;0
2020-03-25;VA;Vatican;0;0;4;0
2020-03-26;VA;Vatican;0;0;4;0
2020-03-27;VA;Vatican;0;0;4;0
2020-03-28;VA;Vatican;2;0;6;0
2020-03-29;VA;Vatican;0;0;6;0
2020-03-30;VA;Vatican;0;0;6;0
2020-03-31;VA;Vatican;0;0;6;0
2020-04-01;VA;Vatican;0;0;6;0
2020-04-02;VA;Vatican;1;0;7;0
2020-04-03;VA;Vatican;0;0;7;0
2020-04-04;VA;Vatican;0;0;7;0
2020-04-05;VA;Vatican;0;0;7;0
2020-04-06;VA;Vatican;0;0;7;0
2020-04-07;VA;Vatican;0;0;7;0
2020-04-08;VA;Vatican;1;0;8;0
2020-04-09;VA;Vatican;0;0;8;0
2020-04-10;VA;Vatican;0;0;8;0
2020-04-11;VA;Vatican;0;0;8;0
2020-04-12;VA;Vatican;0;0;8;0
2020-04-13;VA;Vatican;0;0;8;0
2020-04-14;VA;Vatican;0;0;8;0
2020-04-15;VA;Vatican;0;0;8;0
2020-04-16;VA;Vatican;0;0;8;0
2020-04-17;VA;Vatican;0;0;8;0
2020-04-18;VA;Vatican;0;0;8;0
2020-04-19;VA;Vatican;0;0;8;0
2020-04-20;VA;Vatican;1;0;9;0
2020-04-21;VA;Vatican;0;0;9;0
2020-04-22;VA;Vatican;0;0;9;0
2020-04-23;VA;Vatican;0;0;9;0
2020-04-24;VA;Vatican;0;0;9;0
2020-04-25;VA;Vatican;0;0;9;0
2020-04-26;VA;Vatican;0;0;9;0
2020-04-27;VA;Vatican;0;0;9;0
2020-04-28;VA;Vatican;1;0;10;0
2020-04-29;VA;Vatican;0;0;10;0
2020-04-30;VA;Vatican;1;0;11;0
2020-05-01;VA;Vatican;0;0;11;0
2020-05-02;VA;Vatican;0;0;11;0
2020-05-03;VA;Vatican;0;0;11;0
2020-05-04;VA;Vatican;0;0;11;0
2020-05-05;VA;Vatican;0;0;11;0
2020-05-06;VA;Vatican;1;0;12;0
2020-05-07;VA;Vatican;0;0;12;0
2020-05-08;VA;Vatican;0;0;12;0
2020-05-09;VA;Vatican;0;0;12;0
2020-05-10;VA;Vatican;0;0;12;0
2020-05-11;VA;Vatican;0;0;12;0
2020-05-12;VA;Vatican;0;0;12;0
2020-05-13;VA;Vatican;0;0;12;0
2020-05-14;VA;Vatican;0;0;12;0
2020-05-15;VA;Vatican;0;0;12;0
2020-05-16;VA;Vatican;0;0;12;0
2020-05-17;VA;Vatican;0;0;12;0
2020-05-18;VA;Vatican;0;0;12;0
2020-05-19;VA;Vatican;0;0;12;0
2020-05-20;VA;Vatican;0;0;12;0
2020-05-21;VA;Vatican;0;0;12;0
2020-05-22;VA;Vatican;0;0;12;0
2020-05-23;VA;Vatican;0;0;12;0
2020-05-24;VA;Vatican;0;0;12;0
2020-05-25;VA;Vatican;0;0;12;0
2020-05-26;VA;Vatican;0;0;12;0
2020-05-27;VA;Vatican;0;0;12;0
2020-05-28;VA;Vatican;0;0;12;0
2020-05-29;VA;Vatican;0;0;12;0
2020-05-30;VA;Vatican;0;0;12;0
2020-05-31;VA;Vatican;0;0;12;0
2020-06-01;VA;Vatican;0;0;12;0
2020-06-02;VA;Vatican;0;0;12;0
2020-06-03;VA;Vatican;0;0;12;0
2020-06-04;VA;Vatican;0;0;12;0
2020-06-05;VA;Vatican;0;0;12;0
2020-06-06;VA;Vatican;0;0;12;0
2020-06-07;VA;Vatican;0;0;12;0
2020-06-08;VA;Vatican;0;0;12;0
2020-06-09;VA;Vatican;0;0;12;0
2020-06-10;VA;Vatican;0;0;12;0
2020-06-11;VA;Vatican;0;0;12;0
2020-06-12;VA;Vatican;0;0;12;0
2020-06-13;VA;Vatican;0;0;12;0
2020-06-14;VA;Vatican;0;0;12;0
2020-06-15;VA;Vatican;0;0;12;0
2020-06-16;VA;Vatican;0;0;12;0
2020-06-17;VA;Vatican;0;0;12;0
2020-06-18;VA;Vatican;0;0;12;0
2020-06-19;VA;Vatican;0;0;12;0
2020-06-20;VA;Vatican;0;0;12;0
2020-06-21;VA;Vatican;0;0;12;0
2020-06-22;VA;Vatican;0;0;12;0
2020-06-23;VA;Vatican;0;0;12;0
2020-06-24;VA;Vatican;0;0;12;0
2020-06-25;VA;Vatican;0;0;12;0
2020-06-26;VA;Vatican;0;0;12;0
2020-06-27;VA;Vatican;0;0;12;0
2020-06-28;VA;Vatican;0;0;12;0
2020-06-29;VA;Vatican;0;0;12;0
2020-06-30;VA;Vatican;0;0;12;0
2020-07-01;VA;Vatican;0;0;12;0
2020-07-02;VA;Vatican;0;0;12;0
2020-07-03;VA;Vatican;0;0;12;0
2020-07-04;VA;Vatican;0;0;12;0
2020-07-05;VA;Vatican;0;0;12;0
2020-07-06;VA;Vatican;0;0;12;0
2020-07-07;VA;Vatican;0;0;12;0
2020-07-08;VA;Vatican;0;0;12;0
2020-07-09;VA;Vatican;0;0;12;0
2020-07-10;VA;Vatican;0;0;12;0
2020-07-11;VA;Vatican;0;0;12;0
2020-07-12;VA;Vatican;0;0;12;0
2020-07-13;VA;Vatican;0;0;12;0
2020-07-14;VA;Vatican;0;0;12;0
2020-07-15;VA;Vatican;0;0;12;0
2020-07-16;VA;Vatican;0;0;12;0
2020-07-17;VA;Vatican;0;0;12;0
2020-07-18;VA;Vatican;0;0;12;0
2020-07-19;VA;Vatican;0;0;12;0
2020-07-20;VA;Vatican;0;0;12;0
2020-07-21;VA;Vatican;0;0;12;0
2020-07-22;VA;Vatican;0;0;12;0
2020-07-23;VA;Vatican;0;0;12;0
2020-07-24;VA;Vatican;0;0;12;0
2020-07-25;VA;Vatican;0;0;12;0
2020-07-26;VA;Vatican;0;0;12;0
2020-07-27;VA;Vatican;0;0;12;0
2020-07-28;VA;Vatican;0;0;12;0
2020-07-29;VA;Vatican;0;0;12;0
2020-07-30;VA;Vatican;0;0;12;0
2020-07-31;VA;Vatican;0;0;12;0
2020-08-01;VA;Vatican;0;0;12;0
2020-08-02;VA;Vatican;0;0;12;0
2020-08-03;VA;Vatican;0;0;12;0
2020-08-04;VA;Vatican;0;0;12;0
2020-08-05;VA;Vatican;0;0;12;0
2020-08-06;VA;Vatican;0;0;12;0
2020-08-07;VA;Vatican;0;0;12;0
2020-08-08;VA;Vatican;0;0;12;0
2020-08-09;VA;Vatican;0;0;12;0
2020-08-10;VA;Vatican;0;0;12;0
2020-08-11;VA;Vatican;0;0;12;0
2020-08-12;VA;Vatican;0;0;12;0
2020-08-13;VA;Vatican;0;0;12;0
2020-08-14;VA;Vatican;0;0;12;0
2020-08-15;VA;Vatican;0;0;12;0
2020-08-16;VA;Vatican;0;0;12;0
2020-08-17;VA;Vatican;0;0;12;0
2020-08-18;VA;Vatican;0;0;12;0
2020-08-19;VA;Vatican;0;0;12;0
2020-08-20;VA;Vatican;0;0;12;0
2020-08-21;VA;Vatican;0;0;12;0
2020-08-22;VA;Vatican;0;0;12;0
2020-08-23;VA;Vatican;0;0;12;0
2020-08-24;VA;Vatican;0;0;12;0
2020-08-25;VA;Vatican;0;0;12;0
2020-08-26;VA;Vatican;0;0;12;0
2020-08-27;VA;Vatican;0;0;12;0
2020-08-28;VA;Vatican;0;0;12;0
2020-08-29;VA;Vatican;0;0;12;0
2020-08-30;VA;Vatican;0;0;12;0
2020-08-31;VA;Vatican;0;0;12;0
2020-09-01;VA;Vatican;0;0;12;0
2020-09-02;VA;Vatican;0;0;12;0
2020-09-03;VA;Vatican;0;0;12;0
2020-09-04;VA;Vatican;0;0;12;0
2020-09-05;VA;Vatican;0;0;12;0
2020-09-06;VA;Vatican;0;0;12;0
2020-09-07;VA;Vatican;0;0;12;0
2020-09-08;VA;Vatican;0;0;12;0
2020-09-09;VA;Vatican;0;0;12;0
2020-09-10;VA;Vatican;0;0;12;0
2020-09-11;VA;Vatican;0;0;12;0
2020-09-12;VA;Vatican;0;0;12;0
2020-09-13;VA;Vatican;0;0;12;0
2020-09-14;VA;Vatican;0;0;12;0
2020-09-15;VA;Vatican;0;0;12;0
2020-09-16;VA;Vatican;0;0;12;0
2020-09-17;VA;Vatican;0;0;12;0
2020-09-18;VA;Vatican;0;0;12;0
2020-09-19;VA;Vatican;0;0;12;0
2020-09-20;VA;Vatican;0;0;12;0
2020-09-21;VA;Vatican;0;0;12;0
2020-09-22;VA;Vatican;0;0;12;0
2020-09-23;VA;Vatican;0;0;12;0
2020-09-24;VA;Vatican;0;0;12;0
2020-09-25;VA;Vatican;0;0;12;0
2020-09-26;VA;Vatican;0;0;12;0
2020-09-27;VA;Vatican;0;0;12;0
2020-09-28;VA;Vatican;0;0;12;0
2020-09-29;VA;Vatican;0;0;12;0
2020-09-30;VA;Vatican;0;0;12;0
2020-10-01;VA;Vatican;0;0;12;0
2020-10-02;VA;Vatican;0;0;12;0
2020-10-03;VA;Vatican;0;0;12;0
2020-10-04;VA;Vatican;0;0;12;0
2020-10-05;VA;Vatican;0;0;12;0
2020-10-06;VA;Vatican;0;0;12;0
2020-10-07;VA;Vatican;0;0;12;0
2020-10-08;VA;Vatican;0;0;12;0
2020-10-09;VA;Vatican;0;0;12;0
2020-10-10;VA;Vatican;0;0;12;0
2020-10-11;VA;Vatican;0;0;12;0
2020-10-12;VA;Vatican;7;0;19;0
2020-10-13;VA;Vatican;0;0;19;0
2020-10-14;VA;Vatican;0;0;19;0
2020-10-15;VA;Vatican;7;0;26;0
2020-10-16;VA;Vatican;0;0;26;0
2020-10-17;VA;Vatican;1;0;27;0
2020-10-18;VA;Vatican;0;0;27;0
2020-10-19;VA;Vatican;0;0;27;0
2020-10-20;VA;Vatican;0;0;27;0
2020-10-21;VA;Vatican;0;0;27;0
2020-10-22;VA;Vatican;0;0;27;0
2020-10-23;VA;Vatican;0;0;27;0
2020-10-24;VA;Vatican;0;0;27;0
2020-10-25;VA;Vatican;0;0;27;0
2020-10-26;VA;Vatican;0;0;27;0
2020-10-27;VA;Vatican;0;0;27;0
2020-10-28;VA;Vatican;0;0;27;0
2020-10-29;VA;Vatican;0;0;27;0
2020-10-30;VA;Vatican;0;0;27;0
2020-10-31;VA;Vatican;0;0;27;0
2020-11-01;VA;Vatican;0;0;27;0
2020-11-02;VA;Vatican;0;0;27;0
2020-11-03;VA;Vatican;0;0;27;0
2020-11-04;VA;Vatican;0;0;27;0
2020-11-05;VA;Vatican;0;0;27;0
2020-11-06;VA;Vatican;0;0;27;0
2020-11-07;VA;Vatican;0;0;27;0
2020-11-08;VA;Vatican;0;0;27;0
2020-11-09;VA;Vatican;0;0;27;0
2020-11-10;VA;Vatican;0;0;27;0
2020-11-11;VA;Vatican;0;0;27;0
2020-11-12;VA;Vatican;0;0;27;0
2020-11-13;VA;Vatican;0;0;27;0
2020-11-14;VA;Vatican;0;0;27;0
2020-11-15;VA;Vatican;0;0;27;0
2020-11-16;VA;Vatican;0;0;27;0
2020-11-17;VA;Vatican;0;0;27;0
2020-11-18;VA;Vatican;0;0;27;0
2020-11-19;VA;Vatican;0;0;27;0
2020-11-20;VA;Vatican;0;0;27;0
2020-11-21;VA;Vatican;0;0;27;0
2020-11-22;VA;Vatican;0;0;27;0
2020-11-23;VA;Vatican;0;0;27;0
2020-11-24;VA;Vatican;0;0;27;0
2020-11-25;VA;Vatican;0;0;27;0
2020-11-26;VA;Vatican;0;0;27;0
2020-11-27;VA;Vatican;0;0;27;0
2020-11-28;VA;Vatican;0;0;27;0
2020-11-29;VA;Vatican;0;0;27;0
2020-11-30;VA;Vatican;0;0;27;0
2020-12-01;VA;Vatican;0;0;27;0
2020-12-02;VA;Vatican;0;0;27;0
2020-12-03;VA;Vatican;0;0;27;0
2020-12-04;VA;Vatican;0;0;27;0
2020-12-05;VA;Vatican;0;0;27;0
2020-12-06;VA;Vatican;0;0;27;0
2020-12-07;VA;Vatican;0;0;27;0
2020-12-08;VA;Vatican;0;0;27;0
2020-12-09;VA;Vatican;0;0;27;0
2020-12-10;VA;Vatican;0;0;27;0
2020-12-11;VA;Vatican;0;0;27;0
2020-12-12;VA;Vatican;0;0;27;0
2020-12-13;VA;Vatican;0;0;27;0
2020-12-14;VA;Vatican;0;0;27;0
2020-12-15;VA;Vatican;0;0;27;0
2020-12-16;VA;Vatican;0;0;27;0
2020-12-17;VA;Vatican;0;0;27;0
2020-12-18;VA;Vatican;0;0;27;0
2020-12-19;VA;Vatican;0;0;27;0
2020-12-20;VA;Vatican;0;0;27;0
2020-12-21;VA;Vatican;0;0;27;0
2020-12-22;VA;Vatican;0;0;27;0
2020-12-23;VA;Vatican;0;0;27;0
2020-12-24;VA;Vatican;0;0;27;0
2020-12-25;VA;Vatican;0;0;27;0
2020-12-26;VA;Vatican;0;0;27;0
2020-12-27;VA;Vatican;0;0;27;0
2020-12-28;VA;Vatican;0;0;27;0
2020-12-29;VA;Vatican;0;0;27;0
2020-12-30;VA;Vatican;0;0;27;0
2020-12-31;VA;Vatican;0;0;27;0
2021-01-01;VA;Vatican;0;0;27;0
2021-01-02;VA;Vatican;0;0;27;0
2021-01-03;VA;Vatican;0;0;27;0
2021-01-04;VA;Vatican;0;0;27;0
2021-01-05;VA;Vatican;0;0;27;0
2021-01-06;VA;Vatican;0;0;27;0
2021-01-07;VA;Vatican;0;0;27;0
2021-01-08;VA;Vatican;0;0;27;0
2021-01-09;VA;Vatican;0;0;27;0
2021-01-10;VA;Vatican;0;0;27;0
2021-01-11;VA;Vatican;0;0;27;0
2021-01-12;VA;Vatican;0;0;27;0
2021-01-13;VA;Vatican;0;0;27;0
2021-01-14;VA;Vatican;0;0;27;0
2021-01-15;VA;Vatican;0;0;27;0
2021-01-16;VA;Vatican;0;0;27;0
2021-01-17;VA;Vatican;0;0;27;0
2021-01-18;VA;Vatican;0;0;27;0
2021-01-19;VA;Vatican;0;0;27;0
2021-01-20;VA;Vatican;0;0;27;0
2021-01-21;VA;Vatican;0;0;27;0
2021-01-22;VA;Vatican;0;0;27;0
2021-01-23;VA;Vatican;0;0;27;0
2021-01-24;VA;Vatican;0;0;27;0
2021-01-25;VA;Vatican;0;0;27;0
2021-01-26;VA;Vatican;0;0;27;0
2021-01-27;VA;Vatican;0;0;27;0
2021-01-28;VA;Vatican;0;0;27;0
2021-01-29;VA;Vatican;0;0;27;0
2021-01-30;VA;Vatican;0;0;27;0
2021-01-31;VA;Vatican;0;0;27;0
2021-02-01;VA;Vatican;0;0;27;0
2021-02-02;VA;Vatican;0;0;27;0
2021-02-03;VA;Vatican;0;0;27;0
2021-02-04;VA;Vatican;0;0;27;0
2021-02-05;VA;Vatican;0;0;27;0
2021-02-06;VA;Vatican;0;0;27;0
2021-02-07;VA;Vatican;0;0;27;0
2021-02-08;VA;Vatican;0;0;27;0
2021-02-09;VA;Vatican;0;0;27;0
2021-02-10;VA;Vatican;0;0;27;0
2021-02-11;VA;Vatican;0;0;27;0
2021-02-12;VA;Vatican;0;0;27;0
2021-02-13;VA;Vatican;0;0;27;0
2021-02-14;VA;Vatican;0;0;27;0
2021-02-15;VA;Vatican;0;0;27;0
2021-02-16;VA;Vatican;0;0;27;0
2021-02-17;VA;Vatican;0;0;27;0
2021-02-18;VA;Vatican;0;0;27;0
2021-02-19;VA;Vatican;0;0;27;0
2021-02-20;VA;Vatican;0;0;27;0
2021-02-21;VA;Vatican;0;0;27;0
2021-02-22;VA;Vatican;0;0;27;0
2021-02-23;VA;Vatican;0;0;27;0
2021-02-24;VA;Vatican;0;0;27;0
2021-02-25;VA;Vatican;0;0;27;0
2021-02-26;VA;Vatican;0;0;27;0
2021-02-27;VA;Vatican;0;0;27;0
2021-02-28;VA;Vatican;0;0;27;0
2021-03-01;VA;Vatican;0;0;27;0
2021-03-02;VA;Vatican;0;0;27;0
2021-03-03;VA;Vatican;0;0;27;0
2021-03-04;VA;Vatican;0;0;27;0
2021-03-05;VA;Vatican;0;0;27;0
2021-03-06;VA;Vatican;0;0;27;0
2021-03-07;VA;Vatican;0;0;27;0
2021-03-08;VA;Vatican;0;0;27;0
2021-03-09;VA;Vatican;0;0;27;0
2021-03-10;VA;Vatican;0;0;27;0
2021-03-11;VA;Vatican;0;0;27;0
2021-03-12;VA;Vatican;0;0;27;0
2021-03-13;VA;Vatican;0;0;27;0
2021-03-14;VA;Vatican;0;0;27;0
2021-03-15;VA;Vatican;0;0;27;0
2021-03-16;VA;Vatican;0;0;27;0
2021-03-17;VA;Vatican;0;0;27;0
2021-03-18;VA;Vatican;0;0;27;0
2021-03-19;VA;Vatican;0;0;27;0
2021-03-20;VA;Vatican;0;0;27;0
2021-03-21;VA;Vatican;0;0;27;0
2021-03-22;VA;Vatican;0;0;27;0
2021-03-23;VA;Vatican;0;0;27;0
2021-03-24;VA;Vatican;0;0;27;0
2021-03-25;VA;Vatican;0;0;27;0
2021-03-26;VA;Vatican;0;0;27;0
2021-03-27;VA;Vatican;0;0;27;0
2021-03-28;VA;Vatican;0;0;27;0
2021-03-29;VA;Vatican;0;0;27;0
2021-03-30;VA;Vatican;0;0;27;0
2021-03-31;VA;Vatican;0;0;27;0
2021-04-01;VA;Vatican;0;0;27;0
2021-04-02;VA;Vatican;0;0;27;0
2021-04-03;VA;Vatican;0;0;27;0
2021-04-04;VA;Vatican;0;0;27;0
2021-04-05;VA;Vatican;0;0;27;0
2021-04-06;VA;Vatican;0;0;27;0
2021-04-07;VA;Vatican;0;0;27;0
2021-04-08;VA;Vatican;0;0;27;0
2021-04-09;VA;Vatican;0;0;27;0
2021-04-10;VA;Vatican;0;0;27;0
2021-04-11;VA;Vatican;0;0;27;0
2021-04-12;VA;Vatican;0;0;27;0
2021-04-13;VA;Vatican;0;0;27;0
2021-04-14;VA;Vatican;0;0;27;0
2021-04-15;VA;Vatican;0;0;27;0
2021-04-16;VA;Vatican;0;0;27;0
2021-04-17;VA;Vatican;0;0;27;0
2021-04-18;VA;Vatican;0;0;27;0
2021-04-19;VA;Vatican;0;0;27;0
2021-04-20;VA;Vatican;0;0;27;0
2021-04-21;VA;Vatican;0;0;27;0
2021-04-22;VA;Vatican;0;0;27;0
2021-04-23;VA;Vatican;0;0;27;0
2021-04-24;VA;Vatican;0;0;27;0
2021-04-25;VA;Vatican;0;0;27;0
2021-04-26;VA;Vatican;0;0;27;0
2021-04-27;VA;Vatican;0;0;27;0
2021-04-28;VA;Vatican;0;0;27;0
2021-04-29;VA;Vatican;0;0;27;0
2021-04-30;VA;Vatican;0;0;27;0
2021-05-01;VA;Vatican;0;0;27;0
2021-05-02;VA;Vatican;0;0;27;0
2021-05-03;VA;Vatican;0;0;27;0
2021-05-04;VA;Vatican;0;0;27;0
2021-05-05;VA;Vatican;0;0;27;0
2021-05-06;VA;Vatican;0;0;27;0
2021-05-07;VA;Vatican;0;0;27;0
2021-05-08;VA;Vatican;0;0;27;0
2021-05-09;VA;Vatican;0;0;27;0
2021-05-10;VA;Vatican;0;0;27;0
2021-05-11;VA;Vatican;0;0;27;0
2021-05-12;VA;Vatican;0;0;27;0
2021-05-13;VA;Vatican;0;0;27;0
2021-05-14;VA;Vatican;0;0;27;0
2021-05-15;VA;Vatican;0;0;27;0
2021-05-16;VA;Vatican;0;0;27;0
2021-05-17;VA;Vatican;0;0;27;0
2021-05-18;VA;Vatican;0;0;27;0
2021-05-19;VA;Vatican;0;0;27;0
2021-05-20;VA;Vatican;0;0;27;0
2021-05-21;VA;Vatican;0;0;27;0
2021-05-22;VA;Vatican;0;0;27;0
2021-05-23;VA;Vatican;0;0;27;0
2021-05-24;VA;Vatican;0;0;27;0
2021-05-25;VA;Vatican;0;0;27;0
2021-05-26;VA;Vatican;0;0;27;0
2021-05-27;VA;Vatican;0;0;27;0
2021-05-28;VA;Vatican;0;0;27;0
2021-05-29;VA;Vatican;0;0;27;0
2021-05-30;VA;Vatican;0;0;27;0
2021-05-31;VA;Vatican;0;0;27;0
2021-06-01;VA;Vatican;0;0;27;0
2021-06-02;VA;Vatican;0;0;27;0
2021-06-03;VA;Vatican;0;0;27;0
2021-06-04;VA;Vatican;0;0;27;0
2021-06-05;VA;Vatican;0;0;27;0
2021-06-06;VA;Vatican;0;0;27;0
2021-06-07;VA;Vatican;0;0;27;0
2021-06-08;VA;Vatican;0;0;27;0
2021-06-09;VA;Vatican;0;0;27;0
2021-06-10;VA;Vatican;0;0;27;0
2021-06-11;VA;Vatican;0;0;27;0
2021-06-12;VA;Vatican;0;0;27;0
2021-06-13;VA;Vatican;0;0;27;0
2021-06-14;VA;Vatican;0;0;27;0
2021-06-15;VA;Vatican;0;0;27;0
2021-06-16;VA;Vatican;0;0;27;0
2021-06-17;VA;Vatican;0;0;27;0
2021-06-18;VA;Vatican;0;0;27;0
2021-06-19;VA;Vatican;0;0;27;0
2021-06-20;VA;Vatican;0;0;27;0
2021-06-21;VA;Vatican;0;0;27;0
2021-06-22;VA;Vatican;0;0;27;0
2021-06-23;VA;Vatican;0;0;27;0
2021-06-24;VA;Vatican;0;0;27;0
2021-06-25;VA;Vatican;0;0;27;0
2021-06-26;VA;Vatican;0;0;27;0
2021-06-27;VA;Vatican;0;0;27;0
2021-06-28;VA;Vatican;0;0;27;0
2021-06-29;VA;Vatican;0;0;27;0
2021-06-30;VA;Vatican;0;0;27;0
2021-07-01;VA;Vatican;0;0;27;0
2020-03-14;VE;Venezuela;2;0;2;0
2020-03-15;VE;Venezuela;8;0;10;0
2020-03-16;VE;Venezuela;7;0;17;0
2020-03-17;VE;Venezuela;16;0;33;0
2020-03-18;VE;Venezuela;3;0;36;0
2020-03-19;VE;Venezuela;6;0;42;0
2020-03-20;VE;Venezuela;0;0;42;0
2020-03-21;VE;Venezuela;28;0;70;0
2020-03-22;VE;Venezuela;0;0;70;0
2020-03-23;VE;Venezuela;7;0;77;0
2020-03-24;VE;Venezuela;7;0;84;0
2020-03-25;VE;Venezuela;7;0;91;0
2020-03-26;VE;Venezuela;16;0;107;0
2020-03-27;VE;Venezuela;0;1;107;1
2020-03-28;VE;Venezuela;12;1;119;2
2020-03-29;VE;Venezuela;0;0;119;2
2020-03-30;VE;Venezuela;16;1;135;3
2020-03-31;VE;Venezuela;0;0;135;3
2020-04-01;VE;Venezuela;8;0;143;3
2020-04-02;VE;Venezuela;3;2;146;5
2020-04-03;VE;Venezuela;7;2;153;7
2020-04-04;VE;Venezuela;2;0;155;7
2020-04-05;VE;Venezuela;4;0;159;7
2020-04-06;VE;Venezuela;6;0;165;7
2020-04-07;VE;Venezuela;0;0;165;7
2020-04-08;VE;Venezuela;2;2;167;9
2020-04-09;VE;Venezuela;4;0;171;9
2020-04-10;VE;Venezuela;0;0;171;9
2020-04-11;VE;Venezuela;4;0;175;9
2020-04-12;VE;Venezuela;6;0;181;9
2020-04-13;VE;Venezuela;8;0;189;9
2020-04-14;VE;Venezuela;0;0;189;9
2020-04-15;VE;Venezuela;8;0;197;9
2020-04-16;VE;Venezuela;7;0;204;9
2020-04-17;VE;Venezuela;0;0;204;9
2020-04-18;VE;Venezuela;23;0;227;9
2020-04-19;VE;Venezuela;29;0;256;9
2020-04-20;VE;Venezuela;0;0;256;9
2020-04-21;VE;Venezuela;29;1;285;10
2020-04-22;VE;Venezuela;3;0;288;10
2020-04-23;VE;Venezuela;23;0;311;10
2020-04-24;VE;Venezuela;7;0;318;10
2020-04-25;VE;Venezuela;5;0;323;10
2020-04-26;VE;Venezuela;2;0;325;10
2020-04-27;VE;Venezuela;4;0;329;10
2020-04-28;VE;Venezuela;0;0;329;10
2020-04-29;VE;Venezuela;2;0;331;10
2020-04-30;VE;Venezuela;2;6;333;16
2020-05-01;VE;Venezuela;2;-6;335;10
2020-05-02;VE;Venezuela;10;0;345;10
2020-05-03;VE;Venezuela;12;0;357;10
2020-05-04;VE;Venezuela;0;0;357;10
2020-05-05;VE;Venezuela;4;0;361;10
2020-05-06;VE;Venezuela;18;0;379;10
2020-05-07;VE;Venezuela;2;0;381;10
2020-05-08;VE;Venezuela;7;0;388;10
2020-05-09;VE;Venezuela;14;0;402;10
2020-05-10;VE;Venezuela;12;0;414;10
2020-05-11;VE;Venezuela;8;0;422;10
2020-05-12;VE;Venezuela;1;0;423;10
2020-05-13;VE;Venezuela;0;0;423;10
2020-05-14;VE;Venezuela;32;0;455;10
2020-05-15;VE;Venezuela;4;0;459;10
2020-05-16;VE;Venezuela;45;0;504;10
2020-05-17;VE;Venezuela;37;0;541;10
2020-05-18;VE;Venezuela;77;0;618;10
2020-05-19;VE;Venezuela;131;0;749;10
2020-05-20;VE;Venezuela;75;0;824;10
2020-05-21;VE;Venezuela;58;0;882;10
2020-05-22;VE;Venezuela;62;0;944;10
2020-05-23;VE;Venezuela;66;0;1010;10
2020-05-24;VE;Venezuela;111;0;1121;10
2020-05-25;VE;Venezuela;56;0;1177;10
2020-05-26;VE;Venezuela;34;1;1211;11
2020-05-27;VE;Venezuela;34;0;1245;11
2020-05-28;VE;Venezuela;80;0;1325;11
2020-05-29;VE;Venezuela;45;3;1370;14
2020-05-30;VE;Venezuela;89;0;1459;14
2020-05-31;VE;Venezuela;51;0;1510;14
2020-06-01;VE;Venezuela;152;3;1662;17
2020-06-02;VE;Venezuela;157;1;1819;18
2020-06-03;VE;Venezuela;133;2;1952;20
2020-06-04;VE;Venezuela;135;0;2087;20
2020-06-05;VE;Venezuela;58;0;2145;20
2020-06-06;VE;Venezuela;171;2;2316;22
2020-06-07;VE;Venezuela;61;0;2377;22
2020-06-08;VE;Venezuela;96;0;2473;22
2020-06-09;VE;Venezuela;159;1;2632;23
2020-06-10;VE;Venezuela;106;0;2738;23
2020-06-11;VE;Venezuela;76;0;2814;23
2020-06-12;VE;Venezuela;65;0;2879;23
2020-06-13;VE;Venezuela;25;1;2904;24
2020-06-14;VE;Venezuela;74;1;2978;25
2020-06-15;VE;Venezuela;84;1;3062;26
2020-06-16;VE;Venezuela;88;1;3150;27
2020-06-17;VE;Venezuela;236;1;3386;28
2020-06-18;VE;Venezuela;97;0;3483;28
2020-06-19;VE;Venezuela;108;2;3591;30
2020-06-20;VE;Venezuela;198;3;3789;33
2020-06-21;VE;Venezuela;128;0;3917;33
2020-06-22;VE;Venezuela;131;2;4048;35
2020-06-23;VE;Venezuela;139;0;4187;35
2020-06-24;VE;Venezuela;179;3;4366;38
2020-06-25;VE;Venezuela;197;1;4563;39
2020-06-26;VE;Venezuela;216;2;4779;41
2020-06-27;VE;Venezuela;351;1;5130;42
2020-06-28;VE;Venezuela;167;2;5297;44
2020-06-29;VE;Venezuela;233;4;5530;48
2020-06-30;VE;Venezuela;302;3;5832;51
2020-07-01;VE;Venezuela;230;3;6062;54
2020-07-02;VE;Venezuela;211;3;6273;57
2020-07-03;VE;Venezuela;264;2;6537;59
2020-07-04;VE;Venezuela;213;3;6750;62
2020-07-05;VE;Venezuela;419;3;7169;65
2020-07-06;VE;Venezuela;242;3;7411;68
2020-07-07;VE;Venezuela;282;3;7693;71
2020-07-08;VE;Venezuela;315;4;8008;75
2020-07-09;VE;Venezuela;364;5;8372;80
2020-07-10;VE;Venezuela;431;3;8803;83
2020-07-11;VE;Venezuela;375;2;9178;85
2020-07-12;VE;Venezuela;287;4;9465;89
2020-07-13;VE;Venezuela;242;4;9707;93
2020-07-14;VE;Venezuela;303;3;10010;96
2020-07-15;VE;Venezuela;418;4;10428;100
2020-07-16;VE;Venezuela;426;4;10854;104
2020-07-17;VE;Venezuela;337;3;11191;107
2020-07-18;VE;Venezuela;292;3;11483;110
2020-07-19;VE;Venezuela;408;2;11891;112
2020-07-20;VE;Venezuela;443;4;12334;116
2020-07-21;VE;Venezuela;440;4;12774;120
2020-07-22;VE;Venezuela;390;4;13164;124
2020-07-23;VE;Venezuela;449;5;13613;129
2020-07-24;VE;Venezuela;650;5;14263;134
2020-07-25;VE;Venezuela;666;4;14929;138
2020-07-26;VE;Venezuela;534;4;15463;142
2020-07-27;VE;Venezuela;525;4;15988;146
2020-07-28;VE;Venezuela;583;5;16571;151
2020-07-29;VE;Venezuela;587;5;17158;156
2020-07-30;VE;Venezuela;701;2;17859;158
2020-07-31;VE;Venezuela;715;6;18574;164
2020-08-01;VE;Venezuela;869;5;19443;169
2020-08-02;VE;Venezuela;763;5;20206;174
2020-08-03;VE;Venezuela;548;6;20754;180
2020-08-04;VE;Venezuela;684;7;21438;187
2020-08-05;VE;Venezuela;861;8;22299;195
2020-08-06;VE;Venezuela;981;7;23280;202
2020-08-07;VE;Venezuela;886;6;24166;208
2020-08-08;VE;Venezuela;795;7;24961;215
2020-08-09;VE;Venezuela;844;8;25805;223
2020-08-10;VE;Venezuela;995;6;26800;229
2020-08-11;VE;Venezuela;1138;9;27938;238
2020-08-12;VE;Venezuela;1150;9;29088;247
2020-08-13;VE;Venezuela;1281;12;30369;259
2020-08-14;VE;Venezuela;1012;7;31381;266
2020-08-15;VE;Venezuela;1226;10;32607;276
2020-08-16;VE;Venezuela;1148;5;33755;281
2020-08-17;VE;Venezuela;1047;7;34802;288
2020-08-18;VE;Venezuela;895;9;35697;297
2020-08-19;VE;Venezuela;1171;6;36868;303
2020-08-20;VE;Venezuela;699;8;37567;311
2020-08-21;VE;Venezuela;652;6;38219;317
2020-08-22;VE;Venezuela;738;6;38957;323
2020-08-23;VE;Venezuela;607;6;39564;329
2020-08-24;VE;Venezuela;774;8;40338;337
2020-08-25;VE;Venezuela;820;6;41158;343
2020-08-26;VE;Venezuela;807;8;41965;351
2020-08-27;VE;Venezuela;933;7;42898;358
2020-08-28;VE;Venezuela;981;8;43879;366
2020-08-29;VE;Venezuela;1067;9;44946;375
2020-08-30;VE;Venezuela;922;6;45868;381
2020-08-31;VE;Venezuela;860;5;46728;386
2020-09-01;VE;Venezuela;1028;5;47756;391
2020-09-02;VE;Venezuela;1127;7;48883;398
2020-09-03;VE;Venezuela;994;4;49877;402
2020-09-04;VE;Venezuela;1096;10;50973;412
2020-09-05;VE;Venezuela;1192;8;52165;420
2020-09-06;VE;Venezuela;1124;8;53289;428
2020-09-07;VE;Venezuela;1061;8;54350;436
2020-09-08;VE;Venezuela;1213;8;55563;444
2020-09-09;VE;Venezuela;1188;8;56751;452
2020-09-10;VE;Venezuela;1072;8;57823;460
2020-09-11;VE;Venezuela;840;8;58663;468
2020-09-12;VE;Venezuela;967;9;59630;477
2020-09-13;VE;Venezuela;910;8;60540;485
2020-09-14;VE;Venezuela;1029;9;61569;494
2020-09-15;VE;Venezuela;1086;8;62655;502
2020-09-16;VE;Venezuela;761;9;63416;511
2020-09-17;VE;Venezuela;868;9;64284;520
2020-09-18;VE;Venezuela;890;10;65174;530
2020-09-19;VE;Venezuela;775;9;65949;539
2020-09-20;VE;Venezuela;707;8;66656;547
2020-09-21;VE;Venezuela;787;8;67443;555
2020-09-22;VE;Venezuela;1010;9;68453;564
2020-09-23;VE;Venezuela;986;10;69439;574
2020-09-24;VE;Venezuela;967;7;70406;581
2020-09-25;VE;Venezuela;867;10;71273;591
2020-09-26;VE;Venezuela;667;9;71940;600
2020-09-27;VE;Venezuela;751;6;72691;606
2020-09-28;VE;Venezuela;837;8;73528;614
2020-09-29;VE;Venezuela;835;7;74363;621
2020-09-30;VE;Venezuela;759;7;75122;628
2020-10-01;VE;Venezuela;907;7;76029;635
2020-10-02;VE;Venezuela;791;8;76820;643
2020-10-03;VE;Venezuela;826;6;77646;649
2020-10-04;VE;Venezuela;788;4;78434;653
2020-10-05;VE;Venezuela;683;5;79117;658
2020-10-06;VE;Venezuela;679;7;79796;665
2020-10-07;VE;Venezuela;608;6;80404;671
2020-10-08;VE;Venezuela;615;7;81019;678
2020-10-09;VE;Venezuela;677;6;81696;684
2020-10-10;VE;Venezuela;757;7;82453;691
2020-10-11;VE;Venezuela;684;6;83137;697
2020-10-12;VE;Venezuela;619;7;83756;704
2020-10-13;VE;Venezuela;635;6;84391;710
2020-10-14;VE;Venezuela;614;4;85005;714
2020-10-15;VE;Venezuela;464;6;85469;720
2020-10-16;VE;Venezuela;289;5;85758;725
2020-10-17;VE;Venezuela;531;6;86289;731
2020-10-18;VE;Venezuela;347;5;86636;736
2020-10-19;VE;Venezuela;0;0;86636;736
2020-10-20;VE;Venezuela;1008;11;87644;747
2020-10-21;VE;Venezuela;391;6;88035;753
2020-10-22;VE;Venezuela;381;6;88416;759
2020-10-23;VE;Venezuela;302;5;88718;764
2020-10-24;VE;Venezuela;424;6;89142;770
2020-10-25;VE;Venezuela;423;3;89565;773
2020-10-26;VE;Venezuela;482;4;90047;777
2020-10-27;VE;Venezuela;353;3;90400;780
2020-10-28;VE;Venezuela;476;4;90876;784
2020-10-29;VE;Venezuela;404;5;91280;789
2020-10-30;VE;Venezuela;309;4;91589;793
2020-10-31;VE;Venezuela;424;5;92013;798
2020-11-01;VE;Venezuela;312;3;92325;801
2020-11-02;VE;Venezuela;380;5;92705;806
2020-11-03;VE;Venezuela;395;4;93100;810
2020-11-04;VE;Venezuela;380;4;93480;814
2020-11-05;VE;Venezuela;441;5;93921;819
2020-11-06;VE;Venezuela;384;2;94305;821
2020-11-07;VE;Venezuela;393;3;94698;824
2020-11-08;VE;Venezuela;185;2;94883;826
2020-11-09;VE;Venezuela;266;4;95149;830
2020-11-10;VE;Venezuela;296;4;95445;834
2020-11-11;VE;Venezuela;305;4;95750;838
2020-11-12;VE;Venezuela;390;3;96140;841
2020-11-13;VE;Venezuela;301;3;96441;844
2020-11-14;VE;Venezuela;492;4;96933;848
2020-11-15;VE;Venezuela;419;3;97352;851
2020-11-16;VE;Venezuela;387;4;97739;855
2020-11-17;VE;Venezuela;311;3;98050;858
2020-11-18;VE;Venezuela;300;2;98350;860
2020-11-19;VE;Venezuela;315;3;98665;863
2020-11-20;VE;Venezuela;352;3;99017;866
2020-11-21;VE;Venezuela;418;3;99435;869
2020-11-22;VE;Venezuela;400;2;99835;871
2020-11-23;VE;Venezuela;308;2;100143;873
2020-11-24;VE;Venezuela;355;3;100498;876
2020-11-25;VE;Venezuela;319;4;100817;880
2020-11-26;VE;Venezuela;398;4;101215;884
2020-11-27;VE;Venezuela;309;4;101524;888
2020-11-28;VE;Venezuela;236;4;101760;892
2020-11-29;VE;Venezuela;280;2;102040;894
2020-11-30;VE;Venezuela;354;3;102394;897
2020-12-01;VE;Venezuela;227;4;102621;901
2020-12-02;VE;Venezuela;446;4;103067;905
2020-12-03;VE;Venezuela;481;4;103548;909
2020-12-04;VE;Venezuela;329;4;103877;913
2020-12-05;VE;Venezuela;300;3;104177;916
2020-12-06;VE;Venezuela;265;3;104442;919
2020-12-07;VE;Venezuela;462;5;104904;924
2020-12-08;VE;Venezuela;480;4;105384;928
2020-12-09;VE;Venezuela;468;5;105852;933
2020-12-10;VE;Venezuela;428;5;106280;938
2020-12-11;VE;Venezuela;435;6;106715;944
2020-12-12;VE;Venezuela;462;5;107177;949
2020-12-13;VE;Venezuela;609;5;107786;954
2020-12-14;VE;Venezuela;339;6;108125;960
2020-12-15;VE;Venezuela;355;5;108480;965
2020-12-16;VE;Venezuela;237;5;108717;970
2020-12-17;VE;Venezuela;364;5;109081;975
2020-12-18;VE;Venezuela;314;4;109395;979
2020-12-19;VE;Venezuela;386;5;109781;984
2020-12-20;VE;Venezuela;294;4;110075;988
2020-12-21;VE;Venezuela;438;5;110513;993
2020-12-22;VE;Venezuela;315;4;110828;997
2020-12-23;VE;Venezuela;196;5;111024;1002
2020-12-24;VE;Venezuela;221;4;111245;1006
2020-12-25;VE;Venezuela;358;4;111603;1010
2020-12-26;VE;Venezuela;348;3;111951;1013
2020-12-27;VE;Venezuela;365;1;112316;1014
2020-12-28;VE;Venezuela;320;4;112636;1018
2020-12-29;VE;Venezuela;225;3;112861;1021
2020-12-30;VE;Venezuela;260;4;113121;1025
2020-12-31;VE;Venezuela;437;3;113558;1028
2021-01-01;VE;Venezuela;326;2;113884;1030
2021-01-02;VE;Venezuela;199;2;114083;1032
2021-01-03;VE;Venezuela;147;2;114230;1034
2021-01-04;VE;Venezuela;177;4;114407;1038
2021-01-05;VE;Venezuela;255;4;114662;1042
2021-01-06;VE;Venezuela;246;5;114908;1047
2021-01-07;VE;Venezuela;414;5;115322;1052
2021-01-08;VE;Venezuela;345;4;115667;1056
2021-01-09;VE;Venezuela;505;5;116172;1061
2021-01-10;VE;Venezuela;438;0;116610;1061
2021-01-11;VE;Venezuela;373;12;116983;1073
2021-01-12;VE;Venezuela;316;5;117299;1078
2021-01-13;VE;Venezuela;512;6;117811;1084
2021-01-14;VE;Venezuela;604;6;118415;1090
2021-01-15;VE;Venezuela;441;5;118856;1095
2021-01-16;VE;Venezuela;450;6;119306;1101
2021-01-17;VE;Venezuela;497;5;119803;1106
2021-01-18;VE;Venezuela;641;6;120444;1112
2021-01-19;VE;Venezuela;673;4;121117;1116
2021-01-20;VE;Venezuela;574;6;121691;1122
2021-01-21;VE;Venezuela;569;7;122260;1129
2021-01-22;VE;Venezuela;535;7;122795;1136
2021-01-23;VE;Venezuela;450;6;123245;1142
2021-01-24;VE;Venezuela;464;6;123709;1148
2021-01-25;VE;Venezuela;403;6;124112;1154
2021-01-26;VE;Venezuela;413;5;124525;1159
2021-01-27;VE;Venezuela;433;6;124958;1165
2021-01-28;VE;Venezuela;406;6;125364;1171
2021-01-29;VE;Venezuela;412;6;125776;1177
2021-01-30;VE;Venezuela;547;6;126323;1183
2021-01-31;VE;Venezuela;604;6;126927;1189
2021-02-01;VE;Venezuela;419;7;127346;1196
2021-02-02;VE;Venezuela;406;6;127752;1202
2021-02-03;VE;Venezuela;563;7;128315;1209
2021-02-04;VE;Venezuela;460;7;128775;1216
2021-02-05;VE;Venezuela;456;7;129231;1223
2021-02-06;VE;Venezuela;412;5;129643;1228
2021-02-07;VE;Venezuela;473;5;130116;1233
2021-02-08;VE;Venezuela;480;7;130596;1240
2021-02-09;VE;Venezuela;500;7;131096;1247
2021-02-10;VE;Venezuela;380;6;131476;1253
2021-02-11;VE;Venezuela;352;7;131828;1260
2021-02-12;VE;Venezuela;431;7;132259;1267
2021-02-13;VE;Venezuela;484;6;132743;1273
2021-02-14;VE;Venezuela;475;6;133218;1279
2021-02-15;VE;Venezuela;359;6;133577;1285
2021-02-16;VE;Venezuela;350;7;133927;1292
2021-02-17;VE;Venezuela;392;5;134319;1297
2021-02-18;VE;Venezuela;462;6;134781;1303
2021-02-19;VE;Venezuela;333;5;135114;1308
2021-02-20;VE;Venezuela;489;4;135603;1312
2021-02-21;VE;Venezuela;465;4;136068;1316
2021-02-22;VE;Venezuela;477;4;136545;1320
2021-02-23;VE;Venezuela;441;5;136986;1325
2021-02-24;VE;Venezuela;459;6;137445;1331
2021-02-25;VE;Venezuela;426;3;137871;1334
2021-02-26;VE;Venezuela;424;4;138295;1338
2021-02-27;VE;Venezuela;444;3;138739;1341
2021-02-28;VE;Venezuela;377;3;139116;1344
2021-03-01;VE;Venezuela;429;4;139545;1348
2021-03-02;VE;Venezuela;389;5;139934;1353
2021-03-03;VE;Venezuela;449;5;140383;1358
2021-03-04;VE;Venezuela;577;6;140960;1364
2021-03-05;VE;Venezuela;396;7;141356;1371
2021-03-06;VE;Venezuela;529;7;141885;1378
2021-03-07;VE;Venezuela;453;6;142338;1384
2021-03-08;VE;Venezuela;436;7;142774;1391
2021-03-09;VE;Venezuela;547;8;143321;1399
2021-03-10;VE;Venezuela;0;0;143321;1399
2021-03-11;VE;Venezuela;956;16;144277;1415
2021-03-12;VE;Venezuela;509;7;144786;1422
2021-03-13;VE;Venezuela;593;8;145379;1430
2021-03-14;VE;Venezuela;0;0;145379;1430
2021-03-15;VE;Venezuela;1109;14;146488;1444
2021-03-16;VE;Venezuela;540;7;147028;1451
2021-03-17;VE;Venezuela;549;8;147577;1459
2021-03-18;VE;Venezuela;631;8;148208;1467
2021-03-19;VE;Venezuela;937;8;149145;1475
2021-03-20;VE;Venezuela;1161;8;150306;1483
2021-03-21;VE;Venezuela;817;10;151123;1493
2021-03-22;VE;Venezuela;771;9;151894;1502
2021-03-23;VE;Venezuela;614;9;152508;1511
2021-03-24;VE;Venezuela;807;10;153315;1521
2021-03-25;VE;Venezuela;850;11;154165;1532
2021-03-26;VE;Venezuela;740;11;154905;1543
2021-03-27;VE;Venezuela;758;12;155663;1555
2021-03-28;VE;Venezuela;992;10;156655;1565
2021-03-29;VE;Venezuela;1288;12;157943;1577
2021-03-30;VE;Venezuela;1206;12;159149;1589
2021-03-31;VE;Venezuela;1348;13;160497;1602
2021-04-01;VE;Venezuela;1254;13;161751;1615
2021-04-02;VE;Venezuela;979;14;162730;1629
2021-04-03;VE;Venezuela;1607;18;164337;1647
2021-04-04;VE;Venezuela;1786;15;166123;1662
2021-04-05;VE;Venezuela;1425;16;167548;1678
2021-04-06;VE;Venezuela;1526;15;169074;1693
2021-04-07;VE;Venezuela;1115;12;170189;1705
2021-04-08;VE;Venezuela;1184;15;171373;1720
2021-04-09;VE;Venezuela;1088;19;172461;1739
2021-04-10;VE;Venezuela;1325;20;173786;1759
2021-04-11;VE;Venezuela;1101;19;174887;1778
2021-04-12;VE;Venezuela;925;17;175812;1795
2021-04-13;VE;Venezuela;1160;20;176972;1815
2021-04-14;VE;Venezuela;1122;19;178094;1834
2021-04-15;VE;Venezuela;1271;19;179365;1853
2021-04-16;VE;Venezuela;1244;17;180609;1870
2021-04-17;VE;Venezuela;1294;18;181903;1888
2021-04-18;VE;Venezuela;1287;17;183190;1905
2021-04-19;VE;Venezuela;1405;20;184595;1925
2021-04-20;VE;Venezuela;1141;19;185736;1944
2021-04-21;VE;Venezuela;1009;21;186745;1965
2021-04-22;VE;Venezuela;1318;22;188063;1987
2021-04-23;VE;Venezuela;1318;22;189381;2009
2021-04-24;VE;Venezuela;1142;19;190523;2028
2021-04-25;VE;Venezuela;995;19;191518;2047
2021-04-26;VE;Venezuela;980;18;192498;2065
2021-04-27;VE;Venezuela;1223;17;193721;2082
2021-04-28;VE;Venezuela;1238;17;194959;2099
2021-04-29;VE;Venezuela;1427;18;196386;2117
2021-04-30;VE;Venezuela;1297;19;197683;2136
2021-05-01;VE;Venezuela;1182;19;198865;2155
2021-05-02;VE;Venezuela;1202;17;200067;2172
2021-05-03;VE;Venezuela;864;17;200931;2189
2021-05-04;VE;Venezuela;876;19;201807;2208
2021-05-05;VE;Venezuela;771;18;202578;2226
2021-05-06;VE;Venezuela;1479;18;204057;2244
2021-05-07;VE;Venezuela;1124;19;205181;2263
2021-05-08;VE;Venezuela;1368;17;206549;2280
2021-05-09;VE;Venezuela;1321;11;207870;2291
2021-05-10;VE;Venezuela;1292;13;209162;2304
2021-05-11;VE;Venezuela;954;16;210116;2320
2021-05-12;VE;Venezuela;832;17;210948;2337
2021-05-13;VE;Venezuela;890;15;211838;2352
2021-05-14;VE;Venezuela;1160;14;212998;2366
2021-05-15;VE;Venezuela;0;0;212998;2366
2021-05-16;VE;Venezuela;2303;30;215301;2396
2021-05-17;VE;Venezuela;1114;15;216415;2411
2021-05-18;VE;Venezuela;1188;17;217603;2428
2021-05-19;VE;Venezuela;1211;18;218814;2446
2021-05-20;VE;Venezuela;1050;19;219864;2465
2021-05-21;VE;Venezuela;1178;18;221042;2483
2021-05-22;VE;Venezuela;1010;16;222052;2499
2021-05-23;VE;Venezuela;1293;14;223345;2513
2021-05-24;VE;Venezuela;1474;15;224819;2528
2021-05-25;VE;Venezuela;1317;16;226136;2544
2021-05-26;VE;Venezuela;1271;15;227407;2559
2021-05-27;VE;Venezuela;1421;17;228828;2576
2021-05-28;VE;Venezuela;1319;19;230147;2595
2021-05-29;VE;Venezuela;1296;20;231443;2615
2021-05-30;VE;Venezuela;1357;14;232800;2629
2021-05-31;VE;Venezuela;1365;17;234165;2646
2021-06-01;VE;Venezuela;1402;15;235567;2661
2021-06-02;VE;Venezuela;1188;13;236755;2674
2021-06-03;VE;Venezuela;1258;15;238013;2689
2021-06-04;VE;Venezuela;1239;9;239252;2698
2021-06-05;VE;Venezuela;1462;10;240714;2708
2021-06-06;VE;Venezuela;1424;11;242138;2719
2021-06-07;VE;Venezuela;1483;15;243621;2734
2021-06-08;VE;Venezuela;1679;16;245300;2750
2021-06-09;VE;Venezuela;1464;14;246764;2764
2021-06-10;VE;Venezuela;1083;17;247847;2781
2021-06-11;VE;Venezuela;973;16;248820;2797
2021-06-12;VE;Venezuela;1489;17;250309;2814
2021-06-13;VE;Venezuela;1377;15;251686;2829
2021-06-14;VE;Venezuela;1197;16;252883;2845
2021-06-15;VE;Venezuela;1233;20;254116;2865
2021-06-16;VE;Venezuela;1341;21;255457;2886
2021-06-17;VE;Venezuela;1405;20;256862;2906
2021-06-18;VE;Venezuela;1278;19;258140;2925
2021-06-19;VE;Venezuela;1273;18;259413;2943
2021-06-20;VE;Venezuela;1327;15;260740;2958
2021-06-21;VE;Venezuela;1298;15;262038;2973
2021-06-22;VE;Venezuela;1334;16;263372;2989
2021-06-23;VE;Venezuela;0;0;263372;2989
2021-06-24;VE;Venezuela;2270;34;265642;3023
2021-06-25;VE;Venezuela;1310;15;266952;3038
2021-06-26;VE;Venezuela;1397;17;268349;3055
2021-06-27;VE;Venezuela;1286;13;269635;3068
2021-06-28;VE;Venezuela;0;0;269635;3068
2021-06-29;VE;Venezuela;1019;16;270654;3084
2021-06-30;VE;Venezuela;2058;35;272712;3119
2021-07-01;VE;Venezuela;1312;17;274024;3136
2020-01-23;VN;Vietnam;2;0;2;0
2020-01-24;VN;Vietnam;0;0;2;0
2020-01-25;VN;Vietnam;0;0;2;0
2020-01-26;VN;Vietnam;0;0;2;0
2020-01-27;VN;Vietnam;0;0;2;0
2020-01-28;VN;Vietnam;0;0;2;0
2020-01-29;VN;Vietnam;0;0;2;0
2020-01-30;VN;Vietnam;0;0;2;0
2020-01-31;VN;Vietnam;0;0;2;0
2020-02-01;VN;Vietnam;4;0;6;0
2020-02-02;VN;Vietnam;0;0;6;0
2020-02-03;VN;Vietnam;2;0;8;0
2020-02-04;VN;Vietnam;0;0;8;0
2020-02-05;VN;Vietnam;0;0;8;0
2020-02-06;VN;Vietnam;2;0;10;0
2020-02-07;VN;Vietnam;0;0;10;0
2020-02-08;VN;Vietnam;3;0;13;0
2020-02-09;VN;Vietnam;0;0;13;0
2020-02-10;VN;Vietnam;1;0;14;0
2020-02-11;VN;Vietnam;1;0;15;0
2020-02-12;VN;Vietnam;0;0;15;0
2020-02-13;VN;Vietnam;1;0;16;0
2020-02-14;VN;Vietnam;0;0;16;0
2020-02-15;VN;Vietnam;0;0;16;0
2020-02-16;VN;Vietnam;0;0;16;0
2020-02-17;VN;Vietnam;0;0;16;0
2020-02-18;VN;Vietnam;0;0;16;0
2020-02-19;VN;Vietnam;0;0;16;0
2020-02-20;VN;Vietnam;0;0;16;0
2020-02-21;VN;Vietnam;0;0;16;0
2020-02-22;VN;Vietnam;0;0;16;0
2020-02-23;VN;Vietnam;0;0;16;0
2020-02-24;VN;Vietnam;0;0;16;0
2020-02-25;VN;Vietnam;0;0;16;0
2020-02-26;VN;Vietnam;0;0;16;0
2020-02-27;VN;Vietnam;0;0;16;0
2020-02-28;VN;Vietnam;0;0;16;0
2020-02-29;VN;Vietnam;0;0;16;0
2020-03-01;VN;Vietnam;0;0;16;0
2020-03-02;VN;Vietnam;0;0;16;0
2020-03-03;VN;Vietnam;0;0;16;0
2020-03-04;VN;Vietnam;0;0;16;0
2020-03-05;VN;Vietnam;0;0;16;0
2020-03-06;VN;Vietnam;0;0;16;0
2020-03-07;VN;Vietnam;2;0;18;0
2020-03-08;VN;Vietnam;12;0;30;0
2020-03-09;VN;Vietnam;0;0;30;0
2020-03-10;VN;Vietnam;1;0;31;0
2020-03-11;VN;Vietnam;7;0;38;0
2020-03-12;VN;Vietnam;1;0;39;0
2020-03-13;VN;Vietnam;8;0;47;0
2020-03-14;VN;Vietnam;6;0;53;0
2020-03-15;VN;Vietnam;3;0;56;0
2020-03-16;VN;Vietnam;5;0;61;0
2020-03-17;VN;Vietnam;5;0;66;0
2020-03-18;VN;Vietnam;9;0;75;0
2020-03-19;VN;Vietnam;10;0;85;0
2020-03-20;VN;Vietnam;6;0;91;0
2020-03-21;VN;Vietnam;3;0;94;0
2020-03-22;VN;Vietnam;19;0;113;0
2020-03-23;VN;Vietnam;10;0;123;0
2020-03-24;VN;Vietnam;11;0;134;0
2020-03-25;VN;Vietnam;7;0;141;0
2020-03-26;VN;Vietnam;12;0;153;0
2020-03-27;VN;Vietnam;10;0;163;0
2020-03-28;VN;Vietnam;11;0;174;0
2020-03-29;VN;Vietnam;14;0;188;0
2020-03-30;VN;Vietnam;15;0;203;0
2020-03-31;VN;Vietnam;9;0;212;0
2020-04-01;VN;Vietnam;6;0;218;0
2020-04-02;VN;Vietnam;15;0;233;0
2020-04-03;VN;Vietnam;4;0;237;0
2020-04-04;VN;Vietnam;3;0;240;0
2020-04-05;VN;Vietnam;1;0;241;0
2020-04-06;VN;Vietnam;4;0;245;0
2020-04-07;VN;Vietnam;4;0;249;0
2020-04-08;VN;Vietnam;2;0;251;0
2020-04-09;VN;Vietnam;4;0;255;0
2020-04-10;VN;Vietnam;2;0;257;0
2020-04-11;VN;Vietnam;1;0;258;0
2020-04-12;VN;Vietnam;4;0;262;0
2020-04-13;VN;Vietnam;3;0;265;0
2020-04-14;VN;Vietnam;1;0;266;0
2020-04-15;VN;Vietnam;1;0;267;0
2020-04-16;VN;Vietnam;1;0;268;0
2020-04-17;VN;Vietnam;0;0;268;0
2020-04-18;VN;Vietnam;0;0;268;0
2020-04-19;VN;Vietnam;0;0;268;0
2020-04-20;VN;Vietnam;0;0;268;0
2020-04-21;VN;Vietnam;0;0;268;0
2020-04-22;VN;Vietnam;0;0;268;0
2020-04-23;VN;Vietnam;0;0;268;0
2020-04-24;VN;Vietnam;2;0;270;0
2020-04-25;VN;Vietnam;0;0;270;0
2020-04-26;VN;Vietnam;0;0;270;0
2020-04-27;VN;Vietnam;0;0;270;0
2020-04-28;VN;Vietnam;0;0;270;0
2020-04-29;VN;Vietnam;0;0;270;0
2020-04-30;VN;Vietnam;0;0;270;0
2020-05-01;VN;Vietnam;0;0;270;0
2020-05-02;VN;Vietnam;0;0;270;0
2020-05-03;VN;Vietnam;1;0;271;0
2020-05-04;VN;Vietnam;0;0;271;0
2020-05-05;VN;Vietnam;0;0;271;0
2020-05-06;VN;Vietnam;0;0;271;0
2020-05-07;VN;Vietnam;17;0;288;0
2020-05-08;VN;Vietnam;0;0;288;0
2020-05-09;VN;Vietnam;0;0;288;0
2020-05-10;VN;Vietnam;0;0;288;0
2020-05-11;VN;Vietnam;0;0;288;0
2020-05-12;VN;Vietnam;0;0;288;0
2020-05-13;VN;Vietnam;0;0;288;0
2020-05-14;VN;Vietnam;24;0;312;0
2020-05-15;VN;Vietnam;2;0;314;0
2020-05-16;VN;Vietnam;4;0;318;0
2020-05-17;VN;Vietnam;2;0;320;0
2020-05-18;VN;Vietnam;4;0;324;0
2020-05-19;VN;Vietnam;0;0;324;0
2020-05-20;VN;Vietnam;0;0;324;0
2020-05-21;VN;Vietnam;0;0;324;0
2020-05-22;VN;Vietnam;0;0;324;0
2020-05-23;VN;Vietnam;1;0;325;0
2020-05-24;VN;Vietnam;0;0;325;0
2020-05-25;VN;Vietnam;1;0;326;0
2020-05-26;VN;Vietnam;1;0;327;0
2020-05-27;VN;Vietnam;0;0;327;0
2020-05-28;VN;Vietnam;0;0;327;0
2020-05-29;VN;Vietnam;1;0;328;0
2020-05-30;VN;Vietnam;0;0;328;0
2020-05-31;VN;Vietnam;0;0;328;0
2020-06-01;VN;Vietnam;0;0;328;0
2020-06-02;VN;Vietnam;0;0;328;0
2020-06-03;VN;Vietnam;0;0;328;0
2020-06-04;VN;Vietnam;0;0;328;0
2020-06-05;VN;Vietnam;0;0;328;0
2020-06-06;VN;Vietnam;1;0;329;0
2020-06-07;VN;Vietnam;2;0;331;0
2020-06-08;VN;Vietnam;1;0;332;0
2020-06-09;VN;Vietnam;0;0;332;0
2020-06-10;VN;Vietnam;0;0;332;0
2020-06-11;VN;Vietnam;0;0;332;0
2020-06-12;VN;Vietnam;1;0;333;0
2020-06-13;VN;Vietnam;1;0;334;0
2020-06-14;VN;Vietnam;0;0;334;0
2020-06-15;VN;Vietnam;0;0;334;0
2020-06-16;VN;Vietnam;0;0;334;0
2020-06-17;VN;Vietnam;1;0;335;0
2020-06-18;VN;Vietnam;7;0;342;0
2020-06-19;VN;Vietnam;7;0;349;0
2020-06-20;VN;Vietnam;0;0;349;0
2020-06-21;VN;Vietnam;0;0;349;0
2020-06-22;VN;Vietnam;0;0;349;0
2020-06-23;VN;Vietnam;0;0;349;0
2020-06-24;VN;Vietnam;3;0;352;0
2020-06-25;VN;Vietnam;0;0;352;0
2020-06-26;VN;Vietnam;1;0;353;0
2020-06-27;VN;Vietnam;2;0;355;0
2020-06-28;VN;Vietnam;0;0;355;0
2020-06-29;VN;Vietnam;0;0;355;0
2020-06-30;VN;Vietnam;0;0;355;0
2020-07-01;VN;Vietnam;0;0;355;0
2020-07-02;VN;Vietnam;0;0;355;0
2020-07-03;VN;Vietnam;0;0;355;0
2020-07-04;VN;Vietnam;0;0;355;0
2020-07-05;VN;Vietnam;0;0;355;0
2020-07-06;VN;Vietnam;14;0;369;0
2020-07-07;VN;Vietnam;0;0;369;0
2020-07-08;VN;Vietnam;0;0;369;0
2020-07-09;VN;Vietnam;0;0;369;0
2020-07-10;VN;Vietnam;1;0;370;0
2020-07-11;VN;Vietnam;0;0;370;0
2020-07-12;VN;Vietnam;2;0;372;0
2020-07-13;VN;Vietnam;1;0;373;0
2020-07-14;VN;Vietnam;0;0;373;0
2020-07-15;VN;Vietnam;8;0;381;0
2020-07-16;VN;Vietnam;0;0;381;0
2020-07-17;VN;Vietnam;1;0;382;0
2020-07-18;VN;Vietnam;0;0;382;0
2020-07-19;VN;Vietnam;1;0;383;0
2020-07-20;VN;Vietnam;1;0;384;0
2020-07-21;VN;Vietnam;17;0;401;0
2020-07-22;VN;Vietnam;7;0;408;0
2020-07-23;VN;Vietnam;4;0;412;0
2020-07-24;VN;Vietnam;3;0;415;0
2020-07-25;VN;Vietnam;2;0;417;0
2020-07-26;VN;Vietnam;3;0;420;0
2020-07-27;VN;Vietnam;11;0;431;0
2020-07-28;VN;Vietnam;15;0;446;0
2020-07-29;VN;Vietnam;13;0;459;0
2020-07-30;VN;Vietnam;50;0;509;0
2020-07-31;VN;Vietnam;49;3;558;3
2020-08-01;VN;Vietnam;32;0;590;3
2020-08-02;VN;Vietnam;31;3;621;6
2020-08-03;VN;Vietnam;31;1;652;7
2020-08-04;VN;Vietnam;20;1;672;8
2020-08-05;VN;Vietnam;45;1;717;9
2020-08-06;VN;Vietnam;33;1;750;10
2020-08-07;VN;Vietnam;39;0;789;10
2020-08-08;VN;Vietnam;23;0;812;10
2020-08-09;VN;Vietnam;29;3;841;13
2020-08-10;VN;Vietnam;6;2;847;15
2020-08-11;VN;Vietnam;19;1;866;16
2020-08-12;VN;Vietnam;17;2;883;18
2020-08-13;VN;Vietnam;28;3;911;21
2020-08-14;VN;Vietnam;19;1;930;22
2020-08-15;VN;Vietnam;21;2;951;24
2020-08-16;VN;Vietnam;13;0;964;24
2020-08-17;VN;Vietnam;19;1;983;25
2020-08-18;VN;Vietnam;6;1;989;26
2020-08-19;VN;Vietnam;5;-1;994;25
2020-08-20;VN;Vietnam;13;0;1007;25
2020-08-21;VN;Vietnam;2;0;1009;25
2020-08-22;VN;Vietnam;5;1;1014;26
2020-08-23;VN;Vietnam;2;1;1016;27
2020-08-24;VN;Vietnam;6;0;1022;27
2020-08-25;VN;Vietnam;7;0;1029;27
2020-08-26;VN;Vietnam;5;3;1034;30
2020-08-27;VN;Vietnam;2;0;1036;30
2020-08-28;VN;Vietnam;2;0;1038;30
2020-08-29;VN;Vietnam;2;2;1040;32
2020-08-30;VN;Vietnam;0;0;1040;32
2020-08-31;VN;Vietnam;4;2;1044;34
2020-09-01;VN;Vietnam;0;0;1044;34
2020-09-02;VN;Vietnam;2;0;1046;34
2020-09-03;VN;Vietnam;0;1;1046;35
2020-09-04;VN;Vietnam;3;0;1049;35
2020-09-05;VN;Vietnam;0;0;1049;35
2020-09-06;VN;Vietnam;0;0;1049;35
2020-09-07;VN;Vietnam;0;0;1049;35
2020-09-08;VN;Vietnam;5;0;1054;35
2020-09-09;VN;Vietnam;5;0;1059;35
2020-09-10;VN;Vietnam;0;0;1059;35
2020-09-11;VN;Vietnam;1;0;1060;35
2020-09-12;VN;Vietnam;0;0;1060;35
2020-09-13;VN;Vietnam;3;0;1063;35
2020-09-14;VN;Vietnam;0;0;1063;35
2020-09-15;VN;Vietnam;0;0;1063;35
2020-09-16;VN;Vietnam;0;0;1063;35
2020-09-17;VN;Vietnam;3;0;1066;35
2020-09-18;VN;Vietnam;2;0;1068;35
2020-09-19;VN;Vietnam;0;0;1068;35
2020-09-20;VN;Vietnam;0;0;1068;35
2020-09-21;VN;Vietnam;0;0;1068;35
2020-09-22;VN;Vietnam;0;0;1068;35
2020-09-23;VN;Vietnam;1;0;1069;35
2020-09-24;VN;Vietnam;0;0;1069;35
2020-09-25;VN;Vietnam;0;0;1069;35
2020-09-26;VN;Vietnam;0;0;1069;35
2020-09-27;VN;Vietnam;5;0;1074;35
2020-09-28;VN;Vietnam;3;0;1077;35
2020-09-29;VN;Vietnam;17;0;1094;35
2020-09-30;VN;Vietnam;0;0;1094;35
2020-10-01;VN;Vietnam;1;0;1095;35
2020-10-02;VN;Vietnam;1;0;1096;35
2020-10-03;VN;Vietnam;0;0;1096;35
2020-10-04;VN;Vietnam;0;0;1096;35
2020-10-05;VN;Vietnam;1;0;1097;35
2020-10-06;VN;Vietnam;1;0;1098;35
2020-10-07;VN;Vietnam;1;0;1099;35
2020-10-08;VN;Vietnam;1;0;1100;35
2020-10-09;VN;Vietnam;5;0;1105;35
2020-10-10;VN;Vietnam;2;0;1107;35
2020-10-11;VN;Vietnam;2;0;1109;35
2020-10-12;VN;Vietnam;1;0;1110;35
2020-10-13;VN;Vietnam;3;0;1113;35
2020-10-14;VN;Vietnam;9;0;1122;35
2020-10-15;VN;Vietnam;2;0;1124;35
2020-10-16;VN;Vietnam;0;0;1124;35
2020-10-17;VN;Vietnam;2;0;1126;35
2020-10-18;VN;Vietnam;8;0;1134;35
2020-10-19;VN;Vietnam;6;0;1140;35
2020-10-20;VN;Vietnam;1;0;1141;35
2020-10-21;VN;Vietnam;3;0;1144;35
2020-10-22;VN;Vietnam;4;0;1148;35
2020-10-23;VN;Vietnam;0;0;1148;35
2020-10-24;VN;Vietnam;12;0;1160;35
2020-10-25;VN;Vietnam;8;0;1168;35
2020-10-26;VN;Vietnam;1;0;1169;35
2020-10-27;VN;Vietnam;3;0;1172;35
2020-10-28;VN;Vietnam;1;0;1173;35
2020-10-29;VN;Vietnam;4;0;1177;35
2020-10-30;VN;Vietnam;0;0;1177;35
2020-10-31;VN;Vietnam;3;0;1180;35
2020-11-01;VN;Vietnam;0;0;1180;35
2020-11-02;VN;Vietnam;12;0;1192;35
2020-11-03;VN;Vietnam;10;0;1202;35
2020-11-04;VN;Vietnam;1;0;1203;35
2020-11-05;VN;Vietnam;4;0;1207;35
2020-11-06;VN;Vietnam;5;0;1212;35
2020-11-07;VN;Vietnam;1;0;1213;35
2020-11-08;VN;Vietnam;0;0;1213;35
2020-11-09;VN;Vietnam;2;0;1215;35
2020-11-10;VN;Vietnam;11;0;1226;35
2020-11-11;VN;Vietnam;26;0;1252;35
2020-11-12;VN;Vietnam;1;0;1253;35
2020-11-13;VN;Vietnam;3;0;1256;35
2020-11-14;VN;Vietnam;9;0;1265;35
2020-11-15;VN;Vietnam;16;0;1281;35
2020-11-16;VN;Vietnam;2;0;1283;35
2020-11-17;VN;Vietnam;5;0;1288;35
2020-11-18;VN;Vietnam;12;0;1300;35
2020-11-19;VN;Vietnam;4;0;1304;35
2020-11-20;VN;Vietnam;1;0;1305;35
2020-11-21;VN;Vietnam;1;0;1306;35
2020-11-22;VN;Vietnam;1;0;1307;35
2020-11-23;VN;Vietnam;5;0;1312;35
2020-11-24;VN;Vietnam;4;0;1316;35
2020-11-25;VN;Vietnam;5;0;1321;35
2020-11-26;VN;Vietnam;10;0;1331;35
2020-11-27;VN;Vietnam;8;0;1339;35
2020-11-28;VN;Vietnam;2;0;1341;35
2020-11-29;VN;Vietnam;2;0;1343;35
2020-11-30;VN;Vietnam;4;0;1347;35
2020-12-01;VN;Vietnam;4;0;1351;35
2020-12-02;VN;Vietnam;7;0;1358;35
2020-12-03;VN;Vietnam;3;0;1361;35
2020-12-04;VN;Vietnam;0;0;1361;35
2020-12-05;VN;Vietnam;4;0;1365;35
2020-12-06;VN;Vietnam;1;0;1366;35
2020-12-07;VN;Vietnam;1;0;1367;35
2020-12-08;VN;Vietnam;10;0;1377;35
2020-12-09;VN;Vietnam;4;0;1381;35
2020-12-10;VN;Vietnam;4;0;1385;35
2020-12-11;VN;Vietnam;6;0;1391;35
2020-12-12;VN;Vietnam;4;0;1395;35
2020-12-13;VN;Vietnam;2;0;1397;35
2020-12-14;VN;Vietnam;5;0;1402;35
2020-12-15;VN;Vietnam;3;0;1405;35
2020-12-16;VN;Vietnam;0;0;1405;35
2020-12-17;VN;Vietnam;2;0;1407;35
2020-12-18;VN;Vietnam;3;0;1410;35
2020-12-19;VN;Vietnam;1;0;1411;35
2020-12-20;VN;Vietnam;2;0;1413;35
2020-12-21;VN;Vietnam;1;0;1414;35
2020-12-22;VN;Vietnam;6;0;1420;35
2020-12-23;VN;Vietnam;1;0;1421;35
2020-12-24;VN;Vietnam;11;0;1432;35
2020-12-25;VN;Vietnam;7;0;1439;35
2020-12-26;VN;Vietnam;1;0;1440;35
2020-12-27;VN;Vietnam;1;0;1441;35
2020-12-28;VN;Vietnam;10;0;1451;35
2020-12-29;VN;Vietnam;3;0;1454;35
2020-12-30;VN;Vietnam;2;0;1456;35
2020-12-31;VN;Vietnam;9;0;1465;35
2021-01-01;VN;Vietnam;9;0;1474;35
2021-01-02;VN;Vietnam;8;0;1482;35
2021-01-03;VN;Vietnam;12;0;1494;35
2021-01-04;VN;Vietnam;3;0;1497;35
2021-01-05;VN;Vietnam;7;0;1504;35
2021-01-06;VN;Vietnam;1;0;1505;35
2021-01-07;VN;Vietnam;4;0;1509;35
2021-01-08;VN;Vietnam;3;0;1512;35
2021-01-09;VN;Vietnam;1;0;1513;35
2021-01-10;VN;Vietnam;1;0;1514;35
2021-01-11;VN;Vietnam;1;0;1515;35
2021-01-12;VN;Vietnam;5;0;1520;35
2021-01-13;VN;Vietnam;1;0;1521;35
2021-01-14;VN;Vietnam;10;0;1531;35
2021-01-15;VN;Vietnam;5;0;1536;35
2021-01-16;VN;Vietnam;1;0;1537;35
2021-01-17;VN;Vietnam;0;0;1537;35
2021-01-18;VN;Vietnam;2;0;1539;35
2021-01-19;VN;Vietnam;1;0;1540;35
2021-01-20;VN;Vietnam;4;0;1544;35
2021-01-21;VN;Vietnam;2;0;1546;35
2021-01-22;VN;Vietnam;2;0;1548;35
2021-01-23;VN;Vietnam;0;0;1548;35
2021-01-24;VN;Vietnam;0;0;1548;35
2021-01-25;VN;Vietnam;1;0;1549;35
2021-01-26;VN;Vietnam;2;0;1551;35
2021-01-27;VN;Vietnam;2;0;1553;35
2021-01-28;VN;Vietnam;98;0;1651;35
2021-01-29;VN;Vietnam;6;0;1657;35
2021-01-30;VN;Vietnam;110;0;1767;35
2021-01-31;VN;Vietnam;50;0;1817;35
2021-02-01;VN;Vietnam;33;0;1850;35
2021-02-02;VN;Vietnam;32;0;1882;35
2021-02-03;VN;Vietnam;66;0;1948;35
2021-02-04;VN;Vietnam;9;0;1957;35
2021-02-05;VN;Vietnam;19;0;1976;35
2021-02-06;VN;Vietnam;9;0;1985;35
2021-02-07;VN;Vietnam;16;0;2001;35
2021-02-08;VN;Vietnam;49;0;2050;35
2021-02-09;VN;Vietnam;14;0;2064;35
2021-02-10;VN;Vietnam;27;0;2091;35
2021-02-11;VN;Vietnam;49;0;2140;35
2021-02-12;VN;Vietnam;2;0;2142;35
2021-02-13;VN;Vietnam;53;0;2195;35
2021-02-14;VN;Vietnam;33;0;2228;35
2021-02-15;VN;Vietnam;41;0;2269;35
2021-02-16;VN;Vietnam;42;0;2311;35
2021-02-17;VN;Vietnam;18;0;2329;35
2021-02-18;VN;Vietnam;18;0;2347;35
2021-02-19;VN;Vietnam;15;0;2362;35
2021-02-20;VN;Vietnam;6;0;2368;35
2021-02-21;VN;Vietnam;15;0;2383;35
2021-02-22;VN;Vietnam;9;0;2392;35
2021-02-23;VN;Vietnam;11;0;2403;35
2021-02-24;VN;Vietnam;9;0;2412;35
2021-02-25;VN;Vietnam;9;0;2421;35
2021-02-26;VN;Vietnam;5;0;2426;35
2021-02-27;VN;Vietnam;6;0;2432;35
2021-02-28;VN;Vietnam;16;0;2448;35
2021-03-01;VN;Vietnam;0;0;2448;35
2021-03-02;VN;Vietnam;27;0;2475;35
2021-03-03;VN;Vietnam;7;0;2482;35
2021-03-04;VN;Vietnam;6;0;2488;35
2021-03-05;VN;Vietnam;6;0;2494;35
2021-03-06;VN;Vietnam;7;0;2501;35
2021-03-07;VN;Vietnam;11;0;2512;35
2021-03-08;VN;Vietnam;12;0;2524;35
2021-03-09;VN;Vietnam;2;0;2526;35
2021-03-10;VN;Vietnam;3;0;2529;35
2021-03-11;VN;Vietnam;4;0;2533;35
2021-03-12;VN;Vietnam;17;0;2550;35
2021-03-13;VN;Vietnam;3;0;2553;35
2021-03-14;VN;Vietnam;1;0;2554;35
2021-03-15;VN;Vietnam;3;0;2557;35
2021-03-16;VN;Vietnam;3;0;2560;35
2021-03-17;VN;Vietnam;7;0;2567;35
2021-03-18;VN;Vietnam;3;0;2570;35
2021-03-19;VN;Vietnam;1;0;2571;35
2021-03-20;VN;Vietnam;1;0;2572;35
2021-03-21;VN;Vietnam;0;0;2572;35
2021-03-22;VN;Vietnam;3;0;2575;35
2021-03-23;VN;Vietnam;0;0;2575;35
2021-03-24;VN;Vietnam;1;0;2576;35
2021-03-25;VN;Vietnam;3;0;2579;35
2021-03-26;VN;Vietnam;7;0;2586;35
2021-03-27;VN;Vietnam;0;0;2586;35
2021-03-28;VN;Vietnam;5;0;2591;35
2021-03-29;VN;Vietnam;3;0;2594;35
2021-03-30;VN;Vietnam;0;0;2594;35
2021-03-31;VN;Vietnam;9;0;2603;35
2021-04-01;VN;Vietnam;14;0;2617;35
2021-04-02;VN;Vietnam;3;0;2620;35
2021-04-03;VN;Vietnam;6;0;2626;35
2021-04-04;VN;Vietnam;5;0;2631;35
2021-04-05;VN;Vietnam;6;0;2637;35
2021-04-06;VN;Vietnam;11;0;2648;35
2021-04-07;VN;Vietnam;11;0;2659;35
2021-04-08;VN;Vietnam;9;0;2668;35
2021-04-09;VN;Vietnam;15;0;2683;35
2021-04-10;VN;Vietnam;9;0;2692;35
2021-04-11;VN;Vietnam;1;0;2693;35
2021-04-12;VN;Vietnam;12;0;2705;35
2021-04-13;VN;Vietnam;9;0;2714;35
2021-04-14;VN;Vietnam;19;0;2733;35
2021-04-15;VN;Vietnam;25;0;2758;35
2021-04-16;VN;Vietnam;14;0;2772;35
2021-04-17;VN;Vietnam;9;0;2781;35
2021-04-18;VN;Vietnam;4;0;2785;35
2021-04-19;VN;Vietnam;6;0;2791;35
2021-04-20;VN;Vietnam;9;0;2800;35
2021-04-21;VN;Vietnam;12;0;2812;35
2021-04-22;VN;Vietnam;12;0;2824;35
2021-04-23;VN;Vietnam;6;0;2830;35
2021-04-24;VN;Vietnam;3;0;2833;35
2021-04-25;VN;Vietnam;10;0;2843;35
2021-04-26;VN;Vietnam;9;0;2852;35
2021-04-27;VN;Vietnam;5;0;2857;35
2021-04-28;VN;Vietnam;8;0;2865;35
2021-04-29;VN;Vietnam;45;0;2910;35
2021-04-30;VN;Vietnam;18;0;2928;35
2021-05-01;VN;Vietnam;14;0;2942;35
2021-05-02;VN;Vietnam;20;0;2962;35
2021-05-03;VN;Vietnam;23;0;2985;35
2021-05-04;VN;Vietnam;10;0;2995;35
2021-05-05;VN;Vietnam;35;0;3030;35
2021-05-06;VN;Vietnam;60;0;3090;35
2021-05-07;VN;Vietnam;47;0;3137;35
2021-05-08;VN;Vietnam;108;0;3245;35
2021-05-09;VN;Vietnam;167;0;3412;35
2021-05-10;VN;Vietnam;77;0;3489;35
2021-05-11;VN;Vietnam;82;0;3571;35
2021-05-12;VN;Vietnam;87;0;3658;35
2021-05-13;VN;Vietnam;82;0;3740;35
2021-05-14;VN;Vietnam;76;0;3816;35
2021-05-15;VN;Vietnam;296;1;4112;36
2021-05-16;VN;Vietnam;100;1;4212;37
2021-05-17;VN;Vietnam;147;0;4359;37
2021-05-18;VN;Vietnam;153;0;4512;37
2021-05-19;VN;Vietnam;208;0;4720;37
2021-05-20;VN;Vietnam;89;2;4809;39
2021-05-21;VN;Vietnam;132;2;4941;41
2021-05-22;VN;Vietnam;178;1;5119;42
2021-05-23;VN;Vietnam;156;1;5275;43
2021-05-24;VN;Vietnam;129;1;5404;44
2021-05-25;VN;Vietnam;527;0;5931;44
2021-05-26;VN;Vietnam;155;1;6086;45
2021-05-27;VN;Vietnam;270;1;6356;46
2021-05-28;VN;Vietnam;40;1;6396;47
2021-05-29;VN;Vietnam;512;0;6908;47
2021-05-30;VN;Vietnam;199;0;7107;47
2021-05-31;VN;Vietnam;325;0;7432;47
2021-06-01;VN;Vietnam;193;1;7625;48
2021-06-02;VN;Vietnam;245;1;7870;49
2021-06-03;VN;Vietnam;193;0;8063;49
2021-06-04;VN;Vietnam;301;2;8364;51
2021-06-05;VN;Vietnam;216;2;8580;53
2021-06-06;VN;Vietnam;211;0;8791;53
2021-06-07;VN;Vietnam;236;0;9027;53
2021-06-08;VN;Vietnam;195;2;9222;55
2021-06-09;VN;Vietnam;413;0;9635;55
2021-06-10;VN;Vietnam;200;0;9835;55
2021-06-11;VN;Vietnam;213;2;10048;57
2021-06-12;VN;Vietnam;289;1;10337;58
2021-06-13;VN;Vietnam;293;1;10630;59
2021-06-14;VN;Vietnam;251;0;10881;59
2021-06-15;VN;Vietnam;423;2;11304;61
2021-06-16;VN;Vietnam;490;0;11794;61
2021-06-17;VN;Vietnam;356;0;12150;61
2021-06-18;VN;Vietnam;358;1;12508;62
2021-06-19;VN;Vietnam;470;2;12978;64
2021-06-20;VN;Vietnam;280;2;13258;66
2021-06-21;VN;Vietnam;272;3;13530;69
2021-06-22;VN;Vietnam;252;0;13782;69
2021-06-23;VN;Vietnam;207;1;13989;70
2021-06-24;VN;Vietnam;334;2;14323;72
2021-06-25;VN;Vietnam;214;2;14537;74
2021-06-26;VN;Vietnam;788;0;15325;74
2021-06-27;VN;Vietnam;415;2;15740;76
2021-06-28;VN;Vietnam;396;2;16136;78
2021-06-29;VN;Vietnam;371;2;16507;80
2021-06-30;VN;Vietnam;545;1;17052;81
2021-07-01;VN;Vietnam;675;0;17727;81
2021-03-23;WF;Wallis and Futuna;0;0;0;0
2021-03-24;WF;Wallis and Futuna;0;0;0;0
2021-03-25;WF;Wallis and Futuna;0;0;0;0
2021-03-26;WF;Wallis and Futuna;0;0;0;0
2021-03-27;WF;Wallis and Futuna;0;0;0;0
2021-03-28;WF;Wallis and Futuna;0;0;0;0
2021-03-29;WF;Wallis and Futuna;0;0;0;0
2021-03-30;WF;Wallis and Futuna;0;0;0;0
2021-03-31;WF;Wallis and Futuna;0;0;0;0
2021-04-01;WF;Wallis and Futuna;0;0;0;0
2021-04-02;WF;Wallis and Futuna;0;0;0;0
2021-04-03;WF;Wallis and Futuna;0;0;0;0
2021-04-04;WF;Wallis and Futuna;0;0;0;0
2021-04-05;WF;Wallis and Futuna;0;0;0;0
2021-04-06;WF;Wallis and Futuna;0;0;0;0
2021-04-07;WF;Wallis and Futuna;0;0;0;0
2021-04-08;WF;Wallis and Futuna;0;0;0;0
2021-04-09;WF;Wallis and Futuna;0;0;0;0
2021-04-10;WF;Wallis and Futuna;0;0;0;0
2021-04-11;WF;Wallis and Futuna;0;0;0;0
2021-04-12;WF;Wallis and Futuna;0;0;0;0
2021-04-13;WF;Wallis and Futuna;0;0;0;0
2021-04-14;WF;Wallis and Futuna;0;0;0;0
2021-04-15;WF;Wallis and Futuna;0;0;0;0
2021-04-16;WF;Wallis and Futuna;0;0;0;0
2021-04-17;WF;Wallis and Futuna;0;0;0;0
2021-04-18;WF;Wallis and Futuna;0;0;0;0
2021-04-19;WF;Wallis and Futuna;0;0;0;0
2021-04-20;WF;Wallis and Futuna;0;0;0;0
2021-04-21;WF;Wallis and Futuna;0;0;0;0
2021-04-22;WF;Wallis and Futuna;0;0;0;0
2021-04-23;WF;Wallis and Futuna;0;0;0;0
2021-04-24;WF;Wallis and Futuna;0;0;0;0
2021-04-25;WF;Wallis and Futuna;0;0;0;0
2021-04-26;WF;Wallis and Futuna;0;0;0;0
2021-04-27;WF;Wallis and Futuna;0;0;0;0
2021-04-28;WF;Wallis and Futuna;0;0;0;0
2021-04-29;WF;Wallis and Futuna;0;0;0;0
2021-04-30;WF;Wallis and Futuna;0;0;0;0
2021-05-01;WF;Wallis and Futuna;0;0;0;0
2021-05-02;WF;Wallis and Futuna;0;0;0;0
2021-05-03;WF;Wallis and Futuna;0;0;0;0
2021-05-04;WF;Wallis and Futuna;0;0;0;0
2021-05-05;WF;Wallis and Futuna;0;0;0;0
2021-05-06;WF;Wallis and Futuna;0;0;0;0
2021-05-07;WF;Wallis and Futuna;0;0;0;0
2021-05-08;WF;Wallis and Futuna;0;0;0;0
2021-05-09;WF;Wallis and Futuna;0;0;0;0
2021-05-10;WF;Wallis and Futuna;0;0;0;0
2021-05-11;WF;Wallis and Futuna;0;0;0;0
2021-05-12;WF;Wallis and Futuna;0;0;0;0
2021-05-13;WF;Wallis and Futuna;0;0;0;0
2021-05-14;WF;Wallis and Futuna;0;0;0;0
2021-05-15;WF;Wallis and Futuna;0;0;0;0
2021-05-16;WF;Wallis and Futuna;0;0;0;0
2021-05-17;WF;Wallis and Futuna;0;0;0;0
2021-05-18;WF;Wallis and Futuna;0;0;0;0
2021-05-19;WF;Wallis and Futuna;0;0;0;0
2021-05-20;WF;Wallis and Futuna;0;0;0;0
2021-05-21;WF;Wallis and Futuna;0;0;0;0
2021-05-22;WF;Wallis and Futuna;0;0;0;0
2021-05-23;WF;Wallis and Futuna;0;0;0;0
2021-05-24;WF;Wallis and Futuna;0;0;0;0
2021-05-25;WF;Wallis and Futuna;0;0;0;0
2021-05-26;WF;Wallis and Futuna;0;0;0;0
2021-05-27;WF;Wallis and Futuna;0;0;0;0
2021-05-28;WF;Wallis and Futuna;0;0;0;0
2021-05-29;WF;Wallis and Futuna;0;0;0;0
2021-05-30;WF;Wallis and Futuna;0;0;0;0
2021-05-31;WF;Wallis and Futuna;0;0;0;0
2021-06-01;WF;Wallis and Futuna;0;0;0;0
2021-06-02;WF;Wallis and Futuna;0;0;0;0
2021-06-03;WF;Wallis and Futuna;0;0;0;0
2021-06-04;WF;Wallis and Futuna;0;0;0;0
2021-06-05;WF;Wallis and Futuna;0;0;0;0
2021-06-06;WF;Wallis and Futuna;0;0;0;0
2021-06-07;WF;Wallis and Futuna;0;0;0;0
2021-06-08;WF;Wallis and Futuna;0;0;0;0
2021-06-09;WF;Wallis and Futuna;0;0;0;0
2021-06-10;WF;Wallis and Futuna;0;0;0;0
2021-06-11;WF;Wallis and Futuna;0;0;0;0
2021-06-12;WF;Wallis and Futuna;0;0;0;0
2021-06-13;WF;Wallis and Futuna;0;0;0;0
2021-06-14;WF;Wallis and Futuna;0;0;0;0
2021-06-15;WF;Wallis and Futuna;0;0;0;0
2021-06-16;WF;Wallis and Futuna;0;0;0;0
2021-06-17;WF;Wallis and Futuna;0;0;0;0
2021-06-18;WF;Wallis and Futuna;0;0;0;0
2021-06-19;WF;Wallis and Futuna;0;0;0;0
2021-06-20;WF;Wallis and Futuna;0;0;0;0
2021-06-21;WF;Wallis and Futuna;0;0;0;0
2021-06-22;WF;Wallis and Futuna;0;0;0;0
2021-06-23;WF;Wallis and Futuna;0;0;0;0
2021-06-24;WF;Wallis and Futuna;0;0;0;0
2021-06-25;WF;Wallis and Futuna;0;0;0;0
2021-06-26;WF;Wallis and Futuna;0;0;0;0
2021-06-27;WF;Wallis and Futuna;0;0;0;0
2021-06-28;WF;Wallis and Futuna;0;0;0;0
2021-06-29;WF;Wallis and Futuna;0;0;0;0
2020-01-22;;World;0;0;557;17
2020-01-23;;World;98;1;655;18
2020-01-24;;World;286;8;941;26
2020-01-25;;World;492;16;1433;42
2020-01-26;;World;685;14;2118;56
2020-01-27;;World;809;26;2927;82
2020-01-28;;World;2651;49;5578;131
2020-01-29;;World;589;2;6167;133
2020-01-30;;World;2068;38;8235;171
2020-01-31;;World;1692;42;9927;213
2020-02-01;;World;2111;46;12038;259
2020-02-02;;World;4749;103;16787;362
2020-02-03;;World;3100;64;19887;426
2020-02-04;;World;4011;66;23898;492
2020-02-05;;World;3745;72;27643;564
2020-02-06;;World;3160;70;30803;634
2020-02-07;;World;3593;85;34396;719
2020-02-08;;World;2734;87;37130;806
2020-02-09;;World;3030;100;40160;906
2020-02-10;;World;2609;107;42769;1013
2020-02-11;;World;2042;100;44811;1113
2020-02-12;;World;418;5;45229;1118
2020-02-13;;World;15153;253;60382;1371
2020-02-14;;World;6527;152;66909;1523
2020-02-15;;World;2143;143;69052;1666
2020-02-16;;World;2183;104;71235;1770
2020-02-17;;World;2035;98;73270;1868
2020-02-18;;World;1882;140;75152;2008
2020-02-19;;World;500;115;75652;2123
2020-02-20;;World;560;125;76212;2248
2020-02-21;;World;629;4;76841;2252
2020-02-22;;World;1761;207;78602;2459
2020-02-23;;World;380;11;78982;2470
2020-02-24;;World;564;160;79546;2630
2020-02-25;;World;853;80;80399;2710
2020-02-26;;World;977;61;81376;2771
2020-02-27;;World;1360;43;82736;2814
2020-02-28;;World;1386;59;84122;2873
2020-02-29;;World;1891;69;86013;2942
2020-03-01;;World;2381;54;88394;2996
2020-03-02;;World;1983;89;90377;3085
2020-03-03;;World;2594;75;92971;3160
2020-03-04;;World;2308;95;95279;3255
2020-03-05;;World;2811;94;98090;3349
2020-03-06;;World;3913;112;102003;3461
2020-03-07;;World;4095;104;106098;3565
2020-03-08;;World;3949;240;110047;3805
2020-03-09;;World;4172;190;114219;3995
2020-03-10;;World;4822;274;119041;4269
2020-03-11;;World;7661;344;126702;4613
2020-03-12;;World;5790;307;132492;4920
2020-03-13;;World;14384;497;146876;5417
2020-03-14;;World;11074;420;157950;5837
2020-03-15;;World;11269;638;169219;6475
2020-03-16;;World;14808;683;184027;7158
2020-03-17;;World;15943;817;199970;7975
2020-03-18;;World;19565;912;219535;8887
2020-03-19;;World;27049;1116;246584;10003
2020-03-20;;World;30775;1489;277359;11492
2020-03-21;;World;31991;1724;309350;13216
2020-03-22;;World;34855;1693;344205;14909
2020-03-23;;World;42835;1953;387040;16862
2020-03-24;;World;41179;2294;428219;19156
2020-03-25;;World;51001;2821;479220;21977
2020-03-26;;World;62877;3040;542097;25017
2020-03-27;;World;65041;3494;607138;28511
2020-03-28;;World;67280;3748;674418;32259
2020-03-29;;World;59237;3518;733655;35777
2020-03-30;;World;65294;4093;798949;39870
2020-03-31;;World;76845;4767;875794;44637
2020-04-01;;World;82835;6014;958629;50651
2020-04-02;;World;83050;5894;1041679;56545
2020-04-03;;World;83571;6179;1125250;62724
2020-04-04;;World;58359;5956;1183609;68680
2020-04-05;;World;72610;5237;1256219;73917
2020-04-06;;World;73152;5973;1329371;79890
2020-04-07;;World;69841;8304;1399212;88194
2020-04-08;;World;83398;6846;1482610;95040
2020-04-09;;World;87020;7873;1569630;102913
2020-04-10;;World;85523;7431;1655153;110344
2020-04-11;;World;74264;6262;1729417;116606
2020-04-12;;World;119695;5939;1849112;122545
2020-04-13;;World;70741;6055;1919853;128600
2020-04-14;;World;84004;7077;2003857;135677
2020-04-15;;World;77116;8583;2080973;144260
2020-04-16;;World;95518;7382;2176491;151642
2020-04-17;;World;88033;8528;2264524;160170
2020-04-18;;World;77215;6234;2341739;166404
2020-04-19;;World;76571;5345;2418310;171749
2020-04-20;;World;76010;6037;2494320;177786
2020-04-21;;World;75758;7434;2570078;185220
2020-04-22;;World;81299;7042;2651377;192262
2020-04-23;;World;84291;7034;2735668;199296
2020-04-24;;World;84096;6954;2819764;206250
2020-04-25;;World;82243;5855;2902007;212105
2020-04-26;;World;71575;4246;2973582;216351
2020-04-27;;World;70204;5009;3043786;221360
2020-04-28;;World;75538;6820;3119324;228180
2020-04-29;;World;77131;6972;3196455;235152
2020-04-30;;World;83480;6058;3279935;241210
2020-05-01;;World;88357;5483;3368292;246693
2020-05-02;;World;79198;5826;3447490;252519
2020-05-03;;World;76397;3847;3523887;256366
2020-05-04;;World;77672;4603;3601559;260969
2020-05-05;;World;80499;6125;3682058;267094
2020-05-06;;World;90037;6868;3772095;273962
2020-05-07;;World;88724;5693;3860819;279655
2020-05-08;;World;90270;5914;3951089;285569
2020-05-09;;World;85263;4597;4036352;290166
2020-05-10;;World;74914;4011;4111266;294177
2020-05-11;;World;76658;3936;4187924;298113
2020-05-12;;World;84470;5904;4272394;304017
2020-05-13;;World;85005;5484;4357399;309501
2020-05-14;;World;96230;5574;4453629;315075
2020-05-15;;World;95718;5641;4549347;320716
2020-05-16;;World;94415;4557;4643762;325273
2020-05-17;;World;78047;3568;4721809;328841
2020-05-18;;World;89166;4152;4810975;332993
2020-05-19;;World;96747;5141;4907722;338134
2020-05-20;;World;101906;5195;5009628;343329
2020-05-21;;World;106647;5079;5116275;348408
2020-05-22;;World;106414;5680;5222689;354088
2020-05-23;;World;104792;4312;5327481;358400
2020-05-24;;World;94221;3477;5421702;361877
2020-05-25;;World;86706;1616;5508408;363493
2020-05-26;;World;93980;4664;5602388;368157
2020-05-27;;World;102764;5401;5705152;373558
2020-05-28;;World;119281;5011;5824433;378569
2020-05-29;;World;120908;5159;5945341;383728
2020-05-30;;World;136514;4385;6081855;388113
2020-05-31;;World;106404;3158;6188259;391271
2020-06-01;;World;95973;3515;6284232;394786
2020-06-02;;World;121964;5203;6406196;399989
2020-06-03;;World;114251;5841;6520447;405830
2020-06-04;;World;130963;5439;6651410;411269
2020-06-05;;World;131226;5060;6782636;416329
2020-06-06;;World;133719;4215;6916355;420544
2020-06-07;;World;112375;3186;7028730;423730
2020-06-08;;World;102476;4166;7131206;427896
2020-06-09;;World;125059;5214;7256265;433110
2020-06-10;;World;135106;5476;7391371;438586
2020-06-11;;World;138053;5068;7529424;443654
2020-06-12;;World;128727;4809;7658151;448463
2020-06-13;;World;135293;4462;7793444;452925
2020-06-14;;World;132277;3644;7925721;456569
2020-06-15;;World;119666;3837;8045387;460406
2020-06-16;;World;142081;7140;8187468;467546
2020-06-17;;World;143754;5556;8331222;473102
2020-06-18;;World;141074;5308;8472296;478410
2020-06-19;;World;179897;6384;8652193;484794
2020-06-20;;World;157458;4519;8809651;489313
2020-06-21;;World;127704;4599;8937355;493912
2020-06-22;;World;139353;3738;9076708;497650
2020-06-23;;World;166806;5573;9243514;503223
2020-06-24;;World;172596;5541;9416110;508764
2020-06-25;;World;178390;5038;9594500;513802
2020-06-26;;World;191602;5084;9786102;518886
2020-06-27;;World;178116;4793;9964218;523679
2020-06-28;;World;163875;3515;10128093;527194
2020-06-29;;World;155363;4027;10283456;531221
2020-06-30;;World;174532;5207;10457988;536428
2020-07-01;;World;217608;5310;10675596;541738
2020-07-02;;World;209952;5423;10885548;547161
2020-07-03;;World;201375;5294;11086923;552455
2020-07-04;;World;193821;4793;11280744;557248
2020-07-05;;World;183982;3829;11464726;561077
2020-07-06;;World;163996;4238;11628722;565315
2020-07-07;;World;211369;6342;11840091;571657
2020-07-08;;World;214159;5629;12054250;577286
2020-07-09;;World;226840;5790;12281090;583076
2020-07-10;;World;232676;5631;12513766;588707
2020-07-11;;World;216466;5212;12730232;593919
2020-07-12;;World;192260;4375;12922492;598294
2020-07-13;;World;191478;4316;13113970;602610
2020-07-14;;World;222203;6017;13336173;608627
2020-07-15;;World;231438;5848;13567611;614475
2020-07-16;;World;251358;6186;13818969;620661
2020-07-17;;World;242717;7044;14061686;627705
2020-07-18;;World;236179;6573;14297865;634278
2020-07-19;;World;213414;4681;14511279;638959
2020-07-20;;World;207133;4028;14718412;642987
2020-07-21;;World;233622;6399;14952034;649386
2020-07-22;;World;279883;7356;15231917;656742
2020-07-23;;World;282859;6625;15514776;663367
2020-07-24;;World;281070;6459;15795846;669826
2020-07-25;;World;254092;6150;16049938;675976
2020-07-26;;World;213077;4327;16263015;680303
2020-07-27;;World;226462;5232;16489477;685535
2020-07-28;;World;252740;6723;16742217;692258
2020-07-29;;World;291748;7012;17033965;699270
2020-07-30;;World;280109;6642;17314074;705912
2020-07-31;;World;290737;6581;17604811;712493
2020-08-01;;World;248355;6081;17853166;718574
2020-08-02;;World;231015;4404;18084181;722978
2020-08-03;;World;206447;5066;18290628;728044
2020-08-04;;World;257915;6992;18548543;735036
2020-08-05;;World;276584;7488;18825127;742524
2020-08-06;;World;285194;6891;19110321;749415
2020-08-07;;World;282245;6695;19392566;756110
2020-08-08;;World;258533;6074;19651099;762184
2020-08-09;;World;224698;4801;19875797;766985
2020-08-10;;World;226011;5728;20101808;772713
2020-08-11;;World;257572;6614;20359380;779327
2020-08-12;;World;276638;6947;20636018;786274
2020-08-13;;World;289218;6831;20925236;793105
2020-08-14;;World;303744;6664;21228980;799769
2020-08-15;;World;247738;6005;21476718;805774
2020-08-16;;World;214490;4628;21691208;810402
2020-08-17;;World;207708;4524;21898916;814926
2020-08-18;;World;258255;7216;22157171;822142
2020-08-19;;World;279551;7121;22436722;829263
2020-08-20;;World;272555;6412;22709277;835675
2020-08-21;;World;261219;5740;22970496;841415
2020-08-22;;World;264270;5810;23234766;847225
2020-08-23;;World;206164;4260;23440930;851485
2020-08-24;;World;225228;4822;23666158;856307
2020-08-25;;World;243995;6641;23910153;862948
2020-08-26;;World;283799;6559;24193952;869507
2020-08-27;;World;283908;6217;24477860;875724
2020-08-28;;World;283611;5865;24761471;881589
2020-08-29;;World;263816;5623;25025287;887212
2020-08-30;;World;220988;4322;25246275;891534
2020-08-31;;World;262865;4380;25509140;895914
2020-09-01;;World;264907;6671;25774047;902585
2020-09-02;;World;283508;6356;26057555;908941
2020-09-03;;World;281460;6078;26339015;915019
2020-09-04;;World;314005;5889;26653020;920908
2020-09-05;;World;270061;5157;26923081;926065
2020-09-06;;World;230514;4076;27153595;930141
2020-09-07;;World;217928;9576;27371523;939717
2020-09-08;;World;242032;5109;27613555;944826
2020-09-09;;World;284814;6279;27898369;951105
2020-09-10;;World;299859;6017;28198228;957122
2020-09-11;;World;321361;6035;28519589;963157
2020-09-12;;World;286617;5058;28806206;968215
2020-09-13;;World;242740;3937;29048946;972152
2020-09-14;;World;263747;4536;29312693;976688
2020-09-15;;World;285447;6608;29598140;983296
2020-09-16;;World;304547;5954;29902687;989250
2020-09-17;;World;314879;5599;30217566;994849
2020-09-18;;World;325919;5821;30543485;1000670
2020-09-19;;World;292162;5390;30835647;1006060
2020-09-20;;World;252146;3936;31087793;1009996
2020-09-21;;World;275992;4341;31363785;1014337
2020-09-22;;World;284518;6202;31648303;1020539
2020-09-23;;World;276099;5644;31924402;1026183
2020-09-24;;World;353029;6577;32277431;1032760
2020-09-25;;World;330883;5945;32608314;1038705
2020-09-26;;World;288463;5565;32896777;1044270
2020-09-27;;World;251411;3812;33148188;1048082
2020-09-28;;World;254839;4021;33403027;1052103
2020-09-29;;World;282558;6042;33685585;1058145
2020-09-30;;World;326219;6567;34011804;1064712
2020-10-01;;World;318300;8803;34330104;1073515
2020-10-02;;World;297854;5047;34627958;1078562
2020-10-03;;World;332086;5449;34960044;1084011
2020-10-04;;World;261420;4006;35221464;1088017
2020-10-05;;World;300950;6997;35522414;1095014
2020-10-06;;World;326552;5852;35848966;1100866
2020-10-07;;World;350991;5927;36199957;1106793
2020-10-08;;World;361333;6364;36561290;1113157
2020-10-09;;World;360900;6213;36922190;1119370
2020-10-10;;World;357136;4915;37279326;1124285
2020-10-11;;World;286952;4098;37566278;1128383
2020-10-12;;World;291698;4070;37857976;1132453
2020-10-13;;World;319242;5378;38177218;1137831
2020-10-14;;World;382347;6218;38559565;1144049
2020-10-15;;World;406976;6088;38966541;1150137
2020-10-16;;World;411772;6328;39378313;1156465
2020-10-17;;World;372680;5673;39750993;1162138
2020-10-18;;World;316590;3609;40067583;1165747
2020-10-19;;World;387175;4909;40454758;1170656
2020-10-20;;World;388987;6633;40843745;1177289
2020-10-21;;World;444908;6710;41288653;1183999
2020-10-22;;World;472729;5934;41761382;1189933
2020-10-23;;World;496782;7082;42258164;1197015
2020-10-24;;World;456822;5884;42714986;1202899
2020-10-25;;World;360717;4199;43075703;1207098
2020-10-26;;World;486318;5610;43562021;1212708
2020-10-27;;World;470228;7448;44032249;1220156
2020-10-28;;World;511894;7211;44544143;1227367
2020-10-29;;World;550382;7147;45094525;1234514
2020-10-30;;World;571079;7656;45665604;1242170
2020-10-31;;World;476824;6668;46142428;1248838
2020-11-01;;World;462436;5042;46604864;1253880
2020-11-02;;World;563030;6219;47167894;1260099
2020-11-03;;World;553827;9448;47721721;1269547
2020-11-04;;World;511485;10155;48233206;1279702
2020-11-05;;World;596571;8085;48829777;1287787
2020-11-06;;World;644882;9748;49474659;1297535
2020-11-07;;World;596952;7655;50071611;1305190
2020-11-08;;World;484072;5929;50555683;1311119
2020-11-09;;World;501393;7270;51057076;1318389
2020-11-10;;World;559385;10040;51616461;1328429
2020-11-11;;World;648730;10504;52265191;1338933
2020-11-12;;World;649454;9823;52914645;1348756
2020-11-13;;World;652082;9648;53566727;1358404
2020-11-14;;World;595135;9164;54161862;1367568
2020-11-15;;World;474073;6458;54635935;1374026
2020-11-16;;World;534136;7973;55170071;1381999
2020-11-17;;World;611256;11122;55781327;1393121
2020-11-18;;World;627177;11471;56408504;1404592
2020-11-19;;World;653547;11129;57062051;1415721
2020-11-20;;World;668780;11838;57730831;1427559
2020-11-21;;World;587726;8975;58318557;1436534
2020-11-22;;World;488144;7303;58806701;1443837
2020-11-23;;World;524959;8565;59331660;1452402
2020-11-24;;World;590291;12718;59921951;1465120
2020-11-25;;World;636340;12186;60558291;1477306
2020-11-26;;World;582679;10982;61140970;1488288
2020-11-27;;World;686893;11390;61827863;1499678
2020-11-28;;World;586159;9279;62414022;1508957
2020-11-29;;World;488677;7211;62902699;1516168
2020-11-30;;World;508392;8967;63411091;1525135
2020-12-01;;World;612217;12760;64023308;1537895
2020-12-02;;World;651735;12691;64675043;1550586
2020-12-03;;World;694136;12563;65369179;1563149
2020-12-04;;World;683135;12603;66052314;1575752
2020-12-05;;World;642432;10277;66694746;1586029
2020-12-06;;World;538995;7491;67233741;1593520
2020-12-07;;World;519570;8779;67753311;1602299
2020-12-08;;World;643488;12392;68396799;1614691
2020-12-09;;World;670020;12676;69066819;1627367
2020-12-10;;World;674901;12699;70564945;1640066
2020-12-11;;World;704609;13122;71269554;1653188
2020-12-12;;World;635062;10629;71904616;1663817
2020-12-13;;World;531106;7586;72435722;1671403
2020-12-14;;World;524880;9145;72960602;1680548
2020-12-15;;World;636192;13992;73596794;1694540
2020-12-16;;World;733670;13766;74330464;1708306
2020-12-17;;World;739757;13455;75070221;1721761
2020-12-18;;World;720325;12926;75790546;1734687
2020-12-19;;World;611449;10887;76401995;1745574
2020-12-20;;World;533669;7879;76935664;1753453
2020-12-21;;World;548951;9705;77484615;1763158
2020-12-22;;World;650357;14370;78134972;1777528
2020-12-23;;World;695128;13895;78830100;1791423
2020-12-24;;World;666591;11749;79496691;1803172
2020-12-25;;World;465784;8627;79962475;1811799
2020-12-26;;World;512730;7478;80475205;1819277
2020-12-27;;World;438663;7549;80913868;1826826
2020-12-28;;World;495841;9790;81409709;1836616
2020-12-29;;World;664584;15259;82074293;1851875
2020-12-30;;World;761247;15357;82835540;1867232
2020-12-31;;World;724942;13218;83560482;1880450
2021-01-01;;World;533306;9829;84093788;1890279
2021-01-02;;World;626511;8586;84720299;1898865
2021-01-03;;World;532903;7452;85253202;1906317
2021-01-04;;World;553841;10264;85807043;1916581
2021-01-05;;World;740053;15540;86547096;1932121
2021-01-06;;World;783565;15117;87330661;1947238
2021-01-07;;World;880884;15122;88211545;1962360
2021-01-08;;World;803264;15254;89014809;1977614
2021-01-09;;World;761266;13017;89776075;1990631
2021-01-10;;World;589301;8571;90365376;1999202
2021-01-11;;World;619600;10353;90984976;2009555
2021-01-12;;World;705555;17300;91690531;2026855
2021-01-13;;World;748327;16869;92438858;2043724
2021-01-14;;World;755287;15687;93194145;2059411
2021-01-15;;World;767236;15127;93961381;2074538
2021-01-16;;World;639322;13599;94600703;2088137
2021-01-17;;World;529361;8883;95130064;2097020
2021-01-18;;World;515248;9766;95645312;2106786
2021-01-19;;World;607936;16965;96253248;2123751
2021-01-20;;World;692962;18050;96946210;2141801
2021-01-21;;World;656361;17164;97602571;2158965
2021-01-22;;World;659068;16231;98261639;2175196
2021-01-23;;World;568270;13740;98829909;2188936
2021-01-24;;World;445790;9126;99275699;2198062
2021-01-25;;World;497048;11234;99772747;2209296
2021-01-26;;World;556324;17614;100329071;2226910
2021-01-27;;World;598377;17192;100927448;2244102
2021-01-28;;World;614445;17155;101541893;2261257
2021-01-29;;World;590488;15485;102132381;2276742
2021-01-30;;World;515477;13535;102647858;2290277
2021-01-31;;World;381794;8554;103029652;2298831
2021-02-01;;World;446547;10683;103476199;2309514
2021-02-02;;World;457927;15297;103934126;2324811
2021-02-03;;World;522031;16116;104456157;2340927
2021-02-04;;World;466938;12915;104923095;2353842
2021-02-05;;World;535453;17174;105458548;2371016
2021-02-06;;World;372314;10417;105830862;2381433
2021-02-07;;World;398176;8194;106229038;2389627
2021-02-08;;World;316016;8990;106545054;2398617
2021-02-09;;World;427666;16041;106972720;2414658
2021-02-10;;World;435814;13913;107408534;2428571
2021-02-11;;World;441469;13736;107850003;2442307
2021-02-12;;World;428721;13137;108278724;2455444
2021-02-13;;World;373398;10320;108652122;2465764
2021-02-14;;World;293964;6595;108946086;2472359
2021-02-15;;World;283259;7404;109229345;2479763
2021-02-16;;World;350799;11600;109580144;2491363
2021-02-17;;World;395576;11896;109975720;2503259
2021-02-18;;World;403503;11842;110379223;2515101
2021-02-19;;World;412504;11712;110791727;2526813
2021-02-20;;World;370626;8850;111162353;2535663
2021-02-21;;World;314518;6368;111476871;2542031
2021-02-22;;World;288377;7434;111765248;2549465
2021-02-23;;World;388860;11719;112154108;2561184
2021-02-24;;World;444953;12419;112599061;2573603
2021-02-25;;World;447481;10651;113046542;2584254
2021-02-26;;World;443042;10706;113489584;2594960
2021-02-27;;World;389281;8632;113878865;2603592
2021-02-28;;World;303574;6119;114182439;2609711
2021-03-01;;World;305733;7876;114488172;2617587
2021-03-02;;World;310326;10376;114798498;2627963
2021-03-03;;World;441140;11734;115239638;2639697
2021-03-04;;World;453058;10292;115692696;2649989
2021-03-05;;World;447022;10678;116139718;2660667
2021-03-06;;World;410584;8096;116550302;2668763
2021-03-07;;World;368378;5905;116918680;2674668
2021-03-08;;World;298604;7087;117217284;2681755
2021-03-09;;World;414690;10648;117631974;2692403
2021-03-10;;World;467054;10062;118099028;2702465
2021-03-11;;World;476893;10212;118575921;2712677
2021-03-12;;World;489318;10124;119065239;2722801
2021-03-13;;World;454215;8434;119519454;2731235
2021-03-14;;World;360442;5963;119879896;2737198
2021-03-15;;World;348776;7457;120228672;2744655
2021-03-16;;World;473064;10570;120701736;2755225
2021-03-17;;World;539429;10295;121241165;2765520
2021-03-18;;World;553560;11038;121794725;2776558
2021-03-19;;World;561701;11093;122356426;2787651
2021-03-20;;World;498965;8700;122855391;2796351
2021-03-21;;World;423369;5869;123278760;2802220
2021-03-22;;World;416664;8040;123695424;2810260
2021-03-23;;World;514330;11506;124209754;2821766
2021-03-24;;World;633559;10427;124843313;2832193
2021-03-25;;World;651431;11679;125494744;2843872
2021-03-26;;World;641407;12893;126136151;2856765
2021-03-27;;World;584734;10132;126720885;2866897
2021-03-28;;World;470084;7240;127190969;2874137
2021-03-29;;World;458249;8462;127649218;2882599
2021-03-30;;World;568453;12095;128217671;2894694
2021-03-31;;World;682931;12844;128900602;2907538
2021-04-01;;World;711861;12411;129612463;2919949
2021-04-02;;World;633795;10680;130246258;2930629
2021-04-03;;World;529637;9132;130775895;2939761
2021-04-04;;World;552964;7383;131328859;2947144
2021-04-05;;World;489309;7726;131818168;2954870
2021-04-06;;World;604217;12620;132422385;2967490
2021-04-07;;World;684329;15338;133106714;2982828
2021-04-08;;World;839866;14833;133946580;2997661
2021-04-09;;World;748057;13898;134694637;3011559
2021-04-10;;World;664659;12860;135359296;3024419
2021-04-11;;World;690870;9381;136050166;3033800
2021-04-12;;World;616470;9885;136666636;3043685
2021-04-13;;World;779655;13834;137446291;3057519
2021-04-14;;World;817053;14100;138263344;3071619
2021-04-15;;World;816780;13674;139080124;3085293
2021-04-16;;World;854935;13249;139935059;3098542
2021-04-17;;World;788201;12552;140723260;3111094
2021-04-18;;World;685598;9060;141408858;3120154
2021-04-19;;World;693594;10893;142102452;3131047
2021-04-20;;World;854101;14314;142956553;3145361
2021-04-21;;World;889973;14959;143846526;3160320
2021-04-22;;World;899776;13893;144746302;3174213
2021-04-23;;World;903759;15192;145650061;3189405
2021-04-24;;World;821072;13288;146471133;3202693
2021-04-25;;World;722444;10428;147193577;3213121
2021-04-26;;World;682661;11651;147876238;3224772
2021-04-27;;World;844450;14963;148720688;3239735
2021-04-28;;World;906017;16051;149626705;3255786
2021-04-29;;World;897654;15760;150524359;3271546
2021-04-30;;World;879011;14018;151403370;3285564
2021-05-01;;World;796767;13267;152200137;3298831
2021-05-02;;World;674384;10027;152874521;3308858
2021-05-03;;World;681521;11802;153556042;3320660
2021-05-04;;World;807426;14064;154363468;3334724
2021-05-05;;World;841193;14884;155204661;3349608
2021-05-06;;World;870015;14652;156074676;3364260
2021-05-07;;World;832399;14399;156907075;3378659
2021-05-08;;World;785728;13301;157692803;3391960
2021-05-09;;World;641574;10210;158334377;3402170
2021-05-10;;World;621829;11125;158956206;3413295
2021-05-11;;World;738484;14243;159694690;3427538
2021-05-12;;World;760047;13856;160454737;3441394
2021-05-13;;World;725264;13688;161180001;3455082
2021-05-14;;World;718022;13066;161898023;3468148
2021-05-15;;World;628023;12207;162526046;3480355
2021-05-16;;World;548592;10058;163074638;3490413
2021-05-17;;World;540028;11206;163614666;3501619
2021-05-18;;World;622520;14201;164237186;3515820
2021-05-19;;World;671626;13573;164908812;3529393
2021-05-20;;World;628615;13061;165188760;3542454
2021-05-21;;World;626015;13011;165814775;3555465
2021-05-22;;World;578199;11539;166392974;3567004
2021-05-23;;World;476537;9759;166869511;3576763
2021-05-24;;World;454539;9056;167324050;3585819
2021-05-25;;World;532181;13189;167856231;3599008
2021-05-26;;World;568585;12739;168424816;3611747
2021-05-27;;World;554723;13053;168979539;3624800
2021-05-28;;World;500286;11966;169479825;3636766
2021-05-29;;World;481316;10754;169961141;3647520
2021-05-30;;World;391426;8124;170352567;3655644
2021-05-31;;World;378904;8718;170731471;3664362
2021-06-01;;World;463722;15346;171195193;3679708
2021-06-02;;World;485707;11816;171680900;3691524
2021-06-03;;World;489217;9926;172170117;3701450
2021-06-04;;World;419795;10972;172589912;3712422
2021-06-05;;World;398267;9164;172988179;3721586
2021-06-06;;World;322691;7073;173310870;3728659
2021-06-07;;World;321305;8081;173632175;3736740
2021-06-08;;World;366820;10380;173998995;3747120
2021-06-09;;World;419492;10461;174418487;3757581
2021-06-10;;World;449506;16006;174867993;3773587
2021-06-11;;World;421253;11934;175289246;3785521
2021-06-12;;World;371903;9762;175661149;3795283
2021-06-13;;World;302918;9147;175964067;3804430
2021-06-14;;World;308518;7885;176272585;3812315
2021-06-15;;World;371501;10558;176644086;3822873
2021-06-16;;World;398534;10339;177042620;3833212
2021-06-17;;World;392496;9267;177435116;3842479
2021-06-18;;World;405931;9209;177841047;3851688
2021-06-19;;World;347447;8073;178188494;3859761
2021-06-20;;World;300324;6561;178488818;3866322
2021-06-21;;World;297341;7076;178786159;3873398
2021-06-22;;World;372137;8935;179158296;3882333
2021-06-23;;World;437255;9523;179595551;3891856
2021-06-24;;World;403842;8612;179999393;3900468
2021-06-25;;World;421740;9214;180421133;3909682
2021-06-26;;World;362819;7464;180783952;3917146
2021-06-27;;World;309889;5947;181093841;3923093
2021-06-28;;World;331944;6646;181425785;3929739
2021-06-29;;World;384746;8129;181810531;3937868
2021-06-30;;World;391839;9152;182202370;3947020
2021-07-01;;World;439021;8659;182641391;3955679
2020-04-10;YE;Yemen;1;0;1;0
2020-04-11;YE;Yemen;0;0;1;0
2020-04-12;YE;Yemen;0;0;1;0
2020-04-13;YE;Yemen;0;0;1;0
2020-04-14;YE;Yemen;0;0;1;0
2020-04-15;YE;Yemen;0;0;1;0
2020-04-16;YE;Yemen;0;0;1;0
2020-04-17;YE;Yemen;0;0;1;0
2020-04-18;YE;Yemen;0;0;1;0
2020-04-19;YE;Yemen;0;0;1;0
2020-04-20;YE;Yemen;0;0;1;0
2020-04-21;YE;Yemen;0;0;1;0
2020-04-22;YE;Yemen;0;0;1;0
2020-04-23;YE;Yemen;0;0;1;0
2020-04-24;YE;Yemen;0;0;1;0
2020-04-25;YE;Yemen;0;0;1;0
2020-04-26;YE;Yemen;0;0;1;0
2020-04-27;YE;Yemen;0;0;1;0
2020-04-28;YE;Yemen;0;0;1;0
2020-04-29;YE;Yemen;5;0;6;0
2020-04-30;YE;Yemen;0;2;6;2
2020-05-01;YE;Yemen;1;0;7;2
2020-05-02;YE;Yemen;3;0;10;2
2020-05-03;YE;Yemen;0;0;10;2
2020-05-04;YE;Yemen;2;0;12;2
2020-05-05;YE;Yemen;9;1;21;3
2020-05-06;YE;Yemen;4;2;25;5
2020-05-07;YE;Yemen;0;0;25;5
2020-05-08;YE;Yemen;9;0;34;5
2020-05-09;YE;Yemen;0;2;34;7
2020-05-10;YE;Yemen;17;1;51;8
2020-05-11;YE;Yemen;5;1;56;9
2020-05-12;YE;Yemen;9;1;65;10
2020-05-13;YE;Yemen;5;2;70;12
2020-05-14;YE;Yemen;15;0;85;12
2020-05-15;YE;Yemen;21;3;106;15
2020-05-16;YE;Yemen;16;3;122;18
2020-05-17;YE;Yemen;6;2;128;20
2020-05-18;YE;Yemen;2;0;130;20
2020-05-19;YE;Yemen;37;8;167;28
2020-05-20;YE;Yemen;13;1;180;29
2020-05-21;YE;Yemen;13;4;193;33
2020-05-22;YE;Yemen;12;0;205;33
2020-05-23;YE;Yemen;7;6;212;39
2020-05-24;YE;Yemen;10;3;222;42
2020-05-25;YE;Yemen;11;2;233;44
2020-05-26;YE;Yemen;16;5;249;49
2020-05-27;YE;Yemen;6;4;255;53
2020-05-28;YE;Yemen;23;4;278;57
2020-05-29;YE;Yemen;5;8;283;65
2020-05-30;YE;Yemen;27;12;310;77
2020-05-31;YE;Yemen;13;3;323;80
2020-06-01;YE;Yemen;31;4;354;84
2020-06-02;YE;Yemen;45;3;399;87
2020-06-03;YE;Yemen;20;8;419;95
2020-06-04;YE;Yemen;34;8;453;103
2020-06-05;YE;Yemen;16;8;469;111
2020-06-06;YE;Yemen;13;0;482;111
2020-06-07;YE;Yemen;2;1;484;112
2020-06-08;YE;Yemen;12;0;496;112
2020-06-09;YE;Yemen;28;15;524;127
2020-06-10;YE;Yemen;36;2;560;129
2020-06-11;YE;Yemen;31;7;591;136
2020-06-12;YE;Yemen;41;3;632;139
2020-06-13;YE;Yemen;73;21;705;160
2020-06-14;YE;Yemen;23;4;728;164
2020-06-15;YE;Yemen;116;44;844;208
2020-06-16;YE;Yemen;41;6;885;214
2020-06-17;YE;Yemen;17;30;902;244
2020-06-18;YE;Yemen;7;4;909;248
2020-06-19;YE;Yemen;10;3;919;251
2020-06-20;YE;Yemen;3;3;922;254
2020-06-21;YE;Yemen;19;2;941;256
2020-06-22;YE;Yemen;26;1;967;257
2020-06-23;YE;Yemen;25;4;992;261
2020-06-24;YE;Yemen;23;13;1015;274
2020-06-25;YE;Yemen;61;14;1076;288
2020-06-26;YE;Yemen;13;5;1089;293
2020-06-27;YE;Yemen;14;3;1103;296
2020-06-28;YE;Yemen;15;6;1118;302
2020-06-29;YE;Yemen;10;2;1128;304
2020-06-30;YE;Yemen;30;8;1158;312
2020-07-01;YE;Yemen;32;6;1190;318
2020-07-02;YE;Yemen;31;7;1221;325
2020-07-03;YE;Yemen;19;10;1240;335
2020-07-04;YE;Yemen;8;2;1248;337
2020-07-05;YE;Yemen;17;1;1265;338
2020-07-06;YE;Yemen;25;7;1290;345
2020-07-07;YE;Yemen;7;3;1297;348
2020-07-08;YE;Yemen;21;3;1318;351
2020-07-09;YE;Yemen;38;10;1356;361
2020-07-10;YE;Yemen;24;3;1380;364
2020-07-11;YE;Yemen;9;1;1389;365
2020-07-12;YE;Yemen;76;52;1465;417
2020-07-13;YE;Yemen;33;7;1498;424
2020-07-14;YE;Yemen;18;5;1516;429
2020-07-15;YE;Yemen;10;4;1526;433
2020-07-16;YE;Yemen;26;5;1552;438
2020-07-17;YE;Yemen;24;2;1576;440
2020-07-18;YE;Yemen;5;3;1581;443
2020-07-19;YE;Yemen;25;2;1606;445
2020-07-20;YE;Yemen;13;2;1619;447
2020-07-21;YE;Yemen;10;9;1629;456
2020-07-22;YE;Yemen;11;2;1640;458
2020-07-23;YE;Yemen;14;3;1654;461
2020-07-24;YE;Yemen;20;8;1674;469
2020-07-25;YE;Yemen;0;5;1674;474
2020-07-26;YE;Yemen;7;5;1681;479
2020-07-27;YE;Yemen;10;4;1691;483
2020-07-28;YE;Yemen;12;1;1703;484
2020-07-29;YE;Yemen;8;1;1711;485
2020-07-30;YE;Yemen;15;2;1726;487
2020-07-31;YE;Yemen;2;6;1728;493
2020-08-01;YE;Yemen;2;1;1730;494
2020-08-02;YE;Yemen;4;3;1734;497
2020-08-03;YE;Yemen;0;2;1734;499
2020-08-04;YE;Yemen;26;7;1760;506
2020-08-05;YE;Yemen;3;2;1763;508
2020-08-06;YE;Yemen;5;0;1768;508
2020-08-07;YE;Yemen;28;4;1796;512
2020-08-08;YE;Yemen;1;0;1797;512
2020-08-09;YE;Yemen;7;3;1804;515
2020-08-10;YE;Yemen;28;3;1832;518
2020-08-11;YE;Yemen;-1;5;1831;523
2020-08-12;YE;Yemen;10;5;1841;528
2020-08-13;YE;Yemen;6;0;1847;528
2020-08-14;YE;Yemen;11;0;1858;528
2020-08-15;YE;Yemen;0;0;1858;528
2020-08-16;YE;Yemen;11;2;1869;530
2020-08-17;YE;Yemen;0;5;1869;535
2020-08-18;YE;Yemen;20;2;1889;537
2020-08-19;YE;Yemen;3;2;1892;539
2020-08-20;YE;Yemen;7;2;1899;541
2020-08-21;YE;Yemen;7;1;1906;542
2020-08-22;YE;Yemen;1;4;1907;546
2020-08-23;YE;Yemen;4;7;1911;553
2020-08-24;YE;Yemen;5;2;1916;555
2020-08-25;YE;Yemen;8;2;1924;557
2020-08-26;YE;Yemen;6;3;1930;560
2020-08-27;YE;Yemen;3;2;1933;562
2020-08-28;YE;Yemen;10;1;1943;563
2020-08-29;YE;Yemen;3;0;1946;563
2020-08-30;YE;Yemen;7;1;1953;564
2020-08-31;YE;Yemen;5;2;1958;566
2020-09-01;YE;Yemen;4;4;1962;570
2020-09-02;YE;Yemen;14;1;1976;571
2020-09-03;YE;Yemen;3;0;1979;571
2020-09-04;YE;Yemen;4;1;1983;572
2020-09-05;YE;Yemen;0;0;1983;572
2020-09-06;YE;Yemen;4;0;1987;572
2020-09-07;YE;Yemen;2;1;1989;573
2020-09-08;YE;Yemen;5;3;1994;576
2020-09-09;YE;Yemen;5;0;1999;576
2020-09-10;YE;Yemen;4;4;2003;580
2020-09-11;YE;Yemen;4;2;2007;582
2020-09-12;YE;Yemen;2;0;2009;582
2020-09-13;YE;Yemen;2;1;2011;583
2020-09-14;YE;Yemen;2;0;2013;583
2020-09-15;YE;Yemen;3;0;2016;583
2020-09-16;YE;Yemen;3;0;2019;583
2020-09-17;YE;Yemen;3;2;2022;585
2020-09-18;YE;Yemen;2;0;2024;585
2020-09-19;YE;Yemen;2;0;2026;585
2020-09-20;YE;Yemen;0;1;2026;586
2020-09-21;YE;Yemen;2;0;2028;586
2020-09-22;YE;Yemen;0;0;2028;586
2020-09-23;YE;Yemen;1;0;2029;586
2020-09-24;YE;Yemen;0;0;2029;586
2020-09-25;YE;Yemen;0;1;2029;587
2020-09-26;YE;Yemen;1;0;2030;587
2020-09-27;YE;Yemen;0;0;2030;587
2020-09-28;YE;Yemen;1;0;2031;587
2020-09-29;YE;Yemen;0;0;2031;587
2020-09-30;YE;Yemen;3;0;2034;587
2020-10-01;YE;Yemen;5;0;2039;587
2020-10-02;YE;Yemen;1;2;2040;589
2020-10-03;YE;Yemen;1;0;2041;589
2020-10-04;YE;Yemen;0;2;2041;591
2020-10-05;YE;Yemen;0;1;2041;592
2020-10-06;YE;Yemen;6;1;2047;593
2020-10-07;YE;Yemen;2;0;2049;593
2020-10-08;YE;Yemen;1;0;2050;593
2020-10-09;YE;Yemen;1;0;2051;593
2020-10-10;YE;Yemen;0;2;2051;595
2020-10-11;YE;Yemen;1;0;2052;595
2020-10-12;YE;Yemen;0;1;2052;596
2020-10-13;YE;Yemen;1;0;2053;596
2020-10-14;YE;Yemen;0;0;2053;596
2020-10-15;YE;Yemen;0;0;2053;596
2020-10-16;YE;Yemen;2;0;2055;596
2020-10-17;YE;Yemen;0;0;2055;596
2020-10-18;YE;Yemen;1;1;2056;597
2020-10-19;YE;Yemen;0;0;2056;597
2020-10-20;YE;Yemen;1;0;2057;597
2020-10-21;YE;Yemen;0;0;2057;597
2020-10-22;YE;Yemen;0;0;2057;597
2020-10-23;YE;Yemen;3;2;2060;599
2020-10-24;YE;Yemen;0;0;2060;599
2020-10-25;YE;Yemen;0;0;2060;599
2020-10-26;YE;Yemen;0;0;2060;599
2020-10-27;YE;Yemen;0;0;2060;599
2020-10-28;YE;Yemen;1;0;2061;599
2020-10-29;YE;Yemen;1;0;2062;599
2020-10-30;YE;Yemen;0;0;2062;599
2020-10-31;YE;Yemen;1;0;2063;599
2020-11-01;YE;Yemen;0;1;2063;600
2020-11-02;YE;Yemen;0;1;2063;601
2020-11-03;YE;Yemen;0;0;2063;601
2020-11-04;YE;Yemen;0;0;2063;601
2020-11-05;YE;Yemen;0;0;2063;601
2020-11-06;YE;Yemen;0;0;2063;601
2020-11-07;YE;Yemen;0;0;2063;601
2020-11-08;YE;Yemen;0;0;2063;601
2020-11-09;YE;Yemen;0;0;2063;601
2020-11-10;YE;Yemen;0;0;2063;601
2020-11-11;YE;Yemen;0;0;2063;601
2020-11-12;YE;Yemen;5;1;2068;602
2020-11-13;YE;Yemen;0;0;2068;602
2020-11-14;YE;Yemen;0;0;2068;602
2020-11-15;YE;Yemen;0;1;2068;603
2020-11-16;YE;Yemen;0;0;2068;603
2020-11-17;YE;Yemen;0;0;2068;603
2020-11-18;YE;Yemen;0;0;2068;603
2020-11-19;YE;Yemen;0;1;2068;604
2020-11-20;YE;Yemen;1;0;2069;604
2020-11-21;YE;Yemen;0;0;2069;604
2020-11-22;YE;Yemen;0;0;2069;604
2020-11-23;YE;Yemen;3;0;2072;604
2020-11-24;YE;Yemen;1;0;2073;604
2020-11-25;YE;Yemen;0;0;2073;604
2020-11-26;YE;Yemen;1;0;2074;604
2020-11-27;YE;Yemen;0;0;2074;604
2020-11-28;YE;Yemen;0;0;2074;604
2020-11-29;YE;Yemen;3;1;2077;605
2020-11-30;YE;Yemen;0;0;2077;605
2020-12-01;YE;Yemen;0;0;2077;605
2020-12-02;YE;Yemen;0;0;2077;605
2020-12-03;YE;Yemen;0;1;2077;606
2020-12-04;YE;Yemen;0;0;2077;606
2020-12-05;YE;Yemen;0;0;2077;606
2020-12-06;YE;Yemen;1;0;2078;606
2020-12-07;YE;Yemen;0;0;2078;606
2020-12-08;YE;Yemen;1;0;2079;606
2020-12-09;YE;Yemen;0;0;2079;606
2020-12-10;YE;Yemen;2;0;2081;606
2020-12-11;YE;Yemen;1;0;2082;606
2020-12-12;YE;Yemen;1;0;2083;606
2020-12-13;YE;Yemen;0;0;2083;606
2020-12-14;YE;Yemen;1;0;2084;606
2020-12-15;YE;Yemen;1;0;2085;606
2020-12-16;YE;Yemen;0;0;2085;606
2020-12-17;YE;Yemen;2;0;2087;606
2020-12-18;YE;Yemen;0;0;2087;606
2020-12-19;YE;Yemen;0;0;2087;606
2020-12-20;YE;Yemen;0;0;2087;606
2020-12-21;YE;Yemen;0;0;2087;606
2020-12-22;YE;Yemen;0;0;2087;606
2020-12-23;YE;Yemen;0;0;2087;606
2020-12-24;YE;Yemen;5;0;2092;606
2020-12-25;YE;Yemen;0;0;2092;606
2020-12-26;YE;Yemen;0;0;2092;606
2020-12-27;YE;Yemen;2;1;2094;607
2020-12-28;YE;Yemen;2;1;2096;608
2020-12-29;YE;Yemen;0;2;2096;610
2020-12-30;YE;Yemen;1;0;2097;610
2020-12-31;YE;Yemen;2;0;2099;610
2021-01-01;YE;Yemen;2;0;2101;610
2021-01-02;YE;Yemen;0;0;2101;610
2021-01-03;YE;Yemen;0;0;2101;610
2021-01-04;YE;Yemen;0;0;2101;610
2021-01-05;YE;Yemen;0;0;2101;610
2021-01-06;YE;Yemen;1;0;2102;610
2021-01-07;YE;Yemen;2;0;2104;610
2021-01-08;YE;Yemen;0;0;2104;610
2021-01-09;YE;Yemen;0;0;2104;610
2021-01-10;YE;Yemen;0;1;2104;611
2021-01-11;YE;Yemen;1;1;2105;612
2021-01-12;YE;Yemen;2;0;2107;612
2021-01-13;YE;Yemen;2;0;2109;612
2021-01-14;YE;Yemen;1;0;2110;612
2021-01-15;YE;Yemen;1;0;2111;612
2021-01-16;YE;Yemen;1;0;2112;612
2021-01-17;YE;Yemen;0;0;2112;612
2021-01-18;YE;Yemen;1;0;2113;612
2021-01-19;YE;Yemen;2;0;2115;612
2021-01-20;YE;Yemen;0;0;2115;612
2021-01-21;YE;Yemen;0;2;2115;614
2021-01-22;YE;Yemen;3;0;2118;614
2021-01-23;YE;Yemen;0;1;2118;615
2021-01-24;YE;Yemen;0;0;2118;615
2021-01-25;YE;Yemen;0;0;2118;615
2021-01-26;YE;Yemen;1;0;2119;615
2021-01-27;YE;Yemen;1;0;2120;615
2021-01-28;YE;Yemen;0;0;2120;615
2021-01-29;YE;Yemen;0;0;2120;615
2021-01-30;YE;Yemen;0;0;2120;615
2021-01-31;YE;Yemen;1;0;2121;615
2021-02-01;YE;Yemen;1;0;2122;615
2021-02-02;YE;Yemen;0;0;2122;615
2021-02-03;YE;Yemen;0;0;2122;615
2021-02-04;YE;Yemen;0;0;2122;615
2021-02-05;YE;Yemen;2;0;2124;615
2021-02-06;YE;Yemen;3;0;2127;615
2021-02-07;YE;Yemen;0;0;2127;615
2021-02-08;YE;Yemen;4;0;2131;615
2021-02-09;YE;Yemen;0;0;2131;615
2021-02-10;YE;Yemen;2;1;2133;616
2021-02-11;YE;Yemen;1;0;2134;616
2021-02-12;YE;Yemen;2;0;2136;616
2021-02-13;YE;Yemen;0;0;2136;616
2021-02-14;YE;Yemen;9;1;2145;617
2021-02-15;YE;Yemen;0;0;2145;617
2021-02-16;YE;Yemen;3;1;2148;618
2021-02-17;YE;Yemen;3;0;2151;618
2021-02-18;YE;Yemen;3;0;2154;618
2021-02-19;YE;Yemen;3;0;2157;618
2021-02-20;YE;Yemen;0;0;2157;618
2021-02-21;YE;Yemen;8;1;2165;619
2021-02-22;YE;Yemen;11;0;2176;619
2021-02-23;YE;Yemen;11;1;2187;620
2021-02-24;YE;Yemen;34;4;2221;624
2021-02-25;YE;Yemen;34;1;2255;625
2021-02-26;YE;Yemen;12;2;2267;627
2021-02-27;YE;Yemen;2;4;2269;631
2021-02-28;YE;Yemen;16;3;2285;634
2021-03-01;YE;Yemen;25;0;2310;634
2021-03-02;YE;Yemen;32;6;2342;640
2021-03-03;YE;Yemen;21;3;2363;643
2021-03-04;YE;Yemen;12;2;2375;645
2021-03-05;YE;Yemen;36;3;2411;648
2021-03-06;YE;Yemen;33;2;2444;650
2021-03-07;YE;Yemen;29;1;2473;651
2021-03-08;YE;Yemen;72;2;2545;653
2021-03-09;YE;Yemen;41;1;2586;654
2021-03-10;YE;Yemen;41;7;2627;661
2021-03-11;YE;Yemen;40;6;2667;667
2021-03-12;YE;Yemen;62;12;2729;679
2021-03-13;YE;Yemen;42;4;2771;683
2021-03-14;YE;Yemen;65;6;2836;689
2021-03-15;YE;Yemen;72;9;2908;698
2021-03-16;YE;Yemen;61;9;2969;707
2021-03-17;YE;Yemen;68;6;3037;713
2021-03-18;YE;Yemen;89;10;3126;723
2021-03-19;YE;Yemen;91;10;3217;733
2021-03-20;YE;Yemen;61;4;3278;737
2021-03-21;YE;Yemen;140;14;3418;751
2021-03-22;YE;Yemen;98;20;3516;771
2021-03-23;YE;Yemen;96;14;3612;785
2021-03-24;YE;Yemen;91;15;3703;800
2021-03-25;YE;Yemen;113;10;3816;810
2021-03-26;YE;Yemen;84;10;3900;820
2021-03-27;YE;Yemen;69;12;3969;832
2021-03-28;YE;Yemen;64;19;4033;851
2021-03-29;YE;Yemen;82;12;4115;863
2021-03-30;YE;Yemen;132;19;4247;882
2021-03-31;YE;Yemen;110;6;4357;888
2021-04-01;YE;Yemen;174;18;4531;906
2021-04-02;YE;Yemen;89;10;4620;916
2021-04-03;YE;Yemen;77;16;4697;932
2021-04-04;YE;Yemen;101;14;4798;946
2021-04-05;YE;Yemen;83;9;4881;955
2021-04-06;YE;Yemen;94;21;4975;976
2021-04-07;YE;Yemen;72;10;5047;986
2021-04-08;YE;Yemen;86;18;5133;1004
2021-04-09;YE;Yemen;100;18;5233;1022
2021-04-10;YE;Yemen;43;9;5276;1031
2021-04-11;YE;Yemen;81;18;5357;1049
2021-04-12;YE;Yemen;89;19;5446;1068
2021-04-13;YE;Yemen;61;5;5507;1073
2021-04-14;YE;Yemen;75;10;5582;1083
2021-04-15;YE;Yemen;75;14;5657;1097
2021-04-16;YE;Yemen;58;11;5715;1108
2021-04-17;YE;Yemen;55;11;5770;1119
2021-04-18;YE;Yemen;42;7;5812;1126
2021-04-19;YE;Yemen;46;6;5858;1132
2021-04-20;YE;Yemen;60;6;5918;1138
2021-04-21;YE;Yemen;42;9;5960;1147
2021-04-22;YE;Yemen;60;10;6020;1157
2021-04-23;YE;Yemen;36;8;6056;1165
2021-04-24;YE;Yemen;49;10;6105;1175
2021-04-25;YE;Yemen;32;12;6137;1187
2021-04-26;YE;Yemen;46;18;6183;1205
2021-04-27;YE;Yemen;37;2;6220;1207
2021-04-28;YE;Yemen;43;9;6263;1216
2021-04-29;YE;Yemen;31;6;6294;1222
2021-04-30;YE;Yemen;23;4;6317;1226
2021-05-01;YE;Yemen;8;3;6325;1229
2021-05-02;YE;Yemen;16;4;6341;1233
2021-05-03;YE;Yemen;22;6;6363;1239
2021-05-04;YE;Yemen;27;1;6390;1240
2021-05-05;YE;Yemen;24;20;6414;1260
2021-05-06;YE;Yemen;12;5;6426;1265
2021-05-07;YE;Yemen;20;4;6446;1269
2021-05-08;YE;Yemen;16;1;6462;1270
2021-05-09;YE;Yemen;20;1;6482;1271
2021-05-10;YE;Yemen;3;4;6485;1275
2021-05-11;YE;Yemen;7;1;6492;1276
2021-05-12;YE;Yemen;6;1;6498;1277
2021-05-13;YE;Yemen;9;1;6507;1278
2021-05-14;YE;Yemen;16;7;6523;1285
2021-05-15;YE;Yemen;15;0;6538;1285
2021-05-16;YE;Yemen;5;4;6543;1289
2021-05-17;YE;Yemen;25;5;6568;1294
2021-05-18;YE;Yemen;18;3;6586;1297
2021-05-19;YE;Yemen;7;1;6593;1298
2021-05-20;YE;Yemen;20;3;6613;1301
2021-05-21;YE;Yemen;19;1;6632;1302
2021-05-22;YE;Yemen;17;2;6649;1304
2021-05-23;YE;Yemen;9;3;6658;1307
2021-05-24;YE;Yemen;4;3;6662;1310
2021-05-25;YE;Yemen;8;1;6670;1311
2021-05-26;YE;Yemen;18;2;6688;1313
2021-05-27;YE;Yemen;8;2;6696;1315
2021-05-28;YE;Yemen;27;1;6723;1316
2021-05-29;YE;Yemen;8;3;6731;1319
2021-05-30;YE;Yemen;6;1;6737;1320
2021-05-31;YE;Yemen;5;1;6742;1321
2021-06-01;YE;Yemen;9;1;6751;1322
2021-06-02;YE;Yemen;8;1;6759;1323
2021-06-03;YE;Yemen;8;2;6767;1325
2021-06-04;YE;Yemen;6;0;6773;1325
2021-06-05;YE;Yemen;7;0;6780;1325
2021-06-06;YE;Yemen;7;4;6787;1329
2021-06-07;YE;Yemen;25;7;6812;1336
2021-06-08;YE;Yemen;11;0;6823;1336
2021-06-09;YE;Yemen;9;1;6832;1337
2021-06-10;YE;Yemen;4;1;6836;1338
2021-06-11;YE;Yemen;20;4;6856;1342
2021-06-12;YE;Yemen;1;5;6857;1347
2021-06-13;YE;Yemen;5;2;6862;1349
2021-06-14;YE;Yemen;1;1;6863;1350
2021-06-15;YE;Yemen;1;0;6864;1350
2021-06-16;YE;Yemen;3;1;6867;1351
2021-06-17;YE;Yemen;2;0;6869;1351
2021-06-18;YE;Yemen;6;1;6875;1352
2021-06-19;YE;Yemen;2;1;6877;1353
2021-06-20;YE;Yemen;8;2;6885;1355
2021-06-21;YE;Yemen;4;0;6889;1355
2021-06-22;YE;Yemen;3;0;6892;1355
2021-06-23;YE;Yemen;6;0;6898;1355
2021-06-24;YE;Yemen;7;1;6905;1356
2021-06-25;YE;Yemen;0;1;6905;1357
2021-06-26;YE;Yemen;1;1;6906;1358
2021-06-27;YE;Yemen;2;2;6908;1360
2021-06-28;YE;Yemen;1;1;6909;1361
2021-06-29;YE;Yemen;9;0;6918;1361
2021-06-30;YE;Yemen;2;0;6920;1361
2021-07-01;YE;Yemen;3;0;6923;1361
2020-03-18;ZM;Zambia;2;0;2;0
2020-03-19;ZM;Zambia;0;0;2;0
2020-03-20;ZM;Zambia;0;0;2;0
2020-03-21;ZM;Zambia;0;0;2;0
2020-03-22;ZM;Zambia;1;0;3;0
2020-03-23;ZM;Zambia;0;0;3;0
2020-03-24;ZM;Zambia;0;0;3;0
2020-03-25;ZM;Zambia;9;0;12;0
2020-03-26;ZM;Zambia;4;0;16;0
2020-03-27;ZM;Zambia;6;0;22;0
2020-03-28;ZM;Zambia;6;0;28;0
2020-03-29;ZM;Zambia;1;0;29;0
2020-03-30;ZM;Zambia;6;0;35;0
2020-03-31;ZM;Zambia;0;0;35;0
2020-04-01;ZM;Zambia;1;0;36;0
2020-04-02;ZM;Zambia;3;1;39;1
2020-04-03;ZM;Zambia;0;0;39;1
2020-04-04;ZM;Zambia;0;0;39;1
2020-04-05;ZM;Zambia;0;0;39;1
2020-04-06;ZM;Zambia;0;0;39;1
2020-04-07;ZM;Zambia;0;0;39;1
2020-04-08;ZM;Zambia;0;0;39;1
2020-04-09;ZM;Zambia;0;0;39;1
2020-04-10;ZM;Zambia;1;1;40;2
2020-04-11;ZM;Zambia;0;0;40;2
2020-04-12;ZM;Zambia;3;0;43;2
2020-04-13;ZM;Zambia;2;0;45;2
2020-04-14;ZM;Zambia;0;0;45;2
2020-04-15;ZM;Zambia;3;0;48;2
2020-04-16;ZM;Zambia;0;0;48;2
2020-04-17;ZM;Zambia;4;0;52;2
2020-04-18;ZM;Zambia;5;0;57;2
2020-04-19;ZM;Zambia;4;1;61;3
2020-04-20;ZM;Zambia;4;0;65;3
2020-04-21;ZM;Zambia;5;0;70;3
2020-04-22;ZM;Zambia;4;0;74;3
2020-04-23;ZM;Zambia;2;0;76;3
2020-04-24;ZM;Zambia;8;0;84;3
2020-04-25;ZM;Zambia;0;0;84;3
2020-04-26;ZM;Zambia;4;0;88;3
2020-04-27;ZM;Zambia;0;0;88;3
2020-04-28;ZM;Zambia;7;0;95;3
2020-04-29;ZM;Zambia;2;0;97;3
2020-04-30;ZM;Zambia;9;0;106;3
2020-05-01;ZM;Zambia;3;0;109;3
2020-05-02;ZM;Zambia;10;0;119;3
2020-05-03;ZM;Zambia;5;0;124;3
2020-05-04;ZM;Zambia;13;0;137;3
2020-05-05;ZM;Zambia;1;0;138;3
2020-05-06;ZM;Zambia;8;1;146;4
2020-05-07;ZM;Zambia;7;0;153;4
2020-05-08;ZM;Zambia;14;0;167;4
2020-05-09;ZM;Zambia;85;3;252;7
2020-05-10;ZM;Zambia;15;0;267;7
2020-05-11;ZM;Zambia;0;0;267;7
2020-05-12;ZM;Zambia;174;0;441;7
2020-05-13;ZM;Zambia;5;0;446;7
2020-05-14;ZM;Zambia;208;0;654;7
2020-05-15;ZM;Zambia;0;0;654;7
2020-05-16;ZM;Zambia;25;0;679;7
2020-05-17;ZM;Zambia;74;0;753;7
2020-05-18;ZM;Zambia;8;0;761;7
2020-05-19;ZM;Zambia;11;0;772;7
2020-05-20;ZM;Zambia;60;0;832;7
2020-05-21;ZM;Zambia;34;0;866;7
2020-05-22;ZM;Zambia;54;0;920;7
2020-05-23;ZM;Zambia;0;0;920;7
2020-05-24;ZM;Zambia;0;0;920;7
2020-05-25;ZM;Zambia;0;0;920;7
2020-05-26;ZM;Zambia;0;0;920;7
2020-05-27;ZM;Zambia;137;0;1057;7
2020-05-28;ZM;Zambia;0;0;1057;7
2020-05-29;ZM;Zambia;0;0;1057;7
2020-05-30;ZM;Zambia;0;0;1057;7
2020-05-31;ZM;Zambia;0;0;1057;7
2020-06-01;ZM;Zambia;32;0;1089;7
2020-06-02;ZM;Zambia;0;0;1089;7
2020-06-03;ZM;Zambia;0;0;1089;7
2020-06-04;ZM;Zambia;0;0;1089;7
2020-06-05;ZM;Zambia;0;0;1089;7
2020-06-06;ZM;Zambia;0;0;1089;7
2020-06-07;ZM;Zambia;0;0;1089;7
2020-06-08;ZM;Zambia;111;3;1200;10
2020-06-09;ZM;Zambia;0;0;1200;10
2020-06-10;ZM;Zambia;0;0;1200;10
2020-06-11;ZM;Zambia;0;0;1200;10
2020-06-12;ZM;Zambia;121;0;1321;10
2020-06-13;ZM;Zambia;36;0;1357;10
2020-06-14;ZM;Zambia;1;1;1358;11
2020-06-15;ZM;Zambia;24;0;1382;11
2020-06-16;ZM;Zambia;23;0;1405;11
2020-06-17;ZM;Zambia;7;0;1412;11
2020-06-18;ZM;Zambia;4;0;1416;11
2020-06-19;ZM;Zambia;14;0;1430;11
2020-06-20;ZM;Zambia;0;0;1430;11
2020-06-21;ZM;Zambia;0;0;1430;11
2020-06-22;ZM;Zambia;0;0;1430;11
2020-06-23;ZM;Zambia;47;7;1477;18
2020-06-24;ZM;Zambia;12;0;1489;18
2020-06-25;ZM;Zambia;8;0;1497;18
2020-06-26;ZM;Zambia;34;3;1531;21
2020-06-27;ZM;Zambia;0;0;1531;21
2020-06-28;ZM;Zambia;26;1;1557;22
2020-06-29;ZM;Zambia;11;0;1568;22
2020-06-30;ZM;Zambia;26;2;1594;24
2020-07-01;ZM;Zambia;38;6;1632;30
2020-07-02;ZM;Zambia;0;0;1632;30
2020-07-03;ZM;Zambia;0;0;1632;30
2020-07-04;ZM;Zambia;0;0;1632;30
2020-07-05;ZM;Zambia;0;0;1632;30
2020-07-06;ZM;Zambia;0;0;1632;30
2020-07-07;ZM;Zambia;263;12;1895;42
2020-07-08;ZM;Zambia;0;0;1895;42
2020-07-09;ZM;Zambia;0;0;1895;42
2020-07-10;ZM;Zambia;0;0;1895;42
2020-07-11;ZM;Zambia;0;0;1895;42
2020-07-12;ZM;Zambia;0;0;1895;42
2020-07-13;ZM;Zambia;0;0;1895;42
2020-07-14;ZM;Zambia;0;0;1895;42
2020-07-15;ZM;Zambia;0;0;1895;42
2020-07-16;ZM;Zambia;0;0;1895;42
2020-07-17;ZM;Zambia;915;67;2810;109
2020-07-18;ZM;Zambia;170;11;2980;120
2020-07-19;ZM;Zambia;0;0;2980;120
2020-07-20;ZM;Zambia;346;8;3326;128
2020-07-21;ZM;Zambia;60;0;3386;128
2020-07-22;ZM;Zambia;197;0;3583;128
2020-07-23;ZM;Zambia;206;6;3789;134
2020-07-24;ZM;Zambia;67;2;3856;136
2020-07-25;ZM;Zambia;472;3;4328;139
2020-07-26;ZM;Zambia;153;0;4481;139
2020-07-27;ZM;Zambia;71;1;4552;140
2020-07-28;ZM;Zambia;450;2;5002;142
2020-07-29;ZM;Zambia;247;4;5249;146
2020-07-30;ZM;Zambia;306;3;5555;149
2020-07-31;ZM;Zambia;408;2;5963;151
2020-08-01;ZM;Zambia;265;14;6228;165
2020-08-02;ZM;Zambia;119;5;6347;170
2020-08-03;ZM;Zambia;233;1;6580;171
2020-08-04;ZM;Zambia;213;2;6793;173
2020-08-05;ZM;Zambia;229;3;7022;176
2020-08-06;ZM;Zambia;142;23;7164;199
2020-08-07;ZM;Zambia;322;1;7486;200
2020-08-08;ZM;Zambia;417;3;7903;203
2020-08-09;ZM;Zambia;182;32;8085;235
2020-08-10;ZM;Zambia;125;6;8210;241
2020-08-11;ZM;Zambia;65;0;8275;241
2020-08-12;ZM;Zambia;226;5;8501;246
2020-08-13;ZM;Zambia;162;0;8663;246
2020-08-14;ZM;Zambia;358;10;9021;256
2020-08-15;ZM;Zambia;165;4;9186;260
2020-08-16;ZM;Zambia;157;0;9343;260
2020-08-17;ZM;Zambia;496;4;9839;264
2020-08-18;ZM;Zambia;142;0;9981;264
2020-08-19;ZM;Zambia;237;5;10218;269
2020-08-20;ZM;Zambia;154;5;10372;274
2020-08-21;ZM;Zambia;255;3;10627;277
2020-08-22;ZM;Zambia;204;2;10831;279
2020-08-23;ZM;Zambia;251;1;11082;280
2020-08-24;ZM;Zambia;66;0;11148;280
2020-08-25;ZM;Zambia;137;2;11285;282
2020-08-26;ZM;Zambia;91;0;11376;282
2020-08-27;ZM;Zambia;225;0;11601;282
2020-08-28;ZM;Zambia;178;1;11779;283
2020-08-29;ZM;Zambia;123;1;11902;284
2020-08-30;ZM;Zambia;123;3;12025;287
2020-08-31;ZM;Zambia;72;1;12097;288
2020-09-01;ZM;Zambia;284;2;12381;290
2020-09-02;ZM;Zambia;34;2;12415;292
2020-09-03;ZM;Zambia;108;0;12523;292
2020-09-04;ZM;Zambia;116;0;12639;292
2020-09-05;ZM;Zambia;70;0;12709;292
2020-09-06;ZM;Zambia;67;3;12776;295
2020-09-07;ZM;Zambia;60;0;12836;295
2020-09-08;ZM;Zambia;116;2;12952;297
2020-09-09;ZM;Zambia;160;3;13112;300
2020-09-10;ZM;Zambia;102;0;13214;300
2020-09-11;ZM;Zambia;109;6;13323;306
2020-09-12;ZM;Zambia;143;6;13466;312
2020-09-13;ZM;Zambia;73;0;13539;312
2020-09-14;ZM;Zambia;181;8;13720;320
2020-09-15;ZM;Zambia;99;4;13819;324
2020-09-16;ZM;Zambia;68;2;13887;326
2020-09-17;ZM;Zambia;41;0;13928;326
2020-09-18;ZM;Zambia;94;3;14022;329
2020-09-19;ZM;Zambia;48;1;14070;330
2020-09-20;ZM;Zambia;61;0;14131;330
2020-09-21;ZM;Zambia;44;1;14175;331
2020-09-22;ZM;Zambia;214;0;14389;331
2020-09-23;ZM;Zambia;54;1;14443;332
2020-09-24;ZM;Zambia;48;0;14491;332
2020-09-25;ZM;Zambia;24;0;14515;332
2020-09-26;ZM;Zambia;97;0;14612;332
2020-09-27;ZM;Zambia;29;0;14641;332
2020-09-28;ZM;Zambia;19;0;14660;332
2020-09-29;ZM;Zambia;55;0;14715;332
2020-09-30;ZM;Zambia;44;0;14759;332
2020-10-01;ZM;Zambia;43;1;14802;333
2020-10-02;ZM;Zambia;28;0;14830;333
2020-10-03;ZM;Zambia;144;0;14974;333
2020-10-04;ZM;Zambia;78;0;15052;333
2020-10-05;ZM;Zambia;37;1;15089;334
2020-10-06;ZM;Zambia;81;1;15170;335
2020-10-07;ZM;Zambia;54;0;15224;335
2020-10-08;ZM;Zambia;77;0;15301;335
2020-10-09;ZM;Zambia;38;1;15339;336
2020-10-10;ZM;Zambia;76;1;15415;337
2020-10-11;ZM;Zambia;43;0;15458;337
2020-10-12;ZM;Zambia;91;8;15549;345
2020-10-13;ZM;Zambia;38;0;15587;345
2020-10-14;ZM;Zambia;29;0;15616;345
2020-10-15;ZM;Zambia;43;1;15659;346
2020-10-16;ZM;Zambia;0;0;15659;346
2020-10-17;ZM;Zambia;130;0;15789;346
2020-10-18;ZM;Zambia;64;0;15853;346
2020-10-19;ZM;Zambia;44;0;15897;346
2020-10-20;ZM;Zambia;85;0;15982;346
2020-10-21;ZM;Zambia;18;0;16000;346
2020-10-22;ZM;Zambia;35;0;16035;346
2020-10-23;ZM;Zambia;60;0;16095;346
2020-10-24;ZM;Zambia;22;2;16117;348
2020-10-25;ZM;Zambia;0;0;16117;348
2020-10-26;ZM;Zambia;83;0;16200;348
2020-10-27;ZM;Zambia;43;0;16243;348
2020-10-28;ZM;Zambia;42;0;16285;348
2020-10-29;ZM;Zambia;40;0;16325;348
2020-10-30;ZM;Zambia;90;1;16415;349
2020-10-31;ZM;Zambia;17;0;16432;349
2020-11-01;ZM;Zambia;48;0;16480;349
2020-11-02;ZM;Zambia;63;0;16543;349
2020-11-03;ZM;Zambia;118;0;16661;349
2020-11-04;ZM;Zambia;37;0;16698;349
2020-11-05;ZM;Zambia;72;0;16770;349
2020-11-06;ZM;Zambia;49;0;16819;349
2020-11-07;ZM;Zambia;89;0;16908;349
2020-11-08;ZM;Zambia;46;0;16954;349
2020-11-09;ZM;Zambia;17;0;16971;349
2020-11-10;ZM;Zambia;26;1;16997;350
2020-11-11;ZM;Zambia;39;0;17036;350
2020-11-12;ZM;Zambia;20;0;17056;350
2020-11-13;ZM;Zambia;37;0;17093;350
2020-11-14;ZM;Zambia;4;0;17097;350
2020-11-15;ZM;Zambia;26;3;17123;353
2020-11-16;ZM;Zambia;64;0;17187;353
2020-11-17;ZM;Zambia;56;0;17243;353
2020-11-18;ZM;Zambia;37;3;17280;356
2020-11-19;ZM;Zambia;70;0;17350;356
2020-11-20;ZM;Zambia;23;0;17373;356
2020-11-21;ZM;Zambia;21;0;17394;356
2020-11-22;ZM;Zambia;30;1;17424;357
2020-11-23;ZM;Zambia;30;0;17454;357
2020-11-24;ZM;Zambia;12;0;17466;357
2020-11-25;ZM;Zambia;69;0;17535;357
2020-11-26;ZM;Zambia;18;0;17553;357
2020-11-27;ZM;Zambia;16;0;17569;357
2020-11-28;ZM;Zambia;20;0;17589;357
2020-11-29;ZM;Zambia;19;0;17608;357
2020-11-30;ZM;Zambia;39;0;17647;357
2020-12-01;ZM;Zambia;18;0;17665;357
2020-12-02;ZM;Zambia;35;0;17700;357
2020-12-03;ZM;Zambia;30;0;17730;357
2020-12-04;ZM;Zambia;127;7;17857;364
2020-12-05;ZM;Zambia;41;0;17898;364
2020-12-06;ZM;Zambia;18;0;17916;364
2020-12-07;ZM;Zambia;15;0;17931;364
2020-12-08;ZM;Zambia;32;0;17963;364
2020-12-09;ZM;Zambia;99;0;18062;364
2020-12-10;ZM;Zambia;29;0;18091;364
2020-12-11;ZM;Zambia;70;1;18161;365
2020-12-12;ZM;Zambia;56;1;18217;366
2020-12-13;ZM;Zambia;57;1;18274;367
2020-12-14;ZM;Zambia;48;0;18322;367
2020-12-15;ZM;Zambia;106;1;18428;368
2020-12-16;ZM;Zambia;28;1;18456;369
2020-12-17;ZM;Zambia;48;0;18504;369
2020-12-18;ZM;Zambia;71;4;18575;373
2020-12-19;ZM;Zambia;45;0;18620;373
2020-12-20;ZM;Zambia;96;0;18716;373
2020-12-21;ZM;Zambia;52;2;18768;375
2020-12-22;ZM;Zambia;113;4;18881;379
2020-12-23;ZM;Zambia;241;1;19122;380
2020-12-24;ZM;Zambia;112;1;19234;381
2020-12-25;ZM;Zambia;337;0;19571;381
2020-12-26;ZM;Zambia;100;1;19671;382
2020-12-27;ZM;Zambia;163;1;19834;383
2020-12-28;ZM;Zambia;109;1;19943;384
2020-12-29;ZM;Zambia;234;1;20177;385
2020-12-30;ZM;Zambia;285;1;20462;386
2020-12-31;ZM;Zambia;263;2;20725;388
2021-01-01;ZM;Zambia;272;2;20997;390
2021-01-02;ZM;Zambia;233;2;21230;392
2021-01-03;ZM;Zambia;352;2;21582;394
2021-01-04;ZM;Zambia;411;4;21993;398
2021-01-05;ZM;Zambia;652;14;22645;412
2021-01-06;ZM;Zambia;850;5;23495;417
2021-01-07;ZM;Zambia;802;6;24297;423
2021-01-08;ZM;Zambia;1029;18;25326;441
2021-01-09;ZM;Zambia;1241;23;26567;464
2021-01-10;ZM;Zambia;1161;5;27728;469
2021-01-11;ZM;Zambia;868;2;28596;471
2021-01-12;ZM;Zambia;1161;24;29757;495
2021-01-13;ZM;Zambia;1343;14;31100;509
2021-01-14;ZM;Zambia;1700;5;32800;514
2021-01-15;ZM;Zambia;1478;13;34278;527
2021-01-16;ZM;Zambia;1796;10;36074;537
2021-01-17;ZM;Zambia;1531;9;37605;546
2021-01-18;ZM;Zambia;602;13;38207;559
2021-01-19;ZM;Zambia;1308;19;39515;578
2021-01-20;ZM;Zambia;1434;7;40949;585
2021-01-21;ZM;Zambia;1264;12;42213;597
2021-01-22;ZM;Zambia;1120;13;43333;610
2021-01-23;ZM;Zambia;1259;17;44592;627
2021-01-24;ZM;Zambia;745;12;45337;639
2021-01-25;ZM;Zambia;809;21;46146;660
2021-01-26;ZM;Zambia;1476;12;47622;672
2021-01-27;ZM;Zambia;1289;16;48911;688
2021-01-28;ZM;Zambia;1408;17;50319;705
2021-01-29;ZM;Zambia;1305;23;51624;728
2021-01-30;ZM;Zambia;1728;17;53352;745
2021-01-31;ZM;Zambia;865;18;54217;763
2021-02-01;ZM;Zambia;825;17;55042;780
2021-02-02;ZM;Zambia;1191;14;56233;794
2021-02-03;ZM;Zambia;1256;10;57489;804
2021-02-04;ZM;Zambia;1514;8;59003;812
2021-02-05;ZM;Zambia;1424;16;60427;828
2021-02-06;ZM;Zambia;1000;11;61427;839
2021-02-07;ZM;Zambia;1206;14;62633;853
2021-02-08;ZM;Zambia;940;16;63573;869
2021-02-09;ZM;Zambia;1037;12;64610;881
2021-02-10;ZM;Zambia;963;20;65573;901
2021-02-11;ZM;Zambia;1025;13;66598;914
2021-02-12;ZM;Zambia;1083;17;67681;931
2021-02-13;ZM;Zambia;773;9;68454;940
2021-02-14;ZM;Zambia;983;11;69437;951
2021-02-15;ZM;Zambia;811;8;70248;959
2021-02-16;ZM;Zambia;575;15;70823;974
2021-02-17;ZM;Zambia;854;9;71677;983
2021-02-18;ZM;Zambia;790;8;72467;991
2021-02-19;ZM;Zambia;736;11;73203;1002
2021-02-20;ZM;Zambia;691;14;73894;1016
2021-02-21;ZM;Zambia;609;4;74503;1020
2021-02-22;ZM;Zambia;524;11;75027;1031
2021-02-23;ZM;Zambia;555;9;75582;1040
2021-02-24;ZM;Zambia;902;11;76484;1051
2021-02-25;ZM;Zambia;687;8;77171;1059
2021-02-26;ZM;Zambia;468;7;77639;1066
2021-02-27;ZM;Zambia;563;15;78202;1081
2021-02-28;ZM;Zambia;332;10;78534;1091
2021-03-01;ZM;Zambia;468;7;79002;1098
2021-03-02;ZM;Zambia;555;6;79557;1104
2021-03-03;ZM;Zambia;533;4;80090;1108
2021-03-04;ZM;Zambia;597;1;80687;1109
2021-03-05;ZM;Zambia;654;4;81341;1113
2021-03-06;ZM;Zambia;670;3;82011;1116
2021-03-07;ZM;Zambia;410;8;82421;1124
2021-03-08;ZM;Zambia;234;8;82655;1132
2021-03-09;ZM;Zambia;242;5;82897;1137
2021-03-10;ZM;Zambia;436;3;83333;1140
2021-03-11;ZM;Zambia;580;8;83913;1148
2021-03-12;ZM;Zambia;327;1;84240;1149
2021-03-13;ZM;Zambia;234;4;84474;1153
2021-03-14;ZM;Zambia;323;5;84797;1158
2021-03-15;ZM;Zambia;153;6;84950;1164
2021-03-16;ZM;Zambia;290;3;85240;1167
2021-03-17;ZM;Zambia;262;3;85502;1170
2021-03-18;ZM;Zambia;387;5;85889;1175
2021-03-19;ZM;Zambia;170;3;86059;1178
2021-03-20;ZM;Zambia;214;0;86273;1178
2021-03-21;ZM;Zambia;176;1;86449;1179
2021-03-22;ZM;Zambia;86;3;86535;1182
2021-03-23;ZM;Zambia;244;3;86779;1185
2021-03-24;ZM;Zambia;214;2;86993;1187
2021-03-25;ZM;Zambia;325;4;87318;1191
2021-03-26;ZM;Zambia;265;3;87583;1194
2021-03-27;ZM;Zambia;0;4;87583;1198
2021-03-28;ZM;Zambia;289;2;87872;1200
2021-03-29;ZM;Zambia;140;0;88012;1200
2021-03-30;ZM;Zambia;187;2;88199;1202
2021-03-31;ZM;Zambia;219;6;88418;1208
2021-04-01;ZM;Zambia;131;4;88549;1212
2021-04-02;ZM;Zambia;181;3;88730;1215
2021-04-03;ZM;Zambia;70;0;88800;1215
2021-04-04;ZM;Zambia;130;5;88930;1220
2021-04-05;ZM;Zambia;79;2;89009;1222
2021-04-06;ZM;Zambia;62;2;89071;1224
2021-04-07;ZM;Zambia;315;0;89386;1224
2021-04-08;ZM;Zambia;206;1;89592;1225
2021-04-09;ZM;Zambia;191;1;89783;1226
2021-04-10;ZM;Zambia;135;0;89918;1226
2021-04-11;ZM;Zambia;111;0;90029;1226
2021-04-12;ZM;Zambia;35;1;90064;1227
2021-04-13;ZM;Zambia;154;2;90218;1229
2021-04-14;ZM;Zambia;171;0;90389;1229
2021-04-15;ZM;Zambia;143;1;90532;1230
2021-04-16;ZM;Zambia;218;3;90750;1233
2021-04-17;ZM;Zambia;94;1;90844;1234
2021-04-18;ZM;Zambia;74;1;90918;1235
2021-04-19;ZM;Zambia;24;1;90942;1236
2021-04-20;ZM;Zambia;100;0;91042;1236
2021-04-21;ZM;Zambia;77;2;91119;1238
2021-04-22;ZM;Zambia;70;2;91189;1240
2021-04-23;ZM;Zambia;62;5;91251;1245
2021-04-24;ZM;Zambia;66;0;91317;1245
2021-04-25;ZM;Zambia;41;1;91358;1246
2021-04-26;ZM;Zambia;20;2;91378;1248
2021-04-27;ZM;Zambia;40;1;91418;1249
2021-04-28;ZM;Zambia;66;0;91484;1249
2021-04-29;ZM;Zambia;49;1;91533;1250
2021-04-30;ZM;Zambia;53;1;91586;1251
2021-05-01;ZM;Zambia;84;0;91670;1251
2021-05-02;ZM;Zambia;23;2;91693;1253
2021-05-03;ZM;Zambia;29;0;91722;1253
2021-05-04;ZM;Zambia;82;1;91804;1254
2021-05-05;ZM;Zambia;45;1;91849;1255
2021-05-06;ZM;Zambia;97;1;91946;1256
2021-05-07;ZM;Zambia;58;0;92004;1256
2021-05-08;ZM;Zambia;53;1;92057;1257
2021-05-09;ZM;Zambia;35;0;92092;1257
2021-05-10;ZM;Zambia;20;0;92112;1257
2021-05-11;ZM;Zambia;40;1;92152;1258
2021-05-12;ZM;Zambia;59;1;92211;1259
2021-05-13;ZM;Zambia;51;1;92262;1260
2021-05-14;ZM;Zambia;94;0;92356;1260
2021-05-15;ZM;Zambia;53;0;92409;1260
2021-05-16;ZM;Zambia;27;0;92436;1260
2021-05-17;ZM;Zambia;24;1;92460;1261
2021-05-18;ZM;Zambia;60;2;92520;1263
2021-05-19;ZM;Zambia;110;0;92630;1263
2021-05-20;ZM;Zambia;124;2;92754;1265
2021-05-21;ZM;Zambia;166;1;92920;1266
2021-05-22;ZM;Zambia;186;1;93106;1267
2021-05-23;ZM;Zambia;95;1;93201;1268
2021-05-24;ZM;Zambia;78;3;93279;1271
2021-05-25;ZM;Zambia;149;0;93428;1271
2021-05-26;ZM;Zambia;199;2;93627;1273
2021-05-27;ZM;Zambia;320;2;93947;1275
2021-05-28;ZM;Zambia;483;0;94430;1275
2021-05-29;ZM;Zambia;321;1;94751;1276
2021-05-30;ZM;Zambia;299;2;95050;1278
2021-05-31;ZM;Zambia;213;3;95263;1281
2021-06-01;ZM;Zambia;558;1;95821;1282
2021-06-02;ZM;Zambia;742;2;96563;1284
2021-06-03;ZM;Zambia;825;4;97388;1288
2021-06-04;ZM;Zambia;988;9;98376;1297
2021-06-05;ZM;Zambia;1164;6;99540;1303
2021-06-06;ZM;Zambia;738;5;100278;1308
2021-06-07;ZM;Zambia;487;7;100765;1315
2021-06-08;ZM;Zambia;1231;6;101996;1321
2021-06-09;ZM;Zambia;1767;3;103763;1324
2021-06-10;ZM;Zambia;2146;8;105909;1332
2021-06-11;ZM;Zambia;2065;16;107974;1348
2021-06-12;ZM;Zambia;2358;17;110332;1365
2021-06-13;ZM;Zambia;1414;24;111746;1389
2021-06-14;ZM;Zambia;1388;27;113134;1416
2021-06-15;ZM;Zambia;2690;28;115824;1444
2021-06-16;ZM;Zambia;3026;48;118850;1492
2021-06-17;ZM;Zambia;3394;33;122244;1525
2021-06-18;ZM;Zambia;2913;29;125157;1554
2021-06-19;ZM;Zambia;1816;41;126973;1595
2021-06-20;ZM;Zambia;2060;49;129033;1644
2021-06-21;ZM;Zambia;1598;47;130631;1691
2021-06-22;ZM;Zambia;3028;53;133659;1744
2021-06-23;ZM;Zambia;3367;50;137026;1794
2021-06-24;ZM;Zambia;3594;61;140620;1855
2021-06-25;ZM;Zambia;2595;60;143215;1915
2021-06-26;ZM;Zambia;2816;52;146031;1967
2021-06-27;ZM;Zambia;2537;55;148568;2022
2021-06-28;ZM;Zambia;1093;69;149661;2091
2021-06-29;ZM;Zambia;2395;47;152056;2138
2021-06-30;ZM;Zambia;2892;61;154948;2199
2021-07-01;ZM;Zambia;2884;72;157832;2271
2020-03-20;ZW;Zimbabwe;1;0;1;0
2020-03-21;ZW;Zimbabwe;2;0;3;0
2020-03-22;ZW;Zimbabwe;0;0;3;0
2020-03-23;ZW;Zimbabwe;0;1;3;1
2020-03-24;ZW;Zimbabwe;0;0;3;1
2020-03-25;ZW;Zimbabwe;0;0;3;1
2020-03-26;ZW;Zimbabwe;0;0;3;1
2020-03-27;ZW;Zimbabwe;2;0;5;1
2020-03-28;ZW;Zimbabwe;2;0;7;1
2020-03-29;ZW;Zimbabwe;0;0;7;1
2020-03-30;ZW;Zimbabwe;0;0;7;1
2020-03-31;ZW;Zimbabwe;1;0;8;1
2020-04-01;ZW;Zimbabwe;0;0;8;1
2020-04-02;ZW;Zimbabwe;1;0;9;1
2020-04-03;ZW;Zimbabwe;0;0;9;1
2020-04-04;ZW;Zimbabwe;0;0;9;1
2020-04-05;ZW;Zimbabwe;0;0;9;1
2020-04-06;ZW;Zimbabwe;1;0;10;1
2020-04-07;ZW;Zimbabwe;1;1;11;2
2020-04-08;ZW;Zimbabwe;0;1;11;3
2020-04-09;ZW;Zimbabwe;0;0;11;3
2020-04-10;ZW;Zimbabwe;2;0;13;3
2020-04-11;ZW;Zimbabwe;1;0;14;3
2020-04-12;ZW;Zimbabwe;0;0;14;3
2020-04-13;ZW;Zimbabwe;3;0;17;3
2020-04-14;ZW;Zimbabwe;0;0;17;3
2020-04-15;ZW;Zimbabwe;6;0;23;3
2020-04-16;ZW;Zimbabwe;0;0;23;3
2020-04-17;ZW;Zimbabwe;1;0;24;3
2020-04-18;ZW;Zimbabwe;1;0;25;3
2020-04-19;ZW;Zimbabwe;0;0;25;3
2020-04-20;ZW;Zimbabwe;0;0;25;3
2020-04-21;ZW;Zimbabwe;3;0;28;3
2020-04-22;ZW;Zimbabwe;0;1;28;4
2020-04-23;ZW;Zimbabwe;0;0;28;4
2020-04-24;ZW;Zimbabwe;1;0;29;4
2020-04-25;ZW;Zimbabwe;2;0;31;4
2020-04-26;ZW;Zimbabwe;0;0;31;4
2020-04-27;ZW;Zimbabwe;1;0;32;4
2020-04-28;ZW;Zimbabwe;0;0;32;4
2020-04-29;ZW;Zimbabwe;0;0;32;4
2020-04-30;ZW;Zimbabwe;8;0;40;4
2020-05-01;ZW;Zimbabwe;0;0;40;4
2020-05-02;ZW;Zimbabwe;-6;0;34;4
2020-05-03;ZW;Zimbabwe;0;0;34;4
2020-05-04;ZW;Zimbabwe;0;0;34;4
2020-05-05;ZW;Zimbabwe;0;0;34;4
2020-05-06;ZW;Zimbabwe;0;0;34;4
2020-05-07;ZW;Zimbabwe;0;0;34;4
2020-05-08;ZW;Zimbabwe;0;0;34;4
2020-05-09;ZW;Zimbabwe;1;0;35;4
2020-05-10;ZW;Zimbabwe;1;0;36;4
2020-05-11;ZW;Zimbabwe;0;0;36;4
2020-05-12;ZW;Zimbabwe;0;0;36;4
2020-05-13;ZW;Zimbabwe;1;0;37;4
2020-05-14;ZW;Zimbabwe;0;0;37;4
2020-05-15;ZW;Zimbabwe;5;0;42;4
2020-05-16;ZW;Zimbabwe;0;0;42;4
2020-05-17;ZW;Zimbabwe;2;0;44;4
2020-05-18;ZW;Zimbabwe;2;0;46;4
2020-05-19;ZW;Zimbabwe;0;0;46;4
2020-05-20;ZW;Zimbabwe;2;0;48;4
2020-05-21;ZW;Zimbabwe;3;0;51;4
2020-05-22;ZW;Zimbabwe;0;0;51;4
2020-05-23;ZW;Zimbabwe;5;0;56;4
2020-05-24;ZW;Zimbabwe;0;0;56;4
2020-05-25;ZW;Zimbabwe;0;0;56;4
2020-05-26;ZW;Zimbabwe;0;0;56;4
2020-05-27;ZW;Zimbabwe;76;0;132;4
2020-05-28;ZW;Zimbabwe;17;0;149;4
2020-05-29;ZW;Zimbabwe;0;0;149;4
2020-05-30;ZW;Zimbabwe;25;0;174;4
2020-05-31;ZW;Zimbabwe;4;0;178;4
2020-06-01;ZW;Zimbabwe;25;0;203;4
2020-06-02;ZW;Zimbabwe;3;0;206;4
2020-06-03;ZW;Zimbabwe;16;0;222;4
2020-06-04;ZW;Zimbabwe;15;0;237;4
2020-06-05;ZW;Zimbabwe;28;0;265;4
2020-06-06;ZW;Zimbabwe;14;0;279;4
2020-06-07;ZW;Zimbabwe;3;0;282;4
2020-06-08;ZW;Zimbabwe;5;0;287;4
2020-06-09;ZW;Zimbabwe;27;0;314;4
2020-06-10;ZW;Zimbabwe;6;0;320;4
2020-06-11;ZW;Zimbabwe;12;0;332;4
2020-06-12;ZW;Zimbabwe;11;0;343;4
2020-06-13;ZW;Zimbabwe;13;0;356;4
2020-06-14;ZW;Zimbabwe;27;0;383;4
2020-06-15;ZW;Zimbabwe;4;0;387;4
2020-06-16;ZW;Zimbabwe;4;0;391;4
2020-06-17;ZW;Zimbabwe;10;0;401;4
2020-06-18;ZW;Zimbabwe;62;0;463;4
2020-06-19;ZW;Zimbabwe;16;0;479;4
2020-06-20;ZW;Zimbabwe;0;0;479;4
2020-06-21;ZW;Zimbabwe;10;2;489;6
2020-06-22;ZW;Zimbabwe;23;0;512;6
2020-06-23;ZW;Zimbabwe;13;0;525;6
2020-06-24;ZW;Zimbabwe;5;0;530;6
2020-06-25;ZW;Zimbabwe;21;0;551;6
2020-06-26;ZW;Zimbabwe;10;0;561;6
2020-06-27;ZW;Zimbabwe;6;0;567;6
2020-06-28;ZW;Zimbabwe;0;0;567;6
2020-06-29;ZW;Zimbabwe;7;1;574;7
2020-06-30;ZW;Zimbabwe;17;0;591;7
2020-07-01;ZW;Zimbabwe;14;0;605;7
2020-07-02;ZW;Zimbabwe;12;0;617;7
2020-07-03;ZW;Zimbabwe;8;0;625;7
2020-07-04;ZW;Zimbabwe;73;1;698;8
2020-07-05;ZW;Zimbabwe;18;0;716;8
2020-07-06;ZW;Zimbabwe;18;1;734;9
2020-07-07;ZW;Zimbabwe;53;0;787;9
2020-07-08;ZW;Zimbabwe;98;0;885;9
2020-07-09;ZW;Zimbabwe;0;0;885;9
2020-07-10;ZW;Zimbabwe;57;4;942;13
2020-07-11;ZW;Zimbabwe;40;5;982;18
2020-07-12;ZW;Zimbabwe;3;0;985;18
2020-07-13;ZW;Zimbabwe;49;1;1034;19
2020-07-14;ZW;Zimbabwe;30;1;1064;20
2020-07-15;ZW;Zimbabwe;25;0;1089;20
2020-07-16;ZW;Zimbabwe;273;3;1362;23
2020-07-17;ZW;Zimbabwe;58;1;1420;24
2020-07-18;ZW;Zimbabwe;58;1;1478;25
2020-07-19;ZW;Zimbabwe;133;0;1611;25
2020-07-20;ZW;Zimbabwe;102;1;1713;26
2020-07-21;ZW;Zimbabwe;107;0;1820;26
2020-07-22;ZW;Zimbabwe;214;0;2034;26
2020-07-23;ZW;Zimbabwe;90;2;2124;28
2020-07-24;ZW;Zimbabwe;172;4;2296;32
2020-07-25;ZW;Zimbabwe;138;2;2434;34
2020-07-26;ZW;Zimbabwe;78;0;2512;34
2020-07-27;ZW;Zimbabwe;192;2;2704;36
2020-07-28;ZW;Zimbabwe;113;4;2817;40
2020-07-29;ZW;Zimbabwe;62;1;2879;41
2020-07-30;ZW;Zimbabwe;213;12;3092;53
2020-07-31;ZW;Zimbabwe;77;14;3169;67
2020-08-01;ZW;Zimbabwe;490;2;3659;69
2020-08-02;ZW;Zimbabwe;262;1;3921;70
2020-08-03;ZW;Zimbabwe;154;10;4075;80
2020-08-04;ZW;Zimbabwe;146;1;4221;81
2020-08-05;ZW;Zimbabwe;0;0;4221;81
2020-08-06;ZW;Zimbabwe;118;3;4339;84
2020-08-07;ZW;Zimbabwe;112;18;4451;102
2020-08-08;ZW;Zimbabwe;124;0;4575;102
2020-08-09;ZW;Zimbabwe;74;2;4649;104
2020-08-10;ZW;Zimbabwe;99;0;4748;104
2020-08-11;ZW;Zimbabwe;70;0;4818;104
2020-08-12;ZW;Zimbabwe;75;18;4893;122
2020-08-13;ZW;Zimbabwe;97;6;4990;128
2020-08-14;ZW;Zimbabwe;82;0;5072;128
2020-08-15;ZW;Zimbabwe;104;2;5176;130
2020-08-16;ZW;Zimbabwe;85;2;5261;132
2020-08-17;ZW;Zimbabwe;47;3;5308;135
2020-08-18;ZW;Zimbabwe;70;6;5378;141
2020-08-19;ZW;Zimbabwe;265;9;5643;150
2020-08-20;ZW;Zimbabwe;102;1;5745;151
2020-08-21;ZW;Zimbabwe;70;1;5815;152
2020-08-22;ZW;Zimbabwe;78;1;5893;153
2020-08-23;ZW;Zimbabwe;37;2;5930;155
2020-08-24;ZW;Zimbabwe;140;0;6070;155
2020-08-25;ZW;Zimbabwe;126;11;6196;166
2020-08-26;ZW;Zimbabwe;55;13;6251;179
2020-08-27;ZW;Zimbabwe;41;10;6292;189
2020-08-28;ZW;Zimbabwe;96;6;6388;195
2020-08-29;ZW;Zimbabwe;18;1;6406;196
2020-08-30;ZW;Zimbabwe;6;0;6412;196
2020-08-31;ZW;Zimbabwe;85;6;6497;202
2020-09-01;ZW;Zimbabwe;62;1;6559;203
2020-09-02;ZW;Zimbabwe;79;3;6638;206
2020-09-03;ZW;Zimbabwe;40;0;6678;206
2020-09-04;ZW;Zimbabwe;159;0;6837;206
2020-09-05;ZW;Zimbabwe;0;0;6837;206
2020-09-06;ZW;Zimbabwe;0;0;6837;206
2020-09-07;ZW;Zimbabwe;461;4;7298;210
2020-09-08;ZW;Zimbabwe;90;8;7388;218
2020-09-09;ZW;Zimbabwe;41;4;7429;222
2020-09-10;ZW;Zimbabwe;24;0;7453;222
2020-09-11;ZW;Zimbabwe;26;2;7479;224
2020-09-12;ZW;Zimbabwe;29;0;7508;224
2020-09-13;ZW;Zimbabwe;18;0;7526;224
2020-09-14;ZW;Zimbabwe;5;0;7531;224
2020-09-15;ZW;Zimbabwe;45;0;7576;224
2020-09-16;ZW;Zimbabwe;22;0;7598;224
2020-09-17;ZW;Zimbabwe;35;0;7633;224
2020-09-18;ZW;Zimbabwe;14;0;7647;224
2020-09-19;ZW;Zimbabwe;25;1;7672;225
2020-09-20;ZW;Zimbabwe;11;0;7683;225
2020-09-21;ZW;Zimbabwe;0;0;7683;225
2020-09-22;ZW;Zimbabwe;28;1;7711;226
2020-09-23;ZW;Zimbabwe;14;1;7725;227
2020-09-24;ZW;Zimbabwe;27;0;7752;227
2020-09-25;ZW;Zimbabwe;35;0;7787;227
2020-09-26;ZW;Zimbabwe;16;0;7803;227
2020-09-27;ZW;Zimbabwe;9;0;7812;227
2020-09-28;ZW;Zimbabwe;4;1;7816;228
2020-09-29;ZW;Zimbabwe;21;0;7837;228
2020-09-30;ZW;Zimbabwe;1;0;7838;228
2020-10-01;ZW;Zimbabwe;12;0;7850;228
2020-10-02;ZW;Zimbabwe;8;0;7858;228
2020-10-03;ZW;Zimbabwe;27;0;7885;228
2020-10-04;ZW;Zimbabwe;3;0;7888;228
2020-10-05;ZW;Zimbabwe;10;0;7898;228
2020-10-06;ZW;Zimbabwe;17;1;7915;229
2020-10-07;ZW;Zimbabwe;4;0;7919;229
2020-10-08;ZW;Zimbabwe;32;0;7951;229
2020-10-09;ZW;Zimbabwe;43;0;7994;229
2020-10-10;ZW;Zimbabwe;16;1;8010;230
2020-10-11;ZW;Zimbabwe;1;0;8011;230
2020-10-12;ZW;Zimbabwe;10;0;8021;230
2020-10-13;ZW;Zimbabwe;15;0;8036;230
2020-10-14;ZW;Zimbabwe;19;1;8055;231
2020-10-15;ZW;Zimbabwe;20;0;8075;231
2020-10-16;ZW;Zimbabwe;24;0;8099;231
2020-10-17;ZW;Zimbabwe;11;0;8110;231
2020-10-18;ZW;Zimbabwe;37;0;8147;231
2020-10-19;ZW;Zimbabwe;12;1;8159;232
2020-10-20;ZW;Zimbabwe;28;1;8187;233
2020-10-21;ZW;Zimbabwe;28;3;8215;236
2020-10-22;ZW;Zimbabwe;27;0;8242;236
2020-10-23;ZW;Zimbabwe;15;0;8257;236
2020-10-24;ZW;Zimbabwe;12;0;8269;236
2020-10-25;ZW;Zimbabwe;7;1;8276;237
2020-10-26;ZW;Zimbabwe;27;5;8303;242
2020-10-27;ZW;Zimbabwe;12;0;8315;242
2020-10-28;ZW;Zimbabwe;5;0;8320;242
2020-10-29;ZW;Zimbabwe;29;0;8349;242
2020-10-30;ZW;Zimbabwe;13;0;8362;242
2020-10-31;ZW;Zimbabwe;5;1;8367;243
2020-11-01;ZW;Zimbabwe;7;0;8374;243
2020-11-02;ZW;Zimbabwe;15;2;8389;245
2020-11-03;ZW;Zimbabwe;21;1;8410;246
2020-11-04;ZW;Zimbabwe;17;2;8427;248
2020-11-05;ZW;Zimbabwe;17;0;8444;248
2020-11-06;ZW;Zimbabwe;27;2;8471;250
2020-11-07;ZW;Zimbabwe;27;1;8498;251
2020-11-08;ZW;Zimbabwe;33;2;8531;253
2020-11-09;ZW;Zimbabwe;30;1;8561;254
2020-11-10;ZW;Zimbabwe;49;1;8610;255
2020-11-11;ZW;Zimbabwe;57;0;8667;255
2020-11-12;ZW;Zimbabwe;29;0;8696;255
2020-11-13;ZW;Zimbabwe;69;2;8765;257
2020-11-14;ZW;Zimbabwe;21;0;8786;257
2020-11-15;ZW;Zimbabwe;43;0;8829;257
2020-11-16;ZW;Zimbabwe;68;0;8897;257
2020-11-17;ZW;Zimbabwe;48;3;8945;260
2020-11-18;ZW;Zimbabwe;36;1;8981;261
2020-11-19;ZW;Zimbabwe;65;4;9046;265
2020-11-20;ZW;Zimbabwe;74;0;9120;265
2020-11-21;ZW;Zimbabwe;52;0;9172;265
2020-11-22;ZW;Zimbabwe;48;3;9220;268
2020-11-23;ZW;Zimbabwe;88;5;9308;273
2020-11-24;ZW;Zimbabwe;90;1;9398;274
2020-11-25;ZW;Zimbabwe;110;0;9508;274
2020-11-26;ZW;Zimbabwe;115;0;9623;274
2020-11-27;ZW;Zimbabwe;91;1;9714;275
2020-11-28;ZW;Zimbabwe;108;0;9822;275
2020-11-29;ZW;Zimbabwe;0;0;9822;275
2020-11-30;ZW;Zimbabwe;128;1;9950;276
2020-12-01;ZW;Zimbabwe;179;1;10129;277
2020-12-02;ZW;Zimbabwe;0;0;10129;277
2020-12-03;ZW;Zimbabwe;295;3;10424;280
2020-12-04;ZW;Zimbabwe;123;1;10547;281
2020-12-05;ZW;Zimbabwe;70;10;10617;291
2020-12-06;ZW;Zimbabwe;101;0;10718;291
2020-12-07;ZW;Zimbabwe;121;3;10839;294
2020-12-08;ZW;Zimbabwe;73;9;10912;303
2020-12-09;ZW;Zimbabwe;95;1;11007;304
2020-12-10;ZW;Zimbabwe;74;1;11081;305
2020-12-11;ZW;Zimbabwe;81;1;11162;306
2020-12-12;ZW;Zimbabwe;57;1;11219;307
2020-12-13;ZW;Zimbabwe;27;0;11246;307
2020-12-14;ZW;Zimbabwe;112;2;11358;309
2020-12-15;ZW;Zimbabwe;164;1;11522;310
2020-12-16;ZW;Zimbabwe;227;3;11749;313
2020-12-17;ZW;Zimbabwe;117;1;11866;314
2020-12-18;ZW;Zimbabwe;181;2;12047;316
2020-12-19;ZW;Zimbabwe;104;2;12151;318
2020-12-20;ZW;Zimbabwe;174;2;12325;320
2020-12-21;ZW;Zimbabwe;97;2;12422;322
2020-12-22;ZW;Zimbabwe;122;4;12544;326
2020-12-23;ZW;Zimbabwe;112;4;12656;330
2020-12-24;ZW;Zimbabwe;130;9;12786;339
2020-12-25;ZW;Zimbabwe;94;2;12880;341
2020-12-26;ZW;Zimbabwe;83;0;12963;341
2020-12-27;ZW;Zimbabwe;114;8;13077;349
2020-12-28;ZW;Zimbabwe;71;5;13148;354
2020-12-29;ZW;Zimbabwe;177;5;13325;359
2020-12-30;ZW;Zimbabwe;300;1;13625;360
2020-12-31;ZW;Zimbabwe;242;3;13867;363
2021-01-01;ZW;Zimbabwe;217;6;14084;369
2021-01-02;ZW;Zimbabwe;407;8;14491;377
2021-01-03;ZW;Zimbabwe;774;3;15265;380
2021-01-04;ZW;Zimbabwe;564;4;15829;384
2021-01-05;ZW;Zimbabwe;1365;34;17194;418
2021-01-06;ZW;Zimbabwe;610;13;17804;431
2021-01-07;ZW;Zimbabwe;871;15;18675;446
2021-01-08;ZW;Zimbabwe;985;22;19660;468
2021-01-09;ZW;Zimbabwe;839;15;20499;483
2021-01-10;ZW;Zimbabwe;978;24;21477;507
2021-01-11;ZW;Zimbabwe;820;21;22297;528
2021-01-12;ZW;Zimbabwe;942;23;23239;551
2021-01-13;ZW;Zimbabwe;1017;38;24256;589
2021-01-14;ZW;Zimbabwe;1112;47;25368;636
2021-01-15;ZW;Zimbabwe;741;30;26109;666
2021-01-16;ZW;Zimbabwe;772;17;26881;683
2021-01-17;ZW;Zimbabwe;322;30;27203;713
2021-01-18;ZW;Zimbabwe;689;60;27892;773
2021-01-19;ZW;Zimbabwe;783;52;28675;825
2021-01-20;ZW;Zimbabwe;733;54;29408;879
2021-01-21;ZW;Zimbabwe;639;38;30047;917
2021-01-22;ZW;Zimbabwe;476;45;30523;962
2021-01-23;ZW;Zimbabwe;484;12;31007;974
2021-01-24;ZW;Zimbabwe;313;31;31320;1005
2021-01-25;ZW;Zimbabwe;326;70;31646;1075
2021-01-26;ZW;Zimbabwe;358;28;32004;1103
2021-01-27;ZW;Zimbabwe;300;19;32304;1122
2021-01-28;ZW;Zimbabwe;342;38;32646;1160
2021-01-29;ZW;Zimbabwe;306;18;32952;1178
2021-01-30;ZW;Zimbabwe;321;15;33273;1193
2021-01-31;ZW;Zimbabwe;115;24;33388;1217
2021-02-01;ZW;Zimbabwe;160;17;33548;1234
2021-02-02;ZW;Zimbabwe;266;20;33814;1254
2021-02-03;ZW;Zimbabwe;150;15;33964;1269
2021-02-04;ZW;Zimbabwe;207;19;34171;1288
2021-02-05;ZW;Zimbabwe;160;15;34331;1303
2021-02-06;ZW;Zimbabwe;156;13;34487;1316
2021-02-07;ZW;Zimbabwe;65;10;34552;1326
2021-02-08;ZW;Zimbabwe;106;13;34658;1339
2021-02-09;ZW;Zimbabwe;123;14;34781;1353
2021-02-10;ZW;Zimbabwe;83;11;34864;1364
2021-02-11;ZW;Zimbabwe;0;0;34864;1364
2021-02-12;ZW;Zimbabwe;181;29;35045;1393
2021-02-13;ZW;Zimbabwe;59;5;35104;1398
2021-02-14;ZW;Zimbabwe;68;2;35172;1400
2021-02-15;ZW;Zimbabwe;50;10;35222;1410
2021-02-16;ZW;Zimbabwe;93;4;35315;1414
2021-02-17;ZW;Zimbabwe;108;4;35423;1418
2021-02-18;ZW;Zimbabwe;120;2;35543;1420
2021-02-19;ZW;Zimbabwe;167;10;35710;1430
2021-02-20;ZW;Zimbabwe;58;2;35768;1432
2021-02-21;ZW;Zimbabwe;28;4;35796;1436
2021-02-22;ZW;Zimbabwe;66;5;35862;1441
2021-02-23;ZW;Zimbabwe;48;7;35910;1448
2021-02-24;ZW;Zimbabwe;50;8;35960;1456
2021-02-25;ZW;Zimbabwe;34;2;35994;1458
2021-02-26;ZW;Zimbabwe;50;5;36044;1463
2021-02-27;ZW;Zimbabwe;14;0;36058;1463
2021-02-28;ZW;Zimbabwe;31;0;36089;1463
2021-03-01;ZW;Zimbabwe;26;5;36115;1468
2021-03-02;ZW;Zimbabwe;33;4;36148;1472
2021-03-03;ZW;Zimbabwe;31;6;36179;1478
2021-03-04;ZW;Zimbabwe;44;5;36223;1483
2021-03-05;ZW;Zimbabwe;25;1;36248;1484
2021-03-06;ZW;Zimbabwe;12;1;36260;1485
2021-03-07;ZW;Zimbabwe;11;0;36271;1485
2021-03-08;ZW;Zimbabwe;18;2;36289;1487
2021-03-09;ZW;Zimbabwe;32;2;36321;1489
2021-03-10;ZW;Zimbabwe;20;0;36341;1489
2021-03-11;ZW;Zimbabwe;36;3;36377;1492
2021-03-12;ZW;Zimbabwe;46;4;36423;1496
2021-03-13;ZW;Zimbabwe;48;5;36471;1501
2021-03-14;ZW;Zimbabwe;13;2;36484;1503
2021-03-15;ZW;Zimbabwe;20;1;36504;1504
2021-03-16;ZW;Zimbabwe;31;3;36535;1507
2021-03-17;ZW;Zimbabwe;17;1;36552;1508
2021-03-18;ZW;Zimbabwe;59;1;36611;1509
2021-03-19;ZW;Zimbabwe;41;1;36652;1510
2021-03-20;ZW;Zimbabwe;10;0;36662;1510
2021-03-21;ZW;Zimbabwe;3;2;36665;1512
2021-03-22;ZW;Zimbabwe;19;2;36684;1514
2021-03-23;ZW;Zimbabwe;33;2;36717;1516
2021-03-24;ZW;Zimbabwe;32;0;36749;1516
2021-03-25;ZW;Zimbabwe;29;2;36778;1518
2021-03-26;ZW;Zimbabwe;27;0;36805;1518
2021-03-27;ZW;Zimbabwe;13;1;36818;1519
2021-03-28;ZW;Zimbabwe;4;1;36822;1520
2021-03-29;ZW;Zimbabwe;17;0;36839;1520
2021-03-30;ZW;Zimbabwe;0;0;36839;1520
2021-03-31;ZW;Zimbabwe;43;3;36882;1523
2021-04-01;ZW;Zimbabwe;14;0;36896;1523
2021-04-02;ZW;Zimbabwe;7;1;36903;1524
2021-04-03;ZW;Zimbabwe;8;0;36911;1524
2021-04-04;ZW;Zimbabwe;12;1;36923;1525
2021-04-05;ZW;Zimbabwe;11;0;36934;1525
2021-04-06;ZW;Zimbabwe;32;6;36966;1531
2021-04-07;ZW;Zimbabwe;18;0;36984;1531
2021-04-08;ZW;Zimbabwe;68;1;37052;1532
2021-04-09;ZW;Zimbabwe;95;3;37147;1535
2021-04-10;ZW;Zimbabwe;126;3;37273;1538
2021-04-11;ZW;Zimbabwe;15;0;37288;1538
2021-04-12;ZW;Zimbabwe;19;4;37307;1542
2021-04-13;ZW;Zimbabwe;23;1;37330;1543
2021-04-14;ZW;Zimbabwe;39;5;37369;1548
2021-04-15;ZW;Zimbabwe;53;2;37422;1550
2021-04-16;ZW;Zimbabwe;112;1;37534;1551
2021-04-17;ZW;Zimbabwe;165;1;37699;1552
2021-04-18;ZW;Zimbabwe;52;1;37751;1553
2021-04-19;ZW;Zimbabwe;108;0;37859;1553
2021-04-20;ZW;Zimbabwe;16;1;37875;1554
2021-04-21;ZW;Zimbabwe;105;1;37980;1555
2021-04-22;ZW;Zimbabwe;38;0;38018;1555
2021-04-23;ZW;Zimbabwe;27;1;38045;1556
2021-04-24;ZW;Zimbabwe;19;0;38064;1556
2021-04-25;ZW;Zimbabwe;22;1;38086;1557
2021-04-26;ZW;Zimbabwe;16;3;38102;1560
2021-04-27;ZW;Zimbabwe;62;5;38164;1565
2021-04-28;ZW;Zimbabwe;27;0;38191;1565
2021-04-29;ZW;Zimbabwe;44;2;38235;1567
2021-04-30;ZW;Zimbabwe;22;0;38257;1567
2021-05-01;ZW;Zimbabwe;3;1;38260;1568
2021-05-02;ZW;Zimbabwe;21;2;38281;1570
2021-05-03;ZW;Zimbabwe;12;3;38293;1573
2021-05-04;ZW;Zimbabwe;34;1;38327;1574
2021-05-05;ZW;Zimbabwe;30;0;38357;1574
2021-05-06;ZW;Zimbabwe;41;1;38398;1575
2021-05-07;ZW;Zimbabwe;5;1;38403;1576
2021-05-08;ZW;Zimbabwe;11;0;38414;1576
2021-05-09;ZW;Zimbabwe;5;0;38419;1576
2021-05-10;ZW;Zimbabwe;14;0;38433;1576
2021-05-11;ZW;Zimbabwe;15;3;38448;1579
2021-05-12;ZW;Zimbabwe;18;0;38466;1579
2021-05-13;ZW;Zimbabwe;25;3;38491;1582
2021-05-14;ZW;Zimbabwe;44;0;38535;1582
2021-05-15;ZW;Zimbabwe;19;0;38554;1582
2021-05-16;ZW;Zimbabwe;6;0;38560;1582
2021-05-17;ZW;Zimbabwe;12;0;38572;1582
2021-05-18;ZW;Zimbabwe;23;1;38595;1583
2021-05-19;ZW;Zimbabwe;17;0;38612;1583
2021-05-20;ZW;Zimbabwe;23;2;38635;1585
2021-05-21;ZW;Zimbabwe;29;1;38664;1586
2021-05-22;ZW;Zimbabwe;15;0;38679;1586
2021-05-23;ZW;Zimbabwe;3;0;38682;1586
2021-05-24;ZW;Zimbabwe;14;0;38696;1586
2021-05-25;ZW;Zimbabwe;10;1;38706;1587
2021-05-26;ZW;Zimbabwe;113;2;38819;1589
2021-05-27;ZW;Zimbabwe;35;3;38854;1592
2021-05-28;ZW;Zimbabwe;64;0;38918;1592
2021-05-29;ZW;Zimbabwe;15;2;38933;1594
2021-05-30;ZW;Zimbabwe;11;0;38944;1594
2021-05-31;ZW;Zimbabwe;17;0;38961;1594
2021-06-01;ZW;Zimbabwe;37;5;38998;1599
2021-06-02;ZW;Zimbabwe;33;0;39031;1599
2021-06-03;ZW;Zimbabwe;61;5;39092;1604
2021-06-04;ZW;Zimbabwe;52;1;39144;1605
2021-06-05;ZW;Zimbabwe;24;0;39168;1605
2021-06-06;ZW;Zimbabwe;21;1;39189;1606
2021-06-07;ZW;Zimbabwe;49;5;39238;1611
2021-06-08;ZW;Zimbabwe;83;6;39321;1617
2021-06-09;ZW;Zimbabwe;111;5;39432;1622
2021-06-10;ZW;Zimbabwe;64;4;39496;1626
2021-06-11;ZW;Zimbabwe;192;3;39688;1629
2021-06-12;ZW;Zimbabwe;164;3;39852;1632
2021-06-13;ZW;Zimbabwe;107;0;39959;1632
2021-06-14;ZW;Zimbabwe;118;3;40077;1635
2021-06-15;ZW;Zimbabwe;241;2;40318;1637
2021-06-16;ZW;Zimbabwe;238;3;40556;1640
2021-06-17;ZW;Zimbabwe;371;7;40927;1647
2021-06-18;ZW;Zimbabwe;408;9;41335;1656
2021-06-19;ZW;Zimbabwe;293;10;41628;1666
2021-06-20;ZW;Zimbabwe;151;6;41779;1672
2021-06-21;ZW;Zimbabwe;416;13;42195;1685
2021-06-22;ZW;Zimbabwe;519;6;42714;1691
2021-06-23;ZW;Zimbabwe;766;1;43480;1692
2021-06-24;ZW;Zimbabwe;826;17;44306;1709
2021-06-25;ZW;Zimbabwe;911;12;45217;1721
2021-06-26;ZW;Zimbabwe;801;4;46018;1725
2021-06-27;ZW;Zimbabwe;424;11;46442;1736
2021-06-28;ZW;Zimbabwe;842;13;47284;1749
2021-06-29;ZW;Zimbabwe;1249;12;48533;1761
2021-06-30;ZW;Zimbabwe;1331;28;49864;1789
2021-07-01;ZW;Zimbabwe;1357;19;51221;1808
